time,subj_course_id,sec_code,sec_id,prof,available,waitlist,total,enrolled_ct
1683336964780,ANBI 133,A00,258401,Wilder; Linnea Lorene,34,0,40,6
1683336965810,ANBI 140,A00,258395,Hrvoj Mihic; Branka,18,0,25,7
1683336966841,ANSC 120,A00,258402,Bialecki; Jon Anthony,27,0,40,13
1683336967870,ANSC 144,A00,258400,Staff,14,0,40,26
1683336969934,ANSC 166,A00,258396,Parish; Steven Martin,157,0,175,18
1683336970967,ANSC 180,A00,193533,Staff,9,0,20,11
1683336971995,ANSC 188,A00,258397,Jassal; Aftab,33,0,40,7
1683336973026,ANTH 3,A01,258316,Staff,23,0,30,7
1683336974060,ANTH 5,A00,258394,Semendeferi; Ekaterini,16,0,20,4
1683336975087,ANTH 21,A01,258331,Staff,8,0,40,32
1683336976113,ANTH 103,A00,258398,Varma; Saiba,15,0,25,10
1683336977142,AWP 10,001,202034,Staff,0,0,0,0
1683336977142,AWP 10,002,202035,Staff,0,0,0,0
1683336977142,AWP 10,003,202036,Staff,0,0,0,0
1683336977142,AWP 10,004,202037,Staff,0,0,0,0
1683336977142,AWP 10,005,202038,Staff,0,0,0,0
1683336977142,AWP 10,006,202039,Staff,0,0,0,0
1683336977142,AWP 10,007,202040,Staff,0,0,0,0
1683336977142,AWP 10,008,202041,Staff,0,0,0,0
1683336977142,AWP 10,009,202042,Staff,0,0,0,0
1683336977142,AWP 10,010,202043,Staff,0,0,0,0
1683336977142,AWP 10,011,202044,Staff,0,0,0,0
1683336977142,AWP 10,012,202045,Staff,0,0,0,0
1683336977142,AWP 10,013,202046,Staff,0,0,0,0
1683336977142,AWP 10,014,202047,Staff,0,0,0,0
1683336977142,AWP 10,015,202048,Staff,0,0,0,0
1683336977142,AWP 10,016,202049,Staff,0,0,0,0
1683336977142,AWP 10,017,202050,Staff,0,0,0,0
1683336977142,AWP 10,018,202051,Staff,0,0,0,0
1683336977142,AWP 10,019,202052,Staff,0,0,0,0
1683336977142,AWP 10,020,202053,Staff,0,0,0,0
1683336977142,AWP 10,021,202054,Staff,0,0,0,0
1683336977142,AWP 10,022,202055,Staff,0,0,0,0
1683336977142,AWP 10,023,202056,Staff,0,0,0,0
1683336977142,AWP 10,024,202057,Staff,0,0,0,0
1683336977142,AWP 10,025,202058,Staff,0,0,0,0
1683336977142,AWP 10,026,202059,Staff,0,0,0,0
1683336978171,AWP 102,001,202032,Staff,0,0,0,0
1683336978171,AWP 102,002,202033,Staff,0,0,0,0
1683336979200,BENG 100,A01,254234,Taylor Amos; Alyssa C,31,0,40,9
1683336980227,BENG 196,001,270013,Engler; Adam J.,9999,0,9999,0
1683336981259,BICD 100R,A01,202018,Smith; Laurie,0,7,32,32
1683336981259,BICD 100R,A02,202019,Smith; Laurie,0,2,32,32
1683336981259,BICD 100R,A03,202020,Smith; Laurie,0,1,32,32
1683336981259,BICD 100R,A04,202021,Smith; Laurie,9,0,32,23
1683336981259,BICD 100R,A05,202022,Smith; Laurie,12,0,32,20
1683336982285,BICD 136,A01,193242,Gustafson-Brown; Cindy,0,2,32,32
1683336982285,BICD 136,A02,193244,Gustafson-Brown; Cindy,14,0,32,18
1683336983315,BIEB 102,A01,193249,Butler; Shannon Rhey,0,2,32,32
1683336983315,BIEB 102,A02,193251,Butler; Shannon Rhey,0,0,32,32
1683336983315,BIEB 102,A03,193253,Butler; Shannon Rhey,0,1,32,32
1683336983315,BIEB 102,A04,193255,Butler; Shannon Rhey,17,0,32,15
1683336983315,BIEB 102,A05,193265,Butler; Shannon Rhey,26,0,32,6
1683336983315,BIEB 102,A06,193269,Butler; Shannon Rhey,16,0,32,16
1683336985372,BIEB 150,A01,193274,Staff,0,0,32,32
1683336985372,BIEB 150,A02,193285,Staff,23,0,32,9
1683336986401,BIEB 194,A00,193286,Kurle; Carolyn M.,22,0,32,10
1683336987428,BILD 1,A01,192291,Staff,16,0,32,16
1683336987428,BILD 1,A02,192292,Staff,30,0,32,2
1683336987428,BILD 1,B01,192520,Reuther; Keefe,0,1,0,0
1683336987428,BILD 1,B02,192532,Reuther; Keefe,0,1,0,0
1683336988460,BILD 3,A01,192556,Butler; Shannon Rhey,0,0,32,32
1683336988460,BILD 3,A02,192581,Butler; Shannon Rhey,5,0,32,27
1683336988460,BILD 3,A03,192611,Butler; Shannon Rhey,23,0,32,9
1683336988460,BILD 3,A04,192612,Butler; Shannon Rhey,25,0,32,7
1683336988460,BILD 3,A05,192613,Butler; Shannon Rhey,27,0,32,5
1683336988460,BILD 3,A06,192679,Butler; Shannon Rhey,27,0,32,5
1683336988460,BILD 3,A07,192682,Butler; Shannon Rhey,22,0,32,10
1683336989492,BILD 4,A01,192836,Reuther; Keefe,0,0,24,24
1683336989492,BILD 4,A02,193044,Reuther; Keefe,4,0,24,20
1683336990520,BILD 10,A01,193142,Gustafson-Brown; Cindy,30,0,32,2
1683336990520,BILD 10,A02,193149,Gustafson-Brown; Cindy,31,0,32,1
1683336991551,BIMM 100,A01,193301,Staff,0,6,32,32
1683336991551,BIMM 100,A02,193312,Staff,0,5,32,32
1683336991551,BIMM 100,A03,193323,Staff,0,8,32,32
1683336992578,BIMM 101,A01,193329,McDonnell; Lisa Marie,0,3,24,24
1683336992578,BIMM 101,A02,193339,McDonnell; Lisa Marie,0,3,24,24
1683336992578,BIMM 101,B01,193354,McDonnell; Lisa Marie,0,3,24,24
1683336992578,BIMM 101,B02,193357,McDonnell; Lisa Marie,0,3,24,24
1683336993603,BIMM 110,A01,193377,Tat; John,0,11,32,32
1683336993603,BIMM 110,A02,193378,Tat; John,1,9,32,31
1683336994635,BIMM 120,A01,206116,Staff,0,0,32,32
1683336994635,BIMM 120,A02,206117,Staff,8,0,32,24
1683336994635,BIMM 120,A03,206121,Staff,21,0,32,11
1683336995668,BIPN 100,A01,193393,Park; Ji Young,0,14,32,32
1683336995668,BIPN 100,A02,193402,Park; Ji Young,0,13,32,32
1683336995668,BIPN 100,A03,193413,Park; Ji Young,0,14,32,32
1683336995668,BIPN 100,A04,193414,Park; Ji Young,0,13,32,32
1683336996694,BIPN 102,A01,193429,Staff,0,0,32,32
1683336996694,BIPN 102,A02,193438,Staff,22,0,32,10
1683336997722,BIPN 106,A01,193450,Reyes Gonzalez; Catalina,0,2,40,40
1683336998755,BIPN 134,A01,193465,Cooke; James Edward,0,0,32,32
1683336998755,BIPN 134,A02,193474,Cooke; James Edward,25,0,32,7
1683336998755,BIPN 134,A03,193485,Cooke; James Edward,29,0,32,3
1683336998755,BIPN 134,A04,193486,Cooke; James Edward,21,0,32,11
1683336998755,BIPN 134,A05,193491,Cooke; James Edward,31,0,32,1
1683336998755,BIPN 134,A06,193501,Cooke; James Edward,30,0,32,2
1683336998755,BIPN 134,A07,193510,Cooke; James Edward,29,0,32,3
1683337000817,BISP 194,A00,222522,Staff,14,0,32,18
1683337001847,CAT 124,A01,202407,Staff,20,0,25,5
1683337002880,CAT 125,A00,202408,Marchisotto; Jennifer Anne,4,0,20,16
1683337003912,CAT 125R,A00,202409,Smith; Lauryn Alissa,0,11,20,20
1683337003912,CAT 125R,B00,202410,Morales; Celeste Georgianna,0,11,20,20
1683337003912,CAT 125R,C00,202411,Irwin; Matthew Joseph,0,10,20,20
1683337004942,CENG 15,A01,204712,Yang; Kesong,0,1,0,0
1683337005972,CENG 114,A00,202070,Jahed Motlagh; Zeinab,5,0,20,15
1683337007014,CGS 105,A00,185477,Wesling; Megan E.,24,0,40,16
1683337008046,CGS 106,A00,185494,Staff,13,0,22,9
1683337009076,CGS 108,A00,185495,Staff,14,0,20,6
1683337010105,CGS 114,A00,185496,Staff,13,0,18,5
1683337011135,CGS 119,A00,185501,Staff,15,0,20,5
1683337012164,CGS 120,A00,185511,Staff,13,0,20,7
1683337013198,CHEM 4,A01,184675,Bussey; Thomas J,96,0,100,4
1683337014228,CHEM 6A,A01,184677,Staff,34,0,60,26
1683337015256,CHEM 6B,A01,184679,Staff,65,0,100,35
1683337016286,CHEM 6C,A01,184681,Bussey; Thomas J,1,0,50,49
1683337016286,CHEM 6C,A02,184682,Bussey; Thomas J,34,0,50,16
1683337017319,CHEM 40A,A01,184684,Albizati; Kim F.,37,0,100,63
1683337018345,CHEM 40B,A01,184686,Albizati; Kim F.,0,20,100,100
1683337019372,CHEM 41B,A01,184690,Staff,52,0,100,48
1683337020400,COGS 3,A01,184715,Boyle; Mary E. T.,0,25,40,40
1683337021426,COGS 14B,A01,185172,Staff,0,15,38,38
1683337022458,COGS 18,A01,184736,Staff,17,0,80,63
1683337023490,COGS 100,A01,184932,Staff,0,5,73,73
1683337024515,COGS 101A,A01,184935,Staff,0,39,30,30
1683337025542,COGS 101B,A01,184944,Staff,0,2,30,30
1683337026573,COGS 101C,A01,184946,Staff,0,12,30,30
1683337027605,COGS 102A,A01,184951,Johnson; Christine M.,2,0,40,38
1683337028631,COGS 107B,A01,184953,Mooshagian; Eric Frederick,0,50,40,40
1683337029659,COGS 118B,A01,184959,Gupta; Anjum,0,48,40,40
1683337030690,COGS 153,A00,184961,Staff,0,15,30,30
1683337031718,COGS 177,A00,184962,Staff,0,20,30,30
1683337032750,COGS 187A,A01,184969,Boyle; Mary E. T.,0,17,40,40
1683337033776,COMM 10,A01,185174,Staff,0,5,25,25
1683337033776,COMM 10,A02,185189,Staff,0,5,25,25
1683337033776,COMM 10,A03,269821,Staff,0,0,0,0
1683337034805,COMM 100B,A01,185475,Staff,0,0,0,2
1683337034805,COMM 100B,A02,185476,Staff,14,0,25,11
1683337035834,COMM 100C,A01,185314,Staff,1,0,25,24
1683337035834,COMM 100C,A02,185327,Staff,19,0,25,6
1683337036865,COMM 110M,A00,185349,Staff,2,0,40,38
1683337037892,COMM 113T,A00,185352,Staff,24,0,40,16
1683337038918,COMM 114I,A00,185353,Staff,33,0,40,7
1683337039947,COMM 131,A00,185354,Staff,19,0,30,11
1683337040975,CSE 8A,A50,185358,Cao; Yingjun,0,46,10,10
1683337042008,CSE 8B,A01,185362,Staff,1,47,50,49
1683337043037,CSE 11,A01,185416,Cao; Yingjun,0,92,10,10
1683337044064,CSE 20,A01,185445,Briones; Jor-el Thomas Caparas,5,0,25,20
1683337045092,CSE 21,A01,185447,Staff,10,0,50,40
1683337046125,CSE 101,A01,185451,Staff,0,13,50,50
1683337046125,CSE 101,B01,185453,Jones; Miles E,0,11,50,50
1683337048181,CSE 141,A01,185458,Eldon; John,20,0,100,80
1683337049208,CSE 141L,A01,185461,Eldon; John,12,0,100,88
1683337050236,CSE 142,A01,185463,Staff,36,0,60,24
1683337050236,CSE 142,B01,201355,Staff,0,7,60,60
1683337051262,CSE 142L,A01,185470,Staff,36,0,60,24
1683337051262,CSE 142L,B01,201417,Staff,0,6,60,60
1683337052293,CSE 190,A00,201433,Staff,32,0,49,17
1683337053322,DOC 1,A01,259136,Strom; Megan C.,7,0,15,8
1683337053322,DOC 1,A02,259137,Strom; Megan C.,14,0,15,1
1683337053322,DOC 1,A03,259138,Strom; Megan C.,14,0,15,1
1683337053322,DOC 1,A04,259139,Strom; Megan C.,14,0,15,1
1683337054348,DOC 100D,A00,259140,Pass; Natalye Joann,16,0,25,9
1683337055375,DSGN 1,A01,184749,Rill; Bryan,0,25,30,30
1683337056402,DSGN 100,A01,185168,Staff,0,2,25,25
1683337057435,ECE 5,A01,185626,Morris; Karcher William,0,10,0,0
1683337058472,ECE 101,A01,185628,Staff,17,0,70,53
1683337059500,ECE 107,A01,185635,Baghdadchi; Saharnaz,0,0,20,20
1683337059500,ECE 107,A02,185638,Baghdadchi; Saharnaz,4,0,20,16
1683337060528,ECE 148,A01,185647,Silberman; Jack,0,0,16,16
1683337061558,ECON 1,A01,185537,Crane; Meredith Helen,54,0,70,16
1683337062586,ECON 3,A01,185549,Crane; Meredith Helen,33,0,70,37
1683337063671,ECON 4,A01,203354,Anderson; John Charles,0,4,10,10
1683337064704,ECON 100A,A01,185574,Staff,0,4,40,40
1683337065735,ECON 100B,A01,185576,Staff,10,22,50,40
1683337066765,ECON 100C,A01,185589,Newhouse; Herbert S,30,0,70,40
1683337067796,ECON 105,A00,185608,Vespa; Emanuel Ignacio,19,0,35,16
1683337068824,ECON 109,A01,185610,Shishkin; Denis,10,0,35,25
1683337069855,ECON 110A,A01,185612,Staff,11,0,40,29
1683337070883,ECON 120A,A01,185615,Staff,20,0,40,20
1683337071911,ECON 120C,A01,185617,Sun; Yixiao,0,20,70,70
1683337072942,ECON 144,A00,203346,Squires; Dale E,3,0,35,32
1683337073972,ECON 171,A01,203349,Newhouse; Herbert S,0,1,35,35
1683337075001,ECON 173A,A01,185621,Toda; Alexis Akira,21,0,35,14
1683337076034,EDS 25,A01,202413,Staff,0,1,0,0
1683337076034,EDS 25,A02,202414,Staff,0,1,0,0
1683337076034,EDS 25,A03,202415,Staff,0,0,0,0
1683337076034,EDS 25,A04,202416,Staff,0,1,0,0
1683337076034,EDS 25,A05,202439,Staff,0,0,0,0
1683337076034,EDS 25,A06,202440,Staff,0,0,0,0
1683337076034,EDS 25,B01,202631,Staff,0,0,0,0
1683337076034,EDS 25,B02,202632,Staff,0,0,0,0
1683337076034,EDS 25,B03,202639,Staff,0,0,0,0
1683337076034,EDS 25,B04,202640,Staff,0,0,0,0
1683337076034,EDS 25,B05,202643,Staff,0,0,0,0
1683337076034,EDS 25,B06,202644,Staff,0,0,0,0
1683337077062,EDS 38,A01,202659,Black; Alison Michelle,24,0,25,1
1683337078090,EDS 115,A00,202652,Staff,18,0,30,12
1683337079119,EDS 125,A00,202649,Staff,14,0,30,16
1683337080144,EDS 126,A01,203332,Staff,30,0,30,0
1683337081172,EDS 139,A00,202838,Staff,16,0,25,9
1683337082204,EDS 146,A01,202655,Staff,14,0,25,11
1683337083235,ENG 15,A00,185667,Staff,0,1,0,0
1683337083235,ENG 15,B00,185672,Staff,0,0,0,0
1683337083235,ENG 15,C00,185675,Staff,0,0,0,0
1683337083235,ENG 15,D00,185682,Staff,0,0,0,0
1683337083235,ENG 15,E00,185684,Staff,0,0,0,0
1683337084263,ETHN 103,A00,185710,Staff,0,3,35,35
1683337085291,ETHN 103A,A00,199228,Man; Simeon S,2,0,9,7
1683337086319,ETHN 109,A00,185711,Staff,18,0,35,17
1683337087346,ETHN 142,A00,185726,Staff,0,4,30,30
1683337088373,ETHN 163J,A00,199229,Man; Simeon S,5,0,8,3
1683337089404,ETHN 168,A00,185727,Staff,8,0,10,2
1683337090430,ETHN 182,A00,185728,Staff,1,0,35,34
1683337091462,ETHN 183,A00,185737,Staff,8,0,18,10
1683337092490,GLBH 111,A01,209361,Burgos; Jose L.,0,0,0,0
1683337094548,HIEU 104,A00,185792,Staff,16,0,20,4
1683337095574,HIEU 115,A00,185800,Staff,1,0,20,19
1683337096602,HIEU 128,A00,185801,Staff,0,7,20,20
1683337097630,HIEU 147,A00,185802,Staff,16,0,20,4
1683337098657,HIEU 154,A00,185823,Staff,12,0,20,8
1683337099687,HILA 102,A00,185826,Staff,13,0,20,7
1683337100714,HILD 2C,A01,185778,Staff,0,12,20,20
1683337101741,HILD 7B,A01,185780,Kwak; Nancy,0,15,32,32
1683337101741,HILD 7B,A02,185781,Kwak; Nancy,0,18,32,32
1683337102770,HILD 30,A01,185791,Staff,14,0,20,6
1683337103796,HISC 119,A00,185830,Golan; Tal,0,9,20,20
1683337104825,HITO 156GS,A00,185831,Patterson; Patrick H.,0,0,0,23
1683337105854,HIUS 103,A00,185832,Man; Simeon S,0,6,20,20
1683337106882,HIUS 117,A00,185836,Kwak; Nancy,2,0,20,18
1683337107913,HIUS 125,A00,185840,Man; Simeon S,0,0,23,23
1683337108943,HIUS 149,A00,185845,Staff,0,0,20,20
1683337109970,HUM 3,A01,185882,Zavodny; Tatiana Sophia,0,7,50,50
1683337109970,HUM 3,B01,185899,Caldwell; Michael Alan,0,18,50,50
1683337111004,HUM 3GS,A00,185900,Patterson; Patrick H.,0,0,0,23
1683337112034,HUM 4,A01,185938,Zroka; Amy Liane,31,0,50,19
1683337112034,HUM 4,B01,185956,Watkins; Eric,0,2,50,50
1683337112034,HUM 4,B02,202209,Watkins; Eric,0,2,50,50
1683337112034,HUM 4,B03,202210,Watkins; Eric,0,2,50,50
1683337113061,HUM 5,A01,185958,West; Geoffrey Scott,3,0,50,47
1683337113061,HUM 5,A02,202215,West; Geoffrey Scott,0,0,50,50
1683337114088,INTL 190,A00,185959,Gagnon; Jeffrey C,0,0,0,9
1683337114088,INTL 190,B00,185960,Lettieri; Michael Joseph,0,0,0,1
1683337115116,JAPN 180,A00,254509,Staff,5,1,30,25
1683337116144,LATI 10,A01,202853,Kennemore; Amy Michelle,4,0,35,31
1683337116144,LATI 10,A02,202854,Kennemore; Amy Michelle,2,0,35,33
1683337116144,LATI 10,A03,270054,Kennemore; Amy Michelle,30,0,30,0
1683337117172,LATI 180,A00,202855,Kennemore; Amy Michelle,11,0,20,9
1683337118198,LAWS 101,A00,201767,Golan; Tal,0,7,40,40
1683337119222,LIFR 1C,A00,185961,Staff,6,0,20,14
1683337120251,LIFR 1CX,A00,185962,Staff,7,0,20,13
1683337121277,LIFR 1D,A00,185963,Staff,9,0,20,11
1683337122304,LIFR 1DX,A00,185964,Staff,9,0,20,11
1683337123334,LIGN 101,A01,186039,Staff,43,0,50,7
1683337124364,LIGN 165,A00,186040,Staff,18,0,50,32
1683337125391,LTCS 108,A00,186041,Staff,6,0,10,4
1683337126419,LTCS 119,A00,186042,Staff,16,0,20,4
1683337127442,LTCS 130,A00,186043,Wesling; Megan E.,15,0,25,10
1683337129503,LTEA 138,A00,186119,Staff,14,0,40,26
1683337130533,LTEN 124,A00,186148,Staff,6,0,25,19
1683337131559,LTEN 178,A00,186149,Staff,7,0,15,8
1683337132590,LTEN 181,A00,186150,Blanco; John D,33,0,40,7
1683337133619,LTWL 120,A00,186160,Staff,20,0,25,5
1683337134646,LTWL 165,A00,186161,Staff,22,0,25,3
1683337135675,LTWR 100,A00,186162,Staff,0,5,15,15
1683337136702,LTWR 102,A00,186163,Doller; Ben,5,0,15,10
1683337137726,MAE 8,A01,186412,Staff,0,0,0,0
1683337138757,MAE 30B,A00,186445,Bahadori; Mohammad Yousef,83,0,100,17
1683337139791,MAE 40,A00,186592,Bewley; Thomas R,9,0,50,41
1683337140818,MAE 101B,A00,186593,Bahadori; Mohammad Yousef,81,0,100,19
1683337141848,MAE 105,A00,186594,Bandaru; Prabhakar,12,0,50,38
1683337142873,MAE 107,A00,186599,Pham; Hieu Tan,0,6,120,120
1683337143903,MAE 148,A01,186660,Silberman; Jack,3,0,16,13
1683337144930,MATH 10A,A01,188095,Staff,1,6,35,34
1683337145959,MATH 10B,A01,188097,Bowers; Adam R.,0,11,30,30
1683337145959,MATH 10B,A02,188099,Bowers; Adam R.,0,11,30,30
1683337145959,MATH 10B,B01,188104,Bowers; Adam R.,0,10,30,30
1683337145959,MATH 10B,B02,188106,Bowers; Adam R.,0,10,30,30
1683337146990,MATH 10C,A01,188111,Staff,0,18,30,30
1683337146990,MATH 10C,A02,188127,Staff,0,17,30,30
1683337146990,MATH 10C,A03,188131,Staff,0,18,30,30
1683337146990,MATH 10C,B01,188218,Staff,18,0,30,12
1683337146990,MATH 10C,B02,188244,Staff,13,0,30,17
1683337146990,MATH 10C,B03,188277,Staff,16,0,30,14
1683337148017,MATH 18,A01,188344,Bach; Quang Tran,18,0,30,12
1683337148017,MATH 18,A02,188345,Bach; Quang Tran,11,0,30,19
1683337148017,MATH 18,B01,188353,Bach; Quang Tran,10,0,30,20
1683337148017,MATH 18,B02,188354,Bach; Quang Tran,20,0,30,10
1683337149058,MATH 20A,A01,188374,Staff,13,0,35,22
1683337150086,MATH 20B,A01,188382,Ohm; Ko Woon,6,0,30,24
1683337150086,MATH 20B,A02,188383,Ohm; Ko Woon,22,0,30,8
1683337150086,MATH 20B,B01,188385,Ohm; Ko Woon,7,0,30,23
1683337150086,MATH 20B,B02,188392,Ohm; Ko Woon,22,0,30,8
1683337151114,MATH 20C,A01,188394,Harel; Guershon,10,0,30,20
1683337151114,MATH 20C,A02,188395,Harel; Guershon,15,0,30,15
1683337151114,MATH 20C,B01,188404,Harel; Guershon,5,0,30,25
1683337151114,MATH 20C,B02,188405,Harel; Guershon,19,0,30,11
1683337152140,MATH 20D,A01,188414,Hammock; Frances H,0,1,30,30
1683337152140,MATH 20D,A02,188415,Hammock; Frances H,3,0,30,27
1683337152140,MATH 20D,B01,188447,Hammock; Frances H,1,0,30,29
1683337152140,MATH 20D,B02,188486,Hammock; Frances H,8,0,30,22
1683337153170,MATH 20E,A01,188649,Staff,21,0,30,9
1683337153170,MATH 20E,A02,188650,Staff,23,0,30,7
1683337153170,MATH 20E,A03,188673,Staff,0,0,30,30
1683337154196,MATH 102,A01,188675,Staff,0,35,35,35
1683337155224,MATH 103B,A01,188681,Staff,3,0,35,32
1683337155224,MATH 103B,B01,188692,Staff,5,0,35,30
1683337156249,MATH 109,A01,188695,Salehi Golsefidy; Alireza,25,0,35,10
1683337156249,MATH 109,A02,188696,Salehi Golsefidy; Alireza,25,0,35,10
1683337157277,MATH 120A,A01,188698,Eggers; John Dietrich,7,0,35,28
1683337158305,MATH 142B,A01,188736,Ioana; Adrian,0,2,30,30
1683337158305,MATH 142B,A02,188741,Ioana; Adrian,1,1,30,29
1683337158305,MATH 142B,A03,188743,Ioana; Adrian,1,3,30,29
1683337159331,MATH 168A,A01,188790,Staff,0,9,35,35
1683337160362,MATH 170A,A01,188803,Nie; Jiawang,0,2,35,35
1683337160362,MATH 170A,A02,188811,Nie; Jiawang,0,0,35,35
1683337160362,MATH 170A,A03,188814,Nie; Jiawang,1,0,35,34
1683337160362,MATH 170A,A04,188815,Nie; Jiawang,13,0,35,22
1683337161391,MATH 193B,A01,188817,Staff,0,0,35,35
1683337161391,MATH 193B,A02,188818,Staff,5,0,35,30
1683337162420,MGT 4,A01,202857,Anderson; John Charles,62,0,80,18
1683337163447,MGT 12,A00,202858,Lindenberger; Wade Douglas,42,0,90,48
1683337164473,MGT 18,A00,202859,Staff,74,0,90,16
1683337165502,MGT 18GS,A00,202860,McKay; Michael J,13,0,28,15
1683337166529,MGT 45,A00,202861,Pecore; Joseph P.,14,0,90,76
1683337167611,MGT 100,A00,202863,Yavorsky; Daniel Ryan,28,0,90,62
1683337168641,MGT 103,A00,202864,Ehrich; Kristine R,1,18,90,89
1683337169671,MGT 112,A00,202865,Ehrich; Kristine R,15,0,90,75
1683337170698,MGT 121A,A00,202868,Staff,0,20,0,0
1683337171724,MGT 131B,A00,202869,Anderson; John Charles,59,0,90,31
1683337172750,MGT 136,A00,202871,Lindenberger; Wade Douglas,84,0,90,6
1683337173781,MGT 164,A00,202873,Staff,0,68,90,91
1683337174807,MGT 164GS,A00,202874,McKay; Mary A,13,0,28,15
1683337175833,MGT 180,A00,202875,Staff,0,50,90,91
1683337176862,MMW 11R,A01,205019,Herbst; Matthew,3,0,30,27
1683337176862,MMW 11R,A02,205026,Herbst; Matthew,29,0,30,1
1683337177890,MMW 15,A01,193512,Chang; Edmond Yi-Teh,0,9,28,28
1683337177890,MMW 15,A02,193513,Chang; Edmond Yi-Teh,0,5,28,28
1683337177890,MMW 15,A03,193514,Chang; Edmond Yi-Teh,0,5,28,28
1683337177890,MMW 15,A04,193515,Chang; Edmond Yi-Teh,0,5,28,28
1683337177890,MMW 15,A05,193516,Chang; Edmond Yi-Teh,0,4,28,28
1683337177890,MMW 15,A06,193517,Chang; Edmond Yi-Teh,0,5,28,28
1683337177890,MMW 15,B01,193519,Chang; Edmond Yi-Teh,0,5,28,28
1683337177890,MMW 15,B02,193520,Chang; Edmond Yi-Teh,0,5,28,28
1683337177890,MMW 15,B03,193521,Chang; Edmond Yi-Teh,0,5,28,28
1683337177890,MMW 15,B04,193522,Chang; Edmond Yi-Teh,0,4,28,28
1683337177890,MMW 15,B05,193523,Chang; Edmond Yi-Teh,0,5,28,28
1683337177890,MMW 15,B06,193524,Chang; Edmond Yi-Teh,0,4,28,28
1683337178920,MMW 122,A01,193526,Rahimi; Babak,0,15,28,28
1683337178920,MMW 122,A02,193527,Rahimi; Babak,0,14,28,28
1683337178920,MMW 122,A03,193528,Rahimi; Babak,0,0,0,0
1683337178920,MMW 122,A04,193529,Rahimi; Babak,0,0,0,0
1683337179950,MUS 1A,A01,186663,Staff,0,20,35,35
1683337180979,MUS 4,A01,186715,Staff,0,12,35,35
1683337182008,MUS 5R,A01,186796,Dubnov; Shlomo,0,17,35,35
1683337183038,MUS 6,A01,186798,Staff,0,4,25,25
1683337184064,MUS 7,A01,186830,Staff,13,0,35,22
1683337185090,MUS 8,A01,186930,Staff,0,26,35,35
1683337186118,MUS 15,A01,186932,Staff,0,16,35,35
1683337186118,MUS 15,B01,186934,Staff,0,15,35,35
1683337187145,MUS 80,A00,186935,Staff,1,0,20,19
1683337187145,MUS 80,B00,186936,Staff,25,0,25,0
1683337188172,NANO 11,A00,204702,Lipomi; Darren John,0,0,0,0
1683337189199,NANO 15,A01,204709,Yang; Kesong,0,1,0,0
1683337190226,NANO 114,A00,202069,Jahed Motlagh; Zeinab,3,0,10,7
1683337191252,PHIL 1,A00,186955,Grush; Rick Scott,32,0,40,8
1683337192280,PHIL 10,A01,186973,Grush; Rick Scott,28,0,35,7
1683337192280,PHIL 10,A02,186974,Grush; Rick Scott,33,0,35,2
1683337193312,PHIL 13,A01,186976,Staff,7,0,35,28
1683337193312,PHIL 13,A02,186977,Staff,16,0,35,19
1683337194341,PHIL 14,A01,186979,Staff,31,0,35,4
1683337194341,PHIL 14,A02,186986,Staff,32,0,35,3
1683337195368,PHIL 28,A01,186988,Staff,16,0,30,14
1683337195368,PHIL 28,A02,186989,Staff,1,0,30,29
1683337195368,PHIL 28,A03,186990,Staff,9,0,30,21
1683337195368,PHIL 28,A04,186991,Staff,26,0,30,4
1683337196395,PHIL 120,A00,186997,Staff,23,0,40,17
1683337197422,PHIL 137,A00,187003,Staff,9,0,40,31
1683337198448,PHIL 150,A00,187015,Staff,47,0,70,23
1683337199478,PHIL 167,A00,187021,Lamey; Andy M.,35,0,40,5
1683337200505,PHIL 174,A01,202226,Staff,17,0,20,3
1683337200505,PHIL 174,A02,202235,Staff,20,0,20,0
1683337201530,PHIL 191A,A00,258918,Staff,0,0,1,1
1683337202556,PHYS 1A,A00,187028,Staff,27,0,60,33
1683337203583,PHYS 1AL,001,187036,Staff,2,0,30,28
1683337203583,PHYS 1AL,002,187049,Staff,18,0,30,12
1683337204611,PHYS 1B,A00,187058,Staff,22,0,60,38
1683337205637,PHYS 1BL,001,187064,Staff,0,0,30,30
1683337205637,PHYS 1BL,002,187070,Staff,5,0,30,25
1683337206663,PHYS 1C,A00,187082,Staff,31,0,120,89
1683337207695,PHYS 1CL,001,187088,Staff,0,9,30,30
1683337207695,PHYS 1CL,002,187089,Staff,0,2,30,30
1683337207695,PHYS 1CL,009,262693,Staff,11,0,30,19
1683337208724,PHYS 2B,A01,187097,Staff,54,0,115,61
1683337209749,PHYS 2C,A01,187099,Staff,67,0,115,48
1683337210780,PHYS 2CL,A01,187101,Staff,5,0,28,23
1683337210780,PHYS 2CL,A02,187102,Staff,15,0,28,13
1683337211806,PHYS 2D,A01,187123,Shotwell; Brian,95,0,115,20
1683337212832,PHYS 4B,A01,187133,Grinstein; Benjamin,35,0,50,15
1683337213862,POLI 10,A00,188819,Staff,0,4,50,50
1683337214891,POLI 11,A00,188827,Staff,43,0,50,7
1683337215918,POLI 13R,A00,188828,Staff,0,1,20,20
1683337216944,POLI 27,A01,188830,Elgin; Samuel Zincke,0,1,70,70
1683337217974,POLI 30,A00,188832,Desposato; Scott,31,0,50,19
1683337219003,POLI 102F,A00,188834,Staff,3,0,40,37
1683337220033,POLI 104A,A00,188852,Staff,14,0,30,16
1683337221064,POLI 104I,A00,188853,Staff,0,6,20,20
1683337222094,POLI 110B,A00,188854,Wiens; David,7,0,20,13
1683337223120,POLI 112A,A00,188855,Wiens; David,5,0,30,25
1683337224146,POLI 117R,A00,188856,Forman; Fonna,0,11,20,20
1683337225172,POLI 118,A00,188857,Ingham; Sean,8,0,20,12
1683337226200,POLI 120G,A00,188858,Staff,9,0,30,21
1683337227232,POLI 131CR,A00,188863,Hoston; Germaine,24,0,50,26
1683337228259,POLI 133,A00,188864,Nellis; Gareth Hb,44,0,50,6
1683337229290,POLI 134D,A00,188865,Desposato; Scott,27,0,30,3
1683337230322,POLI 142A,A00,188871,Gartzke; Erik,22,0,50,28
1683337231353,POLI 142K,A00,188874,Staff,38,0,50,12
1683337232384,POLI 143,A00,188940,Gartzke; Erik,16,0,30,14
1683337233411,POLI 153,A00,188943,Staff,3,0,20,17
1683337234436,POLI 160AA,A00,188944,Staff,12,0,40,28
1683337235460,POLI 170A,A00,188945,Staff,11,0,30,19
1683337237511,PSYC 1,A00,188952,Staff,37,0,90,53
1683337238541,PSYC 2,B00,188953,Staff,19,0,35,16
1683337239574,PSYC 6,A00,188970,Staff,47,0,60,13
1683337240604,PSYC 7,A00,188973,Staff,37,0,45,8
1683337241631,PSYC 60,A01,188980,Rickard; Timothy C.,43,0,60,17
1683337242661,PSYC 70,A01,189001,Steiner; Eric Tomas,24,0,45,21
1683337243688,PSYC 100,A00,189005,Lacefield; Katharine I,0,99,120,120
1683337244758,PSYC 102,A00,189008,Staff,9,0,30,21
1683337245784,PSYC 106,B00,189026,Gorman; Michael R.,34,0,60,26
1683337246811,PSYC 114,B01,189033,Winkielman; Piotr,0,32,30,30
1683337247841,PSYC 131,A00,189036,Anagnostaras; Stephan,0,43,60,60
1683337248871,PSYC 136,A00,189041,Lowe; Angela Beth,0,7,25,25
1683337249898,PSYC 137,A00,189057,Winkielman; Piotr,0,34,25,25
1683337250925,PSYC 144,A00,189107,Wixted; John T,0,7,50,50
1683337252975,PSYC 162,A00,189142,Staff,0,8,85,85
1683337254000,PSYC 172,A00,189144,Gorman; Michael R.,0,7,30,30
1683337256058,PSYC 179,A00,189146,Lacefield; Katharine I,0,84,120,120
1683337257084,PSYC 181,A00,189147,Anagnostaras; Stephan,0,44,90,90
1683337258114,PSYC 190R,A00,189148,Barner; David A.,0,22,80,80
1683337259142,PSYC 191,A00,189275,Rickard; Timothy C.,0,7,25,25
1683337260168,PSYC 193,A00,189276,Chapman; Eddie Nathaniel,0,1,0,4
1683337261199,PSYC 193L,A01,189281,Lowe; Angela Beth,12,0,20,8
1683337261199,PSYC 193L,B01,189285,Staff,28,0,35,7
1683337262226,RELI 149,A00,187137,Rahimi; Babak,7,0,40,33
1683337263255,SE 9,A01,187315,Staff,0,2,18,18
1683337264286,SE 101B,A00,187409,Staff,24,0,30,6
1683337265313,SE 110B,A00,187444,Staff,10,0,40,30
1683337266344,SE 130B,A00,187449,Staff,31,0,40,9
1683337267372,SE 150A,A00,187516,Staff,9,0,20,11
1683337268399,SE 154,A00,187528,Staff,30,0,50,20
1683337269426,SIO 3,A01,258171,Staff,35,0,40,5
1683337270457,SIO 10,A00,187144,Cook; Geoffrey W,0,3,75,75
1683337271541,SIO 45,A00,187152,Cook; Geoffrey W,1,0,100,99
1683337272566,SIO 109R,A00,194486,Staff,0,3,20,20
1683337274620,SIO 187,A01,187233,Kacev; David,12,0,40,28
1683337275651,SOCI 1,A01,258656,Thorpe; Charles Robert,28,0,30,2
1683337275651,SOCI 1,A02,258658,Thorpe; Charles Robert,30,0,30,0
1683337275651,SOCI 1,A03,258661,Thorpe; Charles Robert,25,0,25,0
1683337275651,SOCI 1,A04,258666,Thorpe; Charles Robert,22,0,25,3
1683337275651,SOCI 1,A05,258897,Thorpe; Charles Robert,23,0,25,2
1683337275651,SOCI 1,A06,258898,Thorpe; Charles Robert,25,0,25,0
1683337276676,SOCI 30,A01,258903,Pardo Guerra; Juan Pablo,15,0,30,15
1683337277706,SOCI 102,A00,258904,Staff,9,0,25,16
1683337278733,SOCI 106,A00,258905,Staff,19,0,25,6
1683337279760,SOCI 111,A00,258907,Ribas Norris; Janet Vanesa,26,0,30,4
1683337280784,SOCI 121R,A00,258908,Pardo Guerra; Juan Pablo,10,0,30,20
1683337281811,SOCI 126,A01,203330,Staff,14,0,20,6
1683337282838,SOCI 131,A00,258909,Thorpe; Charles Robert,31,0,60,29
1683337283865,SOCI 135,A00,258910,Payne; Christine Anna,0,9,30,30
1683337284896,SOCI 157,A00,258911,Staff,12,0,30,18
1683337285927,SOCI 184,A00,258912,Staff,25,0,30,5
1683337286953,SOCI 188D,A00,258913,Staff,21,0,30,9
1683337287980,SYN 2,001,187529,Staff,10,0,16,6
1683337287980,SYN 2,002,201452,Staff,0,18,16,16
1683337287980,SYN 2,003,201469,Staff,3,0,16,13
1683337289010,SYN 100,A01,187531,Staff,0,9,20,20
1683337289010,SYN 100,B01,201491,Staff,0,12,20,20
1683337290041,TDAC 1,A00,189286,Walsh; Kim C.,3,0,20,17
1683337290041,TDAC 1,B00,189287,Harting; Carla Kelso,11,0,20,9
1683337291071,TDAC 101,A00,189300,Walsh; Kim C.,16,0,20,4
1683337291071,TDAC 101,B00,189301,Harting; Carla Kelso,18,0,20,2
1683337292103,TDAC 102,A00,189304,Basso; Beatrice,14,0,20,6
1683337293131,TDAC 108,A00,189305,Staff,18,0,20,2
1683337294160,TDDE 131,A00,189310,Staff,19,0,20,1
1683337294160,TDDE 131,B00,189314,Staff,19,0,20,1
1683337294160,TDDE 131,C00,189315,Staff,48,0,50,2
1683337294160,TDDE 131,D00,189316,Staff,14,0,15,1
1683337294160,TDDE 131,E00,204841,Staff,20,0,20,0
1683337295190,TDGE 10,A00,189289,Staff,30,0,50,20
1683337295190,TDGE 10,B00,189290,Havis; Allan,1,0,50,49
1683337296221,TDGE 11,A00,189291,Fulton; Julia,0,3,50,50
1683337296221,TDGE 11,B00,189292,Staff,20,0,25,5
1683337296221,TDGE 11,C00,260270,Staff,0,0,0,0
1683337297246,TDGE 25,A00,189294,Staff,3,0,20,17
1683337298272,TDGE 124,A00,189318,Fulton; Julia,0,8,50,50
1683337299299,TDGE 125,A00,189319,Staff,13,0,25,12
1683337299299,TDGE 125,B00,189320,Staff,23,0,25,2
1683337300328,TDGE 127,A00,189322,Havis; Allan,0,0,50,50
1683337301357,TDHT 101,A00,189323,Staff,18,0,25,7
1683337301357,TDHT 101,B00,189324,Staff,25,0,25,0
1683337302381,TDHT 102,A00,189325,Staff,49,0,50,1
1683337303406,TDMV 1,A00,189295,Arcidiacono; Kristin,19,0,30,11
1683337303406,TDMV 1,B00,189296,Caligagan; Maria T.,24,0,30,6
1683337304436,TDMV 2,A00,189297,Sammartano; Tonnie,28,0,30,2
1683337304436,TDMV 2,B00,189299,Arcidiacono; Kristin,24,0,30,6
1683337305466,TDMV 3,A00,204998,Rincon; Alicia,22,0,30,8
1683337306496,TDMV 120,A00,189458,Sammartano; Tonnie,28,0,30,2
1683337307522,TDMV 138,A00,189541,Jun; Grace Shin Hae,22,0,40,18
1683337308551,TDMV 142,A00,189717,Caligagan; Tony,23,0,30,7
1683337308551,TDMV 142,B00,189718,Caligagan; Maria T.,25,0,30,5
1683337309579,TMC 2,A01,187533,Staff,25,0,25,0
1683337309579,TMC 2,A02,187534,Staff,25,0,25,0
1683337310606,USP 1,A01,187536,Kwak; Nancy,0,16,25,25
1683337311631,USP 5,A01,187538,Staff,10,0,25,15
1683337312657,USP 101,A00,199253,Staff,0,4,0,0
1683337313682,USP 124,A00,187562,Boomhower; Matthew Charles,1,0,30,29
1683337314708,USP 138,A00,187582,Staff,20,0,25,5
1683337315738,USP 152,A01,187597,Staff,4,0,25,21
1683337327971,USP 153,A00,187598,Staff,19,0,25,6
1683337328998,USP 168,A00,187607,Kwak; Nancy,2,0,5,3
1683337330025,USP 173,A00,187619,Staff,4,0,25,21
1683337331062,USP 181,A00,187638,Staff,0,0,25,25
1683337332085,VIS 103,A00,187650,Cruz; Edwin Teddy,23,0,75,52
1683337333110,VIS 110D,A00,187669,Staff,12,0,22,10
1683337334137,VIS 127C,A00,187720,Shen; Kuiyi,67,0,146,79
1683337335161,VIS 149,A00,187731,Yoldas; Pinar,0,14,22,22
1683337336189,VIS 151,A01,188091,Staff,22,0,34,12
1683337336189,VIS 151,A02,188092,Staff,11,0,34,23
1683337337214,VIS 160B,A00,188093,Stalbaum; Brett,0,0,10,10
1683337351047,WCWP 10B,A00,201720,Staff,10,0,15,5
1683337351047,WCWP 10B,B00,201722,Staff,9,0,15,6
1683337352076,WCWP 100,A00,201725,Gagnon; Jeffrey C,0,0,2,2
1683337352076,WCWP 100,B00,201727,Staff,0,4,15,15
1683337355194,ANBI 133,A00,258401,Wilder; Linnea Lorene,34,0,40,6
1683337356222,ANBI 140,A00,258395,Hrvoj Mihic; Branka,18,0,25,7
1683337357248,ANSC 120,A00,258402,Bialecki; Jon Anthony,27,0,40,13
1683337358276,ANSC 144,A00,258400,Staff,14,0,40,26
1683337362514,ANSC 166,A00,258396,Parish; Steven Martin,157,0,175,18
1683337363545,ANSC 180,A00,193533,Staff,9,0,20,11
1683337364569,ANSC 188,A00,258397,Jassal; Aftab,33,0,40,7
1683337365598,ANTH 3,A01,258316,Staff,23,0,30,7
1683337366625,ANTH 5,A00,258394,Semendeferi; Ekaterini,16,0,20,4
1683337367651,ANTH 21,A01,258331,Staff,8,0,40,32
1683337368789,ANTH 103,A00,258398,Varma; Saiba,15,0,25,10
1683337369826,AWP 10,001,202034,Staff,0,0,0,0
1683337369826,AWP 10,002,202035,Staff,0,0,0,0
1683337369826,AWP 10,003,202036,Staff,0,0,0,0
1683337369826,AWP 10,004,202037,Staff,0,0,0,0
1683337369826,AWP 10,005,202038,Staff,0,0,0,0
1683337369826,AWP 10,006,202039,Staff,0,0,0,0
1683337369826,AWP 10,007,202040,Staff,0,0,0,0
1683337369826,AWP 10,008,202041,Staff,0,0,0,0
1683337369826,AWP 10,009,202042,Staff,0,0,0,0
1683337369826,AWP 10,010,202043,Staff,0,0,0,0
1683337369826,AWP 10,011,202044,Staff,0,0,0,0
1683337369826,AWP 10,012,202045,Staff,0,0,0,0
1683337369826,AWP 10,013,202046,Staff,0,0,0,0
1683337369826,AWP 10,014,202047,Staff,0,0,0,0
1683337369826,AWP 10,015,202048,Staff,0,0,0,0
1683337369826,AWP 10,016,202049,Staff,0,0,0,0
1683337369826,AWP 10,017,202050,Staff,0,0,0,0
1683337369826,AWP 10,018,202051,Staff,0,0,0,0
1683337369826,AWP 10,019,202052,Staff,0,0,0,0
1683337369826,AWP 10,020,202053,Staff,0,0,0,0
1683337369826,AWP 10,021,202054,Staff,0,0,0,0
1683337369826,AWP 10,022,202055,Staff,0,0,0,0
1683337369826,AWP 10,023,202056,Staff,0,0,0,0
1683337369826,AWP 10,024,202057,Staff,0,0,0,0
1683337369826,AWP 10,025,202058,Staff,0,0,0,0
1683337369826,AWP 10,026,202059,Staff,0,0,0,0
1683337370853,AWP 102,001,202032,Staff,0,0,0,0
1683337370853,AWP 102,002,202033,Staff,0,0,0,0
1683337371880,BENG 100,A01,254234,Taylor Amos; Alyssa C,31,0,40,9
1683337372905,BENG 196,001,270013,Engler; Adam J.,9999,0,9999,0
1683337373933,BICD 100R,A01,202018,Smith; Laurie,0,7,32,32
1683337373933,BICD 100R,A02,202019,Smith; Laurie,0,2,32,32
1683337373933,BICD 100R,A03,202020,Smith; Laurie,0,1,32,32
1683337373933,BICD 100R,A04,202021,Smith; Laurie,9,0,32,23
1683337373933,BICD 100R,A05,202022,Smith; Laurie,12,0,32,20
1683337374964,BICD 136,A01,193242,Gustafson-Brown; Cindy,0,2,32,32
1683337374964,BICD 136,A02,193244,Gustafson-Brown; Cindy,14,0,32,18
1683337375992,BIEB 102,A01,193249,Butler; Shannon Rhey,0,2,32,32
1683337375992,BIEB 102,A02,193251,Butler; Shannon Rhey,0,0,32,32
1683337375992,BIEB 102,A03,193253,Butler; Shannon Rhey,0,1,32,32
1683337375992,BIEB 102,A04,193255,Butler; Shannon Rhey,17,0,32,15
1683337375992,BIEB 102,A05,193265,Butler; Shannon Rhey,26,0,32,6
1683337375992,BIEB 102,A06,193269,Butler; Shannon Rhey,16,0,32,16
1683337378046,BIEB 150,A01,193274,Staff,0,0,32,32
1683337378046,BIEB 150,A02,193285,Staff,23,0,32,9
1683337379076,BIEB 194,A00,193286,Kurle; Carolyn M.,22,0,32,10
1683337380107,BILD 1,A01,192291,Staff,16,0,32,16
1683337380107,BILD 1,A02,192292,Staff,30,0,32,2
1683337380107,BILD 1,B01,192520,Reuther; Keefe,0,1,0,0
1683337380107,BILD 1,B02,192532,Reuther; Keefe,0,1,0,0
1683337381133,BILD 3,A01,192556,Butler; Shannon Rhey,0,0,32,32
1683337381133,BILD 3,A02,192581,Butler; Shannon Rhey,5,0,32,27
1683337381133,BILD 3,A03,192611,Butler; Shannon Rhey,23,0,32,9
1683337381133,BILD 3,A04,192612,Butler; Shannon Rhey,25,0,32,7
1683337381133,BILD 3,A05,192613,Butler; Shannon Rhey,27,0,32,5
1683337381133,BILD 3,A06,192679,Butler; Shannon Rhey,27,0,32,5
1683337381133,BILD 3,A07,192682,Butler; Shannon Rhey,22,0,32,10
1683337382162,BILD 4,A01,192836,Reuther; Keefe,0,0,24,24
1683337382162,BILD 4,A02,193044,Reuther; Keefe,4,0,24,20
1683337383192,BILD 10,A01,193142,Gustafson-Brown; Cindy,30,0,32,2
1683337383192,BILD 10,A02,193149,Gustafson-Brown; Cindy,31,0,32,1
1683337384223,BIMM 100,A01,193301,Staff,0,6,32,32
1683337384223,BIMM 100,A02,193312,Staff,0,5,32,32
1683337384223,BIMM 100,A03,193323,Staff,0,8,32,32
1683337385253,BIMM 101,A01,193329,McDonnell; Lisa Marie,0,3,24,24
1683337385253,BIMM 101,A02,193339,McDonnell; Lisa Marie,0,3,24,24
1683337385253,BIMM 101,B01,193354,McDonnell; Lisa Marie,0,3,24,24
1683337385253,BIMM 101,B02,193357,McDonnell; Lisa Marie,0,3,24,24
1683337386283,BIMM 110,A01,193377,Tat; John,0,11,32,32
1683337386283,BIMM 110,A02,193378,Tat; John,1,9,32,31
1683337387313,BIMM 120,A01,206116,Staff,0,0,32,32
1683337387313,BIMM 120,A02,206117,Staff,8,0,32,24
1683337387313,BIMM 120,A03,206121,Staff,21,0,32,11
1683337388346,BIPN 100,A01,193393,Park; Ji Young,0,14,32,32
1683337388346,BIPN 100,A02,193402,Park; Ji Young,0,13,32,32
1683337388346,BIPN 100,A03,193413,Park; Ji Young,0,14,32,32
1683337388346,BIPN 100,A04,193414,Park; Ji Young,0,13,32,32
1683337389373,BIPN 102,A01,193429,Staff,0,0,32,32
1683337389373,BIPN 102,A02,193438,Staff,22,0,32,10
1683337390399,BIPN 106,A01,193450,Reyes Gonzalez; Catalina,0,2,40,40
1683337391427,BIPN 134,A01,193465,Cooke; James Edward,0,0,32,32
1683337391427,BIPN 134,A02,193474,Cooke; James Edward,25,0,32,7
1683337391427,BIPN 134,A03,193485,Cooke; James Edward,29,0,32,3
1683337391427,BIPN 134,A04,193486,Cooke; James Edward,21,0,32,11
1683337391427,BIPN 134,A05,193491,Cooke; James Edward,31,0,32,1
1683337391427,BIPN 134,A06,193501,Cooke; James Edward,30,0,32,2
1683337391427,BIPN 134,A07,193510,Cooke; James Edward,29,0,32,3
1683337393480,BISP 194,A00,222522,Staff,14,0,32,18
1683337394505,CAT 124,A01,202407,Staff,20,0,25,5
1683337395533,CAT 125,A00,202408,Marchisotto; Jennifer Anne,4,0,20,16
1683337396560,CAT 125R,A00,202409,Smith; Lauryn Alissa,0,11,20,20
1683337396560,CAT 125R,B00,202410,Morales; Celeste Georgianna,0,11,20,20
1683337396560,CAT 125R,C00,202411,Irwin; Matthew Joseph,0,10,20,20
1683337397590,CENG 15,A01,204712,Yang; Kesong,0,1,0,0
1683337398616,CENG 114,A00,202070,Jahed Motlagh; Zeinab,5,0,20,15
1683337399643,CGS 105,A00,185477,Wesling; Megan E.,24,0,40,16
1683337400723,CGS 106,A00,185494,Staff,13,0,22,9
1683337401750,CGS 108,A00,185495,Staff,14,0,20,6
1683337402776,CGS 114,A00,185496,Staff,13,0,18,5
1683337403805,CGS 119,A00,185501,Staff,15,0,20,5
1683337404833,CGS 120,A00,185511,Staff,13,0,20,7
1683337405859,CHEM 4,A01,184675,Bussey; Thomas J,96,0,100,4
1683337406885,CHEM 6A,A01,184677,Staff,34,0,60,26
1683337407912,CHEM 6B,A01,184679,Staff,65,0,100,35
1683337408942,CHEM 6C,A01,184681,Bussey; Thomas J,1,0,50,49
1683337408942,CHEM 6C,A02,184682,Bussey; Thomas J,34,0,50,16
1683337409969,CHEM 40A,A01,184684,Albizati; Kim F.,37,0,100,63
1683337410995,CHEM 40B,A01,184686,Albizati; Kim F.,0,20,100,100
1683337412022,CHEM 41B,A01,184690,Staff,52,0,100,48
1683337413048,COGS 3,A01,184715,Boyle; Mary E. T.,0,25,40,40
1683337414080,COGS 14B,A01,185172,Staff,0,15,38,38
1683337415110,COGS 18,A01,184736,Staff,17,0,80,63
1683337416139,COGS 100,A01,184932,Staff,0,5,73,73
1683337417165,COGS 101A,A01,184935,Staff,0,39,30,30
1683337418190,COGS 101B,A01,184944,Staff,0,2,30,30
1683337419215,COGS 101C,A01,184946,Staff,0,12,30,30
1683337420239,COGS 102A,A01,184951,Johnson; Christine M.,2,0,40,38
1683337421266,COGS 107B,A01,184953,Mooshagian; Eric Frederick,0,50,40,40
1683337422295,COGS 118B,A01,184959,Gupta; Anjum,0,48,40,40
1683337423325,COGS 153,A00,184961,Staff,0,15,30,30
1683337424354,COGS 177,A00,184962,Staff,0,20,30,30
1683337425384,COGS 187A,A01,184969,Boyle; Mary E. T.,0,17,40,40
1683337426411,COMM 10,A01,185174,Staff,0,5,25,25
1683337426411,COMM 10,A02,185189,Staff,0,5,25,25
1683337426411,COMM 10,A03,269821,Staff,0,0,0,0
1683337427438,COMM 100B,A01,185475,Staff,0,0,0,2
1683337427438,COMM 100B,A02,185476,Staff,14,0,25,11
1683337428464,COMM 100C,A01,185314,Staff,1,0,25,24
1683337428464,COMM 100C,A02,185327,Staff,19,0,25,6
1683337429488,COMM 110M,A00,185349,Staff,2,0,40,38
1683337430514,COMM 113T,A00,185352,Staff,24,0,40,16
1683337431539,COMM 114I,A00,185353,Staff,33,0,40,7
1683337432567,COMM 131,A00,185354,Staff,19,0,30,11
1683337433596,CSE 8A,A50,185358,Cao; Yingjun,0,46,10,10
1683337434622,CSE 8B,A01,185362,Staff,1,47,50,49
1683337435648,CSE 11,A01,185416,Cao; Yingjun,0,92,10,10
1683337436675,CSE 20,A01,185445,Briones; Jor-el Thomas Caparas,5,0,25,20
1683337437699,CSE 21,A01,185447,Staff,10,0,50,40
1683337438727,CSE 101,A01,185451,Staff,0,13,50,50
1683337438727,CSE 101,B01,185453,Jones; Miles E,0,11,50,50
1683337440783,CSE 141,A01,185458,Eldon; John,20,0,100,80
1683337441811,CSE 141L,A01,185461,Eldon; John,12,0,100,88
1683337442839,CSE 142,A01,185463,Staff,36,0,60,24
1683337442839,CSE 142,B01,201355,Staff,0,7,60,60
1683337443868,CSE 142L,A01,185470,Staff,36,0,60,24
1683337443868,CSE 142L,B01,201417,Staff,0,6,60,60
1683337444899,CSE 190,A00,201433,Staff,32,0,49,17
1683337445928,DOC 1,A01,259136,Strom; Megan C.,7,0,15,8
1683337445928,DOC 1,A02,259137,Strom; Megan C.,14,0,15,1
1683337445928,DOC 1,A03,259138,Strom; Megan C.,14,0,15,1
1683337445928,DOC 1,A04,259139,Strom; Megan C.,14,0,15,1
1683337446954,DOC 100D,A00,259140,Pass; Natalye Joann,16,0,25,9
1683337447981,DSGN 1,A01,184749,Rill; Bryan,0,25,30,30
1683337449011,DSGN 100,A01,185168,Staff,0,2,25,25
1683337450038,ECE 5,A01,185626,Morris; Karcher William,0,10,0,0
1683337451068,ECE 101,A01,185628,Staff,17,0,70,53
1683337452094,ECE 107,A01,185635,Baghdadchi; Saharnaz,0,0,20,20
1683337452094,ECE 107,A02,185638,Baghdadchi; Saharnaz,4,0,20,16
1683337453118,ECE 148,A01,185647,Silberman; Jack,0,0,16,16
1683337454144,ECON 1,A01,185537,Crane; Meredith Helen,54,0,70,16
1683337455174,ECON 3,A01,185549,Crane; Meredith Helen,33,0,70,37
1683337456199,ECON 4,A01,203354,Anderson; John Charles,0,4,10,10
1683337457225,ECON 100A,A01,185574,Staff,0,4,40,40
1683337458253,ECON 100B,A01,185576,Staff,10,22,50,40
1683337459282,ECON 100C,A01,185589,Newhouse; Herbert S,30,0,70,40
1683337460311,ECON 105,A00,185608,Vespa; Emanuel Ignacio,19,0,35,16
1683337461337,ECON 109,A01,185610,Shishkin; Denis,10,0,35,25
1683337462368,ECON 110A,A01,185612,Staff,11,0,40,29
1683337463394,ECON 120A,A01,185615,Staff,20,0,40,20
1683337464422,ECON 120C,A01,185617,Sun; Yixiao,0,20,70,70
1683337465447,ECON 144,A00,203346,Squires; Dale E,3,0,35,32
1683337466471,ECON 171,A01,203349,Newhouse; Herbert S,0,1,35,35
1683337467495,ECON 173A,A01,185621,Toda; Alexis Akira,21,0,35,14
1683337468523,EDS 25,A01,202413,Staff,0,1,0,0
1683337468523,EDS 25,A02,202414,Staff,0,1,0,0
1683337468523,EDS 25,A03,202415,Staff,0,0,0,0
1683337468523,EDS 25,A04,202416,Staff,0,1,0,0
1683337468523,EDS 25,A05,202439,Staff,0,0,0,0
1683337468523,EDS 25,A06,202440,Staff,0,0,0,0
1683337468523,EDS 25,B01,202631,Staff,0,0,0,0
1683337468523,EDS 25,B02,202632,Staff,0,0,0,0
1683337468523,EDS 25,B03,202639,Staff,0,0,0,0
1683337468523,EDS 25,B04,202640,Staff,0,0,0,0
1683337468523,EDS 25,B05,202643,Staff,0,0,0,0
1683337468523,EDS 25,B06,202644,Staff,0,0,0,0
1683337469550,EDS 38,A01,202659,Black; Alison Michelle,24,0,25,1
1683337470577,EDS 115,A00,202652,Staff,18,0,30,12
1683337471602,EDS 125,A00,202649,Staff,14,0,30,16
1683337472630,EDS 126,A01,203332,Staff,30,0,30,0
1683337473658,EDS 139,A00,202838,Staff,16,0,25,9
1683337474688,EDS 146,A01,202655,Staff,14,0,25,11
1683337475718,ENG 15,A00,185667,Staff,0,1,0,0
1683337475718,ENG 15,B00,185672,Staff,0,0,0,0
1683337475718,ENG 15,C00,185675,Staff,0,0,0,0
1683337475718,ENG 15,D00,185682,Staff,0,0,0,0
1683337475718,ENG 15,E00,185684,Staff,0,0,0,0
1683337476744,ETHN 103,A00,185710,Staff,0,3,35,35
1683337477769,ETHN 103A,A00,199228,Man; Simeon S,2,0,9,7
1683337478798,ETHN 109,A00,185711,Staff,18,0,35,17
1683337479829,ETHN 142,A00,185726,Staff,0,4,30,30
1683337480858,ETHN 163J,A00,199229,Man; Simeon S,5,0,8,3
1683337481884,ETHN 168,A00,185727,Staff,8,0,10,2
1683337482910,ETHN 182,A00,185728,Staff,1,0,35,34
1683337483936,ETHN 183,A00,185737,Staff,8,0,18,10
1683337484966,GLBH 111,A01,209361,Burgos; Jose L.,0,0,0,0
1683337487018,HIEU 104,A00,185792,Staff,16,0,20,4
1683337488048,HIEU 115,A00,185800,Staff,1,0,20,19
1683337489075,HIEU 128,A00,185801,Staff,0,7,20,20
1683337490107,HIEU 147,A00,185802,Staff,16,0,20,4
1683337491134,HIEU 154,A00,185823,Staff,12,0,20,8
1683337492161,HILA 102,A00,185826,Staff,13,0,20,7
1683337493188,HILD 2C,A01,185778,Staff,0,12,20,20
1683337494218,HILD 7B,A01,185780,Kwak; Nancy,0,15,32,32
1683337494218,HILD 7B,A02,185781,Kwak; Nancy,0,18,32,32
1683337495247,HILD 30,A01,185791,Staff,14,0,20,6
1683337496276,HISC 119,A00,185830,Golan; Tal,0,9,20,20
1683337497304,HITO 156GS,A00,185831,Patterson; Patrick H.,0,0,0,23
1683337498329,HIUS 103,A00,185832,Man; Simeon S,0,6,20,20
1683337499358,HIUS 117,A00,185836,Kwak; Nancy,2,0,20,18
1683337500382,HIUS 125,A00,185840,Man; Simeon S,0,0,23,23
1683337501419,HIUS 149,A00,185845,Staff,0,0,20,20
1683337502443,HUM 3,A01,185882,Zavodny; Tatiana Sophia,0,7,50,50
1683337502443,HUM 3,B01,185899,Caldwell; Michael Alan,0,18,50,50
1683337503469,HUM 3GS,A00,185900,Patterson; Patrick H.,0,0,0,23
1683337504559,HUM 4,A01,185938,Zroka; Amy Liane,31,0,50,19
1683337504559,HUM 4,B01,185956,Watkins; Eric,0,2,50,50
1683337504559,HUM 4,B02,202209,Watkins; Eric,0,2,50,50
1683337504559,HUM 4,B03,202210,Watkins; Eric,0,2,50,50
1683337505592,HUM 5,A01,185958,West; Geoffrey Scott,3,0,50,47
1683337505592,HUM 5,A02,202215,West; Geoffrey Scott,0,0,50,50
1683337506617,INTL 190,A00,185959,Gagnon; Jeffrey C,0,0,0,9
1683337506617,INTL 190,B00,185960,Lettieri; Michael Joseph,0,0,0,1
1683337507643,JAPN 180,A00,254509,Staff,5,1,30,25
1683337508670,LATI 10,A01,202853,Kennemore; Amy Michelle,4,0,35,31
1683337508670,LATI 10,A02,202854,Kennemore; Amy Michelle,2,0,35,33
1683337508670,LATI 10,A03,270054,Kennemore; Amy Michelle,30,0,30,0
1683337509697,LATI 180,A00,202855,Kennemore; Amy Michelle,11,0,20,9
1683337510726,LAWS 101,A00,201767,Golan; Tal,0,7,40,40
1683337511756,LIFR 1C,A00,185961,Staff,6,0,20,14
1683337512786,LIFR 1CX,A00,185962,Staff,7,0,20,13
1683337513812,LIFR 1D,A00,185963,Staff,9,0,20,11
1683337514837,LIFR 1DX,A00,185964,Staff,9,0,20,11
1683337515861,LIGN 101,A01,186039,Staff,43,0,50,7
1683337516887,LIGN 165,A00,186040,Staff,18,0,50,32
1683337517916,LTCS 108,A00,186041,Staff,6,0,10,4
1683337518944,LTCS 119,A00,186042,Staff,16,0,20,4
1683337519974,LTCS 130,A00,186043,Wesling; Megan E.,15,0,25,10
1683337522037,LTEA 138,A00,186119,Staff,14,0,40,26
1683337523066,LTEN 124,A00,186148,Staff,6,0,25,19
1683337524090,LTEN 178,A00,186149,Staff,7,0,15,8
1683337525116,LTEN 181,A00,186150,Blanco; John D,33,0,40,7
1683337526141,LTWL 120,A00,186160,Staff,20,0,25,5
1683337527166,LTWL 165,A00,186161,Staff,22,0,25,3
1683337528192,LTWR 100,A00,186162,Staff,0,5,15,15
1683337529219,LTWR 102,A00,186163,Doller; Ben,5,0,15,10
1683337530245,MAE 8,A01,186412,Staff,0,0,0,0
1683337531269,MAE 30B,A00,186445,Bahadori; Mohammad Yousef,83,0,100,17
1683337532294,MAE 40,A00,186592,Bewley; Thomas R,9,0,50,41
1683337533320,MAE 101B,A00,186593,Bahadori; Mohammad Yousef,81,0,100,19
1683337534349,MAE 105,A00,186594,Bandaru; Prabhakar,12,0,50,38
1683337535376,MAE 107,A00,186599,Pham; Hieu Tan,0,6,120,120
1683337536403,MAE 148,A01,186660,Silberman; Jack,3,0,16,13
1683337537431,MATH 10A,A01,188095,Staff,1,6,35,34
1683337538455,MATH 10B,A01,188097,Bowers; Adam R.,0,11,30,30
1683337538455,MATH 10B,A02,188099,Bowers; Adam R.,0,11,30,30
1683337538455,MATH 10B,B01,188104,Bowers; Adam R.,0,10,30,30
1683337538455,MATH 10B,B02,188106,Bowers; Adam R.,0,10,30,30
1683337539482,MATH 10C,A01,188111,Staff,0,18,30,30
1683337539482,MATH 10C,A02,188127,Staff,0,17,30,30
1683337539482,MATH 10C,A03,188131,Staff,0,18,30,30
1683337539482,MATH 10C,B01,188218,Staff,18,0,30,12
1683337539482,MATH 10C,B02,188244,Staff,13,0,30,17
1683337539482,MATH 10C,B03,188277,Staff,16,0,30,14
1683337540508,MATH 18,A01,188344,Bach; Quang Tran,18,0,30,12
1683337540508,MATH 18,A02,188345,Bach; Quang Tran,11,0,30,19
1683337540508,MATH 18,B01,188353,Bach; Quang Tran,10,0,30,20
1683337540508,MATH 18,B02,188354,Bach; Quang Tran,20,0,30,10
1683337541534,MATH 20A,A01,188374,Staff,13,0,35,22
1683337542564,MATH 20B,A01,188382,Ohm; Ko Woon,6,0,30,24
1683337542564,MATH 20B,A02,188383,Ohm; Ko Woon,22,0,30,8
1683337542564,MATH 20B,B01,188385,Ohm; Ko Woon,7,0,30,23
1683337542564,MATH 20B,B02,188392,Ohm; Ko Woon,22,0,30,8
1683337543595,MATH 20C,A01,188394,Harel; Guershon,10,0,30,20
1683337543595,MATH 20C,A02,188395,Harel; Guershon,15,0,30,15
1683337543595,MATH 20C,B01,188404,Harel; Guershon,5,0,30,25
1683337543595,MATH 20C,B02,188405,Harel; Guershon,19,0,30,11
1683337544625,MATH 20D,A01,188414,Hammock; Frances H,0,1,30,30
1683337544625,MATH 20D,A02,188415,Hammock; Frances H,3,0,30,27
1683337544625,MATH 20D,B01,188447,Hammock; Frances H,1,0,30,29
1683337544625,MATH 20D,B02,188486,Hammock; Frances H,8,0,30,22
1683337545653,MATH 20E,A01,188649,Staff,21,0,30,9
1683337545653,MATH 20E,A02,188650,Staff,23,0,30,7
1683337545653,MATH 20E,A03,188673,Staff,0,0,30,30
1683337546679,MATH 102,A01,188675,Staff,0,35,35,35
1683337547708,MATH 103B,A01,188681,Staff,3,0,35,32
1683337547708,MATH 103B,B01,188692,Staff,5,0,35,30
1683337548734,MATH 109,A01,188695,Salehi Golsefidy; Alireza,25,0,35,10
1683337548734,MATH 109,A02,188696,Salehi Golsefidy; Alireza,25,0,35,10
1683337549760,MATH 120A,A01,188698,Eggers; John Dietrich,7,0,35,28
1683337550785,MATH 142B,A01,188736,Ioana; Adrian,0,2,30,30
1683337550785,MATH 142B,A02,188741,Ioana; Adrian,1,1,30,29
1683337550785,MATH 142B,A03,188743,Ioana; Adrian,1,3,30,29
1683337551811,MATH 168A,A01,188790,Staff,0,9,35,35
1683337552840,MATH 170A,A01,188803,Nie; Jiawang,0,2,35,35
1683337552840,MATH 170A,A02,188811,Nie; Jiawang,0,0,35,35
1683337552840,MATH 170A,A03,188814,Nie; Jiawang,1,0,35,34
1683337552840,MATH 170A,A04,188815,Nie; Jiawang,13,0,35,22
1683337553866,MATH 193B,A01,188817,Staff,0,0,35,35
1683337553866,MATH 193B,A02,188818,Staff,5,0,35,30
1683337554896,MGT 4,A01,202857,Anderson; John Charles,62,0,80,18
1683337555924,MGT 12,A00,202858,Lindenberger; Wade Douglas,42,0,90,48
1683337556950,MGT 18,A00,202859,Staff,74,0,90,16
1683337557976,MGT 18GS,A00,202860,McKay; Michael J,13,0,28,15
1683337559006,MGT 45,A00,202861,Pecore; Joseph P.,14,0,90,76
1683337560039,MGT 100,A00,202863,Yavorsky; Daniel Ryan,28,0,90,62
1683337561073,MGT 103,A00,202864,Ehrich; Kristine R,1,18,90,89
1683337562100,MGT 112,A00,202865,Ehrich; Kristine R,15,0,90,75
1683337563126,MGT 121A,A00,202868,Staff,0,20,0,0
1683337564152,MGT 131B,A00,202869,Anderson; John Charles,59,0,90,31
1683337565179,MGT 136,A00,202871,Lindenberger; Wade Douglas,84,0,90,6
1683337566204,MGT 164,A00,202873,Staff,0,68,90,91
1683337567228,MGT 164GS,A00,202874,McKay; Mary A,13,0,28,15
1683337568254,MGT 180,A00,202875,Staff,0,50,90,91
1683337569279,MMW 11R,A01,205019,Herbst; Matthew,3,0,30,27
1683337569279,MMW 11R,A02,205026,Herbst; Matthew,29,0,30,1
1683337570312,MMW 15,A01,193512,Chang; Edmond Yi-Teh,0,9,28,28
1683337570312,MMW 15,A02,193513,Chang; Edmond Yi-Teh,0,5,28,28
1683337570312,MMW 15,A03,193514,Chang; Edmond Yi-Teh,0,5,28,28
1683337570312,MMW 15,A04,193515,Chang; Edmond Yi-Teh,0,5,28,28
1683337570312,MMW 15,A05,193516,Chang; Edmond Yi-Teh,0,4,28,28
1683337570312,MMW 15,A06,193517,Chang; Edmond Yi-Teh,0,5,28,28
1683337570312,MMW 15,B01,193519,Chang; Edmond Yi-Teh,0,5,28,28
1683337570312,MMW 15,B02,193520,Chang; Edmond Yi-Teh,0,5,28,28
1683337570312,MMW 15,B03,193521,Chang; Edmond Yi-Teh,0,5,28,28
1683337570312,MMW 15,B04,193522,Chang; Edmond Yi-Teh,0,4,28,28
1683337570312,MMW 15,B05,193523,Chang; Edmond Yi-Teh,0,5,28,28
1683337570312,MMW 15,B06,193524,Chang; Edmond Yi-Teh,0,4,28,28
1683337571341,MMW 122,A01,193526,Rahimi; Babak,0,15,28,28
1683337571341,MMW 122,A02,193527,Rahimi; Babak,0,14,28,28
1683337571341,MMW 122,A03,193528,Rahimi; Babak,0,0,0,0
1683337571341,MMW 122,A04,193529,Rahimi; Babak,0,0,0,0
1683337572369,MUS 1A,A01,186663,Staff,0,20,35,35
1683337573394,MUS 4,A01,186715,Staff,0,12,35,35
1683337574420,MUS 5R,A01,186796,Dubnov; Shlomo,0,17,35,35
1683337575450,MUS 6,A01,186798,Staff,0,4,25,25
1683337576478,MUS 7,A01,186830,Staff,13,0,35,22
1683337577504,MUS 8,A01,186930,Staff,0,26,35,35
1683337578528,MUS 15,A01,186932,Staff,0,16,35,35
1683337578528,MUS 15,B01,186934,Staff,0,15,35,35
1683337579554,MUS 80,A00,186935,Staff,1,0,20,19
1683337579554,MUS 80,B00,186936,Staff,25,0,25,0
1683337580581,NANO 11,A00,204702,Lipomi; Darren John,0,0,0,0
1683337581608,NANO 15,A01,204709,Yang; Kesong,0,1,0,0
1683337582637,NANO 114,A00,202069,Jahed Motlagh; Zeinab,3,0,10,7
1683337583667,PHIL 1,A00,186955,Grush; Rick Scott,32,0,40,8
1683337584699,PHIL 10,A01,186973,Grush; Rick Scott,28,0,35,7
1683337584699,PHIL 10,A02,186974,Grush; Rick Scott,33,0,35,2
1683337585728,PHIL 13,A01,186976,Staff,7,0,35,28
1683337585728,PHIL 13,A02,186977,Staff,16,0,35,19
1683337586758,PHIL 14,A01,186979,Staff,31,0,35,4
1683337586758,PHIL 14,A02,186986,Staff,32,0,35,3
1683337587785,PHIL 28,A01,186988,Staff,16,0,30,14
1683337587785,PHIL 28,A02,186989,Staff,1,0,30,29
1683337587785,PHIL 28,A03,186990,Staff,9,0,30,21
1683337587785,PHIL 28,A04,186991,Staff,26,0,30,4
1683337588814,PHIL 120,A00,186997,Staff,23,0,40,17
1683337589841,PHIL 137,A00,187003,Staff,9,0,40,31
1683337590868,PHIL 150,A00,187015,Staff,47,0,70,23
1683337591894,PHIL 167,A00,187021,Lamey; Andy M.,35,0,40,5
1683337592920,PHIL 174,A01,202226,Staff,17,0,20,3
1683337592920,PHIL 174,A02,202235,Staff,20,0,20,0
1683337593946,PHIL 191A,A00,258918,Staff,0,0,1,1
1683337594972,PHYS 1A,A00,187028,Staff,27,0,60,33
1683337595998,PHYS 1AL,001,187036,Staff,2,0,30,28
1683337595998,PHYS 1AL,002,187049,Staff,18,0,30,12
1683337597028,PHYS 1B,A00,187058,Staff,22,0,60,38
1683337598052,PHYS 1BL,001,187064,Staff,0,0,30,30
1683337598052,PHYS 1BL,002,187070,Staff,5,0,30,25
1683337599079,PHYS 1C,A00,187082,Staff,31,0,120,89
1683337600105,PHYS 1CL,001,187088,Staff,0,9,30,30
1683337600105,PHYS 1CL,002,187089,Staff,0,2,30,30
1683337600105,PHYS 1CL,009,262693,Staff,11,0,30,19
1683337601131,PHYS 2B,A01,187097,Staff,54,0,115,61
1683337602157,PHYS 2C,A01,187099,Staff,67,0,115,48
1683337603185,PHYS 2CL,A01,187101,Staff,5,0,28,23
1683337603185,PHYS 2CL,A02,187102,Staff,15,0,28,13
1683337604216,PHYS 2D,A01,187123,Shotwell; Brian,95,0,115,20
1683337605246,PHYS 4B,A01,187133,Grinstein; Benjamin,35,0,50,15
1683337606274,POLI 10,A00,188819,Staff,0,4,50,50
1683337607302,POLI 11,A00,188827,Staff,43,0,50,7
1683337608386,POLI 13R,A00,188828,Staff,0,1,20,20
1683337609412,POLI 27,A01,188830,Elgin; Samuel Zincke,0,1,70,70
1683337610440,POLI 30,A00,188832,Desposato; Scott,31,0,50,19
1683337611470,POLI 102F,A00,188834,Staff,3,0,40,37
1683337612496,POLI 104A,A00,188852,Staff,14,0,30,16
1683337613524,POLI 104I,A00,188853,Staff,0,6,20,20
1683337614553,POLI 110B,A00,188854,Wiens; David,7,0,20,13
1683337615587,POLI 112A,A00,188855,Wiens; David,5,0,30,25
1683337616614,POLI 117R,A00,188856,Forman; Fonna,0,11,20,20
1683337617640,POLI 118,A00,188857,Ingham; Sean,8,0,20,12
1683337618668,POLI 120G,A00,188858,Staff,9,0,30,21
1683337619697,POLI 131CR,A00,188863,Hoston; Germaine,24,0,50,26
1683337620725,POLI 133,A00,188864,Nellis; Gareth Hb,44,0,50,6
1683337621757,POLI 134D,A00,188865,Desposato; Scott,27,0,30,3
1683337622784,POLI 142A,A00,188871,Gartzke; Erik,22,0,50,28
1683337623813,POLI 142K,A00,188874,Staff,38,0,50,12
1683337624840,POLI 143,A00,188940,Gartzke; Erik,16,0,30,14
1683337625865,POLI 153,A00,188943,Staff,3,0,20,17
1683337626895,POLI 160AA,A00,188944,Staff,12,0,40,28
1683337627922,POLI 170A,A00,188945,Staff,11,0,30,19
1683337629977,PSYC 1,A00,188952,Staff,37,0,90,53
1683337631004,PSYC 2,B00,188953,Staff,19,0,35,16
1683337632030,PSYC 6,A00,188970,Staff,47,0,60,13
1683337633061,PSYC 7,A00,188973,Staff,37,0,45,8
1683337634090,PSYC 60,A01,188980,Rickard; Timothy C.,43,0,60,17
1683337635116,PSYC 70,A01,189001,Steiner; Eric Tomas,24,0,45,21
1683337636141,PSYC 100,A00,189005,Lacefield; Katharine I,0,99,120,120
1683337637166,PSYC 102,A00,189008,Staff,9,0,30,21
1683337638193,PSYC 106,B00,189026,Gorman; Michael R.,34,0,60,26
1683337639222,PSYC 114,B01,189033,Winkielman; Piotr,0,32,30,30
1683337640248,PSYC 131,A00,189036,Anagnostaras; Stephan,0,43,60,60
1683337641278,PSYC 136,A00,189041,Lowe; Angela Beth,0,7,25,25
1683337642305,PSYC 137,A00,189057,Winkielman; Piotr,0,34,25,25
1683337643331,PSYC 144,A00,189107,Wixted; John T,0,7,50,50
1683337645384,PSYC 162,A00,189142,Staff,0,8,85,85
1683337646410,PSYC 172,A00,189144,Gorman; Michael R.,0,7,30,30
1683337648468,PSYC 179,A00,189146,Lacefield; Katharine I,0,84,120,120
1683337649495,PSYC 181,A00,189147,Anagnostaras; Stephan,0,44,90,90
1683337650523,PSYC 190R,A00,189148,Barner; David A.,0,22,80,80
1683337651549,PSYC 191,A00,189275,Rickard; Timothy C.,0,7,25,25
1683337652574,PSYC 193,A00,189276,Chapman; Eddie Nathaniel,0,1,0,4
1683337653605,PSYC 193L,A01,189281,Lowe; Angela Beth,12,0,20,8
1683337653605,PSYC 193L,B01,189285,Staff,28,0,35,7
1683337654633,RELI 149,A00,187137,Rahimi; Babak,7,0,40,33
1683337655662,SE 9,A01,187315,Staff,0,2,18,18
1683337656688,SE 101B,A00,187409,Staff,24,0,30,6
1683337657715,SE 110B,A00,187444,Staff,10,0,40,30
1683337658745,SE 130B,A00,187449,Staff,31,0,40,9
1683337659774,SE 150A,A00,187516,Staff,9,0,20,11
1683337660806,SE 154,A00,187528,Staff,30,0,50,20
1683337661832,SIO 3,A01,258171,Staff,35,0,40,5
1683337662859,SIO 10,A00,187144,Cook; Geoffrey W,0,3,75,75
1683337663884,SIO 45,A00,187152,Cook; Geoffrey W,1,0,100,99
1683337664910,SIO 109R,A00,194486,Staff,0,3,20,20
1683337666962,SIO 187,A01,187233,Kacev; David,12,0,40,28
1683337667988,SOCI 1,A01,258656,Thorpe; Charles Robert,28,0,30,2
1683337667988,SOCI 1,A02,258658,Thorpe; Charles Robert,30,0,30,0
1683337667988,SOCI 1,A03,258661,Thorpe; Charles Robert,25,0,25,0
1683337667988,SOCI 1,A04,258666,Thorpe; Charles Robert,22,0,25,3
1683337667988,SOCI 1,A05,258897,Thorpe; Charles Robert,23,0,25,2
1683337667988,SOCI 1,A06,258898,Thorpe; Charles Robert,25,0,25,0
1683337669016,SOCI 30,A01,258903,Pardo Guerra; Juan Pablo,15,0,30,15
1683337670045,SOCI 102,A00,258904,Staff,9,0,25,16
1683337671070,SOCI 106,A00,258905,Staff,19,0,25,6
1683337672098,SOCI 111,A00,258907,Ribas Norris; Janet Vanesa,26,0,30,4
1683337673124,SOCI 121R,A00,258908,Pardo Guerra; Juan Pablo,10,0,30,20
1683337674150,SOCI 126,A01,203330,Staff,14,0,20,6
1683337675176,SOCI 131,A00,258909,Thorpe; Charles Robert,31,0,60,29
1683337676202,SOCI 135,A00,258910,Payne; Christine Anna,0,9,30,30
1683337677229,SOCI 157,A00,258911,Staff,12,0,30,18
1683337678254,SOCI 184,A00,258912,Staff,25,0,30,5
1683337679281,SOCI 188D,A00,258913,Staff,21,0,30,9
1683337680307,SYN 2,001,187529,Staff,10,0,16,6
1683337680307,SYN 2,002,201452,Staff,0,18,16,16
1683337680307,SYN 2,003,201469,Staff,3,0,16,13
1683337681337,SYN 100,A01,187531,Staff,0,9,20,20
1683337681337,SYN 100,B01,201491,Staff,0,12,20,20
1683337682364,TDAC 1,A00,189286,Walsh; Kim C.,3,0,20,17
1683337682364,TDAC 1,B00,189287,Harting; Carla Kelso,11,0,20,9
1683337683390,TDAC 101,A00,189300,Walsh; Kim C.,16,0,20,4
1683337683390,TDAC 101,B00,189301,Harting; Carla Kelso,18,0,20,2
1683337684415,TDAC 102,A00,189304,Basso; Beatrice,14,0,20,6
1683337685443,TDAC 108,A00,189305,Staff,18,0,20,2
1683337686470,TDDE 131,A00,189310,Staff,19,0,20,1
1683337686470,TDDE 131,B00,189314,Staff,19,0,20,1
1683337686470,TDDE 131,C00,189315,Staff,48,0,50,2
1683337686470,TDDE 131,D00,189316,Staff,14,0,15,1
1683337686470,TDDE 131,E00,204841,Staff,20,0,20,0
1683337687498,TDGE 10,A00,189289,Staff,30,0,50,20
1683337687498,TDGE 10,B00,189290,Havis; Allan,1,0,50,49
1683337688525,TDGE 11,A00,189291,Fulton; Julia,0,3,50,50
1683337688525,TDGE 11,B00,189292,Staff,20,0,25,5
1683337688525,TDGE 11,C00,260270,Staff,0,0,0,0
1683337689551,TDGE 25,A00,189294,Staff,3,0,20,17
1683337690581,TDGE 124,A00,189318,Fulton; Julia,0,8,50,50
1683337691607,TDGE 125,A00,189319,Staff,13,0,25,12
1683337691607,TDGE 125,B00,189320,Staff,23,0,25,2
1683337692634,TDGE 127,A00,189322,Havis; Allan,0,0,50,50
1683337693662,TDHT 101,A00,189323,Staff,18,0,25,7
1683337693662,TDHT 101,B00,189324,Staff,25,0,25,0
1683337694688,TDHT 102,A00,189325,Staff,49,0,50,1
1683337695714,TDMV 1,A00,189295,Arcidiacono; Kristin,19,0,30,11
1683337695714,TDMV 1,B00,189296,Caligagan; Maria T.,24,0,30,6
1683337696740,TDMV 2,A00,189297,Sammartano; Tonnie,28,0,30,2
1683337696740,TDMV 2,B00,189299,Arcidiacono; Kristin,24,0,30,6
1683337697765,TDMV 3,A00,204998,Rincon; Alicia,22,0,30,8
1683337698791,TDMV 120,A00,189458,Sammartano; Tonnie,28,0,30,2
1683337699820,TDMV 138,A00,189541,Jun; Grace Shin Hae,22,0,40,18
1683337700847,TDMV 142,A00,189717,Caligagan; Tony,23,0,30,7
1683337700847,TDMV 142,B00,189718,Caligagan; Maria T.,25,0,30,5
1683337701872,TMC 2,A01,187533,Staff,25,0,25,0
1683337701872,TMC 2,A02,187534,Staff,25,0,25,0
1683337702899,USP 1,A01,187536,Kwak; Nancy,0,16,25,25
1683337703926,USP 5,A01,187538,Staff,10,0,25,15
1683337704952,USP 101,A00,199253,Staff,0,4,0,0
1683337705978,USP 124,A00,187562,Boomhower; Matthew Charles,1,0,30,29
1683337707005,USP 138,A00,187582,Staff,20,0,25,5
1683337708031,USP 152,A01,187597,Staff,4,0,25,21
1683337709058,USP 153,A00,187598,Staff,19,0,25,6
1683337710083,USP 168,A00,187607,Kwak; Nancy,2,0,5,3
1683337711110,USP 173,A00,187619,Staff,4,0,25,21
1683337712196,USP 181,A00,187638,Staff,0,0,25,25
1683337713222,VIS 103,A00,187650,Cruz; Edwin Teddy,23,0,75,52
1683337714246,VIS 110D,A00,187669,Staff,12,0,22,10
1683337715272,VIS 127C,A00,187720,Shen; Kuiyi,67,0,146,79
1683337716297,VIS 149,A00,187731,Yoldas; Pinar,0,14,22,22
1683337717324,VIS 151,A01,188091,Staff,22,0,34,12
1683337717324,VIS 151,A02,188092,Staff,11,0,34,23
1683337718350,VIS 160B,A00,188093,Stalbaum; Brett,0,0,10,10
1683337720402,WCWP 10B,A00,201720,Staff,10,0,15,5
1683337720402,WCWP 10B,B00,201722,Staff,9,0,15,6
1683337721428,WCWP 100,A00,201725,Gagnon; Jeffrey C,0,0,2,2
1683337721428,WCWP 100,B00,201727,Staff,0,4,15,15
1683337724568,ANBI 133,A00,258401,Wilder; Linnea Lorene,34,0,40,6
1683337725594,ANBI 140,A00,258395,Hrvoj Mihic; Branka,18,0,25,7
1683337726620,ANSC 120,A00,258402,Bialecki; Jon Anthony,27,0,40,13
1683337727649,ANSC 144,A00,258400,Staff,14,0,40,26
1683337729707,ANSC 166,A00,258396,Parish; Steven Martin,157,0,175,18
1683337730734,ANSC 180,A00,193533,Staff,9,0,20,11
1683337731761,ANSC 188,A00,258397,Jassal; Aftab,33,0,40,7
1683337732786,ANTH 3,A01,258316,Staff,23,0,30,7
1683337733814,ANTH 5,A00,258394,Semendeferi; Ekaterini,16,0,20,4
1683337734840,ANTH 21,A01,258331,Staff,8,0,40,32
1683337735867,ANTH 103,A00,258398,Varma; Saiba,15,0,25,10
1683337736896,AWP 10,001,202034,Staff,0,0,0,0
1683337736896,AWP 10,002,202035,Staff,0,0,0,0
1683337736896,AWP 10,003,202036,Staff,0,0,0,0
1683337736896,AWP 10,004,202037,Staff,0,0,0,0
1683337736896,AWP 10,005,202038,Staff,0,0,0,0
1683337736896,AWP 10,006,202039,Staff,0,0,0,0
1683337736896,AWP 10,007,202040,Staff,0,0,0,0
1683337736896,AWP 10,008,202041,Staff,0,0,0,0
1683337736896,AWP 10,009,202042,Staff,0,0,0,0
1683337736896,AWP 10,010,202043,Staff,0,0,0,0
1683337736896,AWP 10,011,202044,Staff,0,0,0,0
1683337736896,AWP 10,012,202045,Staff,0,0,0,0
1683337736896,AWP 10,013,202046,Staff,0,0,0,0
1683337736896,AWP 10,014,202047,Staff,0,0,0,0
1683337736896,AWP 10,015,202048,Staff,0,0,0,0
1683337736896,AWP 10,016,202049,Staff,0,0,0,0
1683337736896,AWP 10,017,202050,Staff,0,0,0,0
1683337736896,AWP 10,018,202051,Staff,0,0,0,0
1683337736896,AWP 10,019,202052,Staff,0,0,0,0
1683337736896,AWP 10,020,202053,Staff,0,0,0,0
1683337736896,AWP 10,021,202054,Staff,0,0,0,0
1683337736896,AWP 10,022,202055,Staff,0,0,0,0
1683337736896,AWP 10,023,202056,Staff,0,0,0,0
1683337736896,AWP 10,024,202057,Staff,0,0,0,0
1683337736896,AWP 10,025,202058,Staff,0,0,0,0
1683337736896,AWP 10,026,202059,Staff,0,0,0,0
1683337737925,AWP 102,001,202032,Staff,0,0,0,0
1683337737925,AWP 102,002,202033,Staff,0,0,0,0
1683337738955,BENG 100,A01,254234,Taylor Amos; Alyssa C,31,0,40,9
1683337739981,BENG 196,001,270013,Engler; Adam J.,9999,0,9999,0
1683337741012,BICD 100R,A01,202018,Smith; Laurie,0,7,32,32
1683337741012,BICD 100R,A02,202019,Smith; Laurie,0,2,32,32
1683337741012,BICD 100R,A03,202020,Smith; Laurie,0,1,32,32
1683337741012,BICD 100R,A04,202021,Smith; Laurie,9,0,32,23
1683337741012,BICD 100R,A05,202022,Smith; Laurie,12,0,32,20
1683337742041,BICD 136,A01,193242,Gustafson-Brown; Cindy,0,2,32,32
1683337742041,BICD 136,A02,193244,Gustafson-Brown; Cindy,14,0,32,18
1683337743071,BIEB 102,A01,193249,Butler; Shannon Rhey,0,2,32,32
1683337743071,BIEB 102,A02,193251,Butler; Shannon Rhey,0,0,32,32
1683337743071,BIEB 102,A03,193253,Butler; Shannon Rhey,0,1,32,32
1683337743071,BIEB 102,A04,193255,Butler; Shannon Rhey,17,0,32,15
1683337743071,BIEB 102,A05,193265,Butler; Shannon Rhey,26,0,32,6
1683337743071,BIEB 102,A06,193269,Butler; Shannon Rhey,16,0,32,16
1683337745127,BIEB 150,A01,193274,Staff,0,0,32,32
1683337745127,BIEB 150,A02,193285,Staff,23,0,32,9
1683337746152,BIEB 194,A00,193286,Kurle; Carolyn M.,22,0,32,10
1683337747182,BILD 1,A01,192291,Staff,16,0,32,16
1683337747182,BILD 1,A02,192292,Staff,30,0,32,2
1683337747182,BILD 1,B01,192520,Reuther; Keefe,0,1,0,0
1683337747182,BILD 1,B02,192532,Reuther; Keefe,0,1,0,0
1683337748215,BILD 3,A01,192556,Butler; Shannon Rhey,0,0,32,32
1683337748215,BILD 3,A02,192581,Butler; Shannon Rhey,5,0,32,27
1683337748215,BILD 3,A03,192611,Butler; Shannon Rhey,23,0,32,9
1683337748215,BILD 3,A04,192612,Butler; Shannon Rhey,25,0,32,7
1683337748215,BILD 3,A05,192613,Butler; Shannon Rhey,27,0,32,5
1683337748215,BILD 3,A06,192679,Butler; Shannon Rhey,27,0,32,5
1683337748215,BILD 3,A07,192682,Butler; Shannon Rhey,22,0,32,10
1683337749243,BILD 4,A01,192836,Reuther; Keefe,0,0,24,24
1683337749243,BILD 4,A02,193044,Reuther; Keefe,4,0,24,20
1683337750270,BILD 10,A01,193142,Gustafson-Brown; Cindy,30,0,32,2
1683337750270,BILD 10,A02,193149,Gustafson-Brown; Cindy,31,0,32,1
1683337751296,BIMM 100,A01,193301,Staff,0,6,32,32
1683337751296,BIMM 100,A02,193312,Staff,0,5,32,32
1683337751296,BIMM 100,A03,193323,Staff,0,8,32,32
1683337752336,BIMM 101,A01,193329,McDonnell; Lisa Marie,0,3,24,24
1683337752336,BIMM 101,A02,193339,McDonnell; Lisa Marie,0,3,24,24
1683337752336,BIMM 101,B01,193354,McDonnell; Lisa Marie,0,3,24,24
1683337752336,BIMM 101,B02,193357,McDonnell; Lisa Marie,0,3,24,24
1683337753360,BIMM 110,A01,193377,Tat; John,0,11,32,32
1683337753360,BIMM 110,A02,193378,Tat; John,1,9,32,31
1683337754388,BIMM 120,A01,206116,Staff,0,0,32,32
1683337754388,BIMM 120,A02,206117,Staff,8,0,32,24
1683337754388,BIMM 120,A03,206121,Staff,21,0,32,11
1683337755415,BIPN 100,A01,193393,Park; Ji Young,0,14,32,32
1683337755415,BIPN 100,A02,193402,Park; Ji Young,0,13,32,32
1683337755415,BIPN 100,A03,193413,Park; Ji Young,0,14,32,32
1683337755415,BIPN 100,A04,193414,Park; Ji Young,0,13,32,32
1683337756440,BIPN 102,A01,193429,Staff,0,0,32,32
1683337756440,BIPN 102,A02,193438,Staff,22,0,32,10
1683337757470,BIPN 106,A01,193450,Reyes Gonzalez; Catalina,0,2,40,40
1683337758495,BIPN 134,A01,193465,Cooke; James Edward,0,0,32,32
1683337758495,BIPN 134,A02,193474,Cooke; James Edward,25,0,32,7
1683337758495,BIPN 134,A03,193485,Cooke; James Edward,29,0,32,3
1683337758495,BIPN 134,A04,193486,Cooke; James Edward,21,0,32,11
1683337758495,BIPN 134,A05,193491,Cooke; James Edward,31,0,32,1
1683337758495,BIPN 134,A06,193501,Cooke; James Edward,30,0,32,2
1683337758495,BIPN 134,A07,193510,Cooke; James Edward,29,0,32,3
1683337760552,BISP 194,A00,222522,Staff,14,0,32,18
1683337761578,CAT 124,A01,202407,Staff,20,0,25,5
1683337762607,CAT 125,A00,202408,Marchisotto; Jennifer Anne,4,0,20,16
1683337763638,CAT 125R,A00,202409,Smith; Lauryn Alissa,0,11,20,20
1683337763638,CAT 125R,B00,202410,Morales; Celeste Georgianna,0,11,20,20
1683337763638,CAT 125R,C00,202411,Irwin; Matthew Joseph,0,10,20,20
1683337764667,CENG 15,A01,204712,Yang; Kesong,0,1,0,0
1683337765696,CENG 114,A00,202070,Jahed Motlagh; Zeinab,5,0,20,15
1683337766724,CGS 105,A00,185477,Wesling; Megan E.,24,0,40,16
1683337767749,CGS 106,A00,185494,Staff,13,0,22,9
1683337768780,CGS 108,A00,185495,Staff,14,0,20,6
1683337769805,CGS 114,A00,185496,Staff,13,0,18,5
1683337770828,CGS 119,A00,185501,Staff,15,0,20,5
1683337771854,CGS 120,A00,185511,Staff,13,0,20,7
1683337772884,CHEM 4,A01,184675,Bussey; Thomas J,96,0,100,4
1683337773914,CHEM 6A,A01,184677,Staff,34,0,60,26
1683337774940,CHEM 6B,A01,184679,Staff,65,0,100,35
1683337775971,CHEM 6C,A01,184681,Bussey; Thomas J,1,0,50,49
1683337775971,CHEM 6C,A02,184682,Bussey; Thomas J,34,0,50,16
1683337776998,CHEM 40A,A01,184684,Albizati; Kim F.,37,0,100,63
1683337778026,CHEM 40B,A01,184686,Albizati; Kim F.,0,20,100,100
1683337779056,CHEM 41B,A01,184690,Staff,52,0,100,48
1683337780081,COGS 3,A01,184715,Boyle; Mary E. T.,0,25,40,40
1683337781110,COGS 14B,A01,185172,Staff,0,15,38,38
1683337782134,COGS 18,A01,184736,Staff,17,0,80,63
1683337783158,COGS 100,A01,184932,Staff,0,5,73,73
1683337784184,COGS 101A,A01,184935,Staff,0,39,30,30
1683337785212,COGS 101B,A01,184944,Staff,0,2,30,30
1683337786240,COGS 101C,A01,184946,Staff,0,12,30,30
1683337787267,COGS 102A,A01,184951,Johnson; Christine M.,2,0,40,38
1683337788294,COGS 107B,A01,184953,Mooshagian; Eric Frederick,0,50,40,40
1683337789322,COGS 118B,A01,184959,Gupta; Anjum,0,48,40,40
1683337790350,COGS 153,A00,184961,Staff,0,15,30,30
1683337791376,COGS 177,A00,184962,Staff,0,20,30,30
1683337792404,COGS 187A,A01,184969,Boyle; Mary E. T.,0,17,40,40
1683337793430,COMM 10,A01,185174,Staff,0,5,25,25
1683337793430,COMM 10,A02,185189,Staff,0,5,25,25
1683337793430,COMM 10,A03,269821,Staff,0,0,0,0
1683337794457,COMM 100B,A01,185475,Staff,0,0,0,2
1683337794457,COMM 100B,A02,185476,Staff,14,0,25,11
1683337795482,COMM 100C,A01,185314,Staff,1,0,25,24
1683337795482,COMM 100C,A02,185327,Staff,19,0,25,6
1683337796512,COMM 110M,A00,185349,Staff,2,0,40,38
1683337797541,COMM 113T,A00,185352,Staff,24,0,40,16
1683337798568,COMM 114I,A00,185353,Staff,33,0,40,7
1683337799596,COMM 131,A00,185354,Staff,19,0,30,11
1683337800625,CSE 8A,A50,185358,Cao; Yingjun,0,46,10,10
1683337801651,CSE 8B,A01,185362,Staff,1,47,50,49
1683337802683,CSE 11,A01,185416,Cao; Yingjun,0,92,10,10
1683337803714,CSE 20,A01,185445,Briones; Jor-el Thomas Caparas,5,0,25,20
1683337804741,CSE 21,A01,185447,Staff,10,0,50,40
1683337805771,CSE 101,A01,185451,Staff,0,13,50,50
1683337805771,CSE 101,B01,185453,Jones; Miles E,0,11,50,50
1683337807824,CSE 141,A01,185458,Eldon; John,20,0,100,80
1683337808849,CSE 141L,A01,185461,Eldon; John,12,0,100,88
1683337809874,CSE 142,A01,185463,Staff,36,0,60,24
1683337809874,CSE 142,B01,201355,Staff,0,7,60,60
1683337810904,CSE 142L,A01,185470,Staff,36,0,60,24
1683337810904,CSE 142L,B01,201417,Staff,0,6,60,60
1683337811929,CSE 190,A00,201433,Staff,32,0,49,17
1683337812956,DOC 1,A01,259136,Strom; Megan C.,7,0,15,8
1683337812956,DOC 1,A02,259137,Strom; Megan C.,14,0,15,1
1683337812956,DOC 1,A03,259138,Strom; Megan C.,14,0,15,1
1683337812956,DOC 1,A04,259139,Strom; Megan C.,14,0,15,1
1683337813982,DOC 100D,A00,259140,Pass; Natalye Joann,16,0,25,9
1683337815008,DSGN 1,A01,184749,Rill; Bryan,0,25,30,30
1683337816094,DSGN 100,A01,185168,Staff,0,2,25,25
1683337817122,ECE 5,A01,185626,Morris; Karcher William,0,10,0,0
1683337818147,ECE 101,A01,185628,Staff,17,0,70,53
1683337819178,ECE 107,A01,185635,Baghdadchi; Saharnaz,0,0,20,20
1683337819178,ECE 107,A02,185638,Baghdadchi; Saharnaz,4,0,20,16
1683337820203,ECE 148,A01,185647,Silberman; Jack,0,0,16,16
1683337821234,ECON 1,A01,185537,Crane; Meredith Helen,54,0,70,16
1683337822262,ECON 3,A01,185549,Crane; Meredith Helen,33,0,70,37
1683337823287,ECON 4,A01,203354,Anderson; John Charles,0,4,10,10
1683337824318,ECON 100A,A01,185574,Staff,0,4,40,40
1683337825343,ECON 100B,A01,185576,Staff,10,22,50,40
1683337826373,ECON 100C,A01,185589,Newhouse; Herbert S,30,0,70,40
1683337827403,ECON 105,A00,185608,Vespa; Emanuel Ignacio,19,0,35,16
1683337828429,ECON 109,A01,185610,Shishkin; Denis,10,0,35,25
1683337829456,ECON 110A,A01,185612,Staff,11,0,40,29
1683337830487,ECON 120A,A01,185615,Staff,20,0,40,20
1683337831515,ECON 120C,A01,185617,Sun; Yixiao,0,20,70,70
1683337832541,ECON 144,A00,203346,Squires; Dale E,3,0,35,32
1683337833570,ECON 171,A01,203349,Newhouse; Herbert S,0,1,35,35
1683337834600,ECON 173A,A01,185621,Toda; Alexis Akira,21,0,35,14
1683337835625,EDS 25,A01,202413,Staff,0,1,0,0
1683337835625,EDS 25,A02,202414,Staff,0,1,0,0
1683337835625,EDS 25,A03,202415,Staff,0,0,0,0
1683337835625,EDS 25,A04,202416,Staff,0,1,0,0
1683337835625,EDS 25,A05,202439,Staff,0,0,0,0
1683337835625,EDS 25,A06,202440,Staff,0,0,0,0
1683337835625,EDS 25,B01,202631,Staff,0,0,0,0
1683337835625,EDS 25,B02,202632,Staff,0,0,0,0
1683337835625,EDS 25,B03,202639,Staff,0,0,0,0
1683337835625,EDS 25,B04,202640,Staff,0,0,0,0
1683337835625,EDS 25,B05,202643,Staff,0,0,0,0
1683337835625,EDS 25,B06,202644,Staff,0,0,0,0
1683337836651,EDS 38,A01,202659,Black; Alison Michelle,24,0,25,1
1683337837677,EDS 115,A00,202652,Staff,18,0,30,12
1683337838706,EDS 125,A00,202649,Staff,14,0,30,16
1683337839732,EDS 126,A01,203332,Staff,30,0,30,0
1683337840758,EDS 139,A00,202838,Staff,16,0,25,9
1683337841789,EDS 146,A01,202655,Staff,14,0,25,11
1683337842821,ENG 15,A00,185667,Staff,0,1,0,0
1683337842821,ENG 15,B00,185672,Staff,0,0,0,0
1683337842821,ENG 15,C00,185675,Staff,0,0,0,0
1683337842821,ENG 15,D00,185682,Staff,0,0,0,0
1683337842821,ENG 15,E00,185684,Staff,0,0,0,0
1683337843847,ETHN 103,A00,185710,Staff,0,3,35,35
1683337844873,ETHN 103A,A00,199228,Man; Simeon S,2,0,9,7
1683337845900,ETHN 109,A00,185711,Staff,18,0,35,17
1683337846928,ETHN 142,A00,185726,Staff,0,4,30,30
1683337847956,ETHN 163J,A00,199229,Man; Simeon S,5,0,8,3
1683337848990,ETHN 168,A00,185727,Staff,8,0,10,2
1683337850019,ETHN 182,A00,185728,Staff,1,0,35,34
1683337851044,ETHN 183,A00,185737,Staff,8,0,18,10
1683337852072,GLBH 111,A01,209361,Burgos; Jose L.,0,0,0,0
1683337854124,HIEU 104,A00,185792,Staff,16,0,20,4
1683337855150,HIEU 115,A00,185800,Staff,1,0,20,19
1683337856178,HIEU 128,A00,185801,Staff,0,7,20,20
1683337857204,HIEU 147,A00,185802,Staff,16,0,20,4
1683337858227,HIEU 154,A00,185823,Staff,12,0,20,8
1683337859251,HILA 102,A00,185826,Staff,13,0,20,7
1683337860275,HILD 2C,A01,185778,Staff,0,12,20,20
1683337861300,HILD 7B,A01,185780,Kwak; Nancy,0,15,32,32
1683337861300,HILD 7B,A02,185781,Kwak; Nancy,0,18,32,32
1683337862327,HILD 30,A01,185791,Staff,14,0,20,6
1683337863350,HISC 119,A00,185830,Golan; Tal,0,9,20,20
1683337864378,HITO 156GS,A00,185831,Patterson; Patrick H.,0,0,0,23
1683337865403,HIUS 103,A00,185832,Man; Simeon S,0,6,20,20
1683337866432,HIUS 117,A00,185836,Kwak; Nancy,2,0,20,18
1683337867460,HIUS 125,A00,185840,Man; Simeon S,0,0,23,23
1683337868489,HIUS 149,A00,185845,Staff,0,0,20,20
1683337869515,HUM 3,A01,185882,Zavodny; Tatiana Sophia,0,7,50,50
1683337869515,HUM 3,B01,185899,Caldwell; Michael Alan,0,18,50,50
1683337870545,HUM 3GS,A00,185900,Patterson; Patrick H.,0,0,0,23
1683337871578,HUM 4,A01,185938,Zroka; Amy Liane,31,0,50,19
1683337871578,HUM 4,B01,185956,Watkins; Eric,0,2,50,50
1683337871578,HUM 4,B02,202209,Watkins; Eric,0,2,50,50
1683337871578,HUM 4,B03,202210,Watkins; Eric,0,2,50,50
1683337872654,HUM 5,A01,185958,West; Geoffrey Scott,3,0,50,47
1683337872654,HUM 5,A02,202215,West; Geoffrey Scott,0,0,50,50
1683337873679,INTL 190,A00,185959,Gagnon; Jeffrey C,0,0,0,9
1683337873679,INTL 190,B00,185960,Lettieri; Michael Joseph,0,0,0,1
1683337874704,JAPN 180,A00,254509,Staff,5,1,30,25
1683337875734,LATI 10,A01,202853,Kennemore; Amy Michelle,4,0,35,31
1683337875734,LATI 10,A02,202854,Kennemore; Amy Michelle,2,0,35,33
1683337875734,LATI 10,A03,270054,Kennemore; Amy Michelle,30,0,30,0
1683337876762,LATI 180,A00,202855,Kennemore; Amy Michelle,11,0,20,9
1683337877791,LAWS 101,A00,201767,Golan; Tal,0,7,40,40
1683337878821,LIFR 1C,A00,185961,Staff,6,0,20,14
1683337879849,LIFR 1CX,A00,185962,Staff,7,0,20,13
1683337880878,LIFR 1D,A00,185963,Staff,9,0,20,11
1683337881904,LIFR 1DX,A00,185964,Staff,9,0,20,11
1683337882932,LIGN 101,A01,186039,Staff,43,0,50,7
1683337883961,LIGN 165,A00,186040,Staff,18,0,50,32
1683337884990,LTCS 108,A00,186041,Staff,6,0,10,4
1683337886017,LTCS 119,A00,186042,Staff,16,0,20,4
1683337887046,LTCS 130,A00,186043,Wesling; Megan E.,15,0,25,10
1683337889098,LTEA 138,A00,186119,Staff,14,0,40,26
1683337890123,LTEN 124,A00,186148,Staff,6,0,25,19
1683337891151,LTEN 178,A00,186149,Staff,7,0,15,8
1683337892177,LTEN 181,A00,186150,Blanco; John D,33,0,40,7
1683337893203,LTWL 120,A00,186160,Staff,20,0,25,5
1683337894230,LTWL 165,A00,186161,Staff,22,0,25,3
1683337895257,LTWR 100,A00,186162,Staff,0,5,15,15
1683337896284,LTWR 102,A00,186163,Doller; Ben,5,0,15,10
1683337897308,MAE 8,A01,186412,Staff,0,0,0,0
1683337898333,MAE 30B,A00,186445,Bahadori; Mohammad Yousef,83,0,100,17
1683337899360,MAE 40,A00,186592,Bewley; Thomas R,9,0,50,41
1683337900384,MAE 101B,A00,186593,Bahadori; Mohammad Yousef,81,0,100,19
1683337901410,MAE 105,A00,186594,Bandaru; Prabhakar,12,0,50,38
1683337902438,MAE 107,A00,186599,Pham; Hieu Tan,0,6,120,120
1683337903467,MAE 148,A01,186660,Silberman; Jack,3,0,16,13
1683337904496,MATH 10A,A01,188095,Staff,1,6,35,34
1683337905523,MATH 10B,A01,188097,Bowers; Adam R.,0,11,30,30
1683337905523,MATH 10B,A02,188099,Bowers; Adam R.,0,11,30,30
1683337905523,MATH 10B,B01,188104,Bowers; Adam R.,0,10,30,30
1683337905523,MATH 10B,B02,188106,Bowers; Adam R.,0,10,30,30
1683337906554,MATH 10C,A01,188111,Staff,0,18,30,30
1683337906554,MATH 10C,A02,188127,Staff,0,17,30,30
1683337906554,MATH 10C,A03,188131,Staff,0,18,30,30
1683337906554,MATH 10C,B01,188218,Staff,18,0,30,12
1683337906554,MATH 10C,B02,188244,Staff,13,0,30,17
1683337906554,MATH 10C,B03,188277,Staff,16,0,30,14
1683337907579,MATH 18,A01,188344,Bach; Quang Tran,18,0,30,12
1683337907579,MATH 18,A02,188345,Bach; Quang Tran,11,0,30,19
1683337907579,MATH 18,B01,188353,Bach; Quang Tran,10,0,30,20
1683337907579,MATH 18,B02,188354,Bach; Quang Tran,20,0,30,10
1683337908605,MATH 20A,A01,188374,Staff,13,0,35,22
1683337909630,MATH 20B,A01,188382,Ohm; Ko Woon,6,0,30,24
1683337909630,MATH 20B,A02,188383,Ohm; Ko Woon,22,0,30,8
1683337909630,MATH 20B,B01,188385,Ohm; Ko Woon,7,0,30,23
1683337909630,MATH 20B,B02,188392,Ohm; Ko Woon,22,0,30,8
1683337910665,MATH 20C,A01,188394,Harel; Guershon,10,0,30,20
1683337910665,MATH 20C,A02,188395,Harel; Guershon,15,0,30,15
1683337910665,MATH 20C,B01,188404,Harel; Guershon,5,0,30,25
1683337910665,MATH 20C,B02,188405,Harel; Guershon,19,0,30,11
1683337911692,MATH 20D,A01,188414,Hammock; Frances H,0,1,30,30
1683337911692,MATH 20D,A02,188415,Hammock; Frances H,3,0,30,27
1683337911692,MATH 20D,B01,188447,Hammock; Frances H,1,0,30,29
1683337911692,MATH 20D,B02,188486,Hammock; Frances H,8,0,30,22
1683337912720,MATH 20E,A01,188649,Staff,21,0,30,9
1683337912720,MATH 20E,A02,188650,Staff,23,0,30,7
1683337912720,MATH 20E,A03,188673,Staff,0,0,30,30
1683337913746,MATH 102,A01,188675,Staff,0,35,35,35
1683337914774,MATH 103B,A01,188681,Staff,3,0,35,32
1683337914774,MATH 103B,B01,188692,Staff,5,0,35,30
1683337915800,MATH 109,A01,188695,Salehi Golsefidy; Alireza,25,0,35,10
1683337915800,MATH 109,A02,188696,Salehi Golsefidy; Alireza,25,0,35,10
1683337916828,MATH 120A,A01,188698,Eggers; John Dietrich,7,0,35,28
1683337917852,MATH 142B,A01,188736,Ioana; Adrian,0,2,30,30
1683337917852,MATH 142B,A02,188741,Ioana; Adrian,1,1,30,29
1683337917852,MATH 142B,A03,188743,Ioana; Adrian,1,3,30,29
1683337918879,MATH 168A,A01,188790,Staff,0,9,35,35
1683337919960,MATH 170A,A01,188803,Nie; Jiawang,0,2,35,35
1683337919960,MATH 170A,A02,188811,Nie; Jiawang,0,0,35,35
1683337919960,MATH 170A,A03,188814,Nie; Jiawang,1,0,35,34
1683337919960,MATH 170A,A04,188815,Nie; Jiawang,13,0,35,22
1683337920989,MATH 193B,A01,188817,Staff,0,0,35,35
1683337920989,MATH 193B,A02,188818,Staff,5,0,35,30
1683337922013,MGT 4,A01,202857,Anderson; John Charles,62,0,80,18
1683337923042,MGT 12,A00,202858,Lindenberger; Wade Douglas,42,0,90,48
1683337924071,MGT 18,A00,202859,Staff,74,0,90,16
1683337925097,MGT 18GS,A00,202860,McKay; Michael J,13,0,28,15
1683337926123,MGT 45,A00,202861,Pecore; Joseph P.,14,0,90,76
1683337927149,MGT 100,A00,202863,Yavorsky; Daniel Ryan,28,0,90,62
1683337928176,MGT 103,A00,202864,Ehrich; Kristine R,1,18,90,89
1683337929202,MGT 112,A00,202865,Ehrich; Kristine R,15,0,90,75
1683337930226,MGT 121A,A00,202868,Staff,0,20,0,0
1683337931252,MGT 131B,A00,202869,Anderson; John Charles,59,0,90,31
1683337932279,MGT 136,A00,202871,Lindenberger; Wade Douglas,84,0,90,6
1683337933307,MGT 164,A00,202873,Staff,0,68,90,91
1683337934334,MGT 164GS,A00,202874,McKay; Mary A,13,0,28,15
1683337935361,MGT 180,A00,202875,Staff,0,50,90,91
1683337936386,MMW 11R,A01,205019,Herbst; Matthew,3,0,30,27
1683337936386,MMW 11R,A02,205026,Herbst; Matthew,29,0,30,1
1683337937417,MMW 15,A01,193512,Chang; Edmond Yi-Teh,0,9,28,28
1683337937417,MMW 15,A02,193513,Chang; Edmond Yi-Teh,0,5,28,28
1683337937417,MMW 15,A03,193514,Chang; Edmond Yi-Teh,0,5,28,28
1683337937417,MMW 15,A04,193515,Chang; Edmond Yi-Teh,0,5,28,28
1683337937417,MMW 15,A05,193516,Chang; Edmond Yi-Teh,0,4,28,28
1683337937417,MMW 15,A06,193517,Chang; Edmond Yi-Teh,0,5,28,28
1683337937417,MMW 15,B01,193519,Chang; Edmond Yi-Teh,0,5,28,28
1683337937417,MMW 15,B02,193520,Chang; Edmond Yi-Teh,0,5,28,28
1683337937417,MMW 15,B03,193521,Chang; Edmond Yi-Teh,0,5,28,28
1683337937417,MMW 15,B04,193522,Chang; Edmond Yi-Teh,0,4,28,28
1683337937417,MMW 15,B05,193523,Chang; Edmond Yi-Teh,0,5,28,28
1683337937417,MMW 15,B06,193524,Chang; Edmond Yi-Teh,0,4,28,28
1683337938446,MMW 122,A01,193526,Rahimi; Babak,0,15,28,28
1683337938446,MMW 122,A02,193527,Rahimi; Babak,0,14,28,28
1683337938446,MMW 122,A03,193528,Rahimi; Babak,0,0,0,0
1683337938446,MMW 122,A04,193529,Rahimi; Babak,0,0,0,0
1683337939476,MUS 1A,A01,186663,Staff,0,20,35,35
1683337940500,MUS 4,A01,186715,Staff,0,12,35,35
1683337941526,MUS 5R,A01,186796,Dubnov; Shlomo,0,17,35,35
1683337942556,MUS 6,A01,186798,Staff,0,4,25,25
1683337943582,MUS 7,A01,186830,Staff,13,0,35,22
1683337944607,MUS 8,A01,186930,Staff,0,26,35,35
1683337945634,MUS 15,A01,186932,Staff,0,16,35,35
1683337945634,MUS 15,B01,186934,Staff,0,15,35,35
1683337946660,MUS 80,A00,186935,Staff,1,0,20,19
1683337946660,MUS 80,B00,186936,Staff,25,0,25,0
1683337947686,NANO 11,A00,204702,Lipomi; Darren John,0,0,0,0
1683337948712,NANO 15,A01,204709,Yang; Kesong,0,1,0,0
1683337949742,NANO 114,A00,202069,Jahed Motlagh; Zeinab,3,0,10,7
1683337950766,PHIL 1,A00,186955,Grush; Rick Scott,32,0,40,8
1683337951796,PHIL 10,A01,186973,Grush; Rick Scott,28,0,35,7
1683337951796,PHIL 10,A02,186974,Grush; Rick Scott,33,0,35,2
1683337952825,PHIL 13,A01,186976,Staff,7,0,35,28
1683337952825,PHIL 13,A02,186977,Staff,16,0,35,19
1683337953854,PHIL 14,A01,186979,Staff,31,0,35,4
1683337953854,PHIL 14,A02,186986,Staff,32,0,35,3
1683337954880,PHIL 28,A01,186988,Staff,16,0,30,14
1683337954880,PHIL 28,A02,186989,Staff,1,0,30,29
1683337954880,PHIL 28,A03,186990,Staff,9,0,30,21
1683337954880,PHIL 28,A04,186991,Staff,26,0,30,4
1683337955905,PHIL 120,A00,186997,Staff,23,0,40,17
1683337956933,PHIL 137,A00,187003,Staff,9,0,40,31
1683337957958,PHIL 150,A00,187015,Staff,47,0,70,23
1683337958984,PHIL 167,A00,187021,Lamey; Andy M.,35,0,40,5
1683337960010,PHIL 174,A01,202226,Staff,17,0,20,3
1683337960010,PHIL 174,A02,202235,Staff,20,0,20,0
1683337961039,PHIL 191A,A00,258918,Staff,0,0,1,1
1683337962066,PHYS 1A,A00,187028,Staff,27,0,60,33
1683337963091,PHYS 1AL,001,187036,Staff,2,0,30,28
1683337963091,PHYS 1AL,002,187049,Staff,18,0,30,12
1683337964117,PHYS 1B,A00,187058,Staff,22,0,60,38
1683337965146,PHYS 1BL,001,187064,Staff,0,0,30,30
1683337965146,PHYS 1BL,002,187070,Staff,5,0,30,25
1683337966173,PHYS 1C,A00,187082,Staff,31,0,120,89
1683337967204,PHYS 1CL,001,187088,Staff,0,9,30,30
1683337967204,PHYS 1CL,002,187089,Staff,0,2,30,30
1683337967204,PHYS 1CL,009,262693,Staff,11,0,30,19
1683337968233,PHYS 2B,A01,187097,Staff,54,0,115,61
1683337969263,PHYS 2C,A01,187099,Staff,67,0,115,48
1683337970292,PHYS 2CL,A01,187101,Staff,5,0,28,23
1683337970292,PHYS 2CL,A02,187102,Staff,15,0,28,13
1683337971323,PHYS 2D,A01,187123,Shotwell; Brian,95,0,115,20
1683337972351,PHYS 4B,A01,187133,Grinstein; Benjamin,35,0,50,15
1683337973376,POLI 10,A00,188819,Staff,0,4,50,50
1683337974402,POLI 11,A00,188827,Staff,43,0,50,7
1683337975431,POLI 13R,A00,188828,Staff,0,1,20,20
1683337976456,POLI 27,A01,188830,Elgin; Samuel Zincke,0,1,70,70
1683337977483,POLI 30,A00,188832,Desposato; Scott,31,0,50,19
1683337978508,POLI 102F,A00,188834,Staff,3,0,40,37
1683337979534,POLI 104A,A00,188852,Staff,14,0,30,16
1683337980563,POLI 104I,A00,188853,Staff,0,6,20,20
1683337981592,POLI 110B,A00,188854,Wiens; David,7,0,20,13
1683337982621,POLI 112A,A00,188855,Wiens; David,5,0,30,25
1683337983651,POLI 117R,A00,188856,Forman; Fonna,0,11,20,20
1683337984676,POLI 118,A00,188857,Ingham; Sean,8,0,20,12
1683337985701,POLI 120G,A00,188858,Staff,9,0,30,21
1683337986726,POLI 131CR,A00,188863,Hoston; Germaine,24,0,50,26
1683337987752,POLI 133,A00,188864,Nellis; Gareth Hb,44,0,50,6
1683337988783,POLI 134D,A00,188865,Desposato; Scott,27,0,30,3
1683337989808,POLI 142A,A00,188871,Gartzke; Erik,22,0,50,28
1683337990835,POLI 142K,A00,188874,Staff,38,0,50,12
1683337991862,POLI 143,A00,188940,Gartzke; Erik,16,0,30,14
1683337992887,POLI 153,A00,188943,Staff,3,0,20,17
1683337993913,POLI 160AA,A00,188944,Staff,12,0,40,28
1683337994941,POLI 170A,A00,188945,Staff,11,0,30,19
1683337996996,PSYC 1,A00,188952,Staff,37,0,90,53
1683337998025,PSYC 2,B00,188953,Staff,19,0,35,16
1683337999051,PSYC 6,A00,188970,Staff,47,0,60,13
1683338000081,PSYC 7,A00,188973,Staff,37,0,45,8
1683338001107,PSYC 60,A01,188980,Rickard; Timothy C.,43,0,60,17
1683338002133,PSYC 70,A01,189001,Steiner; Eric Tomas,24,0,45,21
1683338003163,PSYC 100,A00,189005,Lacefield; Katharine I,0,99,120,120
1683338004189,PSYC 102,A00,189008,Staff,9,0,30,21
1683338005218,PSYC 106,B00,189026,Gorman; Michael R.,34,0,60,26
1683338006243,PSYC 114,B01,189033,Winkielman; Piotr,0,32,30,30
1683338007268,PSYC 131,A00,189036,Anagnostaras; Stephan,0,43,60,60
1683338008295,PSYC 136,A00,189041,Lowe; Angela Beth,0,7,25,25
1683338009319,PSYC 137,A00,189057,Winkielman; Piotr,0,34,25,25
1683338010346,PSYC 144,A00,189107,Wixted; John T,0,7,50,50
1683338012402,PSYC 162,A00,189142,Staff,0,8,85,85
1683338013432,PSYC 172,A00,189144,Gorman; Michael R.,0,7,30,30
1683338015486,PSYC 179,A00,189146,Lacefield; Katharine I,0,84,120,120
1683338016512,PSYC 181,A00,189147,Anagnostaras; Stephan,0,44,90,90
1683338017541,PSYC 190R,A00,189148,Barner; David A.,0,22,80,80
1683338018566,PSYC 191,A00,189275,Rickard; Timothy C.,0,7,25,25
1683338019592,PSYC 193,A00,189276,Chapman; Eddie Nathaniel,0,1,0,4
1683338020619,PSYC 193L,A01,189281,Lowe; Angela Beth,12,0,20,8
1683338020619,PSYC 193L,B01,189285,Staff,28,0,35,7
1683338021643,RELI 149,A00,187137,Rahimi; Babak,7,0,40,33
1683338022674,SE 9,A01,187315,Staff,0,2,18,18
1683338023770,SE 101B,A00,187409,Staff,24,0,30,6
1683338024796,SE 110B,A00,187444,Staff,10,0,40,30
1683338025820,SE 130B,A00,187449,Staff,31,0,40,9
1683338026844,SE 150A,A00,187516,Staff,9,0,20,11
1683338027871,SE 154,A00,187528,Staff,30,0,50,20
1683338028896,SIO 3,A01,258171,Staff,35,0,40,5
1683338029923,SIO 10,A00,187144,Cook; Geoffrey W,0,3,75,75
1683338030949,SIO 45,A00,187152,Cook; Geoffrey W,1,0,100,99
1683338031978,SIO 109R,A00,194486,Staff,0,3,20,20
1683338034028,SIO 187,A01,187233,Kacev; David,12,0,40,28
1683338035054,SOCI 1,A01,258656,Thorpe; Charles Robert,28,0,30,2
1683338035054,SOCI 1,A02,258658,Thorpe; Charles Robert,30,0,30,0
1683338035054,SOCI 1,A03,258661,Thorpe; Charles Robert,25,0,25,0
1683338035054,SOCI 1,A04,258666,Thorpe; Charles Robert,22,0,25,3
1683338035054,SOCI 1,A05,258897,Thorpe; Charles Robert,23,0,25,2
1683338035054,SOCI 1,A06,258898,Thorpe; Charles Robert,25,0,25,0
1683338036079,SOCI 30,A01,258903,Pardo Guerra; Juan Pablo,15,0,30,15
1683338037103,SOCI 102,A00,258904,Staff,9,0,25,16
1683338038128,SOCI 106,A00,258905,Staff,19,0,25,6
1683338039154,SOCI 111,A00,258907,Ribas Norris; Janet Vanesa,26,0,30,4
1683338040177,SOCI 121R,A00,258908,Pardo Guerra; Juan Pablo,10,0,30,20
1683338041201,SOCI 126,A01,203330,Staff,14,0,20,6
1683338042229,SOCI 131,A00,258909,Thorpe; Charles Robert,31,0,60,29
1683338043256,SOCI 135,A00,258910,Payne; Christine Anna,0,9,30,30
1683338044282,SOCI 157,A00,258911,Staff,12,0,30,18
1683338045310,SOCI 184,A00,258912,Staff,25,0,30,5
1683338046340,SOCI 188D,A00,258913,Staff,21,0,30,9
1683338047370,SYN 2,001,187529,Staff,10,0,16,6
1683338047370,SYN 2,002,201452,Staff,0,18,16,16
1683338047370,SYN 2,003,201469,Staff,3,0,16,13
1683338048396,SYN 100,A01,187531,Staff,0,9,20,20
1683338048396,SYN 100,B01,201491,Staff,0,12,20,20
1683338049426,TDAC 1,A00,189286,Walsh; Kim C.,3,0,20,17
1683338049426,TDAC 1,B00,189287,Harting; Carla Kelso,11,0,20,9
1683338050453,TDAC 101,A00,189300,Walsh; Kim C.,16,0,20,4
1683338050453,TDAC 101,B00,189301,Harting; Carla Kelso,18,0,20,2
1683338051482,TDAC 102,A00,189304,Basso; Beatrice,14,0,20,6
1683338052510,TDAC 108,A00,189305,Staff,18,0,20,2
1683338053537,TDDE 131,A00,189310,Staff,19,0,20,1
1683338053537,TDDE 131,B00,189314,Staff,19,0,20,1
1683338053537,TDDE 131,C00,189315,Staff,48,0,50,2
1683338053537,TDDE 131,D00,189316,Staff,14,0,15,1
1683338053537,TDDE 131,E00,204841,Staff,20,0,20,0
1683338054562,TDGE 10,A00,189289,Staff,30,0,50,20
1683338054562,TDGE 10,B00,189290,Havis; Allan,1,0,50,49
1683338055586,TDGE 11,A00,189291,Fulton; Julia,0,3,50,50
1683338055586,TDGE 11,B00,189292,Staff,20,0,25,5
1683338055586,TDGE 11,C00,260270,Staff,0,0,0,0
1683338056612,TDGE 25,A00,189294,Staff,3,0,20,17
1683338057640,TDGE 124,A00,189318,Fulton; Julia,0,8,50,50
1683338058671,TDGE 125,A00,189319,Staff,13,0,25,12
1683338058671,TDGE 125,B00,189320,Staff,23,0,25,2
1683338059697,TDGE 127,A00,189322,Havis; Allan,0,0,50,50
1683338060721,TDHT 101,A00,189323,Staff,18,0,25,7
1683338060721,TDHT 101,B00,189324,Staff,25,0,25,0
1683338061750,TDHT 102,A00,189325,Staff,49,0,50,1
1683338062776,TDMV 1,A00,189295,Arcidiacono; Kristin,19,0,30,11
1683338062776,TDMV 1,B00,189296,Caligagan; Maria T.,24,0,30,6
1683338063802,TDMV 2,A00,189297,Sammartano; Tonnie,28,0,30,2
1683338063802,TDMV 2,B00,189299,Arcidiacono; Kristin,24,0,30,6
1683338064828,TDMV 3,A00,204998,Rincon; Alicia,22,0,30,8
1683338065854,TDMV 120,A00,189458,Sammartano; Tonnie,28,0,30,2
1683338066880,TDMV 138,A00,189541,Jun; Grace Shin Hae,22,0,40,18
1683338067910,TDMV 142,A00,189717,Caligagan; Tony,23,0,30,7
1683338067910,TDMV 142,B00,189718,Caligagan; Maria T.,25,0,30,5
1683338068938,TMC 2,A01,187533,Staff,25,0,25,0
1683338068938,TMC 2,A02,187534,Staff,25,0,25,0
1683338069969,USP 1,A01,187536,Kwak; Nancy,0,16,25,25
1683338070993,USP 5,A01,187538,Staff,10,0,25,15
1683338072019,USP 101,A00,199253,Staff,0,4,0,0
1683338073044,USP 124,A00,187562,Boomhower; Matthew Charles,1,0,30,29
1683338074068,USP 138,A00,187582,Staff,20,0,25,5
1683338075094,USP 152,A01,187597,Staff,4,0,25,21
1683338076122,USP 153,A00,187598,Staff,19,0,25,6
1683338077150,USP 168,A00,187607,Kwak; Nancy,2,0,5,3
1683338078174,USP 173,A00,187619,Staff,4,0,25,21
1683338079200,USP 181,A00,187638,Staff,0,0,25,25
1683338080225,VIS 103,A00,187650,Cruz; Edwin Teddy,23,0,75,52
1683338081250,VIS 110D,A00,187669,Staff,12,0,22,10
1683338082275,VIS 127C,A00,187720,Shen; Kuiyi,67,0,146,79
1683338083300,VIS 149,A00,187731,Yoldas; Pinar,0,14,22,22
1683338084329,VIS 151,A01,188091,Staff,22,0,34,12
1683338084329,VIS 151,A02,188092,Staff,11,0,34,23
1683338085356,VIS 160B,A00,188093,Stalbaum; Brett,0,0,10,10
1683338087405,WCWP 10B,A00,201720,Staff,10,0,15,5
1683338087405,WCWP 10B,B00,201722,Staff,9,0,15,6
1683338088434,WCWP 100,A00,201725,Gagnon; Jeffrey C,0,0,2,2
1683338088434,WCWP 100,B00,201727,Staff,0,4,15,15
1683338091563,ANBI 133,A00,258401,Wilder; Linnea Lorene,34,0,40,6
1683338092587,ANBI 140,A00,258395,Hrvoj Mihic; Branka,18,0,25,7
1683338093615,ANSC 120,A00,258402,Bialecki; Jon Anthony,27,0,40,13
1683338094642,ANSC 144,A00,258400,Staff,14,0,40,26
1683338096696,ANSC 166,A00,258396,Parish; Steven Martin,157,0,175,18
1683338097722,ANSC 180,A00,193533,Staff,9,0,20,11
1683338098752,ANSC 188,A00,258397,Jassal; Aftab,33,0,40,7
1683338099777,ANTH 3,A01,258316,Staff,23,0,30,7
1683338100805,ANTH 5,A00,258394,Semendeferi; Ekaterini,16,0,20,4
1683338101834,ANTH 21,A01,258331,Staff,8,0,40,32
1683338102865,ANTH 103,A00,258398,Varma; Saiba,15,0,25,10
1683338103898,AWP 10,001,202034,Staff,0,0,0,0
1683338103898,AWP 10,002,202035,Staff,0,0,0,0
1683338103898,AWP 10,003,202036,Staff,0,0,0,0
1683338103898,AWP 10,004,202037,Staff,0,0,0,0
1683338103898,AWP 10,005,202038,Staff,0,0,0,0
1683338103898,AWP 10,006,202039,Staff,0,0,0,0
1683338103898,AWP 10,007,202040,Staff,0,0,0,0
1683338103898,AWP 10,008,202041,Staff,0,0,0,0
1683338103898,AWP 10,009,202042,Staff,0,0,0,0
1683338103898,AWP 10,010,202043,Staff,0,0,0,0
1683338103898,AWP 10,011,202044,Staff,0,0,0,0
1683338103898,AWP 10,012,202045,Staff,0,0,0,0
1683338103898,AWP 10,013,202046,Staff,0,0,0,0
1683338103898,AWP 10,014,202047,Staff,0,0,0,0
1683338103898,AWP 10,015,202048,Staff,0,0,0,0
1683338103898,AWP 10,016,202049,Staff,0,0,0,0
1683338103898,AWP 10,017,202050,Staff,0,0,0,0
1683338103898,AWP 10,018,202051,Staff,0,0,0,0
1683338103898,AWP 10,019,202052,Staff,0,0,0,0
1683338103898,AWP 10,020,202053,Staff,0,0,0,0
1683338103898,AWP 10,021,202054,Staff,0,0,0,0
1683338103898,AWP 10,022,202055,Staff,0,0,0,0
1683338103898,AWP 10,023,202056,Staff,0,0,0,0
1683338103898,AWP 10,024,202057,Staff,0,0,0,0
1683338103898,AWP 10,025,202058,Staff,0,0,0,0
1683338103898,AWP 10,026,202059,Staff,0,0,0,0
1683338104927,AWP 102,001,202032,Staff,0,0,0,0
1683338104927,AWP 102,002,202033,Staff,0,0,0,0
1683338105956,BENG 100,A01,254234,Taylor Amos; Alyssa C,31,0,40,9
1683338106983,BENG 196,001,270013,Engler; Adam J.,9999,0,9999,0
1683338108010,BICD 100R,A01,202018,Smith; Laurie,0,7,32,32
1683338108010,BICD 100R,A02,202019,Smith; Laurie,0,2,32,32
1683338108010,BICD 100R,A03,202020,Smith; Laurie,0,1,32,32
1683338108010,BICD 100R,A04,202021,Smith; Laurie,9,0,32,23
1683338108010,BICD 100R,A05,202022,Smith; Laurie,12,0,32,20
1683338109038,BICD 136,A01,193242,Gustafson-Brown; Cindy,0,2,32,32
1683338109038,BICD 136,A02,193244,Gustafson-Brown; Cindy,14,0,32,18
1683338110065,BIEB 102,A01,193249,Butler; Shannon Rhey,0,2,32,32
1683338110065,BIEB 102,A02,193251,Butler; Shannon Rhey,0,0,32,32
1683338110065,BIEB 102,A03,193253,Butler; Shannon Rhey,0,1,32,32
1683338110065,BIEB 102,A04,193255,Butler; Shannon Rhey,17,0,32,15
1683338110065,BIEB 102,A05,193265,Butler; Shannon Rhey,26,0,32,6
1683338110065,BIEB 102,A06,193269,Butler; Shannon Rhey,16,0,32,16
1683338112119,BIEB 150,A01,193274,Staff,0,0,32,32
1683338112119,BIEB 150,A02,193285,Staff,23,0,32,9
1683338113144,BIEB 194,A00,193286,Kurle; Carolyn M.,22,0,32,10
1683338114170,BILD 1,A01,192291,Staff,16,0,32,16
1683338114170,BILD 1,A02,192292,Staff,30,0,32,2
1683338114170,BILD 1,B01,192520,Reuther; Keefe,0,1,0,0
1683338114170,BILD 1,B02,192532,Reuther; Keefe,0,1,0,0
1683338115198,BILD 3,A01,192556,Butler; Shannon Rhey,0,0,32,32
1683338115198,BILD 3,A02,192581,Butler; Shannon Rhey,5,0,32,27
1683338115198,BILD 3,A03,192611,Butler; Shannon Rhey,23,0,32,9
1683338115198,BILD 3,A04,192612,Butler; Shannon Rhey,25,0,32,7
1683338115198,BILD 3,A05,192613,Butler; Shannon Rhey,27,0,32,5
1683338115198,BILD 3,A06,192679,Butler; Shannon Rhey,27,0,32,5
1683338115198,BILD 3,A07,192682,Butler; Shannon Rhey,22,0,32,10
1683338116222,BILD 4,A01,192836,Reuther; Keefe,0,0,24,24
1683338116222,BILD 4,A02,193044,Reuther; Keefe,4,0,24,20
1683338117245,BILD 10,A01,193142,Gustafson-Brown; Cindy,30,0,32,2
1683338117245,BILD 10,A02,193149,Gustafson-Brown; Cindy,31,0,32,1
1683338118275,BIMM 100,A01,193301,Staff,0,6,32,32
1683338118275,BIMM 100,A02,193312,Staff,0,5,32,32
1683338118275,BIMM 100,A03,193323,Staff,0,8,32,32
1683338119303,BIMM 101,A01,193329,McDonnell; Lisa Marie,0,3,24,24
1683338119303,BIMM 101,A02,193339,McDonnell; Lisa Marie,0,3,24,24
1683338119303,BIMM 101,B01,193354,McDonnell; Lisa Marie,0,3,24,24
1683338119303,BIMM 101,B02,193357,McDonnell; Lisa Marie,0,3,24,24
1683338120332,BIMM 110,A01,193377,Tat; John,0,11,32,32
1683338120332,BIMM 110,A02,193378,Tat; John,1,9,32,31
1683338121355,BIMM 120,A01,206116,Staff,0,0,32,32
1683338121355,BIMM 120,A02,206117,Staff,8,0,32,24
1683338121355,BIMM 120,A03,206121,Staff,21,0,32,11
1683338122388,BIPN 100,A01,193393,Park; Ji Young,0,14,32,32
1683338122388,BIPN 100,A02,193402,Park; Ji Young,0,13,32,32
1683338122388,BIPN 100,A03,193413,Park; Ji Young,0,14,32,32
1683338122388,BIPN 100,A04,193414,Park; Ji Young,0,13,32,32
1683338123417,BIPN 102,A01,193429,Staff,0,0,32,32
1683338123417,BIPN 102,A02,193438,Staff,22,0,32,10
1683338124442,BIPN 106,A01,193450,Reyes Gonzalez; Catalina,0,2,40,40
1683338125473,BIPN 134,A01,193465,Cooke; James Edward,0,0,32,32
1683338125473,BIPN 134,A02,193474,Cooke; James Edward,25,0,32,7
1683338125473,BIPN 134,A03,193485,Cooke; James Edward,29,0,32,3
1683338125473,BIPN 134,A04,193486,Cooke; James Edward,21,0,32,11
1683338125473,BIPN 134,A05,193491,Cooke; James Edward,31,0,32,1
1683338125473,BIPN 134,A06,193501,Cooke; James Edward,30,0,32,2
1683338125473,BIPN 134,A07,193510,Cooke; James Edward,29,0,32,3
1683338127582,BISP 194,A00,222522,Staff,14,0,32,18
1683338128611,CAT 124,A01,202407,Staff,20,0,25,5
1683338129640,CAT 125,A00,202408,Marchisotto; Jennifer Anne,4,0,20,16
1683338130671,CAT 125R,A00,202409,Smith; Lauryn Alissa,0,11,20,20
1683338130671,CAT 125R,B00,202410,Morales; Celeste Georgianna,0,11,20,20
1683338130671,CAT 125R,C00,202411,Irwin; Matthew Joseph,0,10,20,20
1683338131696,CENG 15,A01,204712,Yang; Kesong,0,1,0,0
1683338132721,CENG 114,A00,202070,Jahed Motlagh; Zeinab,5,0,20,15
1683338133746,CGS 105,A00,185477,Wesling; Megan E.,24,0,40,16
1683338134771,CGS 106,A00,185494,Staff,13,0,22,9
1683338135798,CGS 108,A00,185495,Staff,14,0,20,6
1683338136824,CGS 114,A00,185496,Staff,13,0,18,5
1683338137853,CGS 119,A00,185501,Staff,15,0,20,5
1683338138881,CGS 120,A00,185511,Staff,13,0,20,7
1683338139912,CHEM 4,A01,184675,Bussey; Thomas J,96,0,100,4
1683338140940,CHEM 6A,A01,184677,Staff,34,0,60,26
1683338141964,CHEM 6B,A01,184679,Staff,65,0,100,35
1683338142991,CHEM 6C,A01,184681,Bussey; Thomas J,1,0,50,49
1683338142991,CHEM 6C,A02,184682,Bussey; Thomas J,34,0,50,16
1683338144018,CHEM 40A,A01,184684,Albizati; Kim F.,37,0,100,63
1683338145047,CHEM 40B,A01,184686,Albizati; Kim F.,0,20,100,100
1683338146072,CHEM 41B,A01,184690,Staff,52,0,100,48
1683338147099,COGS 3,A01,184715,Boyle; Mary E. T.,0,25,40,40
1683338148129,COGS 14B,A01,185172,Staff,0,15,38,38
1683338149154,COGS 18,A01,184736,Staff,17,0,80,63
1683338150307,COGS 100,A01,184932,Staff,0,5,73,73
1683338151335,COGS 101A,A01,184935,Staff,0,39,30,30
1683338152364,COGS 101B,A01,184944,Staff,0,2,30,30
1683338153388,COGS 101C,A01,184946,Staff,0,12,30,30
1683338154414,COGS 102A,A01,184951,Johnson; Christine M.,2,0,40,38
1683338155438,COGS 107B,A01,184953,Mooshagian; Eric Frederick,0,50,40,40
1683338156465,COGS 118B,A01,184959,Gupta; Anjum,0,48,40,40
1683338157492,COGS 153,A00,184961,Staff,0,15,30,30
1683338158518,COGS 177,A00,184962,Staff,0,20,30,30
1683338159546,COGS 187A,A01,184969,Boyle; Mary E. T.,0,17,40,40
1683338160574,COMM 10,A01,185174,Staff,0,5,25,25
1683338160574,COMM 10,A02,185189,Staff,0,5,25,25
1683338160574,COMM 10,A03,269821,Staff,0,0,0,0
1683338161605,COMM 100B,A01,185475,Staff,0,0,0,2
1683338161605,COMM 100B,A02,185476,Staff,13,0,25,12
1683338162630,COMM 100C,A01,185314,Staff,1,0,25,24
1683338162630,COMM 100C,A02,185327,Staff,19,0,25,6
1683338163656,COMM 110M,A00,185349,Staff,2,0,40,38
1683338164681,COMM 113T,A00,185352,Staff,24,0,40,16
1683338165732,COMM 114I,A00,185353,Staff,33,0,40,7
1683338166760,COMM 131,A00,185354,Staff,19,0,30,11
1683338167792,CSE 8A,A50,185358,Cao; Yingjun,0,46,10,10
1683338168824,CSE 8B,A01,185362,Staff,1,47,50,49
1683338169852,CSE 11,A01,185416,Cao; Yingjun,0,92,10,10
1683338170880,CSE 20,A01,185445,Briones; Jor-el Thomas Caparas,5,0,25,20
1683338171908,CSE 21,A01,185447,Staff,10,0,50,40
1683338172936,CSE 101,A01,185451,Staff,0,13,50,50
1683338172936,CSE 101,B01,185453,Jones; Miles E,0,11,50,50
1683338174991,CSE 141,A01,185458,Eldon; John,20,0,100,80
1683338176019,CSE 141L,A01,185461,Eldon; John,12,0,100,88
1683338177047,CSE 142,A01,185463,Staff,36,0,60,24
1683338177047,CSE 142,B01,201355,Staff,0,7,60,60
1683338178074,CSE 142L,A01,185470,Staff,36,0,60,24
1683338178074,CSE 142L,B01,201417,Staff,0,6,60,60
1683338179099,CSE 190,A00,201433,Staff,32,0,49,17
1683338180125,DOC 1,A01,259136,Strom; Megan C.,7,0,15,8
1683338180125,DOC 1,A02,259137,Strom; Megan C.,14,0,15,1
1683338180125,DOC 1,A03,259138,Strom; Megan C.,14,0,15,1
1683338180125,DOC 1,A04,259139,Strom; Megan C.,14,0,15,1
1683338181151,DOC 100D,A00,259140,Pass; Natalye Joann,16,0,25,9
1683338182177,DSGN 1,A01,184749,Rill; Bryan,0,25,30,30
1683338183201,DSGN 100,A01,185168,Staff,0,2,25,25
1683338184226,ECE 5,A01,185626,Morris; Karcher William,0,10,0,0
1683338185249,ECE 101,A01,185628,Staff,17,0,70,53
1683338186277,ECE 107,A01,185635,Baghdadchi; Saharnaz,0,0,20,20
1683338186277,ECE 107,A02,185638,Baghdadchi; Saharnaz,4,0,20,16
1683338187303,ECE 148,A01,185647,Silberman; Jack,0,0,16,16
1683338188326,ECON 1,A01,185537,Crane; Meredith Helen,54,0,70,16
1683338189355,ECON 3,A01,185549,Crane; Meredith Helen,33,0,70,37
1683338190385,ECON 4,A01,203354,Anderson; John Charles,0,4,10,10
1683338191410,ECON 100A,A01,185574,Staff,0,4,40,40
1683338192440,ECON 100B,A01,185576,Staff,10,22,50,40
1683338193466,ECON 100C,A01,185589,Newhouse; Herbert S,30,0,70,40
1683338194492,ECON 105,A00,185608,Vespa; Emanuel Ignacio,19,0,35,16
1683338195515,ECON 109,A01,185610,Shishkin; Denis,10,0,35,25
1683338196540,ECON 110A,A01,185612,Staff,11,0,40,29
1683338197564,ECON 120A,A01,185615,Staff,20,0,40,20
1683338198590,ECON 120C,A01,185617,Sun; Yixiao,0,20,70,70
1683338199615,ECON 144,A00,203346,Squires; Dale E,3,0,35,32
1683338200641,ECON 171,A01,203349,Newhouse; Herbert S,0,1,35,35
1683338201666,ECON 173A,A01,185621,Toda; Alexis Akira,21,0,35,14
1683338202698,EDS 25,A01,202413,Staff,0,1,0,0
1683338202698,EDS 25,A02,202414,Staff,0,1,0,0
1683338202698,EDS 25,A03,202415,Staff,0,0,0,0
1683338202698,EDS 25,A04,202416,Staff,0,1,0,0
1683338202698,EDS 25,A05,202439,Staff,0,0,0,0
1683338202698,EDS 25,A06,202440,Staff,0,0,0,0
1683338202698,EDS 25,B01,202631,Staff,0,0,0,0
1683338202698,EDS 25,B02,202632,Staff,0,0,0,0
1683338202698,EDS 25,B03,202639,Staff,0,0,0,0
1683338202698,EDS 25,B04,202640,Staff,0,0,0,0
1683338202698,EDS 25,B05,202643,Staff,0,0,0,0
1683338202698,EDS 25,B06,202644,Staff,0,0,0,0
1683338203727,EDS 38,A01,202659,Black; Alison Michelle,24,0,25,1
1683338204754,EDS 115,A00,202652,Staff,18,0,30,12
1683338205779,EDS 125,A00,202649,Staff,14,0,30,16
1683338206803,EDS 126,A01,203332,Staff,30,0,30,0
1683338207828,EDS 139,A00,202838,Staff,16,0,25,9
1683338208855,EDS 146,A01,202655,Staff,14,0,25,11
1683338209882,ENG 15,A00,185667,Staff,0,1,0,0
1683338209882,ENG 15,B00,185672,Staff,0,0,0,0
1683338209882,ENG 15,C00,185675,Staff,0,0,0,0
1683338209882,ENG 15,D00,185682,Staff,0,0,0,0
1683338209882,ENG 15,E00,185684,Staff,0,0,0,0
1683338210910,ETHN 103,A00,185710,Staff,0,3,35,35
1683338211939,ETHN 103A,A00,199228,Man; Simeon S,2,0,9,7
1683338212966,ETHN 109,A00,185711,Staff,18,0,35,17
1683338213994,ETHN 142,A00,185726,Staff,0,4,30,30
1683338215020,ETHN 163J,A00,199229,Man; Simeon S,5,0,8,3
1683338216046,ETHN 168,A00,185727,Staff,8,0,10,2
1683338217071,ETHN 182,A00,185728,Staff,1,0,35,34
1683338218097,ETHN 183,A00,185737,Staff,8,0,18,10
1683338219121,GLBH 111,A01,209361,Burgos; Jose L.,0,0,0,0
1683338221178,HIEU 104,A00,185792,Staff,16,0,20,4
1683338222204,HIEU 115,A00,185800,Staff,1,0,20,19
1683338223231,HIEU 128,A00,185801,Staff,0,7,20,20
1683338224258,HIEU 147,A00,185802,Staff,16,0,20,4
1683338225283,HIEU 154,A00,185823,Staff,12,0,20,8
1683338226307,HILA 102,A00,185826,Staff,13,0,20,7
1683338227333,HILD 2C,A01,185778,Staff,0,12,20,20
1683338228363,HILD 7B,A01,185780,Kwak; Nancy,0,15,32,32
1683338228363,HILD 7B,A02,185781,Kwak; Nancy,0,18,32,32
1683338229389,HILD 30,A01,185791,Staff,14,0,20,6
1683338230414,HISC 119,A00,185830,Golan; Tal,0,9,20,20
1683338231496,HITO 156GS,A00,185831,Patterson; Patrick H.,0,0,0,23
1683338232521,HIUS 103,A00,185832,Man; Simeon S,0,6,20,20
1683338233546,HIUS 117,A00,185836,Kwak; Nancy,2,0,20,18
1683338234570,HIUS 125,A00,185840,Man; Simeon S,0,0,23,23
1683338235595,HIUS 149,A00,185845,Staff,0,0,20,20
1683338236625,HUM 3,A01,185882,Zavodny; Tatiana Sophia,0,7,50,50
1683338236625,HUM 3,B01,185899,Caldwell; Michael Alan,0,18,50,50
1683338237652,HUM 3GS,A00,185900,Patterson; Patrick H.,0,0,0,23
1683338238682,HUM 4,A01,185938,Zroka; Amy Liane,31,0,50,19
1683338238682,HUM 4,B01,185956,Watkins; Eric,0,2,50,50
1683338238682,HUM 4,B02,202209,Watkins; Eric,0,2,50,50
1683338238682,HUM 4,B03,202210,Watkins; Eric,0,2,50,50
1683338239712,HUM 5,A01,185958,West; Geoffrey Scott,3,0,50,47
1683338239712,HUM 5,A02,202215,West; Geoffrey Scott,0,0,50,50
1683338240737,INTL 190,A00,185959,Gagnon; Jeffrey C,0,0,0,9
1683338240737,INTL 190,B00,185960,Lettieri; Michael Joseph,0,0,0,1
1683338241765,JAPN 180,A00,254509,Staff,5,1,30,25
1683338242810,LATI 10,A01,202853,Kennemore; Amy Michelle,4,0,35,31
1683338242810,LATI 10,A02,202854,Kennemore; Amy Michelle,2,0,35,33
1683338242810,LATI 10,A03,270054,Kennemore; Amy Michelle,30,0,30,0
1683338243834,LATI 180,A00,202855,Kennemore; Amy Michelle,11,0,20,9
1683338244861,LAWS 101,A00,201767,Golan; Tal,0,7,40,40
1683338245889,LIFR 1C,A00,185961,Staff,6,0,20,14
1683338246916,LIFR 1CX,A00,185962,Staff,7,0,20,13
1683338247945,LIFR 1D,A00,185963,Staff,9,0,20,11
1683338248975,LIFR 1DX,A00,185964,Staff,9,0,20,11
1683338250000,LIGN 101,A01,186039,Staff,43,0,50,7
1683338251025,LIGN 165,A00,186040,Staff,18,0,50,32
1683338252050,LTCS 108,A00,186041,Staff,6,0,10,4
1683338253075,LTCS 119,A00,186042,Staff,16,0,20,4
1683338254103,LTCS 130,A00,186043,Wesling; Megan E.,15,0,25,10
1683338256153,LTEA 138,A00,186119,Staff,14,0,40,26
1683338257178,LTEN 124,A00,186148,Staff,6,0,25,19
1683338258202,LTEN 178,A00,186149,Staff,7,0,15,8
1683338259230,LTEN 181,A00,186150,Blanco; John D,33,0,40,7
1683338260255,LTWL 120,A00,186160,Staff,20,0,25,5
1683338261281,LTWL 165,A00,186161,Staff,22,0,25,3
1683338262306,LTWR 100,A00,186162,Staff,0,5,15,15
1683338263334,LTWR 102,A00,186163,Doller; Ben,5,0,15,10
1683338264361,MAE 8,A01,186412,Staff,0,0,0,0
1683338265386,MAE 30B,A00,186445,Bahadori; Mohammad Yousef,83,0,100,17
1683338266415,MAE 40,A00,186592,Bewley; Thomas R,9,0,50,41
1683338267444,MAE 101B,A00,186593,Bahadori; Mohammad Yousef,81,0,100,19
1683338268472,MAE 105,A00,186594,Bandaru; Prabhakar,12,0,50,38
1683338269497,MAE 107,A00,186599,Pham; Hieu Tan,0,6,120,120
1683338270523,MAE 148,A01,186660,Silberman; Jack,3,0,16,13
1683338271551,MATH 10A,A01,188095,Staff,1,6,35,34
1683338272581,MATH 10B,A01,188097,Bowers; Adam R.,0,11,30,30
1683338272581,MATH 10B,A02,188099,Bowers; Adam R.,0,11,30,30
1683338272581,MATH 10B,B01,188104,Bowers; Adam R.,0,10,30,30
1683338272581,MATH 10B,B02,188106,Bowers; Adam R.,0,10,30,30
1683338273606,MATH 10C,A01,188111,Staff,0,18,30,30
1683338273606,MATH 10C,A02,188127,Staff,0,17,30,30
1683338273606,MATH 10C,A03,188131,Staff,0,18,30,30
1683338273606,MATH 10C,B01,188218,Staff,18,0,30,12
1683338273606,MATH 10C,B02,188244,Staff,13,0,30,17
1683338273606,MATH 10C,B03,188277,Staff,16,0,30,14
1683338274635,MATH 18,A01,188344,Bach; Quang Tran,18,0,30,12
1683338274635,MATH 18,A02,188345,Bach; Quang Tran,11,0,30,19
1683338274635,MATH 18,B01,188353,Bach; Quang Tran,10,0,30,20
1683338274635,MATH 18,B02,188354,Bach; Quang Tran,20,0,30,10
1683338275658,MATH 20A,A01,188374,Staff,13,0,35,22
1683338276684,MATH 20B,A01,188382,Ohm; Ko Woon,6,0,30,24
1683338276684,MATH 20B,A02,188383,Ohm; Ko Woon,22,0,30,8
1683338276684,MATH 20B,B01,188385,Ohm; Ko Woon,7,0,30,23
1683338276684,MATH 20B,B02,188392,Ohm; Ko Woon,22,0,30,8
1683338277710,MATH 20C,A01,188394,Harel; Guershon,10,0,30,20
1683338277710,MATH 20C,A02,188395,Harel; Guershon,15,0,30,15
1683338277710,MATH 20C,B01,188404,Harel; Guershon,5,0,30,25
1683338277710,MATH 20C,B02,188405,Harel; Guershon,19,0,30,11
1683338278738,MATH 20D,A01,188414,Hammock; Frances H,0,1,30,30
1683338278738,MATH 20D,A02,188415,Hammock; Frances H,3,0,30,27
1683338278738,MATH 20D,B01,188447,Hammock; Frances H,1,0,30,29
1683338278738,MATH 20D,B02,188486,Hammock; Frances H,8,0,30,22
1683338279765,MATH 20E,A01,188649,Staff,21,0,30,9
1683338279765,MATH 20E,A02,188650,Staff,23,0,30,7
1683338279765,MATH 20E,A03,188673,Staff,0,0,30,30
1683338280792,MATH 102,A01,188675,Staff,0,35,35,35
1683338281821,MATH 103B,A01,188681,Staff,3,0,35,32
1683338281821,MATH 103B,B01,188692,Staff,5,0,35,30
1683338282846,MATH 109,A01,188695,Salehi Golsefidy; Alireza,25,0,35,10
1683338282846,MATH 109,A02,188696,Salehi Golsefidy; Alireza,25,0,35,10
1683338283872,MATH 120A,A01,188698,Eggers; John Dietrich,7,0,35,28
1683338284906,MATH 142B,A01,188736,Ioana; Adrian,0,2,30,30
1683338284906,MATH 142B,A02,188741,Ioana; Adrian,1,1,30,29
1683338284906,MATH 142B,A03,188743,Ioana; Adrian,1,3,30,29
1683338285934,MATH 168A,A01,188790,Staff,0,9,35,35
1683338286962,MATH 170A,A01,188803,Nie; Jiawang,0,2,35,35
1683338286962,MATH 170A,A02,188811,Nie; Jiawang,0,0,35,35
1683338286962,MATH 170A,A03,188814,Nie; Jiawang,1,0,35,34
1683338286962,MATH 170A,A04,188815,Nie; Jiawang,13,0,35,22
1683338287990,MATH 193B,A01,188817,Staff,0,0,35,35
1683338287990,MATH 193B,A02,188818,Staff,5,0,35,30
1683338289016,MGT 4,A01,202857,Anderson; John Charles,62,0,80,18
1683338290042,MGT 12,A00,202858,Lindenberger; Wade Douglas,42,0,90,48
1683338291068,MGT 18,A00,202859,Staff,74,0,90,16
1683338292093,MGT 18GS,A00,202860,McKay; Michael J,13,0,28,15
1683338293117,MGT 45,A00,202861,Pecore; Joseph P.,14,0,90,76
1683338294140,MGT 100,A00,202863,Yavorsky; Daniel Ryan,28,0,90,62
1683338295170,MGT 103,A00,202864,Ehrich; Kristine R,1,18,90,89
1683338296198,MGT 112,A00,202865,Ehrich; Kristine R,15,0,90,75
1683338297224,MGT 121A,A00,202868,Staff,0,20,0,0
1683338298249,MGT 131B,A00,202869,Anderson; John Charles,59,0,90,31
1683338299277,MGT 136,A00,202871,Lindenberger; Wade Douglas,84,0,90,6
1683338300307,MGT 164,A00,202873,Staff,0,68,90,91
1683338301333,MGT 164GS,A00,202874,McKay; Mary A,13,0,28,15
1683338302358,MGT 180,A00,202875,Staff,0,50,90,91
1683338303382,MMW 11R,A01,205019,Herbst; Matthew,3,0,30,27
1683338303382,MMW 11R,A02,205026,Herbst; Matthew,29,0,30,1
1683338304408,MMW 15,A01,193512,Chang; Edmond Yi-Teh,0,9,28,28
1683338304408,MMW 15,A02,193513,Chang; Edmond Yi-Teh,0,5,28,28
1683338304408,MMW 15,A03,193514,Chang; Edmond Yi-Teh,0,5,28,28
1683338304408,MMW 15,A04,193515,Chang; Edmond Yi-Teh,0,5,28,28
1683338304408,MMW 15,A05,193516,Chang; Edmond Yi-Teh,0,4,28,28
1683338304408,MMW 15,A06,193517,Chang; Edmond Yi-Teh,0,5,28,28
1683338304408,MMW 15,B01,193519,Chang; Edmond Yi-Teh,0,5,28,28
1683338304408,MMW 15,B02,193520,Chang; Edmond Yi-Teh,0,5,28,28
1683338304408,MMW 15,B03,193521,Chang; Edmond Yi-Teh,0,5,28,28
1683338304408,MMW 15,B04,193522,Chang; Edmond Yi-Teh,0,4,28,28
1683338304408,MMW 15,B05,193523,Chang; Edmond Yi-Teh,0,5,28,28
1683338304408,MMW 15,B06,193524,Chang; Edmond Yi-Teh,0,4,28,28
1683338305434,MMW 122,A01,193526,Rahimi; Babak,0,15,28,28
1683338305434,MMW 122,A02,193527,Rahimi; Babak,0,14,28,28
1683338305434,MMW 122,A03,193528,Rahimi; Babak,0,0,0,0
1683338305434,MMW 122,A04,193529,Rahimi; Babak,0,0,0,0
1683338306462,MUS 1A,A01,186663,Staff,0,20,35,35
1683338307491,MUS 4,A01,186715,Staff,0,12,35,35
1683338308517,MUS 5R,A01,186796,Dubnov; Shlomo,0,17,35,35
1683338309546,MUS 6,A01,186798,Staff,0,4,25,25
1683338310575,MUS 7,A01,186830,Staff,13,0,35,22
1683338311598,MUS 8,A01,186930,Staff,0,26,35,35
1683338312628,MUS 15,A01,186932,Staff,0,16,35,35
1683338312628,MUS 15,B01,186934,Staff,0,15,35,35
1683338313654,MUS 80,A00,186935,Staff,1,0,20,19
1683338313654,MUS 80,B00,186936,Staff,25,0,25,0
1683338314679,NANO 11,A00,204702,Lipomi; Darren John,0,0,0,0
1683338315706,NANO 15,A01,204709,Yang; Kesong,0,1,0,0
1683338316731,NANO 114,A00,202069,Jahed Motlagh; Zeinab,3,0,10,7
1683338317757,PHIL 1,A00,186955,Grush; Rick Scott,32,0,40,8
1683338318786,PHIL 10,A01,186973,Grush; Rick Scott,28,0,35,7
1683338318786,PHIL 10,A02,186974,Grush; Rick Scott,33,0,35,2
1683338319812,PHIL 13,A01,186976,Staff,7,0,35,28
1683338319812,PHIL 13,A02,186977,Staff,16,0,35,19
1683338320838,PHIL 14,A01,186979,Staff,31,0,35,4
1683338320838,PHIL 14,A02,186986,Staff,32,0,35,3
1683338321864,PHIL 28,A01,186988,Staff,16,0,30,14
1683338321864,PHIL 28,A02,186989,Staff,1,0,30,29
1683338321864,PHIL 28,A03,186990,Staff,9,0,30,21
1683338321864,PHIL 28,A04,186991,Staff,26,0,30,4
1683338322889,PHIL 120,A00,186997,Staff,23,0,40,17
1683338323915,PHIL 137,A00,187003,Staff,9,0,40,31
1683338324943,PHIL 150,A00,187015,Staff,47,0,70,23
1683338325972,PHIL 167,A00,187021,Lamey; Andy M.,35,0,40,5
1683338326996,PHIL 174,A01,202226,Staff,17,0,20,3
1683338326996,PHIL 174,A02,202235,Staff,20,0,20,0
1683338328026,PHIL 191A,A00,258918,Staff,0,0,1,1
1683338329048,PHYS 1A,A00,187028,Staff,27,0,60,33
1683338330073,PHYS 1AL,001,187036,Staff,2,0,30,28
1683338330073,PHYS 1AL,002,187049,Staff,18,0,30,12
1683338331099,PHYS 1B,A00,187058,Staff,22,0,60,38
1683338332125,PHYS 1BL,001,187064,Staff,0,0,30,30
1683338332125,PHYS 1BL,002,187070,Staff,5,0,30,25
1683338333150,PHYS 1C,A00,187082,Staff,31,0,120,89
1683338334174,PHYS 1CL,001,187088,Staff,0,9,30,30
1683338334174,PHYS 1CL,002,187089,Staff,0,2,30,30
1683338334174,PHYS 1CL,009,262693,Staff,11,0,30,19
1683338335257,PHYS 2B,A01,187097,Staff,54,0,115,61
1683338336282,PHYS 2C,A01,187099,Staff,67,0,115,48
1683338337307,PHYS 2CL,A01,187101,Staff,5,0,28,23
1683338337307,PHYS 2CL,A02,187102,Staff,15,0,28,13
1683338338331,PHYS 2D,A01,187123,Shotwell; Brian,95,0,115,20
1683338339357,PHYS 4B,A01,187133,Grinstein; Benjamin,35,0,50,15
1683338340384,POLI 10,A00,188819,Staff,0,4,50,50
1683338341412,POLI 11,A00,188827,Staff,43,0,50,7
1683338342438,POLI 13R,A00,188828,Staff,0,1,20,20
1683338343465,POLI 27,A01,188830,Elgin; Samuel Zincke,0,1,70,70
1683338344494,POLI 30,A00,188832,Desposato; Scott,31,0,50,19
1683338345522,POLI 102F,A00,188834,Staff,3,0,40,37
1683338346551,POLI 104A,A00,188852,Staff,14,0,30,16
1683338347578,POLI 104I,A00,188853,Staff,0,6,20,20
1683338348606,POLI 110B,A00,188854,Wiens; David,7,0,20,13
1683338349632,POLI 112A,A00,188855,Wiens; David,5,0,30,25
1683338350657,POLI 117R,A00,188856,Forman; Fonna,0,11,20,20
1683338351686,POLI 118,A00,188857,Ingham; Sean,8,0,20,12
1683338352712,POLI 120G,A00,188858,Staff,9,0,30,21
1683338353737,POLI 131CR,A00,188863,Hoston; Germaine,24,0,50,26
1683338354763,POLI 133,A00,188864,Nellis; Gareth Hb,44,0,50,6
1683338355789,POLI 134D,A00,188865,Desposato; Scott,27,0,30,3
1683338356817,POLI 142A,A00,188871,Gartzke; Erik,22,0,50,28
1683338357847,POLI 142K,A00,188874,Staff,38,0,50,12
1683338358873,POLI 143,A00,188940,Gartzke; Erik,16,0,30,14
1683338359901,POLI 153,A00,188943,Staff,3,0,20,17
1683338360926,POLI 160AA,A00,188944,Staff,12,0,40,28
1683338361952,POLI 170A,A00,188945,Staff,11,0,30,19
1683338364010,PSYC 1,A00,188952,Staff,37,0,90,53
1683338365036,PSYC 2,B00,188953,Staff,19,0,35,16
1683338366064,PSYC 6,A00,188970,Staff,47,0,60,13
1683338367092,PSYC 7,A00,188973,Staff,37,0,45,8
1683338368120,PSYC 60,A01,188980,Rickard; Timothy C.,43,0,60,17
1683338369148,PSYC 70,A01,189001,Steiner; Eric Tomas,24,0,45,21
1683338370177,PSYC 100,A00,189005,Lacefield; Katharine I,0,99,120,120
1683338371201,PSYC 102,A00,189008,Staff,9,0,30,21
1683338372227,PSYC 106,B00,189026,Gorman; Michael R.,34,0,60,26
1683338373254,PSYC 114,B01,189033,Winkielman; Piotr,0,32,30,30
1683338374277,PSYC 131,A00,189036,Anagnostaras; Stephan,0,43,60,60
1683338375303,PSYC 136,A00,189041,Lowe; Angela Beth,0,7,25,25
1683338376329,PSYC 137,A00,189057,Winkielman; Piotr,0,34,25,25
1683338377358,PSYC 144,A00,189107,Wixted; John T,0,7,50,50
1683338379416,PSYC 162,A00,189142,Staff,0,8,85,85
1683338380445,PSYC 172,A00,189144,Gorman; Michael R.,0,7,30,30
1683338382503,PSYC 179,A00,189146,Lacefield; Katharine I,0,84,120,120
1683338383532,PSYC 181,A00,189147,Anagnostaras; Stephan,0,44,90,90
1683338384558,PSYC 190R,A00,189148,Barner; David A.,0,22,80,80
1683338385583,PSYC 191,A00,189275,Rickard; Timothy C.,0,7,25,25
1683338386609,PSYC 193,A00,189276,Chapman; Eddie Nathaniel,0,1,0,4
1683338387635,PSYC 193L,A01,189281,Lowe; Angela Beth,12,0,20,8
1683338387635,PSYC 193L,B01,189285,Staff,28,0,35,7
1683338388660,RELI 149,A00,187137,Rahimi; Babak,7,0,40,33
1683338389685,SE 9,A01,187315,Staff,0,2,18,18
1683338390711,SE 101B,A00,187409,Staff,24,0,30,6
1683338391737,SE 110B,A00,187444,Staff,10,0,40,30
1683338392764,SE 130B,A00,187449,Staff,31,0,40,9
1683338393788,SE 150A,A00,187516,Staff,9,0,20,11
1683338394813,SE 154,A00,187528,Staff,30,0,50,20
1683338395841,SIO 3,A01,258171,Staff,35,0,40,5
1683338396867,SIO 10,A00,187144,Cook; Geoffrey W,0,3,75,75
1683338397893,SIO 45,A00,187152,Cook; Geoffrey W,1,0,100,99
1683338398918,SIO 109R,A00,194486,Staff,0,3,20,20
1683338400977,SIO 187,A01,187233,Kacev; David,12,0,40,28
1683338402002,SOCI 1,A01,258656,Thorpe; Charles Robert,28,0,30,2
1683338402002,SOCI 1,A02,258658,Thorpe; Charles Robert,30,0,30,0
1683338402002,SOCI 1,A03,258661,Thorpe; Charles Robert,25,0,25,0
1683338402002,SOCI 1,A04,258666,Thorpe; Charles Robert,22,0,25,3
1683338402002,SOCI 1,A05,258897,Thorpe; Charles Robert,23,0,25,2
1683338402002,SOCI 1,A06,258898,Thorpe; Charles Robert,25,0,25,0
1683338403029,SOCI 30,A01,258903,Pardo Guerra; Juan Pablo,15,0,30,15
1683338404053,SOCI 102,A00,258904,Staff,9,0,25,16
1683338405082,SOCI 106,A00,258905,Staff,19,0,25,6
1683338406111,SOCI 111,A00,258907,Ribas Norris; Janet Vanesa,26,0,30,4
1683338407135,SOCI 121R,A00,258908,Pardo Guerra; Juan Pablo,10,0,30,20
1683338408159,SOCI 126,A01,203330,Staff,14,0,20,6
1683338409187,SOCI 131,A00,258909,Thorpe; Charles Robert,31,0,60,29
1683338410210,SOCI 135,A00,258910,Payne; Christine Anna,0,9,30,30
1683338411238,SOCI 157,A00,258911,Staff,12,0,30,18
1683338412262,SOCI 184,A00,258912,Staff,25,0,30,5
1683338413286,SOCI 188D,A00,258913,Staff,21,0,30,9
1683338414310,SYN 2,001,187529,Staff,10,0,16,6
1683338414310,SYN 2,002,201452,Staff,0,18,16,16
1683338414310,SYN 2,003,201469,Staff,3,0,16,13
1683338415338,SYN 100,A01,187531,Staff,0,9,20,20
1683338415338,SYN 100,B01,201491,Staff,0,12,20,20
1683338416362,TDAC 1,A00,189286,Walsh; Kim C.,3,0,20,17
1683338416362,TDAC 1,B00,189287,Harting; Carla Kelso,11,0,20,9
1683338417388,TDAC 101,A00,189300,Walsh; Kim C.,16,0,20,4
1683338417388,TDAC 101,B00,189301,Harting; Carla Kelso,18,0,20,2
1683338418419,TDAC 102,A00,189304,Basso; Beatrice,14,0,20,6
1683338419447,TDAC 108,A00,189305,Staff,18,0,20,2
1683338420476,TDDE 131,A00,189310,Staff,19,0,20,1
1683338420476,TDDE 131,B00,189314,Staff,19,0,20,1
1683338420476,TDDE 131,C00,189315,Staff,48,0,50,2
1683338420476,TDDE 131,D00,189316,Staff,14,0,15,1
1683338420476,TDDE 131,E00,204841,Staff,20,0,20,0
1683338421500,TDGE 10,A00,189289,Staff,30,0,50,20
1683338421500,TDGE 10,B00,189290,Havis; Allan,1,0,50,49
1683338422526,TDGE 11,A00,189291,Fulton; Julia,0,3,50,50
1683338422526,TDGE 11,B00,189292,Staff,20,0,25,5
1683338422526,TDGE 11,C00,260270,Staff,0,0,0,0
1683338423551,TDGE 25,A00,189294,Staff,3,0,20,17
1683338424578,TDGE 124,A00,189318,Fulton; Julia,0,8,50,50
1683338425605,TDGE 125,A00,189319,Staff,13,0,25,12
1683338425605,TDGE 125,B00,189320,Staff,23,0,25,2
1683338426632,TDGE 127,A00,189322,Havis; Allan,0,0,50,50
1683338427663,TDHT 101,A00,189323,Staff,18,0,25,7
1683338427663,TDHT 101,B00,189324,Staff,25,0,25,0
1683338428688,TDHT 102,A00,189325,Staff,49,0,50,1
1683338429715,TDMV 1,A00,189295,Arcidiacono; Kristin,19,0,30,11
1683338429715,TDMV 1,B00,189296,Caligagan; Maria T.,24,0,30,6
1683338430745,TDMV 2,A00,189297,Sammartano; Tonnie,28,0,30,2
1683338430745,TDMV 2,B00,189299,Arcidiacono; Kristin,24,0,30,6
1683338431772,TDMV 3,A00,204998,Rincon; Alicia,22,0,30,8
1683338432799,TDMV 120,A00,189458,Sammartano; Tonnie,28,0,30,2
1683338433827,TDMV 138,A00,189541,Jun; Grace Shin Hae,22,0,40,18
1683338434856,TDMV 142,A00,189717,Caligagan; Tony,23,0,30,7
1683338434856,TDMV 142,B00,189718,Caligagan; Maria T.,25,0,30,5
1683338435883,TMC 2,A01,187533,Staff,25,0,25,0
1683338435883,TMC 2,A02,187534,Staff,25,0,25,0
1683338436910,USP 1,A01,187536,Kwak; Nancy,0,16,25,25
1683338437936,USP 5,A01,187538,Staff,10,0,25,15
1683338439022,USP 101,A00,199253,Staff,0,4,0,0
1683338440048,USP 124,A00,187562,Boomhower; Matthew Charles,1,0,30,29
1683338441075,USP 138,A00,187582,Staff,20,0,25,5
1683338442105,USP 152,A01,187597,Staff,4,0,25,21
1683338443132,USP 153,A00,187598,Staff,19,0,25,6
1683338444156,USP 168,A00,187607,Kwak; Nancy,2,0,5,3
1683338445184,USP 173,A00,187619,Staff,4,0,25,21
1683338446208,USP 181,A00,187638,Staff,0,0,25,25
1683338447238,VIS 103,A00,187650,Cruz; Edwin Teddy,23,0,75,52
1683338448264,VIS 110D,A00,187669,Staff,12,0,22,10
1683338449294,VIS 127C,A00,187720,Shen; Kuiyi,67,0,146,79
1683338450321,VIS 149,A00,187731,Yoldas; Pinar,0,14,22,22
1683338451353,VIS 151,A01,188091,Staff,22,0,34,12
1683338451353,VIS 151,A02,188092,Staff,11,0,34,23
1683338452379,VIS 160B,A00,188093,Stalbaum; Brett,0,0,10,10
1683338454433,WCWP 10B,A00,201720,Staff,10,0,15,5
1683338454433,WCWP 10B,B00,201722,Staff,9,0,15,6
1683338455458,WCWP 100,A00,201725,Gagnon; Jeffrey C,0,0,2,2
1683338455458,WCWP 100,B00,201727,Staff,0,4,15,15
1683338458576,ANBI 133,A00,258401,Wilder; Linnea Lorene,34,0,40,6
1683338459601,ANBI 140,A00,258395,Hrvoj Mihic; Branka,18,0,25,7
1683338460630,ANSC 120,A00,258402,Bialecki; Jon Anthony,27,0,40,13
1683338461657,ANSC 144,A00,258400,Staff,14,0,40,26
1683338463714,ANSC 166,A00,258396,Parish; Steven Martin,157,0,175,18
1683338464743,ANSC 180,A00,193533,Staff,9,0,20,11
1683338465769,ANSC 188,A00,258397,Jassal; Aftab,33,0,40,7
1683338466798,ANTH 3,A01,258316,Staff,23,0,30,7
1683338467828,ANTH 5,A00,258394,Semendeferi; Ekaterini,16,0,20,4
1683338468854,ANTH 21,A01,258331,Staff,8,0,40,32
1683338469884,ANTH 103,A00,258398,Varma; Saiba,15,0,25,10
1683338470918,AWP 10,001,202034,Staff,0,0,0,0
1683338470918,AWP 10,002,202035,Staff,0,0,0,0
1683338470918,AWP 10,003,202036,Staff,0,0,0,0
1683338470918,AWP 10,004,202037,Staff,0,0,0,0
1683338470918,AWP 10,005,202038,Staff,0,0,0,0
1683338470918,AWP 10,006,202039,Staff,0,0,0,0
1683338470918,AWP 10,007,202040,Staff,0,0,0,0
1683338470918,AWP 10,008,202041,Staff,0,0,0,0
1683338470918,AWP 10,009,202042,Staff,0,0,0,0
1683338470918,AWP 10,010,202043,Staff,0,0,0,0
1683338470918,AWP 10,011,202044,Staff,0,0,0,0
1683338470918,AWP 10,012,202045,Staff,0,0,0,0
1683338470918,AWP 10,013,202046,Staff,0,0,0,0
1683338470918,AWP 10,014,202047,Staff,0,0,0,0
1683338470918,AWP 10,015,202048,Staff,0,0,0,0
1683338470918,AWP 10,016,202049,Staff,0,0,0,0
1683338470918,AWP 10,017,202050,Staff,0,0,0,0
1683338470918,AWP 10,018,202051,Staff,0,0,0,0
1683338470918,AWP 10,019,202052,Staff,0,0,0,0
1683338470918,AWP 10,020,202053,Staff,0,0,0,0
1683338470918,AWP 10,021,202054,Staff,0,0,0,0
1683338470918,AWP 10,022,202055,Staff,0,0,0,0
1683338470918,AWP 10,023,202056,Staff,0,0,0,0
1683338470918,AWP 10,024,202057,Staff,0,0,0,0
1683338470918,AWP 10,025,202058,Staff,0,0,0,0
1683338470918,AWP 10,026,202059,Staff,0,0,0,0
1683338471946,AWP 102,001,202032,Staff,0,0,0,0
1683338471946,AWP 102,002,202033,Staff,0,0,0,0
1683338472972,BENG 100,A01,254234,Taylor Amos; Alyssa C,31,0,40,9
1683338474003,BENG 196,001,270013,Engler; Adam J.,9999,0,9999,0
1683338475030,BICD 100R,A01,202018,Smith; Laurie,0,7,32,32
1683338475030,BICD 100R,A02,202019,Smith; Laurie,0,2,32,32
1683338475030,BICD 100R,A03,202020,Smith; Laurie,0,1,32,32
1683338475030,BICD 100R,A04,202021,Smith; Laurie,9,0,32,23
1683338475030,BICD 100R,A05,202022,Smith; Laurie,12,0,32,20
1683338476055,BICD 136,A01,193242,Gustafson-Brown; Cindy,0,2,32,32
1683338476055,BICD 136,A02,193244,Gustafson-Brown; Cindy,14,0,32,18
1683338477087,BIEB 102,A01,193249,Butler; Shannon Rhey,0,2,32,32
1683338477087,BIEB 102,A02,193251,Butler; Shannon Rhey,0,0,32,32
1683338477087,BIEB 102,A03,193253,Butler; Shannon Rhey,0,1,32,32
1683338477087,BIEB 102,A04,193255,Butler; Shannon Rhey,17,0,32,15
1683338477087,BIEB 102,A05,193265,Butler; Shannon Rhey,26,0,32,6
1683338477087,BIEB 102,A06,193269,Butler; Shannon Rhey,16,0,32,16
1683338479145,BIEB 150,A01,193274,Staff,0,0,32,32
1683338479145,BIEB 150,A02,193285,Staff,23,0,32,9
1683338480171,BIEB 194,A00,193286,Kurle; Carolyn M.,22,0,32,10
1683338481201,BILD 1,A01,192291,Staff,16,0,32,16
1683338481201,BILD 1,A02,192292,Staff,30,0,32,2
1683338481201,BILD 1,B01,192520,Reuther; Keefe,0,1,0,0
1683338481201,BILD 1,B02,192532,Reuther; Keefe,0,1,0,0
1683338482226,BILD 3,A01,192556,Butler; Shannon Rhey,0,0,32,32
1683338482226,BILD 3,A02,192581,Butler; Shannon Rhey,5,0,32,27
1683338482226,BILD 3,A03,192611,Butler; Shannon Rhey,23,0,32,9
1683338482226,BILD 3,A04,192612,Butler; Shannon Rhey,25,0,32,7
1683338482226,BILD 3,A05,192613,Butler; Shannon Rhey,27,0,32,5
1683338482226,BILD 3,A06,192679,Butler; Shannon Rhey,27,0,32,5
1683338482226,BILD 3,A07,192682,Butler; Shannon Rhey,22,0,32,10
1683338483256,BILD 4,A01,192836,Reuther; Keefe,0,0,24,24
1683338483256,BILD 4,A02,193044,Reuther; Keefe,4,0,24,20
1683338484286,BILD 10,A01,193142,Gustafson-Brown; Cindy,30,0,32,2
1683338484286,BILD 10,A02,193149,Gustafson-Brown; Cindy,31,0,32,1
1683338485315,BIMM 100,A01,193301,Staff,0,6,32,32
1683338485315,BIMM 100,A02,193312,Staff,0,5,32,32
1683338485315,BIMM 100,A03,193323,Staff,0,8,32,32
1683338486347,BIMM 101,A01,193329,McDonnell; Lisa Marie,0,3,24,24
1683338486347,BIMM 101,A02,193339,McDonnell; Lisa Marie,0,3,24,24
1683338486347,BIMM 101,B01,193354,McDonnell; Lisa Marie,0,3,24,24
1683338486347,BIMM 101,B02,193357,McDonnell; Lisa Marie,0,3,24,24
1683338487372,BIMM 110,A01,193377,Tat; John,0,11,32,32
1683338487372,BIMM 110,A02,193378,Tat; John,1,9,32,31
1683338488402,BIMM 120,A01,206116,Staff,0,0,32,32
1683338488402,BIMM 120,A02,206117,Staff,8,0,32,24
1683338488402,BIMM 120,A03,206121,Staff,21,0,32,11
1683338489431,BIPN 100,A01,193393,Park; Ji Young,0,14,32,32
1683338489431,BIPN 100,A02,193402,Park; Ji Young,0,13,32,32
1683338489431,BIPN 100,A03,193413,Park; Ji Young,0,14,32,32
1683338489431,BIPN 100,A04,193414,Park; Ji Young,0,13,32,32
1683338490457,BIPN 102,A01,193429,Staff,0,0,32,32
1683338490457,BIPN 102,A02,193438,Staff,22,0,32,10
1683338491484,BIPN 106,A01,193450,Reyes Gonzalez; Catalina,0,2,40,40
1683338492510,BIPN 134,A01,193465,Cooke; James Edward,0,0,32,32
1683338492510,BIPN 134,A02,193474,Cooke; James Edward,25,0,32,7
1683338492510,BIPN 134,A03,193485,Cooke; James Edward,29,0,32,3
1683338492510,BIPN 134,A04,193486,Cooke; James Edward,21,0,32,11
1683338492510,BIPN 134,A05,193491,Cooke; James Edward,31,0,32,1
1683338492510,BIPN 134,A06,193501,Cooke; James Edward,30,0,32,2
1683338492510,BIPN 134,A07,193510,Cooke; James Edward,29,0,32,3
1683338494560,BISP 194,A00,222522,Staff,14,0,32,18
1683338495585,CAT 124,A01,202407,Staff,20,0,25,5
1683338496611,CAT 125,A00,202408,Marchisotto; Jennifer Anne,4,0,20,16
1683338497638,CAT 125R,A00,202409,Smith; Lauryn Alissa,0,11,20,20
1683338497638,CAT 125R,B00,202410,Morales; Celeste Georgianna,0,11,20,20
1683338497638,CAT 125R,C00,202411,Irwin; Matthew Joseph,0,10,20,20
1683338498666,CENG 15,A01,204712,Yang; Kesong,0,1,0,0
1683338499692,CENG 114,A00,202070,Jahed Motlagh; Zeinab,5,0,20,15
1683338500722,CGS 105,A00,185477,Wesling; Megan E.,24,0,40,16
1683338501747,CGS 106,A00,185494,Staff,13,0,22,9
1683338502778,CGS 108,A00,185495,Staff,14,0,20,6
1683338503804,CGS 114,A00,185496,Staff,13,0,18,5
1683338504832,CGS 119,A00,185501,Staff,15,0,20,5
1683338505858,CGS 120,A00,185511,Staff,13,0,20,7
1683338506883,CHEM 4,A01,184675,Bussey; Thomas J,96,0,100,4
1683338507909,CHEM 6A,A01,184677,Staff,34,0,60,26
1683338508938,CHEM 6B,A01,184679,Staff,65,0,100,35
1683338509963,CHEM 6C,A01,184681,Bussey; Thomas J,1,0,50,49
1683338509963,CHEM 6C,A02,184682,Bussey; Thomas J,34,0,50,16
1683338510988,CHEM 40A,A01,184684,Albizati; Kim F.,37,0,100,63
1683338512014,CHEM 40B,A01,184686,Albizati; Kim F.,0,20,100,100
1683338513039,CHEM 41B,A01,184690,Staff,52,0,100,48
1683338514068,COGS 3,A01,184715,Boyle; Mary E. T.,0,25,40,40
1683338515094,COGS 14B,A01,185172,Staff,0,15,38,38
1683338516120,COGS 18,A01,184736,Staff,17,0,80,63
1683338517146,COGS 100,A01,184932,Staff,0,5,73,73
1683338518172,COGS 101A,A01,184935,Staff,0,39,30,30
1683338519198,COGS 101B,A01,184944,Staff,0,2,30,30
1683338520223,COGS 101C,A01,184946,Staff,0,12,30,30
1683338521249,COGS 102A,A01,184951,Johnson; Christine M.,2,0,40,38
1683338522280,COGS 107B,A01,184953,Mooshagian; Eric Frederick,0,50,40,40
1683338523311,COGS 118B,A01,184959,Gupta; Anjum,0,48,40,40
1683338524341,COGS 153,A00,184961,Staff,0,15,30,30
1683338525370,COGS 177,A00,184962,Staff,0,20,30,30
1683338526395,COGS 187A,A01,184969,Boyle; Mary E. T.,0,17,40,40
1683338527419,COMM 10,A01,185174,Staff,0,5,25,25
1683338527419,COMM 10,A02,185189,Staff,0,5,25,25
1683338527419,COMM 10,A03,269821,Staff,0,0,0,0
1683338528448,COMM 100B,A01,185475,Staff,0,0,0,2
1683338528448,COMM 100B,A02,185476,Staff,13,0,25,12
1683338529473,COMM 100C,A01,185314,Staff,1,0,25,24
1683338529473,COMM 100C,A02,185327,Staff,19,0,25,6
1683338530502,COMM 110M,A00,185349,Staff,2,0,40,38
1683338531528,COMM 113T,A00,185352,Staff,24,0,40,16
1683338532554,COMM 114I,A00,185353,Staff,33,0,40,7
1683338533580,COMM 131,A00,185354,Staff,19,0,30,11
1683338534605,CSE 8A,A50,185358,Cao; Yingjun,0,46,10,10
1683338535631,CSE 8B,A01,185362,Staff,1,47,50,49
1683338536661,CSE 11,A01,185416,Cao; Yingjun,0,92,10,10
1683338537689,CSE 20,A01,185445,Briones; Jor-el Thomas Caparas,5,0,25,20
1683338538718,CSE 21,A01,185447,Staff,10,0,50,40
1683338539743,CSE 101,A01,185451,Staff,0,13,50,50
1683338539743,CSE 101,B01,185453,Jones; Miles E,0,11,50,50
1683338541798,CSE 141,A01,185458,Eldon; John,20,0,100,80
1683338542880,CSE 141L,A01,185461,Eldon; John,12,0,100,88
1683338543906,CSE 142,A01,185463,Staff,36,0,60,24
1683338543906,CSE 142,B01,201355,Staff,0,7,60,60
1683338544938,CSE 142L,A01,185470,Staff,36,0,60,24
1683338544938,CSE 142L,B01,201417,Staff,0,6,60,60
1683338545965,CSE 190,A00,201433,Staff,32,0,49,17
1683338546990,DOC 1,A01,259136,Strom; Megan C.,7,0,15,8
1683338546990,DOC 1,A02,259137,Strom; Megan C.,14,0,15,1
1683338546990,DOC 1,A03,259138,Strom; Megan C.,14,0,15,1
1683338546990,DOC 1,A04,259139,Strom; Megan C.,14,0,15,1
1683338548016,DOC 100D,A00,259140,Pass; Natalye Joann,16,0,25,9
1683338549044,DSGN 1,A01,184749,Rill; Bryan,0,25,30,30
1683338550073,DSGN 100,A01,185168,Staff,0,2,25,25
1683338551099,ECE 5,A01,185626,Morris; Karcher William,0,10,0,0
1683338552126,ECE 101,A01,185628,Staff,17,0,70,53
1683338553150,ECE 107,A01,185635,Baghdadchi; Saharnaz,0,0,20,20
1683338553150,ECE 107,A02,185638,Baghdadchi; Saharnaz,4,0,20,16
1683338554176,ECE 148,A01,185647,Silberman; Jack,0,0,16,16
1683338555204,ECON 1,A01,185537,Crane; Meredith Helen,54,0,70,16
1683338556232,ECON 3,A01,185549,Crane; Meredith Helen,33,0,70,37
1683338557261,ECON 4,A01,203354,Anderson; John Charles,0,4,10,10
1683338558286,ECON 100A,A01,185574,Staff,0,4,40,40
1683338559312,ECON 100B,A01,185576,Staff,10,22,50,40
1683338560340,ECON 100C,A01,185589,Newhouse; Herbert S,30,0,70,40
1683338561366,ECON 105,A00,185608,Vespa; Emanuel Ignacio,19,0,35,16
1683338562391,ECON 109,A01,185610,Shishkin; Denis,10,0,35,25
1683338563416,ECON 110A,A01,185612,Staff,11,0,40,29
1683338564443,ECON 120A,A01,185615,Staff,20,0,40,20
1683338565470,ECON 120C,A01,185617,Sun; Yixiao,0,20,70,70
1683338566496,ECON 144,A00,203346,Squires; Dale E,3,0,35,32
1683338567524,ECON 171,A01,203349,Newhouse; Herbert S,0,1,35,35
1683338568551,ECON 173A,A01,185621,Toda; Alexis Akira,21,0,35,14
1683338569578,EDS 25,A01,202413,Staff,0,1,0,0
1683338569578,EDS 25,A02,202414,Staff,0,1,0,0
1683338569578,EDS 25,A03,202415,Staff,0,0,0,0
1683338569578,EDS 25,A04,202416,Staff,0,1,0,0
1683338569578,EDS 25,A05,202439,Staff,0,0,0,0
1683338569578,EDS 25,A06,202440,Staff,0,0,0,0
1683338569578,EDS 25,B01,202631,Staff,0,0,0,0
1683338569578,EDS 25,B02,202632,Staff,0,0,0,0
1683338569578,EDS 25,B03,202639,Staff,0,0,0,0
1683338569578,EDS 25,B04,202640,Staff,0,0,0,0
1683338569578,EDS 25,B05,202643,Staff,0,0,0,0
1683338569578,EDS 25,B06,202644,Staff,0,0,0,0
1683338570603,EDS 38,A01,202659,Black; Alison Michelle,24,0,25,1
1683338571629,EDS 115,A00,202652,Staff,18,0,30,12
1683338572654,EDS 125,A00,202649,Staff,14,0,30,16
1683338573683,EDS 126,A01,203332,Staff,30,0,30,0
1683338574709,EDS 139,A00,202838,Staff,16,0,25,9
1683338575735,EDS 146,A01,202655,Staff,14,0,25,11
1683338576765,ENG 15,A00,185667,Staff,0,1,0,0
1683338576765,ENG 15,B00,185672,Staff,0,0,0,0
1683338576765,ENG 15,C00,185675,Staff,0,0,0,0
1683338576765,ENG 15,D00,185682,Staff,0,0,0,0
1683338576765,ENG 15,E00,185684,Staff,0,0,0,0
1683338577793,ETHN 103,A00,185710,Staff,0,3,35,35
1683338578819,ETHN 103A,A00,199228,Man; Simeon S,2,0,9,7
1683338579844,ETHN 109,A00,185711,Staff,18,0,35,17
1683338580867,ETHN 142,A00,185726,Staff,0,4,30,30
1683338581892,ETHN 163J,A00,199229,Man; Simeon S,5,0,8,3
1683338582920,ETHN 168,A00,185727,Staff,8,0,10,2
1683338583948,ETHN 182,A00,185728,Staff,1,0,35,34
1683338584972,ETHN 183,A00,185737,Staff,8,0,18,10
1683338585996,GLBH 111,A01,209361,Burgos; Jose L.,0,0,0,0
1683338588046,HIEU 104,A00,185792,Staff,16,0,20,4
1683338589074,HIEU 115,A00,185800,Staff,1,0,20,19
1683338590102,HIEU 128,A00,185801,Staff,0,7,20,20
1683338591128,HIEU 147,A00,185802,Staff,16,0,20,4
1683338592157,HIEU 154,A00,185823,Staff,12,0,20,8
1683338593184,HILA 102,A00,185826,Staff,13,0,20,7
1683338594209,HILD 2C,A01,185778,Staff,0,12,20,20
1683338595239,HILD 7B,A01,185780,Kwak; Nancy,0,15,32,32
1683338595239,HILD 7B,A02,185781,Kwak; Nancy,0,18,32,32
1683338596263,HILD 30,A01,185791,Staff,14,0,20,6
1683338597290,HISC 119,A00,185830,Golan; Tal,0,9,20,20
1683338598315,HITO 156GS,A00,185831,Patterson; Patrick H.,0,0,0,23
1683338599342,HIUS 103,A00,185832,Man; Simeon S,0,6,20,20
1683338600370,HIUS 117,A00,185836,Kwak; Nancy,2,0,20,18
1683338601397,HIUS 125,A00,185840,Man; Simeon S,0,0,23,23
1683338602422,HIUS 149,A00,185845,Staff,0,0,20,20
1683338603447,HUM 3,A01,185882,Zavodny; Tatiana Sophia,0,7,50,50
1683338603447,HUM 3,B01,185899,Caldwell; Michael Alan,0,18,50,50
1683338604471,HUM 3GS,A00,185900,Patterson; Patrick H.,0,0,0,23
1683338605500,HUM 4,A01,185938,Zroka; Amy Liane,31,0,50,19
1683338605500,HUM 4,B01,185956,Watkins; Eric,0,2,50,50
1683338605500,HUM 4,B02,202209,Watkins; Eric,0,2,50,50
1683338605500,HUM 4,B03,202210,Watkins; Eric,0,2,50,50
1683338606524,HUM 5,A01,185958,West; Geoffrey Scott,3,0,50,47
1683338606524,HUM 5,A02,202215,West; Geoffrey Scott,0,0,50,50
1683338607547,INTL 190,A00,185959,Gagnon; Jeffrey C,0,0,0,9
1683338607547,INTL 190,B00,185960,Lettieri; Michael Joseph,0,0,0,1
1683338608573,JAPN 180,A00,254509,Staff,5,1,30,25
1683338609601,LATI 10,A01,202853,Kennemore; Amy Michelle,4,0,35,31
1683338609601,LATI 10,A02,202854,Kennemore; Amy Michelle,2,0,35,33
1683338609601,LATI 10,A03,270054,Kennemore; Amy Michelle,30,0,30,0
1683338610628,LATI 180,A00,202855,Kennemore; Amy Michelle,11,0,20,9
1683338611656,LAWS 101,A00,201767,Golan; Tal,0,7,40,40
1683338612685,LIFR 1C,A00,185961,Staff,6,0,20,14
1683338613720,LIFR 1CX,A00,185962,Staff,7,0,20,13
1683338614747,LIFR 1D,A00,185963,Staff,9,0,20,11
1683338615771,LIFR 1DX,A00,185964,Staff,9,0,20,11
1683338616800,LIGN 101,A01,186039,Staff,43,0,50,7
1683338617825,LIGN 165,A00,186040,Staff,18,0,50,32
1683338618849,LTCS 108,A00,186041,Staff,6,0,10,4
1683338619876,LTCS 119,A00,186042,Staff,16,0,20,4
1683338620900,LTCS 130,A00,186043,Wesling; Megan E.,15,0,25,10
1683338622959,LTEA 138,A00,186119,Staff,14,0,40,26
1683338623984,LTEN 124,A00,186148,Staff,6,0,25,19
1683338625008,LTEN 178,A00,186149,Staff,7,0,15,8
1683338626032,LTEN 181,A00,186150,Blanco; John D,33,0,40,7
1683338627058,LTWL 120,A00,186160,Staff,20,0,25,5
1683338628086,LTWL 165,A00,186161,Staff,22,0,25,3
1683338629110,LTWR 100,A00,186162,Staff,0,5,15,15
1683338630138,LTWR 102,A00,186163,Doller; Ben,5,0,15,10
1683338631167,MAE 8,A01,186412,Staff,0,0,0,0
1683338632191,MAE 30B,A00,186445,Bahadori; Mohammad Yousef,83,0,100,17
1683338633215,MAE 40,A00,186592,Bewley; Thomas R,9,0,50,41
1683338634241,MAE 101B,A00,186593,Bahadori; Mohammad Yousef,81,0,100,19
1683338635269,MAE 105,A00,186594,Bandaru; Prabhakar,12,0,50,38
1683338636295,MAE 107,A00,186599,Pham; Hieu Tan,0,6,120,120
1683338637320,MAE 148,A01,186660,Silberman; Jack,3,0,16,13
1683338638343,MATH 10A,A01,188095,Staff,1,6,35,34
1683338639370,MATH 10B,A01,188097,Bowers; Adam R.,0,11,30,30
1683338639370,MATH 10B,A02,188099,Bowers; Adam R.,0,11,30,30
1683338639370,MATH 10B,B01,188104,Bowers; Adam R.,0,10,30,30
1683338639370,MATH 10B,B02,188106,Bowers; Adam R.,0,10,30,30
1683338640397,MATH 10C,A01,188111,Staff,0,18,30,30
1683338640397,MATH 10C,A02,188127,Staff,0,17,30,30
1683338640397,MATH 10C,A03,188131,Staff,0,18,30,30
1683338640397,MATH 10C,B01,188218,Staff,18,0,30,12
1683338640397,MATH 10C,B02,188244,Staff,13,0,30,17
1683338640397,MATH 10C,B03,188277,Staff,16,0,30,14
1683338641423,MATH 18,A01,188344,Bach; Quang Tran,18,0,30,12
1683338641423,MATH 18,A02,188345,Bach; Quang Tran,11,0,30,19
1683338641423,MATH 18,B01,188353,Bach; Quang Tran,10,0,30,20
1683338641423,MATH 18,B02,188354,Bach; Quang Tran,20,0,30,10
1683338642452,MATH 20A,A01,188374,Staff,13,0,35,22
1683338643481,MATH 20B,A01,188382,Ohm; Ko Woon,6,0,30,24
1683338643481,MATH 20B,A02,188383,Ohm; Ko Woon,22,0,30,8
1683338643481,MATH 20B,B01,188385,Ohm; Ko Woon,7,0,30,23
1683338643481,MATH 20B,B02,188392,Ohm; Ko Woon,22,0,30,8
1683338644507,MATH 20C,A01,188394,Harel; Guershon,10,0,30,20
1683338644507,MATH 20C,A02,188395,Harel; Guershon,15,0,30,15
1683338644507,MATH 20C,B01,188404,Harel; Guershon,5,0,30,25
1683338644507,MATH 20C,B02,188405,Harel; Guershon,19,0,30,11
1683338645534,MATH 20D,A01,188414,Hammock; Frances H,0,1,30,30
1683338645534,MATH 20D,A02,188415,Hammock; Frances H,3,0,30,27
1683338645534,MATH 20D,B01,188447,Hammock; Frances H,1,0,30,29
1683338645534,MATH 20D,B02,188486,Hammock; Frances H,8,0,30,22
1683338646619,MATH 20E,A01,188649,Staff,21,0,30,9
1683338646619,MATH 20E,A02,188650,Staff,23,0,30,7
1683338646619,MATH 20E,A03,188673,Staff,0,0,30,30
1683338647643,MATH 102,A01,188675,Staff,0,35,35,35
1683338648672,MATH 103B,A01,188681,Staff,3,0,35,32
1683338648672,MATH 103B,B01,188692,Staff,5,0,35,30
1683338649698,MATH 109,A01,188695,Salehi Golsefidy; Alireza,25,0,35,10
1683338649698,MATH 109,A02,188696,Salehi Golsefidy; Alireza,25,0,35,10
1683338650727,MATH 120A,A01,188698,Eggers; John Dietrich,7,0,35,28
1683338651757,MATH 142B,A01,188736,Ioana; Adrian,0,2,30,30
1683338651757,MATH 142B,A02,188741,Ioana; Adrian,1,1,30,29
1683338651757,MATH 142B,A03,188743,Ioana; Adrian,1,3,30,29
1683338652783,MATH 168A,A01,188790,Staff,0,9,35,35
1683338653810,MATH 170A,A01,188803,Nie; Jiawang,0,2,35,35
1683338653810,MATH 170A,A02,188811,Nie; Jiawang,0,0,35,35
1683338653810,MATH 170A,A03,188814,Nie; Jiawang,1,0,35,34
1683338653810,MATH 170A,A04,188815,Nie; Jiawang,13,0,35,22
1683338654835,MATH 193B,A01,188817,Staff,0,0,35,35
1683338654835,MATH 193B,A02,188818,Staff,5,0,35,30
1683338655860,MGT 4,A01,202857,Anderson; John Charles,62,0,80,18
1683338656885,MGT 12,A00,202858,Lindenberger; Wade Douglas,42,0,90,48
1683338657913,MGT 18,A00,202859,Staff,74,0,90,16
1683338658937,MGT 18GS,A00,202860,McKay; Michael J,13,0,28,15
1683338659965,MGT 45,A00,202861,Pecore; Joseph P.,14,0,90,76
1683338660990,MGT 100,A00,202863,Yavorsky; Daniel Ryan,28,0,90,62
1683338662016,MGT 103,A00,202864,Ehrich; Kristine R,1,18,90,89
1683338663044,MGT 112,A00,202865,Ehrich; Kristine R,15,0,90,75
1683338664070,MGT 121A,A00,202868,Staff,0,20,0,0
1683338665097,MGT 131B,A00,202869,Anderson; John Charles,59,0,90,31
1683338666124,MGT 136,A00,202871,Lindenberger; Wade Douglas,84,0,90,6
1683338667149,MGT 164,A00,202873,Staff,0,68,90,91
1683338668172,MGT 164GS,A00,202874,McKay; Mary A,13,0,28,15
1683338669196,MGT 180,A00,202875,Staff,0,50,90,91
1683338670220,MMW 11R,A01,205019,Herbst; Matthew,3,0,30,27
1683338670220,MMW 11R,A02,205026,Herbst; Matthew,29,0,30,1
1683338671254,MMW 15,A01,193512,Chang; Edmond Yi-Teh,0,9,28,28
1683338671254,MMW 15,A02,193513,Chang; Edmond Yi-Teh,0,5,28,28
1683338671254,MMW 15,A03,193514,Chang; Edmond Yi-Teh,0,5,28,28
1683338671254,MMW 15,A04,193515,Chang; Edmond Yi-Teh,0,5,28,28
1683338671254,MMW 15,A05,193516,Chang; Edmond Yi-Teh,0,4,28,28
1683338671254,MMW 15,A06,193517,Chang; Edmond Yi-Teh,0,5,28,28
1683338671254,MMW 15,B01,193519,Chang; Edmond Yi-Teh,0,5,28,28
1683338671254,MMW 15,B02,193520,Chang; Edmond Yi-Teh,0,5,28,28
1683338671254,MMW 15,B03,193521,Chang; Edmond Yi-Teh,0,5,28,28
1683338671254,MMW 15,B04,193522,Chang; Edmond Yi-Teh,0,4,28,28
1683338671254,MMW 15,B05,193523,Chang; Edmond Yi-Teh,0,5,28,28
1683338671254,MMW 15,B06,193524,Chang; Edmond Yi-Teh,0,4,28,28
1683338672279,MMW 122,A01,193526,Rahimi; Babak,0,15,28,28
1683338672279,MMW 122,A02,193527,Rahimi; Babak,0,14,28,28
1683338672279,MMW 122,A03,193528,Rahimi; Babak,0,0,0,0
1683338672279,MMW 122,A04,193529,Rahimi; Babak,0,0,0,0
1683338673303,MUS 1A,A01,186663,Staff,0,20,35,35
1683338674327,MUS 4,A01,186715,Staff,0,12,35,35
1683338675352,MUS 5R,A01,186796,Dubnov; Shlomo,0,17,35,35
1683338676376,MUS 6,A01,186798,Staff,0,4,25,25
1683338677403,MUS 7,A01,186830,Staff,13,0,35,22
1683338678428,MUS 8,A01,186930,Staff,0,26,35,35
1683338679458,MUS 15,A01,186932,Staff,0,16,35,35
1683338679458,MUS 15,B01,186934,Staff,0,15,35,35
1683338680488,MUS 80,A00,186935,Staff,1,0,20,19
1683338680488,MUS 80,B00,186936,Staff,25,0,25,0
1683338681516,NANO 11,A00,204702,Lipomi; Darren John,0,0,0,0
1683338682542,NANO 15,A01,204709,Yang; Kesong,0,1,0,0
1683338683569,NANO 114,A00,202069,Jahed Motlagh; Zeinab,3,0,10,7
1683338684598,PHIL 1,A00,186955,Grush; Rick Scott,32,0,40,8
1683338685622,PHIL 10,A01,186973,Grush; Rick Scott,28,0,35,7
1683338685622,PHIL 10,A02,186974,Grush; Rick Scott,33,0,35,2
1683338686651,PHIL 13,A01,186976,Staff,7,0,35,28
1683338686651,PHIL 13,A02,186977,Staff,16,0,35,19
1683338687679,PHIL 14,A01,186979,Staff,31,0,35,4
1683338687679,PHIL 14,A02,186986,Staff,32,0,35,3
1683338688708,PHIL 28,A01,186988,Staff,16,0,30,14
1683338688708,PHIL 28,A02,186989,Staff,1,0,30,29
1683338688708,PHIL 28,A03,186990,Staff,9,0,30,21
1683338688708,PHIL 28,A04,186991,Staff,26,0,30,4
1683338689736,PHIL 120,A00,186997,Staff,23,0,40,17
1683338690765,PHIL 137,A00,187003,Staff,9,0,40,31
1683338691792,PHIL 150,A00,187015,Staff,47,0,70,23
1683338692820,PHIL 167,A00,187021,Lamey; Andy M.,35,0,40,5
1683338693851,PHIL 174,A01,202226,Staff,17,0,20,3
1683338693851,PHIL 174,A02,202235,Staff,20,0,20,0
1683338694878,PHIL 191A,A00,258918,Staff,0,0,1,1
1683338695902,PHYS 1A,A00,187028,Staff,27,0,60,33
1683338696929,PHYS 1AL,001,187036,Staff,2,0,30,28
1683338696929,PHYS 1AL,002,187049,Staff,18,0,30,12
1683338697955,PHYS 1B,A00,187058,Staff,22,0,60,38
1683338698984,PHYS 1BL,001,187064,Staff,0,0,30,30
1683338698984,PHYS 1BL,002,187070,Staff,5,0,30,25
1683338700009,PHYS 1C,A00,187082,Staff,31,0,120,89
1683338701034,PHYS 1CL,001,187088,Staff,0,9,30,30
1683338701034,PHYS 1CL,002,187089,Staff,0,2,30,30
1683338701034,PHYS 1CL,009,262693,Staff,11,0,30,19
1683338702062,PHYS 2B,A01,187097,Staff,54,0,115,61
1683338703092,PHYS 2C,A01,187099,Staff,67,0,115,48
1683338704118,PHYS 2CL,A01,187101,Staff,5,0,28,23
1683338704118,PHYS 2CL,A02,187102,Staff,15,0,28,13
1683338705144,PHYS 2D,A01,187123,Shotwell; Brian,95,0,115,20
1683338706168,PHYS 4B,A01,187133,Grinstein; Benjamin,35,0,50,15
1683338707192,POLI 10,A00,188819,Staff,0,4,50,50
1683338708217,POLI 11,A00,188827,Staff,43,0,50,7
1683338709242,POLI 13R,A00,188828,Staff,0,1,20,20
1683338710271,POLI 27,A01,188830,Elgin; Samuel Zincke,0,1,70,70
1683338711297,POLI 30,A00,188832,Desposato; Scott,31,0,50,19
1683338712320,POLI 102F,A00,188834,Staff,3,0,40,37
1683338713352,POLI 104A,A00,188852,Staff,14,0,30,16
1683338714378,POLI 104I,A00,188853,Staff,0,6,20,20
1683338715404,POLI 110B,A00,188854,Wiens; David,7,0,20,13
1683338716429,POLI 112A,A00,188855,Wiens; David,5,0,30,25
1683338717455,POLI 117R,A00,188856,Forman; Fonna,0,11,20,20
1683338718481,POLI 118,A00,188857,Ingham; Sean,8,0,20,12
1683338719505,POLI 120G,A00,188858,Staff,9,0,30,21
1683338720529,POLI 131CR,A00,188863,Hoston; Germaine,24,0,50,26
1683338721557,POLI 133,A00,188864,Nellis; Gareth Hb,44,0,50,6
1683338722582,POLI 134D,A00,188865,Desposato; Scott,27,0,30,3
1683338723607,POLI 142A,A00,188871,Gartzke; Erik,22,0,50,28
1683338724631,POLI 142K,A00,188874,Staff,38,0,50,12
1683338725657,POLI 143,A00,188940,Gartzke; Erik,16,0,30,14
1683338726682,POLI 153,A00,188943,Staff,3,0,20,17
1683338727707,POLI 160AA,A00,188944,Staff,12,0,40,28
1683338728736,POLI 170A,A00,188945,Staff,11,0,30,19
1683338730784,PSYC 1,A00,188952,Staff,37,0,90,53
1683338731809,PSYC 2,B00,188953,Staff,19,0,35,16
1683338732834,PSYC 6,A00,188970,Staff,47,0,60,13
1683338733863,PSYC 7,A00,188973,Staff,37,0,45,8
1683338734888,PSYC 60,A01,188980,Rickard; Timothy C.,43,0,60,17
1683338735914,PSYC 70,A01,189001,Steiner; Eric Tomas,24,0,45,21
1683338736942,PSYC 100,A00,189005,Lacefield; Katharine I,0,98,120,120
1683338737970,PSYC 102,A00,189008,Staff,9,0,30,21
1683338738996,PSYC 106,B00,189026,Gorman; Michael R.,34,0,60,26
1683338740026,PSYC 114,B01,189033,Winkielman; Piotr,0,32,30,30
1683338741052,PSYC 131,A00,189036,Anagnostaras; Stephan,0,43,60,60
1683338742077,PSYC 136,A00,189041,Lowe; Angela Beth,0,7,25,25
1683338743102,PSYC 137,A00,189057,Winkielman; Piotr,0,34,25,25
1683338744127,PSYC 144,A00,189107,Wixted; John T,0,7,50,50
1683338746178,PSYC 162,A00,189142,Staff,0,8,85,85
1683338747205,PSYC 172,A00,189144,Gorman; Michael R.,0,7,30,30
1683338749257,PSYC 179,A00,189146,Lacefield; Katharine I,0,84,120,120
1683338750340,PSYC 181,A00,189147,Anagnostaras; Stephan,0,44,90,90
1683338751365,PSYC 190R,A00,189148,Barner; David A.,0,22,80,80
1683338752394,PSYC 191,A00,189275,Rickard; Timothy C.,0,7,25,25
1683338753420,PSYC 193,A00,189276,Chapman; Eddie Nathaniel,0,1,0,4
1683338754446,PSYC 193L,A01,189281,Lowe; Angela Beth,12,0,20,8
1683338754446,PSYC 193L,B01,189285,Staff,28,0,35,7
1683338755470,RELI 149,A00,187137,Rahimi; Babak,7,0,40,33
1683338756495,SE 9,A01,187315,Staff,0,2,18,18
1683338757524,SE 101B,A00,187409,Staff,24,0,30,6
1683338758552,SE 110B,A00,187444,Staff,10,0,40,30
1683338759580,SE 130B,A00,187449,Staff,31,0,40,9
1683338760607,SE 150A,A00,187516,Staff,9,0,20,11
1683338761636,SE 154,A00,187528,Staff,30,0,50,20
1683338762664,SIO 3,A01,258171,Staff,35,0,40,5
1683338763689,SIO 10,A00,187144,Cook; Geoffrey W,0,3,75,75
1683338764718,SIO 45,A00,187152,Cook; Geoffrey W,1,0,100,99
1683338765745,SIO 109R,A00,194486,Staff,0,3,20,20
1683338767799,SIO 187,A01,187233,Kacev; David,12,0,40,28
1683338768825,SOCI 1,A01,258656,Thorpe; Charles Robert,28,0,30,2
1683338768825,SOCI 1,A02,258658,Thorpe; Charles Robert,30,0,30,0
1683338768825,SOCI 1,A03,258661,Thorpe; Charles Robert,25,0,25,0
1683338768825,SOCI 1,A04,258666,Thorpe; Charles Robert,22,0,25,3
1683338768825,SOCI 1,A05,258897,Thorpe; Charles Robert,23,0,25,2
1683338768825,SOCI 1,A06,258898,Thorpe; Charles Robert,25,0,25,0
1683338769859,SOCI 30,A01,258903,Pardo Guerra; Juan Pablo,15,0,30,15
1683338770883,SOCI 102,A00,258904,Staff,9,0,25,16
1683338771907,SOCI 106,A00,258905,Staff,19,0,25,6
1683338772934,SOCI 111,A00,258907,Ribas Norris; Janet Vanesa,26,0,30,4
1683338773959,SOCI 121R,A00,258908,Pardo Guerra; Juan Pablo,10,0,30,20
1683338774984,SOCI 126,A01,203330,Staff,14,0,20,6
1683338776010,SOCI 131,A00,258909,Thorpe; Charles Robert,31,0,60,29
1683338777038,SOCI 135,A00,258910,Payne; Christine Anna,0,9,30,30
1683338778063,SOCI 157,A00,258911,Staff,12,0,30,18
1683338779089,SOCI 184,A00,258912,Staff,25,0,30,5
1683338780114,SOCI 188D,A00,258913,Staff,21,0,30,9
1683338781142,SYN 2,001,187529,Staff,10,0,16,6
1683338781142,SYN 2,002,201452,Staff,0,18,16,16
1683338781142,SYN 2,003,201469,Staff,3,0,16,13
1683338782170,SYN 100,A01,187531,Staff,0,9,20,20
1683338782170,SYN 100,B01,201491,Staff,0,12,20,20
1683338783199,TDAC 1,A00,189286,Walsh; Kim C.,3,0,20,17
1683338783199,TDAC 1,B00,189287,Harting; Carla Kelso,11,0,20,9
1683338784226,TDAC 101,A00,189300,Walsh; Kim C.,16,0,20,4
1683338784226,TDAC 101,B00,189301,Harting; Carla Kelso,18,0,20,2
1683338785253,TDAC 102,A00,189304,Basso; Beatrice,14,0,20,6
1683338786278,TDAC 108,A00,189305,Staff,18,0,20,2
1683338787305,TDDE 131,A00,189310,Staff,19,0,20,1
1683338787305,TDDE 131,B00,189314,Staff,19,0,20,1
1683338787305,TDDE 131,C00,189315,Staff,48,0,50,2
1683338787305,TDDE 131,D00,189316,Staff,14,0,15,1
1683338787305,TDDE 131,E00,204841,Staff,20,0,20,0
1683338788329,TDGE 10,A00,189289,Staff,30,0,50,20
1683338788329,TDGE 10,B00,189290,Havis; Allan,1,0,50,49
1683338789356,TDGE 11,A00,189291,Fulton; Julia,0,3,50,50
1683338789356,TDGE 11,B00,189292,Staff,20,0,25,5
1683338789356,TDGE 11,C00,260270,Staff,0,0,0,0
1683338790385,TDGE 25,A00,189294,Staff,3,0,20,17
1683338791409,TDGE 124,A00,189318,Fulton; Julia,0,8,50,50
1683338792435,TDGE 125,A00,189319,Staff,13,0,25,12
1683338792435,TDGE 125,B00,189320,Staff,23,0,25,2
1683338793461,TDGE 127,A00,189322,Havis; Allan,0,0,50,50
1683338794486,TDHT 101,A00,189323,Staff,18,0,25,7
1683338794486,TDHT 101,B00,189324,Staff,25,0,25,0
1683338795515,TDHT 102,A00,189325,Staff,49,0,50,1
1683338796543,TDMV 1,A00,189295,Arcidiacono; Kristin,19,0,30,11
1683338796543,TDMV 1,B00,189296,Caligagan; Maria T.,24,0,30,6
1683338797578,TDMV 2,A00,189297,Sammartano; Tonnie,28,0,30,2
1683338797578,TDMV 2,B00,189299,Arcidiacono; Kristin,24,0,30,6
1683338798609,TDMV 3,A00,204998,Rincon; Alicia,22,0,30,8
1683338799638,TDMV 120,A00,189458,Sammartano; Tonnie,28,0,30,2
1683338800667,TDMV 138,A00,189541,Jun; Grace Shin Hae,22,0,40,18
1683338801694,TDMV 142,A00,189717,Caligagan; Tony,23,0,30,7
1683338801694,TDMV 142,B00,189718,Caligagan; Maria T.,25,0,30,5
1683338802719,TMC 2,A01,187533,Staff,25,0,25,0
1683338802719,TMC 2,A02,187534,Staff,25,0,25,0
1683338803744,USP 1,A01,187536,Kwak; Nancy,0,16,25,25
1683338804770,USP 5,A01,187538,Staff,10,0,25,15
1683338805794,USP 101,A00,199253,Staff,0,4,0,0
1683338806819,USP 124,A00,187562,Boomhower; Matthew Charles,1,0,30,29
1683338807845,USP 138,A00,187582,Staff,20,0,25,5
1683338808874,USP 152,A01,187597,Staff,4,0,25,21
1683338809900,USP 153,A00,187598,Staff,19,0,25,6
1683338810928,USP 168,A00,187607,Kwak; Nancy,2,0,5,3
1683338811954,USP 173,A00,187619,Staff,4,0,25,21
1683338812979,USP 181,A00,187638,Staff,0,0,25,25
1683338814008,VIS 103,A00,187650,Cruz; Edwin Teddy,23,0,75,52
1683338815034,VIS 110D,A00,187669,Staff,12,0,22,10
1683338816068,VIS 127C,A00,187720,Shen; Kuiyi,67,0,146,79
1683338817094,VIS 149,A00,187731,Yoldas; Pinar,0,14,22,22
1683338818120,VIS 151,A01,188091,Staff,22,0,34,12
1683338818120,VIS 151,A02,188092,Staff,11,0,34,23
1683338819146,VIS 160B,A00,188093,Stalbaum; Brett,0,0,10,10
1683338821201,WCWP 10B,A00,201720,Staff,10,0,15,5
1683338821201,WCWP 10B,B00,201722,Staff,9,0,15,6
1683338822229,WCWP 100,A00,201725,Gagnon; Jeffrey C,0,0,2,2
1683338822229,WCWP 100,B00,201727,Staff,0,4,15,15
1683338825365,ANBI 133,A00,258401,Wilder; Linnea Lorene,34,0,40,6
1683338826391,ANBI 140,A00,258395,Hrvoj Mihic; Branka,18,0,25,7
1683338827416,ANSC 120,A00,258402,Bialecki; Jon Anthony,27,0,40,13
1683338828444,ANSC 144,A00,258400,Staff,14,0,40,26
1683338830495,ANSC 166,A00,258396,Parish; Steven Martin,157,0,175,18
1683338831524,ANSC 180,A00,193533,Staff,9,0,20,11
1683338832550,ANSC 188,A00,258397,Jassal; Aftab,33,0,40,7
1683338833578,ANTH 3,A01,258316,Staff,23,0,30,7
1683338834603,ANTH 5,A00,258394,Semendeferi; Ekaterini,16,0,20,4
1683338835633,ANTH 21,A01,258331,Staff,8,0,40,32
1683338836662,ANTH 103,A00,258398,Varma; Saiba,15,0,25,10
1683338837691,AWP 10,001,202034,Staff,0,0,0,0
1683338837691,AWP 10,002,202035,Staff,0,0,0,0
1683338837691,AWP 10,003,202036,Staff,0,0,0,0
1683338837691,AWP 10,004,202037,Staff,0,0,0,0
1683338837691,AWP 10,005,202038,Staff,0,0,0,0
1683338837691,AWP 10,006,202039,Staff,0,0,0,0
1683338837691,AWP 10,007,202040,Staff,0,0,0,0
1683338837691,AWP 10,008,202041,Staff,0,0,0,0
1683338837691,AWP 10,009,202042,Staff,0,0,0,0
1683338837691,AWP 10,010,202043,Staff,0,0,0,0
1683338837691,AWP 10,011,202044,Staff,0,0,0,0
1683338837691,AWP 10,012,202045,Staff,0,0,0,0
1683338837691,AWP 10,013,202046,Staff,0,0,0,0
1683338837691,AWP 10,014,202047,Staff,0,0,0,0
1683338837691,AWP 10,015,202048,Staff,0,0,0,0
1683338837691,AWP 10,016,202049,Staff,0,0,0,0
1683338837691,AWP 10,017,202050,Staff,0,0,0,0
1683338837691,AWP 10,018,202051,Staff,0,0,0,0
1683338837691,AWP 10,019,202052,Staff,0,0,0,0
1683338837691,AWP 10,020,202053,Staff,0,0,0,0
1683338837691,AWP 10,021,202054,Staff,0,0,0,0
1683338837691,AWP 10,022,202055,Staff,0,0,0,0
1683338837691,AWP 10,023,202056,Staff,0,0,0,0
1683338837691,AWP 10,024,202057,Staff,0,0,0,0
1683338837691,AWP 10,025,202058,Staff,0,0,0,0
1683338837691,AWP 10,026,202059,Staff,0,0,0,0
1683338838716,AWP 102,001,202032,Staff,0,0,0,0
1683338838716,AWP 102,002,202033,Staff,0,0,0,0
1683338839743,BENG 100,A01,254234,Taylor Amos; Alyssa C,31,0,40,9
1683338840770,BENG 196,001,270013,Engler; Adam J.,9999,0,9999,0
1683338841802,BICD 100R,A01,202018,Smith; Laurie,0,7,32,32
1683338841802,BICD 100R,A02,202019,Smith; Laurie,0,2,32,32
1683338841802,BICD 100R,A03,202020,Smith; Laurie,0,1,32,32
1683338841802,BICD 100R,A04,202021,Smith; Laurie,9,0,32,23
1683338841802,BICD 100R,A05,202022,Smith; Laurie,12,0,32,20
1683338842887,BICD 136,A01,193242,Gustafson-Brown; Cindy,0,2,32,32
1683338842887,BICD 136,A02,193244,Gustafson-Brown; Cindy,14,0,32,18
1683338843921,BIEB 102,A01,193249,Butler; Shannon Rhey,0,2,32,32
1683338843921,BIEB 102,A02,193251,Butler; Shannon Rhey,0,0,32,32
1683338843921,BIEB 102,A03,193253,Butler; Shannon Rhey,0,1,32,32
1683338843921,BIEB 102,A04,193255,Butler; Shannon Rhey,17,0,32,15
1683338843921,BIEB 102,A05,193265,Butler; Shannon Rhey,26,0,32,6
1683338843921,BIEB 102,A06,193269,Butler; Shannon Rhey,16,0,32,16
1683338845976,BIEB 150,A01,193274,Staff,0,0,32,32
1683338845976,BIEB 150,A02,193285,Staff,23,0,32,9
1683338847002,BIEB 194,A00,193286,Kurle; Carolyn M.,22,0,32,10
1683338848028,BILD 1,A01,192291,Staff,16,0,32,16
1683338848028,BILD 1,A02,192292,Staff,30,0,32,2
1683338848028,BILD 1,B01,192520,Reuther; Keefe,0,1,0,0
1683338848028,BILD 1,B02,192532,Reuther; Keefe,0,1,0,0
1683338849054,BILD 3,A01,192556,Butler; Shannon Rhey,0,0,32,32
1683338849054,BILD 3,A02,192581,Butler; Shannon Rhey,5,0,32,27
1683338849054,BILD 3,A03,192611,Butler; Shannon Rhey,23,0,32,9
1683338849054,BILD 3,A04,192612,Butler; Shannon Rhey,25,0,32,7
1683338849054,BILD 3,A05,192613,Butler; Shannon Rhey,27,0,32,5
1683338849054,BILD 3,A06,192679,Butler; Shannon Rhey,27,0,32,5
1683338849054,BILD 3,A07,192682,Butler; Shannon Rhey,22,0,32,10
1683338850080,BILD 4,A01,192836,Reuther; Keefe,0,0,24,24
1683338850080,BILD 4,A02,193044,Reuther; Keefe,4,0,24,20
1683338851106,BILD 10,A01,193142,Gustafson-Brown; Cindy,30,0,32,2
1683338851106,BILD 10,A02,193149,Gustafson-Brown; Cindy,31,0,32,1
1683338852136,BIMM 100,A01,193301,Staff,0,6,32,32
1683338852136,BIMM 100,A02,193312,Staff,0,5,32,32
1683338852136,BIMM 100,A03,193323,Staff,0,8,32,32
1683338853167,BIMM 101,A01,193329,McDonnell; Lisa Marie,0,3,24,24
1683338853167,BIMM 101,A02,193339,McDonnell; Lisa Marie,0,3,24,24
1683338853167,BIMM 101,B01,193354,McDonnell; Lisa Marie,0,3,24,24
1683338853167,BIMM 101,B02,193357,McDonnell; Lisa Marie,0,3,24,24
1683338854250,BIMM 110,A01,193377,Tat; John,0,11,32,32
1683338854250,BIMM 110,A02,193378,Tat; John,1,9,32,31
1683338855277,BIMM 120,A01,206116,Staff,0,0,32,32
1683338855277,BIMM 120,A02,206117,Staff,8,0,32,24
1683338855277,BIMM 120,A03,206121,Staff,21,0,32,11
1683338856308,BIPN 100,A01,193393,Park; Ji Young,0,14,32,32
1683338856308,BIPN 100,A02,193402,Park; Ji Young,0,13,32,32
1683338856308,BIPN 100,A03,193413,Park; Ji Young,0,14,32,32
1683338856308,BIPN 100,A04,193414,Park; Ji Young,0,13,32,32
1683338857334,BIPN 102,A01,193429,Staff,0,0,32,32
1683338857334,BIPN 102,A02,193438,Staff,22,0,32,10
1683338858359,BIPN 106,A01,193450,Reyes Gonzalez; Catalina,0,2,40,40
1683338859389,BIPN 134,A01,193465,Cooke; James Edward,0,0,32,32
1683338859389,BIPN 134,A02,193474,Cooke; James Edward,25,0,32,7
1683338859389,BIPN 134,A03,193485,Cooke; James Edward,29,0,32,3
1683338859389,BIPN 134,A04,193486,Cooke; James Edward,21,0,32,11
1683338859389,BIPN 134,A05,193491,Cooke; James Edward,31,0,32,1
1683338859389,BIPN 134,A06,193501,Cooke; James Edward,30,0,32,2
1683338859389,BIPN 134,A07,193510,Cooke; James Edward,29,0,32,3
1683338861440,BISP 194,A00,222522,Staff,14,0,32,18
1683338862465,CAT 124,A01,202407,Staff,20,0,25,5
1683338863490,CAT 125,A00,202408,Marchisotto; Jennifer Anne,4,0,20,16
1683338864516,CAT 125R,A00,202409,Smith; Lauryn Alissa,0,11,20,20
1683338864516,CAT 125R,B00,202410,Morales; Celeste Georgianna,0,11,20,20
1683338864516,CAT 125R,C00,202411,Irwin; Matthew Joseph,0,10,20,20
1683338865541,CENG 15,A01,204712,Yang; Kesong,0,1,0,0
1683338866571,CENG 114,A00,202070,Jahed Motlagh; Zeinab,5,0,20,15
1683338867600,CGS 105,A00,185477,Wesling; Megan E.,24,0,40,16
1683338868629,CGS 106,A00,185494,Staff,13,0,22,9
1683338869657,CGS 108,A00,185495,Staff,14,0,20,6
1683338870685,CGS 114,A00,185496,Staff,13,0,18,5
1683338871712,CGS 119,A00,185501,Staff,15,0,20,5
1683338872740,CGS 120,A00,185511,Staff,13,0,20,7
1683338873766,CHEM 4,A01,184675,Bussey; Thomas J,96,0,100,4
1683338874791,CHEM 6A,A01,184677,Staff,34,0,60,26
1683338875819,CHEM 6B,A01,184679,Staff,65,0,100,35
1683338876845,CHEM 6C,A01,184681,Bussey; Thomas J,1,0,50,49
1683338876845,CHEM 6C,A02,184682,Bussey; Thomas J,34,0,50,16
1683338877872,CHEM 40A,A01,184684,Albizati; Kim F.,37,0,100,63
1683338878902,CHEM 40B,A01,184686,Albizati; Kim F.,0,20,100,100
1683338879926,CHEM 41B,A01,184690,Staff,52,0,100,48
1683338880952,COGS 3,A01,184715,Boyle; Mary E. T.,0,25,40,40
1683338881981,COGS 14B,A01,185172,Staff,0,15,38,38
1683338883009,COGS 18,A01,184736,Staff,17,0,80,63
1683338884038,COGS 100,A01,184932,Staff,0,5,73,73
1683338885068,COGS 101A,A01,184935,Staff,0,39,30,30
1683338886094,COGS 101B,A01,184944,Staff,0,2,30,30
1683338887121,COGS 101C,A01,184946,Staff,0,12,30,30
1683338888150,COGS 102A,A01,184951,Johnson; Christine M.,2,0,40,38
1683338889175,COGS 107B,A01,184953,Mooshagian; Eric Frederick,0,50,40,40
1683338890198,COGS 118B,A01,184959,Gupta; Anjum,0,48,40,40
1683338891227,COGS 153,A00,184961,Staff,0,15,30,30
1683338892255,COGS 177,A00,184962,Staff,0,20,30,30
1683338893281,COGS 187A,A01,184969,Boyle; Mary E. T.,0,17,40,40
1683338894310,COMM 10,A01,185174,Staff,0,5,25,25
1683338894310,COMM 10,A02,185189,Staff,0,5,25,25
1683338894310,COMM 10,A03,269821,Staff,0,0,0,0
1683338895338,COMM 100B,A01,185475,Staff,0,0,0,2
1683338895338,COMM 100B,A02,185476,Staff,13,0,25,12
1683338896366,COMM 100C,A01,185314,Staff,1,0,25,24
1683338896366,COMM 100C,A02,185327,Staff,19,0,25,6
1683338897393,COMM 110M,A00,185349,Staff,2,0,40,38
1683338898420,COMM 113T,A00,185352,Staff,24,0,40,16
1683338899448,COMM 114I,A00,185353,Staff,33,0,40,7
1683338900473,COMM 131,A00,185354,Staff,19,0,30,11
1683338901500,CSE 8A,A50,185358,Cao; Yingjun,0,46,10,10
1683338902527,CSE 8B,A01,185362,Staff,1,47,50,49
1683338903560,CSE 11,A01,185416,Cao; Yingjun,0,92,10,10
1683338904588,CSE 20,A01,185445,Briones; Jor-el Thomas Caparas,5,0,25,20
1683338905612,CSE 21,A01,185447,Staff,10,0,50,40
1683338906642,CSE 101,A01,185451,Staff,0,13,50,50
1683338906642,CSE 101,B01,185453,Jones; Miles E,0,11,50,50
1683338908694,CSE 141,A01,185458,Eldon; John,20,0,100,80
1683338909719,CSE 141L,A01,185461,Eldon; John,12,0,100,88
1683338910745,CSE 142,A01,185463,Staff,36,0,60,24
1683338910745,CSE 142,B01,201355,Staff,0,7,60,60
1683338911772,CSE 142L,A01,185470,Staff,36,0,60,24
1683338911772,CSE 142L,B01,201417,Staff,0,6,60,60
1683338912804,CSE 190,A00,201433,Staff,32,0,49,17
1683338913834,DOC 1,A01,259136,Strom; Megan C.,7,0,15,8
1683338913834,DOC 1,A02,259137,Strom; Megan C.,14,0,15,1
1683338913834,DOC 1,A03,259138,Strom; Megan C.,14,0,15,1
1683338913834,DOC 1,A04,259139,Strom; Megan C.,14,0,15,1
1683338914862,DOC 100D,A00,259140,Pass; Natalye Joann,16,0,25,9
1683338915890,DSGN 1,A01,184749,Rill; Bryan,0,25,30,30
1683338916919,DSGN 100,A01,185168,Staff,0,2,25,25
1683338917945,ECE 5,A01,185626,Morris; Karcher William,0,10,0,0
1683338918970,ECE 101,A01,185628,Staff,17,0,70,53
1683338920004,ECE 107,A01,185635,Baghdadchi; Saharnaz,0,0,20,20
1683338920004,ECE 107,A02,185638,Baghdadchi; Saharnaz,4,0,20,16
1683338921035,ECE 148,A01,185647,Silberman; Jack,0,0,16,16
1683338922061,ECON 1,A01,185537,Crane; Meredith Helen,54,0,70,16
1683338923089,ECON 3,A01,185549,Crane; Meredith Helen,33,0,70,37
1683338924114,ECON 4,A01,203354,Anderson; John Charles,0,4,10,10
1683338925142,ECON 100A,A01,185574,Staff,0,4,40,40
1683338926168,ECON 100B,A01,185576,Staff,10,22,50,40
1683338927196,ECON 100C,A01,185589,Newhouse; Herbert S,30,0,70,40
1683338928225,ECON 105,A00,185608,Vespa; Emanuel Ignacio,19,0,35,16
1683338929248,ECON 109,A01,185610,Shishkin; Denis,10,0,35,25
1683338930276,ECON 110A,A01,185612,Staff,11,0,40,29
1683338931303,ECON 120A,A01,185615,Staff,20,0,40,20
1683338932328,ECON 120C,A01,185617,Sun; Yixiao,0,20,70,70
1683338933356,ECON 144,A00,203346,Squires; Dale E,3,0,35,32
1683338934382,ECON 171,A01,203349,Newhouse; Herbert S,0,1,35,35
1683338935408,ECON 173A,A01,185621,Toda; Alexis Akira,21,0,35,14
1683338936434,EDS 25,A01,202413,Staff,0,1,0,0
1683338936434,EDS 25,A02,202414,Staff,0,1,0,0
1683338936434,EDS 25,A03,202415,Staff,0,0,0,0
1683338936434,EDS 25,A04,202416,Staff,0,1,0,0
1683338936434,EDS 25,A05,202439,Staff,0,0,0,0
1683338936434,EDS 25,A06,202440,Staff,0,0,0,0
1683338936434,EDS 25,B01,202631,Staff,0,0,0,0
1683338936434,EDS 25,B02,202632,Staff,0,0,0,0
1683338936434,EDS 25,B03,202639,Staff,0,0,0,0
1683338936434,EDS 25,B04,202640,Staff,0,0,0,0
1683338936434,EDS 25,B05,202643,Staff,0,0,0,0
1683338936434,EDS 25,B06,202644,Staff,0,0,0,0
1683338937462,EDS 38,A01,202659,Black; Alison Michelle,24,0,25,1
1683338938488,EDS 115,A00,202652,Staff,18,0,30,12
1683338939512,EDS 125,A00,202649,Staff,14,0,30,16
1683338940538,EDS 126,A01,203332,Staff,30,0,30,0
1683338941563,EDS 139,A00,202838,Staff,16,0,25,9
1683338942590,EDS 146,A01,202655,Staff,14,0,25,11
1683338943620,ENG 15,A00,185667,Staff,0,1,0,0
1683338943620,ENG 15,B00,185672,Staff,0,0,0,0
1683338943620,ENG 15,C00,185675,Staff,0,0,0,0
1683338943620,ENG 15,D00,185682,Staff,0,0,0,0
1683338943620,ENG 15,E00,185684,Staff,0,0,0,0
1683338944646,ETHN 103,A00,185710,Staff,0,4,35,35
1683338945671,ETHN 103A,A00,199228,Man; Simeon S,2,0,9,7
1683338946699,ETHN 109,A00,185711,Staff,18,0,35,17
1683338947727,ETHN 142,A00,185726,Staff,0,4,30,30
1683338948752,ETHN 163J,A00,199229,Man; Simeon S,5,0,8,3
1683338949777,ETHN 168,A00,185727,Staff,8,0,10,2
1683338950801,ETHN 182,A00,185728,Staff,1,0,35,34
1683338951830,ETHN 183,A00,185737,Staff,8,0,18,10
1683338952855,GLBH 111,A01,209361,Burgos; Jose L.,0,0,0,0
1683338954912,HIEU 104,A00,185792,Staff,16,0,20,4
1683338955935,HIEU 115,A00,185800,Staff,1,0,20,19
1683338956963,HIEU 128,A00,185801,Staff,0,7,20,20
1683338958044,HIEU 147,A00,185802,Staff,16,0,20,4
1683338959071,HIEU 154,A00,185823,Staff,12,0,20,8
1683338960094,HILA 102,A00,185826,Staff,13,0,20,7
1683338961119,HILD 2C,A01,185778,Staff,0,12,20,20
1683338962145,HILD 7B,A01,185780,Kwak; Nancy,0,15,32,32
1683338962145,HILD 7B,A02,185781,Kwak; Nancy,0,18,32,32
1683338963174,HILD 30,A01,185791,Staff,14,0,20,6
1683338964202,HISC 119,A00,185830,Golan; Tal,0,9,20,20
1683338965228,HITO 156GS,A00,185831,Patterson; Patrick H.,0,0,0,23
1683338966257,HIUS 103,A00,185832,Man; Simeon S,0,6,20,20
1683338967285,HIUS 117,A00,185836,Kwak; Nancy,2,0,20,18
1683338968309,HIUS 125,A00,185840,Man; Simeon S,0,0,23,23
1683338969335,HIUS 149,A00,185845,Staff,0,0,20,20
1683338970364,HUM 3,A01,185882,Zavodny; Tatiana Sophia,0,7,50,50
1683338970364,HUM 3,B01,185899,Caldwell; Michael Alan,0,18,50,50
1683338971390,HUM 3GS,A00,185900,Patterson; Patrick H.,0,0,0,23
1683338972420,HUM 4,A01,185938,Zroka; Amy Liane,31,0,50,19
1683338972420,HUM 4,B01,185956,Watkins; Eric,0,2,50,50
1683338972420,HUM 4,B02,202209,Watkins; Eric,0,2,50,50
1683338972420,HUM 4,B03,202210,Watkins; Eric,0,2,50,50
1683338973449,HUM 5,A01,185958,West; Geoffrey Scott,3,0,50,47
1683338973449,HUM 5,A02,202215,West; Geoffrey Scott,0,0,50,50
1683338974478,INTL 190,A00,185959,Gagnon; Jeffrey C,0,0,0,9
1683338974478,INTL 190,B00,185960,Lettieri; Michael Joseph,0,0,0,1
1683338975504,JAPN 180,A00,254509,Staff,5,1,30,25
1683338976528,LATI 10,A01,202853,Kennemore; Amy Michelle,4,0,35,31
1683338976528,LATI 10,A02,202854,Kennemore; Amy Michelle,2,0,35,33
1683338976528,LATI 10,A03,270054,Kennemore; Amy Michelle,30,0,30,0
1683338977557,LATI 180,A00,202855,Kennemore; Amy Michelle,11,0,20,9
1683338978588,LAWS 101,A00,201767,Golan; Tal,0,7,40,40
1683338979615,LIFR 1C,A00,185961,Staff,6,0,20,14
1683338980639,LIFR 1CX,A00,185962,Staff,7,0,20,13
1683338981665,LIFR 1D,A00,185963,Staff,9,0,20,11
1683338982690,LIFR 1DX,A00,185964,Staff,9,0,20,11
1683338983720,LIGN 101,A01,186039,Staff,43,0,50,7
1683338984748,LIGN 165,A00,186040,Staff,18,0,50,32
1683338985776,LTCS 108,A00,186041,Staff,6,0,10,4
1683338986803,LTCS 119,A00,186042,Staff,16,0,20,4
1683338987830,LTCS 130,A00,186043,Wesling; Megan E.,15,0,25,10
1683338989881,LTEA 138,A00,186119,Staff,14,0,40,26
1683338990907,LTEN 124,A00,186148,Staff,6,0,25,19
1683338991932,LTEN 178,A00,186149,Staff,7,0,15,8
1683338992959,LTEN 181,A00,186150,Blanco; John D,33,0,40,7
1683338993983,LTWL 120,A00,186160,Staff,20,0,25,5
1683338995010,LTWL 165,A00,186161,Staff,22,0,25,3
1683338996036,LTWR 100,A00,186162,Staff,0,5,15,15
1683338997062,LTWR 102,A00,186163,Doller; Ben,5,0,15,10
1683338998086,MAE 8,A01,186412,Staff,0,0,0,0
1683338999111,MAE 30B,A00,186445,Bahadori; Mohammad Yousef,83,0,100,17
1683339000137,MAE 40,A00,186592,Bewley; Thomas R,9,0,50,41
1683339001162,MAE 101B,A00,186593,Bahadori; Mohammad Yousef,81,0,100,19
1683339002192,MAE 105,A00,186594,Bandaru; Prabhakar,12,0,50,38
1683339003221,MAE 107,A00,186599,Pham; Hieu Tan,0,6,120,120
1683339004245,MAE 148,A01,186660,Silberman; Jack,3,0,16,13
1683339005275,MATH 10A,A01,188095,Staff,1,6,35,34
1683339006301,MATH 10B,A01,188097,Bowers; Adam R.,0,11,30,30
1683339006301,MATH 10B,A02,188099,Bowers; Adam R.,0,11,30,30
1683339006301,MATH 10B,B01,188104,Bowers; Adam R.,0,10,30,30
1683339006301,MATH 10B,B02,188106,Bowers; Adam R.,0,10,30,30
1683339007328,MATH 10C,A01,188111,Staff,0,18,30,30
1683339007328,MATH 10C,A02,188127,Staff,0,17,30,30
1683339007328,MATH 10C,A03,188131,Staff,0,18,30,30
1683339007328,MATH 10C,B01,188218,Staff,18,0,30,12
1683339007328,MATH 10C,B02,188244,Staff,13,0,30,17
1683339007328,MATH 10C,B03,188277,Staff,16,0,30,14
1683339008362,MATH 18,A01,188344,Bach; Quang Tran,18,0,30,12
1683339008362,MATH 18,A02,188345,Bach; Quang Tran,11,0,30,19
1683339008362,MATH 18,B01,188353,Bach; Quang Tran,10,0,30,20
1683339008362,MATH 18,B02,188354,Bach; Quang Tran,20,0,30,10
1683339009392,MATH 20A,A01,188374,Staff,13,0,35,22
1683339010423,MATH 20B,A01,188382,Ohm; Ko Woon,6,0,30,24
1683339010423,MATH 20B,A02,188383,Ohm; Ko Woon,22,0,30,8
1683339010423,MATH 20B,B01,188385,Ohm; Ko Woon,7,0,30,23
1683339010423,MATH 20B,B02,188392,Ohm; Ko Woon,22,0,30,8
1683339011451,MATH 20C,A01,188394,Harel; Guershon,10,0,30,20
1683339011451,MATH 20C,A02,188395,Harel; Guershon,15,0,30,15
1683339011451,MATH 20C,B01,188404,Harel; Guershon,5,0,30,25
1683339011451,MATH 20C,B02,188405,Harel; Guershon,19,0,30,11
1683339012477,MATH 20D,A01,188414,Hammock; Frances H,0,1,30,30
1683339012477,MATH 20D,A02,188415,Hammock; Frances H,3,0,30,27
1683339012477,MATH 20D,B01,188447,Hammock; Frances H,1,0,30,29
1683339012477,MATH 20D,B02,188486,Hammock; Frances H,8,0,30,22
1683339013504,MATH 20E,A01,188649,Staff,21,0,30,9
1683339013504,MATH 20E,A02,188650,Staff,23,0,30,7
1683339013504,MATH 20E,A03,188673,Staff,0,0,30,30
1683339014533,MATH 102,A01,188675,Staff,0,35,35,35
1683339015563,MATH 103B,A01,188681,Staff,3,0,35,32
1683339015563,MATH 103B,B01,188692,Staff,5,0,35,30
1683339016591,MATH 109,A01,188695,Salehi Golsefidy; Alireza,25,0,35,10
1683339016591,MATH 109,A02,188696,Salehi Golsefidy; Alireza,25,0,35,10
1683339017615,MATH 120A,A01,188698,Eggers; John Dietrich,7,0,35,28
1683339018641,MATH 142B,A01,188736,Ioana; Adrian,0,2,30,30
1683339018641,MATH 142B,A02,188741,Ioana; Adrian,1,1,30,29
1683339018641,MATH 142B,A03,188743,Ioana; Adrian,1,3,30,29
1683339019670,MATH 168A,A01,188790,Staff,0,9,35,35
1683339020694,MATH 170A,A01,188803,Nie; Jiawang,0,2,35,35
1683339020694,MATH 170A,A02,188811,Nie; Jiawang,0,0,35,35
1683339020694,MATH 170A,A03,188814,Nie; Jiawang,1,0,35,34
1683339020694,MATH 170A,A04,188815,Nie; Jiawang,13,0,35,22
1683339021719,MATH 193B,A01,188817,Staff,0,0,35,35
1683339021719,MATH 193B,A02,188818,Staff,5,0,35,30
1683339022747,MGT 4,A01,202857,Anderson; John Charles,62,0,80,18
1683339023777,MGT 12,A00,202858,Lindenberger; Wade Douglas,42,0,90,48
1683339024805,MGT 18,A00,202859,Staff,74,0,90,16
1683339025834,MGT 18GS,A00,202860,McKay; Michael J,13,0,28,15
1683339026862,MGT 45,A00,202861,Pecore; Joseph P.,14,0,90,76
1683339027890,MGT 100,A00,202863,Yavorsky; Daniel Ryan,28,0,90,62
1683339028915,MGT 103,A00,202864,Ehrich; Kristine R,1,18,90,89
1683339029940,MGT 112,A00,202865,Ehrich; Kristine R,15,0,90,75
1683339030965,MGT 121A,A00,202868,Staff,0,20,0,0
1683339031990,MGT 131B,A00,202869,Anderson; John Charles,59,0,90,31
1683339033015,MGT 136,A00,202871,Lindenberger; Wade Douglas,84,0,90,6
1683339034041,MGT 164,A00,202873,Staff,0,68,90,91
1683339035069,MGT 164GS,A00,202874,McKay; Mary A,13,0,28,15
1683339036099,MGT 180,A00,202875,Staff,0,50,90,91
1683339037127,MMW 11R,A01,205019,Herbst; Matthew,3,0,30,27
1683339037127,MMW 11R,A02,205026,Herbst; Matthew,29,0,30,1
1683339038158,MMW 15,A01,193512,Chang; Edmond Yi-Teh,0,9,28,28
1683339038158,MMW 15,A02,193513,Chang; Edmond Yi-Teh,0,5,28,28
1683339038158,MMW 15,A03,193514,Chang; Edmond Yi-Teh,0,5,28,28
1683339038158,MMW 15,A04,193515,Chang; Edmond Yi-Teh,0,5,28,28
1683339038158,MMW 15,A05,193516,Chang; Edmond Yi-Teh,0,4,28,28
1683339038158,MMW 15,A06,193517,Chang; Edmond Yi-Teh,0,5,28,28
1683339038158,MMW 15,B01,193519,Chang; Edmond Yi-Teh,0,5,28,28
1683339038158,MMW 15,B02,193520,Chang; Edmond Yi-Teh,0,5,28,28
1683339038158,MMW 15,B03,193521,Chang; Edmond Yi-Teh,0,5,28,28
1683339038158,MMW 15,B04,193522,Chang; Edmond Yi-Teh,0,4,28,28
1683339038158,MMW 15,B05,193523,Chang; Edmond Yi-Teh,0,5,28,28
1683339038158,MMW 15,B06,193524,Chang; Edmond Yi-Teh,0,4,28,28
1683339039186,MMW 122,A01,193526,Rahimi; Babak,0,15,28,28
1683339039186,MMW 122,A02,193527,Rahimi; Babak,0,14,28,28
1683339039186,MMW 122,A03,193528,Rahimi; Babak,0,0,0,0
1683339039186,MMW 122,A04,193529,Rahimi; Babak,0,0,0,0
1683339040214,MUS 1A,A01,186663,Staff,0,20,35,35
1683339041243,MUS 4,A01,186715,Staff,0,12,35,35
1683339042268,MUS 5R,A01,186796,Dubnov; Shlomo,0,17,35,35
1683339043293,MUS 6,A01,186798,Staff,0,4,25,25
1683339044322,MUS 7,A01,186830,Staff,13,0,35,22
1683339045346,MUS 8,A01,186930,Staff,0,26,35,35
1683339046371,MUS 15,A01,186932,Staff,0,16,35,35
1683339046371,MUS 15,B01,186934,Staff,0,15,35,35
1683339047399,MUS 80,A00,186935,Staff,1,0,20,19
1683339047399,MUS 80,B00,186936,Staff,25,0,25,0
1683339048426,NANO 11,A00,204702,Lipomi; Darren John,0,0,0,0
1683339049450,NANO 15,A01,204709,Yang; Kesong,0,1,0,0
1683339050478,NANO 114,A00,202069,Jahed Motlagh; Zeinab,3,0,10,7
1683339051505,PHIL 1,A00,186955,Grush; Rick Scott,32,0,40,8
1683339052530,PHIL 10,A01,186973,Grush; Rick Scott,28,0,35,7
1683339052530,PHIL 10,A02,186974,Grush; Rick Scott,33,0,35,2
1683339053558,PHIL 13,A01,186976,Staff,7,0,35,28
1683339053558,PHIL 13,A02,186977,Staff,16,0,35,19
1683339054582,PHIL 14,A01,186979,Staff,31,0,35,4
1683339054582,PHIL 14,A02,186986,Staff,32,0,35,3
1683339055606,PHIL 28,A01,186988,Staff,16,0,30,14
1683339055606,PHIL 28,A02,186989,Staff,1,0,30,29
1683339055606,PHIL 28,A03,186990,Staff,9,0,30,21
1683339055606,PHIL 28,A04,186991,Staff,26,0,30,4
1683339056633,PHIL 120,A00,186997,Staff,23,0,40,17
1683339057657,PHIL 137,A00,187003,Staff,9,0,40,31
1683339058683,PHIL 150,A00,187015,Staff,47,0,70,23
1683339059712,PHIL 167,A00,187021,Lamey; Andy M.,35,0,40,5
1683339060742,PHIL 174,A01,202226,Staff,17,0,20,3
1683339060742,PHIL 174,A02,202235,Staff,20,0,20,0
1683339061827,PHIL 191A,A00,258918,Staff,0,0,1,1
1683339062854,PHYS 1A,A00,187028,Staff,27,0,60,33
1683339063880,PHYS 1AL,001,187036,Staff,2,0,30,28
1683339063880,PHYS 1AL,002,187049,Staff,18,0,30,12
1683339064906,PHYS 1B,A00,187058,Staff,22,0,60,38
1683339065932,PHYS 1BL,001,187064,Staff,0,0,30,30
1683339065932,PHYS 1BL,002,187070,Staff,5,0,30,25
1683339066956,PHYS 1C,A00,187082,Staff,31,0,120,89
1683339067986,PHYS 1CL,001,187088,Staff,0,9,30,30
1683339067986,PHYS 1CL,002,187089,Staff,0,2,30,30
1683339067986,PHYS 1CL,009,262693,Staff,11,0,30,19
1683339069018,PHYS 2B,A01,187097,Staff,54,0,115,61
1683339070047,PHYS 2C,A01,187099,Staff,67,0,115,48
1683339071079,PHYS 2CL,A01,187101,Staff,5,0,28,23
1683339071079,PHYS 2CL,A02,187102,Staff,15,0,28,13
1683339072102,PHYS 2D,A01,187123,Shotwell; Brian,95,0,115,20
1683339073126,PHYS 4B,A01,187133,Grinstein; Benjamin,35,0,50,15
1683339074151,POLI 10,A00,188819,Staff,0,4,50,50
1683339075176,POLI 11,A00,188827,Staff,43,0,50,7
1683339076203,POLI 13R,A00,188828,Staff,0,1,20,20
1683339077229,POLI 27,A01,188830,Elgin; Samuel Zincke,0,1,70,70
1683339078259,POLI 30,A00,188832,Desposato; Scott,31,0,50,19
1683339079286,POLI 102F,A00,188834,Staff,3,0,40,37
1683339080314,POLI 104A,A00,188852,Staff,14,0,30,16
1683339081342,POLI 104I,A00,188853,Staff,0,6,20,20
1683339082367,POLI 110B,A00,188854,Wiens; David,7,0,20,13
1683339083395,POLI 112A,A00,188855,Wiens; David,5,0,30,25
1683339084419,POLI 117R,A00,188856,Forman; Fonna,0,11,20,20
1683339085447,POLI 118,A00,188857,Ingham; Sean,8,0,20,12
1683339086475,POLI 120G,A00,188858,Staff,9,0,30,21
1683339087499,POLI 131CR,A00,188863,Hoston; Germaine,24,0,50,26
1683339088524,POLI 133,A00,188864,Nellis; Gareth Hb,44,0,50,6
1683339089550,POLI 134D,A00,188865,Desposato; Scott,27,0,30,3
1683339090574,POLI 142A,A00,188871,Gartzke; Erik,22,0,50,28
1683339091600,POLI 142K,A00,188874,Staff,38,0,50,12
1683339092628,POLI 143,A00,188940,Gartzke; Erik,16,0,30,14
1683339093653,POLI 153,A00,188943,Staff,3,0,20,17
1683339094676,POLI 160AA,A00,188944,Staff,12,0,40,28
1683339095702,POLI 170A,A00,188945,Staff,11,0,30,19
1683339097755,PSYC 1,A00,188952,Staff,37,0,90,53
1683339098785,PSYC 2,B00,188953,Staff,19,0,35,16
1683339099813,PSYC 6,A00,188970,Staff,47,0,60,13
1683339100841,PSYC 7,A00,188973,Staff,37,0,45,8
1683339101867,PSYC 60,A01,188980,Rickard; Timothy C.,43,0,60,17
1683339102894,PSYC 70,A01,189001,Steiner; Eric Tomas,24,0,45,21
1683339103921,PSYC 100,A00,189005,Lacefield; Katharine I,0,98,120,120
1683339104946,PSYC 102,A00,189008,Staff,9,0,30,21
1683339105975,PSYC 106,B00,189026,Gorman; Michael R.,34,0,60,26
1683339107008,PSYC 114,B01,189033,Winkielman; Piotr,0,32,30,30
1683339108033,PSYC 131,A00,189036,Anagnostaras; Stephan,0,43,60,60
1683339109058,PSYC 136,A00,189041,Lowe; Angela Beth,0,7,25,25
1683339110087,PSYC 137,A00,189057,Winkielman; Piotr,0,34,25,25
1683339111110,PSYC 144,A00,189107,Wixted; John T,0,7,50,50
1683339113162,PSYC 162,A00,189142,Staff,0,8,85,85
1683339114187,PSYC 172,A00,189144,Gorman; Michael R.,0,7,30,30
1683339116238,PSYC 179,A00,189146,Lacefield; Katharine I,0,84,120,120
1683339117263,PSYC 181,A00,189147,Anagnostaras; Stephan,0,44,90,90
1683339118291,PSYC 190R,A00,189148,Barner; David A.,0,22,80,80
1683339119318,PSYC 191,A00,189275,Rickard; Timothy C.,0,7,25,25
1683339120346,PSYC 193,A00,189276,Chapman; Eddie Nathaniel,0,1,0,4
1683339121370,PSYC 193L,A01,189281,Lowe; Angela Beth,12,0,20,8
1683339121370,PSYC 193L,B01,189285,Staff,28,0,35,7
1683339122400,RELI 149,A00,187137,Rahimi; Babak,7,0,40,33
1683339123427,SE 9,A01,187315,Staff,0,2,18,18
1683339124450,SE 101B,A00,187409,Staff,24,0,30,6
1683339125479,SE 110B,A00,187444,Staff,10,0,40,30
1683339126505,SE 130B,A00,187449,Staff,31,0,40,9
1683339127531,SE 150A,A00,187516,Staff,9,0,20,11
1683339128558,SE 154,A00,187528,Staff,30,0,50,20
1683339129590,SIO 3,A01,258171,Staff,35,0,40,5
1683339130618,SIO 10,A00,187144,Cook; Geoffrey W,0,3,75,75
1683339131643,SIO 45,A00,187152,Cook; Geoffrey W,1,0,100,99
1683339132668,SIO 109R,A00,194486,Staff,0,3,20,20
1683339134727,SIO 187,A01,187233,Kacev; David,12,0,40,28
1683339135756,SOCI 1,A01,258656,Thorpe; Charles Robert,28,0,30,2
1683339135756,SOCI 1,A02,258658,Thorpe; Charles Robert,30,0,30,0
1683339135756,SOCI 1,A03,258661,Thorpe; Charles Robert,25,0,25,0
1683339135756,SOCI 1,A04,258666,Thorpe; Charles Robert,22,0,25,3
1683339135756,SOCI 1,A05,258897,Thorpe; Charles Robert,23,0,25,2
1683339135756,SOCI 1,A06,258898,Thorpe; Charles Robert,25,0,25,0
1683339136786,SOCI 30,A01,258903,Pardo Guerra; Juan Pablo,15,0,30,15
1683339137816,SOCI 102,A00,258904,Staff,9,0,25,16
1683339138842,SOCI 106,A00,258905,Staff,19,0,25,6
1683339139874,SOCI 111,A00,258907,Ribas Norris; Janet Vanesa,26,0,30,4
1683339140904,SOCI 121R,A00,258908,Pardo Guerra; Juan Pablo,10,0,30,20
1683339141933,SOCI 126,A01,203330,Staff,14,0,20,6
1683339142957,SOCI 131,A00,258909,Thorpe; Charles Robert,31,0,60,29
1683339143986,SOCI 135,A00,258910,Payne; Christine Anna,0,9,30,30
1683339145014,SOCI 157,A00,258911,Staff,12,0,30,18
1683339146039,SOCI 184,A00,258912,Staff,25,0,30,5
1683339147063,SOCI 188D,A00,258913,Staff,21,0,30,9
1683339148086,SYN 2,001,187529,Staff,10,0,16,6
1683339148086,SYN 2,002,201452,Staff,0,18,16,16
1683339148086,SYN 2,003,201469,Staff,3,0,16,13
1683339149115,SYN 100,A01,187531,Staff,0,9,20,20
1683339149115,SYN 100,B01,201491,Staff,0,12,20,20
1683339150143,TDAC 1,A00,189286,Walsh; Kim C.,3,0,20,17
1683339150143,TDAC 1,B00,189287,Harting; Carla Kelso,11,0,20,9
1683339151172,TDAC 101,A00,189300,Walsh; Kim C.,16,0,20,4
1683339151172,TDAC 101,B00,189301,Harting; Carla Kelso,18,0,20,2
1683339152202,TDAC 102,A00,189304,Basso; Beatrice,14,0,20,6
1683339153228,TDAC 108,A00,189305,Staff,18,0,20,2
1683339154258,TDDE 131,A00,189310,Staff,19,0,20,1
1683339154258,TDDE 131,B00,189314,Staff,19,0,20,1
1683339154258,TDDE 131,C00,189315,Staff,48,0,50,2
1683339154258,TDDE 131,D00,189316,Staff,14,0,15,1
1683339154258,TDDE 131,E00,204841,Staff,20,0,20,0
1683339155284,TDGE 10,A00,189289,Staff,30,0,50,20
1683339155284,TDGE 10,B00,189290,Havis; Allan,1,0,50,49
1683339156311,TDGE 11,A00,189291,Fulton; Julia,0,3,50,50
1683339156311,TDGE 11,B00,189292,Staff,20,0,25,5
1683339156311,TDGE 11,C00,260270,Staff,0,0,0,0
1683339157336,TDGE 25,A00,189294,Staff,3,0,20,17
1683339158361,TDGE 124,A00,189318,Fulton; Julia,0,8,50,50
1683339159388,TDGE 125,A00,189319,Staff,13,0,25,12
1683339159388,TDGE 125,B00,189320,Staff,23,0,25,2
1683339160415,TDGE 127,A00,189322,Havis; Allan,0,0,50,50
1683339161441,TDHT 101,A00,189323,Staff,18,0,25,7
1683339161441,TDHT 101,B00,189324,Staff,25,0,25,0
1683339162468,TDHT 102,A00,189325,Staff,49,0,50,1
1683339163493,TDMV 1,A00,189295,Arcidiacono; Kristin,19,0,30,11
1683339163493,TDMV 1,B00,189296,Caligagan; Maria T.,24,0,30,6
1683339164518,TDMV 2,A00,189297,Sammartano; Tonnie,28,0,30,2
1683339164518,TDMV 2,B00,189299,Arcidiacono; Kristin,24,0,30,6
1683339165595,TDMV 3,A00,204998,Rincon; Alicia,22,0,30,8
1683339166621,TDMV 120,A00,189458,Sammartano; Tonnie,28,0,30,2
1683339167646,TDMV 138,A00,189541,Jun; Grace Shin Hae,22,0,40,18
1683339168672,TDMV 142,A00,189717,Caligagan; Tony,23,0,30,7
1683339168672,TDMV 142,B00,189718,Caligagan; Maria T.,25,0,30,5
1683339169698,TMC 2,A01,187533,Staff,25,0,25,0
1683339169698,TMC 2,A02,187534,Staff,25,0,25,0
1683339170730,USP 1,A01,187536,Kwak; Nancy,0,16,25,25
1683339171760,USP 5,A01,187538,Staff,10,0,25,15
1683339172786,USP 101,A00,199253,Staff,0,4,0,0
1683339173812,USP 124,A00,187562,Boomhower; Matthew Charles,1,0,30,29
1683339174838,USP 138,A00,187582,Staff,20,0,25,5
1683339175862,USP 152,A01,187597,Staff,4,0,25,21
1683339176890,USP 153,A00,187598,Staff,19,0,25,6
1683339177915,USP 168,A00,187607,Kwak; Nancy,2,0,5,3
1683339178942,USP 173,A00,187619,Staff,4,0,25,21
1683339179966,USP 181,A00,187638,Staff,0,0,25,25
1683339180992,VIS 103,A00,187650,Cruz; Edwin Teddy,23,0,75,52
1683339182019,VIS 110D,A00,187669,Staff,12,0,22,10
1683339183047,VIS 127C,A00,187720,Shen; Kuiyi,67,0,146,79
1683339184075,VIS 149,A00,187731,Yoldas; Pinar,0,14,22,22
1683339185109,VIS 151,A01,188091,Staff,22,0,34,12
1683339185109,VIS 151,A02,188092,Staff,11,0,34,23
1683339186137,VIS 160B,A00,188093,Stalbaum; Brett,0,0,10,10
1683339188188,WCWP 10B,A00,201720,Staff,10,0,15,5
1683339188188,WCWP 10B,B00,201722,Staff,9,0,15,6
1683339189216,WCWP 100,A00,201725,Gagnon; Jeffrey C,0,0,2,2
1683339189216,WCWP 100,B00,201727,Staff,0,4,15,15
1683339192313,ANBI 133,A00,258401,Wilder; Linnea Lorene,34,0,40,6
1683339193342,ANBI 140,A00,258395,Hrvoj Mihic; Branka,18,0,25,7
1683339194367,ANSC 120,A00,258402,Bialecki; Jon Anthony,27,0,40,13
1683339195393,ANSC 144,A00,258400,Staff,14,0,40,26
1683339197445,ANSC 166,A00,258396,Parish; Steven Martin,157,0,175,18
1683339198471,ANSC 180,A00,193533,Staff,9,0,20,11
1683339199496,ANSC 188,A00,258397,Jassal; Aftab,33,0,40,7
1683339200522,ANTH 3,A01,258316,Staff,23,0,30,7
1683339201547,ANTH 5,A00,258394,Semendeferi; Ekaterini,16,0,20,4
1683339202573,ANTH 21,A01,258331,Staff,8,0,40,32
1683339203600,ANTH 103,A00,258398,Varma; Saiba,15,0,25,10
1683339204634,AWP 10,001,202034,Staff,0,0,0,0
1683339204634,AWP 10,002,202035,Staff,0,0,0,0
1683339204634,AWP 10,003,202036,Staff,0,0,0,0
1683339204634,AWP 10,004,202037,Staff,0,0,0,0
1683339204634,AWP 10,005,202038,Staff,0,0,0,0
1683339204634,AWP 10,006,202039,Staff,0,0,0,0
1683339204634,AWP 10,007,202040,Staff,0,0,0,0
1683339204634,AWP 10,008,202041,Staff,0,0,0,0
1683339204634,AWP 10,009,202042,Staff,0,0,0,0
1683339204634,AWP 10,010,202043,Staff,0,0,0,0
1683339204634,AWP 10,011,202044,Staff,0,0,0,0
1683339204634,AWP 10,012,202045,Staff,0,0,0,0
1683339204634,AWP 10,013,202046,Staff,0,0,0,0
1683339204634,AWP 10,014,202047,Staff,0,0,0,0
1683339204634,AWP 10,015,202048,Staff,0,0,0,0
1683339204634,AWP 10,016,202049,Staff,0,0,0,0
1683339204634,AWP 10,017,202050,Staff,0,0,0,0
1683339204634,AWP 10,018,202051,Staff,0,0,0,0
1683339204634,AWP 10,019,202052,Staff,0,0,0,0
1683339204634,AWP 10,020,202053,Staff,0,0,0,0
1683339204634,AWP 10,021,202054,Staff,0,0,0,0
1683339204634,AWP 10,022,202055,Staff,0,0,0,0
1683339204634,AWP 10,023,202056,Staff,0,0,0,0
1683339204634,AWP 10,024,202057,Staff,0,0,0,0
1683339204634,AWP 10,025,202058,Staff,0,0,0,0
1683339204634,AWP 10,026,202059,Staff,0,0,0,0
1683339205663,AWP 102,001,202032,Staff,0,0,0,0
1683339205663,AWP 102,002,202033,Staff,0,0,0,0
1683339206691,BENG 100,A01,254234,Taylor Amos; Alyssa C,31,0,40,9
1683339207716,BENG 196,001,270013,Engler; Adam J.,9999,0,9999,0
1683339208747,BICD 100R,A01,202018,Smith; Laurie,0,7,32,32
1683339208747,BICD 100R,A02,202019,Smith; Laurie,0,2,32,32
1683339208747,BICD 100R,A03,202020,Smith; Laurie,0,1,32,32
1683339208747,BICD 100R,A04,202021,Smith; Laurie,9,0,32,23
1683339208747,BICD 100R,A05,202022,Smith; Laurie,12,0,32,20
1683339209772,BICD 136,A01,193242,Gustafson-Brown; Cindy,0,2,32,32
1683339209772,BICD 136,A02,193244,Gustafson-Brown; Cindy,14,0,32,18
1683339210800,BIEB 102,A01,193249,Butler; Shannon Rhey,0,2,32,32
1683339210800,BIEB 102,A02,193251,Butler; Shannon Rhey,0,0,32,32
1683339210800,BIEB 102,A03,193253,Butler; Shannon Rhey,0,1,32,32
1683339210800,BIEB 102,A04,193255,Butler; Shannon Rhey,17,0,32,15
1683339210800,BIEB 102,A05,193265,Butler; Shannon Rhey,26,0,32,6
1683339210800,BIEB 102,A06,193269,Butler; Shannon Rhey,16,0,32,16
1683339212851,BIEB 150,A01,193274,Staff,0,0,32,32
1683339212851,BIEB 150,A02,193285,Staff,23,0,32,9
1683339213880,BIEB 194,A00,193286,Kurle; Carolyn M.,22,0,32,10
1683339214906,BILD 1,A01,192291,Staff,16,0,32,16
1683339214906,BILD 1,A02,192292,Staff,30,0,32,2
1683339214906,BILD 1,B01,192520,Reuther; Keefe,0,1,0,0
1683339214906,BILD 1,B02,192532,Reuther; Keefe,0,1,0,0
1683339215933,BILD 3,A01,192556,Butler; Shannon Rhey,0,0,32,32
1683339215933,BILD 3,A02,192581,Butler; Shannon Rhey,5,0,32,27
1683339215933,BILD 3,A03,192611,Butler; Shannon Rhey,23,0,32,9
1683339215933,BILD 3,A04,192612,Butler; Shannon Rhey,25,0,32,7
1683339215933,BILD 3,A05,192613,Butler; Shannon Rhey,27,0,32,5
1683339215933,BILD 3,A06,192679,Butler; Shannon Rhey,27,0,32,5
1683339215933,BILD 3,A07,192682,Butler; Shannon Rhey,22,0,32,10
1683339216963,BILD 4,A01,192836,Reuther; Keefe,0,0,24,24
1683339216963,BILD 4,A02,193044,Reuther; Keefe,4,0,24,20
1683339217991,BILD 10,A01,193142,Gustafson-Brown; Cindy,30,0,32,2
1683339217991,BILD 10,A02,193149,Gustafson-Brown; Cindy,31,0,32,1
1683339219017,BIMM 100,A01,193301,Staff,0,6,32,32
1683339219017,BIMM 100,A02,193312,Staff,0,5,32,32
1683339219017,BIMM 100,A03,193323,Staff,0,8,32,32
1683339220044,BIMM 101,A01,193329,McDonnell; Lisa Marie,0,3,24,24
1683339220044,BIMM 101,A02,193339,McDonnell; Lisa Marie,0,3,24,24
1683339220044,BIMM 101,B01,193354,McDonnell; Lisa Marie,0,3,24,24
1683339220044,BIMM 101,B02,193357,McDonnell; Lisa Marie,0,3,24,24
1683339221074,BIMM 110,A01,193377,Tat; John,0,11,32,32
1683339221074,BIMM 110,A02,193378,Tat; John,1,9,32,31
1683339222100,BIMM 120,A01,206116,Staff,0,0,32,32
1683339222100,BIMM 120,A02,206117,Staff,8,0,32,24
1683339222100,BIMM 120,A03,206121,Staff,21,0,32,11
1683339223126,BIPN 100,A01,193393,Park; Ji Young,0,14,32,32
1683339223126,BIPN 100,A02,193402,Park; Ji Young,0,13,32,32
1683339223126,BIPN 100,A03,193413,Park; Ji Young,0,14,32,32
1683339223126,BIPN 100,A04,193414,Park; Ji Young,0,13,32,32
1683339224157,BIPN 102,A01,193429,Staff,0,0,32,32
1683339224157,BIPN 102,A02,193438,Staff,22,0,32,10
1683339225185,BIPN 106,A01,193450,Reyes Gonzalez; Catalina,0,2,40,40
1683339226210,BIPN 134,A01,193465,Cooke; James Edward,0,0,32,32
1683339226210,BIPN 134,A02,193474,Cooke; James Edward,25,0,32,7
1683339226210,BIPN 134,A03,193485,Cooke; James Edward,29,0,32,3
1683339226210,BIPN 134,A04,193486,Cooke; James Edward,21,0,32,11
1683339226210,BIPN 134,A05,193491,Cooke; James Edward,31,0,32,1
1683339226210,BIPN 134,A06,193501,Cooke; James Edward,30,0,32,2
1683339226210,BIPN 134,A07,193510,Cooke; James Edward,29,0,32,3
1683339228267,BISP 194,A00,222522,Staff,14,0,32,18
1683339229290,CAT 124,A01,202407,Staff,20,0,25,5
1683339230320,CAT 125,A00,202408,Marchisotto; Jennifer Anne,4,0,20,16
1683339231346,CAT 125R,A00,202409,Smith; Lauryn Alissa,0,11,20,20
1683339231346,CAT 125R,B00,202410,Morales; Celeste Georgianna,0,11,20,20
1683339231346,CAT 125R,C00,202411,Irwin; Matthew Joseph,0,10,20,20
1683339232374,CENG 15,A01,204712,Yang; Kesong,0,1,0,0
1683339233400,CENG 114,A00,202070,Jahed Motlagh; Zeinab,5,0,20,15
1683339234426,CGS 105,A00,185477,Wesling; Megan E.,24,0,40,16
1683339235451,CGS 106,A00,185494,Staff,13,0,22,9
1683339236476,CGS 108,A00,185495,Staff,14,0,20,6
1683339237501,CGS 114,A00,185496,Staff,13,0,18,5
1683339238525,CGS 119,A00,185501,Staff,15,0,20,5
1683339239553,CGS 120,A00,185511,Staff,13,0,20,7
1683339240580,CHEM 4,A01,184675,Bussey; Thomas J,96,0,100,4
1683339241612,CHEM 6A,A01,184677,Staff,34,0,60,26
1683339242641,CHEM 6B,A01,184679,Staff,65,0,100,35
1683339243668,CHEM 6C,A01,184681,Bussey; Thomas J,1,0,50,49
1683339243668,CHEM 6C,A02,184682,Bussey; Thomas J,34,0,50,16
1683339244692,CHEM 40A,A01,184684,Albizati; Kim F.,37,0,100,63
1683339245722,CHEM 40B,A01,184686,Albizati; Kim F.,0,20,100,100
1683339246748,CHEM 41B,A01,184690,Staff,52,0,100,48
1683339247774,COGS 3,A01,184715,Boyle; Mary E. T.,0,25,40,40
1683339248804,COGS 14B,A01,185172,Staff,0,15,38,38
1683339249833,COGS 18,A01,184736,Staff,17,0,80,63
1683339250858,COGS 100,A01,184932,Staff,0,5,73,73
1683339251885,COGS 101A,A01,184935,Staff,0,39,30,30
1683339252910,COGS 101B,A01,184944,Staff,0,2,30,30
1683339253939,COGS 101C,A01,184946,Staff,0,12,30,30
1683339254967,COGS 102A,A01,184951,Johnson; Christine M.,2,0,40,38
1683339255993,COGS 107B,A01,184953,Mooshagian; Eric Frederick,0,50,40,40
1683339257018,COGS 118B,A01,184959,Gupta; Anjum,0,48,40,40
1683339258047,COGS 153,A00,184961,Staff,0,15,30,30
1683339259074,COGS 177,A00,184962,Staff,0,20,30,30
1683339260101,COGS 187A,A01,184969,Boyle; Mary E. T.,0,17,40,40
1683339261125,COMM 10,A01,185174,Staff,0,5,25,25
1683339261125,COMM 10,A02,185189,Staff,0,5,25,25
1683339261125,COMM 10,A03,269821,Staff,0,0,0,0
1683339262154,COMM 100B,A01,185475,Staff,0,0,0,2
1683339262154,COMM 100B,A02,185476,Staff,13,0,25,12
1683339263179,COMM 100C,A01,185314,Staff,1,0,25,24
1683339263179,COMM 100C,A02,185327,Staff,19,0,25,6
1683339264207,COMM 110M,A00,185349,Staff,2,0,40,38
1683339265232,COMM 113T,A00,185352,Staff,24,0,40,16
1683339266256,COMM 114I,A00,185353,Staff,33,0,40,7
1683339267284,COMM 131,A00,185354,Staff,19,0,30,11
1683339268312,CSE 8A,A50,185358,Cao; Yingjun,0,46,10,10
1683339269395,CSE 8B,A01,185362,Staff,1,47,50,49
1683339270424,CSE 11,A01,185416,Cao; Yingjun,0,92,10,10
1683339271452,CSE 20,A01,185445,Briones; Jor-el Thomas Caparas,5,0,25,20
1683339272480,CSE 21,A01,185447,Staff,10,0,50,40
1683339273506,CSE 101,A01,185451,Staff,0,13,50,50
1683339273506,CSE 101,B01,185453,Jones; Miles E,0,11,50,50
1683339275583,CSE 141,A01,185458,Eldon; John,20,0,100,80
1683339276612,CSE 141L,A01,185461,Eldon; John,12,0,100,88
1683339277642,CSE 142,A01,185463,Staff,36,0,60,24
1683339277642,CSE 142,B01,201355,Staff,0,7,60,60
1683339278669,CSE 142L,A01,185470,Staff,36,0,60,24
1683339278669,CSE 142L,B01,201417,Staff,0,6,60,60
1683339279694,CSE 190,A00,201433,Staff,32,0,49,17
1683339280724,DOC 1,A01,259136,Strom; Megan C.,7,0,15,8
1683339280724,DOC 1,A02,259137,Strom; Megan C.,14,0,15,1
1683339280724,DOC 1,A03,259138,Strom; Megan C.,14,0,15,1
1683339280724,DOC 1,A04,259139,Strom; Megan C.,14,0,15,1
1683339281749,DOC 100D,A00,259140,Pass; Natalye Joann,16,0,25,9
1683339282778,DSGN 1,A01,184749,Rill; Bryan,0,25,30,30
1683339283804,DSGN 100,A01,185168,Staff,0,2,25,25
1683339284830,ECE 5,A01,185626,Morris; Karcher William,0,10,0,0
1683339285855,ECE 101,A01,185628,Staff,17,0,70,53
1683339286883,ECE 107,A01,185635,Baghdadchi; Saharnaz,0,0,20,20
1683339286883,ECE 107,A02,185638,Baghdadchi; Saharnaz,4,0,20,16
1683339287912,ECE 148,A01,185647,Silberman; Jack,0,0,16,16
1683339288938,ECON 1,A01,185537,Crane; Meredith Helen,54,0,70,16
1683339289965,ECON 3,A01,185549,Crane; Meredith Helen,33,0,70,37
1683339290994,ECON 4,A01,203354,Anderson; John Charles,0,4,10,10
1683339292019,ECON 100A,A01,185574,Staff,0,4,40,40
1683339293048,ECON 100B,A01,185576,Staff,10,22,50,40
1683339294079,ECON 100C,A01,185589,Newhouse; Herbert S,30,0,70,40
1683339295107,ECON 105,A00,185608,Vespa; Emanuel Ignacio,19,0,35,16
1683339296135,ECON 109,A01,185610,Shishkin; Denis,10,0,35,25
1683339297162,ECON 110A,A01,185612,Staff,11,0,40,29
1683339298190,ECON 120A,A01,185615,Staff,20,0,40,20
1683339299214,ECON 120C,A01,185617,Sun; Yixiao,0,20,70,70
1683339300240,ECON 144,A00,203346,Squires; Dale E,3,0,35,32
1683339301272,ECON 171,A01,203349,Newhouse; Herbert S,0,1,35,35
1683339302301,ECON 173A,A01,185621,Toda; Alexis Akira,21,0,35,14
1683339303328,EDS 25,A01,202413,Staff,0,1,0,0
1683339303328,EDS 25,A02,202414,Staff,0,1,0,0
1683339303328,EDS 25,A03,202415,Staff,0,0,0,0
1683339303328,EDS 25,A04,202416,Staff,0,1,0,0
1683339303328,EDS 25,A05,202439,Staff,0,0,0,0
1683339303328,EDS 25,A06,202440,Staff,0,0,0,0
1683339303328,EDS 25,B01,202631,Staff,0,0,0,0
1683339303328,EDS 25,B02,202632,Staff,0,0,0,0
1683339303328,EDS 25,B03,202639,Staff,0,0,0,0
1683339303328,EDS 25,B04,202640,Staff,0,0,0,0
1683339303328,EDS 25,B05,202643,Staff,0,0,0,0
1683339303328,EDS 25,B06,202644,Staff,0,0,0,0
1683339304355,EDS 38,A01,202659,Black; Alison Michelle,24,0,25,1
1683339305379,EDS 115,A00,202652,Staff,18,0,30,12
1683339306404,EDS 125,A00,202649,Staff,14,0,30,16
1683339307429,EDS 126,A01,203332,Staff,30,0,30,0
1683339308454,EDS 139,A00,202838,Staff,16,0,25,9
1683339309485,EDS 146,A01,202655,Staff,14,0,25,11
1683339310511,ENG 15,A00,185667,Staff,0,1,0,0
1683339310511,ENG 15,B00,185672,Staff,0,0,0,0
1683339310511,ENG 15,C00,185675,Staff,0,0,0,0
1683339310511,ENG 15,D00,185682,Staff,0,0,0,0
1683339310511,ENG 15,E00,185684,Staff,0,0,0,0
1683339311540,ETHN 103,A00,185710,Staff,0,4,35,35
1683339312566,ETHN 103A,A00,199228,Man; Simeon S,2,0,9,7
1683339313593,ETHN 109,A00,185711,Staff,18,0,35,17
1683339314623,ETHN 142,A00,185726,Staff,0,4,30,30
1683339315649,ETHN 163J,A00,199229,Man; Simeon S,5,0,8,3
1683339316677,ETHN 168,A00,185727,Staff,8,0,10,2
1683339317702,ETHN 182,A00,185728,Staff,1,0,35,34
1683339318730,ETHN 183,A00,185737,Staff,8,0,18,10
1683339319755,GLBH 111,A01,209361,Burgos; Jose L.,0,0,0,0
1683339321804,HIEU 104,A00,185792,Staff,16,0,20,4
1683339322829,HIEU 115,A00,185800,Staff,1,0,20,19
1683339323854,HIEU 128,A00,185801,Staff,0,7,20,20
1683339324881,HIEU 147,A00,185802,Staff,16,0,20,4
1683339325912,HIEU 154,A00,185823,Staff,12,0,20,8
1683339326936,HILA 102,A00,185826,Staff,13,0,20,7
1683339327962,HILD 2C,A01,185778,Staff,0,12,20,20
1683339328989,HILD 7B,A01,185780,Kwak; Nancy,0,15,32,32
1683339328989,HILD 7B,A02,185781,Kwak; Nancy,0,18,32,32
1683339330014,HILD 30,A01,185791,Staff,14,0,20,6
1683339331039,HISC 119,A00,185830,Golan; Tal,0,9,20,20
1683339332063,HITO 156GS,A00,185831,Patterson; Patrick H.,0,0,0,23
1683339333088,HIUS 103,A00,185832,Man; Simeon S,0,6,20,20
1683339334111,HIUS 117,A00,185836,Kwak; Nancy,2,0,20,18
1683339335141,HIUS 125,A00,185840,Man; Simeon S,0,0,23,23
1683339336169,HIUS 149,A00,185845,Staff,0,0,20,20
1683339337198,HUM 3,A01,185882,Zavodny; Tatiana Sophia,0,7,50,50
1683339337198,HUM 3,B01,185899,Caldwell; Michael Alan,0,18,50,50
1683339338222,HUM 3GS,A00,185900,Patterson; Patrick H.,0,0,0,23
1683339339253,HUM 4,A01,185938,Zroka; Amy Liane,31,0,50,19
1683339339253,HUM 4,B01,185956,Watkins; Eric,0,2,50,50
1683339339253,HUM 4,B02,202209,Watkins; Eric,0,2,50,50
1683339339253,HUM 4,B03,202210,Watkins; Eric,0,2,50,50
1683339340276,HUM 5,A01,185958,West; Geoffrey Scott,3,0,50,47
1683339340276,HUM 5,A02,202215,West; Geoffrey Scott,0,0,50,50
1683339341304,INTL 190,A00,185959,Gagnon; Jeffrey C,0,0,0,9
1683339341304,INTL 190,B00,185960,Lettieri; Michael Joseph,0,0,0,1
1683339342331,JAPN 180,A00,254509,Staff,5,1,30,25
1683339343356,LATI 10,A01,202853,Kennemore; Amy Michelle,4,0,35,31
1683339343356,LATI 10,A02,202854,Kennemore; Amy Michelle,2,0,35,33
1683339343356,LATI 10,A03,270054,Kennemore; Amy Michelle,30,0,30,0
1683339344381,LATI 180,A00,202855,Kennemore; Amy Michelle,11,0,20,9
1683339345405,LAWS 101,A00,201767,Golan; Tal,0,7,40,40
1683339346429,LIFR 1C,A00,185961,Staff,6,0,20,14
1683339347453,LIFR 1CX,A00,185962,Staff,7,0,20,13
1683339348478,LIFR 1D,A00,185963,Staff,9,0,20,11
1683339349502,LIFR 1DX,A00,185964,Staff,9,0,20,11
1683339350530,LIGN 101,A01,186039,Staff,43,0,50,7
1683339351555,LIGN 165,A00,186040,Staff,18,0,50,32
1683339352579,LTCS 108,A00,186041,Staff,6,0,10,4
1683339353602,LTCS 119,A00,186042,Staff,16,0,20,4
1683339354627,LTCS 130,A00,186043,Wesling; Megan E.,15,0,25,10
1683339356677,LTEA 138,A00,186119,Staff,14,0,40,26
1683339357706,LTEN 124,A00,186148,Staff,6,0,25,19
1683339358734,LTEN 178,A00,186149,Staff,7,0,15,8
1683339359763,LTEN 181,A00,186150,Blanco; John D,33,0,40,7
1683339360789,LTWL 120,A00,186160,Staff,20,0,25,5
1683339361816,LTWL 165,A00,186161,Staff,22,0,25,3
1683339362840,LTWR 100,A00,186162,Staff,0,5,15,15
1683339363868,LTWR 102,A00,186163,Doller; Ben,5,0,15,10
1683339364892,MAE 8,A01,186412,Staff,0,0,0,0
1683339365921,MAE 30B,A00,186445,Bahadori; Mohammad Yousef,83,0,100,17
1683339366946,MAE 40,A00,186592,Bewley; Thomas R,9,0,50,41
1683339367974,MAE 101B,A00,186593,Bahadori; Mohammad Yousef,81,0,100,19
1683339369000,MAE 105,A00,186594,Bandaru; Prabhakar,12,0,50,38
1683339370024,MAE 107,A00,186599,Pham; Hieu Tan,0,6,120,120
1683339371050,MAE 148,A01,186660,Silberman; Jack,3,0,16,13
1683339372075,MATH 10A,A01,188095,Staff,1,6,35,34
1683339373164,MATH 10B,A01,188097,Bowers; Adam R.,0,11,30,30
1683339373164,MATH 10B,A02,188099,Bowers; Adam R.,0,11,30,30
1683339373164,MATH 10B,B01,188104,Bowers; Adam R.,0,10,30,30
1683339373164,MATH 10B,B02,188106,Bowers; Adam R.,0,10,30,30
1683339374197,MATH 10C,A01,188111,Staff,0,18,30,30
1683339374197,MATH 10C,A02,188127,Staff,0,17,30,30
1683339374197,MATH 10C,A03,188131,Staff,0,18,30,30
1683339374197,MATH 10C,B01,188218,Staff,18,0,30,12
1683339374197,MATH 10C,B02,188244,Staff,13,0,30,17
1683339374197,MATH 10C,B03,188277,Staff,16,0,30,14
1683339375228,MATH 18,A01,188344,Bach; Quang Tran,18,0,30,12
1683339375228,MATH 18,A02,188345,Bach; Quang Tran,11,0,30,19
1683339375228,MATH 18,B01,188353,Bach; Quang Tran,10,0,30,20
1683339375228,MATH 18,B02,188354,Bach; Quang Tran,20,0,30,10
1683339376256,MATH 20A,A01,188374,Staff,13,0,35,22
1683339377286,MATH 20B,A01,188382,Ohm; Ko Woon,6,0,30,24
1683339377286,MATH 20B,A02,188383,Ohm; Ko Woon,22,0,30,8
1683339377286,MATH 20B,B01,188385,Ohm; Ko Woon,7,0,30,23
1683339377286,MATH 20B,B02,188392,Ohm; Ko Woon,22,0,30,8
1683339378316,MATH 20C,A01,188394,Harel; Guershon,10,0,30,20
1683339378316,MATH 20C,A02,188395,Harel; Guershon,15,0,30,15
1683339378316,MATH 20C,B01,188404,Harel; Guershon,5,0,30,25
1683339378316,MATH 20C,B02,188405,Harel; Guershon,19,0,30,11
1683339379347,MATH 20D,A01,188414,Hammock; Frances H,0,1,30,30
1683339379347,MATH 20D,A02,188415,Hammock; Frances H,3,0,30,27
1683339379347,MATH 20D,B01,188447,Hammock; Frances H,1,0,30,29
1683339379347,MATH 20D,B02,188486,Hammock; Frances H,8,0,30,22
1683339380374,MATH 20E,A01,188649,Staff,21,0,30,9
1683339380374,MATH 20E,A02,188650,Staff,23,0,30,7
1683339380374,MATH 20E,A03,188673,Staff,0,0,30,30
1683339381402,MATH 102,A01,188675,Staff,0,35,35,35
1683339382426,MATH 103B,A01,188681,Staff,3,0,35,32
1683339382426,MATH 103B,B01,188692,Staff,5,0,35,30
1683339383451,MATH 109,A01,188695,Salehi Golsefidy; Alireza,25,0,35,10
1683339383451,MATH 109,A02,188696,Salehi Golsefidy; Alireza,25,0,35,10
1683339384477,MATH 120A,A01,188698,Eggers; John Dietrich,7,0,35,28
1683339385504,MATH 142B,A01,188736,Ioana; Adrian,0,2,30,30
1683339385504,MATH 142B,A02,188741,Ioana; Adrian,1,1,30,29
1683339385504,MATH 142B,A03,188743,Ioana; Adrian,1,3,30,29
1683339386532,MATH 168A,A01,188790,Staff,0,9,35,35
1683339387560,MATH 170A,A01,188803,Nie; Jiawang,0,2,35,35
1683339387560,MATH 170A,A02,188811,Nie; Jiawang,0,0,35,35
1683339387560,MATH 170A,A03,188814,Nie; Jiawang,1,0,35,34
1683339387560,MATH 170A,A04,188815,Nie; Jiawang,13,0,35,22
1683339388588,MATH 193B,A01,188817,Staff,0,0,35,35
1683339388588,MATH 193B,A02,188818,Staff,5,0,35,30
1683339389614,MGT 4,A01,202857,Anderson; John Charles,62,0,80,18
1683339390644,MGT 12,A00,202858,Lindenberger; Wade Douglas,42,0,90,48
1683339391671,MGT 18,A00,202859,Staff,74,0,90,16
1683339392698,MGT 18GS,A00,202860,McKay; Michael J,13,0,28,15
1683339393724,MGT 45,A00,202861,Pecore; Joseph P.,14,0,90,76
1683339394749,MGT 100,A00,202863,Yavorsky; Daniel Ryan,28,0,90,62
1683339395774,MGT 103,A00,202864,Ehrich; Kristine R,1,18,90,89
1683339396799,MGT 112,A00,202865,Ehrich; Kristine R,15,0,90,75
1683339397825,MGT 121A,A00,202868,Staff,0,20,0,0
1683339398852,MGT 131B,A00,202869,Anderson; John Charles,59,0,90,31
1683339399877,MGT 136,A00,202871,Lindenberger; Wade Douglas,84,0,90,6
1683339400902,MGT 164,A00,202873,Staff,0,68,90,91
1683339401928,MGT 164GS,A00,202874,McKay; Mary A,13,0,28,15
1683339402955,MGT 180,A00,202875,Staff,0,50,90,91
1683339403983,MMW 11R,A01,205019,Herbst; Matthew,3,0,30,27
1683339403983,MMW 11R,A02,205026,Herbst; Matthew,29,0,30,1
1683339405009,MMW 15,A01,193512,Chang; Edmond Yi-Teh,0,9,28,28
1683339405009,MMW 15,A02,193513,Chang; Edmond Yi-Teh,0,5,28,28
1683339405009,MMW 15,A03,193514,Chang; Edmond Yi-Teh,0,5,28,28
1683339405009,MMW 15,A04,193515,Chang; Edmond Yi-Teh,0,5,28,28
1683339405009,MMW 15,A05,193516,Chang; Edmond Yi-Teh,0,4,28,28
1683339405009,MMW 15,A06,193517,Chang; Edmond Yi-Teh,0,5,28,28
1683339405009,MMW 15,B01,193519,Chang; Edmond Yi-Teh,0,5,28,28
1683339405009,MMW 15,B02,193520,Chang; Edmond Yi-Teh,0,5,28,28
1683339405009,MMW 15,B03,193521,Chang; Edmond Yi-Teh,0,5,28,28
1683339405009,MMW 15,B04,193522,Chang; Edmond Yi-Teh,0,4,28,28
1683339405009,MMW 15,B05,193523,Chang; Edmond Yi-Teh,0,5,28,28
1683339405009,MMW 15,B06,193524,Chang; Edmond Yi-Teh,0,4,28,28
1683339406034,MMW 122,A01,193526,Rahimi; Babak,0,15,28,28
1683339406034,MMW 122,A02,193527,Rahimi; Babak,0,14,28,28
1683339406034,MMW 122,A03,193528,Rahimi; Babak,0,0,0,0
1683339406034,MMW 122,A04,193529,Rahimi; Babak,0,0,0,0
1683339407064,MUS 1A,A01,186663,Staff,0,20,35,35
1683339408091,MUS 4,A01,186715,Staff,0,12,35,35
1683339409118,MUS 5R,A01,186796,Dubnov; Shlomo,0,17,35,35
1683339410147,MUS 6,A01,186798,Staff,0,4,25,25
1683339411171,MUS 7,A01,186830,Staff,13,0,35,22
1683339412196,MUS 8,A01,186930,Staff,0,26,35,35
1683339413222,MUS 15,A01,186932,Staff,0,16,35,35
1683339413222,MUS 15,B01,186934,Staff,0,15,35,35
1683339414246,MUS 80,A00,186935,Staff,1,0,20,19
1683339414246,MUS 80,B00,186936,Staff,25,0,25,0
1683339415270,NANO 11,A00,204702,Lipomi; Darren John,0,0,0,0
1683339416295,NANO 15,A01,204709,Yang; Kesong,0,1,0,0
1683339417323,NANO 114,A00,202069,Jahed Motlagh; Zeinab,3,0,10,7
1683339418351,PHIL 1,A00,186955,Grush; Rick Scott,32,0,40,8
1683339419378,PHIL 10,A01,186973,Grush; Rick Scott,28,0,35,7
1683339419378,PHIL 10,A02,186974,Grush; Rick Scott,33,0,35,2
1683339420407,PHIL 13,A01,186976,Staff,7,0,35,28
1683339420407,PHIL 13,A02,186977,Staff,16,0,35,19
1683339421438,PHIL 14,A01,186979,Staff,31,0,35,4
1683339421438,PHIL 14,A02,186986,Staff,32,0,35,3
1683339422463,PHIL 28,A01,186988,Staff,16,0,30,14
1683339422463,PHIL 28,A02,186989,Staff,1,0,30,29
1683339422463,PHIL 28,A03,186990,Staff,9,0,30,21
1683339422463,PHIL 28,A04,186991,Staff,26,0,30,4
1683339423489,PHIL 120,A00,186997,Staff,23,0,40,17
1683339424514,PHIL 137,A00,187003,Staff,9,0,40,31
1683339425542,PHIL 150,A00,187015,Staff,47,0,70,23
1683339426571,PHIL 167,A00,187021,Lamey; Andy M.,35,0,40,5
1683339427597,PHIL 174,A01,202226,Staff,17,0,20,3
1683339427597,PHIL 174,A02,202235,Staff,20,0,20,0
1683339428626,PHIL 191A,A00,258918,Staff,0,0,1,1
1683339429653,PHYS 1A,A00,187028,Staff,27,0,60,33
1683339430679,PHYS 1AL,001,187036,Staff,2,0,30,28
1683339430679,PHYS 1AL,002,187049,Staff,18,0,30,12
1683339431703,PHYS 1B,A00,187058,Staff,22,0,60,38
1683339432731,PHYS 1BL,001,187064,Staff,0,0,30,30
1683339432731,PHYS 1BL,002,187070,Staff,5,0,30,25
1683339433761,PHYS 1C,A00,187082,Staff,31,0,120,89
1683339434791,PHYS 1CL,001,187088,Staff,0,9,30,30
1683339434791,PHYS 1CL,002,187089,Staff,0,2,30,30
1683339434791,PHYS 1CL,009,262693,Staff,11,0,30,19
1683339435818,PHYS 2B,A01,187097,Staff,54,0,115,61
1683339436848,PHYS 2C,A01,187099,Staff,67,0,115,48
1683339437875,PHYS 2CL,A01,187101,Staff,5,0,28,23
1683339437875,PHYS 2CL,A02,187102,Staff,15,0,28,13
1683339438905,PHYS 2D,A01,187123,Shotwell; Brian,95,0,115,20
1683339439935,PHYS 4B,A01,187133,Grinstein; Benjamin,35,0,50,15
1683339440968,POLI 10,A00,188819,Staff,0,4,50,50
1683339441998,POLI 11,A00,188827,Staff,43,0,50,7
1683339443025,POLI 13R,A00,188828,Staff,0,1,20,20
1683339444054,POLI 27,A01,188830,Elgin; Samuel Zincke,0,1,70,70
1683339445082,POLI 30,A00,188832,Desposato; Scott,31,0,50,19
1683339446106,POLI 102F,A00,188834,Staff,3,0,40,37
1683339447130,POLI 104A,A00,188852,Staff,14,0,30,16
1683339448155,POLI 104I,A00,188853,Staff,0,6,20,20
1683339449180,POLI 110B,A00,188854,Wiens; David,7,0,20,13
1683339450209,POLI 112A,A00,188855,Wiens; David,5,0,30,25
1683339451233,POLI 117R,A00,188856,Forman; Fonna,0,11,20,20
1683339452261,POLI 118,A00,188857,Ingham; Sean,8,0,20,12
1683339453290,POLI 120G,A00,188858,Staff,9,0,30,21
1683339454316,POLI 131CR,A00,188863,Hoston; Germaine,24,0,50,26
1683339455345,POLI 133,A00,188864,Nellis; Gareth Hb,44,0,50,6
1683339456373,POLI 134D,A00,188865,Desposato; Scott,27,0,30,3
1683339457398,POLI 142A,A00,188871,Gartzke; Erik,22,0,50,28
1683339458427,POLI 142K,A00,188874,Staff,38,0,50,12
1683339459454,POLI 143,A00,188940,Gartzke; Erik,16,0,30,14
1683339460479,POLI 153,A00,188943,Staff,3,0,20,17
1683339461506,POLI 160AA,A00,188944,Staff,12,0,40,28
1683339462537,POLI 170A,A00,188945,Staff,11,0,30,19
1683339464591,PSYC 1,A00,188952,Staff,37,0,90,53
1683339465620,PSYC 2,B00,188953,Staff,19,0,35,16
1683339466646,PSYC 6,A00,188970,Staff,47,0,60,13
1683339467671,PSYC 7,A00,188973,Staff,37,0,45,8
1683339468697,PSYC 60,A01,188980,Rickard; Timothy C.,43,0,60,17
1683339469722,PSYC 70,A01,189001,Steiner; Eric Tomas,24,0,45,21
1683339470747,PSYC 100,A00,189005,Lacefield; Katharine I,0,98,120,120
1683339471772,PSYC 102,A00,189008,Staff,9,0,30,21
1683339472799,PSYC 106,B00,189026,Gorman; Michael R.,34,0,60,26
1683339473830,PSYC 114,B01,189033,Winkielman; Piotr,0,32,30,30
1683339474860,PSYC 131,A00,189036,Anagnostaras; Stephan,0,43,60,60
1683339475890,PSYC 136,A00,189041,Lowe; Angela Beth,0,7,25,25
1683339476990,PSYC 137,A00,189057,Winkielman; Piotr,0,34,25,25
1683339478016,PSYC 144,A00,189107,Wixted; John T,0,7,50,50
1683339480074,PSYC 162,A00,189142,Staff,0,8,85,85
1683339481101,PSYC 172,A00,189144,Gorman; Michael R.,0,7,30,30
1683339483155,PSYC 179,A00,189146,Lacefield; Katharine I,0,84,120,120
1683339484179,PSYC 181,A00,189147,Anagnostaras; Stephan,0,44,90,90
1683339485205,PSYC 190R,A00,189148,Barner; David A.,0,22,80,80
1683339486233,PSYC 191,A00,189275,Rickard; Timothy C.,0,7,25,25
1683339487262,PSYC 193,A00,189276,Chapman; Eddie Nathaniel,0,1,0,4
1683339488291,PSYC 193L,A01,189281,Lowe; Angela Beth,12,0,20,8
1683339488291,PSYC 193L,B01,189285,Staff,28,0,35,7
1683339489318,RELI 149,A00,187137,Rahimi; Babak,7,0,40,33
1683339490346,SE 9,A01,187315,Staff,0,2,18,18
1683339491376,SE 101B,A00,187409,Staff,24,0,30,6
1683339492405,SE 110B,A00,187444,Staff,10,0,40,30
1683339493431,SE 130B,A00,187449,Staff,31,0,40,9
1683339494460,SE 150A,A00,187516,Staff,9,0,20,11
1683339495486,SE 154,A00,187528,Staff,30,0,50,20
1683339496515,SIO 3,A01,258171,Staff,35,0,40,5
1683339497540,SIO 10,A00,187144,Cook; Geoffrey W,0,3,75,75
1683339498570,SIO 45,A00,187152,Cook; Geoffrey W,1,0,100,99
1683339499596,SIO 109R,A00,194486,Staff,0,3,20,20
1683339501651,SIO 187,A01,187233,Kacev; David,12,0,40,28
1683339502678,SOCI 1,A01,258656,Thorpe; Charles Robert,28,0,30,2
1683339502678,SOCI 1,A02,258658,Thorpe; Charles Robert,30,0,30,0
1683339502678,SOCI 1,A03,258661,Thorpe; Charles Robert,25,0,25,0
1683339502678,SOCI 1,A04,258666,Thorpe; Charles Robert,22,0,25,3
1683339502678,SOCI 1,A05,258897,Thorpe; Charles Robert,23,0,25,2
1683339502678,SOCI 1,A06,258898,Thorpe; Charles Robert,25,0,25,0
1683339503703,SOCI 30,A01,258903,Pardo Guerra; Juan Pablo,15,0,30,15
1683339504730,SOCI 102,A00,258904,Staff,9,0,25,16
1683339505759,SOCI 106,A00,258905,Staff,19,0,25,6
1683339506788,SOCI 111,A00,258907,Ribas Norris; Janet Vanesa,26,0,30,4
1683339507814,SOCI 121R,A00,258908,Pardo Guerra; Juan Pablo,10,0,30,20
1683339508838,SOCI 126,A01,203330,Staff,14,0,20,6
1683339509863,SOCI 131,A00,258909,Thorpe; Charles Robert,31,0,60,29
1683339510888,SOCI 135,A00,258910,Payne; Christine Anna,0,9,30,30
1683339511913,SOCI 157,A00,258911,Staff,12,0,30,18
1683339512939,SOCI 184,A00,258912,Staff,25,0,30,5
1683339513968,SOCI 188D,A00,258913,Staff,21,0,30,9
1683339514997,SYN 2,001,187529,Staff,10,0,16,6
1683339514997,SYN 2,002,201452,Staff,0,18,16,16
1683339514997,SYN 2,003,201469,Staff,3,0,16,13
1683339516023,SYN 100,A01,187531,Staff,0,9,20,20
1683339516023,SYN 100,B01,201491,Staff,0,12,20,20
1683339517048,TDAC 1,A00,189286,Walsh; Kim C.,3,0,20,17
1683339517048,TDAC 1,B00,189287,Harting; Carla Kelso,11,0,20,9
1683339518073,TDAC 101,A00,189300,Walsh; Kim C.,16,0,20,4
1683339518073,TDAC 101,B00,189301,Harting; Carla Kelso,18,0,20,2
1683339519102,TDAC 102,A00,189304,Basso; Beatrice,14,0,20,6
1683339520127,TDAC 108,A00,189305,Staff,18,0,20,2
1683339521152,TDDE 131,A00,189310,Staff,19,0,20,1
1683339521152,TDDE 131,B00,189314,Staff,19,0,20,1
1683339521152,TDDE 131,C00,189315,Staff,48,0,50,2
1683339521152,TDDE 131,D00,189316,Staff,14,0,15,1
1683339521152,TDDE 131,E00,204841,Staff,20,0,20,0
1683339522176,TDGE 10,A00,189289,Staff,30,0,50,20
1683339522176,TDGE 10,B00,189290,Havis; Allan,1,0,50,49
1683339523206,TDGE 11,A00,189291,Fulton; Julia,0,3,50,50
1683339523206,TDGE 11,B00,189292,Staff,20,0,25,5
1683339523206,TDGE 11,C00,260270,Staff,0,0,0,0
1683339524233,TDGE 25,A00,189294,Staff,3,0,20,17
1683339525259,TDGE 124,A00,189318,Fulton; Julia,0,8,50,50
1683339526287,TDGE 125,A00,189319,Staff,13,0,25,12
1683339526287,TDGE 125,B00,189320,Staff,23,0,25,2
1683339527314,TDGE 127,A00,189322,Havis; Allan,0,0,50,50
1683339528343,TDHT 101,A00,189323,Staff,18,0,25,7
1683339528343,TDHT 101,B00,189324,Staff,25,0,25,0
1683339529371,TDHT 102,A00,189325,Staff,49,0,50,1
1683339530399,TDMV 1,A00,189295,Arcidiacono; Kristin,19,0,30,11
1683339530399,TDMV 1,B00,189296,Caligagan; Maria T.,24,0,30,6
1683339531423,TDMV 2,A00,189297,Sammartano; Tonnie,28,0,30,2
1683339531423,TDMV 2,B00,189299,Arcidiacono; Kristin,24,0,30,6
1683339532447,TDMV 3,A00,204998,Rincon; Alicia,22,0,30,8
1683339533475,TDMV 120,A00,189458,Sammartano; Tonnie,28,0,30,2
1683339534500,TDMV 138,A00,189541,Jun; Grace Shin Hae,22,0,40,18
1683339535525,TDMV 142,A00,189717,Caligagan; Tony,23,0,30,7
1683339535525,TDMV 142,B00,189718,Caligagan; Maria T.,25,0,30,5
1683339536550,TMC 2,A01,187533,Staff,25,0,25,0
1683339536550,TMC 2,A02,187534,Staff,25,0,25,0
1683339537576,USP 1,A01,187536,Kwak; Nancy,0,16,25,25
1683339538604,USP 5,A01,187538,Staff,10,0,25,15
1683339539632,USP 101,A00,199253,Staff,0,4,0,0
1683339540660,USP 124,A00,187562,Boomhower; Matthew Charles,1,0,30,29
1683339541686,USP 138,A00,187582,Staff,20,0,25,5
1683339542711,USP 152,A01,187597,Staff,4,0,25,21
1683339543735,USP 153,A00,187598,Staff,19,0,25,6
1683339544758,USP 168,A00,187607,Kwak; Nancy,2,0,5,3
1683339545786,USP 173,A00,187619,Staff,4,0,25,21
1683339546817,USP 181,A00,187638,Staff,0,0,25,25
1683339547845,VIS 103,A00,187650,Cruz; Edwin Teddy,23,0,75,52
1683339548871,VIS 110D,A00,187669,Staff,12,0,22,10
1683339549893,VIS 127C,A00,187720,Shen; Kuiyi,67,0,146,79
1683339550918,VIS 149,A00,187731,Yoldas; Pinar,0,14,22,22
1683339551944,VIS 151,A01,188091,Staff,22,0,34,12
1683339551944,VIS 151,A02,188092,Staff,11,0,34,23
1683339552970,VIS 160B,A00,188093,Stalbaum; Brett,0,0,10,10
1683339555023,WCWP 10B,A00,201720,Staff,10,0,15,5
1683339555023,WCWP 10B,B00,201722,Staff,9,0,15,6
1683339556048,WCWP 100,A00,201725,Gagnon; Jeffrey C,0,0,2,2
1683339556048,WCWP 100,B00,201727,Staff,0,4,15,15
1683339559147,ANBI 133,A00,258401,Wilder; Linnea Lorene,34,0,40,6
1683339560171,ANBI 140,A00,258395,Hrvoj Mihic; Branka,18,0,25,7
1683339561197,ANSC 120,A00,258402,Bialecki; Jon Anthony,27,0,40,13
1683339562221,ANSC 144,A00,258400,Staff,14,0,40,26
1683339564273,ANSC 166,A00,258396,Parish; Steven Martin,157,0,175,18
1683339565299,ANSC 180,A00,193533,Staff,9,0,20,11
1683339566325,ANSC 188,A00,258397,Jassal; Aftab,33,0,40,7
1683339567359,ANTH 3,A01,258316,Staff,23,0,30,7
1683339568383,ANTH 5,A00,258394,Semendeferi; Ekaterini,16,0,20,4
1683339569410,ANTH 21,A01,258331,Staff,8,0,40,32
1683339570439,ANTH 103,A00,258398,Varma; Saiba,15,0,25,10
1683339571468,AWP 10,001,202034,Staff,0,0,0,0
1683339571468,AWP 10,002,202035,Staff,0,0,0,0
1683339571468,AWP 10,003,202036,Staff,0,0,0,0
1683339571468,AWP 10,004,202037,Staff,0,0,0,0
1683339571468,AWP 10,005,202038,Staff,0,0,0,0
1683339571468,AWP 10,006,202039,Staff,0,0,0,0
1683339571468,AWP 10,007,202040,Staff,0,0,0,0
1683339571468,AWP 10,008,202041,Staff,0,0,0,0
1683339571468,AWP 10,009,202042,Staff,0,0,0,0
1683339571468,AWP 10,010,202043,Staff,0,0,0,0
1683339571468,AWP 10,011,202044,Staff,0,0,0,0
1683339571468,AWP 10,012,202045,Staff,0,0,0,0
1683339571468,AWP 10,013,202046,Staff,0,0,0,0
1683339571468,AWP 10,014,202047,Staff,0,0,0,0
1683339571468,AWP 10,015,202048,Staff,0,0,0,0
1683339571468,AWP 10,016,202049,Staff,0,0,0,0
1683339571468,AWP 10,017,202050,Staff,0,0,0,0
1683339571468,AWP 10,018,202051,Staff,0,0,0,0
1683339571468,AWP 10,019,202052,Staff,0,0,0,0
1683339571468,AWP 10,020,202053,Staff,0,0,0,0
1683339571468,AWP 10,021,202054,Staff,0,0,0,0
1683339571468,AWP 10,022,202055,Staff,0,0,0,0
1683339571468,AWP 10,023,202056,Staff,0,0,0,0
1683339571468,AWP 10,024,202057,Staff,0,0,0,0
1683339571468,AWP 10,025,202058,Staff,0,0,0,0
1683339571468,AWP 10,026,202059,Staff,0,0,0,0
1683339572494,AWP 102,001,202032,Staff,0,0,0,0
1683339572494,AWP 102,002,202033,Staff,0,0,0,0
1683339573521,BENG 100,A01,254234,Taylor Amos; Alyssa C,31,0,40,9
1683339574549,BENG 196,001,270013,Engler; Adam J.,9999,0,9999,0
1683339575574,BICD 100R,A01,202018,Smith; Laurie,0,7,32,32
1683339575574,BICD 100R,A02,202019,Smith; Laurie,0,2,32,32
1683339575574,BICD 100R,A03,202020,Smith; Laurie,0,1,32,32
1683339575574,BICD 100R,A04,202021,Smith; Laurie,9,0,32,23
1683339575574,BICD 100R,A05,202022,Smith; Laurie,12,0,32,20
1683339576603,BICD 136,A01,193242,Gustafson-Brown; Cindy,0,2,32,32
1683339576603,BICD 136,A02,193244,Gustafson-Brown; Cindy,14,0,32,18
1683339577633,BIEB 102,A01,193249,Butler; Shannon Rhey,0,2,32,32
1683339577633,BIEB 102,A02,193251,Butler; Shannon Rhey,0,0,32,32
1683339577633,BIEB 102,A03,193253,Butler; Shannon Rhey,0,1,32,32
1683339577633,BIEB 102,A04,193255,Butler; Shannon Rhey,17,0,32,15
1683339577633,BIEB 102,A05,193265,Butler; Shannon Rhey,26,0,32,6
1683339577633,BIEB 102,A06,193269,Butler; Shannon Rhey,16,0,32,16
1683339579692,BIEB 150,A01,193274,Staff,0,0,32,32
1683339579692,BIEB 150,A02,193285,Staff,23,0,32,9
1683339580775,BIEB 194,A00,193286,Kurle; Carolyn M.,22,0,32,10
1683339581802,BILD 1,A01,192291,Staff,16,0,32,16
1683339581802,BILD 1,A02,192292,Staff,30,0,32,2
1683339581802,BILD 1,B01,192520,Reuther; Keefe,0,1,0,0
1683339581802,BILD 1,B02,192532,Reuther; Keefe,0,1,0,0
1683339582828,BILD 3,A01,192556,Butler; Shannon Rhey,0,0,32,32
1683339582828,BILD 3,A02,192581,Butler; Shannon Rhey,5,0,32,27
1683339582828,BILD 3,A03,192611,Butler; Shannon Rhey,23,0,32,9
1683339582828,BILD 3,A04,192612,Butler; Shannon Rhey,25,0,32,7
1683339582828,BILD 3,A05,192613,Butler; Shannon Rhey,27,0,32,5
1683339582828,BILD 3,A06,192679,Butler; Shannon Rhey,27,0,32,5
1683339582828,BILD 3,A07,192682,Butler; Shannon Rhey,22,0,32,10
1683339583866,BILD 4,A01,192836,Reuther; Keefe,0,0,24,24
1683339583866,BILD 4,A02,193044,Reuther; Keefe,4,0,24,20
1683339584892,BILD 10,A01,193142,Gustafson-Brown; Cindy,30,0,32,2
1683339584892,BILD 10,A02,193149,Gustafson-Brown; Cindy,31,0,32,1
1683339585920,BIMM 100,A01,193301,Staff,0,6,32,32
1683339585920,BIMM 100,A02,193312,Staff,0,5,32,32
1683339585920,BIMM 100,A03,193323,Staff,0,8,32,32
1683339586946,BIMM 101,A01,193329,McDonnell; Lisa Marie,0,3,24,24
1683339586946,BIMM 101,A02,193339,McDonnell; Lisa Marie,0,3,24,24
1683339586946,BIMM 101,B01,193354,McDonnell; Lisa Marie,0,3,24,24
1683339586946,BIMM 101,B02,193357,McDonnell; Lisa Marie,0,3,24,24
1683339587970,BIMM 110,A01,193377,Tat; John,0,11,32,32
1683339587970,BIMM 110,A02,193378,Tat; John,1,9,32,31
1683339588996,BIMM 120,A01,206116,Staff,0,0,32,32
1683339588996,BIMM 120,A02,206117,Staff,8,0,32,24
1683339588996,BIMM 120,A03,206121,Staff,21,0,32,11
1683339590021,BIPN 100,A01,193393,Park; Ji Young,0,14,32,32
1683339590021,BIPN 100,A02,193402,Park; Ji Young,0,13,32,32
1683339590021,BIPN 100,A03,193413,Park; Ji Young,0,14,32,32
1683339590021,BIPN 100,A04,193414,Park; Ji Young,0,13,32,32
1683339591046,BIPN 102,A01,193429,Staff,0,0,32,32
1683339591046,BIPN 102,A02,193438,Staff,22,0,32,10
1683339592072,BIPN 106,A01,193450,Reyes Gonzalez; Catalina,0,2,40,40
1683339593097,BIPN 134,A01,193465,Cooke; James Edward,0,0,32,32
1683339593097,BIPN 134,A02,193474,Cooke; James Edward,25,0,32,7
1683339593097,BIPN 134,A03,193485,Cooke; James Edward,29,0,32,3
1683339593097,BIPN 134,A04,193486,Cooke; James Edward,21,0,32,11
1683339593097,BIPN 134,A05,193491,Cooke; James Edward,31,0,32,1
1683339593097,BIPN 134,A06,193501,Cooke; James Edward,30,0,32,2
1683339593097,BIPN 134,A07,193510,Cooke; James Edward,29,0,32,3
1683339595144,BISP 194,A00,222522,Staff,14,0,32,18
1683339596168,CAT 124,A01,202407,Staff,20,0,25,5
1683339597194,CAT 125,A00,202408,Marchisotto; Jennifer Anne,4,0,20,16
1683339598220,CAT 125R,A00,202409,Smith; Lauryn Alissa,0,11,20,20
1683339598220,CAT 125R,B00,202410,Morales; Celeste Georgianna,0,11,20,20
1683339598220,CAT 125R,C00,202411,Irwin; Matthew Joseph,0,10,20,20
1683339599246,CENG 15,A01,204712,Yang; Kesong,0,1,0,0
1683339600270,CENG 114,A00,202070,Jahed Motlagh; Zeinab,5,0,20,15
1683339601295,CGS 105,A00,185477,Wesling; Megan E.,24,0,40,16
1683339602322,CGS 106,A00,185494,Staff,13,0,22,9
1683339603349,CGS 108,A00,185495,Staff,14,0,20,6
1683339604377,CGS 114,A00,185496,Staff,13,0,18,5
1683339605403,CGS 119,A00,185501,Staff,15,0,20,5
1683339606431,CGS 120,A00,185511,Staff,13,0,20,7
1683339607459,CHEM 4,A01,184675,Bussey; Thomas J,96,0,100,4
1683339608487,CHEM 6A,A01,184677,Staff,34,0,60,26
1683339609515,CHEM 6B,A01,184679,Staff,65,0,100,35
1683339610543,CHEM 6C,A01,184681,Bussey; Thomas J,1,0,50,49
1683339610543,CHEM 6C,A02,184682,Bussey; Thomas J,34,0,50,16
1683339611567,CHEM 40A,A01,184684,Albizati; Kim F.,37,0,100,63
1683339612595,CHEM 40B,A01,184686,Albizati; Kim F.,0,20,100,100
1683339613623,CHEM 41B,A01,184690,Staff,52,0,100,48
1683339614648,COGS 3,A01,184715,Boyle; Mary E. T.,0,25,40,40
1683339615674,COGS 14B,A01,185172,Staff,0,15,38,38
1683339616699,COGS 18,A01,184736,Staff,17,0,80,63
1683339617723,COGS 100,A01,184932,Staff,0,5,73,73
1683339618750,COGS 101A,A01,184935,Staff,0,39,30,30
1683339619774,COGS 101B,A01,184944,Staff,0,2,30,30
1683339620801,COGS 101C,A01,184946,Staff,0,12,30,30
1683339621826,COGS 102A,A01,184951,Johnson; Christine M.,2,0,40,38
1683339622852,COGS 107B,A01,184953,Mooshagian; Eric Frederick,0,50,40,40
1683339623876,COGS 118B,A01,184959,Gupta; Anjum,0,48,40,40
1683339624903,COGS 153,A00,184961,Staff,0,15,30,30
1683339625931,COGS 177,A00,184962,Staff,0,20,30,30
1683339626962,COGS 187A,A01,184969,Boyle; Mary E. T.,0,17,40,40
1683339627992,COMM 10,A01,185174,Staff,0,5,25,25
1683339627992,COMM 10,A02,185189,Staff,0,5,25,25
1683339627992,COMM 10,A03,269821,Staff,0,0,0,0
1683339629019,COMM 100B,A01,185475,Staff,0,0,0,2
1683339629019,COMM 100B,A02,185476,Staff,13,0,25,12
1683339630047,COMM 100C,A01,185314,Staff,1,0,25,24
1683339630047,COMM 100C,A02,185327,Staff,19,0,25,6
1683339631073,COMM 110M,A00,185349,Staff,2,0,40,38
1683339632098,COMM 113T,A00,185352,Staff,24,0,40,16
1683339633123,COMM 114I,A00,185353,Staff,33,0,40,7
1683339634146,COMM 131,A00,185354,Staff,19,0,30,11
1683339635172,CSE 8A,A50,185358,Cao; Yingjun,0,46,10,10
1683339636200,CSE 8B,A01,185362,Staff,1,47,50,49
1683339637223,CSE 11,A01,185416,Cao; Yingjun,0,92,10,10
1683339638248,CSE 20,A01,185445,Briones; Jor-el Thomas Caparas,5,0,25,20
1683339639274,CSE 21,A01,185447,Staff,10,0,50,40
1683339640300,CSE 101,A01,185451,Staff,0,13,50,50
1683339640300,CSE 101,B01,185453,Jones; Miles E,0,11,50,50
1683339642354,CSE 141,A01,185458,Eldon; John,20,0,100,80
1683339643383,CSE 141L,A01,185461,Eldon; John,12,0,100,88
1683339644407,CSE 142,A01,185463,Staff,36,0,60,24
1683339644407,CSE 142,B01,201355,Staff,0,7,60,60
1683339645435,CSE 142L,A01,185470,Staff,36,0,60,24
1683339645435,CSE 142L,B01,201417,Staff,0,6,60,60
1683339646462,CSE 190,A00,201433,Staff,32,0,49,17
1683339647486,DOC 1,A01,259136,Strom; Megan C.,7,0,15,8
1683339647486,DOC 1,A02,259137,Strom; Megan C.,14,0,15,1
1683339647486,DOC 1,A03,259138,Strom; Megan C.,14,0,15,1
1683339647486,DOC 1,A04,259139,Strom; Megan C.,14,0,15,1
1683339648511,DOC 100D,A00,259140,Pass; Natalye Joann,16,0,25,9
1683339649537,DSGN 1,A01,184749,Rill; Bryan,0,25,30,30
1683339650563,DSGN 100,A01,185168,Staff,0,2,25,25
1683339651587,ECE 5,A01,185626,Morris; Karcher William,0,10,0,0
1683339652611,ECE 101,A01,185628,Staff,17,0,70,53
1683339653635,ECE 107,A01,185635,Baghdadchi; Saharnaz,0,0,20,20
1683339653635,ECE 107,A02,185638,Baghdadchi; Saharnaz,4,0,20,16
1683339654659,ECE 148,A01,185647,Silberman; Jack,0,0,16,16
1683339655684,ECON 1,A01,185537,Crane; Meredith Helen,54,0,70,16
1683339656709,ECON 3,A01,185549,Crane; Meredith Helen,33,0,70,37
1683339657737,ECON 4,A01,203354,Anderson; John Charles,0,4,10,10
1683339658764,ECON 100A,A01,185574,Staff,0,4,40,40
1683339659792,ECON 100B,A01,185576,Staff,10,22,50,40
1683339660816,ECON 100C,A01,185589,Newhouse; Herbert S,30,0,70,40
1683339661845,ECON 105,A00,185608,Vespa; Emanuel Ignacio,19,0,35,16
1683339662872,ECON 109,A01,185610,Shishkin; Denis,10,0,35,25
1683339663898,ECON 110A,A01,185612,Staff,11,0,40,29
1683339664921,ECON 120A,A01,185615,Staff,20,0,40,20
1683339665947,ECON 120C,A01,185617,Sun; Yixiao,0,20,70,70
1683339666972,ECON 144,A00,203346,Squires; Dale E,3,0,35,32
1683339667997,ECON 171,A01,203349,Newhouse; Herbert S,0,1,35,35
1683339669026,ECON 173A,A01,185621,Toda; Alexis Akira,21,0,35,14
1683339670057,EDS 25,A01,202413,Staff,0,1,0,0
1683339670057,EDS 25,A02,202414,Staff,0,1,0,0
1683339670057,EDS 25,A03,202415,Staff,0,0,0,0
1683339670057,EDS 25,A04,202416,Staff,0,1,0,0
1683339670057,EDS 25,A05,202439,Staff,0,0,0,0
1683339670057,EDS 25,A06,202440,Staff,0,0,0,0
1683339670057,EDS 25,B01,202631,Staff,0,0,0,0
1683339670057,EDS 25,B02,202632,Staff,0,0,0,0
1683339670057,EDS 25,B03,202639,Staff,0,0,0,0
1683339670057,EDS 25,B04,202640,Staff,0,0,0,0
1683339670057,EDS 25,B05,202643,Staff,0,0,0,0
1683339670057,EDS 25,B06,202644,Staff,0,0,0,0
1683339671085,EDS 38,A01,202659,Black; Alison Michelle,24,0,25,1
1683339672112,EDS 115,A00,202652,Staff,18,0,30,12
1683339673141,EDS 125,A00,202649,Staff,14,0,30,16
1683339674171,EDS 126,A01,203332,Staff,30,0,30,0
1683339675197,EDS 139,A00,202838,Staff,16,0,25,9
1683339676222,EDS 146,A01,202655,Staff,14,0,25,11
1683339677247,ENG 15,A00,185667,Staff,0,1,0,0
1683339677247,ENG 15,B00,185672,Staff,0,0,0,0
1683339677247,ENG 15,C00,185675,Staff,0,0,0,0
1683339677247,ENG 15,D00,185682,Staff,0,0,0,0
1683339677247,ENG 15,E00,185684,Staff,0,0,0,0
1683339678272,ETHN 103,A00,185710,Staff,0,4,35,35
1683339679300,ETHN 103A,A00,199228,Man; Simeon S,2,0,9,7
1683339680325,ETHN 109,A00,185711,Staff,18,0,35,17
1683339681350,ETHN 142,A00,185726,Staff,0,4,30,30
1683339682378,ETHN 163J,A00,199229,Man; Simeon S,5,0,8,3
1683339683402,ETHN 168,A00,185727,Staff,8,0,10,2
1683339684480,ETHN 182,A00,185728,Staff,1,0,35,34
1683339685505,ETHN 183,A00,185737,Staff,8,0,18,10
1683339686529,GLBH 111,A01,209361,Burgos; Jose L.,0,0,0,0
1683339688579,HIEU 104,A00,185792,Staff,16,0,20,4
1683339689604,HIEU 115,A00,185800,Staff,1,0,20,19
1683339690632,HIEU 128,A00,185801,Staff,0,7,20,20
1683339691657,HIEU 147,A00,185802,Staff,16,0,20,4
1683339692682,HIEU 154,A00,185823,Staff,12,0,20,8
1683339693706,HILA 102,A00,185826,Staff,13,0,20,7
1683339694734,HILD 2C,A01,185778,Staff,0,12,20,20
1683339695759,HILD 7B,A01,185780,Kwak; Nancy,0,15,32,32
1683339695759,HILD 7B,A02,185781,Kwak; Nancy,0,18,32,32
1683339696787,HILD 30,A01,185791,Staff,14,0,20,6
1683339697812,HISC 119,A00,185830,Golan; Tal,0,9,20,20
1683339698837,HITO 156GS,A00,185831,Patterson; Patrick H.,0,0,0,23
1683339699861,HIUS 103,A00,185832,Man; Simeon S,0,6,20,20
1683339700887,HIUS 117,A00,185836,Kwak; Nancy,2,0,20,18
1683339701915,HIUS 125,A00,185840,Man; Simeon S,0,0,23,23
1683339702943,HIUS 149,A00,185845,Staff,0,0,20,20
1683339703969,HUM 3,A01,185882,Zavodny; Tatiana Sophia,0,7,50,50
1683339703969,HUM 3,B01,185899,Caldwell; Michael Alan,0,18,50,50
1683339704993,HUM 3GS,A00,185900,Patterson; Patrick H.,0,0,0,23
1683339706019,HUM 4,A01,185938,Zroka; Amy Liane,31,0,50,19
1683339706019,HUM 4,B01,185956,Watkins; Eric,0,2,50,50
1683339706019,HUM 4,B02,202209,Watkins; Eric,0,2,50,50
1683339706019,HUM 4,B03,202210,Watkins; Eric,0,2,50,50
1683339707048,HUM 5,A01,185958,West; Geoffrey Scott,3,0,50,47
1683339707048,HUM 5,A02,202215,West; Geoffrey Scott,0,0,50,50
1683339708077,INTL 190,A00,185959,Gagnon; Jeffrey C,0,0,0,9
1683339708077,INTL 190,B00,185960,Lettieri; Michael Joseph,0,0,0,1
1683339709101,JAPN 180,A00,254509,Staff,5,1,30,25
1683339710128,LATI 10,A01,202853,Kennemore; Amy Michelle,4,0,35,31
1683339710128,LATI 10,A02,202854,Kennemore; Amy Michelle,2,0,35,33
1683339710128,LATI 10,A03,270054,Kennemore; Amy Michelle,30,0,30,0
1683339711157,LATI 180,A00,202855,Kennemore; Amy Michelle,11,0,20,9
1683339712182,LAWS 101,A00,201767,Golan; Tal,0,7,40,40
1683339713208,LIFR 1C,A00,185961,Staff,6,0,20,14
1683339714234,LIFR 1CX,A00,185962,Staff,7,0,20,13
1683339715258,LIFR 1D,A00,185963,Staff,9,0,20,11
1683339716285,LIFR 1DX,A00,185964,Staff,9,0,20,11
1683339717311,LIGN 101,A01,186039,Staff,43,0,50,7
1683339718337,LIGN 165,A00,186040,Staff,18,0,50,32
1683339719362,LTCS 108,A00,186041,Staff,6,0,10,4
1683339720387,LTCS 119,A00,186042,Staff,16,0,20,4
1683339721420,LTCS 130,A00,186043,Wesling; Megan E.,15,0,25,10
1683339723472,LTEA 138,A00,186119,Staff,14,0,40,26
1683339724500,LTEN 124,A00,186148,Staff,6,0,25,19
1683339725529,LTEN 178,A00,186149,Staff,7,0,15,8
1683339726556,LTEN 181,A00,186150,Blanco; John D,33,0,40,7
1683339727584,LTWL 120,A00,186160,Staff,20,0,25,5
1683339728612,LTWL 165,A00,186161,Staff,22,0,25,3
1683339729638,LTWR 100,A00,186162,Staff,0,5,15,15
1683339730666,LTWR 102,A00,186163,Doller; Ben,5,0,15,10
1683339731692,MAE 8,A01,186412,Staff,0,0,0,0
1683339732719,MAE 30B,A00,186445,Bahadori; Mohammad Yousef,83,0,100,17
1683339733745,MAE 40,A00,186592,Bewley; Thomas R,9,0,50,41
1683339734770,MAE 101B,A00,186593,Bahadori; Mohammad Yousef,81,0,100,19
1683339735795,MAE 105,A00,186594,Bandaru; Prabhakar,12,0,50,38
1683339736822,MAE 107,A00,186599,Pham; Hieu Tan,0,6,120,120
1683339737850,MAE 148,A01,186660,Silberman; Jack,3,0,16,13
1683339738879,MATH 10A,A01,188095,Staff,1,6,35,34
1683339739905,MATH 10B,A01,188097,Bowers; Adam R.,0,11,30,30
1683339739905,MATH 10B,A02,188099,Bowers; Adam R.,0,11,30,30
1683339739905,MATH 10B,B01,188104,Bowers; Adam R.,0,10,30,30
1683339739905,MATH 10B,B02,188106,Bowers; Adam R.,0,10,30,30
1683339740930,MATH 10C,A01,188111,Staff,0,18,30,30
1683339740930,MATH 10C,A02,188127,Staff,0,17,30,30
1683339740930,MATH 10C,A03,188131,Staff,0,18,30,30
1683339740930,MATH 10C,B01,188218,Staff,18,0,30,12
1683339740930,MATH 10C,B02,188244,Staff,13,0,30,17
1683339740930,MATH 10C,B03,188277,Staff,16,0,30,14
1683339741956,MATH 18,A01,188344,Bach; Quang Tran,18,0,30,12
1683339741956,MATH 18,A02,188345,Bach; Quang Tran,11,0,30,19
1683339741956,MATH 18,B01,188353,Bach; Quang Tran,10,0,30,20
1683339741956,MATH 18,B02,188354,Bach; Quang Tran,20,0,30,10
1683339742982,MATH 20A,A01,188374,Staff,13,0,35,22
1683339744009,MATH 20B,A01,188382,Ohm; Ko Woon,6,0,30,24
1683339744009,MATH 20B,A02,188383,Ohm; Ko Woon,22,0,30,8
1683339744009,MATH 20B,B01,188385,Ohm; Ko Woon,7,0,30,23
1683339744009,MATH 20B,B02,188392,Ohm; Ko Woon,22,0,30,8
1683339745039,MATH 20C,A01,188394,Harel; Guershon,10,0,30,20
1683339745039,MATH 20C,A02,188395,Harel; Guershon,15,0,30,15
1683339745039,MATH 20C,B01,188404,Harel; Guershon,5,0,30,25
1683339745039,MATH 20C,B02,188405,Harel; Guershon,19,0,30,11
1683339746066,MATH 20D,A01,188414,Hammock; Frances H,0,1,30,30
1683339746066,MATH 20D,A02,188415,Hammock; Frances H,3,0,30,27
1683339746066,MATH 20D,B01,188447,Hammock; Frances H,1,0,30,29
1683339746066,MATH 20D,B02,188486,Hammock; Frances H,8,0,30,22
1683339747092,MATH 20E,A01,188649,Staff,21,0,30,9
1683339747092,MATH 20E,A02,188650,Staff,23,0,30,7
1683339747092,MATH 20E,A03,188673,Staff,0,0,30,30
1683339748115,MATH 102,A01,188675,Staff,0,35,35,35
1683339749140,MATH 103B,A01,188681,Staff,3,0,35,32
1683339749140,MATH 103B,B01,188692,Staff,5,0,35,30
1683339750165,MATH 109,A01,188695,Salehi Golsefidy; Alireza,25,0,35,10
1683339750165,MATH 109,A02,188696,Salehi Golsefidy; Alireza,25,0,35,10
1683339751191,MATH 120A,A01,188698,Eggers; John Dietrich,7,0,35,28
1683339752216,MATH 142B,A01,188736,Ioana; Adrian,0,2,30,30
1683339752216,MATH 142B,A02,188741,Ioana; Adrian,1,1,30,29
1683339752216,MATH 142B,A03,188743,Ioana; Adrian,1,3,30,29
1683339753241,MATH 168A,A01,188790,Staff,0,9,35,35
1683339754267,MATH 170A,A01,188803,Nie; Jiawang,0,2,35,35
1683339754267,MATH 170A,A02,188811,Nie; Jiawang,0,0,35,35
1683339754267,MATH 170A,A03,188814,Nie; Jiawang,1,0,35,34
1683339754267,MATH 170A,A04,188815,Nie; Jiawang,13,0,35,22
1683339755293,MATH 193B,A01,188817,Staff,0,0,35,35
1683339755293,MATH 193B,A02,188818,Staff,5,0,35,30
1683339756322,MGT 4,A01,202857,Anderson; John Charles,62,0,80,18
1683339757350,MGT 12,A00,202858,Lindenberger; Wade Douglas,42,0,90,48
1683339758377,MGT 18,A00,202859,Staff,74,0,90,16
1683339759402,MGT 18GS,A00,202860,McKay; Michael J,13,0,28,15
1683339760426,MGT 45,A00,202861,Pecore; Joseph P.,14,0,90,76
1683339761455,MGT 100,A00,202863,Yavorsky; Daniel Ryan,28,0,90,62
1683339762483,MGT 103,A00,202864,Ehrich; Kristine R,1,18,90,89
1683339763508,MGT 112,A00,202865,Ehrich; Kristine R,15,0,90,75
1683339764535,MGT 121A,A00,202868,Staff,0,20,0,0
1683339765559,MGT 131B,A00,202869,Anderson; John Charles,59,0,90,31
1683339766589,MGT 136,A00,202871,Lindenberger; Wade Douglas,84,0,90,6
1683339767614,MGT 164,A00,202873,Staff,0,68,90,91
1683339768639,MGT 164GS,A00,202874,McKay; Mary A,13,0,28,15
1683339769667,MGT 180,A00,202875,Staff,0,50,90,91
1683339770690,MMW 11R,A01,205019,Herbst; Matthew,3,0,30,27
1683339770690,MMW 11R,A02,205026,Herbst; Matthew,29,0,30,1
1683339771720,MMW 15,A01,193512,Chang; Edmond Yi-Teh,0,9,28,28
1683339771720,MMW 15,A02,193513,Chang; Edmond Yi-Teh,0,5,28,28
1683339771720,MMW 15,A03,193514,Chang; Edmond Yi-Teh,0,5,28,28
1683339771720,MMW 15,A04,193515,Chang; Edmond Yi-Teh,0,5,28,28
1683339771720,MMW 15,A05,193516,Chang; Edmond Yi-Teh,0,4,28,28
1683339771720,MMW 15,A06,193517,Chang; Edmond Yi-Teh,0,5,28,28
1683339771720,MMW 15,B01,193519,Chang; Edmond Yi-Teh,0,5,28,28
1683339771720,MMW 15,B02,193520,Chang; Edmond Yi-Teh,0,5,28,28
1683339771720,MMW 15,B03,193521,Chang; Edmond Yi-Teh,0,5,28,28
1683339771720,MMW 15,B04,193522,Chang; Edmond Yi-Teh,0,4,28,28
1683339771720,MMW 15,B05,193523,Chang; Edmond Yi-Teh,0,5,28,28
1683339771720,MMW 15,B06,193524,Chang; Edmond Yi-Teh,0,4,28,28
1683339772747,MMW 122,A01,193526,Rahimi; Babak,0,15,28,28
1683339772747,MMW 122,A02,193527,Rahimi; Babak,0,14,28,28
1683339772747,MMW 122,A03,193528,Rahimi; Babak,0,0,0,0
1683339772747,MMW 122,A04,193529,Rahimi; Babak,0,0,0,0
1683339773773,MUS 1A,A01,186663,Staff,0,20,35,35
1683339774798,MUS 4,A01,186715,Staff,0,12,35,35
1683339775826,MUS 5R,A01,186796,Dubnov; Shlomo,0,17,35,35
1683339776854,MUS 6,A01,186798,Staff,0,4,25,25
1683339777879,MUS 7,A01,186830,Staff,13,0,35,22
1683339778903,MUS 8,A01,186930,Staff,0,26,35,35
1683339779928,MUS 15,A01,186932,Staff,0,16,35,35
1683339779928,MUS 15,B01,186934,Staff,0,15,35,35
1683339780954,MUS 80,A00,186935,Staff,1,0,20,19
1683339780954,MUS 80,B00,186936,Staff,25,0,25,0
1683339781980,NANO 11,A00,204702,Lipomi; Darren John,0,0,0,0
1683339783005,NANO 15,A01,204709,Yang; Kesong,0,1,0,0
1683339784030,NANO 114,A00,202069,Jahed Motlagh; Zeinab,3,0,10,7
1683339785054,PHIL 1,A00,186955,Grush; Rick Scott,32,0,40,8
1683339786083,PHIL 10,A01,186973,Grush; Rick Scott,28,0,35,7
1683339786083,PHIL 10,A02,186974,Grush; Rick Scott,33,0,35,2
1683339787109,PHIL 13,A01,186976,Staff,7,0,35,28
1683339787109,PHIL 13,A02,186977,Staff,16,0,35,19
1683339788195,PHIL 14,A01,186979,Staff,31,0,35,4
1683339788195,PHIL 14,A02,186986,Staff,32,0,35,3
1683339789219,PHIL 28,A01,186988,Staff,16,0,30,14
1683339789219,PHIL 28,A02,186989,Staff,1,0,30,29
1683339789219,PHIL 28,A03,186990,Staff,9,0,30,21
1683339789219,PHIL 28,A04,186991,Staff,26,0,30,4
1683339790243,PHIL 120,A00,186997,Staff,23,0,40,17
1683339791266,PHIL 137,A00,187003,Staff,9,0,40,31
1683339792295,PHIL 150,A00,187015,Staff,47,0,70,23
1683339793324,PHIL 167,A00,187021,Lamey; Andy M.,35,0,40,5
1683339794350,PHIL 174,A01,202226,Staff,17,0,20,3
1683339794350,PHIL 174,A02,202235,Staff,20,0,20,0
1683339795373,PHIL 191A,A00,258918,Staff,0,0,1,1
1683339796397,PHYS 1A,A00,187028,Staff,27,0,60,33
1683339797428,PHYS 1AL,001,187036,Staff,2,0,30,28
1683339797428,PHYS 1AL,002,187049,Staff,18,0,30,12
1683339798453,PHYS 1B,A00,187058,Staff,22,0,60,38
1683339799480,PHYS 1BL,001,187064,Staff,0,0,30,30
1683339799480,PHYS 1BL,002,187070,Staff,5,0,30,25
1683339800507,PHYS 1C,A00,187082,Staff,31,0,120,89
1683339801536,PHYS 1CL,001,187088,Staff,0,9,30,30
1683339801536,PHYS 1CL,002,187089,Staff,0,2,30,30
1683339801536,PHYS 1CL,009,262693,Staff,11,0,30,19
1683339802564,PHYS 2B,A01,187097,Staff,54,0,115,61
1683339803593,PHYS 2C,A01,187099,Staff,67,0,115,48
1683339804618,PHYS 2CL,A01,187101,Staff,5,0,28,23
1683339804618,PHYS 2CL,A02,187102,Staff,15,0,28,13
1683339805643,PHYS 2D,A01,187123,Shotwell; Brian,95,0,115,20
1683339806670,PHYS 4B,A01,187133,Grinstein; Benjamin,35,0,50,15
1683339807699,POLI 10,A00,188819,Staff,0,4,50,50
1683339808726,POLI 11,A00,188827,Staff,43,0,50,7
1683339809752,POLI 13R,A00,188828,Staff,0,1,20,20
1683339810782,POLI 27,A01,188830,Elgin; Samuel Zincke,0,1,70,70
1683339811810,POLI 30,A00,188832,Desposato; Scott,31,0,50,19
1683339812835,POLI 102F,A00,188834,Staff,3,0,40,37
1683339813859,POLI 104A,A00,188852,Staff,14,0,30,16
1683339814886,POLI 104I,A00,188853,Staff,0,6,20,20
1683339815915,POLI 110B,A00,188854,Wiens; David,7,0,20,13
1683339816943,POLI 112A,A00,188855,Wiens; David,5,0,30,25
1683339817971,POLI 117R,A00,188856,Forman; Fonna,0,11,20,20
1683339818998,POLI 118,A00,188857,Ingham; Sean,8,0,20,12
1683339820025,POLI 120G,A00,188858,Staff,9,0,30,21
1683339821049,POLI 131CR,A00,188863,Hoston; Germaine,24,0,50,26
1683339822072,POLI 133,A00,188864,Nellis; Gareth Hb,44,0,50,6
1683339823098,POLI 134D,A00,188865,Desposato; Scott,27,0,30,3
1683339824124,POLI 142A,A00,188871,Gartzke; Erik,22,0,50,28
1683339825148,POLI 142K,A00,188874,Staff,38,0,50,12
1683339826176,POLI 143,A00,188940,Gartzke; Erik,16,0,30,14
1683339827201,POLI 153,A00,188943,Staff,3,0,20,17
1683339828226,POLI 160AA,A00,188944,Staff,12,0,40,28
1683339829252,POLI 170A,A00,188945,Staff,11,0,30,19
1683339831304,PSYC 1,A00,188952,Staff,37,0,90,53
1683339832331,PSYC 2,B00,188953,Staff,19,0,35,16
1683339833359,PSYC 6,A00,188970,Staff,47,0,60,13
1683339834388,PSYC 7,A00,188973,Staff,37,0,45,8
1683339835415,PSYC 60,A01,188980,Rickard; Timothy C.,43,0,60,17
1683339836449,PSYC 70,A01,189001,Steiner; Eric Tomas,24,0,45,21
1683339837473,PSYC 100,A00,189005,Lacefield; Katharine I,0,98,120,120
1683339838500,PSYC 102,A00,189008,Staff,9,0,30,21
1683339839524,PSYC 106,B00,189026,Gorman; Michael R.,34,0,60,26
1683339840550,PSYC 114,B01,189033,Winkielman; Piotr,0,32,30,30
1683339841578,PSYC 131,A00,189036,Anagnostaras; Stephan,0,43,60,60
1683339842604,PSYC 136,A00,189041,Lowe; Angela Beth,0,7,25,25
1683339843632,PSYC 137,A00,189057,Winkielman; Piotr,0,34,25,25
1683339844660,PSYC 144,A00,189107,Wixted; John T,0,7,50,50
1683339846711,PSYC 162,A00,189142,Staff,0,8,85,85
1683339847736,PSYC 172,A00,189144,Gorman; Michael R.,0,7,30,30
1683339849789,PSYC 179,A00,189146,Lacefield; Katharine I,0,84,120,120
1683339850816,PSYC 181,A00,189147,Anagnostaras; Stephan,0,44,90,90
1683339851844,PSYC 190R,A00,189148,Barner; David A.,0,22,80,80
1683339852870,PSYC 191,A00,189275,Rickard; Timothy C.,0,7,25,25
1683339853894,PSYC 193,A00,189276,Chapman; Eddie Nathaniel,0,1,0,4
1683339854923,PSYC 193L,A01,189281,Lowe; Angela Beth,12,0,20,8
1683339854923,PSYC 193L,B01,189285,Staff,28,0,35,7
1683339855950,RELI 149,A00,187137,Rahimi; Babak,7,0,40,33
1683339856975,SE 9,A01,187315,Staff,0,2,18,18
1683339858000,SE 101B,A00,187409,Staff,24,0,30,6
1683339859028,SE 110B,A00,187444,Staff,10,0,40,30
1683339860057,SE 130B,A00,187449,Staff,31,0,40,9
1683339861086,SE 150A,A00,187516,Staff,9,0,20,11
1683339862112,SE 154,A00,187528,Staff,30,0,50,20
1683339863141,SIO 3,A01,258171,Staff,35,0,40,5
1683339864170,SIO 10,A00,187144,Cook; Geoffrey W,0,3,75,75
1683339865196,SIO 45,A00,187152,Cook; Geoffrey W,1,0,100,99
1683339866221,SIO 109R,A00,194486,Staff,0,3,20,20
1683339868270,SIO 187,A01,187233,Kacev; David,12,0,40,28
1683339869298,SOCI 1,A01,258656,Thorpe; Charles Robert,28,0,30,2
1683339869298,SOCI 1,A02,258658,Thorpe; Charles Robert,30,0,30,0
1683339869298,SOCI 1,A03,258661,Thorpe; Charles Robert,25,0,25,0
1683339869298,SOCI 1,A04,258666,Thorpe; Charles Robert,22,0,25,3
1683339869298,SOCI 1,A05,258897,Thorpe; Charles Robert,23,0,25,2
1683339869298,SOCI 1,A06,258898,Thorpe; Charles Robert,25,0,25,0
1683339870327,SOCI 30,A01,258903,Pardo Guerra; Juan Pablo,15,0,30,15
1683339871355,SOCI 102,A00,258904,Staff,9,0,25,16
1683339872379,SOCI 106,A00,258905,Staff,19,0,25,6
1683339873408,SOCI 111,A00,258907,Ribas Norris; Janet Vanesa,26,0,30,4
1683339874430,SOCI 121R,A00,258908,Pardo Guerra; Juan Pablo,10,0,30,20
1683339875459,SOCI 126,A01,203330,Staff,14,0,20,6
1683339876485,SOCI 131,A00,258909,Thorpe; Charles Robert,31,0,60,29
1683339877512,SOCI 135,A00,258910,Payne; Christine Anna,0,9,30,30
1683339878540,SOCI 157,A00,258911,Staff,12,0,30,18
1683339879567,SOCI 184,A00,258912,Staff,25,0,30,5
1683339880591,SOCI 188D,A00,258913,Staff,21,0,30,9
1683339881620,SYN 2,001,187529,Staff,10,0,16,6
1683339881620,SYN 2,002,201452,Staff,0,18,16,16
1683339881620,SYN 2,003,201469,Staff,3,0,16,13
1683339882649,SYN 100,A01,187531,Staff,0,9,20,20
1683339882649,SYN 100,B01,201491,Staff,0,12,20,20
1683339883677,TDAC 1,A00,189286,Walsh; Kim C.,3,0,20,17
1683339883677,TDAC 1,B00,189287,Harting; Carla Kelso,11,0,20,9
1683339884706,TDAC 101,A00,189300,Walsh; Kim C.,16,0,20,4
1683339884706,TDAC 101,B00,189301,Harting; Carla Kelso,18,0,20,2
1683339885731,TDAC 102,A00,189304,Basso; Beatrice,14,0,20,6
1683339886757,TDAC 108,A00,189305,Staff,18,0,20,2
1683339887785,TDDE 131,A00,189310,Staff,19,0,20,1
1683339887785,TDDE 131,B00,189314,Staff,19,0,20,1
1683339887785,TDDE 131,C00,189315,Staff,48,0,50,2
1683339887785,TDDE 131,D00,189316,Staff,14,0,15,1
1683339887785,TDDE 131,E00,204841,Staff,20,0,20,0
1683339888811,TDGE 10,A00,189289,Staff,30,0,50,20
1683339888811,TDGE 10,B00,189290,Havis; Allan,1,0,50,49
1683339889836,TDGE 11,A00,189291,Fulton; Julia,0,3,50,50
1683339889836,TDGE 11,B00,189292,Staff,20,0,25,5
1683339889836,TDGE 11,C00,260270,Staff,0,0,0,0
1683339890865,TDGE 25,A00,189294,Staff,3,0,20,17
1683339891948,TDGE 124,A00,189318,Fulton; Julia,0,8,50,50
1683339892972,TDGE 125,A00,189319,Staff,13,0,25,12
1683339892972,TDGE 125,B00,189320,Staff,23,0,25,2
1683339893997,TDGE 127,A00,189322,Havis; Allan,0,0,50,50
1683339895024,TDHT 101,A00,189323,Staff,18,0,25,7
1683339895024,TDHT 101,B00,189324,Staff,25,0,25,0
1683339896049,TDHT 102,A00,189325,Staff,49,0,50,1
1683339897079,TDMV 1,A00,189295,Arcidiacono; Kristin,19,0,30,11
1683339897079,TDMV 1,B00,189296,Caligagan; Maria T.,24,0,30,6
1683339898106,TDMV 2,A00,189297,Sammartano; Tonnie,28,0,30,2
1683339898106,TDMV 2,B00,189299,Arcidiacono; Kristin,24,0,30,6
1683339899130,TDMV 3,A00,204998,Rincon; Alicia,22,0,30,8
1683339900156,TDMV 120,A00,189458,Sammartano; Tonnie,28,0,30,2
1683339901181,TDMV 138,A00,189541,Jun; Grace Shin Hae,22,0,40,18
1683339902210,TDMV 142,A00,189717,Caligagan; Tony,23,0,30,7
1683339902210,TDMV 142,B00,189718,Caligagan; Maria T.,25,0,30,5
1683339903241,TMC 2,A01,187533,Staff,25,0,25,0
1683339903241,TMC 2,A02,187534,Staff,25,0,25,0
1683339904267,USP 1,A01,187536,Kwak; Nancy,0,16,25,25
1683339905292,USP 5,A01,187538,Staff,10,0,25,15
1683339906320,USP 101,A00,199253,Staff,0,4,0,0
1683339907345,USP 124,A00,187562,Boomhower; Matthew Charles,1,0,30,29
1683339908373,USP 138,A00,187582,Staff,20,0,25,5
1683339909397,USP 152,A01,187597,Staff,4,0,25,21
1683339910422,USP 153,A00,187598,Staff,19,0,25,6
1683339911449,USP 168,A00,187607,Kwak; Nancy,2,0,5,3
1683339912472,USP 173,A00,187619,Staff,4,0,25,21
1683339913498,USP 181,A00,187638,Staff,0,0,25,25
1683339914526,VIS 103,A00,187650,Cruz; Edwin Teddy,23,0,75,52
1683339915551,VIS 110D,A00,187669,Staff,12,0,22,10
1683339916576,VIS 127C,A00,187720,Shen; Kuiyi,67,0,146,79
1683339917606,VIS 149,A00,187731,Yoldas; Pinar,0,14,22,22
1683339918632,VIS 151,A01,188091,Staff,22,0,34,12
1683339918632,VIS 151,A02,188092,Staff,11,0,34,23
1683339919656,VIS 160B,A00,188093,Stalbaum; Brett,0,0,10,10
1683339921707,WCWP 10B,A00,201720,Staff,10,0,15,5
1683339921707,WCWP 10B,B00,201722,Staff,9,0,15,6
1683339922732,WCWP 100,A00,201725,Gagnon; Jeffrey C,0,0,2,2
1683339922732,WCWP 100,B00,201727,Staff,0,4,15,15
1683339925857,ANBI 133,A00,258401,Wilder; Linnea Lorene,34,0,40,6
1683339926880,ANBI 140,A00,258395,Hrvoj Mihic; Branka,18,0,25,7
1683339927910,ANSC 120,A00,258402,Bialecki; Jon Anthony,27,0,40,13
1683339928938,ANSC 144,A00,258400,Staff,14,0,40,26
1683339930988,ANSC 166,A00,258396,Parish; Steven Martin,157,0,175,18
1683339932016,ANSC 180,A00,193533,Staff,9,0,20,11
1683339933041,ANSC 188,A00,258397,Jassal; Aftab,33,0,40,7
1683339934068,ANTH 3,A01,258316,Staff,23,0,30,7
1683339935095,ANTH 5,A00,258394,Semendeferi; Ekaterini,16,0,20,4
1683339936123,ANTH 21,A01,258331,Staff,8,0,40,32
1683339937150,ANTH 103,A00,258398,Varma; Saiba,15,0,25,10
1683339938178,AWP 10,001,202034,Staff,0,0,0,0
1683339938178,AWP 10,002,202035,Staff,0,0,0,0
1683339938178,AWP 10,003,202036,Staff,0,0,0,0
1683339938178,AWP 10,004,202037,Staff,0,0,0,0
1683339938178,AWP 10,005,202038,Staff,0,0,0,0
1683339938178,AWP 10,006,202039,Staff,0,0,0,0
1683339938178,AWP 10,007,202040,Staff,0,0,0,0
1683339938178,AWP 10,008,202041,Staff,0,0,0,0
1683339938178,AWP 10,009,202042,Staff,0,0,0,0
1683339938178,AWP 10,010,202043,Staff,0,0,0,0
1683339938178,AWP 10,011,202044,Staff,0,0,0,0
1683339938178,AWP 10,012,202045,Staff,0,0,0,0
1683339938178,AWP 10,013,202046,Staff,0,0,0,0
1683339938178,AWP 10,014,202047,Staff,0,0,0,0
1683339938178,AWP 10,015,202048,Staff,0,0,0,0
1683339938178,AWP 10,016,202049,Staff,0,0,0,0
1683339938178,AWP 10,017,202050,Staff,0,0,0,0
1683339938178,AWP 10,018,202051,Staff,0,0,0,0
1683339938178,AWP 10,019,202052,Staff,0,0,0,0
1683339938178,AWP 10,020,202053,Staff,0,0,0,0
1683339938178,AWP 10,021,202054,Staff,0,0,0,0
1683339938178,AWP 10,022,202055,Staff,0,0,0,0
1683339938178,AWP 10,023,202056,Staff,0,0,0,0
1683339938178,AWP 10,024,202057,Staff,0,0,0,0
1683339938178,AWP 10,025,202058,Staff,0,0,0,0
1683339938178,AWP 10,026,202059,Staff,0,0,0,0
1683339939203,AWP 102,001,202032,Staff,0,0,0,0
1683339939203,AWP 102,002,202033,Staff,0,0,0,0
1683339940227,BENG 100,A01,254234,Taylor Amos; Alyssa C,31,0,40,9
1683339941253,BENG 196,001,270013,Engler; Adam J.,9999,0,9999,0
1683339942277,BICD 100R,A01,202018,Smith; Laurie,0,7,32,32
1683339942277,BICD 100R,A02,202019,Smith; Laurie,0,2,32,32
1683339942277,BICD 100R,A03,202020,Smith; Laurie,0,1,32,32
1683339942277,BICD 100R,A04,202021,Smith; Laurie,9,0,32,23
1683339942277,BICD 100R,A05,202022,Smith; Laurie,12,0,32,20
1683339943305,BICD 136,A01,193242,Gustafson-Brown; Cindy,0,2,32,32
1683339943305,BICD 136,A02,193244,Gustafson-Brown; Cindy,14,0,32,18
1683339944333,BIEB 102,A01,193249,Butler; Shannon Rhey,0,2,32,32
1683339944333,BIEB 102,A02,193251,Butler; Shannon Rhey,0,0,32,32
1683339944333,BIEB 102,A03,193253,Butler; Shannon Rhey,0,1,32,32
1683339944333,BIEB 102,A04,193255,Butler; Shannon Rhey,17,0,32,15
1683339944333,BIEB 102,A05,193265,Butler; Shannon Rhey,26,0,32,6
1683339944333,BIEB 102,A06,193269,Butler; Shannon Rhey,16,0,32,16
1683339946386,BIEB 150,A01,193274,Staff,0,0,32,32
1683339946386,BIEB 150,A02,193285,Staff,23,0,32,9
1683339947413,BIEB 194,A00,193286,Kurle; Carolyn M.,22,0,32,10
1683339948442,BILD 1,A01,192291,Staff,16,0,32,16
1683339948442,BILD 1,A02,192292,Staff,30,0,32,2
1683339948442,BILD 1,B01,192520,Reuther; Keefe,0,1,0,0
1683339948442,BILD 1,B02,192532,Reuther; Keefe,0,1,0,0
1683339949474,BILD 3,A01,192556,Butler; Shannon Rhey,0,0,32,32
1683339949474,BILD 3,A02,192581,Butler; Shannon Rhey,5,0,32,27
1683339949474,BILD 3,A03,192611,Butler; Shannon Rhey,23,0,32,9
1683339949474,BILD 3,A04,192612,Butler; Shannon Rhey,25,0,32,7
1683339949474,BILD 3,A05,192613,Butler; Shannon Rhey,27,0,32,5
1683339949474,BILD 3,A06,192679,Butler; Shannon Rhey,27,0,32,5
1683339949474,BILD 3,A07,192682,Butler; Shannon Rhey,22,0,32,10
1683339950504,BILD 4,A01,192836,Reuther; Keefe,0,0,24,24
1683339950504,BILD 4,A02,193044,Reuther; Keefe,4,0,24,20
1683339951531,BILD 10,A01,193142,Gustafson-Brown; Cindy,30,0,32,2
1683339951531,BILD 10,A02,193149,Gustafson-Brown; Cindy,31,0,32,1
1683339952556,BIMM 100,A01,193301,Staff,0,6,32,32
1683339952556,BIMM 100,A02,193312,Staff,0,5,32,32
1683339952556,BIMM 100,A03,193323,Staff,0,8,32,32
1683339953582,BIMM 101,A01,193329,McDonnell; Lisa Marie,0,3,24,24
1683339953582,BIMM 101,A02,193339,McDonnell; Lisa Marie,0,3,24,24
1683339953582,BIMM 101,B01,193354,McDonnell; Lisa Marie,0,3,24,24
1683339953582,BIMM 101,B02,193357,McDonnell; Lisa Marie,0,3,24,24
1683339954607,BIMM 110,A01,193377,Tat; John,0,11,32,32
1683339954607,BIMM 110,A02,193378,Tat; John,1,9,32,31
1683339955631,BIMM 120,A01,206116,Staff,0,0,32,32
1683339955631,BIMM 120,A02,206117,Staff,8,0,32,24
1683339955631,BIMM 120,A03,206121,Staff,21,0,32,11
1683339956657,BIPN 100,A01,193393,Park; Ji Young,0,14,32,32
1683339956657,BIPN 100,A02,193402,Park; Ji Young,0,13,32,32
1683339956657,BIPN 100,A03,193413,Park; Ji Young,0,14,32,32
1683339956657,BIPN 100,A04,193414,Park; Ji Young,0,13,32,32
1683339957686,BIPN 102,A01,193429,Staff,0,0,32,32
1683339957686,BIPN 102,A02,193438,Staff,22,0,32,10
1683339958710,BIPN 106,A01,193450,Reyes Gonzalez; Catalina,0,2,40,40
1683339959741,BIPN 134,A01,193465,Cooke; James Edward,0,0,32,32
1683339959741,BIPN 134,A02,193474,Cooke; James Edward,25,0,32,7
1683339959741,BIPN 134,A03,193485,Cooke; James Edward,29,0,32,3
1683339959741,BIPN 134,A04,193486,Cooke; James Edward,21,0,32,11
1683339959741,BIPN 134,A05,193491,Cooke; James Edward,31,0,32,1
1683339959741,BIPN 134,A06,193501,Cooke; James Edward,30,0,32,2
1683339959741,BIPN 134,A07,193510,Cooke; James Edward,29,0,32,3
1683339961805,BISP 194,A00,222522,Staff,14,0,32,18
1683339962831,CAT 124,A01,202407,Staff,20,0,25,5
1683339963859,CAT 125,A00,202408,Marchisotto; Jennifer Anne,4,0,20,16
1683339964883,CAT 125R,A00,202409,Smith; Lauryn Alissa,0,11,20,20
1683339964883,CAT 125R,B00,202410,Morales; Celeste Georgianna,0,11,20,20
1683339964883,CAT 125R,C00,202411,Irwin; Matthew Joseph,0,10,20,20
1683339965908,CENG 15,A01,204712,Yang; Kesong,0,1,0,0
1683339966934,CENG 114,A00,202070,Jahed Motlagh; Zeinab,5,0,20,15
1683339967963,CGS 105,A00,185477,Wesling; Megan E.,24,0,40,16
1683339968991,CGS 106,A00,185494,Staff,13,0,22,9
1683339970015,CGS 108,A00,185495,Staff,14,0,20,6
1683339971043,CGS 114,A00,185496,Staff,13,0,18,5
1683339972068,CGS 119,A00,185501,Staff,15,0,20,5
1683339973096,CGS 120,A00,185511,Staff,13,0,20,7
1683339974125,CHEM 4,A01,184675,Bussey; Thomas J,96,0,100,4
1683339975150,CHEM 6A,A01,184677,Staff,34,0,60,26
1683339976174,CHEM 6B,A01,184679,Staff,65,0,100,35
1683339977202,CHEM 6C,A01,184681,Bussey; Thomas J,1,0,50,49
1683339977202,CHEM 6C,A02,184682,Bussey; Thomas J,34,0,50,16
1683339978227,CHEM 40A,A01,184684,Albizati; Kim F.,37,0,100,63
1683339979250,CHEM 40B,A01,184686,Albizati; Kim F.,0,20,100,100
1683339980279,CHEM 41B,A01,184690,Staff,52,0,100,48
1683339981304,COGS 3,A01,184715,Boyle; Mary E. T.,0,25,40,40
1683339982332,COGS 14B,A01,185172,Staff,0,15,38,38
1683339983359,COGS 18,A01,184736,Staff,17,0,80,63
1683339984386,COGS 100,A01,184932,Staff,0,5,73,73
1683339985410,COGS 101A,A01,184935,Staff,0,39,30,30
1683339986438,COGS 101B,A01,184944,Staff,0,2,30,30
1683339987461,COGS 101C,A01,184946,Staff,0,12,30,30
1683339988486,COGS 102A,A01,184951,Johnson; Christine M.,2,0,40,38
1683339989510,COGS 107B,A01,184953,Mooshagian; Eric Frederick,0,50,40,40
1683339990535,COGS 118B,A01,184959,Gupta; Anjum,0,48,40,40
1683339991560,COGS 153,A00,184961,Staff,0,15,30,30
1683339992589,COGS 177,A00,184962,Staff,0,20,30,30
1683339993614,COGS 187A,A01,184969,Boyle; Mary E. T.,0,17,40,40
1683339994639,COMM 10,A01,185174,Staff,0,5,25,25
1683339994639,COMM 10,A02,185189,Staff,0,5,25,25
1683339994639,COMM 10,A03,269821,Staff,0,0,0,0
1683339995742,COMM 100B,A01,185475,Staff,0,0,0,2
1683339995742,COMM 100B,A02,185476,Staff,13,0,25,12
1683339996771,COMM 100C,A01,185314,Staff,1,0,25,24
1683339996771,COMM 100C,A02,185327,Staff,19,0,25,6
1683339997795,COMM 110M,A00,185349,Staff,2,0,40,38
1683339998820,COMM 113T,A00,185352,Staff,24,0,40,16
1683339999845,COMM 114I,A00,185353,Staff,33,0,40,7
1683340000869,COMM 131,A00,185354,Staff,19,0,30,11
1683340001893,CSE 8A,A50,185358,Cao; Yingjun,0,46,10,10
1683340002916,CSE 8B,A01,185362,Staff,1,47,50,49
1683340003944,CSE 11,A01,185416,Cao; Yingjun,0,92,10,10
1683340004969,CSE 20,A01,185445,Briones; Jor-el Thomas Caparas,5,0,25,20
1683340005994,CSE 21,A01,185447,Staff,10,0,50,40
1683340007020,CSE 101,A01,185451,Staff,0,13,50,50
1683340007020,CSE 101,B01,185453,Jones; Miles E,0,11,50,50
1683340009069,CSE 141,A01,185458,Eldon; John,20,0,100,80
1683340010093,CSE 141L,A01,185461,Eldon; John,12,0,100,88
1683340011118,CSE 142,A01,185463,Staff,36,0,60,24
1683340011118,CSE 142,B01,201355,Staff,0,7,60,60
1683340012142,CSE 142L,A01,185470,Staff,36,0,60,24
1683340012142,CSE 142L,B01,201417,Staff,0,6,60,60
1683340013169,CSE 190,A00,201433,Staff,32,0,49,17
1683340014198,DOC 1,A01,259136,Strom; Megan C.,7,0,15,8
1683340014198,DOC 1,A02,259137,Strom; Megan C.,14,0,15,1
1683340014198,DOC 1,A03,259138,Strom; Megan C.,14,0,15,1
1683340014198,DOC 1,A04,259139,Strom; Megan C.,14,0,15,1
1683340015221,DOC 100D,A00,259140,Pass; Natalye Joann,16,0,25,9
1683340016245,DSGN 1,A01,184749,Rill; Bryan,0,25,30,30
1683340017272,DSGN 100,A01,185168,Staff,0,2,25,25
1683340018302,ECE 5,A01,185626,Morris; Karcher William,0,10,0,0
1683340019330,ECE 101,A01,185628,Staff,17,0,70,53
1683340020359,ECE 107,A01,185635,Baghdadchi; Saharnaz,0,0,20,20
1683340020359,ECE 107,A02,185638,Baghdadchi; Saharnaz,4,0,20,16
1683340021388,ECE 148,A01,185647,Silberman; Jack,0,0,16,16
1683340022418,ECON 1,A01,185537,Crane; Meredith Helen,54,0,70,16
1683340023447,ECON 3,A01,185549,Crane; Meredith Helen,33,0,70,37
1683340024476,ECON 4,A01,203354,Anderson; John Charles,0,4,10,10
1683340025502,ECON 100A,A01,185574,Staff,0,4,40,40
1683340026527,ECON 100B,A01,185576,Staff,10,22,50,40
1683340027556,ECON 100C,A01,185589,Newhouse; Herbert S,30,0,70,40
1683340028590,ECON 105,A00,185608,Vespa; Emanuel Ignacio,19,0,35,16
1683340029618,ECON 109,A01,185610,Shishkin; Denis,10,0,35,25
1683340030647,ECON 110A,A01,185612,Staff,11,0,40,29
1683340031673,ECON 120A,A01,185615,Staff,20,0,40,20
1683340032702,ECON 120C,A01,185617,Sun; Yixiao,0,20,70,70
1683340033730,ECON 144,A00,203346,Squires; Dale E,3,0,35,32
1683340034759,ECON 171,A01,203349,Newhouse; Herbert S,0,1,35,35
1683340035788,ECON 173A,A01,185621,Toda; Alexis Akira,21,0,35,14
1683340036818,EDS 25,A01,202413,Staff,0,1,0,0
1683340036818,EDS 25,A02,202414,Staff,0,1,0,0
1683340036818,EDS 25,A03,202415,Staff,0,0,0,0
1683340036818,EDS 25,A04,202416,Staff,0,1,0,0
1683340036818,EDS 25,A05,202439,Staff,0,0,0,0
1683340036818,EDS 25,A06,202440,Staff,0,0,0,0
1683340036818,EDS 25,B01,202631,Staff,0,0,0,0
1683340036818,EDS 25,B02,202632,Staff,0,0,0,0
1683340036818,EDS 25,B03,202639,Staff,0,0,0,0
1683340036818,EDS 25,B04,202640,Staff,0,0,0,0
1683340036818,EDS 25,B05,202643,Staff,0,0,0,0
1683340036818,EDS 25,B06,202644,Staff,0,0,0,0
1683340037845,EDS 38,A01,202659,Black; Alison Michelle,24,0,25,1
1683340038870,EDS 115,A00,202652,Staff,18,0,30,12
1683340039895,EDS 125,A00,202649,Staff,14,0,30,16
1683340040920,EDS 126,A01,203332,Staff,30,0,30,0
1683340041945,EDS 139,A00,202838,Staff,16,0,25,9
1683340042973,EDS 146,A01,202655,Staff,14,0,25,11
1683340044003,ENG 15,A00,185667,Staff,0,1,0,0
1683340044003,ENG 15,B00,185672,Staff,0,0,0,0
1683340044003,ENG 15,C00,185675,Staff,0,0,0,0
1683340044003,ENG 15,D00,185682,Staff,0,0,0,0
1683340044003,ENG 15,E00,185684,Staff,0,0,0,0
1683340045033,ETHN 103,A00,185710,Staff,0,4,35,35
1683340046062,ETHN 103A,A00,199228,Man; Simeon S,2,0,9,7
1683340047088,ETHN 109,A00,185711,Staff,18,0,35,17
1683340048114,ETHN 142,A00,185726,Staff,0,4,30,30
1683340049140,ETHN 163J,A00,199229,Man; Simeon S,5,0,8,3
1683340050185,ETHN 168,A00,185727,Staff,8,0,10,2
1683340051210,ETHN 182,A00,185728,Staff,1,0,35,34
1683340052237,ETHN 183,A00,185737,Staff,8,0,18,10
1683340053265,GLBH 111,A01,209361,Burgos; Jose L.,0,0,0,0
1683340055321,HIEU 104,A00,185792,Staff,16,0,20,4
1683340056349,HIEU 115,A00,185800,Staff,1,0,20,19
1683340057375,HIEU 128,A00,185801,Staff,0,7,20,20
1683340058399,HIEU 147,A00,185802,Staff,16,0,20,4
1683340059423,HIEU 154,A00,185823,Staff,12,0,20,8
1683340060451,HILA 102,A00,185826,Staff,13,0,20,7
1683340061474,HILD 2C,A01,185778,Staff,0,12,20,20
1683340062501,HILD 7B,A01,185780,Kwak; Nancy,0,15,32,32
1683340062501,HILD 7B,A02,185781,Kwak; Nancy,0,18,32,32
1683340063529,HILD 30,A01,185791,Staff,14,0,20,6
1683340064554,HISC 119,A00,185830,Golan; Tal,0,9,20,20
1683340065579,HITO 156GS,A00,185831,Patterson; Patrick H.,0,0,0,23
1683340066605,HIUS 103,A00,185832,Man; Simeon S,0,6,20,20
1683340067634,HIUS 117,A00,185836,Kwak; Nancy,2,0,20,18
1683340068663,HIUS 125,A00,185840,Man; Simeon S,0,0,23,23
1683340069688,HIUS 149,A00,185845,Staff,0,0,20,20
1683340070715,HUM 3,A01,185882,Zavodny; Tatiana Sophia,0,7,50,50
1683340070715,HUM 3,B01,185899,Caldwell; Michael Alan,0,18,50,50
1683340071740,HUM 3GS,A00,185900,Patterson; Patrick H.,0,0,0,23
1683340072770,HUM 4,A01,185938,Zroka; Amy Liane,31,0,50,19
1683340072770,HUM 4,B01,185956,Watkins; Eric,0,2,50,50
1683340072770,HUM 4,B02,202209,Watkins; Eric,0,2,50,50
1683340072770,HUM 4,B03,202210,Watkins; Eric,0,2,50,50
1683340073799,HUM 5,A01,185958,West; Geoffrey Scott,3,0,50,47
1683340073799,HUM 5,A02,202215,West; Geoffrey Scott,0,0,50,50
1683340074825,INTL 190,A00,185959,Gagnon; Jeffrey C,0,0,0,9
1683340074825,INTL 190,B00,185960,Lettieri; Michael Joseph,0,0,0,1
1683340075849,JAPN 180,A00,254509,Staff,5,1,30,25
1683340076875,LATI 10,A01,202853,Kennemore; Amy Michelle,4,0,35,31
1683340076875,LATI 10,A02,202854,Kennemore; Amy Michelle,2,0,35,33
1683340076875,LATI 10,A03,270054,Kennemore; Amy Michelle,30,0,30,0
1683340077900,LATI 180,A00,202855,Kennemore; Amy Michelle,11,0,20,9
1683340078922,LAWS 101,A00,201767,Golan; Tal,0,7,40,40
1683340079950,LIFR 1C,A00,185961,Staff,6,0,20,14
1683340080977,LIFR 1CX,A00,185962,Staff,7,0,20,13
1683340082008,LIFR 1D,A00,185963,Staff,9,0,20,11
1683340083034,LIFR 1DX,A00,185964,Staff,9,0,20,11
1683340084062,LIGN 101,A01,186039,Staff,43,0,50,7
1683340085086,LIGN 165,A00,186040,Staff,18,0,50,32
1683340086111,LTCS 108,A00,186041,Staff,6,0,10,4
1683340087138,LTCS 119,A00,186042,Staff,16,0,20,4
1683340088165,LTCS 130,A00,186043,Wesling; Megan E.,15,0,25,10
1683340090215,LTEA 138,A00,186119,Staff,14,0,40,26
1683340091239,LTEN 124,A00,186148,Staff,6,0,25,19
1683340092263,LTEN 178,A00,186149,Staff,7,0,15,8
1683340093291,LTEN 181,A00,186150,Blanco; John D,33,0,40,7
1683340094317,LTWL 120,A00,186160,Staff,20,0,25,5
1683340095343,LTWL 165,A00,186161,Staff,22,0,25,3
1683340096370,LTWR 100,A00,186162,Staff,0,5,15,15
1683340097395,LTWR 102,A00,186163,Doller; Ben,5,0,15,10
1683340098419,MAE 8,A01,186412,Staff,0,0,0,0
1683340099497,MAE 30B,A00,186445,Bahadori; Mohammad Yousef,83,0,100,17
1683340100519,MAE 40,A00,186592,Bewley; Thomas R,9,0,50,41
1683340101547,MAE 101B,A00,186593,Bahadori; Mohammad Yousef,81,0,100,19
1683340102576,MAE 105,A00,186594,Bandaru; Prabhakar,12,0,50,38
1683340103605,MAE 107,A00,186599,Pham; Hieu Tan,0,6,120,120
1683340104633,MAE 148,A01,186660,Silberman; Jack,3,0,16,13
1683340105660,MATH 10A,A01,188095,Staff,1,6,35,34
1683340106688,MATH 10B,A01,188097,Bowers; Adam R.,0,11,30,30
1683340106688,MATH 10B,A02,188099,Bowers; Adam R.,0,11,30,30
1683340106688,MATH 10B,B01,188104,Bowers; Adam R.,0,10,30,30
1683340106688,MATH 10B,B02,188106,Bowers; Adam R.,0,10,30,30
1683340107718,MATH 10C,A01,188111,Staff,0,18,30,30
1683340107718,MATH 10C,A02,188127,Staff,0,17,30,30
1683340107718,MATH 10C,A03,188131,Staff,0,18,30,30
1683340107718,MATH 10C,B01,188218,Staff,18,0,30,12
1683340107718,MATH 10C,B02,188244,Staff,13,0,30,17
1683340107718,MATH 10C,B03,188277,Staff,16,0,30,14
1683340108747,MATH 18,A01,188344,Bach; Quang Tran,18,0,30,12
1683340108747,MATH 18,A02,188345,Bach; Quang Tran,11,0,30,19
1683340108747,MATH 18,B01,188353,Bach; Quang Tran,10,0,30,20
1683340108747,MATH 18,B02,188354,Bach; Quang Tran,20,0,30,10
1683340109772,MATH 20A,A01,188374,Staff,13,0,35,22
1683340110801,MATH 20B,A01,188382,Ohm; Ko Woon,6,0,30,24
1683340110801,MATH 20B,A02,188383,Ohm; Ko Woon,22,0,30,8
1683340110801,MATH 20B,B01,188385,Ohm; Ko Woon,7,0,30,23
1683340110801,MATH 20B,B02,188392,Ohm; Ko Woon,22,0,30,8
1683340111831,MATH 20C,A01,188394,Harel; Guershon,10,0,30,20
1683340111831,MATH 20C,A02,188395,Harel; Guershon,15,0,30,15
1683340111831,MATH 20C,B01,188404,Harel; Guershon,5,0,30,25
1683340111831,MATH 20C,B02,188405,Harel; Guershon,19,0,30,11
1683340112861,MATH 20D,A01,188414,Hammock; Frances H,0,1,30,30
1683340112861,MATH 20D,A02,188415,Hammock; Frances H,3,0,30,27
1683340112861,MATH 20D,B01,188447,Hammock; Frances H,1,0,30,29
1683340112861,MATH 20D,B02,188486,Hammock; Frances H,8,0,30,22
1683340113887,MATH 20E,A01,188649,Staff,21,0,30,9
1683340113887,MATH 20E,A02,188650,Staff,23,0,30,7
1683340113887,MATH 20E,A03,188673,Staff,0,0,30,30
1683340114915,MATH 102,A01,188675,Staff,0,35,35,35
1683340115941,MATH 103B,A01,188681,Staff,3,0,35,32
1683340115941,MATH 103B,B01,188692,Staff,5,0,35,30
1683340116969,MATH 109,A01,188695,Salehi Golsefidy; Alireza,25,0,35,10
1683340116969,MATH 109,A02,188696,Salehi Golsefidy; Alireza,25,0,35,10
1683340117999,MATH 120A,A01,188698,Eggers; John Dietrich,7,0,35,28
1683340119024,MATH 142B,A01,188736,Ioana; Adrian,0,2,30,30
1683340119024,MATH 142B,A02,188741,Ioana; Adrian,1,1,30,29
1683340119024,MATH 142B,A03,188743,Ioana; Adrian,1,3,30,29
1683340120049,MATH 168A,A01,188790,Staff,0,9,35,35
1683340121074,MATH 170A,A01,188803,Nie; Jiawang,0,2,35,35
1683340121074,MATH 170A,A02,188811,Nie; Jiawang,0,0,35,35
1683340121074,MATH 170A,A03,188814,Nie; Jiawang,1,0,35,34
1683340121074,MATH 170A,A04,188815,Nie; Jiawang,13,0,35,22
1683340122099,MATH 193B,A01,188817,Staff,0,0,35,35
1683340122099,MATH 193B,A02,188818,Staff,5,0,35,30
1683340123124,MGT 4,A01,202857,Anderson; John Charles,62,0,80,18
1683340124153,MGT 12,A00,202858,Lindenberger; Wade Douglas,42,0,90,48
1683340125181,MGT 18,A00,202859,Staff,74,0,90,16
1683340126208,MGT 18GS,A00,202860,McKay; Michael J,13,0,28,15
1683340127237,MGT 45,A00,202861,Pecore; Joseph P.,14,0,90,76
1683340128264,MGT 100,A00,202863,Yavorsky; Daniel Ryan,28,0,90,62
1683340129287,MGT 103,A00,202864,Ehrich; Kristine R,1,18,90,89
1683340130316,MGT 112,A00,202865,Ehrich; Kristine R,15,0,90,75
1683340131344,MGT 121A,A00,202868,Staff,0,20,0,0
1683340132372,MGT 131B,A00,202869,Anderson; John Charles,59,0,90,31
1683340133398,MGT 136,A00,202871,Lindenberger; Wade Douglas,84,0,90,6
1683340134424,MGT 164,A00,202873,Staff,0,68,90,91
1683340135448,MGT 164GS,A00,202874,McKay; Mary A,13,0,28,15
1683340136472,MGT 180,A00,202875,Staff,0,50,90,91
1683340137499,MMW 11R,A01,205019,Herbst; Matthew,3,0,30,27
1683340137499,MMW 11R,A02,205026,Herbst; Matthew,29,0,30,1
1683340138526,MMW 15,A01,193512,Chang; Edmond Yi-Teh,0,9,28,28
1683340138526,MMW 15,A02,193513,Chang; Edmond Yi-Teh,0,5,28,28
1683340138526,MMW 15,A03,193514,Chang; Edmond Yi-Teh,0,5,28,28
1683340138526,MMW 15,A04,193515,Chang; Edmond Yi-Teh,0,5,28,28
1683340138526,MMW 15,A05,193516,Chang; Edmond Yi-Teh,0,4,28,28
1683340138526,MMW 15,A06,193517,Chang; Edmond Yi-Teh,0,5,28,28
1683340138526,MMW 15,B01,193519,Chang; Edmond Yi-Teh,0,5,28,28
1683340138526,MMW 15,B02,193520,Chang; Edmond Yi-Teh,0,5,28,28
1683340138526,MMW 15,B03,193521,Chang; Edmond Yi-Teh,0,5,28,28
1683340138526,MMW 15,B04,193522,Chang; Edmond Yi-Teh,0,4,28,28
1683340138526,MMW 15,B05,193523,Chang; Edmond Yi-Teh,0,5,28,28
1683340138526,MMW 15,B06,193524,Chang; Edmond Yi-Teh,0,4,28,28
1683340139550,MMW 122,A01,193526,Rahimi; Babak,0,15,28,28
1683340139550,MMW 122,A02,193527,Rahimi; Babak,0,14,28,28
1683340139550,MMW 122,A03,193528,Rahimi; Babak,0,0,0,0
1683340139550,MMW 122,A04,193529,Rahimi; Babak,0,0,0,0
1683340140578,MUS 1A,A01,186663,Staff,0,20,35,35
1683340141604,MUS 4,A01,186715,Staff,0,12,35,35
1683340142628,MUS 5R,A01,186796,Dubnov; Shlomo,0,17,35,35
1683340143654,MUS 6,A01,186798,Staff,0,4,25,25
1683340144681,MUS 7,A01,186830,Staff,13,0,35,22
1683340145706,MUS 8,A01,186930,Staff,0,26,35,35
1683340146731,MUS 15,A01,186932,Staff,0,16,35,35
1683340146731,MUS 15,B01,186934,Staff,0,15,35,35
1683340147756,MUS 80,A00,186935,Staff,1,0,20,19
1683340147756,MUS 80,B00,186936,Staff,25,0,25,0
1683340148781,NANO 11,A00,204702,Lipomi; Darren John,0,0,0,0
1683340149809,NANO 15,A01,204709,Yang; Kesong,0,1,0,0
1683340150834,NANO 114,A00,202069,Jahed Motlagh; Zeinab,3,0,10,7
1683340151857,PHIL 1,A00,186955,Grush; Rick Scott,32,0,40,8
1683340152886,PHIL 10,A01,186973,Grush; Rick Scott,28,0,35,7
1683340152886,PHIL 10,A02,186974,Grush; Rick Scott,33,0,35,2
1683340153914,PHIL 13,A01,186976,Staff,7,0,35,28
1683340153914,PHIL 13,A02,186977,Staff,16,0,35,19
1683340154942,PHIL 14,A01,186979,Staff,31,0,35,4
1683340154942,PHIL 14,A02,186986,Staff,32,0,35,3
1683340155971,PHIL 28,A01,186988,Staff,16,0,30,14
1683340155971,PHIL 28,A02,186989,Staff,1,0,30,29
1683340155971,PHIL 28,A03,186990,Staff,9,0,30,21
1683340155971,PHIL 28,A04,186991,Staff,26,0,30,4
1683340156995,PHIL 120,A00,186997,Staff,23,0,40,17
1683340158019,PHIL 137,A00,187003,Staff,9,0,40,31
1683340159046,PHIL 150,A00,187015,Staff,47,0,70,23
1683340160071,PHIL 167,A00,187021,Lamey; Andy M.,35,0,40,5
1683340161096,PHIL 174,A01,202226,Staff,17,0,20,3
1683340161096,PHIL 174,A02,202235,Staff,20,0,20,0
1683340162120,PHIL 191A,A00,258918,Staff,0,0,1,1
1683340163143,PHYS 1A,A00,187028,Staff,27,0,60,33
1683340164171,PHYS 1AL,001,187036,Staff,2,0,30,28
1683340164171,PHYS 1AL,002,187049,Staff,18,0,30,12
1683340165195,PHYS 1B,A00,187058,Staff,22,0,60,38
1683340166220,PHYS 1BL,001,187064,Staff,0,0,30,30
1683340166220,PHYS 1BL,002,187070,Staff,5,0,30,25
1683340167245,PHYS 1C,A00,187082,Staff,31,0,120,89
1683340168272,PHYS 1CL,001,187088,Staff,0,9,30,30
1683340168272,PHYS 1CL,002,187089,Staff,0,2,30,30
1683340168272,PHYS 1CL,009,262693,Staff,11,0,30,19
1683340169300,PHYS 2B,A01,187097,Staff,54,0,115,61
1683340170329,PHYS 2C,A01,187099,Staff,67,0,115,48
1683340171354,PHYS 2CL,A01,187101,Staff,5,0,28,23
1683340171354,PHYS 2CL,A02,187102,Staff,15,0,28,13
1683340172377,PHYS 2D,A01,187123,Shotwell; Brian,95,0,115,20
1683340173406,PHYS 4B,A01,187133,Grinstein; Benjamin,35,0,50,15
1683340174434,POLI 10,A00,188819,Staff,0,4,50,50
1683340175458,POLI 11,A00,188827,Staff,43,0,50,7
1683340176484,POLI 13R,A00,188828,Staff,0,1,20,20
1683340177518,POLI 27,A01,188830,Elgin; Samuel Zincke,0,1,70,70
1683340178543,POLI 30,A00,188832,Desposato; Scott,31,0,50,19
1683340179569,POLI 102F,A00,188834,Staff,3,0,40,37
1683340180594,POLI 104A,A00,188852,Staff,14,0,30,16
1683340181621,POLI 104I,A00,188853,Staff,0,6,20,20
1683340182648,POLI 110B,A00,188854,Wiens; David,7,0,20,13
1683340183676,POLI 112A,A00,188855,Wiens; David,5,0,30,25
1683340184702,POLI 117R,A00,188856,Forman; Fonna,0,11,20,20
1683340185729,POLI 118,A00,188857,Ingham; Sean,8,0,20,12
1683340186754,POLI 120G,A00,188858,Staff,9,0,30,21
1683340187779,POLI 131CR,A00,188863,Hoston; Germaine,24,0,50,26
1683340188803,POLI 133,A00,188864,Nellis; Gareth Hb,44,0,50,6
1683340189831,POLI 134D,A00,188865,Desposato; Scott,27,0,30,3
1683340190860,POLI 142A,A00,188871,Gartzke; Erik,22,0,50,28
1683340191887,POLI 142K,A00,188874,Staff,38,0,50,12
1683340192912,POLI 143,A00,188940,Gartzke; Erik,16,0,30,14
1683340193936,POLI 153,A00,188943,Staff,3,0,20,17
1683340194964,POLI 160AA,A00,188944,Staff,12,0,40,28
1683340195989,POLI 170A,A00,188945,Staff,11,0,30,19
1683340198040,PSYC 1,A00,188952,Staff,37,0,90,53
1683340199068,PSYC 2,B00,188953,Staff,19,0,35,16
1683340200095,PSYC 6,A00,188970,Staff,47,0,60,13
1683340201120,PSYC 7,A00,188973,Staff,37,0,45,8
1683340202145,PSYC 60,A01,188980,Rickard; Timothy C.,43,0,60,17
1683340203230,PSYC 70,A01,189001,Steiner; Eric Tomas,24,0,45,21
1683340204258,PSYC 100,A00,189005,Lacefield; Katharine I,0,98,120,120
1683340205283,PSYC 102,A00,189008,Staff,9,0,30,21
1683340206308,PSYC 106,B00,189026,Gorman; Michael R.,34,0,60,26
1683340207336,PSYC 114,B01,189033,Winkielman; Piotr,0,32,30,30
1683340208361,PSYC 131,A00,189036,Anagnostaras; Stephan,0,43,60,60
1683340209384,PSYC 136,A00,189041,Lowe; Angela Beth,0,7,25,25
1683340210413,PSYC 137,A00,189057,Winkielman; Piotr,0,34,25,25
1683340211439,PSYC 144,A00,189107,Wixted; John T,0,7,50,50
1683340213493,PSYC 162,A00,189142,Staff,0,8,85,85
1683340214517,PSYC 172,A00,189144,Gorman; Michael R.,0,7,30,30
1683340216574,PSYC 179,A00,189146,Lacefield; Katharine I,0,84,120,120
1683340217602,PSYC 181,A00,189147,Anagnostaras; Stephan,0,44,90,90
1683340218627,PSYC 190R,A00,189148,Barner; David A.,0,22,80,80
1683340219652,PSYC 191,A00,189275,Rickard; Timothy C.,0,7,25,25
1683340220676,PSYC 193,A00,189276,Chapman; Eddie Nathaniel,0,1,0,4
1683340221704,PSYC 193L,A01,189281,Lowe; Angela Beth,12,0,20,8
1683340221704,PSYC 193L,B01,189285,Staff,28,0,35,7
1683340222728,RELI 149,A00,187137,Rahimi; Babak,7,0,40,33
1683340223752,SE 9,A01,187315,Staff,0,2,18,18
1683340224779,SE 101B,A00,187409,Staff,24,0,30,6
1683340225805,SE 110B,A00,187444,Staff,10,0,40,30
1683340226831,SE 130B,A00,187449,Staff,31,0,40,9
1683340227855,SE 150A,A00,187516,Staff,9,0,20,11
1683340228881,SE 154,A00,187528,Staff,30,0,50,20
1683340229911,SIO 3,A01,258171,Staff,35,0,40,5
1683340230936,SIO 10,A00,187144,Cook; Geoffrey W,0,3,75,75
1683340231960,SIO 45,A00,187152,Cook; Geoffrey W,1,0,100,99
1683340232985,SIO 109R,A00,194486,Staff,0,3,20,20
1683340235034,SIO 187,A01,187233,Kacev; David,12,0,40,28
1683340236064,SOCI 1,A01,258656,Thorpe; Charles Robert,28,0,30,2
1683340236064,SOCI 1,A02,258658,Thorpe; Charles Robert,30,0,30,0
1683340236064,SOCI 1,A03,258661,Thorpe; Charles Robert,25,0,25,0
1683340236064,SOCI 1,A04,258666,Thorpe; Charles Robert,22,0,25,3
1683340236064,SOCI 1,A05,258897,Thorpe; Charles Robert,23,0,25,2
1683340236064,SOCI 1,A06,258898,Thorpe; Charles Robert,25,0,25,0
1683340237093,SOCI 30,A01,258903,Pardo Guerra; Juan Pablo,15,0,30,15
1683340238121,SOCI 102,A00,258904,Staff,9,0,25,16
1683340239146,SOCI 106,A00,258905,Staff,19,0,25,6
1683340240171,SOCI 111,A00,258907,Ribas Norris; Janet Vanesa,26,0,30,4
1683340241199,SOCI 121R,A00,258908,Pardo Guerra; Juan Pablo,10,0,30,20
1683340242226,SOCI 126,A01,203330,Staff,14,0,20,6
1683340243252,SOCI 131,A00,258909,Thorpe; Charles Robert,31,0,60,29
1683340244280,SOCI 135,A00,258910,Payne; Christine Anna,0,9,30,30
1683340245304,SOCI 157,A00,258911,Staff,12,0,30,18
1683340246329,SOCI 184,A00,258912,Staff,25,0,30,5
1683340247353,SOCI 188D,A00,258913,Staff,21,0,30,9
1683340248378,SYN 2,001,187529,Staff,10,0,16,6
1683340248378,SYN 2,002,201452,Staff,0,18,16,16
1683340248378,SYN 2,003,201469,Staff,3,0,16,13
1683340249404,SYN 100,A01,187531,Staff,0,9,20,20
1683340249404,SYN 100,B01,201491,Staff,0,12,20,20
1683340250429,TDAC 1,A00,189286,Walsh; Kim C.,3,0,20,17
1683340250429,TDAC 1,B00,189287,Harting; Carla Kelso,11,0,20,9
1683340251457,TDAC 101,A00,189300,Walsh; Kim C.,16,0,20,4
1683340251457,TDAC 101,B00,189301,Harting; Carla Kelso,18,0,20,2
1683340252481,TDAC 102,A00,189304,Basso; Beatrice,14,0,20,6
1683340253507,TDAC 108,A00,189305,Staff,18,0,20,2
1683340254533,TDDE 131,A00,189310,Staff,19,0,20,1
1683340254533,TDDE 131,B00,189314,Staff,19,0,20,1
1683340254533,TDDE 131,C00,189315,Staff,48,0,50,2
1683340254533,TDDE 131,D00,189316,Staff,14,0,15,1
1683340254533,TDDE 131,E00,204841,Staff,20,0,20,0
1683340255560,TDGE 10,A00,189289,Staff,30,0,50,20
1683340255560,TDGE 10,B00,189290,Havis; Allan,1,0,50,49
1683340256586,TDGE 11,A00,189291,Fulton; Julia,0,3,50,50
1683340256586,TDGE 11,B00,189292,Staff,20,0,25,5
1683340256586,TDGE 11,C00,260270,Staff,0,0,0,0
1683340257611,TDGE 25,A00,189294,Staff,3,0,20,17
1683340258635,TDGE 124,A00,189318,Fulton; Julia,0,8,50,50
1683340259666,TDGE 125,A00,189319,Staff,13,0,25,12
1683340259666,TDGE 125,B00,189320,Staff,23,0,25,2
1683340260694,TDGE 127,A00,189322,Havis; Allan,0,0,50,50
1683340261718,TDHT 101,A00,189323,Staff,18,0,25,7
1683340261718,TDHT 101,B00,189324,Staff,25,0,25,0
1683340262742,TDHT 102,A00,189325,Staff,49,0,50,1
1683340263767,TDMV 1,A00,189295,Arcidiacono; Kristin,19,0,30,11
1683340263767,TDMV 1,B00,189296,Caligagan; Maria T.,24,0,30,6
1683340264791,TDMV 2,A00,189297,Sammartano; Tonnie,28,0,30,2
1683340264791,TDMV 2,B00,189299,Arcidiacono; Kristin,24,0,30,6
1683340265819,TDMV 3,A00,204998,Rincon; Alicia,22,0,30,8
1683340266843,TDMV 120,A00,189458,Sammartano; Tonnie,28,0,30,2
1683340267871,TDMV 138,A00,189541,Jun; Grace Shin Hae,22,0,40,18
1683340268896,TDMV 142,A00,189717,Caligagan; Tony,23,0,30,7
1683340268896,TDMV 142,B00,189718,Caligagan; Maria T.,25,0,30,5
1683340269926,TMC 2,A01,187533,Staff,25,0,25,0
1683340269926,TMC 2,A02,187534,Staff,25,0,25,0
1683340270953,USP 1,A01,187536,Kwak; Nancy,0,16,25,25
1683340271978,USP 5,A01,187538,Staff,10,0,25,15
1683340273006,USP 101,A00,199253,Staff,0,4,0,0
1683340274031,USP 124,A00,187562,Boomhower; Matthew Charles,1,0,30,29
1683340275059,USP 138,A00,187582,Staff,20,0,25,5
1683340276083,USP 152,A01,187597,Staff,4,0,25,21
1683340277109,USP 153,A00,187598,Staff,19,0,25,6
1683340278138,USP 168,A00,187607,Kwak; Nancy,2,0,5,3
1683340279163,USP 173,A00,187619,Staff,4,0,25,21
1683340280189,USP 181,A00,187638,Staff,0,0,25,25
1683340281213,VIS 103,A00,187650,Cruz; Edwin Teddy,23,0,75,52
1683340282237,VIS 110D,A00,187669,Staff,12,0,22,10
1683340283262,VIS 127C,A00,187720,Shen; Kuiyi,67,0,146,79
1683340284287,VIS 149,A00,187731,Yoldas; Pinar,0,14,22,22
1683340285312,VIS 151,A01,188091,Staff,22,0,34,12
1683340285312,VIS 151,A02,188092,Staff,11,0,34,23
1683340286340,VIS 160B,A00,188093,Stalbaum; Brett,0,0,10,10
1683340288392,WCWP 10B,A00,201720,Staff,10,0,15,5
1683340288392,WCWP 10B,B00,201722,Staff,9,0,15,6
1683340289418,WCWP 100,A00,201725,Gagnon; Jeffrey C,0,0,2,2
1683340289418,WCWP 100,B00,201727,Staff,0,4,15,15
1683340292507,ANBI 133,A00,258401,Wilder; Linnea Lorene,34,0,40,6
1683340293533,ANBI 140,A00,258395,Hrvoj Mihic; Branka,18,0,25,7
1683340294561,ANSC 120,A00,258402,Bialecki; Jon Anthony,27,0,40,13
1683340295586,ANSC 144,A00,258400,Staff,14,0,40,26
1683340297636,ANSC 166,A00,258396,Parish; Steven Martin,157,0,175,18
1683340298664,ANSC 180,A00,193533,Staff,9,0,20,11
1683340299687,ANSC 188,A00,258397,Jassal; Aftab,33,0,40,7
1683340300712,ANTH 3,A01,258316,Staff,23,0,30,7
1683340301735,ANTH 5,A00,258394,Semendeferi; Ekaterini,16,0,20,4
1683340302759,ANTH 21,A01,258331,Staff,8,0,40,32
1683340303784,ANTH 103,A00,258398,Varma; Saiba,15,0,25,10
1683340304814,AWP 10,001,202034,Staff,0,0,0,0
1683340304814,AWP 10,002,202035,Staff,0,0,0,0
1683340304814,AWP 10,003,202036,Staff,0,0,0,0
1683340304814,AWP 10,004,202037,Staff,0,0,0,0
1683340304814,AWP 10,005,202038,Staff,0,0,0,0
1683340304814,AWP 10,006,202039,Staff,0,0,0,0
1683340304814,AWP 10,007,202040,Staff,0,0,0,0
1683340304814,AWP 10,008,202041,Staff,0,0,0,0
1683340304814,AWP 10,009,202042,Staff,0,0,0,0
1683340304814,AWP 10,010,202043,Staff,0,0,0,0
1683340304814,AWP 10,011,202044,Staff,0,0,0,0
1683340304814,AWP 10,012,202045,Staff,0,0,0,0
1683340304814,AWP 10,013,202046,Staff,0,0,0,0
1683340304814,AWP 10,014,202047,Staff,0,0,0,0
1683340304814,AWP 10,015,202048,Staff,0,0,0,0
1683340304814,AWP 10,016,202049,Staff,0,0,0,0
1683340304814,AWP 10,017,202050,Staff,0,0,0,0
1683340304814,AWP 10,018,202051,Staff,0,0,0,0
1683340304814,AWP 10,019,202052,Staff,0,0,0,0
1683340304814,AWP 10,020,202053,Staff,0,0,0,0
1683340304814,AWP 10,021,202054,Staff,0,0,0,0
1683340304814,AWP 10,022,202055,Staff,0,0,0,0
1683340304814,AWP 10,023,202056,Staff,0,0,0,0
1683340304814,AWP 10,024,202057,Staff,0,0,0,0
1683340304814,AWP 10,025,202058,Staff,0,0,0,0
1683340304814,AWP 10,026,202059,Staff,0,0,0,0
1683340305839,AWP 102,001,202032,Staff,0,0,0,0
1683340305839,AWP 102,002,202033,Staff,0,0,0,0
1683340306922,BENG 100,A01,254234,Taylor Amos; Alyssa C,31,0,40,9
1683340307950,BENG 196,001,270013,Engler; Adam J.,9999,0,9999,0
1683340308975,BICD 100R,A01,202018,Smith; Laurie,0,7,32,32
1683340308975,BICD 100R,A02,202019,Smith; Laurie,0,2,32,32
1683340308975,BICD 100R,A03,202020,Smith; Laurie,0,1,32,32
1683340308975,BICD 100R,A04,202021,Smith; Laurie,9,0,32,23
1683340308975,BICD 100R,A05,202022,Smith; Laurie,12,0,32,20
1683340310001,BICD 136,A01,193242,Gustafson-Brown; Cindy,0,2,32,32
1683340310001,BICD 136,A02,193244,Gustafson-Brown; Cindy,14,0,32,18
1683340311026,BIEB 102,A01,193249,Butler; Shannon Rhey,0,2,32,32
1683340311026,BIEB 102,A02,193251,Butler; Shannon Rhey,0,0,32,32
1683340311026,BIEB 102,A03,193253,Butler; Shannon Rhey,0,1,32,32
1683340311026,BIEB 102,A04,193255,Butler; Shannon Rhey,17,0,32,15
1683340311026,BIEB 102,A05,193265,Butler; Shannon Rhey,26,0,32,6
1683340311026,BIEB 102,A06,193269,Butler; Shannon Rhey,16,0,32,16
1683340313079,BIEB 150,A01,193274,Staff,0,0,32,32
1683340313079,BIEB 150,A02,193285,Staff,23,0,32,9
1683340314103,BIEB 194,A00,193286,Kurle; Carolyn M.,22,0,32,10
1683340315131,BILD 1,A01,192291,Staff,16,0,32,16
1683340315131,BILD 1,A02,192292,Staff,30,0,32,2
1683340315131,BILD 1,B01,192520,Reuther; Keefe,0,1,0,0
1683340315131,BILD 1,B02,192532,Reuther; Keefe,0,1,0,0
1683340316157,BILD 3,A01,192556,Butler; Shannon Rhey,0,0,32,32
1683340316157,BILD 3,A02,192581,Butler; Shannon Rhey,5,0,32,27
1683340316157,BILD 3,A03,192611,Butler; Shannon Rhey,23,0,32,9
1683340316157,BILD 3,A04,192612,Butler; Shannon Rhey,25,0,32,7
1683340316157,BILD 3,A05,192613,Butler; Shannon Rhey,27,0,32,5
1683340316157,BILD 3,A06,192679,Butler; Shannon Rhey,27,0,32,5
1683340316157,BILD 3,A07,192682,Butler; Shannon Rhey,22,0,32,10
1683340317186,BILD 4,A01,192836,Reuther; Keefe,0,0,24,24
1683340317186,BILD 4,A02,193044,Reuther; Keefe,4,0,24,20
1683340318213,BILD 10,A01,193142,Gustafson-Brown; Cindy,30,0,32,2
1683340318213,BILD 10,A02,193149,Gustafson-Brown; Cindy,31,0,32,1
1683340319238,BIMM 100,A01,193301,Staff,0,6,32,32
1683340319238,BIMM 100,A02,193312,Staff,0,5,32,32
1683340319238,BIMM 100,A03,193323,Staff,0,8,32,32
1683340320267,BIMM 101,A01,193329,McDonnell; Lisa Marie,0,3,24,24
1683340320267,BIMM 101,A02,193339,McDonnell; Lisa Marie,0,3,24,24
1683340320267,BIMM 101,B01,193354,McDonnell; Lisa Marie,0,3,24,24
1683340320267,BIMM 101,B02,193357,McDonnell; Lisa Marie,0,3,24,24
1683340321295,BIMM 110,A01,193377,Tat; John,0,11,32,32
1683340321295,BIMM 110,A02,193378,Tat; John,1,9,32,31
1683340322320,BIMM 120,A01,206116,Staff,0,0,32,32
1683340322320,BIMM 120,A02,206117,Staff,8,0,32,24
1683340322320,BIMM 120,A03,206121,Staff,21,0,32,11
1683340323348,BIPN 100,A01,193393,Park; Ji Young,0,14,32,32
1683340323348,BIPN 100,A02,193402,Park; Ji Young,0,13,32,32
1683340323348,BIPN 100,A03,193413,Park; Ji Young,0,14,32,32
1683340323348,BIPN 100,A04,193414,Park; Ji Young,0,13,32,32
1683340324378,BIPN 102,A01,193429,Staff,0,0,32,32
1683340324378,BIPN 102,A02,193438,Staff,22,0,32,10
1683340325405,BIPN 106,A01,193450,Reyes Gonzalez; Catalina,0,2,40,40
1683340326435,BIPN 134,A01,193465,Cooke; James Edward,0,0,32,32
1683340326435,BIPN 134,A02,193474,Cooke; James Edward,25,0,32,7
1683340326435,BIPN 134,A03,193485,Cooke; James Edward,29,0,32,3
1683340326435,BIPN 134,A04,193486,Cooke; James Edward,21,0,32,11
1683340326435,BIPN 134,A05,193491,Cooke; James Edward,31,0,32,1
1683340326435,BIPN 134,A06,193501,Cooke; James Edward,30,0,32,2
1683340326435,BIPN 134,A07,193510,Cooke; James Edward,29,0,32,3
1683340328487,BISP 194,A00,222522,Staff,14,0,32,18
1683340329516,CAT 124,A01,202407,Staff,20,0,25,5
1683340330545,CAT 125,A00,202408,Marchisotto; Jennifer Anne,4,0,20,16
1683340331574,CAT 125R,A00,202409,Smith; Lauryn Alissa,0,11,20,20
1683340331574,CAT 125R,B00,202410,Morales; Celeste Georgianna,0,11,20,20
1683340331574,CAT 125R,C00,202411,Irwin; Matthew Joseph,0,10,20,20
1683340332603,CENG 15,A01,204712,Yang; Kesong,0,1,0,0
1683340333627,CENG 114,A00,202070,Jahed Motlagh; Zeinab,5,0,20,15
1683340334649,CGS 105,A00,185477,Wesling; Megan E.,24,0,40,16
1683340335675,CGS 106,A00,185494,Staff,13,0,22,9
1683340336700,CGS 108,A00,185495,Staff,14,0,20,6
1683340337724,CGS 114,A00,185496,Staff,13,0,18,5
1683340338749,CGS 119,A00,185501,Staff,15,0,20,5
1683340339772,CGS 120,A00,185511,Staff,13,0,20,7
1683340340796,CHEM 4,A01,184675,Bussey; Thomas J,96,0,100,4
1683340341820,CHEM 6A,A01,184677,Staff,34,0,60,26
1683340342846,CHEM 6B,A01,184679,Staff,65,0,100,35
1683340343872,CHEM 6C,A01,184681,Bussey; Thomas J,1,0,50,49
1683340343872,CHEM 6C,A02,184682,Bussey; Thomas J,34,0,50,16
1683340344898,CHEM 40A,A01,184684,Albizati; Kim F.,37,0,100,63
1683340345924,CHEM 40B,A01,184686,Albizati; Kim F.,0,20,100,100
1683340346950,CHEM 41B,A01,184690,Staff,52,0,100,48
1683340347974,COGS 3,A01,184715,Boyle; Mary E. T.,0,25,40,40
1683340348997,COGS 14B,A01,185172,Staff,0,15,38,38
1683340350024,COGS 18,A01,184736,Staff,17,0,80,63
1683340351054,COGS 100,A01,184932,Staff,0,5,73,73
1683340352079,COGS 101A,A01,184935,Staff,0,39,30,30
1683340353107,COGS 101B,A01,184944,Staff,0,2,30,30
1683340354131,COGS 101C,A01,184946,Staff,0,12,30,30
1683340355157,COGS 102A,A01,184951,Johnson; Christine M.,2,0,40,38
1683340356185,COGS 107B,A01,184953,Mooshagian; Eric Frederick,0,50,40,40
1683340357213,COGS 118B,A01,184959,Gupta; Anjum,0,48,40,40
1683340358238,COGS 153,A00,184961,Staff,0,15,30,30
1683340359269,COGS 177,A00,184962,Staff,0,20,30,30
1683340360296,COGS 187A,A01,184969,Boyle; Mary E. T.,0,17,40,40
1683340361325,COMM 10,A01,185174,Staff,0,5,25,25
1683340361325,COMM 10,A02,185189,Staff,0,5,25,25
1683340361325,COMM 10,A03,269821,Staff,0,0,0,0
1683340362350,COMM 100B,A01,185475,Staff,0,0,0,2
1683340362350,COMM 100B,A02,185476,Staff,13,0,25,12
1683340363374,COMM 100C,A01,185314,Staff,1,0,25,24
1683340363374,COMM 100C,A02,185327,Staff,19,0,25,6
1683340364398,COMM 110M,A00,185349,Staff,2,0,40,38
1683340365424,COMM 113T,A00,185352,Staff,24,0,40,16
1683340366448,COMM 114I,A00,185353,Staff,33,0,40,7
1683340367472,COMM 131,A00,185354,Staff,19,0,30,11
1683340368496,CSE 8A,A50,185358,Cao; Yingjun,0,46,10,10
1683340369524,CSE 8B,A01,185362,Staff,1,47,50,49
1683340370556,CSE 11,A01,185416,Cao; Yingjun,0,92,10,10
1683340371581,CSE 20,A01,185445,Briones; Jor-el Thomas Caparas,5,0,25,20
1683340372606,CSE 21,A01,185447,Staff,10,0,50,40
1683340373634,CSE 101,A01,185451,Staff,0,13,50,50
1683340373634,CSE 101,B01,185453,Jones; Miles E,0,11,50,50
1683340375694,CSE 141,A01,185458,Eldon; John,20,0,100,80
1683340376723,CSE 141L,A01,185461,Eldon; John,12,0,100,88
1683340377751,CSE 142,A01,185463,Staff,36,0,60,24
1683340377751,CSE 142,B01,201355,Staff,0,7,60,60
1683340378776,CSE 142L,A01,185470,Staff,36,0,60,24
1683340378776,CSE 142L,B01,201417,Staff,0,6,60,60
1683340379804,CSE 190,A00,201433,Staff,32,0,49,17
1683340380834,DOC 1,A01,259136,Strom; Megan C.,7,0,15,8
1683340380834,DOC 1,A02,259137,Strom; Megan C.,14,0,15,1
1683340380834,DOC 1,A03,259138,Strom; Megan C.,14,0,15,1
1683340380834,DOC 1,A04,259139,Strom; Megan C.,14,0,15,1
1683340381860,DOC 100D,A00,259140,Pass; Natalye Joann,16,0,25,9
1683340382885,DSGN 1,A01,184749,Rill; Bryan,0,25,30,30
1683340383910,DSGN 100,A01,185168,Staff,0,2,25,25
1683340384939,ECE 5,A01,185626,Morris; Karcher William,0,10,0,0
1683340385968,ECE 101,A01,185628,Staff,17,0,70,53
1683340386997,ECE 107,A01,185635,Baghdadchi; Saharnaz,0,0,20,20
1683340386997,ECE 107,A02,185638,Baghdadchi; Saharnaz,4,0,20,16
1683340388021,ECE 148,A01,185647,Silberman; Jack,0,0,16,16
1683340389045,ECON 1,A01,185537,Crane; Meredith Helen,54,0,70,16
1683340390070,ECON 3,A01,185549,Crane; Meredith Helen,33,0,70,37
1683340391094,ECON 4,A01,203354,Anderson; John Charles,0,4,10,10
1683340392123,ECON 100A,A01,185574,Staff,0,4,40,40
1683340393151,ECON 100B,A01,185576,Staff,10,22,50,40
1683340394177,ECON 100C,A01,185589,Newhouse; Herbert S,30,0,70,40
1683340395206,ECON 105,A00,185608,Vespa; Emanuel Ignacio,19,0,35,16
1683340396230,ECON 109,A01,185610,Shishkin; Denis,10,0,35,25
1683340397256,ECON 110A,A01,185612,Staff,11,0,40,29
1683340398280,ECON 120A,A01,185615,Staff,20,0,40,20
1683340399307,ECON 120C,A01,185617,Sun; Yixiao,0,20,70,70
1683340400337,ECON 144,A00,203346,Squires; Dale E,3,0,35,32
1683340401361,ECON 171,A01,203349,Newhouse; Herbert S,0,1,35,35
1683340402390,ECON 173A,A01,185621,Toda; Alexis Akira,21,0,35,14
1683340403419,EDS 25,A01,202413,Staff,0,1,0,0
1683340403419,EDS 25,A02,202414,Staff,0,1,0,0
1683340403419,EDS 25,A03,202415,Staff,0,0,0,0
1683340403419,EDS 25,A04,202416,Staff,0,1,0,0
1683340403419,EDS 25,A05,202439,Staff,0,0,0,0
1683340403419,EDS 25,A06,202440,Staff,0,0,0,0
1683340403419,EDS 25,B01,202631,Staff,0,0,0,0
1683340403419,EDS 25,B02,202632,Staff,0,0,0,0
1683340403419,EDS 25,B03,202639,Staff,0,0,0,0
1683340403419,EDS 25,B04,202640,Staff,0,0,0,0
1683340403419,EDS 25,B05,202643,Staff,0,0,0,0
1683340403419,EDS 25,B06,202644,Staff,0,0,0,0
1683340404445,EDS 38,A01,202659,Black; Alison Michelle,24,0,25,1
1683340405470,EDS 115,A00,202652,Staff,18,0,30,12
1683340406498,EDS 125,A00,202649,Staff,14,0,30,16
1683340407524,EDS 126,A01,203332,Staff,30,0,30,0
1683340408550,EDS 139,A00,202838,Staff,16,0,25,9
1683340409578,EDS 146,A01,202655,Staff,14,0,25,11
1683340410664,ENG 15,A00,185667,Staff,0,1,0,0
1683340410664,ENG 15,B00,185672,Staff,0,0,0,0
1683340410664,ENG 15,C00,185675,Staff,0,0,0,0
1683340410664,ENG 15,D00,185682,Staff,0,0,0,0
1683340410664,ENG 15,E00,185684,Staff,0,0,0,0
1683340411688,ETHN 103,A00,185710,Staff,0,4,35,35
1683340412713,ETHN 103A,A00,199228,Man; Simeon S,2,0,9,7
1683340413743,ETHN 109,A00,185711,Staff,18,0,35,17
1683340414768,ETHN 142,A00,185726,Staff,0,4,30,30
1683340415793,ETHN 163J,A00,199229,Man; Simeon S,5,0,8,3
1683340416819,ETHN 168,A00,185727,Staff,8,0,10,2
1683340417847,ETHN 182,A00,185728,Staff,1,0,35,34
1683340418878,ETHN 183,A00,185737,Staff,8,0,18,10
1683340419903,GLBH 111,A01,209361,Burgos; Jose L.,0,0,0,0
1683340421954,HIEU 104,A00,185792,Staff,16,0,20,4
1683340422982,HIEU 115,A00,185800,Staff,1,0,20,19
1683340424008,HIEU 128,A00,185801,Staff,0,7,20,20
1683340425038,HIEU 147,A00,185802,Staff,16,0,20,4
1683340426065,HIEU 154,A00,185823,Staff,12,0,20,8
1683340427093,HILA 102,A00,185826,Staff,13,0,20,7
1683340428119,HILD 2C,A01,185778,Staff,0,12,20,20
1683340429146,HILD 7B,A01,185780,Kwak; Nancy,0,15,32,32
1683340429146,HILD 7B,A02,185781,Kwak; Nancy,0,18,32,32
1683340430172,HILD 30,A01,185791,Staff,14,0,20,6
1683340431198,HISC 119,A00,185830,Golan; Tal,0,9,20,20
1683340432224,HITO 156GS,A00,185831,Patterson; Patrick H.,0,0,0,23
1683340433257,HIUS 103,A00,185832,Man; Simeon S,0,6,20,20
1683340434286,HIUS 117,A00,185836,Kwak; Nancy,2,0,20,18
1683340435311,HIUS 125,A00,185840,Man; Simeon S,0,0,23,23
1683340436339,HIUS 149,A00,185845,Staff,0,0,20,20
1683340437366,HUM 3,A01,185882,Zavodny; Tatiana Sophia,0,7,50,50
1683340437366,HUM 3,B01,185899,Caldwell; Michael Alan,0,18,50,50
1683340438392,HUM 3GS,A00,185900,Patterson; Patrick H.,0,0,0,23
1683340439418,HUM 4,A01,185938,Zroka; Amy Liane,31,0,50,19
1683340439418,HUM 4,B01,185956,Watkins; Eric,0,2,50,50
1683340439418,HUM 4,B02,202209,Watkins; Eric,0,2,50,50
1683340439418,HUM 4,B03,202210,Watkins; Eric,0,2,50,50
1683340440449,HUM 5,A01,185958,West; Geoffrey Scott,3,0,50,47
1683340440449,HUM 5,A02,202215,West; Geoffrey Scott,0,0,50,50
1683340441474,INTL 190,A00,185959,Gagnon; Jeffrey C,0,0,0,9
1683340441474,INTL 190,B00,185960,Lettieri; Michael Joseph,0,0,0,1
1683340442499,JAPN 180,A00,254509,Staff,5,1,30,25
1683340443526,LATI 10,A01,202853,Kennemore; Amy Michelle,4,0,35,31
1683340443526,LATI 10,A02,202854,Kennemore; Amy Michelle,2,0,35,33
1683340443526,LATI 10,A03,270054,Kennemore; Amy Michelle,30,0,30,0
1683340444550,LATI 180,A00,202855,Kennemore; Amy Michelle,11,0,20,9
1683340445579,LAWS 101,A00,201767,Golan; Tal,0,7,40,40
1683340446606,LIFR 1C,A00,185961,Staff,6,0,20,14
1683340447634,LIFR 1CX,A00,185962,Staff,7,0,20,13
1683340448659,LIFR 1D,A00,185963,Staff,9,0,20,11
1683340449684,LIFR 1DX,A00,185964,Staff,9,0,20,11
1683340450713,LIGN 101,A01,186039,Staff,43,0,50,7
1683340451739,LIGN 165,A00,186040,Staff,18,0,50,32
1683340452768,LTCS 108,A00,186041,Staff,6,0,10,4
1683340453796,LTCS 119,A00,186042,Staff,16,0,20,4
1683340454822,LTCS 130,A00,186043,Wesling; Megan E.,15,0,25,10
1683340456879,LTEA 138,A00,186119,Staff,14,0,40,26
1683340457904,LTEN 124,A00,186148,Staff,6,0,25,19
1683340458932,LTEN 178,A00,186149,Staff,7,0,15,8
1683340459957,LTEN 181,A00,186150,Blanco; John D,33,0,40,7
1683340460986,LTWL 120,A00,186160,Staff,20,0,25,5
1683340462012,LTWL 165,A00,186161,Staff,22,0,25,3
1683340463038,LTWR 100,A00,186162,Staff,0,5,15,15
1683340464066,LTWR 102,A00,186163,Doller; Ben,5,0,15,10
1683340465092,MAE 8,A01,186412,Staff,0,0,0,0
1683340466115,MAE 30B,A00,186445,Bahadori; Mohammad Yousef,83,0,100,17
1683340467141,MAE 40,A00,186592,Bewley; Thomas R,9,0,50,41
1683340468166,MAE 101B,A00,186593,Bahadori; Mohammad Yousef,81,0,100,19
1683340469196,MAE 105,A00,186594,Bandaru; Prabhakar,12,0,50,38
1683340470219,MAE 107,A00,186599,Pham; Hieu Tan,0,6,120,120
1683340471243,MAE 148,A01,186660,Silberman; Jack,3,0,16,13
1683340472269,MATH 10A,A01,188095,Staff,1,6,35,34
1683340473300,MATH 10B,A01,188097,Bowers; Adam R.,0,11,30,30
1683340473300,MATH 10B,A02,188099,Bowers; Adam R.,0,11,30,30
1683340473300,MATH 10B,B01,188104,Bowers; Adam R.,0,10,30,30
1683340473300,MATH 10B,B02,188106,Bowers; Adam R.,0,10,30,30
1683340474323,MATH 10C,A01,188111,Staff,0,18,30,30
1683340474323,MATH 10C,A02,188127,Staff,0,17,30,30
1683340474323,MATH 10C,A03,188131,Staff,0,18,30,30
1683340474323,MATH 10C,B01,188218,Staff,18,0,30,12
1683340474323,MATH 10C,B02,188244,Staff,13,0,30,17
1683340474323,MATH 10C,B03,188277,Staff,16,0,30,14
1683340475349,MATH 18,A01,188344,Bach; Quang Tran,18,0,30,12
1683340475349,MATH 18,A02,188345,Bach; Quang Tran,11,0,30,19
1683340475349,MATH 18,B01,188353,Bach; Quang Tran,10,0,30,20
1683340475349,MATH 18,B02,188354,Bach; Quang Tran,20,0,30,10
1683340476405,MATH 20A,A01,188374,Staff,13,0,35,22
1683340477435,MATH 20B,A01,188382,Ohm; Ko Woon,6,0,30,24
1683340477435,MATH 20B,A02,188383,Ohm; Ko Woon,22,0,30,8
1683340477435,MATH 20B,B01,188385,Ohm; Ko Woon,7,0,30,23
1683340477435,MATH 20B,B02,188392,Ohm; Ko Woon,22,0,30,8
1683340478464,MATH 20C,A01,188394,Harel; Guershon,10,0,30,20
1683340478464,MATH 20C,A02,188395,Harel; Guershon,15,0,30,15
1683340478464,MATH 20C,B01,188404,Harel; Guershon,5,0,30,25
1683340478464,MATH 20C,B02,188405,Harel; Guershon,19,0,30,11
1683340479495,MATH 20D,A01,188414,Hammock; Frances H,0,1,30,30
1683340479495,MATH 20D,A02,188415,Hammock; Frances H,3,0,30,27
1683340479495,MATH 20D,B01,188447,Hammock; Frances H,1,0,30,29
1683340479495,MATH 20D,B02,188486,Hammock; Frances H,8,0,30,22
1683340480523,MATH 20E,A01,188649,Staff,21,0,30,9
1683340480523,MATH 20E,A02,188650,Staff,23,0,30,7
1683340480523,MATH 20E,A03,188673,Staff,0,0,30,30
1683340481548,MATH 102,A01,188675,Staff,0,35,35,35
1683340482574,MATH 103B,A01,188681,Staff,3,0,35,32
1683340482574,MATH 103B,B01,188692,Staff,5,0,35,30
1683340483603,MATH 109,A01,188695,Salehi Golsefidy; Alireza,25,0,35,10
1683340483603,MATH 109,A02,188696,Salehi Golsefidy; Alireza,25,0,35,10
1683340484628,MATH 120A,A01,188698,Eggers; John Dietrich,7,0,35,28
1683340485655,MATH 142B,A01,188736,Ioana; Adrian,0,2,30,30
1683340485655,MATH 142B,A02,188741,Ioana; Adrian,1,1,30,29
1683340485655,MATH 142B,A03,188743,Ioana; Adrian,1,3,30,29
1683340486683,MATH 168A,A01,188790,Staff,0,9,35,35
1683340487709,MATH 170A,A01,188803,Nie; Jiawang,0,2,35,35
1683340487709,MATH 170A,A02,188811,Nie; Jiawang,0,0,35,35
1683340487709,MATH 170A,A03,188814,Nie; Jiawang,1,0,35,34
1683340487709,MATH 170A,A04,188815,Nie; Jiawang,13,0,35,22
1683340488734,MATH 193B,A01,188817,Staff,0,0,35,35
1683340488734,MATH 193B,A02,188818,Staff,5,0,35,30
1683340489762,MGT 4,A01,202857,Anderson; John Charles,62,0,80,18
1683340490789,MGT 12,A00,202858,Lindenberger; Wade Douglas,42,0,90,48
1683340491817,MGT 18,A00,202859,Staff,74,0,90,16
1683340492845,MGT 18GS,A00,202860,McKay; Michael J,13,0,28,15
1683340493871,MGT 45,A00,202861,Pecore; Joseph P.,14,0,90,76
1683340494896,MGT 100,A00,202863,Yavorsky; Daniel Ryan,28,0,90,62
1683340495922,MGT 103,A00,202864,Ehrich; Kristine R,1,18,90,89
1683340496951,MGT 112,A00,202865,Ehrich; Kristine R,15,0,90,75
1683340497976,MGT 121A,A00,202868,Staff,0,20,0,0
1683340499005,MGT 131B,A00,202869,Anderson; John Charles,59,0,90,31
1683340500034,MGT 136,A00,202871,Lindenberger; Wade Douglas,84,0,90,6
1683340501059,MGT 164,A00,202873,Staff,0,68,90,91
1683340502084,MGT 164GS,A00,202874,McKay; Mary A,13,0,28,15
1683340503109,MGT 180,A00,202875,Staff,0,50,90,91
1683340504134,MMW 11R,A01,205019,Herbst; Matthew,3,0,30,27
1683340504134,MMW 11R,A02,205026,Herbst; Matthew,29,0,30,1
1683340505162,MMW 15,A01,193512,Chang; Edmond Yi-Teh,0,9,28,28
1683340505162,MMW 15,A02,193513,Chang; Edmond Yi-Teh,0,5,28,28
1683340505162,MMW 15,A03,193514,Chang; Edmond Yi-Teh,0,5,28,28
1683340505162,MMW 15,A04,193515,Chang; Edmond Yi-Teh,0,5,28,28
1683340505162,MMW 15,A05,193516,Chang; Edmond Yi-Teh,0,4,28,28
1683340505162,MMW 15,A06,193517,Chang; Edmond Yi-Teh,0,5,28,28
1683340505162,MMW 15,B01,193519,Chang; Edmond Yi-Teh,0,5,28,28
1683340505162,MMW 15,B02,193520,Chang; Edmond Yi-Teh,0,5,28,28
1683340505162,MMW 15,B03,193521,Chang; Edmond Yi-Teh,0,5,28,28
1683340505162,MMW 15,B04,193522,Chang; Edmond Yi-Teh,0,4,28,28
1683340505162,MMW 15,B05,193523,Chang; Edmond Yi-Teh,0,5,28,28
1683340505162,MMW 15,B06,193524,Chang; Edmond Yi-Teh,0,4,28,28
1683340506187,MMW 122,A01,193526,Rahimi; Babak,0,15,28,28
1683340506187,MMW 122,A02,193527,Rahimi; Babak,0,14,28,28
1683340506187,MMW 122,A03,193528,Rahimi; Babak,0,0,0,0
1683340506187,MMW 122,A04,193529,Rahimi; Babak,0,0,0,0
1683340507214,MUS 1A,A01,186663,Staff,0,20,35,35
1683340508241,MUS 4,A01,186715,Staff,0,12,35,35
1683340509270,MUS 5R,A01,186796,Dubnov; Shlomo,0,17,35,35
1683340510299,MUS 6,A01,186798,Staff,0,4,25,25
1683340511327,MUS 7,A01,186830,Staff,13,0,35,22
1683340512351,MUS 8,A01,186930,Staff,0,26,35,35
1683340513378,MUS 15,A01,186932,Staff,0,16,35,35
1683340513378,MUS 15,B01,186934,Staff,0,15,35,35
1683340514462,MUS 80,A00,186935,Staff,1,0,20,19
1683340514462,MUS 80,B00,186936,Staff,25,0,25,0
1683340515487,NANO 11,A00,204702,Lipomi; Darren John,0,0,0,0
1683340516516,NANO 15,A01,204709,Yang; Kesong,0,1,0,0
1683340517544,NANO 114,A00,202069,Jahed Motlagh; Zeinab,3,0,10,7
1683340518570,PHIL 1,A00,186955,Grush; Rick Scott,32,0,40,8
1683340519595,PHIL 10,A01,186973,Grush; Rick Scott,28,0,35,7
1683340519595,PHIL 10,A02,186974,Grush; Rick Scott,33,0,35,2
1683340520622,PHIL 13,A01,186976,Staff,7,0,35,28
1683340520622,PHIL 13,A02,186977,Staff,16,0,35,19
1683340521650,PHIL 14,A01,186979,Staff,31,0,35,4
1683340521650,PHIL 14,A02,186986,Staff,32,0,35,3
1683340522677,PHIL 28,A01,186988,Staff,16,0,30,14
1683340522677,PHIL 28,A02,186989,Staff,1,0,30,29
1683340522677,PHIL 28,A03,186990,Staff,9,0,30,21
1683340522677,PHIL 28,A04,186991,Staff,26,0,30,4
1683340523701,PHIL 120,A00,186997,Staff,23,0,40,17
1683340524728,PHIL 137,A00,187003,Staff,9,0,40,31
1683340525750,PHIL 150,A00,187015,Staff,47,0,70,23
1683340526776,PHIL 167,A00,187021,Lamey; Andy M.,35,0,40,5
1683340527801,PHIL 174,A01,202226,Staff,17,0,20,3
1683340527801,PHIL 174,A02,202235,Staff,20,0,20,0
1683340528827,PHIL 191A,A00,258918,Staff,0,0,1,1
1683340529856,PHYS 1A,A00,187028,Staff,27,0,60,33
1683340530882,PHYS 1AL,001,187036,Staff,2,0,30,28
1683340530882,PHYS 1AL,002,187049,Staff,18,0,30,12
1683340531907,PHYS 1B,A00,187058,Staff,22,0,60,38
1683340532934,PHYS 1BL,001,187064,Staff,0,0,30,30
1683340532934,PHYS 1BL,002,187070,Staff,5,0,30,25
1683340533959,PHYS 1C,A00,187082,Staff,31,0,120,89
1683340534985,PHYS 1CL,001,187088,Staff,0,9,30,30
1683340534985,PHYS 1CL,002,187089,Staff,0,2,30,30
1683340534985,PHYS 1CL,009,262693,Staff,11,0,30,19
1683340536011,PHYS 2B,A01,187097,Staff,54,0,115,61
1683340537036,PHYS 2C,A01,187099,Staff,67,0,115,48
1683340538063,PHYS 2CL,A01,187101,Staff,5,0,28,23
1683340538063,PHYS 2CL,A02,187102,Staff,15,0,28,13
1683340539087,PHYS 2D,A01,187123,Shotwell; Brian,95,0,115,20
1683340540111,PHYS 4B,A01,187133,Grinstein; Benjamin,35,0,50,15
1683340541134,POLI 10,A00,188819,Staff,0,4,50,50
1683340542158,POLI 11,A00,188827,Staff,43,0,50,7
1683340543183,POLI 13R,A00,188828,Staff,0,1,20,20
1683340544207,POLI 27,A01,188830,Elgin; Samuel Zincke,0,1,70,70
1683340545234,POLI 30,A00,188832,Desposato; Scott,31,0,50,19
1683340546263,POLI 102F,A00,188834,Staff,3,0,40,37
1683340547290,POLI 104A,A00,188852,Staff,14,0,30,16
1683340548317,POLI 104I,A00,188853,Staff,0,6,20,20
1683340549341,POLI 110B,A00,188854,Wiens; David,7,0,20,13
1683340550366,POLI 112A,A00,188855,Wiens; David,5,0,30,25
1683340551394,POLI 117R,A00,188856,Forman; Fonna,0,11,20,20
1683340552419,POLI 118,A00,188857,Ingham; Sean,8,0,20,12
1683340553447,POLI 120G,A00,188858,Staff,9,0,30,21
1683340554474,POLI 131CR,A00,188863,Hoston; Germaine,24,0,50,26
1683340555502,POLI 133,A00,188864,Nellis; Gareth Hb,44,0,50,6
1683340556530,POLI 134D,A00,188865,Desposato; Scott,27,0,30,3
1683340557558,POLI 142A,A00,188871,Gartzke; Erik,22,0,50,28
1683340558584,POLI 142K,A00,188874,Staff,38,0,50,12
1683340559612,POLI 143,A00,188940,Gartzke; Erik,16,0,30,14
1683340560636,POLI 153,A00,188943,Staff,3,0,20,17
1683340561661,POLI 160AA,A00,188944,Staff,12,0,40,28
1683340562686,POLI 170A,A00,188945,Staff,11,0,30,19
1683340564746,PSYC 1,A00,188952,Staff,37,0,90,53
1683340565771,PSYC 2,B00,188953,Staff,19,0,35,16
1683340566797,PSYC 6,A00,188970,Staff,47,0,60,13
1683340567823,PSYC 7,A00,188973,Staff,37,0,45,8
1683340568848,PSYC 60,A01,188980,Rickard; Timothy C.,43,0,60,17
1683340569873,PSYC 70,A01,189001,Steiner; Eric Tomas,23,0,45,22
1683340570898,PSYC 100,A00,189005,Lacefield; Katharine I,0,98,120,120
1683340571924,PSYC 102,A00,189008,Staff,9,0,30,21
1683340572948,PSYC 106,B00,189026,Gorman; Michael R.,34,0,60,26
1683340573976,PSYC 114,B01,189033,Winkielman; Piotr,0,32,30,30
1683340575002,PSYC 131,A00,189036,Anagnostaras; Stephan,0,43,60,60
1683340576028,PSYC 136,A00,189041,Lowe; Angela Beth,0,7,25,25
1683340577055,PSYC 137,A00,189057,Winkielman; Piotr,0,34,25,25
1683340578082,PSYC 144,A00,189107,Wixted; John T,0,7,50,50
1683340580134,PSYC 162,A00,189142,Staff,0,8,85,85
1683340581158,PSYC 172,A00,189144,Gorman; Michael R.,0,7,30,30
1683340583207,PSYC 179,A00,189146,Lacefield; Katharine I,0,84,120,120
1683340584231,PSYC 181,A00,189147,Anagnostaras; Stephan,0,44,90,90
1683340585255,PSYC 190R,A00,189148,Barner; David A.,0,22,80,80
1683340586282,PSYC 191,A00,189275,Rickard; Timothy C.,0,7,25,25
1683340587309,PSYC 193,A00,189276,Chapman; Eddie Nathaniel,0,1,0,4
1683340588331,PSYC 193L,A01,189281,Lowe; Angela Beth,12,0,20,8
1683340588331,PSYC 193L,B01,189285,Staff,28,0,35,7
1683340589355,RELI 149,A00,187137,Rahimi; Babak,7,0,40,33
1683340590383,SE 9,A01,187315,Staff,0,2,18,18
1683340591406,SE 101B,A00,187409,Staff,24,0,30,6
1683340592434,SE 110B,A00,187444,Staff,10,0,40,30
1683340593459,SE 130B,A00,187449,Staff,31,0,40,9
1683340594487,SE 150A,A00,187516,Staff,9,0,20,11
1683340595515,SE 154,A00,187528,Staff,30,0,50,20
1683340596542,SIO 3,A01,258171,Staff,35,0,40,5
1683340597569,SIO 10,A00,187144,Cook; Geoffrey W,0,3,75,75
1683340598595,SIO 45,A00,187152,Cook; Geoffrey W,1,0,100,99
1683340599624,SIO 109R,A00,194486,Staff,0,3,20,20
1683340601676,SIO 187,A01,187233,Kacev; David,12,0,40,28
1683340602705,SOCI 1,A01,258656,Thorpe; Charles Robert,28,0,30,2
1683340602705,SOCI 1,A02,258658,Thorpe; Charles Robert,30,0,30,0
1683340602705,SOCI 1,A03,258661,Thorpe; Charles Robert,25,0,25,0
1683340602705,SOCI 1,A04,258666,Thorpe; Charles Robert,22,0,25,3
1683340602705,SOCI 1,A05,258897,Thorpe; Charles Robert,23,0,25,2
1683340602705,SOCI 1,A06,258898,Thorpe; Charles Robert,25,0,25,0
1683340603734,SOCI 30,A01,258903,Pardo Guerra; Juan Pablo,15,0,30,15
1683340604761,SOCI 102,A00,258904,Staff,9,0,25,16
1683340605788,SOCI 106,A00,258905,Staff,19,0,25,6
1683340606815,SOCI 111,A00,258907,Ribas Norris; Janet Vanesa,26,0,30,4
1683340607842,SOCI 121R,A00,258908,Pardo Guerra; Juan Pablo,10,0,30,20
1683340608870,SOCI 126,A01,203330,Staff,14,0,20,6
1683340609899,SOCI 131,A00,258909,Thorpe; Charles Robert,31,0,60,29
1683340610927,SOCI 135,A00,258910,Payne; Christine Anna,0,9,30,30
1683340611952,SOCI 157,A00,258911,Staff,12,0,30,18
1683340612980,SOCI 184,A00,258912,Staff,25,0,30,5
1683340614007,SOCI 188D,A00,258913,Staff,21,0,30,9
1683340615032,SYN 2,001,187529,Staff,10,0,16,6
1683340615032,SYN 2,002,201452,Staff,0,18,16,16
1683340615032,SYN 2,003,201469,Staff,3,0,16,13
1683340616058,SYN 100,A01,187531,Staff,0,9,20,20
1683340616058,SYN 100,B01,201491,Staff,0,12,20,20
1683340617086,TDAC 1,A00,189286,Walsh; Kim C.,3,0,20,17
1683340617086,TDAC 1,B00,189287,Harting; Carla Kelso,11,0,20,9
1683340618164,TDAC 101,A00,189300,Walsh; Kim C.,16,0,20,4
1683340618164,TDAC 101,B00,189301,Harting; Carla Kelso,18,0,20,2
1683340619187,TDAC 102,A00,189304,Basso; Beatrice,14,0,20,6
1683340620214,TDAC 108,A00,189305,Staff,18,0,20,2
1683340621241,TDDE 131,A00,189310,Staff,19,0,20,1
1683340621241,TDDE 131,B00,189314,Staff,19,0,20,1
1683340621241,TDDE 131,C00,189315,Staff,48,0,50,2
1683340621241,TDDE 131,D00,189316,Staff,14,0,15,1
1683340621241,TDDE 131,E00,204841,Staff,20,0,20,0
1683340622273,TDGE 10,A00,189289,Staff,30,0,50,20
1683340622273,TDGE 10,B00,189290,Havis; Allan,1,0,50,49
1683340623299,TDGE 11,A00,189291,Fulton; Julia,0,3,50,50
1683340623299,TDGE 11,B00,189292,Staff,20,0,25,5
1683340623299,TDGE 11,C00,260270,Staff,0,0,0,0
1683340624326,TDGE 25,A00,189294,Staff,3,0,20,17
1683340625354,TDGE 124,A00,189318,Fulton; Julia,0,8,50,50
1683340626380,TDGE 125,A00,189319,Staff,13,0,25,12
1683340626380,TDGE 125,B00,189320,Staff,23,0,25,2
1683340627402,TDGE 127,A00,189322,Havis; Allan,0,0,50,50
1683340628427,TDHT 101,A00,189323,Staff,18,0,25,7
1683340628427,TDHT 101,B00,189324,Staff,25,0,25,0
1683340629455,TDHT 102,A00,189325,Staff,49,0,50,1
1683340630487,TDMV 1,A00,189295,Arcidiacono; Kristin,19,0,30,11
1683340630487,TDMV 1,B00,189296,Caligagan; Maria T.,24,0,30,6
1683340631513,TDMV 2,A00,189297,Sammartano; Tonnie,28,0,30,2
1683340631513,TDMV 2,B00,189299,Arcidiacono; Kristin,24,0,30,6
1683340632542,TDMV 3,A00,204998,Rincon; Alicia,22,0,30,8
1683340633568,TDMV 120,A00,189458,Sammartano; Tonnie,28,0,30,2
1683340634593,TDMV 138,A00,189541,Jun; Grace Shin Hae,22,0,40,18
1683340635621,TDMV 142,A00,189717,Caligagan; Tony,23,0,30,7
1683340635621,TDMV 142,B00,189718,Caligagan; Maria T.,25,0,30,5
1683340636650,TMC 2,A01,187533,Staff,25,0,25,0
1683340636650,TMC 2,A02,187534,Staff,25,0,25,0
1683340637677,USP 1,A01,187536,Kwak; Nancy,0,16,25,25
1683340638705,USP 5,A01,187538,Staff,10,0,25,15
1683340639735,USP 101,A00,199253,Staff,0,4,0,0
1683340640761,USP 124,A00,187562,Boomhower; Matthew Charles,1,0,30,29
1683340641785,USP 138,A00,187582,Staff,20,0,25,5
1683340642813,USP 152,A01,187597,Staff,4,0,25,21
1683340643838,USP 153,A00,187598,Staff,19,0,25,6
1683340644864,USP 168,A00,187607,Kwak; Nancy,2,0,5,3
1683340645891,USP 173,A00,187619,Staff,4,0,25,21
1683340646916,USP 181,A00,187638,Staff,0,0,25,25
1683340647944,VIS 103,A00,187650,Cruz; Edwin Teddy,23,0,75,52
1683340648971,VIS 110D,A00,187669,Staff,12,0,22,10
1683340649996,VIS 127C,A00,187720,Shen; Kuiyi,67,0,146,79
1683340651024,VIS 149,A00,187731,Yoldas; Pinar,0,14,22,22
1683340652048,VIS 151,A01,188091,Staff,22,0,34,12
1683340652048,VIS 151,A02,188092,Staff,11,0,34,23
1683340653076,VIS 160B,A00,188093,Stalbaum; Brett,0,0,10,10
1683340655134,WCWP 10B,A00,201720,Staff,10,0,15,5
1683340655134,WCWP 10B,B00,201722,Staff,9,0,15,6
1683340656158,WCWP 100,A00,201725,Gagnon; Jeffrey C,0,0,2,2
1683340656158,WCWP 100,B00,201727,Staff,0,4,15,15
1683340659267,ANBI 133,A00,258401,Wilder; Linnea Lorene,34,0,40,6
1683340660294,ANBI 140,A00,258395,Hrvoj Mihic; Branka,18,0,25,7
1683340661321,ANSC 120,A00,258402,Bialecki; Jon Anthony,27,0,40,13
1683340662346,ANSC 144,A00,258400,Staff,14,0,40,26
1683340664405,ANSC 166,A00,258396,Parish; Steven Martin,157,0,175,18
1683340665431,ANSC 180,A00,193533,Staff,9,0,20,11
1683340666459,ANSC 188,A00,258397,Jassal; Aftab,33,0,40,7
1683340667484,ANTH 3,A01,258316,Staff,23,0,30,7
1683340668513,ANTH 5,A00,258394,Semendeferi; Ekaterini,16,0,20,4
1683340669538,ANTH 21,A01,258331,Staff,8,0,40,32
1683340670563,ANTH 103,A00,258398,Varma; Saiba,15,0,25,10
1683340671590,AWP 10,001,202034,Staff,0,0,0,0
1683340671590,AWP 10,002,202035,Staff,0,0,0,0
1683340671590,AWP 10,003,202036,Staff,0,0,0,0
1683340671590,AWP 10,004,202037,Staff,0,0,0,0
1683340671590,AWP 10,005,202038,Staff,0,0,0,0
1683340671590,AWP 10,006,202039,Staff,0,0,0,0
1683340671590,AWP 10,007,202040,Staff,0,0,0,0
1683340671590,AWP 10,008,202041,Staff,0,0,0,0
1683340671590,AWP 10,009,202042,Staff,0,0,0,0
1683340671590,AWP 10,010,202043,Staff,0,0,0,0
1683340671590,AWP 10,011,202044,Staff,0,0,0,0
1683340671590,AWP 10,012,202045,Staff,0,0,0,0
1683340671590,AWP 10,013,202046,Staff,0,0,0,0
1683340671590,AWP 10,014,202047,Staff,0,0,0,0
1683340671590,AWP 10,015,202048,Staff,0,0,0,0
1683340671590,AWP 10,016,202049,Staff,0,0,0,0
1683340671590,AWP 10,017,202050,Staff,0,0,0,0
1683340671590,AWP 10,018,202051,Staff,0,0,0,0
1683340671590,AWP 10,019,202052,Staff,0,0,0,0
1683340671590,AWP 10,020,202053,Staff,0,0,0,0
1683340671590,AWP 10,021,202054,Staff,0,0,0,0
1683340671590,AWP 10,022,202055,Staff,0,0,0,0
1683340671590,AWP 10,023,202056,Staff,0,0,0,0
1683340671590,AWP 10,024,202057,Staff,0,0,0,0
1683340671590,AWP 10,025,202058,Staff,0,0,0,0
1683340671590,AWP 10,026,202059,Staff,0,0,0,0
1683340672617,AWP 102,001,202032,Staff,0,0,0,0
1683340672617,AWP 102,002,202033,Staff,0,0,0,0
1683340673645,BENG 100,A01,254234,Taylor Amos; Alyssa C,31,0,40,9
1683340674668,BENG 196,001,270013,Engler; Adam J.,9999,0,9999,0
1683340675698,BICD 100R,A01,202018,Smith; Laurie,0,7,32,32
1683340675698,BICD 100R,A02,202019,Smith; Laurie,0,2,32,32
1683340675698,BICD 100R,A03,202020,Smith; Laurie,0,1,32,32
1683340675698,BICD 100R,A04,202021,Smith; Laurie,9,0,32,23
1683340675698,BICD 100R,A05,202022,Smith; Laurie,12,0,32,20
1683340676726,BICD 136,A01,193242,Gustafson-Brown; Cindy,0,2,32,32
1683340676726,BICD 136,A02,193244,Gustafson-Brown; Cindy,14,0,32,18
1683340677751,BIEB 102,A01,193249,Butler; Shannon Rhey,0,2,32,32
1683340677751,BIEB 102,A02,193251,Butler; Shannon Rhey,0,0,32,32
1683340677751,BIEB 102,A03,193253,Butler; Shannon Rhey,0,1,32,32
1683340677751,BIEB 102,A04,193255,Butler; Shannon Rhey,17,0,32,15
1683340677751,BIEB 102,A05,193265,Butler; Shannon Rhey,26,0,32,6
1683340677751,BIEB 102,A06,193269,Butler; Shannon Rhey,16,0,32,16
1683340679799,BIEB 150,A01,193274,Staff,0,0,32,32
1683340679799,BIEB 150,A02,193285,Staff,23,0,32,9
1683340680824,BIEB 194,A00,193286,Kurle; Carolyn M.,22,0,32,10
1683340681854,BILD 1,A01,192291,Staff,16,0,32,16
1683340681854,BILD 1,A02,192292,Staff,30,0,32,2
1683340681854,BILD 1,B01,192520,Reuther; Keefe,0,1,0,0
1683340681854,BILD 1,B02,192532,Reuther; Keefe,0,1,0,0
1683340682885,BILD 3,A01,192556,Butler; Shannon Rhey,0,0,32,32
1683340682885,BILD 3,A02,192581,Butler; Shannon Rhey,5,0,32,27
1683340682885,BILD 3,A03,192611,Butler; Shannon Rhey,23,0,32,9
1683340682885,BILD 3,A04,192612,Butler; Shannon Rhey,25,0,32,7
1683340682885,BILD 3,A05,192613,Butler; Shannon Rhey,27,0,32,5
1683340682885,BILD 3,A06,192679,Butler; Shannon Rhey,27,0,32,5
1683340682885,BILD 3,A07,192682,Butler; Shannon Rhey,22,0,32,10
1683340683916,BILD 4,A01,192836,Reuther; Keefe,0,0,24,24
1683340683916,BILD 4,A02,193044,Reuther; Keefe,4,0,24,20
1683340684944,BILD 10,A01,193142,Gustafson-Brown; Cindy,30,0,32,2
1683340684944,BILD 10,A02,193149,Gustafson-Brown; Cindy,31,0,32,1
1683340685970,BIMM 100,A01,193301,Staff,0,6,32,32
1683340685970,BIMM 100,A02,193312,Staff,0,5,32,32
1683340685970,BIMM 100,A03,193323,Staff,0,8,32,32
1683340687001,BIMM 101,A01,193329,McDonnell; Lisa Marie,0,3,24,24
1683340687001,BIMM 101,A02,193339,McDonnell; Lisa Marie,0,3,24,24
1683340687001,BIMM 101,B01,193354,McDonnell; Lisa Marie,0,3,24,24
1683340687001,BIMM 101,B02,193357,McDonnell; Lisa Marie,0,3,24,24
1683340688028,BIMM 110,A01,193377,Tat; John,0,11,32,32
1683340688028,BIMM 110,A02,193378,Tat; John,1,9,32,31
1683340689054,BIMM 120,A01,206116,Staff,0,0,32,32
1683340689054,BIMM 120,A02,206117,Staff,8,0,32,24
1683340689054,BIMM 120,A03,206121,Staff,21,0,32,11
1683340690085,BIPN 100,A01,193393,Park; Ji Young,0,14,32,32
1683340690085,BIPN 100,A02,193402,Park; Ji Young,0,13,32,32
1683340690085,BIPN 100,A03,193413,Park; Ji Young,0,14,32,32
1683340690085,BIPN 100,A04,193414,Park; Ji Young,0,13,32,32
1683340691116,BIPN 102,A01,193429,Staff,0,0,32,32
1683340691116,BIPN 102,A02,193438,Staff,22,0,32,10
1683340692147,BIPN 106,A01,193450,Reyes Gonzalez; Catalina,0,2,40,40
1683340693174,BIPN 134,A01,193465,Cooke; James Edward,0,0,32,32
1683340693174,BIPN 134,A02,193474,Cooke; James Edward,25,0,32,7
1683340693174,BIPN 134,A03,193485,Cooke; James Edward,29,0,32,3
1683340693174,BIPN 134,A04,193486,Cooke; James Edward,21,0,32,11
1683340693174,BIPN 134,A05,193491,Cooke; James Edward,31,0,32,1
1683340693174,BIPN 134,A06,193501,Cooke; James Edward,30,0,32,2
1683340693174,BIPN 134,A07,193510,Cooke; James Edward,29,0,32,3
1683340695227,BISP 194,A00,222522,Staff,14,0,32,18
1683340696251,CAT 124,A01,202407,Staff,20,0,25,5
1683340697274,CAT 125,A00,202408,Marchisotto; Jennifer Anne,4,0,20,16
1683340698303,CAT 125R,A00,202409,Smith; Lauryn Alissa,0,11,20,20
1683340698303,CAT 125R,B00,202410,Morales; Celeste Georgianna,0,11,20,20
1683340698303,CAT 125R,C00,202411,Irwin; Matthew Joseph,0,10,20,20
1683340699327,CENG 15,A01,204712,Yang; Kesong,0,1,0,0
1683340700353,CENG 114,A00,202070,Jahed Motlagh; Zeinab,5,0,20,15
1683340701378,CGS 105,A00,185477,Wesling; Megan E.,24,0,40,16
1683340702403,CGS 106,A00,185494,Staff,13,0,22,9
1683340703426,CGS 108,A00,185495,Staff,14,0,20,6
1683340704451,CGS 114,A00,185496,Staff,13,0,18,5
1683340705476,CGS 119,A00,185501,Staff,15,0,20,5
1683340706504,CGS 120,A00,185511,Staff,13,0,20,7
1683340707533,CHEM 4,A01,184675,Bussey; Thomas J,96,0,100,4
1683340708561,CHEM 6A,A01,184677,Staff,34,0,60,26
1683340709586,CHEM 6B,A01,184679,Staff,65,0,100,35
1683340710612,CHEM 6C,A01,184681,Bussey; Thomas J,1,0,50,49
1683340710612,CHEM 6C,A02,184682,Bussey; Thomas J,34,0,50,16
1683340711637,CHEM 40A,A01,184684,Albizati; Kim F.,37,0,100,63
1683340712663,CHEM 40B,A01,184686,Albizati; Kim F.,0,20,100,100
1683340713690,CHEM 41B,A01,184690,Staff,52,0,100,48
1683340714716,COGS 3,A01,184715,Boyle; Mary E. T.,0,25,40,40
1683340715740,COGS 14B,A01,185172,Staff,0,15,38,38
1683340716765,COGS 18,A01,184736,Staff,17,0,80,63
1683340717791,COGS 100,A01,184932,Staff,0,5,73,73
1683340718822,COGS 101A,A01,184935,Staff,0,39,30,30
1683340719847,COGS 101B,A01,184944,Staff,0,2,30,30
1683340720872,COGS 101C,A01,184946,Staff,0,12,30,30
1683340721950,COGS 102A,A01,184951,Johnson; Christine M.,2,0,40,38
1683340722975,COGS 107B,A01,184953,Mooshagian; Eric Frederick,0,50,40,40
1683340723999,COGS 118B,A01,184959,Gupta; Anjum,0,48,40,40
1683340725027,COGS 153,A00,184961,Staff,0,15,30,30
1683340726052,COGS 177,A00,184962,Staff,0,20,30,30
1683340727082,COGS 187A,A01,184969,Boyle; Mary E. T.,0,17,40,40
1683340728106,COMM 10,A01,185174,Staff,0,5,25,25
1683340728106,COMM 10,A02,185189,Staff,0,5,25,25
1683340728106,COMM 10,A03,269821,Staff,0,0,0,0
1683340729132,COMM 100B,A01,185475,Staff,0,0,0,2
1683340729132,COMM 100B,A02,185476,Staff,13,0,25,12
1683340730160,COMM 100C,A01,185314,Staff,1,0,25,24
1683340730160,COMM 100C,A02,185327,Staff,19,0,25,6
1683340731188,COMM 110M,A00,185349,Staff,2,0,40,38
1683340732214,COMM 113T,A00,185352,Staff,24,0,40,16
1683340733242,COMM 114I,A00,185353,Staff,33,0,40,7
1683340734269,COMM 131,A00,185354,Staff,19,0,30,11
1683340735298,CSE 8A,A50,185358,Cao; Yingjun,0,46,10,10
1683340736327,CSE 8B,A01,185362,Staff,1,47,50,49
1683340737353,CSE 11,A01,185416,Cao; Yingjun,0,92,10,10
1683340738377,CSE 20,A01,185445,Briones; Jor-el Thomas Caparas,5,0,25,20
1683340739403,CSE 21,A01,185447,Staff,10,0,50,40
1683340740433,CSE 101,A01,185451,Staff,0,13,50,50
1683340740433,CSE 101,B01,185453,Jones; Miles E,0,11,50,50
1683340742484,CSE 141,A01,185458,Eldon; John,20,0,100,80
1683340743512,CSE 141L,A01,185461,Eldon; John,12,0,100,88
1683340744544,CSE 142,A01,185463,Staff,36,0,60,24
1683340744544,CSE 142,B01,201355,Staff,0,7,60,60
1683340745566,CSE 142L,A01,185470,Staff,36,0,60,24
1683340745566,CSE 142L,B01,201417,Staff,0,6,60,60
1683340746594,CSE 190,A00,201433,Staff,32,0,49,17
1683340747618,DOC 1,A01,259136,Strom; Megan C.,7,0,15,8
1683340747618,DOC 1,A02,259137,Strom; Megan C.,14,0,15,1
1683340747618,DOC 1,A03,259138,Strom; Megan C.,14,0,15,1
1683340747618,DOC 1,A04,259139,Strom; Megan C.,14,0,15,1
1683340748645,DOC 100D,A00,259140,Pass; Natalye Joann,16,0,25,9
1683340749673,DSGN 1,A01,184749,Rill; Bryan,0,25,30,30
1683340750698,DSGN 100,A01,185168,Staff,0,2,25,25
1683340751724,ECE 5,A01,185626,Morris; Karcher William,0,10,0,0
1683340752749,ECE 101,A01,185628,Staff,17,0,70,53
1683340753773,ECE 107,A01,185635,Baghdadchi; Saharnaz,0,0,20,20
1683340753773,ECE 107,A02,185638,Baghdadchi; Saharnaz,4,0,20,16
1683340754801,ECE 148,A01,185647,Silberman; Jack,0,0,16,16
1683340755828,ECON 1,A01,185537,Crane; Meredith Helen,54,0,70,16
1683340756852,ECON 3,A01,185549,Crane; Meredith Helen,32,0,70,38
1683340757877,ECON 4,A01,203354,Anderson; John Charles,0,4,10,10
1683340758902,ECON 100A,A01,185574,Staff,0,4,40,40
1683340759928,ECON 100B,A01,185576,Staff,10,22,50,40
1683340760954,ECON 100C,A01,185589,Newhouse; Herbert S,30,0,70,40
1683340761982,ECON 105,A00,185608,Vespa; Emanuel Ignacio,19,0,35,16
1683340763007,ECON 109,A01,185610,Shishkin; Denis,10,0,35,25
1683340764034,ECON 110A,A01,185612,Staff,11,0,40,29
1683340765062,ECON 120A,A01,185615,Staff,20,0,40,20
1683340766088,ECON 120C,A01,185617,Sun; Yixiao,0,20,70,70
1683340767115,ECON 144,A00,203346,Squires; Dale E,3,0,35,32
1683340768142,ECON 171,A01,203349,Newhouse; Herbert S,0,1,35,35
1683340769165,ECON 173A,A01,185621,Toda; Alexis Akira,21,0,35,14
1683340770191,EDS 25,A01,202413,Staff,0,1,0,0
1683340770191,EDS 25,A02,202414,Staff,0,1,0,0
1683340770191,EDS 25,A03,202415,Staff,0,0,0,0
1683340770191,EDS 25,A04,202416,Staff,0,1,0,0
1683340770191,EDS 25,A05,202439,Staff,0,0,0,0
1683340770191,EDS 25,A06,202440,Staff,0,0,0,0
1683340770191,EDS 25,B01,202631,Staff,0,0,0,0
1683340770191,EDS 25,B02,202632,Staff,0,0,0,0
1683340770191,EDS 25,B03,202639,Staff,0,0,0,0
1683340770191,EDS 25,B04,202640,Staff,0,0,0,0
1683340770191,EDS 25,B05,202643,Staff,0,0,0,0
1683340770191,EDS 25,B06,202644,Staff,0,0,0,0
1683340771215,EDS 38,A01,202659,Black; Alison Michelle,24,0,25,1
1683340772240,EDS 115,A00,202652,Staff,18,0,30,12
1683340773264,EDS 125,A00,202649,Staff,14,0,30,16
1683340774287,EDS 126,A01,203332,Staff,30,0,30,0
1683340775312,EDS 139,A00,202838,Staff,16,0,25,9
1683340776335,EDS 146,A01,202655,Staff,14,0,25,11
1683340777360,ENG 15,A00,185667,Staff,0,1,0,0
1683340777360,ENG 15,B00,185672,Staff,0,0,0,0
1683340777360,ENG 15,C00,185675,Staff,0,0,0,0
1683340777360,ENG 15,D00,185682,Staff,0,0,0,0
1683340777360,ENG 15,E00,185684,Staff,0,0,0,0
1683340778389,ETHN 103,A00,185710,Staff,0,4,35,35
1683340779414,ETHN 103A,A00,199228,Man; Simeon S,2,0,9,7
1683340780442,ETHN 109,A00,185711,Staff,18,0,35,17
1683340781470,ETHN 142,A00,185726,Staff,0,4,30,30
1683340782494,ETHN 163J,A00,199229,Man; Simeon S,5,0,8,3
1683340783519,ETHN 168,A00,185727,Staff,8,0,10,2
1683340784544,ETHN 182,A00,185728,Staff,1,0,35,34
1683340785568,ETHN 183,A00,185737,Staff,8,0,18,10
1683340786592,GLBH 111,A01,209361,Burgos; Jose L.,0,0,0,0
1683340788641,HIEU 104,A00,185792,Staff,16,0,20,4
1683340789666,HIEU 115,A00,185800,Staff,1,0,20,19
1683340790689,HIEU 128,A00,185801,Staff,0,7,20,20
1683340791714,HIEU 147,A00,185802,Staff,16,0,20,4
1683340792739,HIEU 154,A00,185823,Staff,12,0,20,8
1683340793763,HILA 102,A00,185826,Staff,13,0,20,7
1683340794788,HILD 2C,A01,185778,Staff,0,12,20,20
1683340795812,HILD 7B,A01,185780,Kwak; Nancy,0,15,32,32
1683340795812,HILD 7B,A02,185781,Kwak; Nancy,0,18,32,32
1683340796836,HILD 30,A01,185791,Staff,14,0,20,6
1683340797860,HISC 119,A00,185830,Golan; Tal,0,9,20,20
1683340798886,HITO 156GS,A00,185831,Patterson; Patrick H.,0,0,0,23
1683340799912,HIUS 103,A00,185832,Man; Simeon S,0,6,20,20
1683340800940,HIUS 117,A00,185836,Kwak; Nancy,2,0,20,18
1683340801968,HIUS 125,A00,185840,Man; Simeon S,0,0,23,23
1683340802995,HIUS 149,A00,185845,Staff,0,0,20,20
1683340804021,HUM 3,A01,185882,Zavodny; Tatiana Sophia,0,7,50,50
1683340804021,HUM 3,B01,185899,Caldwell; Michael Alan,0,18,50,50
1683340805046,HUM 3GS,A00,185900,Patterson; Patrick H.,0,0,0,23
1683340806077,HUM 4,A01,185938,Zroka; Amy Liane,31,0,50,19
1683340806077,HUM 4,B01,185956,Watkins; Eric,0,2,50,50
1683340806077,HUM 4,B02,202209,Watkins; Eric,0,2,50,50
1683340806077,HUM 4,B03,202210,Watkins; Eric,0,2,50,50
1683340807102,HUM 5,A01,185958,West; Geoffrey Scott,3,0,50,47
1683340807102,HUM 5,A02,202215,West; Geoffrey Scott,0,0,50,50
1683340808128,INTL 190,A00,185959,Gagnon; Jeffrey C,0,0,0,9
1683340808128,INTL 190,B00,185960,Lettieri; Michael Joseph,0,0,0,1
1683340809157,JAPN 180,A00,254509,Staff,5,1,30,25
1683340810182,LATI 10,A01,202853,Kennemore; Amy Michelle,4,0,35,31
1683340810182,LATI 10,A02,202854,Kennemore; Amy Michelle,2,0,35,33
1683340810182,LATI 10,A03,270054,Kennemore; Amy Michelle,30,0,30,0
1683340811210,LATI 180,A00,202855,Kennemore; Amy Michelle,11,0,20,9
1683340812233,LAWS 101,A00,201767,Golan; Tal,0,7,40,40
1683340813258,LIFR 1C,A00,185961,Staff,6,0,20,14
1683340814284,LIFR 1CX,A00,185962,Staff,7,0,20,13
1683340815312,LIFR 1D,A00,185963,Staff,9,0,20,11
1683340816338,LIFR 1DX,A00,185964,Staff,9,0,20,11
1683340817366,LIGN 101,A01,186039,Staff,43,0,50,7
1683340818394,LIGN 165,A00,186040,Staff,18,0,50,32
1683340819420,LTCS 108,A00,186041,Staff,6,0,10,4
1683340820442,LTCS 119,A00,186042,Staff,16,0,20,4
1683340821468,LTCS 130,A00,186043,Wesling; Megan E.,15,0,25,10
1683340823522,LTEA 138,A00,186119,Staff,14,0,40,26
1683340824547,LTEN 124,A00,186148,Staff,6,0,25,19
1683340825627,LTEN 178,A00,186149,Staff,7,0,15,8
1683340826652,LTEN 181,A00,186150,Blanco; John D,33,0,40,7
1683340827680,LTWL 120,A00,186160,Staff,20,0,25,5
1683340828710,LTWL 165,A00,186161,Staff,22,0,25,3
1683340829734,LTWR 100,A00,186162,Staff,0,5,15,15
1683340830760,LTWR 102,A00,186163,Doller; Ben,5,0,15,10
1683340831787,MAE 8,A01,186412,Staff,0,0,0,0
1683340832815,MAE 30B,A00,186445,Bahadori; Mohammad Yousef,83,0,100,17
1683340833838,MAE 40,A00,186592,Bewley; Thomas R,9,0,50,41
1683340834864,MAE 101B,A00,186593,Bahadori; Mohammad Yousef,81,0,100,19
1683340835889,MAE 105,A00,186594,Bandaru; Prabhakar,12,0,50,38
1683340836913,MAE 107,A00,186599,Pham; Hieu Tan,0,6,120,120
1683340837937,MAE 148,A01,186660,Silberman; Jack,3,0,16,13
1683340838962,MATH 10A,A01,188095,Staff,1,6,35,34
1683340839986,MATH 10B,A01,188097,Bowers; Adam R.,0,11,30,30
1683340839986,MATH 10B,A02,188099,Bowers; Adam R.,0,11,30,30
1683340839986,MATH 10B,B01,188104,Bowers; Adam R.,0,10,30,30
1683340839986,MATH 10B,B02,188106,Bowers; Adam R.,0,10,30,30
1683340841014,MATH 10C,A01,188111,Staff,0,18,30,30
1683340841014,MATH 10C,A02,188127,Staff,0,17,30,30
1683340841014,MATH 10C,A03,188131,Staff,0,18,30,30
1683340841014,MATH 10C,B01,188218,Staff,18,0,30,12
1683340841014,MATH 10C,B02,188244,Staff,13,0,30,17
1683340841014,MATH 10C,B03,188277,Staff,16,0,30,14
1683340842039,MATH 18,A01,188344,Bach; Quang Tran,18,0,30,12
1683340842039,MATH 18,A02,188345,Bach; Quang Tran,11,0,30,19
1683340842039,MATH 18,B01,188353,Bach; Quang Tran,10,0,30,20
1683340842039,MATH 18,B02,188354,Bach; Quang Tran,20,0,30,10
1683340843067,MATH 20A,A01,188374,Staff,13,0,35,22
1683340844095,MATH 20B,A01,188382,Ohm; Ko Woon,6,0,30,24
1683340844095,MATH 20B,A02,188383,Ohm; Ko Woon,22,0,30,8
1683340844095,MATH 20B,B01,188385,Ohm; Ko Woon,7,0,30,23
1683340844095,MATH 20B,B02,188392,Ohm; Ko Woon,22,0,30,8
1683340845125,MATH 20C,A01,188394,Harel; Guershon,10,0,30,20
1683340845125,MATH 20C,A02,188395,Harel; Guershon,15,0,30,15
1683340845125,MATH 20C,B01,188404,Harel; Guershon,5,0,30,25
1683340845125,MATH 20C,B02,188405,Harel; Guershon,19,0,30,11
1683340846150,MATH 20D,A01,188414,Hammock; Frances H,0,1,30,30
1683340846150,MATH 20D,A02,188415,Hammock; Frances H,3,0,30,27
1683340846150,MATH 20D,B01,188447,Hammock; Frances H,1,0,30,29
1683340846150,MATH 20D,B02,188486,Hammock; Frances H,8,0,30,22
1683340847173,MATH 20E,A01,188649,Staff,21,0,30,9
1683340847173,MATH 20E,A02,188650,Staff,23,0,30,7
1683340847173,MATH 20E,A03,188673,Staff,0,0,30,30
1683340848198,MATH 102,A01,188675,Staff,0,35,35,35
1683340849222,MATH 103B,A01,188681,Staff,3,0,35,32
1683340849222,MATH 103B,B01,188692,Staff,5,0,35,30
1683340850250,MATH 109,A01,188695,Salehi Golsefidy; Alireza,25,0,35,10
1683340850250,MATH 109,A02,188696,Salehi Golsefidy; Alireza,25,0,35,10
1683340851278,MATH 120A,A01,188698,Eggers; John Dietrich,7,0,35,28
1683340852304,MATH 142B,A01,188736,Ioana; Adrian,0,2,30,30
1683340852304,MATH 142B,A02,188741,Ioana; Adrian,1,1,30,29
1683340852304,MATH 142B,A03,188743,Ioana; Adrian,1,3,30,29
1683340853329,MATH 168A,A01,188790,Staff,0,9,35,35
1683340854354,MATH 170A,A01,188803,Nie; Jiawang,0,2,35,35
1683340854354,MATH 170A,A02,188811,Nie; Jiawang,0,0,35,35
1683340854354,MATH 170A,A03,188814,Nie; Jiawang,1,0,35,34
1683340854354,MATH 170A,A04,188815,Nie; Jiawang,13,0,35,22
1683340855379,MATH 193B,A01,188817,Staff,0,0,35,35
1683340855379,MATH 193B,A02,188818,Staff,5,0,35,30
1683340856403,MGT 4,A01,202857,Anderson; John Charles,62,0,80,18
1683340857428,MGT 12,A00,202858,Lindenberger; Wade Douglas,42,0,90,48
1683340858456,MGT 18,A00,202859,Staff,74,0,90,16
1683340859480,MGT 18GS,A00,202860,McKay; Michael J,13,0,28,15
1683340860505,MGT 45,A00,202861,Pecore; Joseph P.,14,0,90,76
1683340861533,MGT 100,A00,202863,Yavorsky; Daniel Ryan,28,0,90,62
1683340862557,MGT 103,A00,202864,Ehrich; Kristine R,1,18,90,89
1683340863587,MGT 112,A00,202865,Ehrich; Kristine R,15,0,90,75
1683340864616,MGT 121A,A00,202868,Staff,0,20,0,0
1683340865644,MGT 131B,A00,202869,Anderson; John Charles,59,0,90,31
1683340866668,MGT 136,A00,202871,Lindenberger; Wade Douglas,84,0,90,6
1683340867693,MGT 164,A00,202873,Staff,0,68,90,91
1683340868718,MGT 164GS,A00,202874,McKay; Mary A,13,0,28,15
1683340869742,MGT 180,A00,202875,Staff,0,50,90,91
1683340870770,MMW 11R,A01,205019,Herbst; Matthew,3,0,30,27
1683340870770,MMW 11R,A02,205026,Herbst; Matthew,29,0,30,1
1683340871794,MMW 15,A01,193512,Chang; Edmond Yi-Teh,0,9,28,28
1683340871794,MMW 15,A02,193513,Chang; Edmond Yi-Teh,0,5,28,28
1683340871794,MMW 15,A03,193514,Chang; Edmond Yi-Teh,0,5,28,28
1683340871794,MMW 15,A04,193515,Chang; Edmond Yi-Teh,0,5,28,28
1683340871794,MMW 15,A05,193516,Chang; Edmond Yi-Teh,0,4,28,28
1683340871794,MMW 15,A06,193517,Chang; Edmond Yi-Teh,0,5,28,28
1683340871794,MMW 15,B01,193519,Chang; Edmond Yi-Teh,0,5,28,28
1683340871794,MMW 15,B02,193520,Chang; Edmond Yi-Teh,0,5,28,28
1683340871794,MMW 15,B03,193521,Chang; Edmond Yi-Teh,0,5,28,28
1683340871794,MMW 15,B04,193522,Chang; Edmond Yi-Teh,0,4,28,28
1683340871794,MMW 15,B05,193523,Chang; Edmond Yi-Teh,0,5,28,28
1683340871794,MMW 15,B06,193524,Chang; Edmond Yi-Teh,0,4,28,28
1683340872819,MMW 122,A01,193526,Rahimi; Babak,0,15,28,28
1683340872819,MMW 122,A02,193527,Rahimi; Babak,0,14,28,28
1683340872819,MMW 122,A03,193528,Rahimi; Babak,0,0,0,0
1683340872819,MMW 122,A04,193529,Rahimi; Babak,0,0,0,0
1683340873843,MUS 1A,A01,186663,Staff,0,20,35,35
1683340874867,MUS 4,A01,186715,Staff,0,12,35,35
1683340875896,MUS 5R,A01,186796,Dubnov; Shlomo,0,17,35,35
1683340876922,MUS 6,A01,186798,Staff,0,4,25,25
1683340877947,MUS 7,A01,186830,Staff,13,0,35,22
1683340878973,MUS 8,A01,186930,Staff,0,26,35,35
1683340879999,MUS 15,A01,186932,Staff,0,16,35,35
1683340879999,MUS 15,B01,186934,Staff,0,15,35,35
1683340881027,MUS 80,A00,186935,Staff,1,0,20,19
1683340881027,MUS 80,B00,186936,Staff,25,0,25,0
1683340882054,NANO 11,A00,204702,Lipomi; Darren John,0,0,0,0
1683340883082,NANO 15,A01,204709,Yang; Kesong,0,1,0,0
1683340884110,NANO 114,A00,202069,Jahed Motlagh; Zeinab,3,0,10,7
1683340885136,PHIL 1,A00,186955,Grush; Rick Scott,32,0,40,8
1683340886161,PHIL 10,A01,186973,Grush; Rick Scott,28,0,35,7
1683340886161,PHIL 10,A02,186974,Grush; Rick Scott,33,0,35,2
1683340887186,PHIL 13,A01,186976,Staff,7,0,35,28
1683340887186,PHIL 13,A02,186977,Staff,16,0,35,19
1683340888209,PHIL 14,A01,186979,Staff,31,0,35,4
1683340888209,PHIL 14,A02,186986,Staff,32,0,35,3
1683340889236,PHIL 28,A01,186988,Staff,16,0,30,14
1683340889236,PHIL 28,A02,186989,Staff,1,0,30,29
1683340889236,PHIL 28,A03,186990,Staff,9,0,30,21
1683340889236,PHIL 28,A04,186991,Staff,26,0,30,4
1683340890264,PHIL 120,A00,186997,Staff,23,0,40,17
1683340891291,PHIL 137,A00,187003,Staff,9,0,40,31
1683340892318,PHIL 150,A00,187015,Staff,47,0,70,23
1683340893344,PHIL 167,A00,187021,Lamey; Andy M.,35,0,40,5
1683340894371,PHIL 174,A01,202226,Staff,17,0,20,3
1683340894371,PHIL 174,A02,202235,Staff,20,0,20,0
1683340895396,PHIL 191A,A00,258918,Staff,0,0,1,1
1683340896423,PHYS 1A,A00,187028,Staff,27,0,60,33
1683340897452,PHYS 1AL,001,187036,Staff,2,0,30,28
1683340897452,PHYS 1AL,002,187049,Staff,18,0,30,12
1683340898480,PHYS 1B,A00,187058,Staff,22,0,60,38
1683340899508,PHYS 1BL,001,187064,Staff,0,0,30,30
1683340899508,PHYS 1BL,002,187070,Staff,5,0,30,25
1683340900534,PHYS 1C,A00,187082,Staff,31,0,120,89
1683340901559,PHYS 1CL,001,187088,Staff,0,9,30,30
1683340901559,PHYS 1CL,002,187089,Staff,0,2,30,30
1683340901559,PHYS 1CL,009,262693,Staff,11,0,30,19
1683340902587,PHYS 2B,A01,187097,Staff,54,0,115,61
1683340903612,PHYS 2C,A01,187099,Staff,67,0,115,48
1683340904636,PHYS 2CL,A01,187101,Staff,5,0,28,23
1683340904636,PHYS 2CL,A02,187102,Staff,15,0,28,13
1683340905664,PHYS 2D,A01,187123,Shotwell; Brian,95,0,115,20
1683340906693,PHYS 4B,A01,187133,Grinstein; Benjamin,35,0,50,15
1683340907716,POLI 10,A00,188819,Staff,0,4,50,50
1683340908740,POLI 11,A00,188827,Staff,43,0,50,7
1683340909766,POLI 13R,A00,188828,Staff,0,1,20,20
1683340910794,POLI 27,A01,188830,Elgin; Samuel Zincke,0,1,70,70
1683340911822,POLI 30,A00,188832,Desposato; Scott,31,0,50,19
1683340912850,POLI 102F,A00,188834,Staff,3,0,40,37
1683340913874,POLI 104A,A00,188852,Staff,14,0,30,16
1683340914901,POLI 104I,A00,188853,Staff,0,6,20,20
1683340915926,POLI 110B,A00,188854,Wiens; David,7,0,20,13
1683340916955,POLI 112A,A00,188855,Wiens; David,5,0,30,25
1683340917983,POLI 117R,A00,188856,Forman; Fonna,0,11,20,20
1683340919010,POLI 118,A00,188857,Ingham; Sean,8,0,20,12
1683340920037,POLI 120G,A00,188858,Staff,9,0,30,21
1683340921064,POLI 131CR,A00,188863,Hoston; Germaine,24,0,50,26
1683340922092,POLI 133,A00,188864,Nellis; Gareth Hb,44,0,50,6
1683340923115,POLI 134D,A00,188865,Desposato; Scott,27,0,30,3
1683340924141,POLI 142A,A00,188871,Gartzke; Erik,22,0,50,28
1683340925166,POLI 142K,A00,188874,Staff,38,0,50,12
1683340926192,POLI 143,A00,188940,Gartzke; Erik,16,0,30,14
1683340927216,POLI 153,A00,188943,Staff,3,0,20,17
1683340928243,POLI 160AA,A00,188944,Staff,12,0,40,28
1683340929321,POLI 170A,A00,188945,Staff,11,0,30,19
1683340931375,PSYC 1,A00,188952,Staff,37,0,90,53
1683340932405,PSYC 2,B00,188953,Staff,19,0,35,16
1683340933434,PSYC 6,A00,188970,Staff,47,0,60,13
1683340934458,PSYC 7,A00,188973,Staff,37,0,45,8
1683340935483,PSYC 60,A01,188980,Rickard; Timothy C.,43,0,60,17
1683340936509,PSYC 70,A01,189001,Steiner; Eric Tomas,23,0,45,22
1683340937533,PSYC 100,A00,189005,Lacefield; Katharine I,0,98,120,120
1683340938558,PSYC 102,A00,189008,Staff,9,0,30,21
1683340939583,PSYC 106,B00,189026,Gorman; Michael R.,34,0,60,26
1683340940608,PSYC 114,B01,189033,Winkielman; Piotr,0,32,30,30
1683340941634,PSYC 131,A00,189036,Anagnostaras; Stephan,0,43,60,60
1683340942660,PSYC 136,A00,189041,Lowe; Angela Beth,0,7,25,25
1683340943686,PSYC 137,A00,189057,Winkielman; Piotr,0,34,25,25
1683340944715,PSYC 144,A00,189107,Wixted; John T,0,7,50,50
1683340946767,PSYC 162,A00,189142,Staff,0,8,85,85
1683340947796,PSYC 172,A00,189144,Gorman; Michael R.,0,7,30,30
1683340949851,PSYC 179,A00,189146,Lacefield; Katharine I,0,84,120,120
1683340950880,PSYC 181,A00,189147,Anagnostaras; Stephan,0,44,90,90
1683340951910,PSYC 190R,A00,189148,Barner; David A.,0,22,80,80
1683340952935,PSYC 191,A00,189275,Rickard; Timothy C.,0,7,25,25
1683340953961,PSYC 193,A00,189276,Chapman; Eddie Nathaniel,0,1,0,4
1683340954987,PSYC 193L,A01,189281,Lowe; Angela Beth,12,0,20,8
1683340954987,PSYC 193L,B01,189285,Staff,28,0,35,7
1683340956014,RELI 149,A00,187137,Rahimi; Babak,7,0,40,33
1683340957040,SE 9,A01,187315,Staff,0,2,18,18
1683340958064,SE 101B,A00,187409,Staff,24,0,30,6
1683340959088,SE 110B,A00,187444,Staff,10,0,40,30
1683340960114,SE 130B,A00,187449,Staff,31,0,40,9
1683340961141,SE 150A,A00,187516,Staff,9,0,20,11
1683340962166,SE 154,A00,187528,Staff,30,0,50,20
1683340963190,SIO 3,A01,258171,Staff,35,0,40,5
1683340964218,SIO 10,A00,187144,Cook; Geoffrey W,0,3,75,75
1683340965246,SIO 45,A00,187152,Cook; Geoffrey W,1,0,100,99
1683340966271,SIO 109R,A00,194486,Staff,0,3,20,20
1683340968319,SIO 187,A01,187233,Kacev; David,12,0,40,28
1683340969349,SOCI 1,A01,258656,Thorpe; Charles Robert,28,0,30,2
1683340969349,SOCI 1,A02,258658,Thorpe; Charles Robert,30,0,30,0
1683340969349,SOCI 1,A03,258661,Thorpe; Charles Robert,25,0,25,0
1683340969349,SOCI 1,A04,258666,Thorpe; Charles Robert,22,0,25,3
1683340969349,SOCI 1,A05,258897,Thorpe; Charles Robert,23,0,25,2
1683340969349,SOCI 1,A06,258898,Thorpe; Charles Robert,25,0,25,0
1683340970376,SOCI 30,A01,258903,Pardo Guerra; Juan Pablo,15,0,30,15
1683340971400,SOCI 102,A00,258904,Staff,9,0,25,16
1683340972426,SOCI 106,A00,258905,Staff,19,0,25,6
1683340973450,SOCI 111,A00,258907,Ribas Norris; Janet Vanesa,26,0,30,4
1683340974478,SOCI 121R,A00,258908,Pardo Guerra; Juan Pablo,10,0,30,20
1683340975502,SOCI 126,A01,203330,Staff,14,0,20,6
1683340976526,SOCI 131,A00,258909,Thorpe; Charles Robert,31,0,60,29
1683340977549,SOCI 135,A00,258910,Payne; Christine Anna,0,9,30,30
1683340978574,SOCI 157,A00,258911,Staff,12,0,30,18
1683340979601,SOCI 184,A00,258912,Staff,25,0,30,5
1683340980625,SOCI 188D,A00,258913,Staff,21,0,30,9
1683340981650,SYN 2,001,187529,Staff,10,0,16,6
1683340981650,SYN 2,002,201452,Staff,0,18,16,16
1683340981650,SYN 2,003,201469,Staff,3,0,16,13
1683340982674,SYN 100,A01,187531,Staff,0,9,20,20
1683340982674,SYN 100,B01,201491,Staff,0,12,20,20
1683340983698,TDAC 1,A00,189286,Walsh; Kim C.,3,0,20,17
1683340983698,TDAC 1,B00,189287,Harting; Carla Kelso,11,0,20,9
1683340984726,TDAC 101,A00,189300,Walsh; Kim C.,16,0,20,4
1683340984726,TDAC 101,B00,189301,Harting; Carla Kelso,18,0,20,2
1683340985751,TDAC 102,A00,189304,Basso; Beatrice,14,0,20,6
1683340986780,TDAC 108,A00,189305,Staff,18,0,20,2
1683340987808,TDDE 131,A00,189310,Staff,19,0,20,1
1683340987808,TDDE 131,B00,189314,Staff,19,0,20,1
1683340987808,TDDE 131,C00,189315,Staff,48,0,50,2
1683340987808,TDDE 131,D00,189316,Staff,14,0,15,1
1683340987808,TDDE 131,E00,204841,Staff,20,0,20,0
1683340988833,TDGE 10,A00,189289,Staff,30,0,50,20
1683340988833,TDGE 10,B00,189290,Havis; Allan,1,0,50,49
1683340989858,TDGE 11,A00,189291,Fulton; Julia,0,3,50,50
1683340989858,TDGE 11,B00,189292,Staff,20,0,25,5
1683340989858,TDGE 11,C00,260270,Staff,0,0,0,0
1683340990883,TDGE 25,A00,189294,Staff,3,0,20,17
1683340991907,TDGE 124,A00,189318,Fulton; Julia,0,8,50,50
1683340992931,TDGE 125,A00,189319,Staff,13,0,25,12
1683340992931,TDGE 125,B00,189320,Staff,23,0,25,2
1683340993959,TDGE 127,A00,189322,Havis; Allan,0,0,50,50
1683340994985,TDHT 101,A00,189323,Staff,18,0,25,7
1683340994985,TDHT 101,B00,189324,Staff,25,0,25,0
1683340996012,TDHT 102,A00,189325,Staff,49,0,50,1
1683340997038,TDMV 1,A00,189295,Arcidiacono; Kristin,19,0,30,11
1683340997038,TDMV 1,B00,189296,Caligagan; Maria T.,24,0,30,6
1683340998063,TDMV 2,A00,189297,Sammartano; Tonnie,28,0,30,2
1683340998063,TDMV 2,B00,189299,Arcidiacono; Kristin,24,0,30,6
1683340999092,TDMV 3,A00,204998,Rincon; Alicia,22,0,30,8
1683341000120,TDMV 120,A00,189458,Sammartano; Tonnie,28,0,30,2
1683341001144,TDMV 138,A00,189541,Jun; Grace Shin Hae,22,0,40,18
1683341002172,TDMV 142,A00,189717,Caligagan; Tony,23,0,30,7
1683341002172,TDMV 142,B00,189718,Caligagan; Maria T.,25,0,30,5
1683341003196,TMC 2,A01,187533,Staff,25,0,25,0
1683341003196,TMC 2,A02,187534,Staff,25,0,25,0
1683341004224,USP 1,A01,187536,Kwak; Nancy,0,16,25,25
1683341005248,USP 5,A01,187538,Staff,10,0,25,15
1683341006274,USP 101,A00,199253,Staff,0,4,0,0
1683341007303,USP 124,A00,187562,Boomhower; Matthew Charles,1,0,30,29
1683341008325,USP 138,A00,187582,Staff,20,0,25,5
1683341009350,USP 152,A01,187597,Staff,4,0,25,21
1683341010374,USP 153,A00,187598,Staff,19,0,25,6
1683341011404,USP 168,A00,187607,Kwak; Nancy,2,0,5,3
1683341012432,USP 173,A00,187619,Staff,4,0,25,21
1683341013459,USP 181,A00,187638,Staff,0,0,25,25
1683341014483,VIS 103,A00,187650,Cruz; Edwin Teddy,23,0,75,52
1683341015507,VIS 110D,A00,187669,Staff,12,0,22,10
1683341016536,VIS 127C,A00,187720,Shen; Kuiyi,67,0,146,79
1683341017563,VIS 149,A00,187731,Yoldas; Pinar,0,14,22,22
1683341018589,VIS 151,A01,188091,Staff,22,0,34,12
1683341018589,VIS 151,A02,188092,Staff,11,0,34,23
1683341019612,VIS 160B,A00,188093,Stalbaum; Brett,0,0,10,10
1683341021664,WCWP 10B,A00,201720,Staff,10,0,15,5
1683341021664,WCWP 10B,B00,201722,Staff,9,0,15,6
1683341022691,WCWP 100,A00,201725,Gagnon; Jeffrey C,0,0,2,2
1683341022691,WCWP 100,B00,201727,Staff,0,4,15,15
1683341025820,ANBI 133,A00,258401,Wilder; Linnea Lorene,34,0,40,6
1683341026847,ANBI 140,A00,258395,Hrvoj Mihic; Branka,18,0,25,7
1683341027875,ANSC 120,A00,258402,Bialecki; Jon Anthony,27,0,40,13
1683341028905,ANSC 144,A00,258400,Staff,14,0,40,26
1683341030955,ANSC 166,A00,258396,Parish; Steven Martin,157,0,175,18
1683341031980,ANSC 180,A00,193533,Staff,9,0,20,11
1683341033058,ANSC 188,A00,258397,Jassal; Aftab,33,0,40,7
1683341034083,ANTH 3,A01,258316,Staff,23,0,30,7
1683341035106,ANTH 5,A00,258394,Semendeferi; Ekaterini,16,0,20,4
1683341036133,ANTH 21,A01,258331,Staff,8,0,40,32
1683341037160,ANTH 103,A00,258398,Varma; Saiba,15,0,25,10
1683341038190,AWP 10,001,202034,Staff,0,0,0,0
1683341038190,AWP 10,002,202035,Staff,0,0,0,0
1683341038190,AWP 10,003,202036,Staff,0,0,0,0
1683341038190,AWP 10,004,202037,Staff,0,0,0,0
1683341038190,AWP 10,005,202038,Staff,0,0,0,0
1683341038190,AWP 10,006,202039,Staff,0,0,0,0
1683341038190,AWP 10,007,202040,Staff,0,0,0,0
1683341038190,AWP 10,008,202041,Staff,0,0,0,0
1683341038190,AWP 10,009,202042,Staff,0,0,0,0
1683341038190,AWP 10,010,202043,Staff,0,0,0,0
1683341038190,AWP 10,011,202044,Staff,0,0,0,0
1683341038190,AWP 10,012,202045,Staff,0,0,0,0
1683341038190,AWP 10,013,202046,Staff,0,0,0,0
1683341038190,AWP 10,014,202047,Staff,0,0,0,0
1683341038190,AWP 10,015,202048,Staff,0,0,0,0
1683341038190,AWP 10,016,202049,Staff,0,0,0,0
1683341038190,AWP 10,017,202050,Staff,0,0,0,0
1683341038190,AWP 10,018,202051,Staff,0,0,0,0
1683341038190,AWP 10,019,202052,Staff,0,0,0,0
1683341038190,AWP 10,020,202053,Staff,0,0,0,0
1683341038190,AWP 10,021,202054,Staff,0,0,0,0
1683341038190,AWP 10,022,202055,Staff,0,0,0,0
1683341038190,AWP 10,023,202056,Staff,0,0,0,0
1683341038190,AWP 10,024,202057,Staff,0,0,0,0
1683341038190,AWP 10,025,202058,Staff,0,0,0,0
1683341038190,AWP 10,026,202059,Staff,0,0,0,0
1683341039214,AWP 102,001,202032,Staff,0,0,0,0
1683341039214,AWP 102,002,202033,Staff,0,0,0,0
1683341040239,BENG 100,A01,254234,Taylor Amos; Alyssa C,31,0,40,9
1683341041267,BENG 196,001,270013,Engler; Adam J.,9999,0,9999,0
1683341042293,BICD 100R,A01,202018,Smith; Laurie,0,7,32,32
1683341042293,BICD 100R,A02,202019,Smith; Laurie,0,2,32,32
1683341042293,BICD 100R,A03,202020,Smith; Laurie,0,1,32,32
1683341042293,BICD 100R,A04,202021,Smith; Laurie,9,0,32,23
1683341042293,BICD 100R,A05,202022,Smith; Laurie,12,0,32,20
1683341043321,BICD 136,A01,193242,Gustafson-Brown; Cindy,0,2,32,32
1683341043321,BICD 136,A02,193244,Gustafson-Brown; Cindy,14,0,32,18
1683341044360,BIEB 102,A01,193249,Butler; Shannon Rhey,0,2,32,32
1683341044360,BIEB 102,A02,193251,Butler; Shannon Rhey,0,0,32,32
1683341044360,BIEB 102,A03,193253,Butler; Shannon Rhey,0,1,32,32
1683341044360,BIEB 102,A04,193255,Butler; Shannon Rhey,17,0,32,15
1683341044360,BIEB 102,A05,193265,Butler; Shannon Rhey,26,0,32,6
1683341044360,BIEB 102,A06,193269,Butler; Shannon Rhey,16,0,32,16
1683341046418,BIEB 150,A01,193274,Staff,0,0,32,32
1683341046418,BIEB 150,A02,193285,Staff,23,0,32,9
1683341047441,BIEB 194,A00,193286,Kurle; Carolyn M.,22,0,32,10
1683341048467,BILD 1,A01,192291,Staff,16,0,32,16
1683341048467,BILD 1,A02,192292,Staff,30,0,32,2
1683341048467,BILD 1,B01,192520,Reuther; Keefe,0,1,0,0
1683341048467,BILD 1,B02,192532,Reuther; Keefe,0,1,0,0
1683341049497,BILD 3,A01,192556,Butler; Shannon Rhey,0,0,32,32
1683341049497,BILD 3,A02,192581,Butler; Shannon Rhey,5,0,32,27
1683341049497,BILD 3,A03,192611,Butler; Shannon Rhey,23,0,32,9
1683341049497,BILD 3,A04,192612,Butler; Shannon Rhey,25,0,32,7
1683341049497,BILD 3,A05,192613,Butler; Shannon Rhey,27,0,32,5
1683341049497,BILD 3,A06,192679,Butler; Shannon Rhey,27,0,32,5
1683341049497,BILD 3,A07,192682,Butler; Shannon Rhey,22,0,32,10
1683341050523,BILD 4,A01,192836,Reuther; Keefe,0,0,24,24
1683341050523,BILD 4,A02,193044,Reuther; Keefe,4,0,24,20
1683341051551,BILD 10,A01,193142,Gustafson-Brown; Cindy,30,0,32,2
1683341051551,BILD 10,A02,193149,Gustafson-Brown; Cindy,31,0,32,1
1683341052577,BIMM 100,A01,193301,Staff,0,6,32,32
1683341052577,BIMM 100,A02,193312,Staff,0,5,32,32
1683341052577,BIMM 100,A03,193323,Staff,0,8,32,32
1683341053603,BIMM 101,A01,193329,McDonnell; Lisa Marie,0,3,24,24
1683341053603,BIMM 101,A02,193339,McDonnell; Lisa Marie,0,3,24,24
1683341053603,BIMM 101,B01,193354,McDonnell; Lisa Marie,0,3,24,24
1683341053603,BIMM 101,B02,193357,McDonnell; Lisa Marie,0,3,24,24
1683341054631,BIMM 110,A01,193377,Tat; John,0,11,32,32
1683341054631,BIMM 110,A02,193378,Tat; John,1,9,32,31
1683341055659,BIMM 120,A01,206116,Staff,0,0,32,32
1683341055659,BIMM 120,A02,206117,Staff,8,0,32,24
1683341055659,BIMM 120,A03,206121,Staff,21,0,32,11
1683341056684,BIPN 100,A01,193393,Park; Ji Young,0,14,32,32
1683341056684,BIPN 100,A02,193402,Park; Ji Young,0,13,32,32
1683341056684,BIPN 100,A03,193413,Park; Ji Young,0,14,32,32
1683341056684,BIPN 100,A04,193414,Park; Ji Young,0,13,32,32
1683341057713,BIPN 102,A01,193429,Staff,0,0,32,32
1683341057713,BIPN 102,A02,193438,Staff,22,0,32,10
1683341058739,BIPN 106,A01,193450,Reyes Gonzalez; Catalina,0,2,40,40
1683341059765,BIPN 134,A01,193465,Cooke; James Edward,0,0,32,32
1683341059765,BIPN 134,A02,193474,Cooke; James Edward,25,0,32,7
1683341059765,BIPN 134,A03,193485,Cooke; James Edward,29,0,32,3
1683341059765,BIPN 134,A04,193486,Cooke; James Edward,21,0,32,11
1683341059765,BIPN 134,A05,193491,Cooke; James Edward,31,0,32,1
1683341059765,BIPN 134,A06,193501,Cooke; James Edward,30,0,32,2
1683341059765,BIPN 134,A07,193510,Cooke; James Edward,29,0,32,3
1683341061815,BISP 194,A00,222522,Staff,14,0,32,18
1683341062841,CAT 124,A01,202407,Staff,20,0,25,5
1683341063868,CAT 125,A00,202408,Marchisotto; Jennifer Anne,4,0,20,16
1683341064898,CAT 125R,A00,202409,Smith; Lauryn Alissa,0,11,20,20
1683341064898,CAT 125R,B00,202410,Morales; Celeste Georgianna,0,11,20,20
1683341064898,CAT 125R,C00,202411,Irwin; Matthew Joseph,0,10,20,20
1683341065925,CENG 15,A01,204712,Yang; Kesong,0,1,0,0
1683341066951,CENG 114,A00,202070,Jahed Motlagh; Zeinab,5,0,20,15
1683341067976,CGS 105,A00,185477,Wesling; Megan E.,24,0,40,16
1683341069000,CGS 106,A00,185494,Staff,13,0,22,9
1683341070028,CGS 108,A00,185495,Staff,14,0,20,6
1683341071056,CGS 114,A00,185496,Staff,13,0,18,5
1683341072084,CGS 119,A00,185501,Staff,15,0,20,5
1683341073108,CGS 120,A00,185511,Staff,13,0,20,7
1683341074136,CHEM 4,A01,184675,Bussey; Thomas J,96,0,100,4
1683341075164,CHEM 6A,A01,184677,Staff,34,0,60,26
1683341076191,CHEM 6B,A01,184679,Staff,65,0,100,35
1683341077218,CHEM 6C,A01,184681,Bussey; Thomas J,1,0,50,49
1683341077218,CHEM 6C,A02,184682,Bussey; Thomas J,34,0,50,16
1683341078244,CHEM 40A,A01,184684,Albizati; Kim F.,37,0,100,63
1683341079272,CHEM 40B,A01,184686,Albizati; Kim F.,0,20,100,100
1683341080299,CHEM 41B,A01,184690,Staff,52,0,100,48
1683341081323,COGS 3,A01,184715,Boyle; Mary E. T.,0,25,40,40
1683341082347,COGS 14B,A01,185172,Staff,0,15,38,38
1683341083375,COGS 18,A01,184736,Staff,17,0,80,63
1683341084400,COGS 100,A01,184932,Staff,0,5,73,73
1683341085425,COGS 101A,A01,184935,Staff,0,39,30,30
1683341086449,COGS 101B,A01,184944,Staff,0,2,30,30
1683341087476,COGS 101C,A01,184946,Staff,0,12,30,30
1683341088502,COGS 102A,A01,184951,Johnson; Christine M.,2,0,40,38
1683341089527,COGS 107B,A01,184953,Mooshagian; Eric Frederick,0,50,40,40
1683341090555,COGS 118B,A01,184959,Gupta; Anjum,0,48,40,40
1683341091585,COGS 153,A00,184961,Staff,0,15,30,30
1683341092612,COGS 177,A00,184962,Staff,0,20,30,30
1683341093638,COGS 187A,A01,184969,Boyle; Mary E. T.,0,17,40,40
1683341094662,COMM 10,A01,185174,Staff,0,5,25,25
1683341094662,COMM 10,A02,185189,Staff,0,5,25,25
1683341094662,COMM 10,A03,269821,Staff,0,0,0,0
1683341095686,COMM 100B,A01,185475,Staff,0,0,0,2
1683341095686,COMM 100B,A02,185476,Staff,13,0,25,12
1683341096713,COMM 100C,A01,185314,Staff,1,0,25,24
1683341096713,COMM 100C,A02,185327,Staff,19,0,25,6
1683341097739,COMM 110M,A00,185349,Staff,2,0,40,38
1683341098767,COMM 113T,A00,185352,Staff,24,0,40,16
1683341099795,COMM 114I,A00,185353,Staff,33,0,40,7
1683341100823,COMM 131,A00,185354,Staff,19,0,30,11
1683341101848,CSE 8A,A50,185358,Cao; Yingjun,0,46,10,10
1683341102871,CSE 8B,A01,185362,Staff,1,47,50,49
1683341103897,CSE 11,A01,185416,Cao; Yingjun,0,92,10,10
1683341104922,CSE 20,A01,185445,Briones; Jor-el Thomas Caparas,5,0,25,20
1683341105947,CSE 21,A01,185447,Staff,10,0,50,40
1683341106974,CSE 101,A01,185451,Staff,0,13,50,50
1683341106974,CSE 101,B01,185453,Jones; Miles E,0,11,50,50
1683341109025,CSE 141,A01,185458,Eldon; John,20,0,100,80
1683341110053,CSE 141L,A01,185461,Eldon; John,12,0,100,88
1683341111076,CSE 142,A01,185463,Staff,36,0,60,24
1683341111076,CSE 142,B01,201355,Staff,0,7,60,60
1683341112101,CSE 142L,A01,185470,Staff,36,0,60,24
1683341112101,CSE 142L,B01,201417,Staff,0,6,60,60
1683341113124,CSE 190,A00,201433,Staff,32,0,49,17
1683341114148,DOC 1,A01,259136,Strom; Megan C.,7,0,15,8
1683341114148,DOC 1,A02,259137,Strom; Megan C.,14,0,15,1
1683341114148,DOC 1,A03,259138,Strom; Megan C.,14,0,15,1
1683341114148,DOC 1,A04,259139,Strom; Megan C.,14,0,15,1
1683341115172,DOC 100D,A00,259140,Pass; Natalye Joann,16,0,25,9
1683341116196,DSGN 1,A01,184749,Rill; Bryan,0,25,30,30
1683341117224,DSGN 100,A01,185168,Staff,0,2,25,25
1683341118249,ECE 5,A01,185626,Morris; Karcher William,0,10,0,0
1683341119274,ECE 101,A01,185628,Staff,17,0,70,53
1683341120298,ECE 107,A01,185635,Baghdadchi; Saharnaz,0,0,20,20
1683341120298,ECE 107,A02,185638,Baghdadchi; Saharnaz,4,0,20,16
1683341121326,ECE 148,A01,185647,Silberman; Jack,0,0,16,16
1683341122350,ECON 1,A01,185537,Crane; Meredith Helen,54,0,70,16
1683341123375,ECON 3,A01,185549,Crane; Meredith Helen,32,0,70,38
1683341124402,ECON 4,A01,203354,Anderson; John Charles,0,4,10,10
1683341125428,ECON 100A,A01,185574,Staff,0,4,40,40
1683341126452,ECON 100B,A01,185576,Staff,10,22,50,40
1683341127475,ECON 100C,A01,185589,Newhouse; Herbert S,30,0,70,40
1683341128500,ECON 105,A00,185608,Vespa; Emanuel Ignacio,19,0,35,16
1683341129525,ECON 109,A01,185610,Shishkin; Denis,10,0,35,25
1683341130550,ECON 110A,A01,185612,Staff,11,0,40,29
1683341131575,ECON 120A,A01,185615,Staff,20,0,40,20
1683341132599,ECON 120C,A01,185617,Sun; Yixiao,0,20,70,70
1683341133622,ECON 144,A00,203346,Squires; Dale E,3,0,35,32
1683341134647,ECON 171,A01,203349,Newhouse; Herbert S,0,1,35,35
1683341135672,ECON 173A,A01,185621,Toda; Alexis Akira,21,0,35,14
1683341136756,EDS 25,A01,202413,Staff,0,1,0,0
1683341136756,EDS 25,A02,202414,Staff,0,1,0,0
1683341136756,EDS 25,A03,202415,Staff,0,0,0,0
1683341136756,EDS 25,A04,202416,Staff,0,1,0,0
1683341136756,EDS 25,A05,202439,Staff,0,0,0,0
1683341136756,EDS 25,A06,202440,Staff,0,0,0,0
1683341136756,EDS 25,B01,202631,Staff,0,0,0,0
1683341136756,EDS 25,B02,202632,Staff,0,0,0,0
1683341136756,EDS 25,B03,202639,Staff,0,0,0,0
1683341136756,EDS 25,B04,202640,Staff,0,0,0,0
1683341136756,EDS 25,B05,202643,Staff,0,0,0,0
1683341136756,EDS 25,B06,202644,Staff,0,0,0,0
1683341137784,EDS 38,A01,202659,Black; Alison Michelle,24,0,25,1
1683341138812,EDS 115,A00,202652,Staff,18,0,30,12
1683341139840,EDS 125,A00,202649,Staff,14,0,30,16
1683341140866,EDS 126,A01,203332,Staff,30,0,30,0
1683341141896,EDS 139,A00,202838,Staff,16,0,25,9
1683341142921,EDS 146,A01,202655,Staff,14,0,25,11
1683341143947,ENG 15,A00,185667,Staff,0,1,0,0
1683341143947,ENG 15,B00,185672,Staff,0,0,0,0
1683341143947,ENG 15,C00,185675,Staff,0,0,0,0
1683341143947,ENG 15,D00,185682,Staff,0,0,0,0
1683341143947,ENG 15,E00,185684,Staff,0,0,0,0
1683341144975,ETHN 103,A00,185710,Staff,0,4,35,35
1683341145999,ETHN 103A,A00,199228,Man; Simeon S,2,0,9,7
1683341147022,ETHN 109,A00,185711,Staff,18,0,35,17
1683341148044,ETHN 142,A00,185726,Staff,0,4,30,30
1683341149068,ETHN 163J,A00,199229,Man; Simeon S,5,0,8,3
1683341150096,ETHN 168,A00,185727,Staff,8,0,10,2
1683341151124,ETHN 182,A00,185728,Staff,1,0,35,34
1683341152147,ETHN 183,A00,185737,Staff,8,0,18,10
1683341153170,GLBH 111,A01,209361,Burgos; Jose L.,0,0,0,0
1683341155218,HIEU 104,A00,185792,Staff,16,0,20,4
1683341156242,HIEU 115,A00,185800,Staff,1,0,20,19
1683341157267,HIEU 128,A00,185801,Staff,0,7,20,20
1683341158293,HIEU 147,A00,185802,Staff,16,0,20,4
1683341159325,HIEU 154,A00,185823,Staff,12,0,20,8
1683341160349,HILA 102,A00,185826,Staff,13,0,20,7
1683341161373,HILD 2C,A01,185778,Staff,0,12,20,20
1683341162403,HILD 7B,A01,185780,Kwak; Nancy,0,15,32,32
1683341162403,HILD 7B,A02,185781,Kwak; Nancy,0,18,32,32
1683341163431,HILD 30,A01,185791,Staff,14,0,20,6
1683341164456,HISC 119,A00,185830,Golan; Tal,0,9,20,20
1683341165482,HITO 156GS,A00,185831,Patterson; Patrick H.,0,0,0,23
1683341166507,HIUS 103,A00,185832,Man; Simeon S,0,6,20,20
1683341167534,HIUS 117,A00,185836,Kwak; Nancy,2,0,20,18
1683341168560,HIUS 125,A00,185840,Man; Simeon S,0,0,23,23
1683341169584,HIUS 149,A00,185845,Staff,0,0,20,20
1683341170610,HUM 3,A01,185882,Zavodny; Tatiana Sophia,0,7,50,50
1683341170610,HUM 3,B01,185899,Caldwell; Michael Alan,0,18,50,50
1683341171638,HUM 3GS,A00,185900,Patterson; Patrick H.,0,0,0,23
1683341172664,HUM 4,A01,185938,Zroka; Amy Liane,31,0,50,19
1683341172664,HUM 4,B01,185956,Watkins; Eric,0,2,50,50
1683341172664,HUM 4,B02,202209,Watkins; Eric,0,2,50,50
1683341172664,HUM 4,B03,202210,Watkins; Eric,0,2,50,50
1683341173688,HUM 5,A01,185958,West; Geoffrey Scott,3,0,50,47
1683341173688,HUM 5,A02,202215,West; Geoffrey Scott,0,0,50,50
1683341174718,INTL 190,A00,185959,Gagnon; Jeffrey C,0,0,0,9
1683341174718,INTL 190,B00,185960,Lettieri; Michael Joseph,0,0,0,1
1683341175741,JAPN 180,A00,254509,Staff,5,1,30,25
1683341176770,LATI 10,A01,202853,Kennemore; Amy Michelle,4,0,35,31
1683341176770,LATI 10,A02,202854,Kennemore; Amy Michelle,2,0,35,33
1683341176770,LATI 10,A03,270054,Kennemore; Amy Michelle,30,0,30,0
1683341177798,LATI 180,A00,202855,Kennemore; Amy Michelle,11,0,20,9
1683341178822,LAWS 101,A00,201767,Golan; Tal,0,7,40,40
1683341179847,LIFR 1C,A00,185961,Staff,6,0,20,14
1683341180872,LIFR 1CX,A00,185962,Staff,7,0,20,13
1683341181899,LIFR 1D,A00,185963,Staff,9,0,20,11
1683341182926,LIFR 1DX,A00,185964,Staff,9,0,20,11
1683341183967,LIGN 101,A01,186039,Staff,43,0,50,7
1683341184992,LIGN 165,A00,186040,Staff,18,0,50,32
1683341186018,LTCS 108,A00,186041,Staff,6,0,10,4
1683341187041,LTCS 119,A00,186042,Staff,16,0,20,4
1683341188066,LTCS 130,A00,186043,Wesling; Megan E.,15,0,25,10
1683341190117,LTEA 138,A00,186119,Staff,14,0,40,26
1683341191140,LTEN 124,A00,186148,Staff,6,0,25,19
1683341192169,LTEN 178,A00,186149,Staff,7,0,15,8
1683341193191,LTEN 181,A00,186150,Blanco; John D,33,0,40,7
1683341194218,LTWL 120,A00,186160,Staff,20,0,25,5
1683341195244,LTWL 165,A00,186161,Staff,22,0,25,3
1683341196268,LTWR 100,A00,186162,Staff,0,5,15,15
1683341197292,LTWR 102,A00,186163,Doller; Ben,5,0,15,10
1683341198321,MAE 8,A01,186412,Staff,0,0,0,0
1683341199348,MAE 30B,A00,186445,Bahadori; Mohammad Yousef,83,0,100,17
1683341200372,MAE 40,A00,186592,Bewley; Thomas R,9,0,50,41
1683341201396,MAE 101B,A00,186593,Bahadori; Mohammad Yousef,81,0,100,19
1683341202421,MAE 105,A00,186594,Bandaru; Prabhakar,12,0,50,38
1683341203443,MAE 107,A00,186599,Pham; Hieu Tan,0,6,120,120
1683341204468,MAE 148,A01,186660,Silberman; Jack,3,0,16,13
1683341205495,MATH 10A,A01,188095,Staff,1,6,35,34
1683341206526,MATH 10B,A01,188097,Bowers; Adam R.,0,11,30,30
1683341206526,MATH 10B,A02,188099,Bowers; Adam R.,0,11,30,30
1683341206526,MATH 10B,B01,188104,Bowers; Adam R.,0,10,30,30
1683341206526,MATH 10B,B02,188106,Bowers; Adam R.,0,10,30,30
1683341207550,MATH 10C,A01,188111,Staff,0,18,30,30
1683341207550,MATH 10C,A02,188127,Staff,0,17,30,30
1683341207550,MATH 10C,A03,188131,Staff,0,18,30,30
1683341207550,MATH 10C,B01,188218,Staff,18,0,30,12
1683341207550,MATH 10C,B02,188244,Staff,13,0,30,17
1683341207550,MATH 10C,B03,188277,Staff,16,0,30,14
1683341208575,MATH 18,A01,188344,Bach; Quang Tran,18,0,30,12
1683341208575,MATH 18,A02,188345,Bach; Quang Tran,11,0,30,19
1683341208575,MATH 18,B01,188353,Bach; Quang Tran,10,0,30,20
1683341208575,MATH 18,B02,188354,Bach; Quang Tran,20,0,30,10
1683341209602,MATH 20A,A01,188374,Staff,13,0,35,22
1683341210627,MATH 20B,A01,188382,Ohm; Ko Woon,6,0,30,24
1683341210627,MATH 20B,A02,188383,Ohm; Ko Woon,22,0,30,8
1683341210627,MATH 20B,B01,188385,Ohm; Ko Woon,7,0,30,23
1683341210627,MATH 20B,B02,188392,Ohm; Ko Woon,22,0,30,8
1683341211653,MATH 20C,A01,188394,Harel; Guershon,10,0,30,20
1683341211653,MATH 20C,A02,188395,Harel; Guershon,15,0,30,15
1683341211653,MATH 20C,B01,188404,Harel; Guershon,5,0,30,25
1683341211653,MATH 20C,B02,188405,Harel; Guershon,19,0,30,11
1683341212679,MATH 20D,A01,188414,Hammock; Frances H,0,1,30,30
1683341212679,MATH 20D,A02,188415,Hammock; Frances H,3,0,30,27
1683341212679,MATH 20D,B01,188447,Hammock; Frances H,1,0,30,29
1683341212679,MATH 20D,B02,188486,Hammock; Frances H,8,0,30,22
1683341213703,MATH 20E,A01,188649,Staff,21,0,30,9
1683341213703,MATH 20E,A02,188650,Staff,23,0,30,7
1683341213703,MATH 20E,A03,188673,Staff,0,0,30,30
1683341214730,MATH 102,A01,188675,Staff,0,35,35,35
1683341215755,MATH 103B,A01,188681,Staff,3,0,35,32
1683341215755,MATH 103B,B01,188692,Staff,5,0,35,30
1683341216780,MATH 109,A01,188695,Salehi Golsefidy; Alireza,25,0,35,10
1683341216780,MATH 109,A02,188696,Salehi Golsefidy; Alireza,25,0,35,10
1683341217805,MATH 120A,A01,188698,Eggers; John Dietrich,7,0,35,28
1683341218830,MATH 142B,A01,188736,Ioana; Adrian,0,2,30,30
1683341218830,MATH 142B,A02,188741,Ioana; Adrian,1,1,30,29
1683341218830,MATH 142B,A03,188743,Ioana; Adrian,1,3,30,29
1683341219855,MATH 168A,A01,188790,Staff,0,9,35,35
1683341220879,MATH 170A,A01,188803,Nie; Jiawang,0,2,35,35
1683341220879,MATH 170A,A02,188811,Nie; Jiawang,0,0,35,35
1683341220879,MATH 170A,A03,188814,Nie; Jiawang,1,0,35,34
1683341220879,MATH 170A,A04,188815,Nie; Jiawang,13,0,35,22
1683341221906,MATH 193B,A01,188817,Staff,0,0,35,35
1683341221906,MATH 193B,A02,188818,Staff,5,0,35,30
1683341222932,MGT 4,A01,202857,Anderson; John Charles,62,0,80,18
1683341223958,MGT 12,A00,202858,Lindenberger; Wade Douglas,42,0,90,48
1683341224986,MGT 18,A00,202859,Staff,74,0,90,16
1683341226010,MGT 18GS,A00,202860,McKay; Michael J,13,0,28,15
1683341227036,MGT 45,A00,202861,Pecore; Joseph P.,14,0,90,76
1683341228061,MGT 100,A00,202863,Yavorsky; Daniel Ryan,28,0,90,62
1683341229090,MGT 103,A00,202864,Ehrich; Kristine R,1,18,90,89
1683341230118,MGT 112,A00,202865,Ehrich; Kristine R,15,0,90,75
1683341231145,MGT 121A,A00,202868,Staff,0,20,0,0
1683341232173,MGT 131B,A00,202869,Anderson; John Charles,59,0,90,31
1683341233198,MGT 136,A00,202871,Lindenberger; Wade Douglas,84,0,90,6
1683341234221,MGT 164,A00,202873,Staff,0,68,90,91
1683341235246,MGT 164GS,A00,202874,McKay; Mary A,13,0,28,15
1683341236270,MGT 180,A00,202875,Staff,0,50,90,91
1683341237295,MMW 11R,A01,205019,Herbst; Matthew,3,0,30,27
1683341237295,MMW 11R,A02,205026,Herbst; Matthew,29,0,30,1
1683341238320,MMW 15,A01,193512,Chang; Edmond Yi-Teh,0,9,28,28
1683341238320,MMW 15,A02,193513,Chang; Edmond Yi-Teh,0,5,28,28
1683341238320,MMW 15,A03,193514,Chang; Edmond Yi-Teh,0,5,28,28
1683341238320,MMW 15,A04,193515,Chang; Edmond Yi-Teh,0,5,28,28
1683341238320,MMW 15,A05,193516,Chang; Edmond Yi-Teh,0,4,28,28
1683341238320,MMW 15,A06,193517,Chang; Edmond Yi-Teh,0,5,28,28
1683341238320,MMW 15,B01,193519,Chang; Edmond Yi-Teh,0,5,28,28
1683341238320,MMW 15,B02,193520,Chang; Edmond Yi-Teh,0,5,28,28
1683341238320,MMW 15,B03,193521,Chang; Edmond Yi-Teh,0,5,28,28
1683341238320,MMW 15,B04,193522,Chang; Edmond Yi-Teh,0,4,28,28
1683341238320,MMW 15,B05,193523,Chang; Edmond Yi-Teh,0,5,28,28
1683341238320,MMW 15,B06,193524,Chang; Edmond Yi-Teh,0,4,28,28
1683341239345,MMW 122,A01,193526,Rahimi; Babak,0,15,28,28
1683341239345,MMW 122,A02,193527,Rahimi; Babak,0,14,28,28
1683341239345,MMW 122,A03,193528,Rahimi; Babak,0,0,0,0
1683341239345,MMW 122,A04,193529,Rahimi; Babak,0,0,0,0
1683341240424,MUS 1A,A01,186663,Staff,0,20,35,35
1683341241452,MUS 4,A01,186715,Staff,0,12,35,35
1683341242479,MUS 5R,A01,186796,Dubnov; Shlomo,0,17,35,35
1683341243507,MUS 6,A01,186798,Staff,0,4,25,25
1683341244535,MUS 7,A01,186830,Staff,13,0,35,22
1683341245560,MUS 8,A01,186930,Staff,0,26,35,35
1683341246589,MUS 15,A01,186932,Staff,0,16,35,35
1683341246589,MUS 15,B01,186934,Staff,0,15,35,35
1683341247617,MUS 80,A00,186935,Staff,1,0,20,19
1683341247617,MUS 80,B00,186936,Staff,25,0,25,0
1683341248641,NANO 11,A00,204702,Lipomi; Darren John,0,0,0,0
1683341249668,NANO 15,A01,204709,Yang; Kesong,0,1,0,0
1683341250693,NANO 114,A00,202069,Jahed Motlagh; Zeinab,3,0,10,7
1683341251718,PHIL 1,A00,186955,Grush; Rick Scott,32,0,40,8
1683341252747,PHIL 10,A01,186973,Grush; Rick Scott,28,0,35,7
1683341252747,PHIL 10,A02,186974,Grush; Rick Scott,33,0,35,2
1683341253771,PHIL 13,A01,186976,Staff,7,0,35,28
1683341253771,PHIL 13,A02,186977,Staff,16,0,35,19
1683341254800,PHIL 14,A01,186979,Staff,31,0,35,4
1683341254800,PHIL 14,A02,186986,Staff,32,0,35,3
1683341255828,PHIL 28,A01,186988,Staff,16,0,30,14
1683341255828,PHIL 28,A02,186989,Staff,1,0,30,29
1683341255828,PHIL 28,A03,186990,Staff,9,0,30,21
1683341255828,PHIL 28,A04,186991,Staff,26,0,30,4
1683341256853,PHIL 120,A00,186997,Staff,23,0,40,17
1683341257876,PHIL 137,A00,187003,Staff,9,0,40,31
1683341258900,PHIL 150,A00,187015,Staff,47,0,70,23
1683341259925,PHIL 167,A00,187021,Lamey; Andy M.,35,0,40,5
1683341260950,PHIL 174,A01,202226,Staff,17,0,20,3
1683341260950,PHIL 174,A02,202235,Staff,20,0,20,0
1683341261975,PHIL 191A,A00,258918,Staff,0,0,1,1
1683341262999,PHYS 1A,A00,187028,Staff,27,0,60,33
1683341264025,PHYS 1AL,001,187036,Staff,2,0,30,28
1683341264025,PHYS 1AL,002,187049,Staff,18,0,30,12
1683341265053,PHYS 1B,A00,187058,Staff,22,0,60,38
1683341266079,PHYS 1BL,001,187064,Staff,0,0,30,30
1683341266079,PHYS 1BL,002,187070,Staff,5,0,30,25
1683341267103,PHYS 1C,A00,187082,Staff,31,0,120,89
1683341268127,PHYS 1CL,001,187088,Staff,0,9,30,30
1683341268127,PHYS 1CL,002,187089,Staff,0,2,30,30
1683341268127,PHYS 1CL,009,262693,Staff,11,0,30,19
1683341269155,PHYS 2B,A01,187097,Staff,54,0,115,61
1683341270180,PHYS 2C,A01,187099,Staff,67,0,115,48
1683341271205,PHYS 2CL,A01,187101,Staff,5,0,28,23
1683341271205,PHYS 2CL,A02,187102,Staff,15,0,28,13
1683341272230,PHYS 2D,A01,187123,Shotwell; Brian,95,0,115,20
1683341273256,PHYS 4B,A01,187133,Grinstein; Benjamin,35,0,50,15
1683341274280,POLI 10,A00,188819,Staff,0,4,50,50
1683341275303,POLI 11,A00,188827,Staff,43,0,50,7
1683341276330,POLI 13R,A00,188828,Staff,0,1,20,20
1683341277354,POLI 27,A01,188830,Elgin; Samuel Zincke,0,1,70,70
1683341278377,POLI 30,A00,188832,Desposato; Scott,31,0,50,19
1683341279401,POLI 102F,A00,188834,Staff,3,0,40,37
1683341280430,POLI 104A,A00,188852,Staff,14,0,30,16
1683341281454,POLI 104I,A00,188853,Staff,0,6,20,20
1683341282479,POLI 110B,A00,188854,Wiens; David,7,0,20,13
1683341283507,POLI 112A,A00,188855,Wiens; David,5,0,30,25
1683341284533,POLI 117R,A00,188856,Forman; Fonna,0,11,20,20
1683341285561,POLI 118,A00,188857,Ingham; Sean,8,0,20,12
1683341286587,POLI 120G,A00,188858,Staff,9,0,30,21
1683341287612,POLI 131CR,A00,188863,Hoston; Germaine,24,0,50,26
1683341288643,POLI 133,A00,188864,Nellis; Gareth Hb,44,0,50,6
1683341289668,POLI 134D,A00,188865,Desposato; Scott,27,0,30,3
1683341290693,POLI 142A,A00,188871,Gartzke; Erik,22,0,50,28
1683341291716,POLI 142K,A00,188874,Staff,38,0,50,12
1683341292745,POLI 143,A00,188940,Gartzke; Erik,16,0,30,14
1683341293772,POLI 153,A00,188943,Staff,3,0,20,17
1683341294797,POLI 160AA,A00,188944,Staff,12,0,40,28
1683341295824,POLI 170A,A00,188945,Staff,11,0,30,19
1683341297876,PSYC 1,A00,188952,Staff,37,0,90,53
1683341298901,PSYC 2,B00,188953,Staff,19,0,35,16
1683341299927,PSYC 6,A00,188970,Staff,47,0,60,13
1683341300955,PSYC 7,A00,188973,Staff,37,0,45,8
1683341301980,PSYC 60,A01,188980,Rickard; Timothy C.,43,0,60,17
1683341303005,PSYC 70,A01,189001,Steiner; Eric Tomas,23,0,45,22
1683341304029,PSYC 100,A00,189005,Lacefield; Katharine I,0,98,120,120
1683341305054,PSYC 102,A00,189008,Staff,9,0,30,21
1683341306078,PSYC 106,B00,189026,Gorman; Michael R.,34,0,60,26
1683341307103,PSYC 114,B01,189033,Winkielman; Piotr,0,32,30,30
1683341308131,PSYC 131,A00,189036,Anagnostaras; Stephan,0,43,60,60
1683341309155,PSYC 136,A00,189041,Lowe; Angela Beth,0,7,25,25
1683341310178,PSYC 137,A00,189057,Winkielman; Piotr,0,34,25,25
1683341311212,PSYC 144,A00,189107,Wixted; John T,0,7,50,50
1683341313266,PSYC 162,A00,189142,Staff,0,8,85,85
1683341314291,PSYC 172,A00,189144,Gorman; Michael R.,0,7,30,30
1683341316338,PSYC 179,A00,189146,Lacefield; Katharine I,0,84,120,120
1683341317364,PSYC 181,A00,189147,Anagnostaras; Stephan,0,44,90,90
1683341318392,PSYC 190R,A00,189148,Barner; David A.,0,22,80,80
1683341319417,PSYC 191,A00,189275,Rickard; Timothy C.,0,7,25,25
1683341320445,PSYC 193,A00,189276,Chapman; Eddie Nathaniel,0,1,0,4
1683341321470,PSYC 193L,A01,189281,Lowe; Angela Beth,12,0,20,8
1683341321470,PSYC 193L,B01,189285,Staff,28,0,35,7
1683341322492,RELI 149,A00,187137,Rahimi; Babak,7,0,40,33
1683341323517,SE 9,A01,187315,Staff,0,2,18,18
1683341324542,SE 101B,A00,187409,Staff,24,0,30,6
1683341325566,SE 110B,A00,187444,Staff,10,0,40,30
1683341326590,SE 130B,A00,187449,Staff,31,0,40,9
1683341327618,SE 150A,A00,187516,Staff,9,0,20,11
1683341328645,SE 154,A00,187528,Staff,30,0,50,20
1683341329671,SIO 3,A01,258171,Staff,35,0,40,5
1683341330698,SIO 10,A00,187144,Cook; Geoffrey W,0,3,75,75
1683341331725,SIO 45,A00,187152,Cook; Geoffrey W,1,0,100,99
1683341332752,SIO 109R,A00,194486,Staff,0,3,20,20
1683341334804,SIO 187,A01,187233,Kacev; David,12,0,40,28
1683341335834,SOCI 1,A01,258656,Thorpe; Charles Robert,28,0,30,2
1683341335834,SOCI 1,A02,258658,Thorpe; Charles Robert,30,0,30,0
1683341335834,SOCI 1,A03,258661,Thorpe; Charles Robert,25,0,25,0
1683341335834,SOCI 1,A04,258666,Thorpe; Charles Robert,22,0,25,3
1683341335834,SOCI 1,A05,258897,Thorpe; Charles Robert,23,0,25,2
1683341335834,SOCI 1,A06,258898,Thorpe; Charles Robert,25,0,25,0
1683341336858,SOCI 30,A01,258903,Pardo Guerra; Juan Pablo,15,0,30,15
1683341337883,SOCI 102,A00,258904,Staff,9,0,25,16
1683341338911,SOCI 106,A00,258905,Staff,19,0,25,6
1683341339934,SOCI 111,A00,258907,Ribas Norris; Janet Vanesa,26,0,30,4
1683341340958,SOCI 121R,A00,258908,Pardo Guerra; Juan Pablo,10,0,30,20
1683341341987,SOCI 126,A01,203330,Staff,14,0,20,6
1683341343013,SOCI 131,A00,258909,Thorpe; Charles Robert,31,0,60,29
1683341344094,SOCI 135,A00,258910,Payne; Christine Anna,0,9,30,30
1683341345118,SOCI 157,A00,258911,Staff,12,0,30,18
1683341346143,SOCI 184,A00,258912,Staff,25,0,30,5
1683341347166,SOCI 188D,A00,258913,Staff,21,0,30,9
1683341348191,SYN 2,001,187529,Staff,10,0,16,6
1683341348191,SYN 2,002,201452,Staff,0,18,16,16
1683341348191,SYN 2,003,201469,Staff,3,0,16,13
1683341349217,SYN 100,A01,187531,Staff,0,9,20,20
1683341349217,SYN 100,B01,201491,Staff,0,12,20,20
1683341350240,TDAC 1,A00,189286,Walsh; Kim C.,3,0,20,17
1683341350240,TDAC 1,B00,189287,Harting; Carla Kelso,11,0,20,9
1683341351265,TDAC 101,A00,189300,Walsh; Kim C.,16,0,20,4
1683341351265,TDAC 101,B00,189301,Harting; Carla Kelso,18,0,20,2
1683341352289,TDAC 102,A00,189304,Basso; Beatrice,14,0,20,6
1683341353313,TDAC 108,A00,189305,Staff,18,0,20,2
1683341354337,TDDE 131,A00,189310,Staff,19,0,20,1
1683341354337,TDDE 131,B00,189314,Staff,19,0,20,1
1683341354337,TDDE 131,C00,189315,Staff,48,0,50,2
1683341354337,TDDE 131,D00,189316,Staff,14,0,15,1
1683341354337,TDDE 131,E00,204841,Staff,20,0,20,0
1683341355361,TDGE 10,A00,189289,Staff,30,0,50,20
1683341355361,TDGE 10,B00,189290,Havis; Allan,1,0,50,49
1683341356386,TDGE 11,A00,189291,Fulton; Julia,0,3,50,50
1683341356386,TDGE 11,B00,189292,Staff,20,0,25,5
1683341356386,TDGE 11,C00,260270,Staff,0,0,0,0
1683341357410,TDGE 25,A00,189294,Staff,3,0,20,17
1683341358434,TDGE 124,A00,189318,Fulton; Julia,0,8,50,50
1683341359462,TDGE 125,A00,189319,Staff,13,0,25,12
1683341359462,TDGE 125,B00,189320,Staff,23,0,25,2
1683341360490,TDGE 127,A00,189322,Havis; Allan,0,0,50,50
1683341361516,TDHT 101,A00,189323,Staff,18,0,25,7
1683341361516,TDHT 101,B00,189324,Staff,25,0,25,0
1683341362543,TDHT 102,A00,189325,Staff,49,0,50,1
1683341363568,TDMV 1,A00,189295,Arcidiacono; Kristin,19,0,30,11
1683341363568,TDMV 1,B00,189296,Caligagan; Maria T.,24,0,30,6
1683341364596,TDMV 2,A00,189297,Sammartano; Tonnie,28,0,30,2
1683341364596,TDMV 2,B00,189299,Arcidiacono; Kristin,24,0,30,6
1683341365622,TDMV 3,A00,204998,Rincon; Alicia,22,0,30,8
1683341366651,TDMV 120,A00,189458,Sammartano; Tonnie,28,0,30,2
1683341367679,TDMV 138,A00,189541,Jun; Grace Shin Hae,22,0,40,18
1683341368705,TDMV 142,A00,189717,Caligagan; Tony,23,0,30,7
1683341368705,TDMV 142,B00,189718,Caligagan; Maria T.,25,0,30,5
1683341369733,TMC 2,A01,187533,Staff,25,0,25,0
1683341369733,TMC 2,A02,187534,Staff,25,0,25,0
1683341370757,USP 1,A01,187536,Kwak; Nancy,0,16,25,25
1683341371782,USP 5,A01,187538,Staff,10,0,25,15
1683341372807,USP 101,A00,199253,Staff,0,4,0,0
1683341373830,USP 124,A00,187562,Boomhower; Matthew Charles,1,0,30,29
1683341374855,USP 138,A00,187582,Staff,20,0,25,5
1683341375877,USP 152,A01,187597,Staff,4,0,25,21
1683341376900,USP 153,A00,187598,Staff,19,0,25,6
1683341377924,USP 168,A00,187607,Kwak; Nancy,2,0,5,3
1683341378947,USP 173,A00,187619,Staff,4,0,25,21
1683341379974,USP 181,A00,187638,Staff,0,0,25,25
1683341380999,VIS 103,A00,187650,Cruz; Edwin Teddy,23,0,75,52
1683341382029,VIS 110D,A00,187669,Staff,12,0,22,10
1683341383057,VIS 127C,A00,187720,Shen; Kuiyi,67,0,146,79
1683341384085,VIS 149,A00,187731,Yoldas; Pinar,0,14,22,22
1683341385111,VIS 151,A01,188091,Staff,22,0,34,12
1683341385111,VIS 151,A02,188092,Staff,11,0,34,23
1683341386136,VIS 160B,A00,188093,Stalbaum; Brett,0,0,10,10
1683341388185,WCWP 10B,A00,201720,Staff,10,0,15,5
1683341388185,WCWP 10B,B00,201722,Staff,9,0,15,6
1683341389212,WCWP 100,A00,201725,Gagnon; Jeffrey C,0,0,2,2
1683341389212,WCWP 100,B00,201727,Staff,0,4,15,15
1683341392306,ANBI 133,A00,258401,Wilder; Linnea Lorene,34,0,40,6
1683341393331,ANBI 140,A00,258395,Hrvoj Mihic; Branka,18,0,25,7
1683341394356,ANSC 120,A00,258402,Bialecki; Jon Anthony,27,0,40,13
1683341395384,ANSC 144,A00,258400,Staff,14,0,40,26
1683341397435,ANSC 166,A00,258396,Parish; Steven Martin,157,0,175,18
1683341398458,ANSC 180,A00,193533,Staff,9,0,20,11
1683341399481,ANSC 188,A00,258397,Jassal; Aftab,33,0,40,7
1683341400507,ANTH 3,A01,258316,Staff,23,0,30,7
1683341401539,ANTH 5,A00,258394,Semendeferi; Ekaterini,16,0,20,4
1683341402563,ANTH 21,A01,258331,Staff,8,0,40,32
1683341403591,ANTH 103,A00,258398,Varma; Saiba,15,0,25,10
1683341404619,AWP 10,001,202034,Staff,0,0,0,0
1683341404619,AWP 10,002,202035,Staff,0,0,0,0
1683341404619,AWP 10,003,202036,Staff,0,0,0,0
1683341404619,AWP 10,004,202037,Staff,0,0,0,0
1683341404619,AWP 10,005,202038,Staff,0,0,0,0
1683341404619,AWP 10,006,202039,Staff,0,0,0,0
1683341404619,AWP 10,007,202040,Staff,0,0,0,0
1683341404619,AWP 10,008,202041,Staff,0,0,0,0
1683341404619,AWP 10,009,202042,Staff,0,0,0,0
1683341404619,AWP 10,010,202043,Staff,0,0,0,0
1683341404619,AWP 10,011,202044,Staff,0,0,0,0
1683341404619,AWP 10,012,202045,Staff,0,0,0,0
1683341404619,AWP 10,013,202046,Staff,0,0,0,0
1683341404619,AWP 10,014,202047,Staff,0,0,0,0
1683341404619,AWP 10,015,202048,Staff,0,0,0,0
1683341404619,AWP 10,016,202049,Staff,0,0,0,0
1683341404619,AWP 10,017,202050,Staff,0,0,0,0
1683341404619,AWP 10,018,202051,Staff,0,0,0,0
1683341404619,AWP 10,019,202052,Staff,0,0,0,0
1683341404619,AWP 10,020,202053,Staff,0,0,0,0
1683341404619,AWP 10,021,202054,Staff,0,0,0,0
1683341404619,AWP 10,022,202055,Staff,0,0,0,0
1683341404619,AWP 10,023,202056,Staff,0,0,0,0
1683341404619,AWP 10,024,202057,Staff,0,0,0,0
1683341404619,AWP 10,025,202058,Staff,0,0,0,0
1683341404619,AWP 10,026,202059,Staff,0,0,0,0
1683341405644,AWP 102,001,202032,Staff,0,0,0,0
1683341405644,AWP 102,002,202033,Staff,0,0,0,0
1683341406669,BENG 100,A01,254234,Taylor Amos; Alyssa C,31,0,40,9
1683341407692,BENG 196,001,270013,Engler; Adam J.,9999,0,9999,0
1683341408718,BICD 100R,A01,202018,Smith; Laurie,0,7,32,32
1683341408718,BICD 100R,A02,202019,Smith; Laurie,0,2,32,32
1683341408718,BICD 100R,A03,202020,Smith; Laurie,0,1,32,32
1683341408718,BICD 100R,A04,202021,Smith; Laurie,9,0,32,23
1683341408718,BICD 100R,A05,202022,Smith; Laurie,12,0,32,20
1683341409743,BICD 136,A01,193242,Gustafson-Brown; Cindy,0,2,32,32
1683341409743,BICD 136,A02,193244,Gustafson-Brown; Cindy,14,0,32,18
1683341410767,BIEB 102,A01,193249,Butler; Shannon Rhey,0,2,32,32
1683341410767,BIEB 102,A02,193251,Butler; Shannon Rhey,0,0,32,32
1683341410767,BIEB 102,A03,193253,Butler; Shannon Rhey,0,1,32,32
1683341410767,BIEB 102,A04,193255,Butler; Shannon Rhey,17,0,32,15
1683341410767,BIEB 102,A05,193265,Butler; Shannon Rhey,26,0,32,6
1683341410767,BIEB 102,A06,193269,Butler; Shannon Rhey,16,0,32,16
1683341412821,BIEB 150,A01,193274,Staff,0,0,32,32
1683341412821,BIEB 150,A02,193285,Staff,23,0,32,9
1683341413845,BIEB 194,A00,193286,Kurle; Carolyn M.,22,0,32,10
1683341414871,BILD 1,A01,192291,Staff,16,0,32,16
1683341414871,BILD 1,A02,192292,Staff,30,0,32,2
1683341414871,BILD 1,B01,192520,Reuther; Keefe,0,1,0,0
1683341414871,BILD 1,B02,192532,Reuther; Keefe,0,1,0,0
1683341415894,BILD 3,A01,192556,Butler; Shannon Rhey,0,0,32,32
1683341415894,BILD 3,A02,192581,Butler; Shannon Rhey,5,0,32,27
1683341415894,BILD 3,A03,192611,Butler; Shannon Rhey,23,0,32,9
1683341415894,BILD 3,A04,192612,Butler; Shannon Rhey,25,0,32,7
1683341415894,BILD 3,A05,192613,Butler; Shannon Rhey,27,0,32,5
1683341415894,BILD 3,A06,192679,Butler; Shannon Rhey,27,0,32,5
1683341415894,BILD 3,A07,192682,Butler; Shannon Rhey,22,0,32,10
1683341416918,BILD 4,A01,192836,Reuther; Keefe,0,0,24,24
1683341416918,BILD 4,A02,193044,Reuther; Keefe,4,0,24,20
1683341417943,BILD 10,A01,193142,Gustafson-Brown; Cindy,30,0,32,2
1683341417943,BILD 10,A02,193149,Gustafson-Brown; Cindy,31,0,32,1
1683341418966,BIMM 100,A01,193301,Staff,0,6,32,32
1683341418966,BIMM 100,A02,193312,Staff,0,5,32,32
1683341418966,BIMM 100,A03,193323,Staff,0,8,32,32
1683341419991,BIMM 101,A01,193329,McDonnell; Lisa Marie,0,3,24,24
1683341419991,BIMM 101,A02,193339,McDonnell; Lisa Marie,0,3,24,24
1683341419991,BIMM 101,B01,193354,McDonnell; Lisa Marie,0,3,24,24
1683341419991,BIMM 101,B02,193357,McDonnell; Lisa Marie,0,3,24,24
1683341421018,BIMM 110,A01,193377,Tat; John,0,11,32,32
1683341421018,BIMM 110,A02,193378,Tat; John,1,9,32,31
1683341422046,BIMM 120,A01,206116,Staff,0,0,32,32
1683341422046,BIMM 120,A02,206117,Staff,8,0,32,24
1683341422046,BIMM 120,A03,206121,Staff,21,0,32,11
1683341423069,BIPN 100,A01,193393,Park; Ji Young,0,14,32,32
1683341423069,BIPN 100,A02,193402,Park; Ji Young,0,13,32,32
1683341423069,BIPN 100,A03,193413,Park; Ji Young,0,14,32,32
1683341423069,BIPN 100,A04,193414,Park; Ji Young,0,13,32,32
1683341424095,BIPN 102,A01,193429,Staff,0,0,32,32
1683341424095,BIPN 102,A02,193438,Staff,22,0,32,10
1683341425118,BIPN 106,A01,193450,Reyes Gonzalez; Catalina,0,2,40,40
1683341426143,BIPN 134,A01,193465,Cooke; James Edward,0,0,32,32
1683341426143,BIPN 134,A02,193474,Cooke; James Edward,25,0,32,7
1683341426143,BIPN 134,A03,193485,Cooke; James Edward,29,0,32,3
1683341426143,BIPN 134,A04,193486,Cooke; James Edward,21,0,32,11
1683341426143,BIPN 134,A05,193491,Cooke; James Edward,31,0,32,1
1683341426143,BIPN 134,A06,193501,Cooke; James Edward,30,0,32,2
1683341426143,BIPN 134,A07,193510,Cooke; James Edward,29,0,32,3
1683341428193,BISP 194,A00,222522,Staff,14,0,32,18
1683341429222,CAT 124,A01,202407,Staff,20,0,25,5
1683341430245,CAT 125,A00,202408,Marchisotto; Jennifer Anne,4,0,20,16
1683341431274,CAT 125R,A00,202409,Smith; Lauryn Alissa,0,11,20,20
1683341431274,CAT 125R,B00,202410,Morales; Celeste Georgianna,0,11,20,20
1683341431274,CAT 125R,C00,202411,Irwin; Matthew Joseph,0,10,20,20
1683341432301,CENG 15,A01,204712,Yang; Kesong,0,1,0,0
1683341433327,CENG 114,A00,202070,Jahed Motlagh; Zeinab,5,0,20,15
1683341434350,CGS 105,A00,185477,Wesling; Megan E.,24,0,40,16
1683341435374,CGS 106,A00,185494,Staff,13,0,22,9
1683341436398,CGS 108,A00,185495,Staff,14,0,20,6
1683341437422,CGS 114,A00,185496,Staff,13,0,18,5
1683341438450,CGS 119,A00,185501,Staff,15,0,20,5
1683341439474,CGS 120,A00,185511,Staff,13,0,20,7
1683341440499,CHEM 4,A01,184675,Bussey; Thomas J,96,0,100,4
1683341441529,CHEM 6A,A01,184677,Staff,34,0,60,26
1683341442556,CHEM 6B,A01,184679,Staff,65,0,100,35
1683341443580,CHEM 6C,A01,184681,Bussey; Thomas J,1,0,50,49
1683341443580,CHEM 6C,A02,184682,Bussey; Thomas J,34,0,50,16
1683341444605,CHEM 40A,A01,184684,Albizati; Kim F.,37,0,100,63
1683341445629,CHEM 40B,A01,184686,Albizati; Kim F.,0,20,100,100
1683341446654,CHEM 41B,A01,184690,Staff,52,0,100,48
1683341447734,COGS 3,A01,184715,Boyle; Mary E. T.,0,25,40,40
1683341448759,COGS 14B,A01,185172,Staff,0,15,38,38
1683341449784,COGS 18,A01,184736,Staff,17,0,80,63
1683341450808,COGS 100,A01,184932,Staff,0,5,73,73
1683341451833,COGS 101A,A01,184935,Staff,0,39,30,30
1683341452858,COGS 101B,A01,184944,Staff,0,2,30,30
1683341453883,COGS 101C,A01,184946,Staff,0,12,30,30
1683341454908,COGS 102A,A01,184951,Johnson; Christine M.,2,0,40,38
1683341455936,COGS 107B,A01,184953,Mooshagian; Eric Frederick,0,50,40,40
1683341456962,COGS 118B,A01,184959,Gupta; Anjum,0,48,40,40
1683341457987,COGS 153,A00,184961,Staff,0,15,30,30
1683341459012,COGS 177,A00,184962,Staff,0,20,30,30
1683341460038,COGS 187A,A01,184969,Boyle; Mary E. T.,0,17,40,40
1683341461062,COMM 10,A01,185174,Staff,0,5,25,25
1683341461062,COMM 10,A02,185189,Staff,0,5,25,25
1683341461062,COMM 10,A03,269821,Staff,0,0,0,0
1683341462091,COMM 100B,A01,185475,Staff,0,0,0,2
1683341462091,COMM 100B,A02,185476,Staff,13,0,25,12
1683341463118,COMM 100C,A01,185314,Staff,1,0,25,24
1683341463118,COMM 100C,A02,185327,Staff,19,0,25,6
1683341464142,COMM 110M,A00,185349,Staff,2,0,40,38
1683341465170,COMM 113T,A00,185352,Staff,24,0,40,16
1683341466197,COMM 114I,A00,185353,Staff,33,0,40,7
1683341467223,COMM 131,A00,185354,Staff,19,0,30,11
1683341468247,CSE 8A,A50,185358,Cao; Yingjun,0,46,10,10
1683341469271,CSE 8B,A01,185362,Staff,1,47,50,49
1683341470296,CSE 11,A01,185416,Cao; Yingjun,0,92,10,10
1683341471324,CSE 20,A01,185445,Briones; Jor-el Thomas Caparas,5,0,25,20
1683341472353,CSE 21,A01,185447,Staff,10,0,50,40
1683341473382,CSE 101,A01,185451,Staff,0,13,50,50
1683341473382,CSE 101,B01,185453,Jones; Miles E,0,11,50,50
1683341475433,CSE 141,A01,185458,Eldon; John,20,0,100,80
1683341476458,CSE 141L,A01,185461,Eldon; John,12,0,100,88
1683341477483,CSE 142,A01,185463,Staff,36,0,60,24
1683341477483,CSE 142,B01,201355,Staff,0,7,60,60
1683341478509,CSE 142L,A01,185470,Staff,36,0,60,24
1683341478509,CSE 142L,B01,201417,Staff,0,6,60,60
1683341479533,CSE 190,A00,201433,Staff,32,0,49,17
1683341480558,DOC 1,A01,259136,Strom; Megan C.,7,0,15,8
1683341480558,DOC 1,A02,259137,Strom; Megan C.,14,0,15,1
1683341480558,DOC 1,A03,259138,Strom; Megan C.,14,0,15,1
1683341480558,DOC 1,A04,259139,Strom; Megan C.,14,0,15,1
1683341481583,DOC 100D,A00,259140,Pass; Natalye Joann,16,0,25,9
1683341482612,DSGN 1,A01,184749,Rill; Bryan,0,25,30,30
1683341483642,DSGN 100,A01,185168,Staff,0,2,25,25
1683341484670,ECE 5,A01,185626,Morris; Karcher William,0,10,0,0
1683341485694,ECE 101,A01,185628,Staff,17,0,70,53
1683341486720,ECE 107,A01,185635,Baghdadchi; Saharnaz,0,0,20,20
1683341486720,ECE 107,A02,185638,Baghdadchi; Saharnaz,4,0,20,16
1683341487748,ECE 148,A01,185647,Silberman; Jack,0,0,16,16
1683341488774,ECON 1,A01,185537,Crane; Meredith Helen,54,0,70,16
1683341489802,ECON 3,A01,185549,Crane; Meredith Helen,32,0,70,38
1683341490829,ECON 4,A01,203354,Anderson; John Charles,0,4,10,10
1683341491854,ECON 100A,A01,185574,Staff,0,4,40,40
1683341492879,ECON 100B,A01,185576,Staff,10,22,50,40
1683341493903,ECON 100C,A01,185589,Newhouse; Herbert S,30,0,70,40
1683341494929,ECON 105,A00,185608,Vespa; Emanuel Ignacio,19,0,35,16
1683341495953,ECON 109,A01,185610,Shishkin; Denis,10,0,35,25
1683341496980,ECON 110A,A01,185612,Staff,11,0,40,29
1683341498008,ECON 120A,A01,185615,Staff,20,0,40,20
1683341499034,ECON 120C,A01,185617,Sun; Yixiao,0,20,70,70
1683341500059,ECON 144,A00,203346,Squires; Dale E,3,0,35,32
1683341501083,ECON 171,A01,203349,Newhouse; Herbert S,0,1,35,35
1683341502112,ECON 173A,A01,185621,Toda; Alexis Akira,21,0,35,14
1683341503136,EDS 25,A01,202413,Staff,0,1,0,0
1683341503136,EDS 25,A02,202414,Staff,0,1,0,0
1683341503136,EDS 25,A03,202415,Staff,0,0,0,0
1683341503136,EDS 25,A04,202416,Staff,0,1,0,0
1683341503136,EDS 25,A05,202439,Staff,0,0,0,0
1683341503136,EDS 25,A06,202440,Staff,0,0,0,0
1683341503136,EDS 25,B01,202631,Staff,0,0,0,0
1683341503136,EDS 25,B02,202632,Staff,0,0,0,0
1683341503136,EDS 25,B03,202639,Staff,0,0,0,0
1683341503136,EDS 25,B04,202640,Staff,0,0,0,0
1683341503136,EDS 25,B05,202643,Staff,0,0,0,0
1683341503136,EDS 25,B06,202644,Staff,0,0,0,0
1683341504160,EDS 38,A01,202659,Black; Alison Michelle,24,0,25,1
1683341505187,EDS 115,A00,202652,Staff,18,0,30,12
1683341506212,EDS 125,A00,202649,Staff,14,0,30,16
1683341507240,EDS 126,A01,203332,Staff,30,0,30,0
1683341508264,EDS 139,A00,202838,Staff,16,0,25,9
1683341509289,EDS 146,A01,202655,Staff,14,0,25,11
1683341510319,ENG 15,A00,185667,Staff,0,1,0,0
1683341510319,ENG 15,B00,185672,Staff,0,0,0,0
1683341510319,ENG 15,C00,185675,Staff,0,0,0,0
1683341510319,ENG 15,D00,185682,Staff,0,0,0,0
1683341510319,ENG 15,E00,185684,Staff,0,0,0,0
1683341511343,ETHN 103,A00,185710,Staff,0,4,35,35
1683341512368,ETHN 103A,A00,199228,Man; Simeon S,2,0,9,7
1683341513393,ETHN 109,A00,185711,Staff,18,0,35,17
1683341514420,ETHN 142,A00,185726,Staff,0,4,30,30
1683341515447,ETHN 163J,A00,199229,Man; Simeon S,5,0,8,3
1683341516475,ETHN 168,A00,185727,Staff,8,0,10,2
1683341517500,ETHN 182,A00,185728,Staff,1,0,35,34
1683341518526,ETHN 183,A00,185737,Staff,8,0,18,10
1683341519549,GLBH 111,A01,209361,Burgos; Jose L.,0,0,0,0
1683341521599,HIEU 104,A00,185792,Staff,16,0,20,4
1683341522627,HIEU 115,A00,185800,Staff,1,0,20,19
1683341523654,HIEU 128,A00,185801,Staff,0,7,20,20
1683341524684,HIEU 147,A00,185802,Staff,16,0,20,4
1683341525708,HIEU 154,A00,185823,Staff,12,0,20,8
1683341526733,HILA 102,A00,185826,Staff,13,0,20,7
1683341527760,HILD 2C,A01,185778,Staff,0,12,20,20
1683341528788,HILD 7B,A01,185780,Kwak; Nancy,0,15,32,32
1683341528788,HILD 7B,A02,185781,Kwak; Nancy,0,18,32,32
1683341529814,HILD 30,A01,185791,Staff,14,0,20,6
1683341530842,HISC 119,A00,185830,Golan; Tal,0,9,20,20
1683341531870,HITO 156GS,A00,185831,Patterson; Patrick H.,0,0,0,23
1683341532898,HIUS 103,A00,185832,Man; Simeon S,0,6,20,20
1683341533926,HIUS 117,A00,185836,Kwak; Nancy,2,0,20,18
1683341534951,HIUS 125,A00,185840,Man; Simeon S,0,0,23,23
1683341535978,HIUS 149,A00,185845,Staff,0,0,20,20
1683341537010,HUM 3,A01,185882,Zavodny; Tatiana Sophia,0,7,50,50
1683341537010,HUM 3,B01,185899,Caldwell; Michael Alan,0,18,50,50
1683341538035,HUM 3GS,A00,185900,Patterson; Patrick H.,0,0,0,23
1683341539060,HUM 4,A01,185938,Zroka; Amy Liane,31,0,50,19
1683341539060,HUM 4,B01,185956,Watkins; Eric,0,2,50,50
1683341539060,HUM 4,B02,202209,Watkins; Eric,0,2,50,50
1683341539060,HUM 4,B03,202210,Watkins; Eric,0,2,50,50
1683341540085,HUM 5,A01,185958,West; Geoffrey Scott,3,0,50,47
1683341540085,HUM 5,A02,202215,West; Geoffrey Scott,0,0,50,50
1683341541110,INTL 190,A00,185959,Gagnon; Jeffrey C,0,0,0,9
1683341541110,INTL 190,B00,185960,Lettieri; Michael Joseph,0,0,0,1
1683341542135,JAPN 180,A00,254509,Staff,5,1,30,25
1683341543160,LATI 10,A01,202853,Kennemore; Amy Michelle,4,0,35,31
1683341543160,LATI 10,A02,202854,Kennemore; Amy Michelle,2,0,35,33
1683341543160,LATI 10,A03,270054,Kennemore; Amy Michelle,30,0,30,0
1683341544185,LATI 180,A00,202855,Kennemore; Amy Michelle,11,0,20,9
1683341545208,LAWS 101,A00,201767,Golan; Tal,0,7,40,40
1683341546235,LIFR 1C,A00,185961,Staff,6,0,20,14
1683341547260,LIFR 1CX,A00,185962,Staff,7,0,20,13
1683341548283,LIFR 1D,A00,185963,Staff,9,0,20,11
1683341549307,LIFR 1DX,A00,185964,Staff,9,0,20,11
1683341550335,LIGN 101,A01,186039,Staff,43,0,50,7
1683341551417,LIGN 165,A00,186040,Staff,18,0,50,32
1683341552444,LTCS 108,A00,186041,Staff,6,0,10,4
1683341553470,LTCS 119,A00,186042,Staff,16,0,20,4
1683341554494,LTCS 130,A00,186043,Wesling; Megan E.,15,0,25,10
1683341556546,LTEA 138,A00,186119,Staff,14,0,40,26
1683341557571,LTEN 124,A00,186148,Staff,6,0,25,19
1683341558596,LTEN 178,A00,186149,Staff,7,0,15,8
1683341559624,LTEN 181,A00,186150,Blanco; John D,33,0,40,7
1683341560651,LTWL 120,A00,186160,Staff,20,0,25,5
1683341561677,LTWL 165,A00,186161,Staff,22,0,25,3
1683341562704,LTWR 100,A00,186162,Staff,0,5,15,15
1683341563731,LTWR 102,A00,186163,Doller; Ben,5,0,15,10
1683341564758,MAE 8,A01,186412,Staff,0,0,0,0
1683341565784,MAE 30B,A00,186445,Bahadori; Mohammad Yousef,83,0,100,17
1683341566806,MAE 40,A00,186592,Bewley; Thomas R,9,0,50,41
1683341567831,MAE 101B,A00,186593,Bahadori; Mohammad Yousef,81,0,100,19
1683341568855,MAE 105,A00,186594,Bandaru; Prabhakar,12,0,50,38
1683341569884,MAE 107,A00,186599,Pham; Hieu Tan,0,6,120,120
1683341570911,MAE 148,A01,186660,Silberman; Jack,3,0,16,13
1683341571935,MATH 10A,A01,188095,Staff,1,6,35,34
1683341572959,MATH 10B,A01,188097,Bowers; Adam R.,0,11,30,30
1683341572959,MATH 10B,A02,188099,Bowers; Adam R.,0,11,30,30
1683341572959,MATH 10B,B01,188104,Bowers; Adam R.,0,10,30,30
1683341572959,MATH 10B,B02,188106,Bowers; Adam R.,0,10,30,30
1683341573983,MATH 10C,A01,188111,Staff,0,18,30,30
1683341573983,MATH 10C,A02,188127,Staff,0,17,30,30
1683341573983,MATH 10C,A03,188131,Staff,0,18,30,30
1683341573983,MATH 10C,B01,188218,Staff,18,0,30,12
1683341573983,MATH 10C,B02,188244,Staff,13,0,30,17
1683341573983,MATH 10C,B03,188277,Staff,16,0,30,14
1683341575012,MATH 18,A01,188344,Bach; Quang Tran,18,0,30,12
1683341575012,MATH 18,A02,188345,Bach; Quang Tran,11,0,30,19
1683341575012,MATH 18,B01,188353,Bach; Quang Tran,10,0,30,20
1683341575012,MATH 18,B02,188354,Bach; Quang Tran,20,0,30,10
1683341576041,MATH 20A,A01,188374,Staff,13,0,35,22
1683341577070,MATH 20B,A01,188382,Ohm; Ko Woon,6,0,30,24
1683341577070,MATH 20B,A02,188383,Ohm; Ko Woon,22,0,30,8
1683341577070,MATH 20B,B01,188385,Ohm; Ko Woon,7,0,30,23
1683341577070,MATH 20B,B02,188392,Ohm; Ko Woon,22,0,30,8
1683341578093,MATH 20C,A01,188394,Harel; Guershon,10,0,30,20
1683341578093,MATH 20C,A02,188395,Harel; Guershon,15,0,30,15
1683341578093,MATH 20C,B01,188404,Harel; Guershon,5,0,30,25
1683341578093,MATH 20C,B02,188405,Harel; Guershon,19,0,30,11
1683341579117,MATH 20D,A01,188414,Hammock; Frances H,0,1,30,30
1683341579117,MATH 20D,A02,188415,Hammock; Frances H,3,0,30,27
1683341579117,MATH 20D,B01,188447,Hammock; Frances H,1,0,30,29
1683341579117,MATH 20D,B02,188486,Hammock; Frances H,8,0,30,22
1683341580145,MATH 20E,A01,188649,Staff,21,0,30,9
1683341580145,MATH 20E,A02,188650,Staff,23,0,30,7
1683341580145,MATH 20E,A03,188673,Staff,0,0,30,30
1683341581168,MATH 102,A01,188675,Staff,0,35,35,35
1683341582198,MATH 103B,A01,188681,Staff,3,0,35,32
1683341582198,MATH 103B,B01,188692,Staff,5,0,35,30
1683341583223,MATH 109,A01,188695,Salehi Golsefidy; Alireza,25,0,35,10
1683341583223,MATH 109,A02,188696,Salehi Golsefidy; Alireza,25,0,35,10
1683341584248,MATH 120A,A01,188698,Eggers; John Dietrich,7,0,35,28
1683341585274,MATH 142B,A01,188736,Ioana; Adrian,0,2,30,30
1683341585274,MATH 142B,A02,188741,Ioana; Adrian,1,1,30,29
1683341585274,MATH 142B,A03,188743,Ioana; Adrian,1,3,30,29
1683341586300,MATH 168A,A01,188790,Staff,0,9,35,35
1683341587329,MATH 170A,A01,188803,Nie; Jiawang,0,2,35,35
1683341587329,MATH 170A,A02,188811,Nie; Jiawang,0,0,35,35
1683341587329,MATH 170A,A03,188814,Nie; Jiawang,1,0,35,34
1683341587329,MATH 170A,A04,188815,Nie; Jiawang,13,0,35,22
1683341588356,MATH 193B,A01,188817,Staff,0,0,35,35
1683341588356,MATH 193B,A02,188818,Staff,5,0,35,30
1683341589383,MGT 4,A01,202857,Anderson; John Charles,62,0,80,18
1683341590410,MGT 12,A00,202858,Lindenberger; Wade Douglas,42,0,90,48
1683341591434,MGT 18,A00,202859,Staff,74,0,90,16
1683341592461,MGT 18GS,A00,202860,McKay; Michael J,13,0,28,15
1683341593487,MGT 45,A00,202861,Pecore; Joseph P.,14,0,90,76
1683341594513,MGT 100,A00,202863,Yavorsky; Daniel Ryan,28,0,90,62
1683341595536,MGT 103,A00,202864,Ehrich; Kristine R,1,18,90,89
1683341596561,MGT 112,A00,202865,Ehrich; Kristine R,15,0,90,75
1683341597587,MGT 121A,A00,202868,Staff,0,20,0,0
1683341598611,MGT 131B,A00,202869,Anderson; John Charles,59,0,90,31
1683341599639,MGT 136,A00,202871,Lindenberger; Wade Douglas,84,0,90,6
1683341600664,MGT 164,A00,202873,Staff,0,68,90,91
1683341601692,MGT 164GS,A00,202874,McKay; Mary A,13,0,28,15
1683341602720,MGT 180,A00,202875,Staff,0,50,90,91
1683341603745,MMW 11R,A01,205019,Herbst; Matthew,3,0,30,27
1683341603745,MMW 11R,A02,205026,Herbst; Matthew,29,0,30,1
1683341604770,MMW 15,A01,193512,Chang; Edmond Yi-Teh,0,9,28,28
1683341604770,MMW 15,A02,193513,Chang; Edmond Yi-Teh,0,5,28,28
1683341604770,MMW 15,A03,193514,Chang; Edmond Yi-Teh,0,5,28,28
1683341604770,MMW 15,A04,193515,Chang; Edmond Yi-Teh,0,5,28,28
1683341604770,MMW 15,A05,193516,Chang; Edmond Yi-Teh,0,4,28,28
1683341604770,MMW 15,A06,193517,Chang; Edmond Yi-Teh,0,5,28,28
1683341604770,MMW 15,B01,193519,Chang; Edmond Yi-Teh,0,5,28,28
1683341604770,MMW 15,B02,193520,Chang; Edmond Yi-Teh,0,5,28,28
1683341604770,MMW 15,B03,193521,Chang; Edmond Yi-Teh,0,5,28,28
1683341604770,MMW 15,B04,193522,Chang; Edmond Yi-Teh,0,4,28,28
1683341604770,MMW 15,B05,193523,Chang; Edmond Yi-Teh,0,5,28,28
1683341604770,MMW 15,B06,193524,Chang; Edmond Yi-Teh,0,4,28,28
1683341605795,MMW 122,A01,193526,Rahimi; Babak,0,15,28,28
1683341605795,MMW 122,A02,193527,Rahimi; Babak,0,14,28,28
1683341605795,MMW 122,A03,193528,Rahimi; Babak,0,0,0,0
1683341605795,MMW 122,A04,193529,Rahimi; Babak,0,0,0,0
1683341606820,MUS 1A,A01,186663,Staff,0,20,35,35
1683341607846,MUS 4,A01,186715,Staff,0,12,35,35
1683341608870,MUS 5R,A01,186796,Dubnov; Shlomo,0,17,35,35
1683341609898,MUS 6,A01,186798,Staff,0,4,25,25
1683341610923,MUS 7,A01,186830,Staff,13,0,35,22
1683341611949,MUS 8,A01,186930,Staff,0,26,35,35
1683341612974,MUS 15,A01,186932,Staff,0,16,35,35
1683341612974,MUS 15,B01,186934,Staff,0,15,35,35
1683341614004,MUS 80,A00,186935,Staff,1,0,20,19
1683341614004,MUS 80,B00,186936,Staff,25,0,25,0
1683341615033,NANO 11,A00,204702,Lipomi; Darren John,0,0,0,0
1683341616058,NANO 15,A01,204709,Yang; Kesong,0,1,0,0
1683341617087,NANO 114,A00,202069,Jahed Motlagh; Zeinab,3,0,10,7
1683341618110,PHIL 1,A00,186955,Grush; Rick Scott,32,0,40,8
1683341619138,PHIL 10,A01,186973,Grush; Rick Scott,28,0,35,7
1683341619138,PHIL 10,A02,186974,Grush; Rick Scott,33,0,35,2
1683341620163,PHIL 13,A01,186976,Staff,7,0,35,28
1683341620163,PHIL 13,A02,186977,Staff,16,0,35,19
1683341621188,PHIL 14,A01,186979,Staff,31,0,35,4
1683341621188,PHIL 14,A02,186986,Staff,32,0,35,3
1683341622213,PHIL 28,A01,186988,Staff,16,0,30,14
1683341622213,PHIL 28,A02,186989,Staff,1,0,30,29
1683341622213,PHIL 28,A03,186990,Staff,9,0,30,21
1683341622213,PHIL 28,A04,186991,Staff,26,0,30,4
1683341623237,PHIL 120,A00,186997,Staff,23,0,40,17
1683341624261,PHIL 137,A00,187003,Staff,9,0,40,31
1683341625286,PHIL 150,A00,187015,Staff,47,0,70,23
1683341626315,PHIL 167,A00,187021,Lamey; Andy M.,35,0,40,5
1683341627341,PHIL 174,A01,202226,Staff,17,0,20,3
1683341627341,PHIL 174,A02,202235,Staff,20,0,20,0
1683341628365,PHIL 191A,A00,258918,Staff,0,0,1,1
1683341629393,PHYS 1A,A00,187028,Staff,27,0,60,33
1683341630416,PHYS 1AL,001,187036,Staff,2,0,30,28
1683341630416,PHYS 1AL,002,187049,Staff,18,0,30,12
1683341631442,PHYS 1B,A00,187058,Staff,22,0,60,38
1683341632468,PHYS 1BL,001,187064,Staff,0,0,30,30
1683341632468,PHYS 1BL,002,187070,Staff,5,0,30,25
1683341633492,PHYS 1C,A00,187082,Staff,31,0,120,89
1683341634517,PHYS 1CL,001,187088,Staff,0,9,30,30
1683341634517,PHYS 1CL,002,187089,Staff,0,2,30,30
1683341634517,PHYS 1CL,009,262693,Staff,11,0,30,19
1683341635543,PHYS 2B,A01,187097,Staff,54,0,115,61
1683341636569,PHYS 2C,A01,187099,Staff,67,0,115,48
1683341637594,PHYS 2CL,A01,187101,Staff,5,0,28,23
1683341637594,PHYS 2CL,A02,187102,Staff,15,0,28,13
1683341638619,PHYS 2D,A01,187123,Shotwell; Brian,95,0,115,20
1683341639646,PHYS 4B,A01,187133,Grinstein; Benjamin,35,0,50,15
1683341640671,POLI 10,A00,188819,Staff,0,4,50,50
1683341641695,POLI 11,A00,188827,Staff,43,0,50,7
1683341642720,POLI 13R,A00,188828,Staff,0,1,20,20
1683341643747,POLI 27,A01,188830,Elgin; Samuel Zincke,0,1,70,70
1683341644778,POLI 30,A00,188832,Desposato; Scott,31,0,50,19
1683341645802,POLI 102F,A00,188834,Staff,3,0,40,37
1683341646827,POLI 104A,A00,188852,Staff,14,0,30,16
1683341647852,POLI 104I,A00,188853,Staff,0,6,20,20
1683341648877,POLI 110B,A00,188854,Wiens; David,7,0,20,13
1683341649902,POLI 112A,A00,188855,Wiens; David,5,0,30,25
1683341650931,POLI 117R,A00,188856,Forman; Fonna,0,11,20,20
1683341651959,POLI 118,A00,188857,Ingham; Sean,8,0,20,12
1683341652986,POLI 120G,A00,188858,Staff,9,0,30,21
1683341654010,POLI 131CR,A00,188863,Hoston; Germaine,24,0,50,26
1683341655110,POLI 133,A00,188864,Nellis; Gareth Hb,44,0,50,6
1683341656137,POLI 134D,A00,188865,Desposato; Scott,27,0,30,3
1683341657164,POLI 142A,A00,188871,Gartzke; Erik,22,0,50,28
1683341658190,POLI 142K,A00,188874,Staff,38,0,50,12
1683341659214,POLI 143,A00,188940,Gartzke; Erik,16,0,30,14
1683341660242,POLI 153,A00,188943,Staff,3,0,20,17
1683341661267,POLI 160AA,A00,188944,Staff,12,0,40,28
1683341662291,POLI 170A,A00,188945,Staff,11,0,30,19
1683341664343,PSYC 1,A00,188952,Staff,37,0,90,53
1683341665367,PSYC 2,B00,188953,Staff,19,0,35,16
1683341666394,PSYC 6,A00,188970,Staff,47,0,60,13
1683341667417,PSYC 7,A00,188973,Staff,37,0,45,8
1683341668445,PSYC 60,A01,188980,Rickard; Timothy C.,43,0,60,17
1683341669477,PSYC 70,A01,189001,Steiner; Eric Tomas,23,0,45,22
1683341670502,PSYC 100,A00,189005,Lacefield; Katharine I,0,98,120,120
1683341671530,PSYC 102,A00,189008,Staff,9,0,30,21
1683341672555,PSYC 106,B00,189026,Gorman; Michael R.,34,0,60,26
1683341673579,PSYC 114,B01,189033,Winkielman; Piotr,0,32,30,30
1683341674603,PSYC 131,A00,189036,Anagnostaras; Stephan,0,43,60,60
1683341675630,PSYC 136,A00,189041,Lowe; Angela Beth,0,7,25,25
1683341676656,PSYC 137,A00,189057,Winkielman; Piotr,0,34,25,25
1683341677683,PSYC 144,A00,189107,Wixted; John T,0,7,50,50
1683341679732,PSYC 162,A00,189142,Staff,0,8,85,85
1683341680758,PSYC 172,A00,189144,Gorman; Michael R.,0,7,30,30
1683341682814,PSYC 179,A00,189146,Lacefield; Katharine I,0,84,120,120
1683341683842,PSYC 181,A00,189147,Anagnostaras; Stephan,0,44,90,90
1683341684865,PSYC 190R,A00,189148,Barner; David A.,0,22,80,80
1683341685890,PSYC 191,A00,189275,Rickard; Timothy C.,0,7,25,25
1683341686916,PSYC 193,A00,189276,Chapman; Eddie Nathaniel,0,1,0,4
1683341687943,PSYC 193L,A01,189281,Lowe; Angela Beth,12,0,20,8
1683341687943,PSYC 193L,B01,189285,Staff,28,0,35,7
1683341688967,RELI 149,A00,187137,Rahimi; Babak,7,0,40,33
1683341689990,SE 9,A01,187315,Staff,0,2,18,18
1683341691014,SE 101B,A00,187409,Staff,24,0,30,6
1683341692042,SE 110B,A00,187444,Staff,10,0,40,30
1683341693071,SE 130B,A00,187449,Staff,31,0,40,9
1683341694096,SE 150A,A00,187516,Staff,9,0,20,11
1683341695122,SE 154,A00,187528,Staff,30,0,50,20
1683341696146,SIO 3,A01,258171,Staff,35,0,40,5
1683341697169,SIO 10,A00,187144,Cook; Geoffrey W,0,3,75,75
1683341698196,SIO 45,A00,187152,Cook; Geoffrey W,1,0,100,99
1683341699223,SIO 109R,A00,194486,Staff,0,3,20,20
1683341701278,SIO 187,A01,187233,Kacev; David,12,0,40,28
1683341702303,SOCI 1,A01,258656,Thorpe; Charles Robert,28,0,30,2
1683341702303,SOCI 1,A02,258658,Thorpe; Charles Robert,30,0,30,0
1683341702303,SOCI 1,A03,258661,Thorpe; Charles Robert,25,0,25,0
1683341702303,SOCI 1,A04,258666,Thorpe; Charles Robert,22,0,25,3
1683341702303,SOCI 1,A05,258897,Thorpe; Charles Robert,23,0,25,2
1683341702303,SOCI 1,A06,258898,Thorpe; Charles Robert,25,0,25,0
1683341703330,SOCI 30,A01,258903,Pardo Guerra; Juan Pablo,15,0,30,15
1683341704356,SOCI 102,A00,258904,Staff,9,0,25,16
1683341705383,SOCI 106,A00,258905,Staff,19,0,25,6
1683341706410,SOCI 111,A00,258907,Ribas Norris; Janet Vanesa,26,0,30,4
1683341707435,SOCI 121R,A00,258908,Pardo Guerra; Juan Pablo,10,0,30,20
1683341708460,SOCI 126,A01,203330,Staff,14,0,20,6
1683341709487,SOCI 131,A00,258909,Thorpe; Charles Robert,31,0,60,29
1683341710514,SOCI 135,A00,258910,Payne; Christine Anna,0,9,30,30
1683341711541,SOCI 157,A00,258911,Staff,12,0,30,18
1683341712566,SOCI 184,A00,258912,Staff,25,0,30,5
1683341713591,SOCI 188D,A00,258913,Staff,21,0,30,9
1683341714619,SYN 2,001,187529,Staff,10,0,16,6
1683341714619,SYN 2,002,201452,Staff,0,18,16,16
1683341714619,SYN 2,003,201469,Staff,3,0,16,13
1683341715647,SYN 100,A01,187531,Staff,0,9,20,20
1683341715647,SYN 100,B01,201491,Staff,0,12,20,20
1683341716672,TDAC 1,A00,189286,Walsh; Kim C.,3,0,20,17
1683341716672,TDAC 1,B00,189287,Harting; Carla Kelso,11,0,20,9
1683341717700,TDAC 101,A00,189300,Walsh; Kim C.,16,0,20,4
1683341717700,TDAC 101,B00,189301,Harting; Carla Kelso,18,0,20,2
1683341718726,TDAC 102,A00,189304,Basso; Beatrice,14,0,20,6
1683341719751,TDAC 108,A00,189305,Staff,18,0,20,2
1683341720779,TDDE 131,A00,189310,Staff,19,0,20,1
1683341720779,TDDE 131,B00,189314,Staff,19,0,20,1
1683341720779,TDDE 131,C00,189315,Staff,48,0,50,2
1683341720779,TDDE 131,D00,189316,Staff,14,0,15,1
1683341720779,TDDE 131,E00,204841,Staff,20,0,20,0
1683341721802,TDGE 10,A00,189289,Staff,30,0,50,20
1683341721802,TDGE 10,B00,189290,Havis; Allan,1,0,50,49
1683341722831,TDGE 11,A00,189291,Fulton; Julia,0,3,50,50
1683341722831,TDGE 11,B00,189292,Staff,20,0,25,5
1683341722831,TDGE 11,C00,260270,Staff,0,0,0,0
1683341723854,TDGE 25,A00,189294,Staff,3,0,20,17
1683341724877,TDGE 124,A00,189318,Fulton; Julia,0,8,50,50
1683341725900,TDGE 125,A00,189319,Staff,13,0,25,12
1683341725900,TDGE 125,B00,189320,Staff,23,0,25,2
1683341726923,TDGE 127,A00,189322,Havis; Allan,0,0,50,50
1683341727947,TDHT 101,A00,189323,Staff,18,0,25,7
1683341727947,TDHT 101,B00,189324,Staff,25,0,25,0
1683341728970,TDHT 102,A00,189325,Staff,49,0,50,1
1683341729997,TDMV 1,A00,189295,Arcidiacono; Kristin,19,0,30,11
1683341729997,TDMV 1,B00,189296,Caligagan; Maria T.,24,0,30,6
1683341731026,TDMV 2,A00,189297,Sammartano; Tonnie,28,0,30,2
1683341731026,TDMV 2,B00,189299,Arcidiacono; Kristin,24,0,30,6
1683341732054,TDMV 3,A00,204998,Rincon; Alicia,22,0,30,8
1683341733080,TDMV 120,A00,189458,Sammartano; Tonnie,28,0,30,2
1683341734107,TDMV 138,A00,189541,Jun; Grace Shin Hae,22,0,40,18
1683341735131,TDMV 142,A00,189717,Caligagan; Tony,23,0,30,7
1683341735131,TDMV 142,B00,189718,Caligagan; Maria T.,25,0,30,5
1683341736156,TMC 2,A01,187533,Staff,25,0,25,0
1683341736156,TMC 2,A02,187534,Staff,25,0,25,0
1683341737180,USP 1,A01,187536,Kwak; Nancy,0,16,25,25
1683341738204,USP 5,A01,187538,Staff,10,0,25,15
1683341739233,USP 101,A00,199253,Staff,0,4,0,0
1683341740259,USP 124,A00,187562,Boomhower; Matthew Charles,1,0,30,29
1683341741286,USP 138,A00,187582,Staff,20,0,25,5
1683341742313,USP 152,A01,187597,Staff,4,0,25,21
1683341743339,USP 153,A00,187598,Staff,19,0,25,6
1683341744364,USP 168,A00,187607,Kwak; Nancy,2,0,5,3
1683341745391,USP 173,A00,187619,Staff,4,0,25,21
1683341746415,USP 181,A00,187638,Staff,0,0,25,25
1683341747438,VIS 103,A00,187650,Cruz; Edwin Teddy,23,0,75,52
1683341748462,VIS 110D,A00,187669,Staff,12,0,22,10
1683341749486,VIS 127C,A00,187720,Shen; Kuiyi,67,0,146,79
1683341750509,VIS 149,A00,187731,Yoldas; Pinar,0,14,22,22
1683341751534,VIS 151,A01,188091,Staff,22,0,34,12
1683341751534,VIS 151,A02,188092,Staff,11,0,34,23
1683341752558,VIS 160B,A00,188093,Stalbaum; Brett,0,0,10,10
1683341754609,WCWP 10B,A00,201720,Staff,10,0,15,5
1683341754609,WCWP 10B,B00,201722,Staff,9,0,15,6
1683341755635,WCWP 100,A00,201725,Gagnon; Jeffrey C,0,0,2,2
1683341755635,WCWP 100,B00,201727,Staff,0,4,15,15
1683341758779,ANBI 133,A00,258401,Wilder; Linnea Lorene,34,0,40,6
1683341759803,ANBI 140,A00,258395,Hrvoj Mihic; Branka,18,0,25,7
1683341760828,ANSC 120,A00,258402,Bialecki; Jon Anthony,27,0,40,13
1683341761855,ANSC 144,A00,258400,Staff,14,0,40,26
1683341763908,ANSC 166,A00,258396,Parish; Steven Martin,157,0,175,18
1683341764935,ANSC 180,A00,193533,Staff,9,0,20,11
1683341765959,ANSC 188,A00,258397,Jassal; Aftab,33,0,40,7
1683341766987,ANTH 3,A01,258316,Staff,23,0,30,7
1683341768015,ANTH 5,A00,258394,Semendeferi; Ekaterini,16,0,20,4
1683341769042,ANTH 21,A01,258331,Staff,8,0,40,32
1683341770069,ANTH 103,A00,258398,Varma; Saiba,15,0,25,10
1683341771101,AWP 10,001,202034,Staff,0,0,0,0
1683341771101,AWP 10,002,202035,Staff,0,0,0,0
1683341771101,AWP 10,003,202036,Staff,0,0,0,0
1683341771101,AWP 10,004,202037,Staff,0,0,0,0
1683341771101,AWP 10,005,202038,Staff,0,0,0,0
1683341771101,AWP 10,006,202039,Staff,0,0,0,0
1683341771101,AWP 10,007,202040,Staff,0,0,0,0
1683341771101,AWP 10,008,202041,Staff,0,0,0,0
1683341771101,AWP 10,009,202042,Staff,0,0,0,0
1683341771101,AWP 10,010,202043,Staff,0,0,0,0
1683341771101,AWP 10,011,202044,Staff,0,0,0,0
1683341771101,AWP 10,012,202045,Staff,0,0,0,0
1683341771101,AWP 10,013,202046,Staff,0,0,0,0
1683341771101,AWP 10,014,202047,Staff,0,0,0,0
1683341771101,AWP 10,015,202048,Staff,0,0,0,0
1683341771101,AWP 10,016,202049,Staff,0,0,0,0
1683341771101,AWP 10,017,202050,Staff,0,0,0,0
1683341771101,AWP 10,018,202051,Staff,0,0,0,0
1683341771101,AWP 10,019,202052,Staff,0,0,0,0
1683341771101,AWP 10,020,202053,Staff,0,0,0,0
1683341771101,AWP 10,021,202054,Staff,0,0,0,0
1683341771101,AWP 10,022,202055,Staff,0,0,0,0
1683341771101,AWP 10,023,202056,Staff,0,0,0,0
1683341771101,AWP 10,024,202057,Staff,0,0,0,0
1683341771101,AWP 10,025,202058,Staff,0,0,0,0
1683341771101,AWP 10,026,202059,Staff,0,0,0,0
1683341772127,AWP 102,001,202032,Staff,0,0,0,0
1683341772127,AWP 102,002,202033,Staff,0,0,0,0
1683341773150,BENG 100,A01,254234,Taylor Amos; Alyssa C,31,0,40,9
1683341774173,BENG 196,001,270013,Engler; Adam J.,9999,0,9999,0
1683341775197,BICD 100R,A01,202018,Smith; Laurie,0,7,32,32
1683341775197,BICD 100R,A02,202019,Smith; Laurie,0,2,32,32
1683341775197,BICD 100R,A03,202020,Smith; Laurie,0,1,32,32
1683341775197,BICD 100R,A04,202021,Smith; Laurie,9,0,32,23
1683341775197,BICD 100R,A05,202022,Smith; Laurie,12,0,32,20
1683341776224,BICD 136,A01,193242,Gustafson-Brown; Cindy,0,2,32,32
1683341776224,BICD 136,A02,193244,Gustafson-Brown; Cindy,14,0,32,18
1683341777252,BIEB 102,A01,193249,Butler; Shannon Rhey,0,2,32,32
1683341777252,BIEB 102,A02,193251,Butler; Shannon Rhey,0,0,32,32
1683341777252,BIEB 102,A03,193253,Butler; Shannon Rhey,0,1,32,32
1683341777252,BIEB 102,A04,193255,Butler; Shannon Rhey,17,0,32,15
1683341777252,BIEB 102,A05,193265,Butler; Shannon Rhey,26,0,32,6
1683341777252,BIEB 102,A06,193269,Butler; Shannon Rhey,16,0,32,16
1683341779302,BIEB 150,A01,193274,Staff,0,0,32,32
1683341779302,BIEB 150,A02,193285,Staff,23,0,32,9
1683341780326,BIEB 194,A00,193286,Kurle; Carolyn M.,22,0,32,10
1683341781352,BILD 1,A01,192291,Staff,16,0,32,16
1683341781352,BILD 1,A02,192292,Staff,30,0,32,2
1683341781352,BILD 1,B01,192520,Reuther; Keefe,0,1,0,0
1683341781352,BILD 1,B02,192532,Reuther; Keefe,0,1,0,0
1683341782377,BILD 3,A01,192556,Butler; Shannon Rhey,0,0,32,32
1683341782377,BILD 3,A02,192581,Butler; Shannon Rhey,5,0,32,27
1683341782377,BILD 3,A03,192611,Butler; Shannon Rhey,23,0,32,9
1683341782377,BILD 3,A04,192612,Butler; Shannon Rhey,25,0,32,7
1683341782377,BILD 3,A05,192613,Butler; Shannon Rhey,27,0,32,5
1683341782377,BILD 3,A06,192679,Butler; Shannon Rhey,27,0,32,5
1683341782377,BILD 3,A07,192682,Butler; Shannon Rhey,22,0,32,10
1683341783401,BILD 4,A01,192836,Reuther; Keefe,0,0,24,24
1683341783401,BILD 4,A02,193044,Reuther; Keefe,4,0,24,20
1683341784425,BILD 10,A01,193142,Gustafson-Brown; Cindy,30,0,32,2
1683341784425,BILD 10,A02,193149,Gustafson-Brown; Cindy,31,0,32,1
1683341785451,BIMM 100,A01,193301,Staff,0,6,32,32
1683341785451,BIMM 100,A02,193312,Staff,0,5,32,32
1683341785451,BIMM 100,A03,193323,Staff,0,8,32,32
1683341786476,BIMM 101,A01,193329,McDonnell; Lisa Marie,0,3,24,24
1683341786476,BIMM 101,A02,193339,McDonnell; Lisa Marie,0,3,24,24
1683341786476,BIMM 101,B01,193354,McDonnell; Lisa Marie,0,3,24,24
1683341786476,BIMM 101,B02,193357,McDonnell; Lisa Marie,0,3,24,24
1683341787503,BIMM 110,A01,193377,Tat; John,0,11,32,32
1683341787503,BIMM 110,A02,193378,Tat; John,1,9,32,31
1683341788532,BIMM 120,A01,206116,Staff,0,0,32,32
1683341788532,BIMM 120,A02,206117,Staff,8,0,32,24
1683341788532,BIMM 120,A03,206121,Staff,21,0,32,11
1683341789556,BIPN 100,A01,193393,Park; Ji Young,0,14,32,32
1683341789556,BIPN 100,A02,193402,Park; Ji Young,0,13,32,32
1683341789556,BIPN 100,A03,193413,Park; Ji Young,0,14,32,32
1683341789556,BIPN 100,A04,193414,Park; Ji Young,0,13,32,32
1683341790584,BIPN 102,A01,193429,Staff,0,0,32,32
1683341790584,BIPN 102,A02,193438,Staff,22,0,32,10
1683341791612,BIPN 106,A01,193450,Reyes Gonzalez; Catalina,0,2,40,40
1683341792641,BIPN 134,A01,193465,Cooke; James Edward,0,0,32,32
1683341792641,BIPN 134,A02,193474,Cooke; James Edward,25,0,32,7
1683341792641,BIPN 134,A03,193485,Cooke; James Edward,29,0,32,3
1683341792641,BIPN 134,A04,193486,Cooke; James Edward,21,0,32,11
1683341792641,BIPN 134,A05,193491,Cooke; James Edward,31,0,32,1
1683341792641,BIPN 134,A06,193501,Cooke; James Edward,30,0,32,2
1683341792641,BIPN 134,A07,193510,Cooke; James Edward,29,0,32,3
1683341794688,BISP 194,A00,222522,Staff,14,0,32,18
1683341795711,CAT 124,A01,202407,Staff,20,0,25,5
1683341796735,CAT 125,A00,202408,Marchisotto; Jennifer Anne,4,0,20,16
1683341797758,CAT 125R,A00,202409,Smith; Lauryn Alissa,0,11,20,20
1683341797758,CAT 125R,B00,202410,Morales; Celeste Georgianna,0,11,20,20
1683341797758,CAT 125R,C00,202411,Irwin; Matthew Joseph,0,10,20,20
1683341798787,CENG 15,A01,204712,Yang; Kesong,0,1,0,0
1683341799811,CENG 114,A00,202070,Jahed Motlagh; Zeinab,5,0,20,15
1683341800834,CGS 105,A00,185477,Wesling; Megan E.,24,0,40,16
1683341801858,CGS 106,A00,185494,Staff,13,0,22,9
1683341802883,CGS 108,A00,185495,Staff,14,0,20,6
1683341803908,CGS 114,A00,185496,Staff,13,0,18,5
1683341804932,CGS 119,A00,185501,Staff,15,0,20,5
1683341805956,CGS 120,A00,185511,Staff,13,0,20,7
1683341806985,CHEM 4,A01,184675,Bussey; Thomas J,96,0,100,4
1683341808009,CHEM 6A,A01,184677,Staff,34,0,60,26
1683341809034,CHEM 6B,A01,184679,Staff,65,0,100,35
1683341810059,CHEM 6C,A01,184681,Bussey; Thomas J,1,0,50,49
1683341810059,CHEM 6C,A02,184682,Bussey; Thomas J,34,0,50,16
1683341811084,CHEM 40A,A01,184684,Albizati; Kim F.,37,0,100,63
1683341812112,CHEM 40B,A01,184686,Albizati; Kim F.,0,20,100,100
1683341813139,CHEM 41B,A01,184690,Staff,52,0,100,48
1683341814163,COGS 3,A01,184715,Boyle; Mary E. T.,0,25,40,40
1683341815187,COGS 14B,A01,185172,Staff,0,15,38,38
1683341816211,COGS 18,A01,184736,Staff,17,0,80,63
1683341817239,COGS 100,A01,184932,Staff,0,5,73,73
1683341818263,COGS 101A,A01,184935,Staff,0,39,30,30
1683341819288,COGS 101B,A01,184944,Staff,0,2,30,30
1683341820311,COGS 101C,A01,184946,Staff,0,12,30,30
1683341821336,COGS 102A,A01,184951,Johnson; Christine M.,2,0,40,38
1683341822362,COGS 107B,A01,184953,Mooshagian; Eric Frederick,0,50,40,40
1683341823392,COGS 118B,A01,184959,Gupta; Anjum,0,48,40,40
1683341824417,COGS 153,A00,184961,Staff,0,15,30,30
1683341825441,COGS 177,A00,184962,Staff,0,20,30,30
1683341826468,COGS 187A,A01,184969,Boyle; Mary E. T.,0,17,40,40
1683341827499,COMM 10,A01,185174,Staff,0,5,25,25
1683341827499,COMM 10,A02,185189,Staff,0,5,25,25
1683341827499,COMM 10,A03,269821,Staff,0,0,0,0
1683341828526,COMM 100B,A01,185475,Staff,0,0,0,2
1683341828526,COMM 100B,A02,185476,Staff,13,0,25,12
1683341829553,COMM 100C,A01,185314,Staff,1,0,25,24
1683341829553,COMM 100C,A02,185327,Staff,19,0,25,6
1683341830578,COMM 110M,A00,185349,Staff,2,0,40,38
1683341831605,COMM 113T,A00,185352,Staff,24,0,40,16
1683341832630,COMM 114I,A00,185353,Staff,33,0,40,7
1683341833657,COMM 131,A00,185354,Staff,19,0,30,11
1683341834682,CSE 8A,A50,185358,Cao; Yingjun,0,46,10,10
1683341835710,CSE 8B,A01,185362,Staff,1,47,50,49
1683341836735,CSE 11,A01,185416,Cao; Yingjun,0,92,10,10
1683341837762,CSE 20,A01,185445,Briones; Jor-el Thomas Caparas,5,0,25,20
1683341838789,CSE 21,A01,185447,Staff,10,0,50,40
1683341839814,CSE 101,A01,185451,Staff,0,13,50,50
1683341839814,CSE 101,B01,185453,Jones; Miles E,0,11,50,50
1683341841862,CSE 141,A01,185458,Eldon; John,20,0,100,80
1683341842891,CSE 141L,A01,185461,Eldon; John,12,0,100,88
1683341843918,CSE 142,A01,185463,Staff,36,0,60,24
1683341843918,CSE 142,B01,201355,Staff,0,7,60,60
1683341844945,CSE 142L,A01,185470,Staff,36,0,60,24
1683341844945,CSE 142L,B01,201417,Staff,0,6,60,60
1683341845969,CSE 190,A00,201433,Staff,32,0,49,17
1683341846995,DOC 1,A01,259136,Strom; Megan C.,7,0,15,8
1683341846995,DOC 1,A02,259137,Strom; Megan C.,14,0,15,1
1683341846995,DOC 1,A03,259138,Strom; Megan C.,14,0,15,1
1683341846995,DOC 1,A04,259139,Strom; Megan C.,14,0,15,1
1683341848020,DOC 100D,A00,259140,Pass; Natalye Joann,16,0,25,9
1683341849044,DSGN 1,A01,184749,Rill; Bryan,0,25,30,30
1683341850069,DSGN 100,A01,185168,Staff,0,2,25,25
1683341851092,ECE 5,A01,185626,Morris; Karcher William,0,10,0,0
1683341852118,ECE 101,A01,185628,Staff,17,0,70,53
1683341853141,ECE 107,A01,185635,Baghdadchi; Saharnaz,0,0,20,20
1683341853141,ECE 107,A02,185638,Baghdadchi; Saharnaz,4,0,20,16
1683341854167,ECE 148,A01,185647,Silberman; Jack,0,0,16,16
1683341855190,ECON 1,A01,185537,Crane; Meredith Helen,54,0,70,16
1683341856215,ECON 3,A01,185549,Crane; Meredith Helen,32,0,70,38
1683341857238,ECON 4,A01,203354,Anderson; John Charles,0,4,10,10
1683341858262,ECON 100A,A01,185574,Staff,0,4,40,40
1683341859288,ECON 100B,A01,185576,Staff,10,22,50,40
1683341860316,ECON 100C,A01,185589,Newhouse; Herbert S,30,0,70,40
1683341861344,ECON 105,A00,185608,Vespa; Emanuel Ignacio,19,0,35,16
1683341862423,ECON 109,A01,185610,Shishkin; Denis,10,0,35,25
1683341863447,ECON 110A,A01,185612,Staff,11,0,40,29
1683341864471,ECON 120A,A01,185615,Staff,20,0,40,20
1683341865495,ECON 120C,A01,185617,Sun; Yixiao,0,20,70,70
1683341866517,ECON 144,A00,203346,Squires; Dale E,3,0,35,32
1683341867542,ECON 171,A01,203349,Newhouse; Herbert S,0,1,35,35
1683341868569,ECON 173A,A01,185621,Toda; Alexis Akira,21,0,35,14
1683341869595,EDS 25,A01,202413,Staff,0,1,0,0
1683341869595,EDS 25,A02,202414,Staff,0,1,0,0
1683341869595,EDS 25,A03,202415,Staff,0,0,0,0
1683341869595,EDS 25,A04,202416,Staff,0,1,0,0
1683341869595,EDS 25,A05,202439,Staff,0,0,0,0
1683341869595,EDS 25,A06,202440,Staff,0,0,0,0
1683341869595,EDS 25,B01,202631,Staff,0,0,0,0
1683341869595,EDS 25,B02,202632,Staff,0,0,0,0
1683341869595,EDS 25,B03,202639,Staff,0,0,0,0
1683341869595,EDS 25,B04,202640,Staff,0,0,0,0
1683341869595,EDS 25,B05,202643,Staff,0,0,0,0
1683341869595,EDS 25,B06,202644,Staff,0,0,0,0
1683341870619,EDS 38,A01,202659,Black; Alison Michelle,24,0,25,1
1683341871647,EDS 115,A00,202652,Staff,18,0,30,12
1683341872672,EDS 125,A00,202649,Staff,14,0,30,16
1683341873696,EDS 126,A01,203332,Staff,30,0,30,0
1683341874721,EDS 139,A00,202838,Staff,16,0,25,9
1683341875746,EDS 146,A01,202655,Staff,14,0,25,11
1683341876772,ENG 15,A00,185667,Staff,0,1,0,0
1683341876772,ENG 15,B00,185672,Staff,0,0,0,0
1683341876772,ENG 15,C00,185675,Staff,0,0,0,0
1683341876772,ENG 15,D00,185682,Staff,0,0,0,0
1683341876772,ENG 15,E00,185684,Staff,0,0,0,0
1683341877797,ETHN 103,A00,185710,Staff,0,4,35,35
1683341878821,ETHN 103A,A00,199228,Man; Simeon S,2,0,9,7
1683341879846,ETHN 109,A00,185711,Staff,18,0,35,17
1683341880873,ETHN 142,A00,185726,Staff,0,4,30,30
1683341881899,ETHN 163J,A00,199229,Man; Simeon S,5,0,8,3
1683341882927,ETHN 168,A00,185727,Staff,8,0,10,2
1683341883954,ETHN 182,A00,185728,Staff,1,0,35,34
1683341884982,ETHN 183,A00,185737,Staff,8,0,18,10
1683341886009,GLBH 111,A01,209361,Burgos; Jose L.,0,0,0,0
1683341888060,HIEU 104,A00,185792,Staff,16,0,20,4
1683341889087,HIEU 115,A00,185800,Staff,1,0,20,19
1683341890110,HIEU 128,A00,185801,Staff,0,7,20,20
1683341891136,HIEU 147,A00,185802,Staff,16,0,20,4
1683341892163,HIEU 154,A00,185823,Staff,12,0,20,8
1683341893186,HILA 102,A00,185826,Staff,13,0,20,7
1683341894211,HILD 2C,A01,185778,Staff,0,12,20,20
1683341895240,HILD 7B,A01,185780,Kwak; Nancy,0,15,32,32
1683341895240,HILD 7B,A02,185781,Kwak; Nancy,0,18,32,32
1683341896267,HILD 30,A01,185791,Staff,14,0,20,6
1683341897294,HISC 119,A00,185830,Golan; Tal,0,9,20,20
1683341898319,HITO 156GS,A00,185831,Patterson; Patrick H.,0,0,0,23
1683341899348,HIUS 103,A00,185832,Man; Simeon S,0,6,20,20
1683341900372,HIUS 117,A00,185836,Kwak; Nancy,2,0,20,18
1683341901396,HIUS 125,A00,185840,Man; Simeon S,0,0,23,23
1683341902423,HIUS 149,A00,185845,Staff,0,0,20,20
1683341903450,HUM 3,A01,185882,Zavodny; Tatiana Sophia,0,7,50,50
1683341903450,HUM 3,B01,185899,Caldwell; Michael Alan,0,18,50,50
1683341904476,HUM 3GS,A00,185900,Patterson; Patrick H.,0,0,0,23
1683341905499,HUM 4,A01,185938,Zroka; Amy Liane,31,0,50,19
1683341905499,HUM 4,B01,185956,Watkins; Eric,0,2,50,50
1683341905499,HUM 4,B02,202209,Watkins; Eric,0,2,50,50
1683341905499,HUM 4,B03,202210,Watkins; Eric,0,2,50,50
1683341906526,HUM 5,A01,185958,West; Geoffrey Scott,3,0,50,47
1683341906526,HUM 5,A02,202215,West; Geoffrey Scott,0,0,50,50
1683341907550,INTL 190,A00,185959,Gagnon; Jeffrey C,0,0,0,9
1683341907550,INTL 190,B00,185960,Lettieri; Michael Joseph,0,0,0,1
1683341908575,JAPN 180,A00,254509,Staff,5,1,30,25
1683341909600,LATI 10,A01,202853,Kennemore; Amy Michelle,4,0,35,31
1683341909600,LATI 10,A02,202854,Kennemore; Amy Michelle,2,0,35,33
1683341909600,LATI 10,A03,270054,Kennemore; Amy Michelle,30,0,30,0
1683341910625,LATI 180,A00,202855,Kennemore; Amy Michelle,11,0,20,9
1683341911651,LAWS 101,A00,201767,Golan; Tal,0,7,40,40
1683341912676,LIFR 1C,A00,185961,Staff,6,0,20,14
1683341913700,LIFR 1CX,A00,185962,Staff,7,0,20,13
1683341914728,LIFR 1D,A00,185963,Staff,9,0,20,11
1683341915754,LIFR 1DX,A00,185964,Staff,9,0,20,11
1683341916779,LIGN 101,A01,186039,Staff,43,0,50,7
1683341917803,LIGN 165,A00,186040,Staff,18,0,50,32
1683341918827,LTCS 108,A00,186041,Staff,6,0,10,4
1683341919854,LTCS 119,A00,186042,Staff,16,0,20,4
1683341920877,LTCS 130,A00,186043,Wesling; Megan E.,15,0,25,10
1683341922930,LTEA 138,A00,186119,Staff,14,0,40,26
1683341923959,LTEN 124,A00,186148,Staff,6,0,25,19
1683341924982,LTEN 178,A00,186149,Staff,7,0,15,8
1683341926007,LTEN 181,A00,186150,Blanco; John D,33,0,40,7
1683341927030,LTWL 120,A00,186160,Staff,20,0,25,5
1683341928055,LTWL 165,A00,186161,Staff,22,0,25,3
1683341929079,LTWR 100,A00,186162,Staff,0,5,15,15
1683341930101,LTWR 102,A00,186163,Doller; Ben,5,0,15,10
1683341931128,MAE 8,A01,186412,Staff,0,0,0,0
1683341932154,MAE 30B,A00,186445,Bahadori; Mohammad Yousef,83,0,100,17
1683341933182,MAE 40,A00,186592,Bewley; Thomas R,9,0,50,41
1683341934206,MAE 101B,A00,186593,Bahadori; Mohammad Yousef,81,0,100,19
1683341935232,MAE 105,A00,186594,Bandaru; Prabhakar,12,0,50,38
1683341936260,MAE 107,A00,186599,Pham; Hieu Tan,0,6,120,120
1683341937288,MAE 148,A01,186660,Silberman; Jack,3,0,16,13
1683341938311,MATH 10A,A01,188095,Staff,1,6,35,34
1683341939336,MATH 10B,A01,188097,Bowers; Adam R.,0,11,30,30
1683341939336,MATH 10B,A02,188099,Bowers; Adam R.,0,11,30,30
1683341939336,MATH 10B,B01,188104,Bowers; Adam R.,0,10,30,30
1683341939336,MATH 10B,B02,188106,Bowers; Adam R.,0,10,30,30
1683341940362,MATH 10C,A01,188111,Staff,0,18,30,30
1683341940362,MATH 10C,A02,188127,Staff,0,17,30,30
1683341940362,MATH 10C,A03,188131,Staff,0,18,30,30
1683341940362,MATH 10C,B01,188218,Staff,18,0,30,12
1683341940362,MATH 10C,B02,188244,Staff,13,0,30,17
1683341940362,MATH 10C,B03,188277,Staff,16,0,30,14
1683341941395,MATH 18,A01,188344,Bach; Quang Tran,18,0,30,12
1683341941395,MATH 18,A02,188345,Bach; Quang Tran,11,0,30,19
1683341941395,MATH 18,B01,188353,Bach; Quang Tran,10,0,30,20
1683341941395,MATH 18,B02,188354,Bach; Quang Tran,20,0,30,10
1683341942419,MATH 20A,A01,188374,Staff,13,0,35,22
1683341943445,MATH 20B,A01,188382,Ohm; Ko Woon,6,0,30,24
1683341943445,MATH 20B,A02,188383,Ohm; Ko Woon,22,0,30,8
1683341943445,MATH 20B,B01,188385,Ohm; Ko Woon,7,0,30,23
1683341943445,MATH 20B,B02,188392,Ohm; Ko Woon,22,0,30,8
1683341944471,MATH 20C,A01,188394,Harel; Guershon,10,0,30,20
1683341944471,MATH 20C,A02,188395,Harel; Guershon,15,0,30,15
1683341944471,MATH 20C,B01,188404,Harel; Guershon,5,0,30,25
1683341944471,MATH 20C,B02,188405,Harel; Guershon,19,0,30,11
1683341945496,MATH 20D,A01,188414,Hammock; Frances H,0,1,30,30
1683341945496,MATH 20D,A02,188415,Hammock; Frances H,3,0,30,27
1683341945496,MATH 20D,B01,188447,Hammock; Frances H,1,0,30,29
1683341945496,MATH 20D,B02,188486,Hammock; Frances H,8,0,30,22
1683341946521,MATH 20E,A01,188649,Staff,21,0,30,9
1683341946521,MATH 20E,A02,188650,Staff,23,0,30,7
1683341946521,MATH 20E,A03,188673,Staff,0,0,30,30
1683341947548,MATH 102,A01,188675,Staff,0,35,35,35
1683341948576,MATH 103B,A01,188681,Staff,3,0,35,32
1683341948576,MATH 103B,B01,188692,Staff,5,0,35,30
1683341949601,MATH 109,A01,188695,Salehi Golsefidy; Alireza,25,0,35,10
1683341949601,MATH 109,A02,188696,Salehi Golsefidy; Alireza,25,0,35,10
1683341950624,MATH 120A,A01,188698,Eggers; John Dietrich,7,0,35,28
1683341951650,MATH 142B,A01,188736,Ioana; Adrian,0,2,30,30
1683341951650,MATH 142B,A02,188741,Ioana; Adrian,1,1,30,29
1683341951650,MATH 142B,A03,188743,Ioana; Adrian,1,3,30,29
1683341952678,MATH 168A,A01,188790,Staff,0,9,35,35
1683341953707,MATH 170A,A01,188803,Nie; Jiawang,0,2,35,35
1683341953707,MATH 170A,A02,188811,Nie; Jiawang,0,0,35,35
1683341953707,MATH 170A,A03,188814,Nie; Jiawang,1,0,35,34
1683341953707,MATH 170A,A04,188815,Nie; Jiawang,13,0,35,22
1683341954734,MATH 193B,A01,188817,Staff,0,0,35,35
1683341954734,MATH 193B,A02,188818,Staff,5,0,35,30
1683341955768,MGT 4,A01,202857,Anderson; John Charles,62,0,80,18
1683341956795,MGT 12,A00,202858,Lindenberger; Wade Douglas,42,0,90,48
1683341957818,MGT 18,A00,202859,Staff,74,0,90,16
1683341958846,MGT 18GS,A00,202860,McKay; Michael J,13,0,28,15
1683341959872,MGT 45,A00,202861,Pecore; Joseph P.,14,0,90,76
1683341960897,MGT 100,A00,202863,Yavorsky; Daniel Ryan,28,0,90,62
1683341961921,MGT 103,A00,202864,Ehrich; Kristine R,1,18,90,89
1683341962949,MGT 112,A00,202865,Ehrich; Kristine R,15,0,90,75
1683341963975,MGT 121A,A00,202868,Staff,0,20,0,0
1683341964998,MGT 131B,A00,202869,Anderson; John Charles,59,0,90,31
1683341966087,MGT 136,A00,202871,Lindenberger; Wade Douglas,84,0,90,6
1683341967115,MGT 164,A00,202873,Staff,0,68,90,91
1683341968143,MGT 164GS,A00,202874,McKay; Mary A,13,0,28,15
1683341969168,MGT 180,A00,202875,Staff,0,50,90,91
1683341970195,MMW 11R,A01,205019,Herbst; Matthew,3,0,30,27
1683341970195,MMW 11R,A02,205026,Herbst; Matthew,29,0,30,1
1683341971223,MMW 15,A01,193512,Chang; Edmond Yi-Teh,0,9,28,28
1683341971223,MMW 15,A02,193513,Chang; Edmond Yi-Teh,0,5,28,28
1683341971223,MMW 15,A03,193514,Chang; Edmond Yi-Teh,0,5,28,28
1683341971223,MMW 15,A04,193515,Chang; Edmond Yi-Teh,0,5,28,28
1683341971223,MMW 15,A05,193516,Chang; Edmond Yi-Teh,0,4,28,28
1683341971223,MMW 15,A06,193517,Chang; Edmond Yi-Teh,0,5,28,28
1683341971223,MMW 15,B01,193519,Chang; Edmond Yi-Teh,0,5,28,28
1683341971223,MMW 15,B02,193520,Chang; Edmond Yi-Teh,0,5,28,28
1683341971223,MMW 15,B03,193521,Chang; Edmond Yi-Teh,0,5,28,28
1683341971223,MMW 15,B04,193522,Chang; Edmond Yi-Teh,0,4,28,28
1683341971223,MMW 15,B05,193523,Chang; Edmond Yi-Teh,0,5,28,28
1683341971223,MMW 15,B06,193524,Chang; Edmond Yi-Teh,0,4,28,28
1683341972248,MMW 122,A01,193526,Rahimi; Babak,0,15,28,28
1683341972248,MMW 122,A02,193527,Rahimi; Babak,0,14,28,28
1683341972248,MMW 122,A03,193528,Rahimi; Babak,0,0,0,0
1683341972248,MMW 122,A04,193529,Rahimi; Babak,0,0,0,0
1683341973273,MUS 1A,A01,186663,Staff,0,20,35,35
1683341974296,MUS 4,A01,186715,Staff,0,12,35,35
1683341975323,MUS 5R,A01,186796,Dubnov; Shlomo,0,17,35,35
1683341976351,MUS 6,A01,186798,Staff,0,4,25,25
1683341977378,MUS 7,A01,186830,Staff,13,0,35,22
1683341978403,MUS 8,A01,186930,Staff,0,26,35,35
1683341979428,MUS 15,A01,186932,Staff,0,16,35,35
1683341979428,MUS 15,B01,186934,Staff,0,15,35,35
1683341980450,MUS 80,A00,186935,Staff,1,0,20,19
1683341980450,MUS 80,B00,186936,Staff,25,0,25,0
1683341981474,NANO 11,A00,204702,Lipomi; Darren John,0,0,0,0
1683341982497,NANO 15,A01,204709,Yang; Kesong,0,1,0,0
1683341983525,NANO 114,A00,202069,Jahed Motlagh; Zeinab,3,0,10,7
1683341984552,PHIL 1,A00,186955,Grush; Rick Scott,32,0,40,8
1683341985579,PHIL 10,A01,186973,Grush; Rick Scott,28,0,35,7
1683341985579,PHIL 10,A02,186974,Grush; Rick Scott,33,0,35,2
1683341986603,PHIL 13,A01,186976,Staff,7,0,35,28
1683341986603,PHIL 13,A02,186977,Staff,16,0,35,19
1683341987631,PHIL 14,A01,186979,Staff,31,0,35,4
1683341987631,PHIL 14,A02,186986,Staff,32,0,35,3
1683341988659,PHIL 28,A01,186988,Staff,16,0,30,14
1683341988659,PHIL 28,A02,186989,Staff,1,0,30,29
1683341988659,PHIL 28,A03,186990,Staff,9,0,30,21
1683341988659,PHIL 28,A04,186991,Staff,26,0,30,4
1683341989686,PHIL 120,A00,186997,Staff,23,0,40,17
1683341990712,PHIL 137,A00,187003,Staff,9,0,40,31
1683341991736,PHIL 150,A00,187015,Staff,47,0,70,23
1683341992763,PHIL 167,A00,187021,Lamey; Andy M.,35,0,40,5
1683341993791,PHIL 174,A01,202226,Staff,17,0,20,3
1683341993791,PHIL 174,A02,202235,Staff,20,0,20,0
1683341994828,PHIL 191A,A00,258918,Staff,0,0,1,1
1683341995857,PHYS 1A,A00,187028,Staff,27,0,60,33
1683341996883,PHYS 1AL,001,187036,Staff,2,0,30,28
1683341996883,PHYS 1AL,002,187049,Staff,18,0,30,12
1683341997908,PHYS 1B,A00,187058,Staff,22,0,60,38
1683341998933,PHYS 1BL,001,187064,Staff,0,0,30,30
1683341998933,PHYS 1BL,002,187070,Staff,5,0,30,25
1683341999957,PHYS 1C,A00,187082,Staff,31,0,120,89
1683342000982,PHYS 1CL,001,187088,Staff,0,9,30,30
1683342000982,PHYS 1CL,002,187089,Staff,0,2,30,30
1683342000982,PHYS 1CL,009,262693,Staff,11,0,30,19
1683342002006,PHYS 2B,A01,187097,Staff,54,0,115,61
1683342003034,PHYS 2C,A01,187099,Staff,67,0,115,48
1683342004058,PHYS 2CL,A01,187101,Staff,5,0,28,23
1683342004058,PHYS 2CL,A02,187102,Staff,15,0,28,13
1683342005083,PHYS 2D,A01,187123,Shotwell; Brian,95,0,115,20
1683342006108,PHYS 4B,A01,187133,Grinstein; Benjamin,35,0,50,15
1683342007133,POLI 10,A00,188819,Staff,0,4,50,50
1683342008160,POLI 11,A00,188827,Staff,43,0,50,7
1683342009186,POLI 13R,A00,188828,Staff,0,1,20,20
1683342010214,POLI 27,A01,188830,Elgin; Samuel Zincke,0,1,70,70
1683342011242,POLI 30,A00,188832,Desposato; Scott,31,0,50,19
1683342012268,POLI 102F,A00,188834,Staff,3,0,40,37
1683342013292,POLI 104A,A00,188852,Staff,14,0,30,16
1683342014317,POLI 104I,A00,188853,Staff,0,6,20,20
1683342015347,POLI 110B,A00,188854,Wiens; David,7,0,20,13
1683342016373,POLI 112A,A00,188855,Wiens; David,5,0,30,25
1683342017400,POLI 117R,A00,188856,Forman; Fonna,0,11,20,20
1683342018427,POLI 118,A00,188857,Ingham; Sean,8,0,20,12
1683342019455,POLI 120G,A00,188858,Staff,9,0,30,21
1683342020482,POLI 131CR,A00,188863,Hoston; Germaine,24,0,50,26
1683342021514,POLI 133,A00,188864,Nellis; Gareth Hb,44,0,50,6
1683342022542,POLI 134D,A00,188865,Desposato; Scott,27,0,30,3
1683342023566,POLI 142A,A00,188871,Gartzke; Erik,22,0,50,28
1683342024616,POLI 142K,A00,188874,Staff,38,0,50,12
1683342025643,POLI 143,A00,188940,Gartzke; Erik,16,0,30,14
1683342026667,POLI 153,A00,188943,Staff,3,0,20,17
1683342027695,POLI 160AA,A00,188944,Staff,12,0,40,28
1683342028720,POLI 170A,A00,188945,Staff,11,0,30,19
1683342030770,PSYC 1,A00,188952,Staff,37,0,90,53
1683342031793,PSYC 2,B00,188953,Staff,19,0,35,16
1683342032822,PSYC 6,A00,188970,Staff,47,0,60,13
1683342033846,PSYC 7,A00,188973,Staff,37,0,45,8
1683342034887,PSYC 60,A01,188980,Rickard; Timothy C.,43,0,60,17
1683342035914,PSYC 70,A01,189001,Steiner; Eric Tomas,23,0,45,22
1683342036944,PSYC 100,A00,189005,Lacefield; Katharine I,0,98,120,120
1683342037967,PSYC 102,A00,189008,Staff,9,0,30,21
1683342038994,PSYC 106,B00,189026,Gorman; Michael R.,34,0,60,26
1683342040023,PSYC 114,B01,189033,Winkielman; Piotr,0,32,30,30
1683342041046,PSYC 131,A00,189036,Anagnostaras; Stephan,0,43,60,60
1683342042069,PSYC 136,A00,189041,Lowe; Angela Beth,0,7,25,25
1683342043095,PSYC 137,A00,189057,Winkielman; Piotr,0,34,25,25
1683342044119,PSYC 144,A00,189107,Wixted; John T,0,7,50,50
1683342046168,PSYC 162,A00,189142,Staff,0,8,85,85
1683342047194,PSYC 172,A00,189144,Gorman; Michael R.,0,7,30,30
1683342049243,PSYC 179,A00,189146,Lacefield; Katharine I,0,84,120,120
1683342050271,PSYC 181,A00,189147,Anagnostaras; Stephan,0,44,90,90
1683342051296,PSYC 190R,A00,189148,Barner; David A.,0,22,80,80
1683342052320,PSYC 191,A00,189275,Rickard; Timothy C.,0,7,25,25
1683342053351,PSYC 193,A00,189276,Chapman; Eddie Nathaniel,0,1,0,4
1683342054379,PSYC 193L,A01,189281,Lowe; Angela Beth,12,0,20,8
1683342054379,PSYC 193L,B01,189285,Staff,28,0,35,7
1683342055405,RELI 149,A00,187137,Rahimi; Babak,7,0,40,33
1683342056429,SE 9,A01,187315,Staff,0,2,18,18
1683342057455,SE 101B,A00,187409,Staff,24,0,30,6
1683342058480,SE 110B,A00,187444,Staff,10,0,40,30
1683342059506,SE 130B,A00,187449,Staff,31,0,40,9
1683342060546,SE 150A,A00,187516,Staff,9,0,20,11
1683342061595,SE 154,A00,187528,Staff,30,0,50,20
1683342062620,SIO 3,A01,258171,Staff,35,0,40,5
1683342063646,SIO 10,A00,187144,Cook; Geoffrey W,0,3,75,75
1683342064669,SIO 45,A00,187152,Cook; Geoffrey W,1,0,100,99
1683342065697,SIO 109R,A00,194486,Staff,0,3,20,20
1683342067746,SIO 187,A01,187233,Kacev; David,12,0,40,28
1683342068776,SOCI 1,A01,258656,Thorpe; Charles Robert,28,0,30,2
1683342068776,SOCI 1,A02,258658,Thorpe; Charles Robert,30,0,30,0
1683342068776,SOCI 1,A03,258661,Thorpe; Charles Robert,25,0,25,0
1683342068776,SOCI 1,A04,258666,Thorpe; Charles Robert,22,0,25,3
1683342068776,SOCI 1,A05,258897,Thorpe; Charles Robert,23,0,25,2
1683342068776,SOCI 1,A06,258898,Thorpe; Charles Robert,25,0,25,0
1683342069870,SOCI 30,A01,258903,Pardo Guerra; Juan Pablo,15,0,30,15
1683342070893,SOCI 102,A00,258904,Staff,9,0,25,16
1683342071917,SOCI 106,A00,258905,Staff,19,0,25,6
1683342072945,SOCI 111,A00,258907,Ribas Norris; Janet Vanesa,26,0,30,4
1683342073969,SOCI 121R,A00,258908,Pardo Guerra; Juan Pablo,10,0,30,20
1683342074994,SOCI 126,A01,203330,Staff,14,0,20,6
1683342076019,SOCI 131,A00,258909,Thorpe; Charles Robert,31,0,60,29
1683342077044,SOCI 135,A00,258910,Payne; Christine Anna,0,9,30,30
1683342078068,SOCI 157,A00,258911,Staff,12,0,30,18
1683342079095,SOCI 184,A00,258912,Staff,25,0,30,5
1683342080123,SOCI 188D,A00,258913,Staff,21,0,30,9
1683342081152,SYN 2,001,187529,Staff,10,0,16,6
1683342081152,SYN 2,002,201452,Staff,0,18,16,16
1683342081152,SYN 2,003,201469,Staff,3,0,16,13
1683342082180,SYN 100,A01,187531,Staff,0,9,20,20
1683342082180,SYN 100,B01,201491,Staff,0,12,20,20
1683342083210,TDAC 1,A00,189286,Walsh; Kim C.,3,0,20,17
1683342083210,TDAC 1,B00,189287,Harting; Carla Kelso,11,0,20,9
1683342084238,TDAC 101,A00,189300,Walsh; Kim C.,16,0,20,4
1683342084238,TDAC 101,B00,189301,Harting; Carla Kelso,18,0,20,2
1683342085263,TDAC 102,A00,189304,Basso; Beatrice,14,0,20,6
1683342086291,TDAC 108,A00,189305,Staff,18,0,20,2
1683342087317,TDDE 131,A00,189310,Staff,19,0,20,1
1683342087317,TDDE 131,B00,189314,Staff,19,0,20,1
1683342087317,TDDE 131,C00,189315,Staff,48,0,50,2
1683342087317,TDDE 131,D00,189316,Staff,14,0,15,1
1683342087317,TDDE 131,E00,204841,Staff,20,0,20,0
1683342088343,TDGE 10,A00,189289,Staff,30,0,50,20
1683342088343,TDGE 10,B00,189290,Havis; Allan,1,0,50,49
1683342089369,TDGE 11,A00,189291,Fulton; Julia,0,3,50,50
1683342089369,TDGE 11,B00,189292,Staff,20,0,25,5
1683342089369,TDGE 11,C00,260270,Staff,0,0,0,0
1683342090393,TDGE 25,A00,189294,Staff,3,0,20,17
1683342091425,TDGE 124,A00,189318,Fulton; Julia,0,8,50,50
1683342092449,TDGE 125,A00,189319,Staff,13,0,25,12
1683342092449,TDGE 125,B00,189320,Staff,23,0,25,2
1683342093472,TDGE 127,A00,189322,Havis; Allan,0,0,50,50
1683342094501,TDHT 101,A00,189323,Staff,18,0,25,7
1683342094501,TDHT 101,B00,189324,Staff,25,0,25,0
1683342095525,TDHT 102,A00,189325,Staff,49,0,50,1
1683342096554,TDMV 1,A00,189295,Arcidiacono; Kristin,19,0,30,11
1683342096554,TDMV 1,B00,189296,Caligagan; Maria T.,24,0,30,6
1683342097579,TDMV 2,A00,189297,Sammartano; Tonnie,28,0,30,2
1683342097579,TDMV 2,B00,189299,Arcidiacono; Kristin,24,0,30,6
1683342098607,TDMV 3,A00,204998,Rincon; Alicia,22,0,30,8
1683342099634,TDMV 120,A00,189458,Sammartano; Tonnie,28,0,30,2
1683342100659,TDMV 138,A00,189541,Jun; Grace Shin Hae,22,0,40,18
1683342101684,TDMV 142,A00,189717,Caligagan; Tony,23,0,30,7
1683342101684,TDMV 142,B00,189718,Caligagan; Maria T.,25,0,30,5
1683342102708,TMC 2,A01,187533,Staff,25,0,25,0
1683342102708,TMC 2,A02,187534,Staff,25,0,25,0
1683342103731,USP 1,A01,187536,Kwak; Nancy,0,16,25,25
1683342104755,USP 5,A01,187538,Staff,10,0,25,15
1683342105780,USP 101,A00,199253,Staff,0,4,0,0
1683342106810,USP 124,A00,187562,Boomhower; Matthew Charles,1,0,30,29
1683342107835,USP 138,A00,187582,Staff,20,0,25,5
1683342108862,USP 152,A01,187597,Staff,4,0,25,21
1683342109887,USP 153,A00,187598,Staff,19,0,25,6
1683342110911,USP 168,A00,187607,Kwak; Nancy,2,0,5,3
1683342111939,USP 173,A00,187619,Staff,4,0,25,21
1683342112965,USP 181,A00,187638,Staff,0,0,25,25
1683342113989,VIS 103,A00,187650,Cruz; Edwin Teddy,23,0,75,52
1683342115018,VIS 110D,A00,187669,Staff,12,0,22,10
1683342116044,VIS 127C,A00,187720,Shen; Kuiyi,67,0,146,79
1683342117071,VIS 149,A00,187731,Yoldas; Pinar,0,14,22,22
1683342118097,VIS 151,A01,188091,Staff,22,0,34,12
1683342118097,VIS 151,A02,188092,Staff,11,0,34,23
1683342119123,VIS 160B,A00,188093,Stalbaum; Brett,0,0,10,10
1683342121169,WCWP 10B,A00,201720,Staff,10,0,15,5
1683342121169,WCWP 10B,B00,201722,Staff,9,0,15,6
1683342122194,WCWP 100,A00,201725,Gagnon; Jeffrey C,0,0,2,2
1683342122194,WCWP 100,B00,201727,Staff,0,4,15,15
1683342125323,ANBI 133,A00,258401,Wilder; Linnea Lorene,34,0,40,6
1683342126350,ANBI 140,A00,258395,Hrvoj Mihic; Branka,18,0,25,7
1683342127374,ANSC 120,A00,258402,Bialecki; Jon Anthony,27,0,40,13
1683342128401,ANSC 144,A00,258400,Staff,14,0,40,26
1683342130458,ANSC 166,A00,258396,Parish; Steven Martin,157,0,175,18
1683342131483,ANSC 180,A00,193533,Staff,9,0,20,11
1683342132507,ANSC 188,A00,258397,Jassal; Aftab,33,0,40,7
1683342133530,ANTH 3,A01,258316,Staff,23,0,30,7
1683342134554,ANTH 5,A00,258394,Semendeferi; Ekaterini,16,0,20,4
1683342135579,ANTH 21,A01,258331,Staff,8,0,40,32
1683342136603,ANTH 103,A00,258398,Varma; Saiba,15,0,25,10
1683342137635,AWP 10,001,202034,Staff,0,0,0,0
1683342137635,AWP 10,002,202035,Staff,0,0,0,0
1683342137635,AWP 10,003,202036,Staff,0,0,0,0
1683342137635,AWP 10,004,202037,Staff,0,0,0,0
1683342137635,AWP 10,005,202038,Staff,0,0,0,0
1683342137635,AWP 10,006,202039,Staff,0,0,0,0
1683342137635,AWP 10,007,202040,Staff,0,0,0,0
1683342137635,AWP 10,008,202041,Staff,0,0,0,0
1683342137635,AWP 10,009,202042,Staff,0,0,0,0
1683342137635,AWP 10,010,202043,Staff,0,0,0,0
1683342137635,AWP 10,011,202044,Staff,0,0,0,0
1683342137635,AWP 10,012,202045,Staff,0,0,0,0
1683342137635,AWP 10,013,202046,Staff,0,0,0,0
1683342137635,AWP 10,014,202047,Staff,0,0,0,0
1683342137635,AWP 10,015,202048,Staff,0,0,0,0
1683342137635,AWP 10,016,202049,Staff,0,0,0,0
1683342137635,AWP 10,017,202050,Staff,0,0,0,0
1683342137635,AWP 10,018,202051,Staff,0,0,0,0
1683342137635,AWP 10,019,202052,Staff,0,0,0,0
1683342137635,AWP 10,020,202053,Staff,0,0,0,0
1683342137635,AWP 10,021,202054,Staff,0,0,0,0
1683342137635,AWP 10,022,202055,Staff,0,0,0,0
1683342137635,AWP 10,023,202056,Staff,0,0,0,0
1683342137635,AWP 10,024,202057,Staff,0,0,0,0
1683342137635,AWP 10,025,202058,Staff,0,0,0,0
1683342137635,AWP 10,026,202059,Staff,0,0,0,0
1683342138659,AWP 102,001,202032,Staff,0,0,0,0
1683342138659,AWP 102,002,202033,Staff,0,0,0,0
1683342139686,BENG 100,A01,254234,Taylor Amos; Alyssa C,31,0,40,9
1683342140712,BENG 196,001,270013,Engler; Adam J.,9999,0,9999,0
1683342141742,BICD 100R,A01,202018,Smith; Laurie,0,7,32,32
1683342141742,BICD 100R,A02,202019,Smith; Laurie,0,2,32,32
1683342141742,BICD 100R,A03,202020,Smith; Laurie,0,1,32,32
1683342141742,BICD 100R,A04,202021,Smith; Laurie,9,0,32,23
1683342141742,BICD 100R,A05,202022,Smith; Laurie,12,0,32,20
1683342142769,BICD 136,A01,193242,Gustafson-Brown; Cindy,0,2,32,32
1683342142769,BICD 136,A02,193244,Gustafson-Brown; Cindy,14,0,32,18
1683342143798,BIEB 102,A01,193249,Butler; Shannon Rhey,0,2,32,32
1683342143798,BIEB 102,A02,193251,Butler; Shannon Rhey,0,0,32,32
1683342143798,BIEB 102,A03,193253,Butler; Shannon Rhey,0,1,32,32
1683342143798,BIEB 102,A04,193255,Butler; Shannon Rhey,17,0,32,15
1683342143798,BIEB 102,A05,193265,Butler; Shannon Rhey,26,0,32,6
1683342143798,BIEB 102,A06,193269,Butler; Shannon Rhey,16,0,32,16
1683342145866,BIEB 150,A01,193274,Staff,0,0,32,32
1683342145866,BIEB 150,A02,193285,Staff,23,0,32,9
1683342146894,BIEB 194,A00,193286,Kurle; Carolyn M.,22,0,32,10
1683342147919,BILD 1,A01,192291,Staff,16,0,32,16
1683342147919,BILD 1,A02,192292,Staff,30,0,32,2
1683342147919,BILD 1,B01,192520,Reuther; Keefe,0,1,0,0
1683342147919,BILD 1,B02,192532,Reuther; Keefe,0,1,0,0
1683342148951,BILD 3,A01,192556,Butler; Shannon Rhey,0,0,32,32
1683342148951,BILD 3,A02,192581,Butler; Shannon Rhey,5,0,32,27
1683342148951,BILD 3,A03,192611,Butler; Shannon Rhey,23,0,32,9
1683342148951,BILD 3,A04,192612,Butler; Shannon Rhey,25,0,32,7
1683342148951,BILD 3,A05,192613,Butler; Shannon Rhey,27,0,32,5
1683342148951,BILD 3,A06,192679,Butler; Shannon Rhey,27,0,32,5
1683342148951,BILD 3,A07,192682,Butler; Shannon Rhey,22,0,32,10
1683342149981,BILD 4,A01,192836,Reuther; Keefe,0,0,24,24
1683342149981,BILD 4,A02,193044,Reuther; Keefe,4,0,24,20
1683342151006,BILD 10,A01,193142,Gustafson-Brown; Cindy,30,0,32,2
1683342151006,BILD 10,A02,193149,Gustafson-Brown; Cindy,31,0,32,1
1683342152040,BIMM 100,A01,193301,Staff,0,6,32,32
1683342152040,BIMM 100,A02,193312,Staff,0,5,32,32
1683342152040,BIMM 100,A03,193323,Staff,0,8,32,32
1683342153064,BIMM 101,A01,193329,McDonnell; Lisa Marie,0,3,24,24
1683342153064,BIMM 101,A02,193339,McDonnell; Lisa Marie,0,3,24,24
1683342153064,BIMM 101,B01,193354,McDonnell; Lisa Marie,0,3,24,24
1683342153064,BIMM 101,B02,193357,McDonnell; Lisa Marie,0,3,24,24
1683342154087,BIMM 110,A01,193377,Tat; John,0,11,32,32
1683342154087,BIMM 110,A02,193378,Tat; John,1,9,32,31
1683342155116,BIMM 120,A01,206116,Staff,0,0,32,32
1683342155116,BIMM 120,A02,206117,Staff,8,0,32,24
1683342155116,BIMM 120,A03,206121,Staff,21,0,32,11
1683342156140,BIPN 100,A01,193393,Park; Ji Young,0,14,32,32
1683342156140,BIPN 100,A02,193402,Park; Ji Young,0,13,32,32
1683342156140,BIPN 100,A03,193413,Park; Ji Young,0,14,32,32
1683342156140,BIPN 100,A04,193414,Park; Ji Young,0,13,32,32
1683342157165,BIPN 102,A01,193429,Staff,0,0,32,32
1683342157165,BIPN 102,A02,193438,Staff,22,0,32,10
1683342158193,BIPN 106,A01,193450,Reyes Gonzalez; Catalina,0,2,40,40
1683342159220,BIPN 134,A01,193465,Cooke; James Edward,0,0,32,32
1683342159220,BIPN 134,A02,193474,Cooke; James Edward,25,0,32,7
1683342159220,BIPN 134,A03,193485,Cooke; James Edward,29,0,32,3
1683342159220,BIPN 134,A04,193486,Cooke; James Edward,21,0,32,11
1683342159220,BIPN 134,A05,193491,Cooke; James Edward,31,0,32,1
1683342159220,BIPN 134,A06,193501,Cooke; James Edward,30,0,32,2
1683342159220,BIPN 134,A07,193510,Cooke; James Edward,29,0,32,3
1683342161267,BISP 194,A00,222522,Staff,14,0,32,18
1683342162294,CAT 124,A01,202407,Staff,20,0,25,5
1683342163319,CAT 125,A00,202408,Marchisotto; Jennifer Anne,4,0,20,16
1683342164344,CAT 125R,A00,202409,Smith; Lauryn Alissa,0,11,20,20
1683342164344,CAT 125R,B00,202410,Morales; Celeste Georgianna,0,11,20,20
1683342164344,CAT 125R,C00,202411,Irwin; Matthew Joseph,0,10,20,20
1683342165369,CENG 15,A01,204712,Yang; Kesong,0,1,0,0
1683342166394,CENG 114,A00,202070,Jahed Motlagh; Zeinab,5,0,20,15
1683342167419,CGS 105,A00,185477,Wesling; Megan E.,24,0,40,16
1683342168445,CGS 106,A00,185494,Staff,13,0,22,9
1683342169470,CGS 108,A00,185495,Staff,14,0,20,6
1683342170498,CGS 114,A00,185496,Staff,13,0,18,5
1683342171525,CGS 119,A00,185501,Staff,15,0,20,5
1683342172551,CGS 120,A00,185511,Staff,13,0,20,7
1683342173644,CHEM 4,A01,184675,Bussey; Thomas J,96,0,100,4
1683342174674,CHEM 6A,A01,184677,Staff,34,0,60,26
1683342175697,CHEM 6B,A01,184679,Staff,65,0,100,35
1683342176722,CHEM 6C,A01,184681,Bussey; Thomas J,1,0,50,49
1683342176722,CHEM 6C,A02,184682,Bussey; Thomas J,34,0,50,16
1683342177747,CHEM 40A,A01,184684,Albizati; Kim F.,37,0,100,63
1683342178770,CHEM 40B,A01,184686,Albizati; Kim F.,0,20,100,100
1683342179797,CHEM 41B,A01,184690,Staff,52,0,100,48
1683342180825,COGS 3,A01,184715,Boyle; Mary E. T.,0,25,40,40
1683342181853,COGS 14B,A01,185172,Staff,0,15,38,38
1683342182881,COGS 18,A01,184736,Staff,17,0,80,63
1683342183907,COGS 100,A01,184932,Staff,0,5,73,73
1683342184930,COGS 101A,A01,184935,Staff,0,39,30,30
1683342185958,COGS 101B,A01,184944,Staff,0,2,30,30
1683342186988,COGS 101C,A01,184946,Staff,0,12,30,30
1683342188015,COGS 102A,A01,184951,Johnson; Christine M.,2,0,40,38
1683342189039,COGS 107B,A01,184953,Mooshagian; Eric Frederick,0,50,40,40
1683342190065,COGS 118B,A01,184959,Gupta; Anjum,0,48,40,40
1683342191089,COGS 153,A00,184961,Staff,0,15,30,30
1683342192111,COGS 177,A00,184962,Staff,0,20,30,30
1683342193135,COGS 187A,A01,184969,Boyle; Mary E. T.,0,17,40,40
1683342194160,COMM 10,A01,185174,Staff,0,5,25,25
1683342194160,COMM 10,A02,185189,Staff,0,5,25,25
1683342194160,COMM 10,A03,269821,Staff,0,0,0,0
1683342195184,COMM 100B,A01,185475,Staff,0,0,0,2
1683342195184,COMM 100B,A02,185476,Staff,13,0,25,12
1683342196212,COMM 100C,A01,185314,Staff,1,0,25,24
1683342196212,COMM 100C,A02,185327,Staff,19,0,25,6
1683342197237,COMM 110M,A00,185349,Staff,2,0,40,38
1683342198261,COMM 113T,A00,185352,Staff,24,0,40,16
1683342199286,COMM 114I,A00,185353,Staff,33,0,40,7
1683342200311,COMM 131,A00,185354,Staff,19,0,30,11
1683342201336,CSE 8A,A50,185358,Cao; Yingjun,0,46,10,10
1683342202364,CSE 8B,A01,185362,Staff,1,47,50,49
1683342203392,CSE 11,A01,185416,Cao; Yingjun,0,92,10,10
1683342204420,CSE 20,A01,185445,Briones; Jor-el Thomas Caparas,5,0,25,20
1683342205444,CSE 21,A01,185447,Staff,10,0,50,40
1683342206468,CSE 101,A01,185451,Staff,0,13,50,50
1683342206468,CSE 101,B01,185453,Jones; Miles E,0,11,50,50
1683342208518,CSE 141,A01,185458,Eldon; John,20,0,100,80
1683342209546,CSE 141L,A01,185461,Eldon; John,12,0,100,88
1683342210573,CSE 142,A01,185463,Staff,36,0,60,24
1683342210573,CSE 142,B01,201355,Staff,0,7,60,60
1683342211601,CSE 142L,A01,185470,Staff,36,0,60,24
1683342211601,CSE 142L,B01,201417,Staff,0,6,60,60
1683342212628,CSE 190,A00,201433,Staff,32,0,49,17
1683342213656,DOC 1,A01,259136,Strom; Megan C.,7,0,15,8
1683342213656,DOC 1,A02,259137,Strom; Megan C.,14,0,15,1
1683342213656,DOC 1,A03,259138,Strom; Megan C.,14,0,15,1
1683342213656,DOC 1,A04,259139,Strom; Megan C.,14,0,15,1
1683342214680,DOC 100D,A00,259140,Pass; Natalye Joann,16,0,25,9
1683342215704,DSGN 1,A01,184749,Rill; Bryan,0,25,30,30
1683342216728,DSGN 100,A01,185168,Staff,0,2,25,25
1683342217752,ECE 5,A01,185626,Morris; Karcher William,0,10,0,0
1683342218778,ECE 101,A01,185628,Staff,17,0,70,53
1683342219803,ECE 107,A01,185635,Baghdadchi; Saharnaz,0,0,20,20
1683342219803,ECE 107,A02,185638,Baghdadchi; Saharnaz,4,0,20,16
1683342220830,ECE 148,A01,185647,Silberman; Jack,0,0,16,16
1683342221857,ECON 1,A01,185537,Crane; Meredith Helen,54,0,70,16
1683342222882,ECON 3,A01,185549,Crane; Meredith Helen,32,0,70,38
1683342223909,ECON 4,A01,203354,Anderson; John Charles,0,4,10,10
1683342224936,ECON 100A,A01,185574,Staff,0,4,40,40
1683342225963,ECON 100B,A01,185576,Staff,10,22,50,40
1683342226990,ECON 100C,A01,185589,Newhouse; Herbert S,30,0,70,40
1683342228018,ECON 105,A00,185608,Vespa; Emanuel Ignacio,19,0,35,16
1683342229043,ECON 109,A01,185610,Shishkin; Denis,10,0,35,25
1683342230068,ECON 110A,A01,185612,Staff,11,0,40,29
1683342231093,ECON 120A,A01,185615,Staff,20,0,40,20
1683342232117,ECON 120C,A01,185617,Sun; Yixiao,0,20,70,70
1683342233140,ECON 144,A00,203346,Squires; Dale E,3,0,35,32
1683342234164,ECON 171,A01,203349,Newhouse; Herbert S,0,1,35,35
1683342235189,ECON 173A,A01,185621,Toda; Alexis Akira,21,0,35,14
1683342236213,EDS 25,A01,202413,Staff,0,1,0,0
1683342236213,EDS 25,A02,202414,Staff,0,1,0,0
1683342236213,EDS 25,A03,202415,Staff,0,0,0,0
1683342236213,EDS 25,A04,202416,Staff,0,1,0,0
1683342236213,EDS 25,A05,202439,Staff,0,0,0,0
1683342236213,EDS 25,A06,202440,Staff,0,0,0,0
1683342236213,EDS 25,B01,202631,Staff,0,0,0,0
1683342236213,EDS 25,B02,202632,Staff,0,0,0,0
1683342236213,EDS 25,B03,202639,Staff,0,0,0,0
1683342236213,EDS 25,B04,202640,Staff,0,0,0,0
1683342236213,EDS 25,B05,202643,Staff,0,0,0,0
1683342236213,EDS 25,B06,202644,Staff,0,0,0,0
1683342237240,EDS 38,A01,202659,Black; Alison Michelle,24,0,25,1
1683342238262,EDS 115,A00,202652,Staff,18,0,30,12
1683342239290,EDS 125,A00,202649,Staff,14,0,30,16
1683342240318,EDS 126,A01,203332,Staff,30,0,30,0
1683342241340,EDS 139,A00,202838,Staff,16,0,25,9
1683342242369,EDS 146,A01,202655,Staff,14,0,25,11
1683342243394,ENG 15,A00,185667,Staff,0,1,0,0
1683342243394,ENG 15,B00,185672,Staff,0,0,0,0
1683342243394,ENG 15,C00,185675,Staff,0,0,0,0
1683342243394,ENG 15,D00,185682,Staff,0,0,0,0
1683342243394,ENG 15,E00,185684,Staff,0,0,0,0
1683342244418,ETHN 103,A00,185710,Staff,0,4,35,35
1683342245440,ETHN 103A,A00,199228,Man; Simeon S,2,0,9,7
1683342246465,ETHN 109,A00,185711,Staff,18,0,35,17
1683342247490,ETHN 142,A00,185726,Staff,0,4,30,30
1683342248514,ETHN 163J,A00,199229,Man; Simeon S,5,0,8,3
1683342249540,ETHN 168,A00,185727,Staff,8,0,10,2
1683342250568,ETHN 182,A00,185728,Staff,1,0,35,34
1683342251595,ETHN 183,A00,185737,Staff,8,0,18,10
1683342252620,GLBH 111,A01,209361,Burgos; Jose L.,0,0,0,0
1683342254674,HIEU 104,A00,185792,Staff,16,0,20,4
1683342255701,HIEU 115,A00,185800,Staff,1,0,20,19
1683342256729,HIEU 128,A00,185801,Staff,0,7,20,20
1683342257755,HIEU 147,A00,185802,Staff,16,0,20,4
1683342258782,HIEU 154,A00,185823,Staff,12,0,20,8
1683342259809,HILA 102,A00,185826,Staff,13,0,20,7
1683342260834,HILD 2C,A01,185778,Staff,0,12,20,20
1683342261859,HILD 7B,A01,185780,Kwak; Nancy,0,15,32,32
1683342261859,HILD 7B,A02,185781,Kwak; Nancy,0,18,32,32
1683342262883,HILD 30,A01,185791,Staff,14,0,20,6
1683342263908,HISC 119,A00,185830,Golan; Tal,0,9,20,20
1683342264932,HITO 156GS,A00,185831,Patterson; Patrick H.,0,0,0,23
1683342265960,HIUS 103,A00,185832,Man; Simeon S,0,6,20,20
1683342266985,HIUS 117,A00,185836,Kwak; Nancy,2,0,20,18
1683342268013,HIUS 125,A00,185840,Man; Simeon S,0,0,23,23
1683342269040,HIUS 149,A00,185845,Staff,0,0,20,20
1683342270066,HUM 3,A01,185882,Zavodny; Tatiana Sophia,0,7,50,50
1683342270066,HUM 3,B01,185899,Caldwell; Michael Alan,0,18,50,50
1683342271094,HUM 3GS,A00,185900,Patterson; Patrick H.,0,0,0,23
1683342272125,HUM 4,A01,185938,Zroka; Amy Liane,31,0,50,19
1683342272125,HUM 4,B01,185956,Watkins; Eric,0,2,50,50
1683342272125,HUM 4,B02,202209,Watkins; Eric,0,2,50,50
1683342272125,HUM 4,B03,202210,Watkins; Eric,0,2,50,50
1683342273154,HUM 5,A01,185958,West; Geoffrey Scott,3,0,50,47
1683342273154,HUM 5,A02,202215,West; Geoffrey Scott,0,0,50,50
1683342274178,INTL 190,A00,185959,Gagnon; Jeffrey C,0,0,0,9
1683342274178,INTL 190,B00,185960,Lettieri; Michael Joseph,0,0,0,1
1683342275203,JAPN 180,A00,254509,Staff,5,1,30,25
1683342276231,LATI 10,A01,202853,Kennemore; Amy Michelle,4,0,35,31
1683342276231,LATI 10,A02,202854,Kennemore; Amy Michelle,2,0,35,33
1683342276231,LATI 10,A03,270054,Kennemore; Amy Michelle,30,0,30,0
1683342277318,LATI 180,A00,202855,Kennemore; Amy Michelle,11,0,20,9
1683342278345,LAWS 101,A00,201767,Golan; Tal,0,7,40,40
1683342279370,LIFR 1C,A00,185961,Staff,6,0,20,14
1683342280396,LIFR 1CX,A00,185962,Staff,7,0,20,13
1683342281421,LIFR 1D,A00,185963,Staff,9,0,20,11
1683342282447,LIFR 1DX,A00,185964,Staff,9,0,20,11
1683342283476,LIGN 101,A01,186039,Staff,43,0,50,7
1683342284502,LIGN 165,A00,186040,Staff,18,0,50,32
1683342285529,LTCS 108,A00,186041,Staff,6,0,10,4
1683342286554,LTCS 119,A00,186042,Staff,16,0,20,4
1683342287580,LTCS 130,A00,186043,Wesling; Megan E.,15,0,25,10
1683342289630,LTEA 138,A00,186119,Staff,14,0,40,26
1683342290654,LTEN 124,A00,186148,Staff,6,0,25,19
1683342291683,LTEN 178,A00,186149,Staff,7,0,15,8
1683342292711,LTEN 181,A00,186150,Blanco; John D,33,0,40,7
1683342293735,LTWL 120,A00,186160,Staff,20,0,25,5
1683342294761,LTWL 165,A00,186161,Staff,22,0,25,3
1683342295794,LTWR 100,A00,186162,Staff,0,5,15,15
1683342296819,LTWR 102,A00,186163,Doller; Ben,5,0,15,10
1683342297844,MAE 8,A01,186412,Staff,0,0,0,0
1683342298868,MAE 30B,A00,186445,Bahadori; Mohammad Yousef,83,0,100,17
1683342299893,MAE 40,A00,186592,Bewley; Thomas R,9,0,50,41
1683342300916,MAE 101B,A00,186593,Bahadori; Mohammad Yousef,81,0,100,19
1683342301943,MAE 105,A00,186594,Bandaru; Prabhakar,12,0,50,38
1683342302967,MAE 107,A00,186599,Pham; Hieu Tan,0,6,120,120
1683342303991,MAE 148,A01,186660,Silberman; Jack,3,0,16,13
1683342305015,MATH 10A,A01,188095,Staff,1,6,35,34
1683342306046,MATH 10B,A01,188097,Bowers; Adam R.,0,11,30,30
1683342306046,MATH 10B,A02,188099,Bowers; Adam R.,0,11,30,30
1683342306046,MATH 10B,B01,188104,Bowers; Adam R.,0,10,30,30
1683342306046,MATH 10B,B02,188106,Bowers; Adam R.,0,10,30,30
1683342307077,MATH 10C,A01,188111,Staff,0,18,30,30
1683342307077,MATH 10C,A02,188127,Staff,0,17,30,30
1683342307077,MATH 10C,A03,188131,Staff,0,18,30,30
1683342307077,MATH 10C,B01,188218,Staff,18,0,30,12
1683342307077,MATH 10C,B02,188244,Staff,13,0,30,17
1683342307077,MATH 10C,B03,188277,Staff,16,0,30,14
1683342308106,MATH 18,A01,188344,Bach; Quang Tran,18,0,30,12
1683342308106,MATH 18,A02,188345,Bach; Quang Tran,11,0,30,19
1683342308106,MATH 18,B01,188353,Bach; Quang Tran,10,0,30,20
1683342308106,MATH 18,B02,188354,Bach; Quang Tran,20,0,30,10
1683342309130,MATH 20A,A01,188374,Staff,13,0,35,22
1683342310153,MATH 20B,A01,188382,Ohm; Ko Woon,6,0,30,24
1683342310153,MATH 20B,A02,188383,Ohm; Ko Woon,22,0,30,8
1683342310153,MATH 20B,B01,188385,Ohm; Ko Woon,7,0,30,23
1683342310153,MATH 20B,B02,188392,Ohm; Ko Woon,22,0,30,8
1683342311181,MATH 20C,A01,188394,Harel; Guershon,10,0,30,20
1683342311181,MATH 20C,A02,188395,Harel; Guershon,15,0,30,15
1683342311181,MATH 20C,B01,188404,Harel; Guershon,5,0,30,25
1683342311181,MATH 20C,B02,188405,Harel; Guershon,19,0,30,11
1683342312205,MATH 20D,A01,188414,Hammock; Frances H,0,1,30,30
1683342312205,MATH 20D,A02,188415,Hammock; Frances H,3,0,30,27
1683342312205,MATH 20D,B01,188447,Hammock; Frances H,1,0,30,29
1683342312205,MATH 20D,B02,188486,Hammock; Frances H,8,0,30,22
1683342313228,MATH 20E,A01,188649,Staff,21,0,30,9
1683342313228,MATH 20E,A02,188650,Staff,23,0,30,7
1683342313228,MATH 20E,A03,188673,Staff,0,0,30,30
1683342314255,MATH 102,A01,188675,Staff,0,35,35,35
1683342315282,MATH 103B,A01,188681,Staff,3,0,35,32
1683342315282,MATH 103B,B01,188692,Staff,5,0,35,30
1683342316305,MATH 109,A01,188695,Salehi Golsefidy; Alireza,25,0,35,10
1683342316305,MATH 109,A02,188696,Salehi Golsefidy; Alireza,25,0,35,10
1683342317333,MATH 120A,A01,188698,Eggers; John Dietrich,7,0,35,28
1683342318361,MATH 142B,A01,188736,Ioana; Adrian,0,2,30,30
1683342318361,MATH 142B,A02,188741,Ioana; Adrian,1,1,30,29
1683342318361,MATH 142B,A03,188743,Ioana; Adrian,1,3,30,29
1683342319385,MATH 168A,A01,188790,Staff,0,9,35,35
1683342320410,MATH 170A,A01,188803,Nie; Jiawang,0,2,35,35
1683342320410,MATH 170A,A02,188811,Nie; Jiawang,0,0,35,35
1683342320410,MATH 170A,A03,188814,Nie; Jiawang,1,0,35,34
1683342320410,MATH 170A,A04,188815,Nie; Jiawang,13,0,35,22
1683342321438,MATH 193B,A01,188817,Staff,0,0,35,35
1683342321438,MATH 193B,A02,188818,Staff,5,0,35,30
1683342322462,MGT 4,A01,202857,Anderson; John Charles,62,0,80,18
1683342323486,MGT 12,A00,202858,Lindenberger; Wade Douglas,42,0,90,48
1683342324511,MGT 18,A00,202859,Staff,74,0,90,16
1683342325536,MGT 18GS,A00,202860,McKay; Michael J,13,0,28,15
1683342326560,MGT 45,A00,202861,Pecore; Joseph P.,14,0,90,76
1683342327588,MGT 100,A00,202863,Yavorsky; Daniel Ryan,28,0,90,62
1683342328613,MGT 103,A00,202864,Ehrich; Kristine R,1,18,90,89
1683342329638,MGT 112,A00,202865,Ehrich; Kristine R,15,0,90,75
1683342330662,MGT 121A,A00,202868,Staff,0,20,0,0
1683342331686,MGT 131B,A00,202869,Anderson; John Charles,59,0,90,31
1683342332710,MGT 136,A00,202871,Lindenberger; Wade Douglas,84,0,90,6
1683342333737,MGT 164,A00,202873,Staff,0,68,90,91
1683342334760,MGT 164GS,A00,202874,McKay; Mary A,13,0,28,15
1683342335784,MGT 180,A00,202875,Staff,0,50,90,91
1683342336809,MMW 11R,A01,205019,Herbst; Matthew,3,0,30,27
1683342336809,MMW 11R,A02,205026,Herbst; Matthew,29,0,30,1
1683342337837,MMW 15,A01,193512,Chang; Edmond Yi-Teh,0,9,28,28
1683342337837,MMW 15,A02,193513,Chang; Edmond Yi-Teh,0,5,28,28
1683342337837,MMW 15,A03,193514,Chang; Edmond Yi-Teh,0,5,28,28
1683342337837,MMW 15,A04,193515,Chang; Edmond Yi-Teh,0,5,28,28
1683342337837,MMW 15,A05,193516,Chang; Edmond Yi-Teh,0,4,28,28
1683342337837,MMW 15,A06,193517,Chang; Edmond Yi-Teh,0,5,28,28
1683342337837,MMW 15,B01,193519,Chang; Edmond Yi-Teh,0,5,28,28
1683342337837,MMW 15,B02,193520,Chang; Edmond Yi-Teh,0,5,28,28
1683342337837,MMW 15,B03,193521,Chang; Edmond Yi-Teh,0,5,28,28
1683342337837,MMW 15,B04,193522,Chang; Edmond Yi-Teh,0,4,28,28
1683342337837,MMW 15,B05,193523,Chang; Edmond Yi-Teh,0,5,28,28
1683342337837,MMW 15,B06,193524,Chang; Edmond Yi-Teh,0,4,28,28
1683342338862,MMW 122,A01,193526,Rahimi; Babak,0,15,28,28
1683342338862,MMW 122,A02,193527,Rahimi; Babak,0,14,28,28
1683342338862,MMW 122,A03,193528,Rahimi; Babak,0,0,0,0
1683342338862,MMW 122,A04,193529,Rahimi; Babak,0,0,0,0
1683342339886,MUS 1A,A01,186663,Staff,0,20,35,35
1683342340910,MUS 4,A01,186715,Staff,0,12,35,35
1683342341935,MUS 5R,A01,186796,Dubnov; Shlomo,0,17,35,35
1683342342959,MUS 6,A01,186798,Staff,0,4,25,25
1683342343987,MUS 7,A01,186830,Staff,13,0,35,22
1683342345011,MUS 8,A01,186930,Staff,0,26,35,35
1683342346040,MUS 15,A01,186932,Staff,0,16,35,35
1683342346040,MUS 15,B01,186934,Staff,0,15,35,35
1683342347066,MUS 80,A00,186935,Staff,1,0,20,19
1683342347066,MUS 80,B00,186936,Staff,25,0,25,0
1683342348090,NANO 11,A00,204702,Lipomi; Darren John,0,0,0,0
1683342349113,NANO 15,A01,204709,Yang; Kesong,0,1,0,0
1683342350136,NANO 114,A00,202069,Jahed Motlagh; Zeinab,3,0,10,7
1683342351164,PHIL 1,A00,186955,Grush; Rick Scott,32,0,40,8
1683342352187,PHIL 10,A01,186973,Grush; Rick Scott,28,0,35,7
1683342352187,PHIL 10,A02,186974,Grush; Rick Scott,33,0,35,2
1683342353211,PHIL 13,A01,186976,Staff,7,0,35,28
1683342353211,PHIL 13,A02,186977,Staff,16,0,35,19
1683342354239,PHIL 14,A01,186979,Staff,31,0,35,4
1683342354239,PHIL 14,A02,186986,Staff,32,0,35,3
1683342355264,PHIL 28,A01,186988,Staff,16,0,30,14
1683342355264,PHIL 28,A02,186989,Staff,1,0,30,29
1683342355264,PHIL 28,A03,186990,Staff,9,0,30,21
1683342355264,PHIL 28,A04,186991,Staff,26,0,30,4
1683342356291,PHIL 120,A00,186997,Staff,23,0,40,17
1683342357316,PHIL 137,A00,187003,Staff,9,0,40,31
1683342358339,PHIL 150,A00,187015,Staff,47,0,70,23
1683342359365,PHIL 167,A00,187021,Lamey; Andy M.,35,0,40,5
1683342360388,PHIL 174,A01,202226,Staff,17,0,20,3
1683342360388,PHIL 174,A02,202235,Staff,20,0,20,0
1683342361415,PHIL 191A,A00,258918,Staff,0,0,1,1
1683342362443,PHYS 1A,A00,187028,Staff,27,0,60,33
1683342363472,PHYS 1AL,001,187036,Staff,2,0,30,28
1683342363472,PHYS 1AL,002,187049,Staff,18,0,30,12
1683342364499,PHYS 1B,A00,187058,Staff,22,0,60,38
1683342365527,PHYS 1BL,001,187064,Staff,0,0,30,30
1683342365527,PHYS 1BL,002,187070,Staff,5,0,30,25
1683342366550,PHYS 1C,A00,187082,Staff,31,0,120,89
1683342367575,PHYS 1CL,001,187088,Staff,0,9,30,30
1683342367575,PHYS 1CL,002,187089,Staff,0,2,30,30
1683342367575,PHYS 1CL,009,262693,Staff,11,0,30,19
1683342368600,PHYS 2B,A01,187097,Staff,54,0,115,61
1683342369626,PHYS 2C,A01,187099,Staff,67,0,115,48
1683342370654,PHYS 2CL,A01,187101,Staff,5,0,28,23
1683342370654,PHYS 2CL,A02,187102,Staff,15,0,28,13
1683342371680,PHYS 2D,A01,187123,Shotwell; Brian,95,0,115,20
1683342372705,PHYS 4B,A01,187133,Grinstein; Benjamin,35,0,50,15
1683342373729,POLI 10,A00,188819,Staff,0,4,50,50
1683342374753,POLI 11,A00,188827,Staff,43,0,50,7
1683342375778,POLI 13R,A00,188828,Staff,0,1,20,20
1683342376803,POLI 27,A01,188830,Elgin; Samuel Zincke,0,1,70,70
1683342377825,POLI 30,A00,188832,Desposato; Scott,31,0,50,19
1683342378850,POLI 102F,A00,188834,Staff,3,0,40,37
1683342379875,POLI 104A,A00,188852,Staff,14,0,30,16
1683342380960,POLI 104I,A00,188853,Staff,0,6,20,20
1683342381985,POLI 110B,A00,188854,Wiens; David,7,0,20,13
1683342383010,POLI 112A,A00,188855,Wiens; David,5,0,30,25
1683342384036,POLI 117R,A00,188856,Forman; Fonna,0,11,20,20
1683342385060,POLI 118,A00,188857,Ingham; Sean,8,0,20,12
1683342386089,POLI 120G,A00,188858,Staff,9,0,30,21
1683342387112,POLI 131CR,A00,188863,Hoston; Germaine,24,0,50,26
1683342388135,POLI 133,A00,188864,Nellis; Gareth Hb,44,0,50,6
1683342389160,POLI 134D,A00,188865,Desposato; Scott,27,0,30,3
1683342390186,POLI 142A,A00,188871,Gartzke; Erik,22,0,50,28
1683342391213,POLI 142K,A00,188874,Staff,38,0,50,12
1683342392237,POLI 143,A00,188940,Gartzke; Erik,16,0,30,14
1683342393266,POLI 153,A00,188943,Staff,3,0,20,17
1683342394290,POLI 160AA,A00,188944,Staff,12,0,40,28
1683342395316,POLI 170A,A00,188945,Staff,11,0,30,19
1683342397368,PSYC 1,A00,188952,Staff,37,0,90,53
1683342398392,PSYC 2,B00,188953,Staff,19,0,35,16
1683342399416,PSYC 6,A00,188970,Staff,47,0,60,13
1683342400440,PSYC 7,A00,188973,Staff,37,0,45,8
1683342401468,PSYC 60,A01,188980,Rickard; Timothy C.,43,0,60,17
1683342402497,PSYC 70,A01,189001,Steiner; Eric Tomas,23,0,45,22
1683342403522,PSYC 100,A00,189005,Lacefield; Katharine I,0,98,120,120
1683342404550,PSYC 102,A00,189008,Staff,9,0,30,21
1683342405578,PSYC 106,B00,189026,Gorman; Michael R.,34,0,60,26
1683342406608,PSYC 114,B01,189033,Winkielman; Piotr,0,32,30,30
1683342407635,PSYC 131,A00,189036,Anagnostaras; Stephan,0,43,60,60
1683342408661,PSYC 136,A00,189041,Lowe; Angela Beth,0,7,25,25
1683342409689,PSYC 137,A00,189057,Winkielman; Piotr,0,34,25,25
1683342410717,PSYC 144,A00,189107,Wixted; John T,0,7,50,50
1683342412764,PSYC 162,A00,189142,Staff,0,8,85,85
1683342413792,PSYC 172,A00,189144,Gorman; Michael R.,0,7,30,30
1683342415841,PSYC 179,A00,189146,Lacefield; Katharine I,0,84,120,120
1683342416868,PSYC 181,A00,189147,Anagnostaras; Stephan,0,44,90,90
1683342417892,PSYC 190R,A00,189148,Barner; David A.,0,22,80,80
1683342418917,PSYC 191,A00,189275,Rickard; Timothy C.,0,7,25,25
1683342419942,PSYC 193,A00,189276,Chapman; Eddie Nathaniel,0,1,0,4
1683342420966,PSYC 193L,A01,189281,Lowe; Angela Beth,12,0,20,8
1683342420966,PSYC 193L,B01,189285,Staff,28,0,35,7
1683342421993,RELI 149,A00,187137,Rahimi; Babak,7,0,40,33
1683342423021,SE 9,A01,187315,Staff,0,2,18,18
1683342424049,SE 101B,A00,187409,Staff,24,0,30,6
1683342425074,SE 110B,A00,187444,Staff,10,0,40,30
1683342426102,SE 130B,A00,187449,Staff,31,0,40,9
1683342427130,SE 150A,A00,187516,Staff,9,0,20,11
1683342428155,SE 154,A00,187528,Staff,30,0,50,20
1683342429182,SIO 3,A01,258171,Staff,35,0,40,5
1683342430210,SIO 10,A00,187144,Cook; Geoffrey W,0,3,75,75
1683342431234,SIO 45,A00,187152,Cook; Geoffrey W,1,0,100,99
1683342432257,SIO 109R,A00,194486,Staff,0,3,20,20
1683342434309,SIO 187,A01,187233,Kacev; David,12,0,40,28
1683342435339,SOCI 1,A01,258656,Thorpe; Charles Robert,28,0,30,2
1683342435339,SOCI 1,A02,258658,Thorpe; Charles Robert,30,0,30,0
1683342435339,SOCI 1,A03,258661,Thorpe; Charles Robert,25,0,25,0
1683342435339,SOCI 1,A04,258666,Thorpe; Charles Robert,22,0,25,3
1683342435339,SOCI 1,A05,258897,Thorpe; Charles Robert,23,0,25,2
1683342435339,SOCI 1,A06,258898,Thorpe; Charles Robert,25,0,25,0
1683342436363,SOCI 30,A01,258903,Pardo Guerra; Juan Pablo,15,0,30,15
1683342437386,SOCI 102,A00,258904,Staff,9,0,25,16
1683342438416,SOCI 106,A00,258905,Staff,19,0,25,6
1683342439445,SOCI 111,A00,258907,Ribas Norris; Janet Vanesa,26,0,30,4
1683342440469,SOCI 121R,A00,258908,Pardo Guerra; Juan Pablo,10,0,30,20
1683342441493,SOCI 126,A01,203330,Staff,14,0,20,6
1683342442517,SOCI 131,A00,258909,Thorpe; Charles Robert,31,0,60,29
1683342443543,SOCI 135,A00,258910,Payne; Christine Anna,0,9,30,30
1683342444569,SOCI 157,A00,258911,Staff,12,0,30,18
1683342445593,SOCI 184,A00,258912,Staff,25,0,30,5
1683342446620,SOCI 188D,A00,258913,Staff,21,0,30,9
1683342447649,SYN 2,001,187529,Staff,10,0,16,6
1683342447649,SYN 2,002,201452,Staff,0,18,16,16
1683342447649,SYN 2,003,201469,Staff,3,0,16,13
1683342448674,SYN 100,A01,187531,Staff,0,9,20,20
1683342448674,SYN 100,B01,201491,Staff,0,12,20,20
1683342449702,TDAC 1,A00,189286,Walsh; Kim C.,3,0,20,17
1683342449702,TDAC 1,B00,189287,Harting; Carla Kelso,11,0,20,9
1683342450730,TDAC 101,A00,189300,Walsh; Kim C.,16,0,20,4
1683342450730,TDAC 101,B00,189301,Harting; Carla Kelso,18,0,20,2
1683342451755,TDAC 102,A00,189304,Basso; Beatrice,14,0,20,6
1683342452780,TDAC 108,A00,189305,Staff,18,0,20,2
1683342453810,TDDE 131,A00,189310,Staff,19,0,20,1
1683342453810,TDDE 131,B00,189314,Staff,19,0,20,1
1683342453810,TDDE 131,C00,189315,Staff,48,0,50,2
1683342453810,TDDE 131,D00,189316,Staff,14,0,15,1
1683342453810,TDDE 131,E00,204841,Staff,20,0,20,0
1683342454837,TDGE 10,A00,189289,Staff,30,0,50,20
1683342454837,TDGE 10,B00,189290,Havis; Allan,1,0,50,49
1683342455866,TDGE 11,A00,189291,Fulton; Julia,0,3,50,50
1683342455866,TDGE 11,B00,189292,Staff,20,0,25,5
1683342455866,TDGE 11,C00,260270,Staff,0,0,0,0
1683342456894,TDGE 25,A00,189294,Staff,3,0,20,17
1683342457919,TDGE 124,A00,189318,Fulton; Julia,0,8,50,50
1683342458943,TDGE 125,A00,189319,Staff,13,0,25,12
1683342458943,TDGE 125,B00,189320,Staff,23,0,25,2
1683342459967,TDGE 127,A00,189322,Havis; Allan,0,0,50,50
1683342460994,TDHT 101,A00,189323,Staff,18,0,25,7
1683342460994,TDHT 101,B00,189324,Staff,25,0,25,0
1683342462022,TDHT 102,A00,189325,Staff,49,0,50,1
1683342463051,TDMV 1,A00,189295,Arcidiacono; Kristin,19,0,30,11
1683342463051,TDMV 1,B00,189296,Caligagan; Maria T.,24,0,30,6
1683342464075,TDMV 2,A00,189297,Sammartano; Tonnie,28,0,30,2
1683342464075,TDMV 2,B00,189299,Arcidiacono; Kristin,24,0,30,6
1683342465098,TDMV 3,A00,204998,Rincon; Alicia,22,0,30,8
1683342466127,TDMV 120,A00,189458,Sammartano; Tonnie,28,0,30,2
1683342467154,TDMV 138,A00,189541,Jun; Grace Shin Hae,22,0,40,18
1683342468179,TDMV 142,A00,189717,Caligagan; Tony,23,0,30,7
1683342468179,TDMV 142,B00,189718,Caligagan; Maria T.,25,0,30,5
1683342469203,TMC 2,A01,187533,Staff,25,0,25,0
1683342469203,TMC 2,A02,187534,Staff,25,0,25,0
1683342470231,USP 1,A01,187536,Kwak; Nancy,0,16,25,25
1683342471255,USP 5,A01,187538,Staff,10,0,25,15
1683342472280,USP 101,A00,199253,Staff,0,4,0,0
1683342473303,USP 124,A00,187562,Boomhower; Matthew Charles,1,0,30,29
1683342474326,USP 138,A00,187582,Staff,20,0,25,5
1683342475352,USP 152,A01,187597,Staff,4,0,25,21
1683342476378,USP 153,A00,187598,Staff,19,0,25,6
1683342477404,USP 168,A00,187607,Kwak; Nancy,2,0,5,3
1683342478431,USP 173,A00,187619,Staff,4,0,25,21
1683342479462,USP 181,A00,187638,Staff,0,0,25,25
1683342480490,VIS 103,A00,187650,Cruz; Edwin Teddy,23,0,75,52
1683342481518,VIS 110D,A00,187669,Staff,12,0,22,10
1683342482546,VIS 127C,A00,187720,Shen; Kuiyi,67,0,146,79
1683342483575,VIS 149,A00,187731,Yoldas; Pinar,0,14,22,22
1683342484656,VIS 151,A01,188091,Staff,22,0,34,12
1683342484656,VIS 151,A02,188092,Staff,11,0,34,23
1683342485685,VIS 160B,A00,188093,Stalbaum; Brett,0,0,10,10
1683342487738,WCWP 10B,A00,201720,Staff,10,0,15,5
1683342487738,WCWP 10B,B00,201722,Staff,9,0,15,6
1683342488764,WCWP 100,A00,201725,Gagnon; Jeffrey C,0,0,2,2
1683342488764,WCWP 100,B00,201727,Staff,0,4,15,15
1683342491856,ANBI 133,A00,258401,Wilder; Linnea Lorene,34,0,40,6
1683342492883,ANBI 140,A00,258395,Hrvoj Mihic; Branka,18,0,25,7
1683342493908,ANSC 120,A00,258402,Bialecki; Jon Anthony,27,0,40,13
1683342494932,ANSC 144,A00,258400,Staff,14,0,40,26
1683342496988,ANSC 166,A00,258396,Parish; Steven Martin,157,0,175,18
1683342498013,ANSC 180,A00,193533,Staff,9,0,20,11
1683342499039,ANSC 188,A00,258397,Jassal; Aftab,33,0,40,7
1683342500070,ANTH 3,A01,258316,Staff,23,0,30,7
1683342501095,ANTH 5,A00,258394,Semendeferi; Ekaterini,16,0,20,4
1683342502125,ANTH 21,A01,258331,Staff,8,0,40,32
1683342503151,ANTH 103,A00,258398,Varma; Saiba,15,0,25,10
1683342504186,AWP 10,001,202034,Staff,0,0,0,0
1683342504186,AWP 10,002,202035,Staff,0,0,0,0
1683342504186,AWP 10,003,202036,Staff,0,0,0,0
1683342504186,AWP 10,004,202037,Staff,0,0,0,0
1683342504186,AWP 10,005,202038,Staff,0,0,0,0
1683342504186,AWP 10,006,202039,Staff,0,0,0,0
1683342504186,AWP 10,007,202040,Staff,0,0,0,0
1683342504186,AWP 10,008,202041,Staff,0,0,0,0
1683342504186,AWP 10,009,202042,Staff,0,0,0,0
1683342504186,AWP 10,010,202043,Staff,0,0,0,0
1683342504186,AWP 10,011,202044,Staff,0,0,0,0
1683342504186,AWP 10,012,202045,Staff,0,0,0,0
1683342504186,AWP 10,013,202046,Staff,0,0,0,0
1683342504186,AWP 10,014,202047,Staff,0,0,0,0
1683342504186,AWP 10,015,202048,Staff,0,0,0,0
1683342504186,AWP 10,016,202049,Staff,0,0,0,0
1683342504186,AWP 10,017,202050,Staff,0,0,0,0
1683342504186,AWP 10,018,202051,Staff,0,0,0,0
1683342504186,AWP 10,019,202052,Staff,0,0,0,0
1683342504186,AWP 10,020,202053,Staff,0,0,0,0
1683342504186,AWP 10,021,202054,Staff,0,0,0,0
1683342504186,AWP 10,022,202055,Staff,0,0,0,0
1683342504186,AWP 10,023,202056,Staff,0,0,0,0
1683342504186,AWP 10,024,202057,Staff,0,0,0,0
1683342504186,AWP 10,025,202058,Staff,0,0,0,0
1683342504186,AWP 10,026,202059,Staff,0,0,0,0
1683342505211,AWP 102,001,202032,Staff,0,0,0,0
1683342505211,AWP 102,002,202033,Staff,0,0,0,0
1683342506238,BENG 100,A01,254234,Taylor Amos; Alyssa C,31,0,40,9
1683342507268,BENG 196,001,270013,Engler; Adam J.,9999,0,9999,0
1683342508291,BICD 100R,A01,202018,Smith; Laurie,0,7,32,32
1683342508291,BICD 100R,A02,202019,Smith; Laurie,0,2,32,32
1683342508291,BICD 100R,A03,202020,Smith; Laurie,0,1,32,32
1683342508291,BICD 100R,A04,202021,Smith; Laurie,9,0,32,23
1683342508291,BICD 100R,A05,202022,Smith; Laurie,12,0,32,20
1683342509316,BICD 136,A01,193242,Gustafson-Brown; Cindy,0,2,32,32
1683342509316,BICD 136,A02,193244,Gustafson-Brown; Cindy,14,0,32,18
1683342510346,BIEB 102,A01,193249,Butler; Shannon Rhey,0,2,32,32
1683342510346,BIEB 102,A02,193251,Butler; Shannon Rhey,0,0,32,32
1683342510346,BIEB 102,A03,193253,Butler; Shannon Rhey,0,1,32,32
1683342510346,BIEB 102,A04,193255,Butler; Shannon Rhey,17,0,32,15
1683342510346,BIEB 102,A05,193265,Butler; Shannon Rhey,26,0,32,6
1683342510346,BIEB 102,A06,193269,Butler; Shannon Rhey,16,0,32,16
1683342512398,BIEB 150,A01,193274,Staff,0,0,32,32
1683342512398,BIEB 150,A02,193285,Staff,23,0,32,9
1683342513422,BIEB 194,A00,193286,Kurle; Carolyn M.,22,0,32,10
1683342514448,BILD 1,A01,192291,Staff,16,0,32,16
1683342514448,BILD 1,A02,192292,Staff,30,0,32,2
1683342514448,BILD 1,B01,192520,Reuther; Keefe,0,1,0,0
1683342514448,BILD 1,B02,192532,Reuther; Keefe,0,1,0,0
1683342515477,BILD 3,A01,192556,Butler; Shannon Rhey,0,0,32,32
1683342515477,BILD 3,A02,192581,Butler; Shannon Rhey,5,0,32,27
1683342515477,BILD 3,A03,192611,Butler; Shannon Rhey,23,0,32,9
1683342515477,BILD 3,A04,192612,Butler; Shannon Rhey,25,0,32,7
1683342515477,BILD 3,A05,192613,Butler; Shannon Rhey,27,0,32,5
1683342515477,BILD 3,A06,192679,Butler; Shannon Rhey,27,0,32,5
1683342515477,BILD 3,A07,192682,Butler; Shannon Rhey,22,0,32,10
1683342516506,BILD 4,A01,192836,Reuther; Keefe,0,0,24,24
1683342516506,BILD 4,A02,193044,Reuther; Keefe,4,0,24,20
1683342517531,BILD 10,A01,193142,Gustafson-Brown; Cindy,30,0,32,2
1683342517531,BILD 10,A02,193149,Gustafson-Brown; Cindy,31,0,32,1
1683342518556,BIMM 100,A01,193301,Staff,0,6,32,32
1683342518556,BIMM 100,A02,193312,Staff,0,5,32,32
1683342518556,BIMM 100,A03,193323,Staff,0,8,32,32
1683342519588,BIMM 101,A01,193329,McDonnell; Lisa Marie,0,3,24,24
1683342519588,BIMM 101,A02,193339,McDonnell; Lisa Marie,0,3,24,24
1683342519588,BIMM 101,B01,193354,McDonnell; Lisa Marie,0,3,24,24
1683342519588,BIMM 101,B02,193357,McDonnell; Lisa Marie,0,3,24,24
1683342520616,BIMM 110,A01,193377,Tat; John,0,11,32,32
1683342520616,BIMM 110,A02,193378,Tat; John,1,9,32,31
1683342521644,BIMM 120,A01,206116,Staff,0,0,32,32
1683342521644,BIMM 120,A02,206117,Staff,8,0,32,24
1683342521644,BIMM 120,A03,206121,Staff,21,0,32,11
1683342522667,BIPN 100,A01,193393,Park; Ji Young,0,14,32,32
1683342522667,BIPN 100,A02,193402,Park; Ji Young,0,13,32,32
1683342522667,BIPN 100,A03,193413,Park; Ji Young,0,14,32,32
1683342522667,BIPN 100,A04,193414,Park; Ji Young,0,13,32,32
1683342523692,BIPN 102,A01,193429,Staff,0,0,32,32
1683342523692,BIPN 102,A02,193438,Staff,22,0,32,10
1683342524717,BIPN 106,A01,193450,Reyes Gonzalez; Catalina,0,2,40,40
1683342525742,BIPN 134,A01,193465,Cooke; James Edward,0,0,32,32
1683342525742,BIPN 134,A02,193474,Cooke; James Edward,25,0,32,7
1683342525742,BIPN 134,A03,193485,Cooke; James Edward,29,0,32,3
1683342525742,BIPN 134,A04,193486,Cooke; James Edward,21,0,32,11
1683342525742,BIPN 134,A05,193491,Cooke; James Edward,31,0,32,1
1683342525742,BIPN 134,A06,193501,Cooke; James Edward,30,0,32,2
1683342525742,BIPN 134,A07,193510,Cooke; James Edward,29,0,32,3
1683342527798,BISP 194,A00,222522,Staff,14,0,32,18
1683342528822,CAT 124,A01,202407,Staff,20,0,25,5
1683342529849,CAT 125,A00,202408,Marchisotto; Jennifer Anne,4,0,20,16
1683342530874,CAT 125R,A00,202409,Smith; Lauryn Alissa,0,11,20,20
1683342530874,CAT 125R,B00,202410,Morales; Celeste Georgianna,0,11,20,20
1683342530874,CAT 125R,C00,202411,Irwin; Matthew Joseph,0,10,20,20
1683342531903,CENG 15,A01,204712,Yang; Kesong,0,1,0,0
1683342532927,CENG 114,A00,202070,Jahed Motlagh; Zeinab,5,0,20,15
1683342533951,CGS 105,A00,185477,Wesling; Megan E.,24,0,40,16
1683342534976,CGS 106,A00,185494,Staff,13,0,22,9
1683342536000,CGS 108,A00,185495,Staff,14,0,20,6
1683342537028,CGS 114,A00,185496,Staff,13,0,18,5
1683342538055,CGS 119,A00,185501,Staff,15,0,20,5
1683342539081,CGS 120,A00,185511,Staff,13,0,20,7
1683342540110,CHEM 4,A01,184675,Bussey; Thomas J,96,0,100,4
1683342541136,CHEM 6A,A01,184677,Staff,34,0,60,26
1683342542165,CHEM 6B,A01,184679,Staff,65,0,100,35
1683342543190,CHEM 6C,A01,184681,Bussey; Thomas J,1,0,50,49
1683342543190,CHEM 6C,A02,184682,Bussey; Thomas J,34,0,50,16
1683342544220,CHEM 40A,A01,184684,Albizati; Kim F.,37,0,100,63
1683342545248,CHEM 40B,A01,184686,Albizati; Kim F.,0,20,100,100
1683342546272,CHEM 41B,A01,184690,Staff,52,0,100,48
1683342547296,COGS 3,A01,184715,Boyle; Mary E. T.,0,25,40,40
1683342548321,COGS 14B,A01,185172,Staff,0,15,38,38
1683342549345,COGS 18,A01,184736,Staff,17,0,80,63
1683342550372,COGS 100,A01,184932,Staff,0,5,73,73
1683342551397,COGS 101A,A01,184935,Staff,0,39,30,30
1683342552423,COGS 101B,A01,184944,Staff,0,2,30,30
1683342553446,COGS 101C,A01,184946,Staff,0,12,30,30
1683342554474,COGS 102A,A01,184951,Johnson; Christine M.,2,0,40,38
1683342555503,COGS 107B,A01,184953,Mooshagian; Eric Frederick,0,50,40,40
1683342556528,COGS 118B,A01,184959,Gupta; Anjum,0,48,40,40
1683342557552,COGS 153,A00,184961,Staff,0,15,30,30
1683342558577,COGS 177,A00,184962,Staff,0,20,30,30
1683342559606,COGS 187A,A01,184969,Boyle; Mary E. T.,0,17,40,40
1683342560640,COMM 10,A01,185174,Staff,0,5,25,25
1683342560640,COMM 10,A02,185189,Staff,0,5,25,25
1683342560640,COMM 10,A03,269821,Staff,0,0,0,0
1683342561668,COMM 100B,A01,185475,Staff,0,0,0,2
1683342561668,COMM 100B,A02,185476,Staff,13,0,25,12
1683342562693,COMM 100C,A01,185314,Staff,1,0,25,24
1683342562693,COMM 100C,A02,185327,Staff,19,0,25,6
1683342563718,COMM 110M,A00,185349,Staff,2,0,40,38
1683342564746,COMM 113T,A00,185352,Staff,24,0,40,16
1683342565769,COMM 114I,A00,185353,Staff,33,0,40,7
1683342566794,COMM 131,A00,185354,Staff,19,0,30,11
1683342567828,CSE 8A,A50,185358,Cao; Yingjun,0,46,10,10
1683342568856,CSE 8B,A01,185362,Staff,1,47,50,49
1683342569883,CSE 11,A01,185416,Cao; Yingjun,0,92,10,10
1683342570906,CSE 20,A01,185445,Briones; Jor-el Thomas Caparas,5,0,25,20
1683342571933,CSE 21,A01,185447,Staff,10,0,50,40
1683342572958,CSE 101,A01,185451,Staff,0,13,50,50
1683342572958,CSE 101,B01,185453,Jones; Miles E,0,11,50,50
1683342575010,CSE 141,A01,185458,Eldon; John,20,0,100,80
1683342576038,CSE 141L,A01,185461,Eldon; John,12,0,100,88
1683342577063,CSE 142,A01,185463,Staff,36,0,60,24
1683342577063,CSE 142,B01,201355,Staff,0,7,60,60
1683342578087,CSE 142L,A01,185470,Staff,36,0,60,24
1683342578087,CSE 142L,B01,201417,Staff,0,6,60,60
1683342579112,CSE 190,A00,201433,Staff,32,0,49,17
1683342580138,DOC 1,A01,259136,Strom; Megan C.,7,0,15,8
1683342580138,DOC 1,A02,259137,Strom; Megan C.,14,0,15,1
1683342580138,DOC 1,A03,259138,Strom; Megan C.,14,0,15,1
1683342580138,DOC 1,A04,259139,Strom; Megan C.,14,0,15,1
1683342581163,DOC 100D,A00,259140,Pass; Natalye Joann,16,0,25,9
1683342582187,DSGN 1,A01,184749,Rill; Bryan,0,25,30,30
1683342583214,DSGN 100,A01,185168,Staff,0,2,25,25
1683342584242,ECE 5,A01,185626,Morris; Karcher William,0,10,0,0
1683342585269,ECE 101,A01,185628,Staff,17,0,70,53
1683342586294,ECE 107,A01,185635,Baghdadchi; Saharnaz,0,0,20,20
1683342586294,ECE 107,A02,185638,Baghdadchi; Saharnaz,4,0,20,16
1683342587319,ECE 148,A01,185647,Silberman; Jack,0,0,16,16
1683342588416,ECON 1,A01,185537,Crane; Meredith Helen,54,0,70,16
1683342589439,ECON 3,A01,185549,Crane; Meredith Helen,32,0,70,38
1683342590463,ECON 4,A01,203354,Anderson; John Charles,0,4,10,10
1683342591491,ECON 100A,A01,185574,Staff,0,4,40,40
1683342592515,ECON 100B,A01,185576,Staff,10,22,50,40
1683342593539,ECON 100C,A01,185589,Newhouse; Herbert S,30,0,70,40
1683342594563,ECON 105,A00,185608,Vespa; Emanuel Ignacio,19,0,35,16
1683342595588,ECON 109,A01,185610,Shishkin; Denis,10,0,35,25
1683342596612,ECON 110A,A01,185612,Staff,11,0,40,29
1683342597637,ECON 120A,A01,185615,Staff,20,0,40,20
1683342598660,ECON 120C,A01,185617,Sun; Yixiao,0,20,70,70
1683342599684,ECON 144,A00,203346,Squires; Dale E,3,0,35,32
1683342600708,ECON 171,A01,203349,Newhouse; Herbert S,0,1,35,35
1683342601734,ECON 173A,A01,185621,Toda; Alexis Akira,21,0,35,14
1683342602758,EDS 25,A01,202413,Staff,0,1,0,0
1683342602758,EDS 25,A02,202414,Staff,0,1,0,0
1683342602758,EDS 25,A03,202415,Staff,0,0,0,0
1683342602758,EDS 25,A04,202416,Staff,0,1,0,0
1683342602758,EDS 25,A05,202439,Staff,0,0,0,0
1683342602758,EDS 25,A06,202440,Staff,0,0,0,0
1683342602758,EDS 25,B01,202631,Staff,0,0,0,0
1683342602758,EDS 25,B02,202632,Staff,0,0,0,0
1683342602758,EDS 25,B03,202639,Staff,0,0,0,0
1683342602758,EDS 25,B04,202640,Staff,0,0,0,0
1683342602758,EDS 25,B05,202643,Staff,0,0,0,0
1683342602758,EDS 25,B06,202644,Staff,0,0,0,0
1683342603785,EDS 38,A01,202659,Black; Alison Michelle,24,0,25,1
1683342604811,EDS 115,A00,202652,Staff,18,0,30,12
1683342605835,EDS 125,A00,202649,Staff,14,0,30,16
1683342606862,EDS 126,A01,203332,Staff,30,0,30,0
1683342607886,EDS 139,A00,202838,Staff,16,0,25,9
1683342608914,EDS 146,A01,202655,Staff,14,0,25,11
1683342609942,ENG 15,A00,185667,Staff,0,1,0,0
1683342609942,ENG 15,B00,185672,Staff,0,0,0,0
1683342609942,ENG 15,C00,185675,Staff,0,0,0,0
1683342609942,ENG 15,D00,185682,Staff,0,0,0,0
1683342609942,ENG 15,E00,185684,Staff,0,0,0,0
1683342610967,ETHN 103,A00,185710,Staff,0,4,35,35
1683342611995,ETHN 103A,A00,199228,Man; Simeon S,2,0,9,7
1683342613023,ETHN 109,A00,185711,Staff,18,0,35,17
1683342614048,ETHN 142,A00,185726,Staff,0,4,30,30
1683342615072,ETHN 163J,A00,199229,Man; Simeon S,5,0,8,3
1683342616098,ETHN 168,A00,185727,Staff,8,0,10,2
1683342617124,ETHN 182,A00,185728,Staff,1,0,35,34
1683342618152,ETHN 183,A00,185737,Staff,8,0,18,10
1683342619177,GLBH 111,A01,209361,Burgos; Jose L.,0,0,0,0
1683342621227,HIEU 104,A00,185792,Staff,16,0,20,4
1683342622254,HIEU 115,A00,185800,Staff,1,0,20,19
1683342623281,HIEU 128,A00,185801,Staff,0,7,20,20
1683342624308,HIEU 147,A00,185802,Staff,16,0,20,4
1683342625332,HIEU 154,A00,185823,Staff,12,0,20,8
1683342626360,HILA 102,A00,185826,Staff,13,0,20,7
1683342627386,HILD 2C,A01,185778,Staff,0,12,20,20
1683342628409,HILD 7B,A01,185780,Kwak; Nancy,0,15,32,32
1683342628409,HILD 7B,A02,185781,Kwak; Nancy,0,18,32,32
1683342629433,HILD 30,A01,185791,Staff,14,0,20,6
1683342630458,HISC 119,A00,185830,Golan; Tal,0,9,20,20
1683342631482,HITO 156GS,A00,185831,Patterson; Patrick H.,0,0,0,23
1683342632506,HIUS 103,A00,185832,Man; Simeon S,0,6,20,20
1683342633530,HIUS 117,A00,185836,Kwak; Nancy,2,0,20,18
1683342634556,HIUS 125,A00,185840,Man; Simeon S,0,0,23,23
1683342635581,HIUS 149,A00,185845,Staff,0,0,20,20
1683342636608,HUM 3,A01,185882,Zavodny; Tatiana Sophia,0,7,50,50
1683342636608,HUM 3,B01,185899,Caldwell; Michael Alan,0,18,50,50
1683342637634,HUM 3GS,A00,185900,Patterson; Patrick H.,0,0,0,23
1683342638659,HUM 4,A01,185938,Zroka; Amy Liane,31,0,50,19
1683342638659,HUM 4,B01,185956,Watkins; Eric,0,2,50,50
1683342638659,HUM 4,B02,202209,Watkins; Eric,0,2,50,50
1683342638659,HUM 4,B03,202210,Watkins; Eric,0,2,50,50
1683342639686,HUM 5,A01,185958,West; Geoffrey Scott,3,0,50,47
1683342639686,HUM 5,A02,202215,West; Geoffrey Scott,0,0,50,50
1683342640713,INTL 190,A00,185959,Gagnon; Jeffrey C,0,0,0,9
1683342640713,INTL 190,B00,185960,Lettieri; Michael Joseph,0,0,0,1
1683342641737,JAPN 180,A00,254509,Staff,5,1,30,25
1683342642762,LATI 10,A01,202853,Kennemore; Amy Michelle,4,0,35,31
1683342642762,LATI 10,A02,202854,Kennemore; Amy Michelle,2,0,35,33
1683342642762,LATI 10,A03,270054,Kennemore; Amy Michelle,30,0,30,0
1683342643790,LATI 180,A00,202855,Kennemore; Amy Michelle,11,0,20,9
1683342644815,LAWS 101,A00,201767,Golan; Tal,0,7,40,40
1683342645837,LIFR 1C,A00,185961,Staff,6,0,20,14
1683342646864,LIFR 1CX,A00,185962,Staff,7,0,20,13
1683342647888,LIFR 1D,A00,185963,Staff,9,0,20,11
1683342648915,LIFR 1DX,A00,185964,Staff,9,0,20,11
1683342649942,LIGN 101,A01,186039,Staff,43,0,50,7
1683342650966,LIGN 165,A00,186040,Staff,18,0,50,32
1683342651991,LTCS 108,A00,186041,Staff,6,0,10,4
1683342653014,LTCS 119,A00,186042,Staff,16,0,20,4
1683342654041,LTCS 130,A00,186043,Wesling; Megan E.,15,0,25,10
1683342656090,LTEA 138,A00,186119,Staff,14,0,40,26
1683342657117,LTEN 124,A00,186148,Staff,6,0,25,19
1683342658142,LTEN 178,A00,186149,Staff,7,0,15,8
1683342659166,LTEN 181,A00,186150,Blanco; John D,33,0,40,7
1683342660194,LTWL 120,A00,186160,Staff,20,0,25,5
1683342661220,LTWL 165,A00,186161,Staff,22,0,25,3
1683342662244,LTWR 100,A00,186162,Staff,0,5,15,15
1683342663268,LTWR 102,A00,186163,Doller; Ben,5,0,15,10
1683342664298,MAE 8,A01,186412,Staff,0,0,0,0
1683342665326,MAE 30B,A00,186445,Bahadori; Mohammad Yousef,83,0,100,17
1683342666352,MAE 40,A00,186592,Bewley; Thomas R,9,0,50,41
1683342667378,MAE 101B,A00,186593,Bahadori; Mohammad Yousef,81,0,100,19
1683342668404,MAE 105,A00,186594,Bandaru; Prabhakar,12,0,50,38
1683342669430,MAE 107,A00,186599,Pham; Hieu Tan,0,6,120,120
1683342670458,MAE 148,A01,186660,Silberman; Jack,3,0,16,13
1683342671486,MATH 10A,A01,188095,Staff,1,6,35,34
1683342672515,MATH 10B,A01,188097,Bowers; Adam R.,0,11,30,30
1683342672515,MATH 10B,A02,188099,Bowers; Adam R.,0,11,30,30
1683342672515,MATH 10B,B01,188104,Bowers; Adam R.,0,10,30,30
1683342672515,MATH 10B,B02,188106,Bowers; Adam R.,0,10,30,30
1683342673544,MATH 10C,A01,188111,Staff,0,18,30,30
1683342673544,MATH 10C,A02,188127,Staff,0,17,30,30
1683342673544,MATH 10C,A03,188131,Staff,0,18,30,30
1683342673544,MATH 10C,B01,188218,Staff,18,0,30,12
1683342673544,MATH 10C,B02,188244,Staff,13,0,30,17
1683342673544,MATH 10C,B03,188277,Staff,16,0,30,14
1683342674570,MATH 18,A01,188344,Bach; Quang Tran,18,0,30,12
1683342674570,MATH 18,A02,188345,Bach; Quang Tran,11,0,30,19
1683342674570,MATH 18,B01,188353,Bach; Quang Tran,10,0,30,20
1683342674570,MATH 18,B02,188354,Bach; Quang Tran,20,0,30,10
1683342675599,MATH 20A,A01,188374,Staff,13,0,35,22
1683342676624,MATH 20B,A01,188382,Ohm; Ko Woon,6,0,30,24
1683342676624,MATH 20B,A02,188383,Ohm; Ko Woon,22,0,30,8
1683342676624,MATH 20B,B01,188385,Ohm; Ko Woon,7,0,30,23
1683342676624,MATH 20B,B02,188392,Ohm; Ko Woon,22,0,30,8
1683342677653,MATH 20C,A01,188394,Harel; Guershon,10,0,30,20
1683342677653,MATH 20C,A02,188395,Harel; Guershon,15,0,30,15
1683342677653,MATH 20C,B01,188404,Harel; Guershon,5,0,30,25
1683342677653,MATH 20C,B02,188405,Harel; Guershon,19,0,30,11
1683342678678,MATH 20D,A01,188414,Hammock; Frances H,0,1,30,30
1683342678678,MATH 20D,A02,188415,Hammock; Frances H,3,0,30,27
1683342678678,MATH 20D,B01,188447,Hammock; Frances H,1,0,30,29
1683342678678,MATH 20D,B02,188486,Hammock; Frances H,8,0,30,22
1683342679704,MATH 20E,A01,188649,Staff,21,0,30,9
1683342679704,MATH 20E,A02,188650,Staff,23,0,30,7
1683342679704,MATH 20E,A03,188673,Staff,0,0,30,30
1683342680728,MATH 102,A01,188675,Staff,0,35,35,35
1683342681755,MATH 103B,A01,188681,Staff,3,0,35,32
1683342681755,MATH 103B,B01,188692,Staff,5,0,35,30
1683342682780,MATH 109,A01,188695,Salehi Golsefidy; Alireza,25,0,35,10
1683342682780,MATH 109,A02,188696,Salehi Golsefidy; Alireza,25,0,35,10
1683342683811,MATH 120A,A01,188698,Eggers; John Dietrich,7,0,35,28
1683342684839,MATH 142B,A01,188736,Ioana; Adrian,0,2,30,30
1683342684839,MATH 142B,A02,188741,Ioana; Adrian,1,1,30,29
1683342684839,MATH 142B,A03,188743,Ioana; Adrian,1,3,30,29
1683342685862,MATH 168A,A01,188790,Staff,0,9,35,35
1683342686891,MATH 170A,A01,188803,Nie; Jiawang,0,2,35,35
1683342686891,MATH 170A,A02,188811,Nie; Jiawang,0,0,35,35
1683342686891,MATH 170A,A03,188814,Nie; Jiawang,1,0,35,34
1683342686891,MATH 170A,A04,188815,Nie; Jiawang,13,0,35,22
1683342687916,MATH 193B,A01,188817,Staff,0,0,35,35
1683342687916,MATH 193B,A02,188818,Staff,5,0,35,30
1683342688940,MGT 4,A01,202857,Anderson; John Charles,62,0,80,18
1683342689964,MGT 12,A00,202858,Lindenberger; Wade Douglas,42,0,90,48
1683342690991,MGT 18,A00,202859,Staff,74,0,90,16
1683342692073,MGT 18GS,A00,202860,McKay; Michael J,13,0,28,15
1683342693097,MGT 45,A00,202861,Pecore; Joseph P.,14,0,90,76
1683342694122,MGT 100,A00,202863,Yavorsky; Daniel Ryan,28,0,90,62
1683342695146,MGT 103,A00,202864,Ehrich; Kristine R,1,18,90,89
1683342696170,MGT 112,A00,202865,Ehrich; Kristine R,15,0,90,75
1683342697197,MGT 121A,A00,202868,Staff,0,20,0,0
1683342698224,MGT 131B,A00,202869,Anderson; John Charles,59,0,90,31
1683342699252,MGT 136,A00,202871,Lindenberger; Wade Douglas,84,0,90,6
1683342700277,MGT 164,A00,202873,Staff,0,68,90,91
1683342701301,MGT 164GS,A00,202874,McKay; Mary A,13,0,28,15
1683342702326,MGT 180,A00,202875,Staff,0,50,90,91
1683342703351,MMW 11R,A01,205019,Herbst; Matthew,3,0,30,27
1683342703351,MMW 11R,A02,205026,Herbst; Matthew,29,0,30,1
1683342704379,MMW 15,A01,193512,Chang; Edmond Yi-Teh,0,9,28,28
1683342704379,MMW 15,A02,193513,Chang; Edmond Yi-Teh,0,5,28,28
1683342704379,MMW 15,A03,193514,Chang; Edmond Yi-Teh,0,5,28,28
1683342704379,MMW 15,A04,193515,Chang; Edmond Yi-Teh,0,5,28,28
1683342704379,MMW 15,A05,193516,Chang; Edmond Yi-Teh,0,4,28,28
1683342704379,MMW 15,A06,193517,Chang; Edmond Yi-Teh,0,5,28,28
1683342704379,MMW 15,B01,193519,Chang; Edmond Yi-Teh,0,5,28,28
1683342704379,MMW 15,B02,193520,Chang; Edmond Yi-Teh,0,5,28,28
1683342704379,MMW 15,B03,193521,Chang; Edmond Yi-Teh,0,5,28,28
1683342704379,MMW 15,B04,193522,Chang; Edmond Yi-Teh,0,4,28,28
1683342704379,MMW 15,B05,193523,Chang; Edmond Yi-Teh,0,5,28,28
1683342704379,MMW 15,B06,193524,Chang; Edmond Yi-Teh,0,4,28,28
1683342705406,MMW 122,A01,193526,Rahimi; Babak,0,15,28,28
1683342705406,MMW 122,A02,193527,Rahimi; Babak,0,14,28,28
1683342705406,MMW 122,A03,193528,Rahimi; Babak,0,0,0,0
1683342705406,MMW 122,A04,193529,Rahimi; Babak,0,0,0,0
1683342706430,MUS 1A,A01,186663,Staff,0,20,35,35
1683342707458,MUS 4,A01,186715,Staff,0,12,35,35
1683342708484,MUS 5R,A01,186796,Dubnov; Shlomo,0,17,35,35
1683342709512,MUS 6,A01,186798,Staff,0,4,25,25
1683342710539,MUS 7,A01,186830,Staff,13,0,35,22
1683342711564,MUS 8,A01,186930,Staff,0,26,35,35
1683342712594,MUS 15,A01,186932,Staff,0,16,35,35
1683342712594,MUS 15,B01,186934,Staff,0,15,35,35
1683342713623,MUS 80,A00,186935,Staff,1,0,20,19
1683342713623,MUS 80,B00,186936,Staff,25,0,25,0
1683342714650,NANO 11,A00,204702,Lipomi; Darren John,0,0,0,0
1683342715675,NANO 15,A01,204709,Yang; Kesong,0,1,0,0
1683342716699,NANO 114,A00,202069,Jahed Motlagh; Zeinab,3,0,10,7
1683342717724,PHIL 1,A00,186955,Grush; Rick Scott,32,0,40,8
1683342718748,PHIL 10,A01,186973,Grush; Rick Scott,28,0,35,7
1683342718748,PHIL 10,A02,186974,Grush; Rick Scott,33,0,35,2
1683342719771,PHIL 13,A01,186976,Staff,7,0,35,28
1683342719771,PHIL 13,A02,186977,Staff,16,0,35,19
1683342720799,PHIL 14,A01,186979,Staff,31,0,35,4
1683342720799,PHIL 14,A02,186986,Staff,32,0,35,3
1683342721825,PHIL 28,A01,186988,Staff,16,0,30,14
1683342721825,PHIL 28,A02,186989,Staff,1,0,30,29
1683342721825,PHIL 28,A03,186990,Staff,9,0,30,21
1683342721825,PHIL 28,A04,186991,Staff,26,0,30,4
1683342722853,PHIL 120,A00,186997,Staff,23,0,40,17
1683342723884,PHIL 137,A00,187003,Staff,9,0,40,31
1683342724908,PHIL 150,A00,187015,Staff,47,0,70,23
1683342725936,PHIL 167,A00,187021,Lamey; Andy M.,35,0,40,5
1683342726961,PHIL 174,A01,202226,Staff,17,0,20,3
1683342726961,PHIL 174,A02,202235,Staff,20,0,20,0
1683342727987,PHIL 191A,A00,258918,Staff,0,0,1,1
1683342729012,PHYS 1A,A00,187028,Staff,27,0,60,33
1683342730037,PHYS 1AL,001,187036,Staff,2,0,30,28
1683342730037,PHYS 1AL,002,187049,Staff,18,0,30,12
1683342731067,PHYS 1B,A00,187058,Staff,22,0,60,38
1683342732091,PHYS 1BL,001,187064,Staff,0,0,30,30
1683342732091,PHYS 1BL,002,187070,Staff,5,0,30,25
1683342733115,PHYS 1C,A00,187082,Staff,31,0,120,89
1683342734139,PHYS 1CL,001,187088,Staff,0,9,30,30
1683342734139,PHYS 1CL,002,187089,Staff,0,2,30,30
1683342734139,PHYS 1CL,009,262693,Staff,11,0,30,19
1683342735163,PHYS 2B,A01,187097,Staff,54,0,115,61
1683342736187,PHYS 2C,A01,187099,Staff,67,0,115,48
1683342737213,PHYS 2CL,A01,187101,Staff,5,0,28,23
1683342737213,PHYS 2CL,A02,187102,Staff,15,0,28,13
1683342738238,PHYS 2D,A01,187123,Shotwell; Brian,95,0,115,20
1683342739263,PHYS 4B,A01,187133,Grinstein; Benjamin,35,0,50,15
1683342740287,POLI 10,A00,188819,Staff,0,4,50,50
1683342741310,POLI 11,A00,188827,Staff,43,0,50,7
1683342742337,POLI 13R,A00,188828,Staff,0,1,20,20
1683342743367,POLI 27,A01,188830,Elgin; Samuel Zincke,0,1,70,70
1683342744394,POLI 30,A00,188832,Desposato; Scott,31,0,50,19
1683342745419,POLI 102F,A00,188834,Staff,3,0,40,37
1683342746446,POLI 104A,A00,188852,Staff,14,0,30,16
1683342747471,POLI 104I,A00,188853,Staff,0,6,20,20
1683342748499,POLI 110B,A00,188854,Wiens; David,7,0,20,13
1683342749527,POLI 112A,A00,188855,Wiens; David,5,0,30,25
1683342750552,POLI 117R,A00,188856,Forman; Fonna,0,11,20,20
1683342751577,POLI 118,A00,188857,Ingham; Sean,8,0,20,12
1683342752603,POLI 120G,A00,188858,Staff,9,0,30,21
1683342753628,POLI 131CR,A00,188863,Hoston; Germaine,24,0,50,26
1683342754652,POLI 133,A00,188864,Nellis; Gareth Hb,44,0,50,6
1683342755678,POLI 134D,A00,188865,Desposato; Scott,27,0,30,3
1683342756702,POLI 142A,A00,188871,Gartzke; Erik,22,0,50,28
1683342757730,POLI 142K,A00,188874,Staff,38,0,50,12
1683342758758,POLI 143,A00,188940,Gartzke; Erik,16,0,30,14
1683342759785,POLI 153,A00,188943,Staff,3,0,20,17
1683342760812,POLI 160AA,A00,188944,Staff,12,0,40,28
1683342761836,POLI 170A,A00,188945,Staff,11,0,30,19
1683342763884,PSYC 1,A00,188952,Staff,37,0,90,53
1683342764911,PSYC 2,B00,188953,Staff,19,0,35,16
1683342765940,PSYC 6,A00,188970,Staff,47,0,60,13
1683342766964,PSYC 7,A00,188973,Staff,37,0,45,8
1683342767993,PSYC 60,A01,188980,Rickard; Timothy C.,43,0,60,17
1683342769019,PSYC 70,A01,189001,Steiner; Eric Tomas,23,0,45,22
1683342770046,PSYC 100,A00,189005,Lacefield; Katharine I,0,98,120,120
1683342771071,PSYC 102,A00,189008,Staff,9,0,30,21
1683342772098,PSYC 106,B00,189026,Gorman; Michael R.,34,0,60,26
1683342773122,PSYC 114,B01,189033,Winkielman; Piotr,0,32,30,30
1683342774146,PSYC 131,A00,189036,Anagnostaras; Stephan,0,43,60,60
1683342775173,PSYC 136,A00,189041,Lowe; Angela Beth,0,7,25,25
1683342776198,PSYC 137,A00,189057,Winkielman; Piotr,0,34,25,25
1683342777221,PSYC 144,A00,189107,Wixted; John T,0,7,50,50
1683342779266,PSYC 162,A00,189142,Staff,0,8,85,85
1683342780293,PSYC 172,A00,189144,Gorman; Michael R.,0,7,30,30
1683342782342,PSYC 179,A00,189146,Lacefield; Katharine I,0,84,120,120
1683342783370,PSYC 181,A00,189147,Anagnostaras; Stephan,0,44,90,90
1683342784398,PSYC 190R,A00,189148,Barner; David A.,0,22,80,80
1683342785427,PSYC 191,A00,189275,Rickard; Timothy C.,0,7,25,25
1683342786454,PSYC 193,A00,189276,Chapman; Eddie Nathaniel,0,1,0,4
1683342787479,PSYC 193L,A01,189281,Lowe; Angela Beth,12,0,20,8
1683342787479,PSYC 193L,B01,189285,Staff,28,0,35,7
1683342788506,RELI 149,A00,187137,Rahimi; Babak,7,0,40,33
1683342789534,SE 9,A01,187315,Staff,0,2,18,18
1683342790561,SE 101B,A00,187409,Staff,24,0,30,6
1683342791585,SE 110B,A00,187444,Staff,10,0,40,30
1683342792611,SE 130B,A00,187449,Staff,31,0,40,9
1683342793641,SE 150A,A00,187516,Staff,9,0,20,11
1683342794670,SE 154,A00,187528,Staff,30,0,50,20
1683342795753,SIO 3,A01,258171,Staff,35,0,40,5
1683342796780,SIO 10,A00,187144,Cook; Geoffrey W,0,3,75,75
1683342797803,SIO 45,A00,187152,Cook; Geoffrey W,1,0,100,99
1683342798827,SIO 109R,A00,194486,Staff,0,3,20,20
1683342800883,SIO 187,A01,187233,Kacev; David,12,0,40,28
1683342801911,SOCI 1,A01,258656,Thorpe; Charles Robert,28,0,30,2
1683342801911,SOCI 1,A02,258658,Thorpe; Charles Robert,30,0,30,0
1683342801911,SOCI 1,A03,258661,Thorpe; Charles Robert,25,0,25,0
1683342801911,SOCI 1,A04,258666,Thorpe; Charles Robert,22,0,25,3
1683342801911,SOCI 1,A05,258897,Thorpe; Charles Robert,23,0,25,2
1683342801911,SOCI 1,A06,258898,Thorpe; Charles Robert,25,0,25,0
1683342802939,SOCI 30,A01,258903,Pardo Guerra; Juan Pablo,15,0,30,15
1683342803961,SOCI 102,A00,258904,Staff,9,0,25,16
1683342804986,SOCI 106,A00,258905,Staff,19,0,25,6
1683342806009,SOCI 111,A00,258907,Ribas Norris; Janet Vanesa,26,0,30,4
1683342807037,SOCI 121R,A00,258908,Pardo Guerra; Juan Pablo,10,0,30,20
1683342808063,SOCI 126,A01,203330,Staff,14,0,20,6
1683342809086,SOCI 131,A00,258909,Thorpe; Charles Robert,31,0,60,29
1683342810113,SOCI 135,A00,258910,Payne; Christine Anna,0,9,30,30
1683342811139,SOCI 157,A00,258911,Staff,12,0,30,18
1683342812167,SOCI 184,A00,258912,Staff,25,0,30,5
1683342813191,SOCI 188D,A00,258913,Staff,21,0,30,9
1683342814217,SYN 2,001,187529,Staff,10,0,16,6
1683342814217,SYN 2,002,201452,Staff,0,18,16,16
1683342814217,SYN 2,003,201469,Staff,3,0,16,13
1683342815242,SYN 100,A01,187531,Staff,0,9,20,20
1683342815242,SYN 100,B01,201491,Staff,0,12,20,20
1683342816267,TDAC 1,A00,189286,Walsh; Kim C.,3,0,20,17
1683342816267,TDAC 1,B00,189287,Harting; Carla Kelso,11,0,20,9
1683342817291,TDAC 101,A00,189300,Walsh; Kim C.,16,0,20,4
1683342817291,TDAC 101,B00,189301,Harting; Carla Kelso,18,0,20,2
1683342818315,TDAC 102,A00,189304,Basso; Beatrice,14,0,20,6
1683342819338,TDAC 108,A00,189305,Staff,18,0,20,2
1683342820363,TDDE 131,A00,189310,Staff,19,0,20,1
1683342820363,TDDE 131,B00,189314,Staff,19,0,20,1
1683342820363,TDDE 131,C00,189315,Staff,48,0,50,2
1683342820363,TDDE 131,D00,189316,Staff,14,0,15,1
1683342820363,TDDE 131,E00,204841,Staff,20,0,20,0
1683342821387,TDGE 10,A00,189289,Staff,30,0,50,20
1683342821387,TDGE 10,B00,189290,Havis; Allan,1,0,50,49
1683342822413,TDGE 11,A00,189291,Fulton; Julia,0,3,50,50
1683342822413,TDGE 11,B00,189292,Staff,20,0,25,5
1683342822413,TDGE 11,C00,260270,Staff,0,0,0,0
1683342823439,TDGE 25,A00,189294,Staff,3,0,20,17
1683342824464,TDGE 124,A00,189318,Fulton; Julia,0,8,50,50
1683342825491,TDGE 125,A00,189319,Staff,13,0,25,12
1683342825491,TDGE 125,B00,189320,Staff,23,0,25,2
1683342826515,TDGE 127,A00,189322,Havis; Allan,0,0,50,50
1683342827543,TDHT 101,A00,189323,Staff,18,0,25,7
1683342827543,TDHT 101,B00,189324,Staff,25,0,25,0
1683342828567,TDHT 102,A00,189325,Staff,49,0,50,1
1683342829591,TDMV 1,A00,189295,Arcidiacono; Kristin,19,0,30,11
1683342829591,TDMV 1,B00,189296,Caligagan; Maria T.,24,0,30,6
1683342830616,TDMV 2,A00,189297,Sammartano; Tonnie,28,0,30,2
1683342830616,TDMV 2,B00,189299,Arcidiacono; Kristin,24,0,30,6
1683342831641,TDMV 3,A00,204998,Rincon; Alicia,22,0,30,8
1683342832666,TDMV 120,A00,189458,Sammartano; Tonnie,28,0,30,2
1683342833690,TDMV 138,A00,189541,Jun; Grace Shin Hae,22,0,40,18
1683342834715,TDMV 142,A00,189717,Caligagan; Tony,23,0,30,7
1683342834715,TDMV 142,B00,189718,Caligagan; Maria T.,25,0,30,5
1683342835741,TMC 2,A01,187533,Staff,25,0,25,0
1683342835741,TMC 2,A02,187534,Staff,25,0,25,0
1683342836765,USP 1,A01,187536,Kwak; Nancy,0,16,25,25
1683342837792,USP 5,A01,187538,Staff,10,0,25,15
1683342838816,USP 101,A00,199253,Staff,0,4,0,0
1683342839840,USP 124,A00,187562,Boomhower; Matthew Charles,1,0,30,29
1683342840868,USP 138,A00,187582,Staff,20,0,25,5
1683342841893,USP 152,A01,187597,Staff,4,0,25,21
1683342842917,USP 153,A00,187598,Staff,19,0,25,6
1683342843945,USP 168,A00,187607,Kwak; Nancy,2,0,5,3
1683342844973,USP 173,A00,187619,Staff,4,0,25,21
1683342845997,USP 181,A00,187638,Staff,0,0,25,25
1683342847025,VIS 103,A00,187650,Cruz; Edwin Teddy,23,0,75,52
1683342848053,VIS 110D,A00,187669,Staff,12,0,22,10
1683342849081,VIS 127C,A00,187720,Shen; Kuiyi,67,0,146,79
1683342850106,VIS 149,A00,187731,Yoldas; Pinar,0,14,22,22
1683342851133,VIS 151,A01,188091,Staff,22,0,34,12
1683342851133,VIS 151,A02,188092,Staff,11,0,34,23
1683342852160,VIS 160B,A00,188093,Stalbaum; Brett,0,0,10,10
1683342854210,WCWP 10B,A00,201720,Staff,10,0,15,5
1683342854210,WCWP 10B,B00,201722,Staff,9,0,15,6
1683342855234,WCWP 100,A00,201725,Gagnon; Jeffrey C,0,0,2,2
1683342855234,WCWP 100,B00,201727,Staff,0,4,15,15
1683342858412,ANBI 133,A00,258401,Wilder; Linnea Lorene,34,0,40,6
1683342859436,ANBI 140,A00,258395,Hrvoj Mihic; Branka,18,0,25,7
1683342860460,ANSC 120,A00,258402,Bialecki; Jon Anthony,27,0,40,13
1683342861487,ANSC 144,A00,258400,Staff,14,0,40,26
1683342863539,ANSC 166,A00,258396,Parish; Steven Martin,157,0,175,18
1683342864567,ANSC 180,A00,193533,Staff,9,0,20,11
1683342865594,ANSC 188,A00,258397,Jassal; Aftab,33,0,40,7
1683342866619,ANTH 3,A01,258316,Staff,23,0,30,7
1683342867646,ANTH 5,A00,258394,Semendeferi; Ekaterini,16,0,20,4
1683342868673,ANTH 21,A01,258331,Staff,8,0,40,32
1683342869698,ANTH 103,A00,258398,Varma; Saiba,15,0,25,10
1683342870732,AWP 10,001,202034,Staff,0,0,0,0
1683342870732,AWP 10,002,202035,Staff,0,0,0,0
1683342870732,AWP 10,003,202036,Staff,0,0,0,0
1683342870732,AWP 10,004,202037,Staff,0,0,0,0
1683342870732,AWP 10,005,202038,Staff,0,0,0,0
1683342870732,AWP 10,006,202039,Staff,0,0,0,0
1683342870732,AWP 10,007,202040,Staff,0,0,0,0
1683342870732,AWP 10,008,202041,Staff,0,0,0,0
1683342870732,AWP 10,009,202042,Staff,0,0,0,0
1683342870732,AWP 10,010,202043,Staff,0,0,0,0
1683342870732,AWP 10,011,202044,Staff,0,0,0,0
1683342870732,AWP 10,012,202045,Staff,0,0,0,0
1683342870732,AWP 10,013,202046,Staff,0,0,0,0
1683342870732,AWP 10,014,202047,Staff,0,0,0,0
1683342870732,AWP 10,015,202048,Staff,0,0,0,0
1683342870732,AWP 10,016,202049,Staff,0,0,0,0
1683342870732,AWP 10,017,202050,Staff,0,0,0,0
1683342870732,AWP 10,018,202051,Staff,0,0,0,0
1683342870732,AWP 10,019,202052,Staff,0,0,0,0
1683342870732,AWP 10,020,202053,Staff,0,0,0,0
1683342870732,AWP 10,021,202054,Staff,0,0,0,0
1683342870732,AWP 10,022,202055,Staff,0,0,0,0
1683342870732,AWP 10,023,202056,Staff,0,0,0,0
1683342870732,AWP 10,024,202057,Staff,0,0,0,0
1683342870732,AWP 10,025,202058,Staff,0,0,0,0
1683342870732,AWP 10,026,202059,Staff,0,0,0,0
1683342871758,AWP 102,001,202032,Staff,0,0,0,0
1683342871758,AWP 102,002,202033,Staff,0,0,0,0
1683342872786,BENG 100,A01,254234,Taylor Amos; Alyssa C,31,0,40,9
1683342873813,BENG 196,001,270013,Engler; Adam J.,9999,0,9999,0
1683342874838,BICD 100R,A01,202018,Smith; Laurie,0,7,32,32
1683342874838,BICD 100R,A02,202019,Smith; Laurie,0,2,32,32
1683342874838,BICD 100R,A03,202020,Smith; Laurie,0,1,32,32
1683342874838,BICD 100R,A04,202021,Smith; Laurie,9,0,32,23
1683342874838,BICD 100R,A05,202022,Smith; Laurie,12,0,32,20
1683342875863,BICD 136,A01,193242,Gustafson-Brown; Cindy,0,2,32,32
1683342875863,BICD 136,A02,193244,Gustafson-Brown; Cindy,14,0,32,18
1683342876888,BIEB 102,A01,193249,Butler; Shannon Rhey,0,2,32,32
1683342876888,BIEB 102,A02,193251,Butler; Shannon Rhey,0,0,32,32
1683342876888,BIEB 102,A03,193253,Butler; Shannon Rhey,0,1,32,32
1683342876888,BIEB 102,A04,193255,Butler; Shannon Rhey,17,0,32,15
1683342876888,BIEB 102,A05,193265,Butler; Shannon Rhey,26,0,32,6
1683342876888,BIEB 102,A06,193269,Butler; Shannon Rhey,16,0,32,16
1683342878942,BIEB 150,A01,193274,Staff,0,0,32,32
1683342878942,BIEB 150,A02,193285,Staff,23,0,32,9
1683342879966,BIEB 194,A00,193286,Kurle; Carolyn M.,22,0,32,10
1683342880996,BILD 1,A01,192291,Staff,16,0,32,16
1683342880996,BILD 1,A02,192292,Staff,30,0,32,2
1683342880996,BILD 1,B01,192520,Reuther; Keefe,0,1,0,0
1683342880996,BILD 1,B02,192532,Reuther; Keefe,0,1,0,0
1683342882020,BILD 3,A01,192556,Butler; Shannon Rhey,0,0,32,32
1683342882020,BILD 3,A02,192581,Butler; Shannon Rhey,5,0,32,27
1683342882020,BILD 3,A03,192611,Butler; Shannon Rhey,23,0,32,9
1683342882020,BILD 3,A04,192612,Butler; Shannon Rhey,25,0,32,7
1683342882020,BILD 3,A05,192613,Butler; Shannon Rhey,27,0,32,5
1683342882020,BILD 3,A06,192679,Butler; Shannon Rhey,27,0,32,5
1683342882020,BILD 3,A07,192682,Butler; Shannon Rhey,22,0,32,10
1683342883044,BILD 4,A01,192836,Reuther; Keefe,0,0,24,24
1683342883044,BILD 4,A02,193044,Reuther; Keefe,4,0,24,20
1683342884075,BILD 10,A01,193142,Gustafson-Brown; Cindy,30,0,32,2
1683342884075,BILD 10,A02,193149,Gustafson-Brown; Cindy,31,0,32,1
1683342885103,BIMM 100,A01,193301,Staff,0,6,32,32
1683342885103,BIMM 100,A02,193312,Staff,0,5,32,32
1683342885103,BIMM 100,A03,193323,Staff,0,8,32,32
1683342886129,BIMM 101,A01,193329,McDonnell; Lisa Marie,0,3,24,24
1683342886129,BIMM 101,A02,193339,McDonnell; Lisa Marie,0,3,24,24
1683342886129,BIMM 101,B01,193354,McDonnell; Lisa Marie,0,3,24,24
1683342886129,BIMM 101,B02,193357,McDonnell; Lisa Marie,0,3,24,24
1683342887153,BIMM 110,A01,193377,Tat; John,0,11,32,32
1683342887153,BIMM 110,A02,193378,Tat; John,1,9,32,31
1683342888178,BIMM 120,A01,206116,Staff,0,0,32,32
1683342888178,BIMM 120,A02,206117,Staff,8,0,32,24
1683342888178,BIMM 120,A03,206121,Staff,21,0,32,11
1683342889206,BIPN 100,A01,193393,Park; Ji Young,0,14,32,32
1683342889206,BIPN 100,A02,193402,Park; Ji Young,0,13,32,32
1683342889206,BIPN 100,A03,193413,Park; Ji Young,0,14,32,32
1683342889206,BIPN 100,A04,193414,Park; Ji Young,0,13,32,32
1683342890230,BIPN 102,A01,193429,Staff,0,0,32,32
1683342890230,BIPN 102,A02,193438,Staff,22,0,32,10
1683342891254,BIPN 106,A01,193450,Reyes Gonzalez; Catalina,0,2,40,40
1683342892278,BIPN 134,A01,193465,Cooke; James Edward,0,0,32,32
1683342892278,BIPN 134,A02,193474,Cooke; James Edward,25,0,32,7
1683342892278,BIPN 134,A03,193485,Cooke; James Edward,29,0,32,3
1683342892278,BIPN 134,A04,193486,Cooke; James Edward,21,0,32,11
1683342892278,BIPN 134,A05,193491,Cooke; James Edward,31,0,32,1
1683342892278,BIPN 134,A06,193501,Cooke; James Edward,30,0,32,2
1683342892278,BIPN 134,A07,193510,Cooke; James Edward,29,0,32,3
1683342894325,BISP 194,A00,222522,Staff,14,0,32,18
1683342895354,CAT 124,A01,202407,Staff,20,0,25,5
1683342896378,CAT 125,A00,202408,Marchisotto; Jennifer Anne,4,0,20,16
1683342897406,CAT 125R,A00,202409,Smith; Lauryn Alissa,0,11,20,20
1683342897406,CAT 125R,B00,202410,Morales; Celeste Georgianna,0,11,20,20
1683342897406,CAT 125R,C00,202411,Irwin; Matthew Joseph,0,10,20,20
1683342898429,CENG 15,A01,204712,Yang; Kesong,0,1,0,0
1683342899511,CENG 114,A00,202070,Jahed Motlagh; Zeinab,5,0,20,15
1683342900534,CGS 105,A00,185477,Wesling; Megan E.,24,0,40,16
1683342901560,CGS 106,A00,185494,Staff,13,0,22,9
1683342902583,CGS 108,A00,185495,Staff,14,0,20,6
1683342903620,CGS 114,A00,185496,Staff,13,0,18,5
1683342904647,CGS 119,A00,185501,Staff,15,0,20,5
1683342905671,CGS 120,A00,185511,Staff,13,0,20,7
1683342906697,CHEM 4,A01,184675,Bussey; Thomas J,96,0,100,4
1683342907724,CHEM 6A,A01,184677,Staff,34,0,60,26
1683342908752,CHEM 6B,A01,184679,Staff,65,0,100,35
1683342909777,CHEM 6C,A01,184681,Bussey; Thomas J,1,0,50,49
1683342909777,CHEM 6C,A02,184682,Bussey; Thomas J,34,0,50,16
1683342910802,CHEM 40A,A01,184684,Albizati; Kim F.,37,0,100,63
1683342911829,CHEM 40B,A01,184686,Albizati; Kim F.,0,20,100,100
1683342912853,CHEM 41B,A01,184690,Staff,52,0,100,48
1683342913877,COGS 3,A01,184715,Boyle; Mary E. T.,0,25,40,40
1683342914901,COGS 14B,A01,185172,Staff,0,15,38,38
1683342915925,COGS 18,A01,184736,Staff,17,0,80,63
1683342916952,COGS 100,A01,184932,Staff,0,5,73,73
1683342917980,COGS 101A,A01,184935,Staff,0,39,30,30
1683342919004,COGS 101B,A01,184944,Staff,0,2,30,30
1683342920030,COGS 101C,A01,184946,Staff,0,12,30,30
1683342921054,COGS 102A,A01,184951,Johnson; Christine M.,2,0,40,38
1683342922079,COGS 107B,A01,184953,Mooshagian; Eric Frederick,0,50,40,40
1683342923102,COGS 118B,A01,184959,Gupta; Anjum,0,48,40,40
1683342924129,COGS 153,A00,184961,Staff,0,15,30,30
1683342925156,COGS 177,A00,184962,Staff,0,20,30,30
1683342926184,COGS 187A,A01,184969,Boyle; Mary E. T.,0,17,40,40
1683342927208,COMM 10,A01,185174,Staff,0,5,25,25
1683342927208,COMM 10,A02,185189,Staff,0,5,25,25
1683342927208,COMM 10,A03,269821,Staff,0,0,0,0
1683342928230,COMM 100B,A01,185475,Staff,0,0,0,2
1683342928230,COMM 100B,A02,185476,Staff,13,0,25,12
1683342929253,COMM 100C,A01,185314,Staff,1,0,25,24
1683342929253,COMM 100C,A02,185327,Staff,19,0,25,6
1683342930278,COMM 110M,A00,185349,Staff,2,0,40,38
1683342931302,COMM 113T,A00,185352,Staff,24,0,40,16
1683342932326,COMM 114I,A00,185353,Staff,33,0,40,7
1683342933351,COMM 131,A00,185354,Staff,19,0,30,11
1683342934374,CSE 8A,A50,185358,Cao; Yingjun,0,46,10,10
1683342935436,CSE 8B,A01,185362,Staff,1,47,50,49
1683342936461,CSE 11,A01,185416,Cao; Yingjun,0,92,10,10
1683342937484,CSE 20,A01,185445,Briones; Jor-el Thomas Caparas,5,0,25,20
1683342938509,CSE 21,A01,185447,Staff,10,0,50,40
1683342939533,CSE 101,A01,185451,Staff,0,13,50,50
1683342939533,CSE 101,B01,185453,Jones; Miles E,0,11,50,50
1683342941584,CSE 141,A01,185458,Eldon; John,20,0,100,80
1683342942609,CSE 141L,A01,185461,Eldon; John,12,0,100,88
1683342943637,CSE 142,A01,185463,Staff,36,0,60,24
1683342943637,CSE 142,B01,201355,Staff,0,7,60,60
1683342944661,CSE 142L,A01,185470,Staff,36,0,60,24
1683342944661,CSE 142L,B01,201417,Staff,0,6,60,60
1683342945685,CSE 190,A00,201433,Staff,32,0,49,17
1683342946714,DOC 1,A01,259136,Strom; Megan C.,7,0,15,8
1683342946714,DOC 1,A02,259137,Strom; Megan C.,14,0,15,1
1683342946714,DOC 1,A03,259138,Strom; Megan C.,14,0,15,1
1683342946714,DOC 1,A04,259139,Strom; Megan C.,14,0,15,1
1683342947746,DOC 100D,A00,259140,Pass; Natalye Joann,16,0,25,9
1683342948770,DSGN 1,A01,184749,Rill; Bryan,0,25,30,30
1683342949796,DSGN 100,A01,185168,Staff,0,2,25,25
1683342950821,ECE 5,A01,185626,Morris; Karcher William,0,10,0,0
1683342951844,ECE 101,A01,185628,Staff,17,0,70,53
1683342952870,ECE 107,A01,185635,Baghdadchi; Saharnaz,0,0,20,20
1683342952870,ECE 107,A02,185638,Baghdadchi; Saharnaz,4,0,20,16
1683342953895,ECE 148,A01,185647,Silberman; Jack,0,0,16,16
1683342954919,ECON 1,A01,185537,Crane; Meredith Helen,54,0,70,16
1683342955944,ECON 3,A01,185549,Crane; Meredith Helen,32,0,70,38
1683342956972,ECON 4,A01,203354,Anderson; John Charles,0,4,10,10
1683342957995,ECON 100A,A01,185574,Staff,0,4,40,40
1683342959022,ECON 100B,A01,185576,Staff,10,22,50,40
1683342960050,ECON 100C,A01,185589,Newhouse; Herbert S,30,0,70,40
1683342961105,ECON 105,A00,185608,Vespa; Emanuel Ignacio,19,0,35,16
1683342962134,ECON 109,A01,185610,Shishkin; Denis,10,0,35,25
1683342963158,ECON 110A,A01,185612,Staff,11,0,40,29
1683342964187,ECON 120A,A01,185615,Staff,20,0,40,20
1683342965213,ECON 120C,A01,185617,Sun; Yixiao,0,20,70,70
1683342966238,ECON 144,A00,203346,Squires; Dale E,3,0,35,32
1683342967263,ECON 171,A01,203349,Newhouse; Herbert S,0,1,35,35
1683342968292,ECON 173A,A01,185621,Toda; Alexis Akira,21,0,35,14
1683342969323,EDS 25,A01,202413,Staff,0,1,0,0
1683342969323,EDS 25,A02,202414,Staff,0,1,0,0
1683342969323,EDS 25,A03,202415,Staff,0,0,0,0
1683342969323,EDS 25,A04,202416,Staff,0,1,0,0
1683342969323,EDS 25,A05,202439,Staff,0,0,0,0
1683342969323,EDS 25,A06,202440,Staff,0,0,0,0
1683342969323,EDS 25,B01,202631,Staff,0,0,0,0
1683342969323,EDS 25,B02,202632,Staff,0,0,0,0
1683342969323,EDS 25,B03,202639,Staff,0,0,0,0
1683342969323,EDS 25,B04,202640,Staff,0,0,0,0
1683342969323,EDS 25,B05,202643,Staff,0,0,0,0
1683342969323,EDS 25,B06,202644,Staff,0,0,0,0
1683342970350,EDS 38,A01,202659,Black; Alison Michelle,24,0,25,1
1683342971379,EDS 115,A00,202652,Staff,18,0,30,12
1683342972404,EDS 125,A00,202649,Staff,14,0,30,16
1683342973432,EDS 126,A01,203332,Staff,30,0,30,0
1683342974458,EDS 139,A00,202838,Staff,16,0,25,9
1683342975483,EDS 146,A01,202655,Staff,14,0,25,11
1683342976508,ENG 15,A00,185667,Staff,0,1,0,0
1683342976508,ENG 15,B00,185672,Staff,0,0,0,0
1683342976508,ENG 15,C00,185675,Staff,0,0,0,0
1683342976508,ENG 15,D00,185682,Staff,0,0,0,0
1683342976508,ENG 15,E00,185684,Staff,0,0,0,0
1683342977533,ETHN 103,A00,185710,Staff,0,4,35,35
1683342978561,ETHN 103A,A00,199228,Man; Simeon S,2,0,9,7
1683342979587,ETHN 109,A00,185711,Staff,18,0,35,17
1683342980612,ETHN 142,A00,185726,Staff,0,4,30,30
1683342981637,ETHN 163J,A00,199229,Man; Simeon S,5,0,8,3
1683342982662,ETHN 168,A00,185727,Staff,8,0,10,2
1683342983690,ETHN 182,A00,185728,Staff,1,0,35,34
1683342984716,ETHN 183,A00,185737,Staff,8,0,18,10
1683342985741,GLBH 111,A01,209361,Burgos; Jose L.,0,0,0,0
1683342987790,HIEU 104,A00,185792,Staff,16,0,20,4
1683342988816,HIEU 115,A00,185800,Staff,1,0,20,19
1683342989838,HIEU 128,A00,185801,Staff,0,7,20,20
1683342990865,HIEU 147,A00,185802,Staff,16,0,20,4
1683342991890,HIEU 154,A00,185823,Staff,12,0,20,8
1683342992918,HILA 102,A00,185826,Staff,13,0,20,7
1683342993942,HILD 2C,A01,185778,Staff,0,12,20,20
1683342994967,HILD 7B,A01,185780,Kwak; Nancy,0,15,32,32
1683342994967,HILD 7B,A02,185781,Kwak; Nancy,0,18,32,32
1683342995996,HILD 30,A01,185791,Staff,14,0,20,6
1683342997021,HISC 119,A00,185830,Golan; Tal,0,9,20,20
1683342998045,HITO 156GS,A00,185831,Patterson; Patrick H.,0,0,0,23
1683342999071,HIUS 103,A00,185832,Man; Simeon S,0,6,20,20
1683343000097,HIUS 117,A00,185836,Kwak; Nancy,2,0,20,18
1683343001121,HIUS 125,A00,185840,Man; Simeon S,0,0,23,23
1683343002148,HIUS 149,A00,185845,Staff,0,0,20,20
1683343003230,HUM 3,A01,185882,Zavodny; Tatiana Sophia,0,7,50,50
1683343003230,HUM 3,B01,185899,Caldwell; Michael Alan,0,18,50,50
1683343004255,HUM 3GS,A00,185900,Patterson; Patrick H.,0,0,0,23
1683343005284,HUM 4,A01,185938,Zroka; Amy Liane,31,0,50,19
1683343005284,HUM 4,B01,185956,Watkins; Eric,0,2,50,50
1683343005284,HUM 4,B02,202209,Watkins; Eric,0,2,50,50
1683343005284,HUM 4,B03,202210,Watkins; Eric,0,2,50,50
1683343006312,HUM 5,A01,185958,West; Geoffrey Scott,3,0,50,47
1683343006312,HUM 5,A02,202215,West; Geoffrey Scott,0,0,50,50
1683343007339,INTL 190,A00,185959,Gagnon; Jeffrey C,0,0,0,9
1683343007339,INTL 190,B00,185960,Lettieri; Michael Joseph,0,0,0,1
1683343008366,JAPN 180,A00,254509,Staff,5,1,30,25
1683343009390,LATI 10,A01,202853,Kennemore; Amy Michelle,4,0,35,31
1683343009390,LATI 10,A02,202854,Kennemore; Amy Michelle,2,0,35,33
1683343009390,LATI 10,A03,270054,Kennemore; Amy Michelle,30,0,30,0
1683343010418,LATI 180,A00,202855,Kennemore; Amy Michelle,11,0,20,9
1683343011442,LAWS 101,A00,201767,Golan; Tal,0,7,40,40
1683343012466,LIFR 1C,A00,185961,Staff,6,0,20,14
1683343013490,LIFR 1CX,A00,185962,Staff,7,0,20,13
1683343014514,LIFR 1D,A00,185963,Staff,9,0,20,11
1683343015539,LIFR 1DX,A00,185964,Staff,9,0,20,11
1683343016564,LIGN 101,A01,186039,Staff,43,0,50,7
1683343017588,LIGN 165,A00,186040,Staff,18,0,50,32
1683343018613,LTCS 108,A00,186041,Staff,6,0,10,4
1683343019643,LTCS 119,A00,186042,Staff,16,0,20,4
1683343020670,LTCS 130,A00,186043,Wesling; Megan E.,15,0,25,10
1683343022727,LTEA 138,A00,186119,Staff,14,0,40,26
1683343023757,LTEN 124,A00,186148,Staff,6,0,25,19
1683343024781,LTEN 178,A00,186149,Staff,7,0,15,8
1683343025808,LTEN 181,A00,186150,Blanco; John D,33,0,40,7
1683343026836,LTWL 120,A00,186160,Staff,20,0,25,5
1683343027864,LTWL 165,A00,186161,Staff,22,0,25,3
1683343028891,LTWR 100,A00,186162,Staff,0,5,15,15
1683343029917,LTWR 102,A00,186163,Doller; Ben,5,0,15,10
1683343030941,MAE 8,A01,186412,Staff,0,0,0,0
1683343031966,MAE 30B,A00,186445,Bahadori; Mohammad Yousef,83,0,100,17
1683343032990,MAE 40,A00,186592,Bewley; Thomas R,9,0,50,41
1683343034015,MAE 101B,A00,186593,Bahadori; Mohammad Yousef,81,0,100,19
1683343035039,MAE 105,A00,186594,Bandaru; Prabhakar,12,0,50,38
1683343036067,MAE 107,A00,186599,Pham; Hieu Tan,0,6,120,120
1683343037092,MAE 148,A01,186660,Silberman; Jack,3,0,16,13
1683343038121,MATH 10A,A01,188095,Staff,1,6,35,34
1683343039151,MATH 10B,A01,188097,Bowers; Adam R.,0,11,30,30
1683343039151,MATH 10B,A02,188099,Bowers; Adam R.,0,11,30,30
1683343039151,MATH 10B,B01,188104,Bowers; Adam R.,0,10,30,30
1683343039151,MATH 10B,B02,188106,Bowers; Adam R.,0,10,30,30
1683343040179,MATH 10C,A01,188111,Staff,0,18,30,30
1683343040179,MATH 10C,A02,188127,Staff,0,17,30,30
1683343040179,MATH 10C,A03,188131,Staff,0,18,30,30
1683343040179,MATH 10C,B01,188218,Staff,18,0,30,12
1683343040179,MATH 10C,B02,188244,Staff,13,0,30,17
1683343040179,MATH 10C,B03,188277,Staff,16,0,30,14
1683343041207,MATH 18,A01,188344,Bach; Quang Tran,18,0,30,12
1683343041207,MATH 18,A02,188345,Bach; Quang Tran,11,0,30,19
1683343041207,MATH 18,B01,188353,Bach; Quang Tran,10,0,30,20
1683343041207,MATH 18,B02,188354,Bach; Quang Tran,20,0,30,10
1683343042234,MATH 20A,A01,188374,Staff,13,0,35,22
1683343043260,MATH 20B,A01,188382,Ohm; Ko Woon,6,0,30,24
1683343043260,MATH 20B,A02,188383,Ohm; Ko Woon,22,0,30,8
1683343043260,MATH 20B,B01,188385,Ohm; Ko Woon,7,0,30,23
1683343043260,MATH 20B,B02,188392,Ohm; Ko Woon,22,0,30,8
1683343044286,MATH 20C,A01,188394,Harel; Guershon,10,0,30,20
1683343044286,MATH 20C,A02,188395,Harel; Guershon,15,0,30,15
1683343044286,MATH 20C,B01,188404,Harel; Guershon,5,0,30,25
1683343044286,MATH 20C,B02,188405,Harel; Guershon,19,0,30,11
1683343045313,MATH 20D,A01,188414,Hammock; Frances H,0,1,30,30
1683343045313,MATH 20D,A02,188415,Hammock; Frances H,3,0,30,27
1683343045313,MATH 20D,B01,188447,Hammock; Frances H,1,0,30,29
1683343045313,MATH 20D,B02,188486,Hammock; Frances H,8,0,30,22
1683343046337,MATH 20E,A01,188649,Staff,21,0,30,9
1683343046337,MATH 20E,A02,188650,Staff,23,0,30,7
1683343046337,MATH 20E,A03,188673,Staff,0,0,30,30
1683343047364,MATH 102,A01,188675,Staff,0,35,35,35
1683343048393,MATH 103B,A01,188681,Staff,3,0,35,32
1683343048393,MATH 103B,B01,188692,Staff,5,0,35,30
1683343049423,MATH 109,A01,188695,Salehi Golsefidy; Alireza,25,0,35,10
1683343049423,MATH 109,A02,188696,Salehi Golsefidy; Alireza,25,0,35,10
1683343050447,MATH 120A,A01,188698,Eggers; John Dietrich,7,0,35,28
1683343051477,MATH 142B,A01,188736,Ioana; Adrian,0,2,30,30
1683343051477,MATH 142B,A02,188741,Ioana; Adrian,1,1,30,29
1683343051477,MATH 142B,A03,188743,Ioana; Adrian,1,3,30,29
1683343052500,MATH 168A,A01,188790,Staff,0,9,35,35
1683343053529,MATH 170A,A01,188803,Nie; Jiawang,0,2,35,35
1683343053529,MATH 170A,A02,188811,Nie; Jiawang,0,0,35,35
1683343053529,MATH 170A,A03,188814,Nie; Jiawang,1,0,35,34
1683343053529,MATH 170A,A04,188815,Nie; Jiawang,13,0,35,22
1683343054554,MATH 193B,A01,188817,Staff,0,0,35,35
1683343054554,MATH 193B,A02,188818,Staff,5,0,35,30
1683343055579,MGT 4,A01,202857,Anderson; John Charles,62,0,80,18
1683343056606,MGT 12,A00,202858,Lindenberger; Wade Douglas,42,0,90,48
1683343057630,MGT 18,A00,202859,Staff,74,0,90,16
1683343058654,MGT 18GS,A00,202860,McKay; Michael J,13,0,28,15
1683343059683,MGT 45,A00,202861,Pecore; Joseph P.,14,0,90,76
1683343060710,MGT 100,A00,202863,Yavorsky; Daniel Ryan,28,0,90,62
1683343061736,MGT 103,A00,202864,Ehrich; Kristine R,1,18,90,89
1683343062761,MGT 112,A00,202865,Ehrich; Kristine R,15,0,90,75
1683343063786,MGT 121A,A00,202868,Staff,0,20,0,0
1683343064810,MGT 131B,A00,202869,Anderson; John Charles,59,0,90,31
1683343065838,MGT 136,A00,202871,Lindenberger; Wade Douglas,84,0,90,6
1683343066862,MGT 164,A00,202873,Staff,0,68,90,91
1683343067886,MGT 164GS,A00,202874,McKay; Mary A,13,0,28,15
1683343068912,MGT 180,A00,202875,Staff,0,50,90,91
1683343069936,MMW 11R,A01,205019,Herbst; Matthew,3,0,30,27
1683343069936,MMW 11R,A02,205026,Herbst; Matthew,29,0,30,1
1683343070966,MMW 15,A01,193512,Chang; Edmond Yi-Teh,0,9,28,28
1683343070966,MMW 15,A02,193513,Chang; Edmond Yi-Teh,0,5,28,28
1683343070966,MMW 15,A03,193514,Chang; Edmond Yi-Teh,0,5,28,28
1683343070966,MMW 15,A04,193515,Chang; Edmond Yi-Teh,0,5,28,28
1683343070966,MMW 15,A05,193516,Chang; Edmond Yi-Teh,0,4,28,28
1683343070966,MMW 15,A06,193517,Chang; Edmond Yi-Teh,0,5,28,28
1683343070966,MMW 15,B01,193519,Chang; Edmond Yi-Teh,0,5,28,28
1683343070966,MMW 15,B02,193520,Chang; Edmond Yi-Teh,0,5,28,28
1683343070966,MMW 15,B03,193521,Chang; Edmond Yi-Teh,0,5,28,28
1683343070966,MMW 15,B04,193522,Chang; Edmond Yi-Teh,0,4,28,28
1683343070966,MMW 15,B05,193523,Chang; Edmond Yi-Teh,0,5,28,28
1683343070966,MMW 15,B06,193524,Chang; Edmond Yi-Teh,0,4,28,28
1683343071991,MMW 122,A01,193526,Rahimi; Babak,0,15,28,28
1683343071991,MMW 122,A02,193527,Rahimi; Babak,0,14,28,28
1683343071991,MMW 122,A03,193528,Rahimi; Babak,0,0,0,0
1683343071991,MMW 122,A04,193529,Rahimi; Babak,0,0,0,0
1683343073015,MUS 1A,A01,186663,Staff,0,20,35,35
1683343074038,MUS 4,A01,186715,Staff,0,12,35,35
1683343075066,MUS 5R,A01,186796,Dubnov; Shlomo,0,17,35,35
1683343076090,MUS 6,A01,186798,Staff,0,4,25,25
1683343077114,MUS 7,A01,186830,Staff,13,0,35,22
1683343078137,MUS 8,A01,186930,Staff,0,26,35,35
1683343079161,MUS 15,A01,186932,Staff,0,16,35,35
1683343079161,MUS 15,B01,186934,Staff,0,15,35,35
1683343080186,MUS 80,A00,186935,Staff,1,0,20,19
1683343080186,MUS 80,B00,186936,Staff,25,0,25,0
1683343081210,NANO 11,A00,204702,Lipomi; Darren John,0,0,0,0
1683343082234,NANO 15,A01,204709,Yang; Kesong,0,1,0,0
1683343083258,NANO 114,A00,202069,Jahed Motlagh; Zeinab,3,0,10,7
1683343084283,PHIL 1,A00,186955,Grush; Rick Scott,32,0,40,8
1683343085311,PHIL 10,A01,186973,Grush; Rick Scott,28,0,35,7
1683343085311,PHIL 10,A02,186974,Grush; Rick Scott,33,0,35,2
1683343086335,PHIL 13,A01,186976,Staff,7,0,35,28
1683343086335,PHIL 13,A02,186977,Staff,16,0,35,19
1683343087359,PHIL 14,A01,186979,Staff,31,0,35,4
1683343087359,PHIL 14,A02,186986,Staff,32,0,35,3
1683343088383,PHIL 28,A01,186988,Staff,16,0,30,14
1683343088383,PHIL 28,A02,186989,Staff,1,0,30,29
1683343088383,PHIL 28,A03,186990,Staff,9,0,30,21
1683343088383,PHIL 28,A04,186991,Staff,26,0,30,4
1683343089410,PHIL 120,A00,186997,Staff,23,0,40,17
1683343090435,PHIL 137,A00,187003,Staff,9,0,40,31
1683343091462,PHIL 150,A00,187015,Staff,47,0,70,23
1683343092487,PHIL 167,A00,187021,Lamey; Andy M.,35,0,40,5
1683343093511,PHIL 174,A01,202226,Staff,17,0,20,3
1683343093511,PHIL 174,A02,202235,Staff,20,0,20,0
1683343094538,PHIL 191A,A00,258918,Staff,0,0,1,1
1683343095563,PHYS 1A,A00,187028,Staff,27,0,60,33
1683343096591,PHYS 1AL,001,187036,Staff,2,0,30,28
1683343096591,PHYS 1AL,002,187049,Staff,18,0,30,12
1683343097618,PHYS 1B,A00,187058,Staff,22,0,60,38
1683343098642,PHYS 1BL,001,187064,Staff,0,0,30,30
1683343098642,PHYS 1BL,002,187070,Staff,5,0,30,25
1683343099670,PHYS 1C,A00,187082,Staff,31,0,120,89
1683343100695,PHYS 1CL,001,187088,Staff,0,9,30,30
1683343100695,PHYS 1CL,002,187089,Staff,0,2,30,30
1683343100695,PHYS 1CL,009,262693,Staff,11,0,30,19
1683343101722,PHYS 2B,A01,187097,Staff,54,0,115,61
1683343102749,PHYS 2C,A01,187099,Staff,67,0,115,48
1683343103774,PHYS 2CL,A01,187101,Staff,5,0,28,23
1683343103774,PHYS 2CL,A02,187102,Staff,15,0,28,13
1683343104802,PHYS 2D,A01,187123,Shotwell; Brian,95,0,115,20
1683343105831,PHYS 4B,A01,187133,Grinstein; Benjamin,35,0,50,15
1683343106911,POLI 10,A00,188819,Staff,0,4,50,50
1683343107936,POLI 11,A00,188827,Staff,43,0,50,7
1683343108960,POLI 13R,A00,188828,Staff,0,1,20,20
1683343109990,POLI 27,A01,188830,Elgin; Samuel Zincke,0,1,70,70
1683343111017,POLI 30,A00,188832,Desposato; Scott,31,0,50,19
1683343112042,POLI 102F,A00,188834,Staff,3,0,40,37
1683343113069,POLI 104A,A00,188852,Staff,14,0,30,16
1683343114094,POLI 104I,A00,188853,Staff,0,6,20,20
1683343115117,POLI 110B,A00,188854,Wiens; David,7,0,20,13
1683343116142,POLI 112A,A00,188855,Wiens; David,5,0,30,25
1683343117167,POLI 117R,A00,188856,Forman; Fonna,0,11,20,20
1683343118195,POLI 118,A00,188857,Ingham; Sean,8,0,20,12
1683343119219,POLI 120G,A00,188858,Staff,9,0,30,21
1683343120243,POLI 131CR,A00,188863,Hoston; Germaine,24,0,50,26
1683343121268,POLI 133,A00,188864,Nellis; Gareth Hb,44,0,50,6
1683343122292,POLI 134D,A00,188865,Desposato; Scott,27,0,30,3
1683343123318,POLI 142A,A00,188871,Gartzke; Erik,22,0,50,28
1683343124345,POLI 142K,A00,188874,Staff,38,0,50,12
1683343125369,POLI 143,A00,188940,Gartzke; Erik,16,0,30,14
1683343126392,POLI 153,A00,188943,Staff,3,0,20,17
1683343127419,POLI 160AA,A00,188944,Staff,12,0,40,28
1683343128444,POLI 170A,A00,188945,Staff,11,0,30,19
1683343130495,PSYC 1,A00,188952,Staff,37,0,90,53
1683343131521,PSYC 2,B00,188953,Staff,19,0,35,16
1683343132545,PSYC 6,A00,188970,Staff,47,0,60,13
1683343133569,PSYC 7,A00,188973,Staff,37,0,45,8
1683343134594,PSYC 60,A01,188980,Rickard; Timothy C.,43,0,60,17
1683343135623,PSYC 70,A01,189001,Steiner; Eric Tomas,23,0,45,22
1683343136647,PSYC 100,A00,189005,Lacefield; Katharine I,0,98,120,120
1683343137672,PSYC 102,A00,189008,Staff,9,0,30,21
1683343138696,PSYC 106,B00,189026,Gorman; Michael R.,34,0,60,26
1683343139721,PSYC 114,B01,189033,Winkielman; Piotr,0,32,30,30
1683343140745,PSYC 131,A00,189036,Anagnostaras; Stephan,0,43,60,60
1683343141772,PSYC 136,A00,189041,Lowe; Angela Beth,0,7,25,25
1683343142800,PSYC 137,A00,189057,Winkielman; Piotr,0,34,25,25
1683343143824,PSYC 144,A00,189107,Wixted; John T,0,7,50,50
1683343145875,PSYC 162,A00,189142,Staff,0,8,85,85
1683343146903,PSYC 172,A00,189144,Gorman; Michael R.,0,7,30,30
1683343148953,PSYC 179,A00,189146,Lacefield; Katharine I,0,84,120,120
1683343149979,PSYC 181,A00,189147,Anagnostaras; Stephan,0,44,90,90
1683343151006,PSYC 190R,A00,189148,Barner; David A.,0,22,80,80
1683343152031,PSYC 191,A00,189275,Rickard; Timothy C.,0,7,25,25
1683343153056,PSYC 193,A00,189276,Chapman; Eddie Nathaniel,0,1,0,4
1683343154082,PSYC 193L,A01,189281,Lowe; Angela Beth,12,0,20,8
1683343154082,PSYC 193L,B01,189285,Staff,28,0,35,7
1683343155107,RELI 149,A00,187137,Rahimi; Babak,7,0,40,33
1683343156162,SE 9,A01,187315,Staff,0,2,18,18
1683343157189,SE 101B,A00,187409,Staff,24,0,30,6
1683343158215,SE 110B,A00,187444,Staff,10,0,40,30
1683343159239,SE 130B,A00,187449,Staff,31,0,40,9
1683343160266,SE 150A,A00,187516,Staff,9,0,20,11
1683343161290,SE 154,A00,187528,Staff,30,0,50,20
1683343162316,SIO 3,A01,258171,Staff,35,0,40,5
1683343163340,SIO 10,A00,187144,Cook; Geoffrey W,0,3,75,75
1683343164364,SIO 45,A00,187152,Cook; Geoffrey W,1,0,100,99
1683343165388,SIO 109R,A00,194486,Staff,0,3,20,20
1683343167435,SIO 187,A01,187233,Kacev; David,12,0,40,28
1683343168460,SOCI 1,A01,258656,Thorpe; Charles Robert,28,0,30,2
1683343168460,SOCI 1,A02,258658,Thorpe; Charles Robert,30,0,30,0
1683343168460,SOCI 1,A03,258661,Thorpe; Charles Robert,25,0,25,0
1683343168460,SOCI 1,A04,258666,Thorpe; Charles Robert,22,0,25,3
1683343168460,SOCI 1,A05,258897,Thorpe; Charles Robert,23,0,25,2
1683343168460,SOCI 1,A06,258898,Thorpe; Charles Robert,25,0,25,0
1683343169484,SOCI 30,A01,258903,Pardo Guerra; Juan Pablo,15,0,30,15
1683343170511,SOCI 102,A00,258904,Staff,9,0,25,16
1683343171535,SOCI 106,A00,258905,Staff,19,0,25,6
1683343172558,SOCI 111,A00,258907,Ribas Norris; Janet Vanesa,26,0,30,4
1683343173582,SOCI 121R,A00,258908,Pardo Guerra; Juan Pablo,10,0,30,20
1683343174607,SOCI 126,A01,203330,Staff,14,0,20,6
1683343175632,SOCI 131,A00,258909,Thorpe; Charles Robert,31,0,60,29
1683343176657,SOCI 135,A00,258910,Payne; Christine Anna,0,9,30,30
1683343177683,SOCI 157,A00,258911,Staff,12,0,30,18
1683343178710,SOCI 184,A00,258912,Staff,25,0,30,5
1683343179734,SOCI 188D,A00,258913,Staff,21,0,30,9
1683343180762,SYN 2,001,187529,Staff,10,0,16,6
1683343180762,SYN 2,002,201452,Staff,0,18,16,16
1683343180762,SYN 2,003,201469,Staff,3,0,16,13
1683343181789,SYN 100,A01,187531,Staff,0,9,20,20
1683343181789,SYN 100,B01,201491,Staff,0,12,20,20
1683343182814,TDAC 1,A00,189286,Walsh; Kim C.,3,0,20,17
1683343182814,TDAC 1,B00,189287,Harting; Carla Kelso,11,0,20,9
1683343183842,TDAC 101,A00,189300,Walsh; Kim C.,16,0,20,4
1683343183842,TDAC 101,B00,189301,Harting; Carla Kelso,18,0,20,2
1683343184870,TDAC 102,A00,189304,Basso; Beatrice,14,0,20,6
1683343185894,TDAC 108,A00,189305,Staff,18,0,20,2
1683343186920,TDDE 131,A00,189310,Staff,19,0,20,1
1683343186920,TDDE 131,B00,189314,Staff,19,0,20,1
1683343186920,TDDE 131,C00,189315,Staff,48,0,50,2
1683343186920,TDDE 131,D00,189316,Staff,14,0,15,1
1683343186920,TDDE 131,E00,204841,Staff,20,0,20,0
1683343187946,TDGE 10,A00,189289,Staff,30,0,50,20
1683343187946,TDGE 10,B00,189290,Havis; Allan,1,0,50,49
1683343188971,TDGE 11,A00,189291,Fulton; Julia,0,3,50,50
1683343188971,TDGE 11,B00,189292,Staff,20,0,25,5
1683343188971,TDGE 11,C00,260270,Staff,0,0,0,0
1683343189995,TDGE 25,A00,189294,Staff,3,0,20,17
1683343191023,TDGE 124,A00,189318,Fulton; Julia,0,8,50,50
1683343192051,TDGE 125,A00,189319,Staff,13,0,25,12
1683343192051,TDGE 125,B00,189320,Staff,23,0,25,2
1683343193080,TDGE 127,A00,189322,Havis; Allan,0,0,50,50
1683343194108,TDHT 101,A00,189323,Staff,18,0,25,7
1683343194108,TDHT 101,B00,189324,Staff,25,0,25,0
1683343195132,TDHT 102,A00,189325,Staff,49,0,50,1
1683343196156,TDMV 1,A00,189295,Arcidiacono; Kristin,19,0,30,11
1683343196156,TDMV 1,B00,189296,Caligagan; Maria T.,24,0,30,6
1683343197180,TDMV 2,A00,189297,Sammartano; Tonnie,28,0,30,2
1683343197180,TDMV 2,B00,189299,Arcidiacono; Kristin,24,0,30,6
1683343198207,TDMV 3,A00,204998,Rincon; Alicia,22,0,30,8
1683343199232,TDMV 120,A00,189458,Sammartano; Tonnie,28,0,30,2
1683343200259,TDMV 138,A00,189541,Jun; Grace Shin Hae,22,0,40,18
1683343201288,TDMV 142,A00,189717,Caligagan; Tony,23,0,30,7
1683343201288,TDMV 142,B00,189718,Caligagan; Maria T.,25,0,30,5
1683343202312,TMC 2,A01,187533,Staff,25,0,25,0
1683343202312,TMC 2,A02,187534,Staff,25,0,25,0
1683343203336,USP 1,A01,187536,Kwak; Nancy,0,16,25,25
1683343204358,USP 5,A01,187538,Staff,10,0,25,15
1683343205385,USP 101,A00,199253,Staff,0,4,0,0
1683343206410,USP 124,A00,187562,Boomhower; Matthew Charles,1,0,30,29
1683343207434,USP 138,A00,187582,Staff,20,0,25,5
1683343208459,USP 152,A01,187597,Staff,4,0,25,21
1683343209486,USP 153,A00,187598,Staff,19,0,25,6
1683343210584,USP 168,A00,187607,Kwak; Nancy,2,0,5,3
1683343211608,USP 173,A00,187619,Staff,4,0,25,21
1683343212634,USP 181,A00,187638,Staff,0,0,25,25
1683343213660,VIS 103,A00,187650,Cruz; Edwin Teddy,23,0,75,52
1683343214687,VIS 110D,A00,187669,Staff,12,0,22,10
1683343215711,VIS 127C,A00,187720,Shen; Kuiyi,67,0,146,79
1683343216735,VIS 149,A00,187731,Yoldas; Pinar,0,14,22,22
1683343217759,VIS 151,A01,188091,Staff,22,0,34,12
1683343217759,VIS 151,A02,188092,Staff,11,0,34,23
1683343218787,VIS 160B,A00,188093,Stalbaum; Brett,0,0,10,10
1683343220841,WCWP 10B,A00,201720,Staff,10,0,15,5
1683343220841,WCWP 10B,B00,201722,Staff,9,0,15,6
1683343221866,WCWP 100,A00,201725,Gagnon; Jeffrey C,0,0,2,2
1683343221866,WCWP 100,B00,201727,Staff,0,4,15,15
1683343224989,ANBI 133,A00,258401,Wilder; Linnea Lorene,34,0,40,6
1683343226013,ANBI 140,A00,258395,Hrvoj Mihic; Branka,18,0,25,7
1683343227036,ANSC 120,A00,258402,Bialecki; Jon Anthony,27,0,40,13
1683343228060,ANSC 144,A00,258400,Staff,14,0,40,26
1683343230113,ANSC 166,A00,258396,Parish; Steven Martin,157,0,175,18
1683343231139,ANSC 180,A00,193533,Staff,9,0,20,11
1683343232162,ANSC 188,A00,258397,Jassal; Aftab,33,0,40,7
1683343233187,ANTH 3,A01,258316,Staff,23,0,30,7
1683343234210,ANTH 5,A00,258394,Semendeferi; Ekaterini,16,0,20,4
1683343235238,ANTH 21,A01,258331,Staff,8,0,40,32
1683343236264,ANTH 103,A00,258398,Varma; Saiba,15,0,25,10
1683343237295,AWP 10,001,202034,Staff,0,0,0,0
1683343237295,AWP 10,002,202035,Staff,0,0,0,0
1683343237295,AWP 10,003,202036,Staff,0,0,0,0
1683343237295,AWP 10,004,202037,Staff,0,0,0,0
1683343237295,AWP 10,005,202038,Staff,0,0,0,0
1683343237295,AWP 10,006,202039,Staff,0,0,0,0
1683343237295,AWP 10,007,202040,Staff,0,0,0,0
1683343237295,AWP 10,008,202041,Staff,0,0,0,0
1683343237295,AWP 10,009,202042,Staff,0,0,0,0
1683343237295,AWP 10,010,202043,Staff,0,0,0,0
1683343237295,AWP 10,011,202044,Staff,0,0,0,0
1683343237295,AWP 10,012,202045,Staff,0,0,0,0
1683343237295,AWP 10,013,202046,Staff,0,0,0,0
1683343237295,AWP 10,014,202047,Staff,0,0,0,0
1683343237295,AWP 10,015,202048,Staff,0,0,0,0
1683343237295,AWP 10,016,202049,Staff,0,0,0,0
1683343237295,AWP 10,017,202050,Staff,0,0,0,0
1683343237295,AWP 10,018,202051,Staff,0,0,0,0
1683343237295,AWP 10,019,202052,Staff,0,0,0,0
1683343237295,AWP 10,020,202053,Staff,0,0,0,0
1683343237295,AWP 10,021,202054,Staff,0,0,0,0
1683343237295,AWP 10,022,202055,Staff,0,0,0,0
1683343237295,AWP 10,023,202056,Staff,0,0,0,0
1683343237295,AWP 10,024,202057,Staff,0,0,0,0
1683343237295,AWP 10,025,202058,Staff,0,0,0,0
1683343237295,AWP 10,026,202059,Staff,0,0,0,0
1683343238319,AWP 102,001,202032,Staff,0,0,0,0
1683343238319,AWP 102,002,202033,Staff,0,0,0,0
1683343239347,BENG 100,A01,254234,Taylor Amos; Alyssa C,31,0,40,9
1683343240369,BENG 196,001,270013,Engler; Adam J.,9999,0,9999,0
1683343241394,BICD 100R,A01,202018,Smith; Laurie,0,7,32,32
1683343241394,BICD 100R,A02,202019,Smith; Laurie,0,2,32,32
1683343241394,BICD 100R,A03,202020,Smith; Laurie,0,1,32,32
1683343241394,BICD 100R,A04,202021,Smith; Laurie,9,0,32,23
1683343241394,BICD 100R,A05,202022,Smith; Laurie,12,0,32,20
1683343242418,BICD 136,A01,193242,Gustafson-Brown; Cindy,0,2,32,32
1683343242418,BICD 136,A02,193244,Gustafson-Brown; Cindy,14,0,32,18
1683343243443,BIEB 102,A01,193249,Butler; Shannon Rhey,0,2,32,32
1683343243443,BIEB 102,A02,193251,Butler; Shannon Rhey,0,0,32,32
1683343243443,BIEB 102,A03,193253,Butler; Shannon Rhey,0,1,32,32
1683343243443,BIEB 102,A04,193255,Butler; Shannon Rhey,17,0,32,15
1683343243443,BIEB 102,A05,193265,Butler; Shannon Rhey,26,0,32,6
1683343243443,BIEB 102,A06,193269,Butler; Shannon Rhey,16,0,32,16
1683343245495,BIEB 150,A01,193274,Staff,0,0,32,32
1683343245495,BIEB 150,A02,193285,Staff,23,0,32,9
1683343246523,BIEB 194,A00,193286,Kurle; Carolyn M.,22,0,32,10
1683343247552,BILD 1,A01,192291,Staff,16,0,32,16
1683343247552,BILD 1,A02,192292,Staff,30,0,32,2
1683343247552,BILD 1,B01,192520,Reuther; Keefe,0,1,0,0
1683343247552,BILD 1,B02,192532,Reuther; Keefe,0,1,0,0
1683343248580,BILD 3,A01,192556,Butler; Shannon Rhey,0,0,32,32
1683343248580,BILD 3,A02,192581,Butler; Shannon Rhey,5,0,32,27
1683343248580,BILD 3,A03,192611,Butler; Shannon Rhey,23,0,32,9
1683343248580,BILD 3,A04,192612,Butler; Shannon Rhey,25,0,32,7
1683343248580,BILD 3,A05,192613,Butler; Shannon Rhey,27,0,32,5
1683343248580,BILD 3,A06,192679,Butler; Shannon Rhey,27,0,32,5
1683343248580,BILD 3,A07,192682,Butler; Shannon Rhey,22,0,32,10
1683343249605,BILD 4,A01,192836,Reuther; Keefe,0,0,24,24
1683343249605,BILD 4,A02,193044,Reuther; Keefe,4,0,24,20
1683343250632,BILD 10,A01,193142,Gustafson-Brown; Cindy,30,0,32,2
1683343250632,BILD 10,A02,193149,Gustafson-Brown; Cindy,31,0,32,1
1683343251658,BIMM 100,A01,193301,Staff,0,6,32,32
1683343251658,BIMM 100,A02,193312,Staff,0,5,32,32
1683343251658,BIMM 100,A03,193323,Staff,0,8,32,32
1683343252687,BIMM 101,A01,193329,McDonnell; Lisa Marie,0,3,24,24
1683343252687,BIMM 101,A02,193339,McDonnell; Lisa Marie,0,3,24,24
1683343252687,BIMM 101,B01,193354,McDonnell; Lisa Marie,0,3,24,24
1683343252687,BIMM 101,B02,193357,McDonnell; Lisa Marie,0,3,24,24
1683343253712,BIMM 110,A01,193377,Tat; John,0,11,32,32
1683343253712,BIMM 110,A02,193378,Tat; John,1,9,32,31
1683343254735,BIMM 120,A01,206116,Staff,0,0,32,32
1683343254735,BIMM 120,A02,206117,Staff,8,0,32,24
1683343254735,BIMM 120,A03,206121,Staff,21,0,32,11
1683343255760,BIPN 100,A01,193393,Park; Ji Young,0,14,32,32
1683343255760,BIPN 100,A02,193402,Park; Ji Young,0,13,32,32
1683343255760,BIPN 100,A03,193413,Park; Ji Young,0,14,32,32
1683343255760,BIPN 100,A04,193414,Park; Ji Young,0,13,32,32
1683343256786,BIPN 102,A01,193429,Staff,0,0,32,32
1683343256786,BIPN 102,A02,193438,Staff,22,0,32,10
1683343257809,BIPN 106,A01,193450,Reyes Gonzalez; Catalina,0,2,40,40
1683343258834,BIPN 134,A01,193465,Cooke; James Edward,0,0,32,32
1683343258834,BIPN 134,A02,193474,Cooke; James Edward,25,0,32,7
1683343258834,BIPN 134,A03,193485,Cooke; James Edward,29,0,32,3
1683343258834,BIPN 134,A04,193486,Cooke; James Edward,21,0,32,11
1683343258834,BIPN 134,A05,193491,Cooke; James Edward,31,0,32,1
1683343258834,BIPN 134,A06,193501,Cooke; James Edward,30,0,32,2
1683343258834,BIPN 134,A07,193510,Cooke; James Edward,29,0,32,3
1683343260887,BISP 194,A00,222522,Staff,14,0,32,18
1683343261910,CAT 124,A01,202407,Staff,20,0,25,5
1683343262934,CAT 125,A00,202408,Marchisotto; Jennifer Anne,4,0,20,16
1683343263959,CAT 125R,A00,202409,Smith; Lauryn Alissa,0,11,20,20
1683343263959,CAT 125R,B00,202410,Morales; Celeste Georgianna,0,11,20,20
1683343263959,CAT 125R,C00,202411,Irwin; Matthew Joseph,0,10,20,20
1683343264983,CENG 15,A01,204712,Yang; Kesong,0,1,0,0
1683343266007,CENG 114,A00,202070,Jahed Motlagh; Zeinab,5,0,20,15
1683343267038,CGS 105,A00,185477,Wesling; Megan E.,24,0,40,16
1683343268067,CGS 106,A00,185494,Staff,13,0,22,9
1683343269092,CGS 108,A00,185495,Staff,14,0,20,6
1683343270116,CGS 114,A00,185496,Staff,13,0,18,5
1683343271146,CGS 119,A00,185501,Staff,15,0,20,5
1683343272174,CGS 120,A00,185511,Staff,13,0,20,7
1683343273202,CHEM 4,A01,184675,Bussey; Thomas J,96,0,100,4
1683343274229,CHEM 6A,A01,184677,Staff,34,0,60,26
1683343275253,CHEM 6B,A01,184679,Staff,65,0,100,35
1683343276281,CHEM 6C,A01,184681,Bussey; Thomas J,1,0,50,49
1683343276281,CHEM 6C,A02,184682,Bussey; Thomas J,34,0,50,16
1683343277305,CHEM 40A,A01,184684,Albizati; Kim F.,37,0,100,63
1683343278334,CHEM 40B,A01,184686,Albizati; Kim F.,0,20,100,100
1683343279358,CHEM 41B,A01,184690,Staff,52,0,100,48
1683343280382,COGS 3,A01,184715,Boyle; Mary E. T.,0,25,40,40
1683343281407,COGS 14B,A01,185172,Staff,0,15,38,38
1683343282430,COGS 18,A01,184736,Staff,17,0,80,63
1683343283457,COGS 100,A01,184932,Staff,0,5,73,73
1683343284482,COGS 101A,A01,184935,Staff,0,39,30,30
1683343285506,COGS 101B,A01,184944,Staff,0,2,30,30
1683343286531,COGS 101C,A01,184946,Staff,0,12,30,30
1683343287555,COGS 102A,A01,184951,Johnson; Christine M.,2,0,40,38
1683343288580,COGS 107B,A01,184953,Mooshagian; Eric Frederick,0,50,40,40
1683343289604,COGS 118B,A01,184959,Gupta; Anjum,0,48,40,40
1683343290631,COGS 153,A00,184961,Staff,0,15,30,30
1683343291655,COGS 177,A00,184962,Staff,0,20,30,30
1683343292680,COGS 187A,A01,184969,Boyle; Mary E. T.,0,17,40,40
1683343293705,COMM 10,A01,185174,Staff,0,5,25,25
1683343293705,COMM 10,A02,185189,Staff,0,5,25,25
1683343293705,COMM 10,A03,269821,Staff,0,0,0,0
1683343294730,COMM 100B,A01,185475,Staff,0,0,0,2
1683343294730,COMM 100B,A02,185476,Staff,13,0,25,12
1683343295756,COMM 100C,A01,185314,Staff,1,0,25,24
1683343295756,COMM 100C,A02,185327,Staff,19,0,25,6
1683343296785,COMM 110M,A00,185349,Staff,2,0,40,38
1683343297809,COMM 113T,A00,185352,Staff,24,0,40,16
1683343298833,COMM 114I,A00,185353,Staff,33,0,40,7
1683343299857,COMM 131,A00,185354,Staff,19,0,30,11
1683343300882,CSE 8A,A50,185358,Cao; Yingjun,0,46,10,10
1683343301910,CSE 8B,A01,185362,Staff,1,47,50,49
1683343302935,CSE 11,A01,185416,Cao; Yingjun,0,92,10,10
1683343303958,CSE 20,A01,185445,Briones; Jor-el Thomas Caparas,5,0,25,20
1683343304983,CSE 21,A01,185447,Staff,10,0,50,40
1683343306012,CSE 101,A01,185451,Staff,0,13,50,50
1683343306012,CSE 101,B01,185453,Jones; Miles E,0,11,50,50
1683343308065,CSE 141,A01,185458,Eldon; John,20,0,100,80
1683343309093,CSE 141L,A01,185461,Eldon; John,12,0,100,88
1683343310123,CSE 142,A01,185463,Staff,36,0,60,24
1683343310123,CSE 142,B01,201355,Staff,0,7,60,60
1683343311150,CSE 142L,A01,185470,Staff,36,0,60,24
1683343311150,CSE 142L,B01,201417,Staff,0,6,60,60
1683343312179,CSE 190,A00,201433,Staff,32,0,49,17
1683343313207,DOC 1,A01,259136,Strom; Megan C.,7,0,15,8
1683343313207,DOC 1,A02,259137,Strom; Megan C.,14,0,15,1
1683343313207,DOC 1,A03,259138,Strom; Megan C.,14,0,15,1
1683343313207,DOC 1,A04,259139,Strom; Megan C.,14,0,15,1
1683343314290,DOC 100D,A00,259140,Pass; Natalye Joann,16,0,25,9
1683343315317,DSGN 1,A01,184749,Rill; Bryan,0,25,30,30
1683343316344,DSGN 100,A01,185168,Staff,0,2,25,25
1683343317369,ECE 5,A01,185626,Morris; Karcher William,0,10,0,0
1683343318394,ECE 101,A01,185628,Staff,17,0,70,53
1683343319418,ECE 107,A01,185635,Baghdadchi; Saharnaz,0,0,20,20
1683343319418,ECE 107,A02,185638,Baghdadchi; Saharnaz,4,0,20,16
1683343320443,ECE 148,A01,185647,Silberman; Jack,0,0,16,16
1683343321468,ECON 1,A01,185537,Crane; Meredith Helen,54,0,70,16
1683343322497,ECON 3,A01,185549,Crane; Meredith Helen,32,0,70,38
1683343323522,ECON 4,A01,203354,Anderson; John Charles,0,4,10,10
1683343324551,ECON 100A,A01,185574,Staff,0,4,40,40
1683343325575,ECON 100B,A01,185576,Staff,10,22,50,40
1683343326600,ECON 100C,A01,185589,Newhouse; Herbert S,30,0,70,40
1683343327629,ECON 105,A00,185608,Vespa; Emanuel Ignacio,19,0,35,16
1683343328653,ECON 109,A01,185610,Shishkin; Denis,10,0,35,25
1683343329678,ECON 110A,A01,185612,Staff,11,0,40,29
1683343330704,ECON 120A,A01,185615,Staff,20,0,40,20
1683343331729,ECON 120C,A01,185617,Sun; Yixiao,0,20,70,70
1683343332752,ECON 144,A00,203346,Squires; Dale E,3,0,35,32
1683343333780,ECON 171,A01,203349,Newhouse; Herbert S,0,1,35,35
1683343334806,ECON 173A,A01,185621,Toda; Alexis Akira,21,0,35,14
1683343335836,EDS 25,A01,202413,Staff,0,1,0,0
1683343335836,EDS 25,A02,202414,Staff,0,1,0,0
1683343335836,EDS 25,A03,202415,Staff,0,0,0,0
1683343335836,EDS 25,A04,202416,Staff,0,1,0,0
1683343335836,EDS 25,A05,202439,Staff,0,0,0,0
1683343335836,EDS 25,A06,202440,Staff,0,0,0,0
1683343335836,EDS 25,B01,202631,Staff,0,0,0,0
1683343335836,EDS 25,B02,202632,Staff,0,0,0,0
1683343335836,EDS 25,B03,202639,Staff,0,0,0,0
1683343335836,EDS 25,B04,202640,Staff,0,0,0,0
1683343335836,EDS 25,B05,202643,Staff,0,0,0,0
1683343335836,EDS 25,B06,202644,Staff,0,0,0,0
1683343336864,EDS 38,A01,202659,Black; Alison Michelle,24,0,25,1
1683343337888,EDS 115,A00,202652,Staff,18,0,30,12
1683343338912,EDS 125,A00,202649,Staff,14,0,30,16
1683343339937,EDS 126,A01,203332,Staff,30,0,30,0
1683343340962,EDS 139,A00,202838,Staff,16,0,25,9
1683343341985,EDS 146,A01,202655,Staff,14,0,25,11
1683343343010,ENG 15,A00,185667,Staff,0,1,0,0
1683343343010,ENG 15,B00,185672,Staff,0,0,0,0
1683343343010,ENG 15,C00,185675,Staff,0,0,0,0
1683343343010,ENG 15,D00,185682,Staff,0,0,0,0
1683343343010,ENG 15,E00,185684,Staff,0,0,0,0
1683343344035,ETHN 103,A00,185710,Staff,0,4,35,35
1683343345063,ETHN 103A,A00,199228,Man; Simeon S,2,0,9,7
1683343346092,ETHN 109,A00,185711,Staff,18,0,35,17
1683343347122,ETHN 142,A00,185726,Staff,0,4,30,30
1683343348145,ETHN 163J,A00,199229,Man; Simeon S,5,0,8,3
1683343349170,ETHN 168,A00,185727,Staff,8,0,10,2
1683343350196,ETHN 182,A00,185728,Staff,1,0,35,34
1683343351219,ETHN 183,A00,185737,Staff,8,0,18,10
1683343352243,GLBH 111,A01,209361,Burgos; Jose L.,0,0,0,0
1683343354297,HIEU 104,A00,185792,Staff,16,0,20,4
1683343355325,HIEU 115,A00,185800,Staff,1,0,20,19
1683343356349,HIEU 128,A00,185801,Staff,0,7,20,20
1683343357374,HIEU 147,A00,185802,Staff,16,0,20,4
1683343358403,HIEU 154,A00,185823,Staff,12,0,20,8
1683343359431,HILA 102,A00,185826,Staff,13,0,20,7
1683343360459,HILD 2C,A01,185778,Staff,0,12,20,20
1683343361487,HILD 7B,A01,185780,Kwak; Nancy,0,15,32,32
1683343361487,HILD 7B,A02,185781,Kwak; Nancy,0,18,32,32
1683343362514,HILD 30,A01,185791,Staff,14,0,20,6
1683343363539,HISC 119,A00,185830,Golan; Tal,0,9,20,20
1683343364582,HITO 156GS,A00,185831,Patterson; Patrick H.,0,0,0,23
1683343365611,HIUS 103,A00,185832,Man; Simeon S,0,6,20,20
1683343366638,HIUS 117,A00,185836,Kwak; Nancy,2,0,20,18
1683343367662,HIUS 125,A00,185840,Man; Simeon S,0,0,23,23
1683343368689,HIUS 149,A00,185845,Staff,0,0,20,20
1683343369716,HUM 3,A01,185882,Zavodny; Tatiana Sophia,0,7,50,50
1683343369716,HUM 3,B01,185899,Caldwell; Michael Alan,0,18,50,50
1683343370740,HUM 3GS,A00,185900,Patterson; Patrick H.,0,0,0,23
1683343371769,HUM 4,A01,185938,Zroka; Amy Liane,31,0,50,19
1683343371769,HUM 4,B01,185956,Watkins; Eric,0,2,50,50
1683343371769,HUM 4,B02,202209,Watkins; Eric,0,2,50,50
1683343371769,HUM 4,B03,202210,Watkins; Eric,0,2,50,50
1683343372794,HUM 5,A01,185958,West; Geoffrey Scott,3,0,50,47
1683343372794,HUM 5,A02,202215,West; Geoffrey Scott,0,0,50,50
1683343373820,INTL 190,A00,185959,Gagnon; Jeffrey C,0,0,0,9
1683343373820,INTL 190,B00,185960,Lettieri; Michael Joseph,0,0,0,1
1683343374844,JAPN 180,A00,254509,Staff,5,1,30,25
1683343375873,LATI 10,A01,202853,Kennemore; Amy Michelle,4,0,35,31
1683343375873,LATI 10,A02,202854,Kennemore; Amy Michelle,2,0,35,33
1683343375873,LATI 10,A03,270054,Kennemore; Amy Michelle,30,0,30,0
1683343376901,LATI 180,A00,202855,Kennemore; Amy Michelle,11,0,20,9
1683343377928,LAWS 101,A00,201767,Golan; Tal,0,7,40,40
1683343378956,LIFR 1C,A00,185961,Staff,6,0,20,14
1683343379984,LIFR 1CX,A00,185962,Staff,7,0,20,13
1683343381012,LIFR 1D,A00,185963,Staff,9,0,20,11
1683343382035,LIFR 1DX,A00,185964,Staff,9,0,20,11
1683343383059,LIGN 101,A01,186039,Staff,43,0,50,7
1683343384093,LIGN 165,A00,186040,Staff,18,0,50,32
1683343385118,LTCS 108,A00,186041,Staff,6,0,10,4
1683343386142,LTCS 119,A00,186042,Staff,16,0,20,4
1683343387167,LTCS 130,A00,186043,Wesling; Megan E.,15,0,25,10
1683343389216,LTEA 138,A00,186119,Staff,14,0,40,26
1683343390242,LTEN 124,A00,186148,Staff,6,0,25,19
1683343391269,LTEN 178,A00,186149,Staff,7,0,15,8
1683343392293,LTEN 181,A00,186150,Blanco; John D,33,0,40,7
1683343393318,LTWL 120,A00,186160,Staff,20,0,25,5
1683343394342,LTWL 165,A00,186161,Staff,22,0,25,3
1683343395369,LTWR 100,A00,186162,Staff,0,5,15,15
1683343396395,LTWR 102,A00,186163,Doller; Ben,5,0,15,10
1683343397418,MAE 8,A01,186412,Staff,0,0,0,0
1683343398441,MAE 30B,A00,186445,Bahadori; Mohammad Yousef,83,0,100,17
1683343399466,MAE 40,A00,186592,Bewley; Thomas R,9,0,50,41
1683343400494,MAE 101B,A00,186593,Bahadori; Mohammad Yousef,81,0,100,19
1683343401518,MAE 105,A00,186594,Bandaru; Prabhakar,12,0,50,38
1683343402541,MAE 107,A00,186599,Pham; Hieu Tan,0,6,120,120
1683343403570,MAE 148,A01,186660,Silberman; Jack,3,0,16,13
1683343404594,MATH 10A,A01,188095,Staff,1,6,35,34
1683343405620,MATH 10B,A01,188097,Bowers; Adam R.,0,11,30,30
1683343405620,MATH 10B,A02,188099,Bowers; Adam R.,0,11,30,30
1683343405620,MATH 10B,B01,188104,Bowers; Adam R.,0,10,30,30
1683343405620,MATH 10B,B02,188106,Bowers; Adam R.,0,10,30,30
1683343406649,MATH 10C,A01,188111,Staff,0,18,30,30
1683343406649,MATH 10C,A02,188127,Staff,0,17,30,30
1683343406649,MATH 10C,A03,188131,Staff,0,18,30,30
1683343406649,MATH 10C,B01,188218,Staff,18,0,30,12
1683343406649,MATH 10C,B02,188244,Staff,13,0,30,17
1683343406649,MATH 10C,B03,188277,Staff,16,0,30,14
1683343407675,MATH 18,A01,188344,Bach; Quang Tran,18,0,30,12
1683343407675,MATH 18,A02,188345,Bach; Quang Tran,11,0,30,19
1683343407675,MATH 18,B01,188353,Bach; Quang Tran,10,0,30,20
1683343407675,MATH 18,B02,188354,Bach; Quang Tran,20,0,30,10
1683343408700,MATH 20A,A01,188374,Staff,13,0,35,22
1683343409725,MATH 20B,A01,188382,Ohm; Ko Woon,6,0,30,24
1683343409725,MATH 20B,A02,188383,Ohm; Ko Woon,22,0,30,8
1683343409725,MATH 20B,B01,188385,Ohm; Ko Woon,7,0,30,23
1683343409725,MATH 20B,B02,188392,Ohm; Ko Woon,22,0,30,8
1683343410749,MATH 20C,A01,188394,Harel; Guershon,10,0,30,20
1683343410749,MATH 20C,A02,188395,Harel; Guershon,15,0,30,15
1683343410749,MATH 20C,B01,188404,Harel; Guershon,5,0,30,25
1683343410749,MATH 20C,B02,188405,Harel; Guershon,19,0,30,11
1683343411780,MATH 20D,A01,188414,Hammock; Frances H,0,1,30,30
1683343411780,MATH 20D,A02,188415,Hammock; Frances H,3,0,30,27
1683343411780,MATH 20D,B01,188447,Hammock; Frances H,1,0,30,29
1683343411780,MATH 20D,B02,188486,Hammock; Frances H,8,0,30,22
1683343412809,MATH 20E,A01,188649,Staff,21,0,30,9
1683343412809,MATH 20E,A02,188650,Staff,23,0,30,7
1683343412809,MATH 20E,A03,188673,Staff,0,0,30,30
1683343413836,MATH 102,A01,188675,Staff,0,35,35,35
1683343414860,MATH 103B,A01,188681,Staff,3,0,35,32
1683343414860,MATH 103B,B01,188692,Staff,5,0,35,30
1683343415888,MATH 109,A01,188695,Salehi Golsefidy; Alireza,25,0,35,10
1683343415888,MATH 109,A02,188696,Salehi Golsefidy; Alireza,25,0,35,10
1683343416913,MATH 120A,A01,188698,Eggers; John Dietrich,7,0,35,28
1683343417997,MATH 142B,A01,188736,Ioana; Adrian,0,2,30,30
1683343417997,MATH 142B,A02,188741,Ioana; Adrian,1,1,30,29
1683343417997,MATH 142B,A03,188743,Ioana; Adrian,1,3,30,29
1683343419022,MATH 168A,A01,188790,Staff,0,9,35,35
1683343420047,MATH 170A,A01,188803,Nie; Jiawang,0,2,35,35
1683343420047,MATH 170A,A02,188811,Nie; Jiawang,0,0,35,35
1683343420047,MATH 170A,A03,188814,Nie; Jiawang,1,0,35,34
1683343420047,MATH 170A,A04,188815,Nie; Jiawang,13,0,35,22
1683343421076,MATH 193B,A01,188817,Staff,0,0,35,35
1683343421076,MATH 193B,A02,188818,Staff,5,0,35,30
1683343422100,MGT 4,A01,202857,Anderson; John Charles,62,0,80,18
1683343423124,MGT 12,A00,202858,Lindenberger; Wade Douglas,42,0,90,48
1683343424149,MGT 18,A00,202859,Staff,74,0,90,16
1683343425173,MGT 18GS,A00,202860,McKay; Michael J,13,0,28,15
1683343426197,MGT 45,A00,202861,Pecore; Joseph P.,14,0,90,76
1683343427221,MGT 100,A00,202863,Yavorsky; Daniel Ryan,28,0,90,62
1683343428245,MGT 103,A00,202864,Ehrich; Kristine R,1,18,90,89
1683343429269,MGT 112,A00,202865,Ehrich; Kristine R,15,0,90,75
1683343430293,MGT 121A,A00,202868,Staff,0,20,0,0
1683343431318,MGT 131B,A00,202869,Anderson; John Charles,59,0,90,31
1683343432346,MGT 136,A00,202871,Lindenberger; Wade Douglas,84,0,90,6
1683343433373,MGT 164,A00,202873,Staff,0,68,90,91
1683343434400,MGT 164GS,A00,202874,McKay; Mary A,13,0,28,15
1683343435424,MGT 180,A00,202875,Staff,0,50,90,91
1683343436452,MMW 11R,A01,205019,Herbst; Matthew,3,0,30,27
1683343436452,MMW 11R,A02,205026,Herbst; Matthew,29,0,30,1
1683343437481,MMW 15,A01,193512,Chang; Edmond Yi-Teh,0,9,28,28
1683343437481,MMW 15,A02,193513,Chang; Edmond Yi-Teh,0,5,28,28
1683343437481,MMW 15,A03,193514,Chang; Edmond Yi-Teh,0,5,28,28
1683343437481,MMW 15,A04,193515,Chang; Edmond Yi-Teh,0,5,28,28
1683343437481,MMW 15,A05,193516,Chang; Edmond Yi-Teh,0,4,28,28
1683343437481,MMW 15,A06,193517,Chang; Edmond Yi-Teh,0,5,28,28
1683343437481,MMW 15,B01,193519,Chang; Edmond Yi-Teh,0,5,28,28
1683343437481,MMW 15,B02,193520,Chang; Edmond Yi-Teh,0,5,28,28
1683343437481,MMW 15,B03,193521,Chang; Edmond Yi-Teh,0,5,28,28
1683343437481,MMW 15,B04,193522,Chang; Edmond Yi-Teh,0,4,28,28
1683343437481,MMW 15,B05,193523,Chang; Edmond Yi-Teh,0,5,28,28
1683343437481,MMW 15,B06,193524,Chang; Edmond Yi-Teh,0,4,28,28
1683343438507,MMW 122,A01,193526,Rahimi; Babak,0,15,28,28
1683343438507,MMW 122,A02,193527,Rahimi; Babak,0,14,28,28
1683343438507,MMW 122,A03,193528,Rahimi; Babak,0,0,0,0
1683343438507,MMW 122,A04,193529,Rahimi; Babak,0,0,0,0
1683343439534,MUS 1A,A01,186663,Staff,0,20,35,35
1683343440563,MUS 4,A01,186715,Staff,0,12,35,35
1683343441587,MUS 5R,A01,186796,Dubnov; Shlomo,0,17,35,35
1683343442611,MUS 6,A01,186798,Staff,0,4,25,25
1683343443636,MUS 7,A01,186830,Staff,13,0,35,22
1683343444660,MUS 8,A01,186930,Staff,0,26,35,35
1683343445689,MUS 15,A01,186932,Staff,0,16,35,35
1683343445689,MUS 15,B01,186934,Staff,0,15,35,35
1683343446714,MUS 80,A00,186935,Staff,1,0,20,19
1683343446714,MUS 80,B00,186936,Staff,25,0,25,0
1683343447739,NANO 11,A00,204702,Lipomi; Darren John,0,0,0,0
1683343448768,NANO 15,A01,204709,Yang; Kesong,0,1,0,0
1683343449797,NANO 114,A00,202069,Jahed Motlagh; Zeinab,3,0,10,7
1683343450820,PHIL 1,A00,186955,Grush; Rick Scott,32,0,40,8
1683343451847,PHIL 10,A01,186973,Grush; Rick Scott,28,0,35,7
1683343451847,PHIL 10,A02,186974,Grush; Rick Scott,33,0,35,2
1683343452875,PHIL 13,A01,186976,Staff,7,0,35,28
1683343452875,PHIL 13,A02,186977,Staff,16,0,35,19
1683343453904,PHIL 14,A01,186979,Staff,31,0,35,4
1683343453904,PHIL 14,A02,186986,Staff,32,0,35,3
1683343454929,PHIL 28,A01,186988,Staff,16,0,30,14
1683343454929,PHIL 28,A02,186989,Staff,1,0,30,29
1683343454929,PHIL 28,A03,186990,Staff,9,0,30,21
1683343454929,PHIL 28,A04,186991,Staff,26,0,30,4
1683343455957,PHIL 120,A00,186997,Staff,23,0,40,17
1683343456983,PHIL 137,A00,187003,Staff,9,0,40,31
1683343458010,PHIL 150,A00,187015,Staff,47,0,70,23
1683343459035,PHIL 167,A00,187021,Lamey; Andy M.,35,0,40,5
1683343460062,PHIL 174,A01,202226,Staff,17,0,20,3
1683343460062,PHIL 174,A02,202235,Staff,20,0,20,0
1683343461089,PHIL 191A,A00,258918,Staff,0,0,1,1
1683343462114,PHYS 1A,A00,187028,Staff,27,0,60,33
1683343463142,PHYS 1AL,001,187036,Staff,2,0,30,28
1683343463142,PHYS 1AL,002,187049,Staff,18,0,30,12
1683343464170,PHYS 1B,A00,187058,Staff,22,0,60,38
1683343465201,PHYS 1BL,001,187064,Staff,0,0,30,30
1683343465201,PHYS 1BL,002,187070,Staff,5,0,30,25
1683343466225,PHYS 1C,A00,187082,Staff,31,0,120,89
1683343467253,PHYS 1CL,001,187088,Staff,0,9,30,30
1683343467253,PHYS 1CL,002,187089,Staff,0,2,30,30
1683343467253,PHYS 1CL,009,262693,Staff,11,0,30,19
1683343468278,PHYS 2B,A01,187097,Staff,54,0,115,61
1683343469301,PHYS 2C,A01,187099,Staff,67,0,115,48
1683343470330,PHYS 2CL,A01,187101,Staff,5,0,28,23
1683343470330,PHYS 2CL,A02,187102,Staff,15,0,28,13
1683343471354,PHYS 2D,A01,187123,Shotwell; Brian,95,0,115,20
1683343472379,PHYS 4B,A01,187133,Grinstein; Benjamin,35,0,50,15
1683343473404,POLI 10,A00,188819,Staff,0,4,50,50
1683343474428,POLI 11,A00,188827,Staff,43,0,50,7
1683343475455,POLI 13R,A00,188828,Staff,0,1,20,20
1683343476482,POLI 27,A01,188830,Elgin; Samuel Zincke,0,1,70,70
1683343477509,POLI 30,A00,188832,Desposato; Scott,31,0,50,19
1683343478533,POLI 102F,A00,188834,Staff,3,0,40,37
1683343479558,POLI 104A,A00,188852,Staff,14,0,30,16
1683343480585,POLI 104I,A00,188853,Staff,0,6,20,20
1683343481612,POLI 110B,A00,188854,Wiens; David,7,0,20,13
1683343482640,POLI 112A,A00,188855,Wiens; David,5,0,30,25
1683343483661,POLI 117R,A00,188856,Forman; Fonna,0,11,20,20
1683343484686,POLI 118,A00,188857,Ingham; Sean,8,0,20,12
1683343485710,POLI 120G,A00,188858,Staff,9,0,30,21
1683343486739,POLI 131CR,A00,188863,Hoston; Germaine,24,0,50,26
1683343487766,POLI 133,A00,188864,Nellis; Gareth Hb,44,0,50,6
1683343488795,POLI 134D,A00,188865,Desposato; Scott,27,0,30,3
1683343489823,POLI 142A,A00,188871,Gartzke; Erik,22,0,50,28
1683343490849,POLI 142K,A00,188874,Staff,38,0,50,12
1683343491877,POLI 143,A00,188940,Gartzke; Erik,16,0,30,14
1683343492901,POLI 153,A00,188943,Staff,3,0,20,17
1683343493925,POLI 160AA,A00,188944,Staff,12,0,40,28
1683343494952,POLI 170A,A00,188945,Staff,11,0,30,19
1683343497000,PSYC 1,A00,188952,Staff,37,0,90,53
1683343498024,PSYC 2,B00,188953,Staff,19,0,35,16
1683343499054,PSYC 6,A00,188970,Staff,47,0,60,13
1683343500081,PSYC 7,A00,188973,Staff,37,0,45,8
1683343501113,PSYC 60,A01,188980,Rickard; Timothy C.,43,0,60,17
1683343502139,PSYC 70,A01,189001,Steiner; Eric Tomas,23,0,45,22
1683343503164,PSYC 100,A00,189005,Lacefield; Katharine I,0,98,120,120
1683343504187,PSYC 102,A00,189008,Staff,9,0,30,21
1683343505212,PSYC 106,B00,189026,Gorman; Michael R.,34,0,60,26
1683343506236,PSYC 114,B01,189033,Winkielman; Piotr,0,32,30,30
1683343507261,PSYC 131,A00,189036,Anagnostaras; Stephan,0,43,60,60
1683343508285,PSYC 136,A00,189041,Lowe; Angela Beth,0,7,25,25
1683343509308,PSYC 137,A00,189057,Winkielman; Piotr,0,34,25,25
1683343510335,PSYC 144,A00,189107,Wixted; John T,0,7,50,50
1683343512386,PSYC 162,A00,189142,Staff,0,8,85,85
1683343513413,PSYC 172,A00,189144,Gorman; Michael R.,0,7,30,30
1683343515461,PSYC 179,A00,189146,Lacefield; Katharine I,0,84,120,120
1683343516486,PSYC 181,A00,189147,Anagnostaras; Stephan,0,44,90,90
1683343517510,PSYC 190R,A00,189148,Barner; David A.,0,22,80,80
1683343518534,PSYC 191,A00,189275,Rickard; Timothy C.,0,7,25,25
1683343519558,PSYC 193,A00,189276,Chapman; Eddie Nathaniel,0,1,0,4
1683343520588,PSYC 193L,A01,189281,Lowe; Angela Beth,12,0,20,8
1683343520588,PSYC 193L,B01,189285,Staff,28,0,35,7
1683343521667,RELI 149,A00,187137,Rahimi; Babak,7,0,40,33
1683343522690,SE 9,A01,187315,Staff,0,2,18,18
1683343523714,SE 101B,A00,187409,Staff,24,0,30,6
1683343524741,SE 110B,A00,187444,Staff,10,0,40,30
1683343525769,SE 130B,A00,187449,Staff,31,0,40,9
1683343526797,SE 150A,A00,187516,Staff,9,0,20,11
1683343527822,SE 154,A00,187528,Staff,30,0,50,20
1683343528851,SIO 3,A01,258171,Staff,35,0,40,5
1683343529878,SIO 10,A00,187144,Cook; Geoffrey W,0,3,75,75
1683343530901,SIO 45,A00,187152,Cook; Geoffrey W,1,0,100,99
1683343531928,SIO 109R,A00,194486,Staff,0,3,20,20
1683343533985,SIO 187,A01,187233,Kacev; David,12,0,40,28
1683343535010,SOCI 1,A01,258656,Thorpe; Charles Robert,28,0,30,2
1683343535010,SOCI 1,A02,258658,Thorpe; Charles Robert,30,0,30,0
1683343535010,SOCI 1,A03,258661,Thorpe; Charles Robert,25,0,25,0
1683343535010,SOCI 1,A04,258666,Thorpe; Charles Robert,22,0,25,3
1683343535010,SOCI 1,A05,258897,Thorpe; Charles Robert,23,0,25,2
1683343535010,SOCI 1,A06,258898,Thorpe; Charles Robert,25,0,25,0
1683343536048,SOCI 30,A01,258903,Pardo Guerra; Juan Pablo,15,0,30,15
1683343537074,SOCI 102,A00,258904,Staff,9,0,25,16
1683343538098,SOCI 106,A00,258905,Staff,19,0,25,6
1683343539126,SOCI 111,A00,258907,Ribas Norris; Janet Vanesa,26,0,30,4
1683343540149,SOCI 121R,A00,258908,Pardo Guerra; Juan Pablo,10,0,30,20
1683343541174,SOCI 126,A01,203330,Staff,14,0,20,6
1683343542201,SOCI 131,A00,258909,Thorpe; Charles Robert,31,0,60,29
1683343543224,SOCI 135,A00,258910,Payne; Christine Anna,0,9,30,30
1683343544249,SOCI 157,A00,258911,Staff,12,0,30,18
1683343545275,SOCI 184,A00,258912,Staff,25,0,30,5
1683343546299,SOCI 188D,A00,258913,Staff,21,0,30,9
1683343547326,SYN 2,001,187529,Staff,10,0,16,6
1683343547326,SYN 2,002,201452,Staff,0,18,16,16
1683343547326,SYN 2,003,201469,Staff,3,0,16,13
1683343548354,SYN 100,A01,187531,Staff,0,9,20,20
1683343548354,SYN 100,B01,201491,Staff,0,12,20,20
1683343549379,TDAC 1,A00,189286,Walsh; Kim C.,3,0,20,17
1683343549379,TDAC 1,B00,189287,Harting; Carla Kelso,11,0,20,9
1683343550406,TDAC 101,A00,189300,Walsh; Kim C.,16,0,20,4
1683343550406,TDAC 101,B00,189301,Harting; Carla Kelso,18,0,20,2
1683343551433,TDAC 102,A00,189304,Basso; Beatrice,14,0,20,6
1683343552459,TDAC 108,A00,189305,Staff,18,0,20,2
1683343553485,TDDE 131,A00,189310,Staff,19,0,20,1
1683343553485,TDDE 131,B00,189314,Staff,19,0,20,1
1683343553485,TDDE 131,C00,189315,Staff,48,0,50,2
1683343553485,TDDE 131,D00,189316,Staff,14,0,15,1
1683343553485,TDDE 131,E00,204841,Staff,20,0,20,0
1683343554507,TDGE 10,A00,189289,Staff,30,0,50,20
1683343554507,TDGE 10,B00,189290,Havis; Allan,1,0,50,49
1683343555532,TDGE 11,A00,189291,Fulton; Julia,0,3,50,50
1683343555532,TDGE 11,B00,189292,Staff,20,0,25,5
1683343555532,TDGE 11,C00,260270,Staff,0,0,0,0
1683343556556,TDGE 25,A00,189294,Staff,3,0,20,17
1683343557580,TDGE 124,A00,189318,Fulton; Julia,0,8,50,50
1683343558605,TDGE 125,A00,189319,Staff,13,0,25,12
1683343558605,TDGE 125,B00,189320,Staff,23,0,25,2
1683343559629,TDGE 127,A00,189322,Havis; Allan,0,0,50,50
1683343560652,TDHT 101,A00,189323,Staff,18,0,25,7
1683343560652,TDHT 101,B00,189324,Staff,25,0,25,0
1683343561676,TDHT 102,A00,189325,Staff,49,0,50,1
1683343562703,TDMV 1,A00,189295,Arcidiacono; Kristin,19,0,30,11
1683343562703,TDMV 1,B00,189296,Caligagan; Maria T.,24,0,30,6
1683343563728,TDMV 2,A00,189297,Sammartano; Tonnie,28,0,30,2
1683343563728,TDMV 2,B00,189299,Arcidiacono; Kristin,24,0,30,6
1683343564752,TDMV 3,A00,204998,Rincon; Alicia,22,0,30,8
1683343565780,TDMV 120,A00,189458,Sammartano; Tonnie,28,0,30,2
1683343566804,TDMV 138,A00,189541,Jun; Grace Shin Hae,22,0,40,18
1683343567828,TDMV 142,A00,189717,Caligagan; Tony,23,0,30,7
1683343567828,TDMV 142,B00,189718,Caligagan; Maria T.,25,0,30,5
1683343568855,TMC 2,A01,187533,Staff,25,0,25,0
1683343568855,TMC 2,A02,187534,Staff,25,0,25,0
1683343569882,USP 1,A01,187536,Kwak; Nancy,0,16,25,25
1683343570910,USP 5,A01,187538,Staff,10,0,25,15
1683343571934,USP 101,A00,199253,Staff,0,4,0,0
1683343572963,USP 124,A00,187562,Boomhower; Matthew Charles,1,0,30,29
1683343573995,USP 138,A00,187582,Staff,20,0,25,5
1683343575023,USP 152,A01,187597,Staff,4,0,25,21
1683343576052,USP 153,A00,187598,Staff,19,0,25,6
1683343577080,USP 168,A00,187607,Kwak; Nancy,2,0,5,3
1683343578106,USP 173,A00,187619,Staff,4,0,25,21
1683343579130,USP 181,A00,187638,Staff,0,0,25,25
1683343580154,VIS 103,A00,187650,Cruz; Edwin Teddy,23,0,75,52
1683343581181,VIS 110D,A00,187669,Staff,12,0,22,10
1683343582209,VIS 127C,A00,187720,Shen; Kuiyi,67,0,146,79
1683343583230,VIS 149,A00,187731,Yoldas; Pinar,0,14,22,22
1683343584255,VIS 151,A01,188091,Staff,22,0,34,12
1683343584255,VIS 151,A02,188092,Staff,11,0,34,23
1683343585280,VIS 160B,A00,188093,Stalbaum; Brett,0,0,10,10
1683343587331,WCWP 10B,A00,201720,Staff,10,0,15,5
1683343587331,WCWP 10B,B00,201722,Staff,9,0,15,6
1683343588356,WCWP 100,A00,201725,Gagnon; Jeffrey C,0,0,2,2
1683343588356,WCWP 100,B00,201727,Staff,0,4,15,15
1683343591447,ANBI 133,A00,258401,Wilder; Linnea Lorene,34,0,40,6
1683343592473,ANBI 140,A00,258395,Hrvoj Mihic; Branka,18,0,25,7
1683343593500,ANSC 120,A00,258402,Bialecki; Jon Anthony,27,0,40,13
1683343594526,ANSC 144,A00,258400,Staff,14,0,40,26
1683343596578,ANSC 166,A00,258396,Parish; Steven Martin,157,0,175,18
1683343597606,ANSC 180,A00,193533,Staff,9,0,20,11
1683343598630,ANSC 188,A00,258397,Jassal; Aftab,33,0,40,7
1683343599654,ANTH 3,A01,258316,Staff,23,0,30,7
1683343600682,ANTH 5,A00,258394,Semendeferi; Ekaterini,16,0,20,4
1683343601706,ANTH 21,A01,258331,Staff,8,0,40,32
1683343602730,ANTH 103,A00,258398,Varma; Saiba,15,0,25,10
1683343603763,AWP 10,001,202034,Staff,0,0,0,0
1683343603763,AWP 10,002,202035,Staff,0,0,0,0
1683343603763,AWP 10,003,202036,Staff,0,0,0,0
1683343603763,AWP 10,004,202037,Staff,0,0,0,0
1683343603763,AWP 10,005,202038,Staff,0,0,0,0
1683343603763,AWP 10,006,202039,Staff,0,0,0,0
1683343603763,AWP 10,007,202040,Staff,0,0,0,0
1683343603763,AWP 10,008,202041,Staff,0,0,0,0
1683343603763,AWP 10,009,202042,Staff,0,0,0,0
1683343603763,AWP 10,010,202043,Staff,0,0,0,0
1683343603763,AWP 10,011,202044,Staff,0,0,0,0
1683343603763,AWP 10,012,202045,Staff,0,0,0,0
1683343603763,AWP 10,013,202046,Staff,0,0,0,0
1683343603763,AWP 10,014,202047,Staff,0,0,0,0
1683343603763,AWP 10,015,202048,Staff,0,0,0,0
1683343603763,AWP 10,016,202049,Staff,0,0,0,0
1683343603763,AWP 10,017,202050,Staff,0,0,0,0
1683343603763,AWP 10,018,202051,Staff,0,0,0,0
1683343603763,AWP 10,019,202052,Staff,0,0,0,0
1683343603763,AWP 10,020,202053,Staff,0,0,0,0
1683343603763,AWP 10,021,202054,Staff,0,0,0,0
1683343603763,AWP 10,022,202055,Staff,0,0,0,0
1683343603763,AWP 10,023,202056,Staff,0,0,0,0
1683343603763,AWP 10,024,202057,Staff,0,0,0,0
1683343603763,AWP 10,025,202058,Staff,0,0,0,0
1683343603763,AWP 10,026,202059,Staff,0,0,0,0
1683343604791,AWP 102,001,202032,Staff,0,0,0,0
1683343604791,AWP 102,002,202033,Staff,0,0,0,0
1683343605840,BENG 100,A01,254234,Taylor Amos; Alyssa C,31,0,40,9
1683343606865,BENG 196,001,270013,Engler; Adam J.,9999,0,9999,0
1683343607894,BICD 100R,A01,202018,Smith; Laurie,0,7,32,32
1683343607894,BICD 100R,A02,202019,Smith; Laurie,0,2,32,32
1683343607894,BICD 100R,A03,202020,Smith; Laurie,0,1,32,32
1683343607894,BICD 100R,A04,202021,Smith; Laurie,9,0,32,23
1683343607894,BICD 100R,A05,202022,Smith; Laurie,12,0,32,20
1683343608918,BICD 136,A01,193242,Gustafson-Brown; Cindy,0,2,32,32
1683343608918,BICD 136,A02,193244,Gustafson-Brown; Cindy,14,0,32,18
1683343609947,BIEB 102,A01,193249,Butler; Shannon Rhey,0,2,32,32
1683343609947,BIEB 102,A02,193251,Butler; Shannon Rhey,0,0,32,32
1683343609947,BIEB 102,A03,193253,Butler; Shannon Rhey,0,1,32,32
1683343609947,BIEB 102,A04,193255,Butler; Shannon Rhey,17,0,32,15
1683343609947,BIEB 102,A05,193265,Butler; Shannon Rhey,26,0,32,6
1683343609947,BIEB 102,A06,193269,Butler; Shannon Rhey,16,0,32,16
1683343612001,BIEB 150,A01,193274,Staff,0,0,32,32
1683343612001,BIEB 150,A02,193285,Staff,23,0,32,9
1683343613024,BIEB 194,A00,193286,Kurle; Carolyn M.,22,0,32,10
1683343614049,BILD 1,A01,192291,Staff,16,0,32,16
1683343614049,BILD 1,A02,192292,Staff,30,0,32,2
1683343614049,BILD 1,B01,192520,Reuther; Keefe,0,1,0,0
1683343614049,BILD 1,B02,192532,Reuther; Keefe,0,1,0,0
1683343615075,BILD 3,A01,192556,Butler; Shannon Rhey,0,0,32,32
1683343615075,BILD 3,A02,192581,Butler; Shannon Rhey,5,0,32,27
1683343615075,BILD 3,A03,192611,Butler; Shannon Rhey,23,0,32,9
1683343615075,BILD 3,A04,192612,Butler; Shannon Rhey,25,0,32,7
1683343615075,BILD 3,A05,192613,Butler; Shannon Rhey,27,0,32,5
1683343615075,BILD 3,A06,192679,Butler; Shannon Rhey,27,0,32,5
1683343615075,BILD 3,A07,192682,Butler; Shannon Rhey,22,0,32,10
1683343616105,BILD 4,A01,192836,Reuther; Keefe,0,0,24,24
1683343616105,BILD 4,A02,193044,Reuther; Keefe,4,0,24,20
1683343617131,BILD 10,A01,193142,Gustafson-Brown; Cindy,30,0,32,2
1683343617131,BILD 10,A02,193149,Gustafson-Brown; Cindy,31,0,32,1
1683343618155,BIMM 100,A01,193301,Staff,0,6,32,32
1683343618155,BIMM 100,A02,193312,Staff,0,5,32,32
1683343618155,BIMM 100,A03,193323,Staff,0,8,32,32
1683343619186,BIMM 101,A01,193329,McDonnell; Lisa Marie,0,3,24,24
1683343619186,BIMM 101,A02,193339,McDonnell; Lisa Marie,0,3,24,24
1683343619186,BIMM 101,B01,193354,McDonnell; Lisa Marie,0,3,24,24
1683343619186,BIMM 101,B02,193357,McDonnell; Lisa Marie,0,3,24,24
1683343620211,BIMM 110,A01,193377,Tat; John,0,11,32,32
1683343620211,BIMM 110,A02,193378,Tat; John,1,9,32,31
1683343621235,BIMM 120,A01,206116,Staff,0,0,32,32
1683343621235,BIMM 120,A02,206117,Staff,8,0,32,24
1683343621235,BIMM 120,A03,206121,Staff,21,0,32,11
1683343622265,BIPN 100,A01,193393,Park; Ji Young,0,14,32,32
1683343622265,BIPN 100,A02,193402,Park; Ji Young,0,13,32,32
1683343622265,BIPN 100,A03,193413,Park; Ji Young,0,14,32,32
1683343622265,BIPN 100,A04,193414,Park; Ji Young,0,13,32,32
1683343623291,BIPN 102,A01,193429,Staff,0,0,32,32
1683343623291,BIPN 102,A02,193438,Staff,22,0,32,10
1683343624315,BIPN 106,A01,193450,Reyes Gonzalez; Catalina,0,2,40,40
1683343625424,BIPN 134,A01,193465,Cooke; James Edward,0,0,32,32
1683343625424,BIPN 134,A02,193474,Cooke; James Edward,25,0,32,7
1683343625424,BIPN 134,A03,193485,Cooke; James Edward,29,0,32,3
1683343625424,BIPN 134,A04,193486,Cooke; James Edward,21,0,32,11
1683343625424,BIPN 134,A05,193491,Cooke; James Edward,31,0,32,1
1683343625424,BIPN 134,A06,193501,Cooke; James Edward,30,0,32,2
1683343625424,BIPN 134,A07,193510,Cooke; James Edward,29,0,32,3
1683343627473,BISP 194,A00,222522,Staff,14,0,32,18
1683343628500,CAT 124,A01,202407,Staff,20,0,25,5
1683343629529,CAT 125,A00,202408,Marchisotto; Jennifer Anne,4,0,20,16
1683343630557,CAT 125R,A00,202409,Smith; Lauryn Alissa,0,11,20,20
1683343630557,CAT 125R,B00,202410,Morales; Celeste Georgianna,0,11,20,20
1683343630557,CAT 125R,C00,202411,Irwin; Matthew Joseph,0,10,20,20
1683343631583,CENG 15,A01,204712,Yang; Kesong,0,1,0,0
1683343632613,CENG 114,A00,202070,Jahed Motlagh; Zeinab,5,0,20,15
1683343633640,CGS 105,A00,185477,Wesling; Megan E.,24,0,40,16
1683343634668,CGS 106,A00,185494,Staff,13,0,22,9
1683343635694,CGS 108,A00,185495,Staff,14,0,20,6
1683343636723,CGS 114,A00,185496,Staff,13,0,18,5
1683343637750,CGS 119,A00,185501,Staff,15,0,20,5
1683343638778,CGS 120,A00,185511,Staff,13,0,20,7
1683343639803,CHEM 4,A01,184675,Bussey; Thomas J,96,0,100,4
1683343640832,CHEM 6A,A01,184677,Staff,34,0,60,26
1683343641856,CHEM 6B,A01,184679,Staff,65,0,100,35
1683343642885,CHEM 6C,A01,184681,Bussey; Thomas J,1,0,50,49
1683343642885,CHEM 6C,A02,184682,Bussey; Thomas J,34,0,50,16
1683343643910,CHEM 40A,A01,184684,Albizati; Kim F.,37,0,100,63
1683343644936,CHEM 40B,A01,184686,Albizati; Kim F.,0,20,100,100
1683343645960,CHEM 41B,A01,184690,Staff,52,0,100,48
1683343646989,COGS 3,A01,184715,Boyle; Mary E. T.,0,25,40,40
1683343648015,COGS 14B,A01,185172,Staff,0,15,38,38
1683343649042,COGS 18,A01,184736,Staff,17,0,80,63
1683343650067,COGS 100,A01,184932,Staff,0,5,73,73
1683343651091,COGS 101A,A01,184935,Staff,0,39,30,30
1683343652116,COGS 101B,A01,184944,Staff,0,2,30,30
1683343653144,COGS 101C,A01,184946,Staff,0,12,30,30
1683343654172,COGS 102A,A01,184951,Johnson; Christine M.,2,0,40,38
1683343655196,COGS 107B,A01,184953,Mooshagian; Eric Frederick,0,50,40,40
1683343656223,COGS 118B,A01,184959,Gupta; Anjum,0,48,40,40
1683343657250,COGS 153,A00,184961,Staff,0,15,30,30
1683343658277,COGS 177,A00,184962,Staff,0,20,30,30
1683343659301,COGS 187A,A01,184969,Boyle; Mary E. T.,0,17,40,40
1683343660327,COMM 10,A01,185174,Staff,0,5,25,25
1683343660327,COMM 10,A02,185189,Staff,0,5,25,25
1683343660327,COMM 10,A03,269821,Staff,0,0,0,0
1683343661355,COMM 100B,A01,185475,Staff,0,0,0,2
1683343661355,COMM 100B,A02,185476,Staff,13,0,25,12
1683343662383,COMM 100C,A01,185314,Staff,1,0,25,24
1683343662383,COMM 100C,A02,185327,Staff,19,0,25,6
1683343663407,COMM 110M,A00,185349,Staff,2,0,40,38
1683343664433,COMM 113T,A00,185352,Staff,24,0,40,16
1683343665457,COMM 114I,A00,185353,Staff,33,0,40,7
1683343666482,COMM 131,A00,185354,Staff,19,0,30,11
1683343667508,CSE 8A,A50,185358,Cao; Yingjun,0,46,10,10
1683343668534,CSE 8B,A01,185362,Staff,1,47,50,49
1683343669559,CSE 11,A01,185416,Cao; Yingjun,0,92,10,10
1683343670585,CSE 20,A01,185445,Briones; Jor-el Thomas Caparas,5,0,25,20
1683343671609,CSE 21,A01,185447,Staff,10,0,50,40
1683343672638,CSE 101,A01,185451,Staff,0,13,50,50
1683343672638,CSE 101,B01,185453,Jones; Miles E,0,11,50,50
1683343674694,CSE 141,A01,185458,Eldon; John,20,0,100,80
1683343675722,CSE 141L,A01,185461,Eldon; John,12,0,100,88
1683343676747,CSE 142,A01,185463,Staff,36,0,60,24
1683343676747,CSE 142,B01,201355,Staff,0,7,60,60
1683343677771,CSE 142L,A01,185470,Staff,36,0,60,24
1683343677771,CSE 142L,B01,201417,Staff,0,6,60,60
1683343678796,CSE 190,A00,201433,Staff,32,0,49,17
1683343679823,DOC 1,A01,259136,Strom; Megan C.,7,0,15,8
1683343679823,DOC 1,A02,259137,Strom; Megan C.,14,0,15,1
1683343679823,DOC 1,A03,259138,Strom; Megan C.,14,0,15,1
1683343679823,DOC 1,A04,259139,Strom; Megan C.,14,0,15,1
1683343680850,DOC 100D,A00,259140,Pass; Natalye Joann,16,0,25,9
1683343681876,DSGN 1,A01,184749,Rill; Bryan,0,25,30,30
1683343682901,DSGN 100,A01,185168,Staff,0,2,25,25
1683343683926,ECE 5,A01,185626,Morris; Karcher William,0,10,0,0
1683343684950,ECE 101,A01,185628,Staff,17,0,70,53
1683343685975,ECE 107,A01,185635,Baghdadchi; Saharnaz,0,0,20,20
1683343685975,ECE 107,A02,185638,Baghdadchi; Saharnaz,4,0,20,16
1683343687003,ECE 148,A01,185647,Silberman; Jack,0,0,16,16
1683343688028,ECON 1,A01,185537,Crane; Meredith Helen,54,0,70,16
1683343689059,ECON 3,A01,185549,Crane; Meredith Helen,32,0,70,38
1683343690086,ECON 4,A01,203354,Anderson; John Charles,0,4,10,10
1683343691111,ECON 100A,A01,185574,Staff,0,4,40,40
1683343692138,ECON 100B,A01,185576,Staff,10,22,50,40
1683343693166,ECON 100C,A01,185589,Newhouse; Herbert S,30,0,70,40
1683343694191,ECON 105,A00,185608,Vespa; Emanuel Ignacio,19,0,35,16
1683343695220,ECON 109,A01,185610,Shishkin; Denis,10,0,35,25
1683343696245,ECON 110A,A01,185612,Staff,11,0,40,29
1683343697272,ECON 120A,A01,185615,Staff,20,0,40,20
1683343698298,ECON 120C,A01,185617,Sun; Yixiao,0,20,70,70
1683343699322,ECON 144,A00,203346,Squires; Dale E,3,0,35,32
1683343700346,ECON 171,A01,203349,Newhouse; Herbert S,0,1,35,35
1683343701372,ECON 173A,A01,185621,Toda; Alexis Akira,21,0,35,14
1683343702401,EDS 25,A01,202413,Staff,0,1,0,0
1683343702401,EDS 25,A02,202414,Staff,0,1,0,0
1683343702401,EDS 25,A03,202415,Staff,0,0,0,0
1683343702401,EDS 25,A04,202416,Staff,0,1,0,0
1683343702401,EDS 25,A05,202439,Staff,0,0,0,0
1683343702401,EDS 25,A06,202440,Staff,0,0,0,0
1683343702401,EDS 25,B01,202631,Staff,0,0,0,0
1683343702401,EDS 25,B02,202632,Staff,0,0,0,0
1683343702401,EDS 25,B03,202639,Staff,0,0,0,0
1683343702401,EDS 25,B04,202640,Staff,0,0,0,0
1683343702401,EDS 25,B05,202643,Staff,0,0,0,0
1683343702401,EDS 25,B06,202644,Staff,0,0,0,0
1683343703429,EDS 38,A01,202659,Black; Alison Michelle,24,0,25,1
1683343704456,EDS 115,A00,202652,Staff,18,0,30,12
1683343705484,EDS 125,A00,202649,Staff,14,0,30,16
1683343706509,EDS 126,A01,203332,Staff,30,0,30,0
1683343707537,EDS 139,A00,202838,Staff,16,0,25,9
1683343708562,EDS 146,A01,202655,Staff,14,0,25,11
1683343709585,ENG 15,A00,185667,Staff,0,1,0,0
1683343709585,ENG 15,B00,185672,Staff,0,0,0,0
1683343709585,ENG 15,C00,185675,Staff,0,0,0,0
1683343709585,ENG 15,D00,185682,Staff,0,0,0,0
1683343709585,ENG 15,E00,185684,Staff,0,0,0,0
1683343710613,ETHN 103,A00,185710,Staff,0,4,35,35
1683343711638,ETHN 103A,A00,199228,Man; Simeon S,2,0,9,7
1683343712668,ETHN 109,A00,185711,Staff,18,0,35,17
1683343713696,ETHN 142,A00,185726,Staff,0,4,30,30
1683343714719,ETHN 163J,A00,199229,Man; Simeon S,5,0,8,3
1683343715741,ETHN 168,A00,185727,Staff,8,0,10,2
1683343716768,ETHN 182,A00,185728,Staff,1,0,35,34
1683343717795,ETHN 183,A00,185737,Staff,8,0,18,10
1683343718825,GLBH 111,A01,209361,Burgos; Jose L.,0,0,0,0
1683343720877,HIEU 104,A00,185792,Staff,16,0,20,4
1683343721903,HIEU 115,A00,185800,Staff,1,0,20,19
1683343722928,HIEU 128,A00,185801,Staff,0,7,20,20
1683343723952,HIEU 147,A00,185802,Staff,16,0,20,4
1683343724976,HIEU 154,A00,185823,Staff,12,0,20,8
1683343726000,HILA 102,A00,185826,Staff,13,0,20,7
1683343727026,HILD 2C,A01,185778,Staff,0,12,20,20
1683343728054,HILD 7B,A01,185780,Kwak; Nancy,0,15,32,32
1683343728054,HILD 7B,A02,185781,Kwak; Nancy,0,18,32,32
1683343729131,HILD 30,A01,185791,Staff,14,0,20,6
1683343730158,HISC 119,A00,185830,Golan; Tal,0,9,20,20
1683343731185,HITO 156GS,A00,185831,Patterson; Patrick H.,0,0,0,23
1683343732207,HIUS 103,A00,185832,Man; Simeon S,0,6,20,20
1683343733233,HIUS 117,A00,185836,Kwak; Nancy,2,0,20,18
1683343734260,HIUS 125,A00,185840,Man; Simeon S,0,0,23,23
1683343735288,HIUS 149,A00,185845,Staff,0,0,20,20
1683343736314,HUM 3,A01,185882,Zavodny; Tatiana Sophia,0,7,50,50
1683343736314,HUM 3,B01,185899,Caldwell; Michael Alan,0,18,50,50
1683343737339,HUM 3GS,A00,185900,Patterson; Patrick H.,0,0,0,23
1683343738369,HUM 4,A01,185938,Zroka; Amy Liane,31,0,50,19
1683343738369,HUM 4,B01,185956,Watkins; Eric,0,2,50,50
1683343738369,HUM 4,B02,202209,Watkins; Eric,0,2,50,50
1683343738369,HUM 4,B03,202210,Watkins; Eric,0,2,50,50
1683343739396,HUM 5,A01,185958,West; Geoffrey Scott,3,0,50,47
1683343739396,HUM 5,A02,202215,West; Geoffrey Scott,0,0,50,50
1683343740424,INTL 190,A00,185959,Gagnon; Jeffrey C,0,0,0,9
1683343740424,INTL 190,B00,185960,Lettieri; Michael Joseph,0,0,0,1
1683343741449,JAPN 180,A00,254509,Staff,5,1,30,25
1683343742473,LATI 10,A01,202853,Kennemore; Amy Michelle,4,0,35,31
1683343742473,LATI 10,A02,202854,Kennemore; Amy Michelle,2,0,35,33
1683343742473,LATI 10,A03,270054,Kennemore; Amy Michelle,30,0,30,0
1683343743498,LATI 180,A00,202855,Kennemore; Amy Michelle,11,0,20,9
1683343744522,LAWS 101,A00,201767,Golan; Tal,0,7,40,40
1683343745546,LIFR 1C,A00,185961,Staff,6,0,20,14
1683343746570,LIFR 1CX,A00,185962,Staff,7,0,20,13
1683343747594,LIFR 1D,A00,185963,Staff,9,0,20,11
1683343748617,LIFR 1DX,A00,185964,Staff,9,0,20,11
1683343749641,LIGN 101,A01,186039,Staff,43,0,50,7
1683343750667,LIGN 165,A00,186040,Staff,18,0,50,32
1683343751690,LTCS 108,A00,186041,Staff,6,0,10,4
1683343752714,LTCS 119,A00,186042,Staff,16,0,20,4
1683343753738,LTCS 130,A00,186043,Wesling; Megan E.,15,0,25,10
1683343755789,LTEA 138,A00,186119,Staff,14,0,40,26
1683343756814,LTEN 124,A00,186148,Staff,6,0,25,19
1683343757843,LTEN 178,A00,186149,Staff,7,0,15,8
1683343758873,LTEN 181,A00,186150,Blanco; John D,33,0,40,7
1683343759902,LTWL 120,A00,186160,Staff,20,0,25,5
1683343760928,LTWL 165,A00,186161,Staff,22,0,25,3
1683343761954,LTWR 100,A00,186162,Staff,0,5,15,15
1683343762978,LTWR 102,A00,186163,Doller; Ben,5,0,15,10
1683343764001,MAE 8,A01,186412,Staff,0,0,0,0
1683343765031,MAE 30B,A00,186445,Bahadori; Mohammad Yousef,83,0,100,17
1683343766055,MAE 40,A00,186592,Bewley; Thomas R,9,0,50,41
1683343767083,MAE 101B,A00,186593,Bahadori; Mohammad Yousef,81,0,100,19
1683343768111,MAE 105,A00,186594,Bandaru; Prabhakar,12,0,50,38
1683343769137,MAE 107,A00,186599,Pham; Hieu Tan,0,6,120,120
1683343770160,MAE 148,A01,186660,Silberman; Jack,3,0,16,13
1683343771184,MATH 10A,A01,188095,Staff,1,6,35,34
1683343772213,MATH 10B,A01,188097,Bowers; Adam R.,0,11,30,30
1683343772213,MATH 10B,A02,188099,Bowers; Adam R.,0,11,30,30
1683343772213,MATH 10B,B01,188104,Bowers; Adam R.,0,10,30,30
1683343772213,MATH 10B,B02,188106,Bowers; Adam R.,0,10,30,30
1683343773241,MATH 10C,A01,188111,Staff,0,18,30,30
1683343773241,MATH 10C,A02,188127,Staff,0,17,30,30
1683343773241,MATH 10C,A03,188131,Staff,0,18,30,30
1683343773241,MATH 10C,B01,188218,Staff,18,0,30,12
1683343773241,MATH 10C,B02,188244,Staff,13,0,30,17
1683343773241,MATH 10C,B03,188277,Staff,16,0,30,14
1683343774266,MATH 18,A01,188344,Bach; Quang Tran,18,0,30,12
1683343774266,MATH 18,A02,188345,Bach; Quang Tran,11,0,30,19
1683343774266,MATH 18,B01,188353,Bach; Quang Tran,10,0,30,20
1683343774266,MATH 18,B02,188354,Bach; Quang Tran,20,0,30,10
1683343775290,MATH 20A,A01,188374,Staff,13,0,35,22
1683343776320,MATH 20B,A01,188382,Ohm; Ko Woon,6,0,30,24
1683343776320,MATH 20B,A02,188383,Ohm; Ko Woon,22,0,30,8
1683343776320,MATH 20B,B01,188385,Ohm; Ko Woon,7,0,30,23
1683343776320,MATH 20B,B02,188392,Ohm; Ko Woon,22,0,30,8
1683343777348,MATH 20C,A01,188394,Harel; Guershon,10,0,30,20
1683343777348,MATH 20C,A02,188395,Harel; Guershon,15,0,30,15
1683343777348,MATH 20C,B01,188404,Harel; Guershon,5,0,30,25
1683343777348,MATH 20C,B02,188405,Harel; Guershon,19,0,30,11
1683343778373,MATH 20D,A01,188414,Hammock; Frances H,0,1,30,30
1683343778373,MATH 20D,A02,188415,Hammock; Frances H,3,0,30,27
1683343778373,MATH 20D,B01,188447,Hammock; Frances H,1,0,30,29
1683343778373,MATH 20D,B02,188486,Hammock; Frances H,8,0,30,22
1683343779398,MATH 20E,A01,188649,Staff,21,0,30,9
1683343779398,MATH 20E,A02,188650,Staff,23,0,30,7
1683343779398,MATH 20E,A03,188673,Staff,0,0,30,30
1683343780425,MATH 102,A01,188675,Staff,0,35,35,35
1683343781454,MATH 103B,A01,188681,Staff,3,0,35,32
1683343781454,MATH 103B,B01,188692,Staff,5,0,35,30
1683343782483,MATH 109,A01,188695,Salehi Golsefidy; Alireza,25,0,35,10
1683343782483,MATH 109,A02,188696,Salehi Golsefidy; Alireza,25,0,35,10
1683343783510,MATH 120A,A01,188698,Eggers; John Dietrich,7,0,35,28
1683343784535,MATH 142B,A01,188736,Ioana; Adrian,0,2,30,30
1683343784535,MATH 142B,A02,188741,Ioana; Adrian,1,1,30,29
1683343784535,MATH 142B,A03,188743,Ioana; Adrian,1,3,30,29
1683343785563,MATH 168A,A01,188790,Staff,0,9,35,35
1683343786588,MATH 170A,A01,188803,Nie; Jiawang,0,2,35,35
1683343786588,MATH 170A,A02,188811,Nie; Jiawang,0,0,35,35
1683343786588,MATH 170A,A03,188814,Nie; Jiawang,1,0,35,34
1683343786588,MATH 170A,A04,188815,Nie; Jiawang,13,0,35,22
1683343787612,MATH 193B,A01,188817,Staff,0,0,35,35
1683343787612,MATH 193B,A02,188818,Staff,5,0,35,30
1683343788636,MGT 4,A01,202857,Anderson; John Charles,62,0,80,18
1683343789659,MGT 12,A00,202858,Lindenberger; Wade Douglas,42,0,90,48
1683343790684,MGT 18,A00,202859,Staff,74,0,90,16
1683343791708,MGT 18GS,A00,202860,McKay; Michael J,13,0,28,15
1683343792732,MGT 45,A00,202861,Pecore; Joseph P.,14,0,90,76
1683343793759,MGT 100,A00,202863,Yavorsky; Daniel Ryan,28,0,90,62
1683343794787,MGT 103,A00,202864,Ehrich; Kristine R,1,18,90,89
1683343795815,MGT 112,A00,202865,Ehrich; Kristine R,15,0,90,75
1683343796842,MGT 121A,A00,202868,Staff,0,20,0,0
1683343797868,MGT 131B,A00,202869,Anderson; John Charles,59,0,90,31
1683343798892,MGT 136,A00,202871,Lindenberger; Wade Douglas,84,0,90,6
1683343799915,MGT 164,A00,202873,Staff,0,68,90,91
1683343800943,MGT 164GS,A00,202874,McKay; Mary A,13,0,28,15
1683343801985,MGT 180,A00,202875,Staff,0,50,90,91
1683343803025,MMW 11R,A01,205019,Herbst; Matthew,3,0,30,27
1683343803025,MMW 11R,A02,205026,Herbst; Matthew,29,0,30,1
1683343804052,MMW 15,A01,193512,Chang; Edmond Yi-Teh,0,9,28,28
1683343804052,MMW 15,A02,193513,Chang; Edmond Yi-Teh,0,5,28,28
1683343804052,MMW 15,A03,193514,Chang; Edmond Yi-Teh,0,5,28,28
1683343804052,MMW 15,A04,193515,Chang; Edmond Yi-Teh,0,5,28,28
1683343804052,MMW 15,A05,193516,Chang; Edmond Yi-Teh,0,4,28,28
1683343804052,MMW 15,A06,193517,Chang; Edmond Yi-Teh,0,5,28,28
1683343804052,MMW 15,B01,193519,Chang; Edmond Yi-Teh,0,5,28,28
1683343804052,MMW 15,B02,193520,Chang; Edmond Yi-Teh,0,5,28,28
1683343804052,MMW 15,B03,193521,Chang; Edmond Yi-Teh,0,5,28,28
1683343804052,MMW 15,B04,193522,Chang; Edmond Yi-Teh,0,4,28,28
1683343804052,MMW 15,B05,193523,Chang; Edmond Yi-Teh,0,5,28,28
1683343804052,MMW 15,B06,193524,Chang; Edmond Yi-Teh,0,4,28,28
1683343805077,MMW 122,A01,193526,Rahimi; Babak,0,15,28,28
1683343805077,MMW 122,A02,193527,Rahimi; Babak,0,14,28,28
1683343805077,MMW 122,A03,193528,Rahimi; Babak,0,0,0,0
1683343805077,MMW 122,A04,193529,Rahimi; Babak,0,0,0,0
1683343806104,MUS 1A,A01,186663,Staff,0,20,35,35
1683343807128,MUS 4,A01,186715,Staff,0,12,35,35
1683343808152,MUS 5R,A01,186796,Dubnov; Shlomo,0,17,35,35
1683343809177,MUS 6,A01,186798,Staff,0,4,25,25
1683343810205,MUS 7,A01,186830,Staff,13,0,35,22
1683343811229,MUS 8,A01,186930,Staff,0,26,35,35
1683343812257,MUS 15,A01,186932,Staff,0,16,35,35
1683343812257,MUS 15,B01,186934,Staff,0,15,35,35
1683343813294,MUS 80,A00,186935,Staff,1,0,20,19
1683343813294,MUS 80,B00,186936,Staff,25,0,25,0
1683343814322,NANO 11,A00,204702,Lipomi; Darren John,0,0,0,0
1683343815349,NANO 15,A01,204709,Yang; Kesong,0,1,0,0
1683343816376,NANO 114,A00,202069,Jahed Motlagh; Zeinab,3,0,10,7
1683343817400,PHIL 1,A00,186955,Grush; Rick Scott,32,0,40,8
1683343818424,PHIL 10,A01,186973,Grush; Rick Scott,28,0,35,7
1683343818424,PHIL 10,A02,186974,Grush; Rick Scott,33,0,35,2
1683343819450,PHIL 13,A01,186976,Staff,7,0,35,28
1683343819450,PHIL 13,A02,186977,Staff,16,0,35,19
1683343820477,PHIL 14,A01,186979,Staff,31,0,35,4
1683343820477,PHIL 14,A02,186986,Staff,32,0,35,3
1683343821504,PHIL 28,A01,186988,Staff,16,0,30,14
1683343821504,PHIL 28,A02,186989,Staff,1,0,30,29
1683343821504,PHIL 28,A03,186990,Staff,9,0,30,21
1683343821504,PHIL 28,A04,186991,Staff,26,0,30,4
1683343822530,PHIL 120,A00,186997,Staff,23,0,40,17
1683343823553,PHIL 137,A00,187003,Staff,9,0,40,31
1683343824576,PHIL 150,A00,187015,Staff,47,0,70,23
1683343825602,PHIL 167,A00,187021,Lamey; Andy M.,35,0,40,5
1683343826626,PHIL 174,A01,202226,Staff,17,0,20,3
1683343826626,PHIL 174,A02,202235,Staff,20,0,20,0
1683343827651,PHIL 191A,A00,258918,Staff,0,0,1,1
1683343828683,PHYS 1A,A00,187028,Staff,27,0,60,33
1683343829711,PHYS 1AL,001,187036,Staff,2,0,30,28
1683343829711,PHYS 1AL,002,187049,Staff,18,0,30,12
1683343830738,PHYS 1B,A00,187058,Staff,22,0,60,38
1683343831766,PHYS 1BL,001,187064,Staff,0,0,30,30
1683343831766,PHYS 1BL,002,187070,Staff,5,0,30,25
1683343832848,PHYS 1C,A00,187082,Staff,31,0,120,89
1683343833876,PHYS 1CL,001,187088,Staff,0,9,30,30
1683343833876,PHYS 1CL,002,187089,Staff,0,2,30,30
1683343833876,PHYS 1CL,009,262693,Staff,11,0,30,19
1683343834903,PHYS 2B,A01,187097,Staff,54,0,115,61
1683343835927,PHYS 2C,A01,187099,Staff,67,0,115,48
1683343836952,PHYS 2CL,A01,187101,Staff,5,0,28,23
1683343836952,PHYS 2CL,A02,187102,Staff,15,0,28,13
1683343837976,PHYS 2D,A01,187123,Shotwell; Brian,95,0,115,20
1683343839000,PHYS 4B,A01,187133,Grinstein; Benjamin,35,0,50,15
1683343840024,POLI 10,A00,188819,Staff,0,4,50,50
1683343841048,POLI 11,A00,188827,Staff,43,0,50,7
1683343842074,POLI 13R,A00,188828,Staff,0,1,20,20
1683343843102,POLI 27,A01,188830,Elgin; Samuel Zincke,0,1,70,70
1683343844126,POLI 30,A00,188832,Desposato; Scott,31,0,50,19
1683343845151,POLI 102F,A00,188834,Staff,3,0,40,37
1683343846175,POLI 104A,A00,188852,Staff,14,0,30,16
1683343847199,POLI 104I,A00,188853,Staff,0,6,20,20
1683343848227,POLI 110B,A00,188854,Wiens; David,7,0,20,13
1683343849249,POLI 112A,A00,188855,Wiens; David,5,0,30,25
1683343850273,POLI 117R,A00,188856,Forman; Fonna,0,11,20,20
1683343851300,POLI 118,A00,188857,Ingham; Sean,8,0,20,12
1683343852324,POLI 120G,A00,188858,Staff,9,0,30,21
1683343853348,POLI 131CR,A00,188863,Hoston; Germaine,24,0,50,26
1683343854383,POLI 133,A00,188864,Nellis; Gareth Hb,44,0,50,6
1683343855407,POLI 134D,A00,188865,Desposato; Scott,27,0,30,3
1683343856431,POLI 142A,A00,188871,Gartzke; Erik,22,0,50,28
1683343857459,POLI 142K,A00,188874,Staff,38,0,50,12
1683343858486,POLI 143,A00,188940,Gartzke; Erik,16,0,30,14
1683343859509,POLI 153,A00,188943,Staff,3,0,20,17
1683343860532,POLI 160AA,A00,188944,Staff,12,0,40,28
1683343861557,POLI 170A,A00,188945,Staff,11,0,30,19
1683343863609,PSYC 1,A00,188952,Staff,37,0,90,53
1683343864633,PSYC 2,B00,188953,Staff,19,0,35,16
1683343865657,PSYC 6,A00,188970,Staff,47,0,60,13
1683343866680,PSYC 7,A00,188973,Staff,37,0,45,8
1683343867705,PSYC 60,A01,188980,Rickard; Timothy C.,43,0,60,17
1683343868733,PSYC 70,A01,189001,Steiner; Eric Tomas,23,0,45,22
1683343869760,PSYC 100,A00,189005,Lacefield; Katharine I,0,98,120,120
1683343870783,PSYC 102,A00,189008,Staff,9,0,30,21
1683343871807,PSYC 106,B00,189026,Gorman; Michael R.,34,0,60,26
1683343872831,PSYC 114,B01,189033,Winkielman; Piotr,0,32,30,30
1683343873856,PSYC 131,A00,189036,Anagnostaras; Stephan,0,43,60,60
1683343874880,PSYC 136,A00,189041,Lowe; Angela Beth,0,7,25,25
1683343875904,PSYC 137,A00,189057,Winkielman; Piotr,0,34,25,25
1683343876929,PSYC 144,A00,189107,Wixted; John T,0,7,50,50
1683343878980,PSYC 162,A00,189142,Staff,0,8,85,85
1683343880004,PSYC 172,A00,189144,Gorman; Michael R.,0,7,30,30
1683343882054,PSYC 179,A00,189146,Lacefield; Katharine I,0,84,120,120
1683343883079,PSYC 181,A00,189147,Anagnostaras; Stephan,0,44,90,90
1683343884107,PSYC 190R,A00,189148,Barner; David A.,0,22,80,80
1683343885137,PSYC 191,A00,189275,Rickard; Timothy C.,0,7,25,25
1683343886161,PSYC 193,A00,189276,Chapman; Eddie Nathaniel,0,1,0,4
1683343887186,PSYC 193L,A01,189281,Lowe; Angela Beth,12,0,20,8
1683343887186,PSYC 193L,B01,189285,Staff,28,0,35,7
1683343888213,RELI 149,A00,187137,Rahimi; Babak,7,0,40,33
1683343889238,SE 9,A01,187315,Staff,0,2,18,18
1683343890262,SE 101B,A00,187409,Staff,24,0,30,6
1683343891287,SE 110B,A00,187444,Staff,10,0,40,30
1683343892310,SE 130B,A00,187449,Staff,31,0,40,9
1683343893335,SE 150A,A00,187516,Staff,9,0,20,11
1683343894358,SE 154,A00,187528,Staff,30,0,50,20
1683343895383,SIO 3,A01,258171,Staff,35,0,40,5
1683343896410,SIO 10,A00,187144,Cook; Geoffrey W,0,3,75,75
1683343897438,SIO 45,A00,187152,Cook; Geoffrey W,1,0,100,99
1683343898462,SIO 109R,A00,194486,Staff,0,3,20,20
1683343900515,SIO 187,A01,187233,Kacev; David,12,0,40,28
1683343901542,SOCI 1,A01,258656,Thorpe; Charles Robert,28,0,30,2
1683343901542,SOCI 1,A02,258658,Thorpe; Charles Robert,30,0,30,0
1683343901542,SOCI 1,A03,258661,Thorpe; Charles Robert,25,0,25,0
1683343901542,SOCI 1,A04,258666,Thorpe; Charles Robert,22,0,25,3
1683343901542,SOCI 1,A05,258897,Thorpe; Charles Robert,23,0,25,2
1683343901542,SOCI 1,A06,258898,Thorpe; Charles Robert,25,0,25,0
1683343902571,SOCI 30,A01,258903,Pardo Guerra; Juan Pablo,15,0,30,15
1683343903602,SOCI 102,A00,258904,Staff,9,0,25,16
1683343904627,SOCI 106,A00,258905,Staff,19,0,25,6
1683343905651,SOCI 111,A00,258907,Ribas Norris; Janet Vanesa,26,0,30,4
1683343906681,SOCI 121R,A00,258908,Pardo Guerra; Juan Pablo,10,0,30,20
1683343907709,SOCI 126,A01,203330,Staff,14,0,20,6
1683343908737,SOCI 131,A00,258909,Thorpe; Charles Robert,31,0,60,29
1683343909762,SOCI 135,A00,258910,Payne; Christine Anna,0,9,30,30
1683343910790,SOCI 157,A00,258911,Staff,12,0,30,18
1683343911817,SOCI 184,A00,258912,Staff,25,0,30,5
1683343912844,SOCI 188D,A00,258913,Staff,21,0,30,9
1683343913868,SYN 2,001,187529,Staff,10,0,16,6
1683343913868,SYN 2,002,201452,Staff,0,18,16,16
1683343913868,SYN 2,003,201469,Staff,3,0,16,13
1683343914893,SYN 100,A01,187531,Staff,0,9,20,20
1683343914893,SYN 100,B01,201491,Staff,0,12,20,20
1683343915921,TDAC 1,A00,189286,Walsh; Kim C.,3,0,20,17
1683343915921,TDAC 1,B00,189287,Harting; Carla Kelso,11,0,20,9
1683343916946,TDAC 101,A00,189300,Walsh; Kim C.,16,0,20,4
1683343916946,TDAC 101,B00,189301,Harting; Carla Kelso,18,0,20,2
1683343917974,TDAC 102,A00,189304,Basso; Beatrice,14,0,20,6
1683343919002,TDAC 108,A00,189305,Staff,18,0,20,2
1683343920034,TDDE 131,A00,189310,Staff,19,0,20,1
1683343920034,TDDE 131,B00,189314,Staff,19,0,20,1
1683343920034,TDDE 131,C00,189315,Staff,48,0,50,2
1683343920034,TDDE 131,D00,189316,Staff,14,0,15,1
1683343920034,TDDE 131,E00,204841,Staff,20,0,20,0
1683343921059,TDGE 10,A00,189289,Staff,30,0,50,20
1683343921059,TDGE 10,B00,189290,Havis; Allan,1,0,50,49
1683343922091,TDGE 11,A00,189291,Fulton; Julia,0,3,50,50
1683343922091,TDGE 11,B00,189292,Staff,20,0,25,5
1683343922091,TDGE 11,C00,260270,Staff,0,0,0,0
1683343923117,TDGE 25,A00,189294,Staff,3,0,20,17
1683343924139,TDGE 124,A00,189318,Fulton; Julia,0,8,50,50
1683343925162,TDGE 125,A00,189319,Staff,13,0,25,12
1683343925162,TDGE 125,B00,189320,Staff,23,0,25,2
1683343926188,TDGE 127,A00,189322,Havis; Allan,0,0,50,50
1683343927211,TDHT 101,A00,189323,Staff,18,0,25,7
1683343927211,TDHT 101,B00,189324,Staff,25,0,25,0
1683343928241,TDHT 102,A00,189325,Staff,49,0,50,1
1683343929269,TDMV 1,A00,189295,Arcidiacono; Kristin,19,0,30,11
1683343929269,TDMV 1,B00,189296,Caligagan; Maria T.,24,0,30,6
1683343930293,TDMV 2,A00,189297,Sammartano; Tonnie,28,0,30,2
1683343930293,TDMV 2,B00,189299,Arcidiacono; Kristin,24,0,30,6
1683343931318,TDMV 3,A00,204998,Rincon; Alicia,22,0,30,8
1683343932343,TDMV 120,A00,189458,Sammartano; Tonnie,28,0,30,2
1683343933371,TDMV 138,A00,189541,Jun; Grace Shin Hae,22,0,40,18
1683343934400,TDMV 142,A00,189717,Caligagan; Tony,23,0,30,7
1683343934400,TDMV 142,B00,189718,Caligagan; Maria T.,25,0,30,5
1683343935427,TMC 2,A01,187533,Staff,25,0,25,0
1683343935427,TMC 2,A02,187534,Staff,25,0,25,0
1683343936524,USP 1,A01,187536,Kwak; Nancy,0,16,25,25
1683343937548,USP 5,A01,187538,Staff,10,0,25,15
1683343938573,USP 101,A00,199253,Staff,0,4,0,0
1683343939597,USP 124,A00,187562,Boomhower; Matthew Charles,1,0,30,29
1683343940624,USP 138,A00,187582,Staff,20,0,25,5
1683343941652,USP 152,A01,187597,Staff,4,0,25,21
1683343942676,USP 153,A00,187598,Staff,19,0,25,6
1683343943704,USP 168,A00,187607,Kwak; Nancy,2,0,5,3
1683343944728,USP 173,A00,187619,Staff,4,0,25,21
1683343945753,USP 181,A00,187638,Staff,0,0,25,25
1683343946778,VIS 103,A00,187650,Cruz; Edwin Teddy,23,0,75,52
1683343947805,VIS 110D,A00,187669,Staff,12,0,22,10
1683343948834,VIS 127C,A00,187720,Shen; Kuiyi,67,0,146,79
1683343949861,VIS 149,A00,187731,Yoldas; Pinar,0,14,22,22
1683343950886,VIS 151,A01,188091,Staff,22,0,34,12
1683343950886,VIS 151,A02,188092,Staff,11,0,34,23
1683343951914,VIS 160B,A00,188093,Stalbaum; Brett,0,0,10,10
1683343953967,WCWP 10B,A00,201720,Staff,10,0,15,5
1683343953967,WCWP 10B,B00,201722,Staff,9,0,15,6
1683343954990,WCWP 100,A00,201725,Gagnon; Jeffrey C,0,0,2,2
1683343954990,WCWP 100,B00,201727,Staff,0,4,15,15
1683343958119,ANBI 133,A00,258401,Wilder; Linnea Lorene,34,0,40,6
1683343959143,ANBI 140,A00,258395,Hrvoj Mihic; Branka,18,0,25,7
1683343960166,ANSC 120,A00,258402,Bialecki; Jon Anthony,27,0,40,13
1683343961193,ANSC 144,A00,258400,Staff,14,0,40,26
1683343963240,ANSC 166,A00,258396,Parish; Steven Martin,157,0,175,18
1683343964264,ANSC 180,A00,193533,Staff,9,0,20,11
1683343965291,ANSC 188,A00,258397,Jassal; Aftab,33,0,40,7
1683343966317,ANTH 3,A01,258316,Staff,23,0,30,7
1683343967343,ANTH 5,A00,258394,Semendeferi; Ekaterini,16,0,20,4
1683343968364,ANTH 21,A01,258331,Staff,8,0,40,32
1683343969391,ANTH 103,A00,258398,Varma; Saiba,15,0,25,10
1683343970419,AWP 10,001,202034,Staff,0,0,0,0
1683343970419,AWP 10,002,202035,Staff,0,0,0,0
1683343970419,AWP 10,003,202036,Staff,0,0,0,0
1683343970419,AWP 10,004,202037,Staff,0,0,0,0
1683343970419,AWP 10,005,202038,Staff,0,0,0,0
1683343970419,AWP 10,006,202039,Staff,0,0,0,0
1683343970419,AWP 10,007,202040,Staff,0,0,0,0
1683343970419,AWP 10,008,202041,Staff,0,0,0,0
1683343970419,AWP 10,009,202042,Staff,0,0,0,0
1683343970419,AWP 10,010,202043,Staff,0,0,0,0
1683343970419,AWP 10,011,202044,Staff,0,0,0,0
1683343970419,AWP 10,012,202045,Staff,0,0,0,0
1683343970419,AWP 10,013,202046,Staff,0,0,0,0
1683343970419,AWP 10,014,202047,Staff,0,0,0,0
1683343970419,AWP 10,015,202048,Staff,0,0,0,0
1683343970419,AWP 10,016,202049,Staff,0,0,0,0
1683343970419,AWP 10,017,202050,Staff,0,0,0,0
1683343970419,AWP 10,018,202051,Staff,0,0,0,0
1683343970419,AWP 10,019,202052,Staff,0,0,0,0
1683343970419,AWP 10,020,202053,Staff,0,0,0,0
1683343970419,AWP 10,021,202054,Staff,0,0,0,0
1683343970419,AWP 10,022,202055,Staff,0,0,0,0
1683343970419,AWP 10,023,202056,Staff,0,0,0,0
1683343970419,AWP 10,024,202057,Staff,0,0,0,0
1683343970419,AWP 10,025,202058,Staff,0,0,0,0
1683343970419,AWP 10,026,202059,Staff,0,0,0,0
1683343971446,AWP 102,001,202032,Staff,0,0,0,0
1683343971446,AWP 102,002,202033,Staff,0,0,0,0
1683343972471,BENG 100,A01,254234,Taylor Amos; Alyssa C,31,0,40,9
1683343973498,BENG 196,001,270013,Engler; Adam J.,9999,0,9999,0
1683343974528,BICD 100R,A01,202018,Smith; Laurie,0,7,32,32
1683343974528,BICD 100R,A02,202019,Smith; Laurie,0,2,32,32
1683343974528,BICD 100R,A03,202020,Smith; Laurie,0,1,32,32
1683343974528,BICD 100R,A04,202021,Smith; Laurie,9,0,32,23
1683343974528,BICD 100R,A05,202022,Smith; Laurie,12,0,32,20
1683343975552,BICD 136,A01,193242,Gustafson-Brown; Cindy,0,2,32,32
1683343975552,BICD 136,A02,193244,Gustafson-Brown; Cindy,14,0,32,18
1683343976577,BIEB 102,A01,193249,Butler; Shannon Rhey,0,2,32,32
1683343976577,BIEB 102,A02,193251,Butler; Shannon Rhey,0,0,32,32
1683343976577,BIEB 102,A03,193253,Butler; Shannon Rhey,0,1,32,32
1683343976577,BIEB 102,A04,193255,Butler; Shannon Rhey,17,0,32,15
1683343976577,BIEB 102,A05,193265,Butler; Shannon Rhey,26,0,32,6
1683343976577,BIEB 102,A06,193269,Butler; Shannon Rhey,16,0,32,16
1683343978626,BIEB 150,A01,193274,Staff,0,0,32,32
1683343978626,BIEB 150,A02,193285,Staff,23,0,32,9
1683343979651,BIEB 194,A00,193286,Kurle; Carolyn M.,22,0,32,10
1683343980675,BILD 1,A01,192291,Staff,16,0,32,16
1683343980675,BILD 1,A02,192292,Staff,30,0,32,2
1683343980675,BILD 1,B01,192520,Reuther; Keefe,0,1,0,0
1683343980675,BILD 1,B02,192532,Reuther; Keefe,0,1,0,0
1683343981706,BILD 3,A01,192556,Butler; Shannon Rhey,0,0,32,32
1683343981706,BILD 3,A02,192581,Butler; Shannon Rhey,5,0,32,27
1683343981706,BILD 3,A03,192611,Butler; Shannon Rhey,23,0,32,9
1683343981706,BILD 3,A04,192612,Butler; Shannon Rhey,25,0,32,7
1683343981706,BILD 3,A05,192613,Butler; Shannon Rhey,27,0,32,5
1683343981706,BILD 3,A06,192679,Butler; Shannon Rhey,27,0,32,5
1683343981706,BILD 3,A07,192682,Butler; Shannon Rhey,22,0,32,10
1683343982736,BILD 4,A01,192836,Reuther; Keefe,0,0,24,24
1683343982736,BILD 4,A02,193044,Reuther; Keefe,4,0,24,20
1683343983761,BILD 10,A01,193142,Gustafson-Brown; Cindy,30,0,32,2
1683343983761,BILD 10,A02,193149,Gustafson-Brown; Cindy,31,0,32,1
1683343984789,BIMM 100,A01,193301,Staff,0,6,32,32
1683343984789,BIMM 100,A02,193312,Staff,0,5,32,32
1683343984789,BIMM 100,A03,193323,Staff,0,8,32,32
1683343985814,BIMM 101,A01,193329,McDonnell; Lisa Marie,0,3,24,24
1683343985814,BIMM 101,A02,193339,McDonnell; Lisa Marie,0,3,24,24
1683343985814,BIMM 101,B01,193354,McDonnell; Lisa Marie,0,3,24,24
1683343985814,BIMM 101,B02,193357,McDonnell; Lisa Marie,0,3,24,24
1683343986838,BIMM 110,A01,193377,Tat; John,0,11,32,32
1683343986838,BIMM 110,A02,193378,Tat; John,1,9,32,31
1683343987868,BIMM 120,A01,206116,Staff,0,0,32,32
1683343987868,BIMM 120,A02,206117,Staff,8,0,32,24
1683343987868,BIMM 120,A03,206121,Staff,21,0,32,11
1683343988895,BIPN 100,A01,193393,Park; Ji Young,0,14,32,32
1683343988895,BIPN 100,A02,193402,Park; Ji Young,0,13,32,32
1683343988895,BIPN 100,A03,193413,Park; Ji Young,0,14,32,32
1683343988895,BIPN 100,A04,193414,Park; Ji Young,0,13,32,32
1683343989919,BIPN 102,A01,193429,Staff,0,0,32,32
1683343989919,BIPN 102,A02,193438,Staff,22,0,32,10
1683343990946,BIPN 106,A01,193450,Reyes Gonzalez; Catalina,0,2,40,40
1683343991975,BIPN 134,A01,193465,Cooke; James Edward,0,0,32,32
1683343991975,BIPN 134,A02,193474,Cooke; James Edward,25,0,32,7
1683343991975,BIPN 134,A03,193485,Cooke; James Edward,29,0,32,3
1683343991975,BIPN 134,A04,193486,Cooke; James Edward,21,0,32,11
1683343991975,BIPN 134,A05,193491,Cooke; James Edward,31,0,32,1
1683343991975,BIPN 134,A06,193501,Cooke; James Edward,30,0,32,2
1683343991975,BIPN 134,A07,193510,Cooke; James Edward,29,0,32,3
1683343994029,BISP 194,A00,222522,Staff,14,0,32,18
1683343995057,CAT 124,A01,202407,Staff,20,0,25,5
1683343996084,CAT 125,A00,202408,Marchisotto; Jennifer Anne,4,0,20,16
1683343997110,CAT 125R,A00,202409,Smith; Lauryn Alissa,0,11,20,20
1683343997110,CAT 125R,B00,202410,Morales; Celeste Georgianna,0,11,20,20
1683343997110,CAT 125R,C00,202411,Irwin; Matthew Joseph,0,10,20,20
1683343998135,CENG 15,A01,204712,Yang; Kesong,0,1,0,0
1683343999159,CENG 114,A00,202070,Jahed Motlagh; Zeinab,5,0,20,15
1683344000184,CGS 105,A00,185477,Wesling; Megan E.,24,0,40,16
1683344001209,CGS 106,A00,185494,Staff,13,0,22,9
1683344002235,CGS 108,A00,185495,Staff,14,0,20,6
1683344003262,CGS 114,A00,185496,Staff,13,0,18,5
1683344004289,CGS 119,A00,185501,Staff,15,0,20,5
1683344005314,CGS 120,A00,185511,Staff,13,0,20,7
1683344006338,CHEM 4,A01,184675,Bussey; Thomas J,96,0,100,4
1683344007366,CHEM 6A,A01,184677,Staff,34,0,60,26
1683344008392,CHEM 6B,A01,184679,Staff,65,0,100,35
1683344009415,CHEM 6C,A01,184681,Bussey; Thomas J,1,0,50,49
1683344009415,CHEM 6C,A02,184682,Bussey; Thomas J,34,0,50,16
1683344010440,CHEM 40A,A01,184684,Albizati; Kim F.,37,0,100,63
1683344011463,CHEM 40B,A01,184686,Albizati; Kim F.,0,20,100,100
1683344012492,CHEM 41B,A01,184690,Staff,52,0,100,48
1683344013515,COGS 3,A01,184715,Boyle; Mary E. T.,0,25,40,40
1683344014544,COGS 14B,A01,185172,Staff,0,15,38,38
1683344015572,COGS 18,A01,184736,Staff,17,0,80,63
1683344016597,COGS 100,A01,184932,Staff,0,5,73,73
1683344017625,COGS 101A,A01,184935,Staff,0,39,30,30
1683344018652,COGS 101B,A01,184944,Staff,0,2,30,30
1683344019679,COGS 101C,A01,184946,Staff,0,12,30,30
1683344020704,COGS 102A,A01,184951,Johnson; Christine M.,2,0,40,38
1683344021729,COGS 107B,A01,184953,Mooshagian; Eric Frederick,0,50,40,40
1683344022754,COGS 118B,A01,184959,Gupta; Anjum,0,48,40,40
1683344023779,COGS 153,A00,184961,Staff,0,15,30,30
1683344024807,COGS 177,A00,184962,Staff,0,20,30,30
1683344025834,COGS 187A,A01,184969,Boyle; Mary E. T.,0,17,40,40
1683344026865,COMM 10,A01,185174,Staff,0,5,25,25
1683344026865,COMM 10,A02,185189,Staff,0,5,25,25
1683344026865,COMM 10,A03,269821,Staff,0,0,0,0
1683344027890,COMM 100B,A01,185475,Staff,0,0,0,2
1683344027890,COMM 100B,A02,185476,Staff,13,0,25,12
1683344028916,COMM 100C,A01,185314,Staff,1,0,25,24
1683344028916,COMM 100C,A02,185327,Staff,19,0,25,6
1683344029940,COMM 110M,A00,185349,Staff,2,0,40,38
1683344030964,COMM 113T,A00,185352,Staff,24,0,40,16
1683344031993,COMM 114I,A00,185353,Staff,33,0,40,7
1683344033020,COMM 131,A00,185354,Staff,19,0,30,11
1683344034045,CSE 8A,A50,185358,Cao; Yingjun,0,46,10,10
1683344035069,CSE 8B,A01,185362,Staff,1,47,50,49
1683344036092,CSE 11,A01,185416,Cao; Yingjun,0,92,10,10
1683344037119,CSE 20,A01,185445,Briones; Jor-el Thomas Caparas,5,0,25,20
1683344038147,CSE 21,A01,185447,Staff,10,0,50,40
1683344039170,CSE 101,A01,185451,Staff,0,13,50,50
1683344039170,CSE 101,B01,185453,Jones; Miles E,0,11,50,50
1683344041279,CSE 141,A01,185458,Eldon; John,20,0,100,80
1683344042304,CSE 141L,A01,185461,Eldon; John,12,0,100,88
1683344043333,CSE 142,A01,185463,Staff,36,0,60,24
1683344043333,CSE 142,B01,201355,Staff,0,7,60,60
1683344044358,CSE 142L,A01,185470,Staff,36,0,60,24
1683344044358,CSE 142L,B01,201417,Staff,0,6,60,60
1683344045382,CSE 190,A00,201433,Staff,32,0,49,17
1683344046407,DOC 1,A01,259136,Strom; Megan C.,7,0,15,8
1683344046407,DOC 1,A02,259137,Strom; Megan C.,14,0,15,1
1683344046407,DOC 1,A03,259138,Strom; Megan C.,14,0,15,1
1683344046407,DOC 1,A04,259139,Strom; Megan C.,14,0,15,1
1683344047431,DOC 100D,A00,259140,Pass; Natalye Joann,16,0,25,9
1683344048456,DSGN 1,A01,184749,Rill; Bryan,0,25,30,30
1683344049481,DSGN 100,A01,185168,Staff,0,2,25,25
1683344050506,ECE 5,A01,185626,Morris; Karcher William,0,10,0,0
1683344051534,ECE 101,A01,185628,Staff,17,0,70,53
1683344052559,ECE 107,A01,185635,Baghdadchi; Saharnaz,0,0,20,20
1683344052559,ECE 107,A02,185638,Baghdadchi; Saharnaz,4,0,20,16
1683344053583,ECE 148,A01,185647,Silberman; Jack,0,0,16,16
1683344054613,ECON 1,A01,185537,Crane; Meredith Helen,54,0,70,16
1683344055639,ECON 3,A01,185549,Crane; Meredith Helen,32,0,70,38
1683344056666,ECON 4,A01,203354,Anderson; John Charles,0,4,10,10
1683344057693,ECON 100A,A01,185574,Staff,0,4,40,40
1683344058718,ECON 100B,A01,185576,Staff,10,22,50,40
1683344059742,ECON 100C,A01,185589,Newhouse; Herbert S,29,0,70,41
1683344060766,ECON 105,A00,185608,Vespa; Emanuel Ignacio,19,0,35,16
1683344061791,ECON 109,A01,185610,Shishkin; Denis,10,0,35,25
1683344062819,ECON 110A,A01,185612,Staff,11,0,40,29
1683344063845,ECON 120A,A01,185615,Staff,20,0,40,20
1683344064871,ECON 120C,A01,185617,Sun; Yixiao,0,20,70,70
1683344065896,ECON 144,A00,203346,Squires; Dale E,3,0,35,32
1683344066921,ECON 171,A01,203349,Newhouse; Herbert S,0,1,35,35
1683344067950,ECON 173A,A01,185621,Toda; Alexis Akira,21,0,35,14
1683344068976,EDS 25,A01,202413,Staff,0,1,0,0
1683344068976,EDS 25,A02,202414,Staff,0,1,0,0
1683344068976,EDS 25,A03,202415,Staff,0,0,0,0
1683344068976,EDS 25,A04,202416,Staff,0,1,0,0
1683344068976,EDS 25,A05,202439,Staff,0,0,0,0
1683344068976,EDS 25,A06,202440,Staff,0,0,0,0
1683344068976,EDS 25,B01,202631,Staff,0,0,0,0
1683344068976,EDS 25,B02,202632,Staff,0,0,0,0
1683344068976,EDS 25,B03,202639,Staff,0,0,0,0
1683344068976,EDS 25,B04,202640,Staff,0,0,0,0
1683344068976,EDS 25,B05,202643,Staff,0,0,0,0
1683344068976,EDS 25,B06,202644,Staff,0,0,0,0
1683344070003,EDS 38,A01,202659,Black; Alison Michelle,24,0,25,1
1683344071031,EDS 115,A00,202652,Staff,18,0,30,12
1683344072057,EDS 125,A00,202649,Staff,14,0,30,16
1683344073083,EDS 126,A01,203332,Staff,30,0,30,0
1683344074107,EDS 139,A00,202838,Staff,16,0,25,9
1683344075132,EDS 146,A01,202655,Staff,14,0,25,11
1683344076156,ENG 15,A00,185667,Staff,0,1,0,0
1683344076156,ENG 15,B00,185672,Staff,0,0,0,0
1683344076156,ENG 15,C00,185675,Staff,0,0,0,0
1683344076156,ENG 15,D00,185682,Staff,0,0,0,0
1683344076156,ENG 15,E00,185684,Staff,0,0,0,0
1683344077180,ETHN 103,A00,185710,Staff,0,4,35,35
1683344078205,ETHN 103A,A00,199228,Man; Simeon S,2,0,9,7
1683344079232,ETHN 109,A00,185711,Staff,18,0,35,17
1683344080258,ETHN 142,A00,185726,Staff,0,4,30,30
1683344081283,ETHN 163J,A00,199229,Man; Simeon S,5,0,8,3
1683344082308,ETHN 168,A00,185727,Staff,8,0,10,2
1683344083331,ETHN 182,A00,185728,Staff,1,0,35,34
1683344084355,ETHN 183,A00,185737,Staff,8,0,18,10
1683344085381,GLBH 111,A01,209361,Burgos; Jose L.,0,0,0,0
1683344087434,HIEU 104,A00,185792,Staff,16,0,20,4
1683344088461,HIEU 115,A00,185800,Staff,1,0,20,19
1683344089486,HIEU 128,A00,185801,Staff,0,7,20,20
1683344090511,HIEU 147,A00,185802,Staff,16,0,20,4
1683344091534,HIEU 154,A00,185823,Staff,12,0,20,8
1683344092560,HILA 102,A00,185826,Staff,13,0,20,7
1683344093588,HILD 2C,A01,185778,Staff,0,12,20,20
1683344094611,HILD 7B,A01,185780,Kwak; Nancy,0,15,32,32
1683344094611,HILD 7B,A02,185781,Kwak; Nancy,0,18,32,32
1683344095636,HILD 30,A01,185791,Staff,14,0,20,6
1683344096660,HISC 119,A00,185830,Golan; Tal,0,9,20,20
1683344097684,HITO 156GS,A00,185831,Patterson; Patrick H.,0,0,0,23
1683344098709,HIUS 103,A00,185832,Man; Simeon S,0,6,20,20
1683344099733,HIUS 117,A00,185836,Kwak; Nancy,2,0,20,18
1683344100757,HIUS 125,A00,185840,Man; Simeon S,0,0,23,23
1683344101781,HIUS 149,A00,185845,Staff,0,0,20,20
1683344102806,HUM 3,A01,185882,Zavodny; Tatiana Sophia,0,7,50,50
1683344102806,HUM 3,B01,185899,Caldwell; Michael Alan,0,18,50,50
1683344103829,HUM 3GS,A00,185900,Patterson; Patrick H.,0,0,0,23
1683344104852,HUM 4,A01,185938,Zroka; Amy Liane,31,0,50,19
1683344104852,HUM 4,B01,185956,Watkins; Eric,0,2,50,50
1683344104852,HUM 4,B02,202209,Watkins; Eric,0,2,50,50
1683344104852,HUM 4,B03,202210,Watkins; Eric,0,2,50,50
1683344105880,HUM 5,A01,185958,West; Geoffrey Scott,3,0,50,47
1683344105880,HUM 5,A02,202215,West; Geoffrey Scott,0,0,50,50
1683344106903,INTL 190,A00,185959,Gagnon; Jeffrey C,0,0,0,9
1683344106903,INTL 190,B00,185960,Lettieri; Michael Joseph,0,0,0,1
1683344107927,JAPN 180,A00,254509,Staff,5,1,30,25
1683344108955,LATI 10,A01,202853,Kennemore; Amy Michelle,4,0,35,31
1683344108955,LATI 10,A02,202854,Kennemore; Amy Michelle,2,0,35,33
1683344108955,LATI 10,A03,270054,Kennemore; Amy Michelle,30,0,30,0
1683344109981,LATI 180,A00,202855,Kennemore; Amy Michelle,11,0,20,9
1683344111007,LAWS 101,A00,201767,Golan; Tal,0,7,40,40
1683344112033,LIFR 1C,A00,185961,Staff,6,0,20,14
1683344113058,LIFR 1CX,A00,185962,Staff,7,0,20,13
1683344114083,LIFR 1D,A00,185963,Staff,9,0,20,11
1683344115106,LIFR 1DX,A00,185964,Staff,9,0,20,11
1683344116130,LIGN 101,A01,186039,Staff,43,0,50,7
1683344117155,LIGN 165,A00,186040,Staff,18,0,50,32
1683344118178,LTCS 108,A00,186041,Staff,6,0,10,4
1683344119201,LTCS 119,A00,186042,Staff,16,0,20,4
1683344120227,LTCS 130,A00,186043,Wesling; Megan E.,15,0,25,10
1683344122278,LTEA 138,A00,186119,Staff,14,0,40,26
1683344123309,LTEN 124,A00,186148,Staff,6,0,25,19
1683344124334,LTEN 178,A00,186149,Staff,7,0,15,8
1683344125362,LTEN 181,A00,186150,Blanco; John D,33,0,40,7
1683344126387,LTWL 120,A00,186160,Staff,20,0,25,5
1683344127410,LTWL 165,A00,186161,Staff,22,0,25,3
1683344128432,LTWR 100,A00,186162,Staff,0,5,15,15
1683344129456,LTWR 102,A00,186163,Doller; Ben,5,0,15,10
1683344130480,MAE 8,A01,186412,Staff,0,0,0,0
1683344131504,MAE 30B,A00,186445,Bahadori; Mohammad Yousef,83,0,100,17
1683344132532,MAE 40,A00,186592,Bewley; Thomas R,9,0,50,41
1683344133558,MAE 101B,A00,186593,Bahadori; Mohammad Yousef,81,0,100,19
1683344134583,MAE 105,A00,186594,Bandaru; Prabhakar,12,0,50,38
1683344135607,MAE 107,A00,186599,Pham; Hieu Tan,0,6,120,120
1683344136631,MAE 148,A01,186660,Silberman; Jack,3,0,16,13
1683344137657,MATH 10A,A01,188095,Staff,1,6,35,34
1683344138683,MATH 10B,A01,188097,Bowers; Adam R.,0,11,30,30
1683344138683,MATH 10B,A02,188099,Bowers; Adam R.,0,11,30,30
1683344138683,MATH 10B,B01,188104,Bowers; Adam R.,0,10,30,30
1683344138683,MATH 10B,B02,188106,Bowers; Adam R.,0,10,30,30
1683344139707,MATH 10C,A01,188111,Staff,0,18,30,30
1683344139707,MATH 10C,A02,188127,Staff,0,17,30,30
1683344139707,MATH 10C,A03,188131,Staff,0,18,30,30
1683344139707,MATH 10C,B01,188218,Staff,18,0,30,12
1683344139707,MATH 10C,B02,188244,Staff,13,0,30,17
1683344139707,MATH 10C,B03,188277,Staff,16,0,30,14
1683344140732,MATH 18,A01,188344,Bach; Quang Tran,18,0,30,12
1683344140732,MATH 18,A02,188345,Bach; Quang Tran,11,0,30,19
1683344140732,MATH 18,B01,188353,Bach; Quang Tran,10,0,30,20
1683344140732,MATH 18,B02,188354,Bach; Quang Tran,20,0,30,10
1683344141755,MATH 20A,A01,188374,Staff,13,0,35,22
1683344142779,MATH 20B,A01,188382,Ohm; Ko Woon,6,0,30,24
1683344142779,MATH 20B,A02,188383,Ohm; Ko Woon,22,0,30,8
1683344142779,MATH 20B,B01,188385,Ohm; Ko Woon,7,0,30,23
1683344142779,MATH 20B,B02,188392,Ohm; Ko Woon,22,0,30,8
1683344143874,MATH 20C,A01,188394,Harel; Guershon,10,0,30,20
1683344143874,MATH 20C,A02,188395,Harel; Guershon,15,0,30,15
1683344143874,MATH 20C,B01,188404,Harel; Guershon,5,0,30,25
1683344143874,MATH 20C,B02,188405,Harel; Guershon,19,0,30,11
1683344144899,MATH 20D,A01,188414,Hammock; Frances H,0,1,30,30
1683344144899,MATH 20D,A02,188415,Hammock; Frances H,3,0,30,27
1683344144899,MATH 20D,B01,188447,Hammock; Frances H,1,0,30,29
1683344144899,MATH 20D,B02,188486,Hammock; Frances H,8,0,30,22
1683344145924,MATH 20E,A01,188649,Staff,21,0,30,9
1683344145924,MATH 20E,A02,188650,Staff,23,0,30,7
1683344145924,MATH 20E,A03,188673,Staff,0,0,30,30
1683344146949,MATH 102,A01,188675,Staff,0,35,35,35
1683344147973,MATH 103B,A01,188681,Staff,3,0,35,32
1683344147973,MATH 103B,B01,188692,Staff,5,0,35,30
1683344148998,MATH 109,A01,188695,Salehi Golsefidy; Alireza,25,0,35,10
1683344148998,MATH 109,A02,188696,Salehi Golsefidy; Alireza,25,0,35,10
1683344150026,MATH 120A,A01,188698,Eggers; John Dietrich,7,0,35,28
1683344151050,MATH 142B,A01,188736,Ioana; Adrian,0,2,30,30
1683344151050,MATH 142B,A02,188741,Ioana; Adrian,1,1,30,29
1683344151050,MATH 142B,A03,188743,Ioana; Adrian,1,3,30,29
1683344152079,MATH 168A,A01,188790,Staff,0,9,35,35
1683344153105,MATH 170A,A01,188803,Nie; Jiawang,0,2,35,35
1683344153105,MATH 170A,A02,188811,Nie; Jiawang,0,0,35,35
1683344153105,MATH 170A,A03,188814,Nie; Jiawang,1,0,35,34
1683344153105,MATH 170A,A04,188815,Nie; Jiawang,13,0,35,22
1683344154133,MATH 193B,A01,188817,Staff,0,0,35,35
1683344154133,MATH 193B,A02,188818,Staff,5,0,35,30
1683344155161,MGT 4,A01,202857,Anderson; John Charles,62,0,80,18
1683344156186,MGT 12,A00,202858,Lindenberger; Wade Douglas,42,0,90,48
1683344157213,MGT 18,A00,202859,Staff,74,0,90,16
1683344158236,MGT 18GS,A00,202860,McKay; Michael J,13,0,28,15
1683344159262,MGT 45,A00,202861,Pecore; Joseph P.,14,0,90,76
1683344160287,MGT 100,A00,202863,Yavorsky; Daniel Ryan,28,0,90,62
1683344161312,MGT 103,A00,202864,Ehrich; Kristine R,1,18,90,89
1683344162336,MGT 112,A00,202865,Ehrich; Kristine R,15,0,90,75
1683344163363,MGT 121A,A00,202868,Staff,0,20,0,0
1683344164389,MGT 131B,A00,202869,Anderson; John Charles,59,0,90,31
1683344165413,MGT 136,A00,202871,Lindenberger; Wade Douglas,84,0,90,6
1683344166438,MGT 164,A00,202873,Staff,0,68,90,91
1683344167465,MGT 164GS,A00,202874,McKay; Mary A,13,0,28,15
1683344168489,MGT 180,A00,202875,Staff,0,50,90,91
1683344169518,MMW 11R,A01,205019,Herbst; Matthew,3,0,30,27
1683344169518,MMW 11R,A02,205026,Herbst; Matthew,29,0,30,1
1683344170543,MMW 15,A01,193512,Chang; Edmond Yi-Teh,0,9,28,28
1683344170543,MMW 15,A02,193513,Chang; Edmond Yi-Teh,0,5,28,28
1683344170543,MMW 15,A03,193514,Chang; Edmond Yi-Teh,0,5,28,28
1683344170543,MMW 15,A04,193515,Chang; Edmond Yi-Teh,0,5,28,28
1683344170543,MMW 15,A05,193516,Chang; Edmond Yi-Teh,0,4,28,28
1683344170543,MMW 15,A06,193517,Chang; Edmond Yi-Teh,0,5,28,28
1683344170543,MMW 15,B01,193519,Chang; Edmond Yi-Teh,0,5,28,28
1683344170543,MMW 15,B02,193520,Chang; Edmond Yi-Teh,0,5,28,28
1683344170543,MMW 15,B03,193521,Chang; Edmond Yi-Teh,0,5,28,28
1683344170543,MMW 15,B04,193522,Chang; Edmond Yi-Teh,0,4,28,28
1683344170543,MMW 15,B05,193523,Chang; Edmond Yi-Teh,0,5,28,28
1683344170543,MMW 15,B06,193524,Chang; Edmond Yi-Teh,0,4,28,28
1683344171568,MMW 122,A01,193526,Rahimi; Babak,0,15,28,28
1683344171568,MMW 122,A02,193527,Rahimi; Babak,0,14,28,28
1683344171568,MMW 122,A03,193528,Rahimi; Babak,0,0,0,0
1683344171568,MMW 122,A04,193529,Rahimi; Babak,0,0,0,0
1683344172592,MUS 1A,A01,186663,Staff,0,20,35,35
1683344173620,MUS 4,A01,186715,Staff,0,12,35,35
1683344174649,MUS 5R,A01,186796,Dubnov; Shlomo,0,17,35,35
1683344175675,MUS 6,A01,186798,Staff,0,4,25,25
1683344176701,MUS 7,A01,186830,Staff,13,0,35,22
1683344177729,MUS 8,A01,186930,Staff,0,26,35,35
1683344178753,MUS 15,A01,186932,Staff,0,16,35,35
1683344178753,MUS 15,B01,186934,Staff,0,15,35,35
1683344179778,MUS 80,A00,186935,Staff,1,0,20,19
1683344179778,MUS 80,B00,186936,Staff,25,0,25,0
1683344180803,NANO 11,A00,204702,Lipomi; Darren John,0,0,0,0
1683344181828,NANO 15,A01,204709,Yang; Kesong,0,1,0,0
1683344182853,NANO 114,A00,202069,Jahed Motlagh; Zeinab,3,0,10,7
1683344183877,PHIL 1,A00,186955,Grush; Rick Scott,32,0,40,8
1683344184902,PHIL 10,A01,186973,Grush; Rick Scott,28,0,35,7
1683344184902,PHIL 10,A02,186974,Grush; Rick Scott,33,0,35,2
1683344185927,PHIL 13,A01,186976,Staff,7,0,35,28
1683344185927,PHIL 13,A02,186977,Staff,16,0,35,19
1683344186951,PHIL 14,A01,186979,Staff,31,0,35,4
1683344186951,PHIL 14,A02,186986,Staff,32,0,35,3
1683344187976,PHIL 28,A01,186988,Staff,16,0,30,14
1683344187976,PHIL 28,A02,186989,Staff,1,0,30,29
1683344187976,PHIL 28,A03,186990,Staff,9,0,30,21
1683344187976,PHIL 28,A04,186991,Staff,26,0,30,4
1683344188998,PHIL 120,A00,186997,Staff,23,0,40,17
1683344190022,PHIL 137,A00,187003,Staff,9,0,40,31
1683344191047,PHIL 150,A00,187015,Staff,47,0,70,23
1683344192071,PHIL 167,A00,187021,Lamey; Andy M.,35,0,40,5
1683344193098,PHIL 174,A01,202226,Staff,17,0,20,3
1683344193098,PHIL 174,A02,202235,Staff,20,0,20,0
1683344194122,PHIL 191A,A00,258918,Staff,0,0,1,1
1683344195149,PHYS 1A,A00,187028,Staff,27,0,60,33
1683344196176,PHYS 1AL,001,187036,Staff,2,0,30,28
1683344196176,PHYS 1AL,002,187049,Staff,18,0,30,12
1683344197202,PHYS 1B,A00,187058,Staff,22,0,60,38
1683344198226,PHYS 1BL,001,187064,Staff,0,0,30,30
1683344198226,PHYS 1BL,002,187070,Staff,5,0,30,25
1683344199252,PHYS 1C,A00,187082,Staff,31,0,120,89
1683344200278,PHYS 1CL,001,187088,Staff,0,9,30,30
1683344200278,PHYS 1CL,002,187089,Staff,0,2,30,30
1683344200278,PHYS 1CL,009,262693,Staff,11,0,30,19
1683344201305,PHYS 2B,A01,187097,Staff,54,0,115,61
1683344202331,PHYS 2C,A01,187099,Staff,67,0,115,48
1683344203356,PHYS 2CL,A01,187101,Staff,5,0,28,23
1683344203356,PHYS 2CL,A02,187102,Staff,15,0,28,13
1683344204380,PHYS 2D,A01,187123,Shotwell; Brian,95,0,115,20
1683344205408,PHYS 4B,A01,187133,Grinstein; Benjamin,35,0,50,15
1683344206434,POLI 10,A00,188819,Staff,0,4,50,50
1683344207460,POLI 11,A00,188827,Staff,43,0,50,7
1683344208486,POLI 13R,A00,188828,Staff,0,1,20,20
1683344209511,POLI 27,A01,188830,Elgin; Samuel Zincke,0,1,70,70
1683344210536,POLI 30,A00,188832,Desposato; Scott,31,0,50,19
1683344211563,POLI 102F,A00,188834,Staff,3,0,40,37
1683344212591,POLI 104A,A00,188852,Staff,14,0,30,16
1683344213613,POLI 104I,A00,188853,Staff,0,6,20,20
1683344214637,POLI 110B,A00,188854,Wiens; David,7,0,20,13
1683344215661,POLI 112A,A00,188855,Wiens; David,5,0,30,25
1683344216685,POLI 117R,A00,188856,Forman; Fonna,0,11,20,20
1683344217709,POLI 118,A00,188857,Ingham; Sean,8,0,20,12
1683344218736,POLI 120G,A00,188858,Staff,9,0,30,21
1683344219763,POLI 131CR,A00,188863,Hoston; Germaine,24,0,50,26
1683344220788,POLI 133,A00,188864,Nellis; Gareth Hb,44,0,50,6
1683344221816,POLI 134D,A00,188865,Desposato; Scott,27,0,30,3
1683344222844,POLI 142A,A00,188871,Gartzke; Erik,22,0,50,28
1683344223868,POLI 142K,A00,188874,Staff,38,0,50,12
1683344224890,POLI 143,A00,188940,Gartzke; Erik,16,0,30,14
1683344225914,POLI 153,A00,188943,Staff,3,0,20,17
1683344226938,POLI 160AA,A00,188944,Staff,12,0,40,28
1683344227966,POLI 170A,A00,188945,Staff,11,0,30,19
1683344230014,PSYC 1,A00,188952,Staff,37,0,90,53
1683344231039,PSYC 2,B00,188953,Staff,19,0,35,16
1683344232066,PSYC 6,A00,188970,Staff,47,0,60,13
1683344233091,PSYC 7,A00,188973,Staff,37,0,45,8
1683344234117,PSYC 60,A01,188980,Rickard; Timothy C.,43,0,60,17
1683344235142,PSYC 70,A01,189001,Steiner; Eric Tomas,23,0,45,22
1683344236197,PSYC 100,A00,189005,Lacefield; Katharine I,0,98,120,120
1683344237221,PSYC 102,A00,189008,Staff,9,0,30,21
1683344238246,PSYC 106,B00,189026,Gorman; Michael R.,34,0,60,26
1683344239269,PSYC 114,B01,189033,Winkielman; Piotr,0,32,30,30
1683344240297,PSYC 131,A00,189036,Anagnostaras; Stephan,0,43,60,60
1683344241320,PSYC 136,A00,189041,Lowe; Angela Beth,0,7,25,25
1683344242345,PSYC 137,A00,189057,Winkielman; Piotr,0,34,25,25
1683344243369,PSYC 144,A00,189107,Wixted; John T,0,7,50,50
1683344245418,PSYC 162,A00,189142,Staff,0,8,85,85
1683344246442,PSYC 172,A00,189144,Gorman; Michael R.,0,7,30,30
1683344248546,PSYC 179,A00,189146,Lacefield; Katharine I,0,84,120,120
1683344249574,PSYC 181,A00,189147,Anagnostaras; Stephan,0,44,90,90
1683344250599,PSYC 190R,A00,189148,Barner; David A.,0,22,80,80
1683344251623,PSYC 191,A00,189275,Rickard; Timothy C.,0,7,25,25
1683344252648,PSYC 193,A00,189276,Chapman; Eddie Nathaniel,0,1,0,4
1683344253673,PSYC 193L,A01,189281,Lowe; Angela Beth,12,0,20,8
1683344253673,PSYC 193L,B01,189285,Staff,28,0,35,7
1683344254698,RELI 149,A00,187137,Rahimi; Babak,7,0,40,33
1683344255725,SE 9,A01,187315,Staff,0,2,18,18
1683344256750,SE 101B,A00,187409,Staff,24,0,30,6
1683344257775,SE 110B,A00,187444,Staff,10,0,40,30
1683344258803,SE 130B,A00,187449,Staff,31,0,40,9
1683344259828,SE 150A,A00,187516,Staff,9,0,20,11
1683344260851,SE 154,A00,187528,Staff,30,0,50,20
1683344261876,SIO 3,A01,258171,Staff,35,0,40,5
1683344262899,SIO 10,A00,187144,Cook; Geoffrey W,0,3,75,75
1683344263926,SIO 45,A00,187152,Cook; Geoffrey W,1,0,100,99
1683344264953,SIO 109R,A00,194486,Staff,0,3,20,20
1683344267004,SIO 187,A01,187233,Kacev; David,12,0,40,28
1683344268032,SOCI 1,A01,258656,Thorpe; Charles Robert,28,0,30,2
1683344268032,SOCI 1,A02,258658,Thorpe; Charles Robert,30,0,30,0
1683344268032,SOCI 1,A03,258661,Thorpe; Charles Robert,25,0,25,0
1683344268032,SOCI 1,A04,258666,Thorpe; Charles Robert,22,0,25,3
1683344268032,SOCI 1,A05,258897,Thorpe; Charles Robert,23,0,25,2
1683344268032,SOCI 1,A06,258898,Thorpe; Charles Robert,25,0,25,0
1683344269056,SOCI 30,A01,258903,Pardo Guerra; Juan Pablo,15,0,30,15
1683344270080,SOCI 102,A00,258904,Staff,9,0,25,16
1683344271104,SOCI 106,A00,258905,Staff,19,0,25,6
1683344272127,SOCI 111,A00,258907,Ribas Norris; Janet Vanesa,26,0,30,4
1683344273151,SOCI 121R,A00,258908,Pardo Guerra; Juan Pablo,10,0,30,20
1683344274175,SOCI 126,A01,203330,Staff,14,0,20,6
1683344275198,SOCI 131,A00,258909,Thorpe; Charles Robert,31,0,60,29
1683344276223,SOCI 135,A00,258910,Payne; Christine Anna,0,9,30,30
1683344277247,SOCI 157,A00,258911,Staff,12,0,30,18
1683344278270,SOCI 184,A00,258912,Staff,25,0,30,5
1683344279294,SOCI 188D,A00,258913,Staff,21,0,30,9
1683344280321,SYN 2,001,187529,Staff,10,0,16,6
1683344280321,SYN 2,002,201452,Staff,0,18,16,16
1683344280321,SYN 2,003,201469,Staff,3,0,16,13
1683344281348,SYN 100,A01,187531,Staff,0,9,20,20
1683344281348,SYN 100,B01,201491,Staff,0,12,20,20
1683344282374,TDAC 1,A00,189286,Walsh; Kim C.,3,0,20,17
1683344282374,TDAC 1,B00,189287,Harting; Carla Kelso,11,0,20,9
1683344283398,TDAC 101,A00,189300,Walsh; Kim C.,16,0,20,4
1683344283398,TDAC 101,B00,189301,Harting; Carla Kelso,18,0,20,2
1683344284426,TDAC 102,A00,189304,Basso; Beatrice,14,0,20,6
1683344285451,TDAC 108,A00,189305,Staff,18,0,20,2
1683344286478,TDDE 131,A00,189310,Staff,19,0,20,1
1683344286478,TDDE 131,B00,189314,Staff,19,0,20,1
1683344286478,TDDE 131,C00,189315,Staff,48,0,50,2
1683344286478,TDDE 131,D00,189316,Staff,14,0,15,1
1683344286478,TDDE 131,E00,204841,Staff,20,0,20,0
1683344287502,TDGE 10,A00,189289,Staff,30,0,50,20
1683344287502,TDGE 10,B00,189290,Havis; Allan,1,0,50,49
1683344288529,TDGE 11,A00,189291,Fulton; Julia,0,3,50,50
1683344288529,TDGE 11,B00,189292,Staff,20,0,25,5
1683344288529,TDGE 11,C00,260270,Staff,0,0,0,0
1683344289556,TDGE 25,A00,189294,Staff,3,0,20,17
1683344290580,TDGE 124,A00,189318,Fulton; Julia,0,8,50,50
1683344291605,TDGE 125,A00,189319,Staff,13,0,25,12
1683344291605,TDGE 125,B00,189320,Staff,23,0,25,2
1683344292630,TDGE 127,A00,189322,Havis; Allan,0,0,50,50
1683344293655,TDHT 101,A00,189323,Staff,18,0,25,7
1683344293655,TDHT 101,B00,189324,Staff,25,0,25,0
1683344294678,TDHT 102,A00,189325,Staff,49,0,50,1
1683344295703,TDMV 1,A00,189295,Arcidiacono; Kristin,19,0,30,11
1683344295703,TDMV 1,B00,189296,Caligagan; Maria T.,24,0,30,6
1683344296732,TDMV 2,A00,189297,Sammartano; Tonnie,28,0,30,2
1683344296732,TDMV 2,B00,189299,Arcidiacono; Kristin,24,0,30,6
1683344297760,TDMV 3,A00,204998,Rincon; Alicia,22,0,30,8
1683344298785,TDMV 120,A00,189458,Sammartano; Tonnie,28,0,30,2
1683344299813,TDMV 138,A00,189541,Jun; Grace Shin Hae,22,0,40,18
1683344300842,TDMV 142,A00,189717,Caligagan; Tony,23,0,30,7
1683344300842,TDMV 142,B00,189718,Caligagan; Maria T.,25,0,30,5
1683344301866,TMC 2,A01,187533,Staff,25,0,25,0
1683344301866,TMC 2,A02,187534,Staff,25,0,25,0
1683344302895,USP 1,A01,187536,Kwak; Nancy,0,16,25,25
1683344303924,USP 5,A01,187538,Staff,10,0,25,15
1683344304951,USP 101,A00,199253,Staff,0,4,0,0
1683344305977,USP 124,A00,187562,Boomhower; Matthew Charles,1,0,30,29
1683344307004,USP 138,A00,187582,Staff,20,0,25,5
1683344308029,USP 152,A01,187597,Staff,4,0,25,21
1683344309054,USP 153,A00,187598,Staff,19,0,25,6
1683344310080,USP 168,A00,187607,Kwak; Nancy,2,0,5,3
1683344311105,USP 173,A00,187619,Staff,4,0,25,21
1683344312132,USP 181,A00,187638,Staff,0,0,25,25
1683344313160,VIS 103,A00,187650,Cruz; Edwin Teddy,23,0,75,52
1683344314186,VIS 110D,A00,187669,Staff,12,0,22,10
1683344315209,VIS 127C,A00,187720,Shen; Kuiyi,67,0,146,79
1683344316238,VIS 149,A00,187731,Yoldas; Pinar,0,14,22,22
1683344317264,VIS 151,A01,188091,Staff,22,0,34,12
1683344317264,VIS 151,A02,188092,Staff,11,0,34,23
1683344318291,VIS 160B,A00,188093,Stalbaum; Brett,0,0,10,10
1683344320340,WCWP 10B,A00,201720,Staff,10,0,15,5
1683344320340,WCWP 10B,B00,201722,Staff,9,0,15,6
1683344321365,WCWP 100,A00,201725,Gagnon; Jeffrey C,0,0,2,2
1683344321365,WCWP 100,B00,201727,Staff,0,4,15,15
1683344324461,ANBI 133,A00,258401,Wilder; Linnea Lorene,34,0,40,6
1683344325488,ANBI 140,A00,258395,Hrvoj Mihic; Branka,18,0,25,7
1683344326512,ANSC 120,A00,258402,Bialecki; Jon Anthony,27,0,40,13
1683344327536,ANSC 144,A00,258400,Staff,14,0,40,26
1683344329587,ANSC 166,A00,258396,Parish; Steven Martin,157,0,175,18
1683344330614,ANSC 180,A00,193533,Staff,9,0,20,11
1683344331642,ANSC 188,A00,258397,Jassal; Aftab,33,0,40,7
1683344332669,ANTH 3,A01,258316,Staff,23,0,30,7
1683344333694,ANTH 5,A00,258394,Semendeferi; Ekaterini,16,0,20,4
1683344334717,ANTH 21,A01,258331,Staff,8,0,40,32
1683344335740,ANTH 103,A00,258398,Varma; Saiba,15,0,25,10
1683344336766,AWP 10,001,202034,Staff,0,0,0,0
1683344336766,AWP 10,002,202035,Staff,0,0,0,0
1683344336766,AWP 10,003,202036,Staff,0,0,0,0
1683344336766,AWP 10,004,202037,Staff,0,0,0,0
1683344336766,AWP 10,005,202038,Staff,0,0,0,0
1683344336766,AWP 10,006,202039,Staff,0,0,0,0
1683344336766,AWP 10,007,202040,Staff,0,0,0,0
1683344336766,AWP 10,008,202041,Staff,0,0,0,0
1683344336766,AWP 10,009,202042,Staff,0,0,0,0
1683344336766,AWP 10,010,202043,Staff,0,0,0,0
1683344336766,AWP 10,011,202044,Staff,0,0,0,0
1683344336766,AWP 10,012,202045,Staff,0,0,0,0
1683344336766,AWP 10,013,202046,Staff,0,0,0,0
1683344336766,AWP 10,014,202047,Staff,0,0,0,0
1683344336766,AWP 10,015,202048,Staff,0,0,0,0
1683344336766,AWP 10,016,202049,Staff,0,0,0,0
1683344336766,AWP 10,017,202050,Staff,0,0,0,0
1683344336766,AWP 10,018,202051,Staff,0,0,0,0
1683344336766,AWP 10,019,202052,Staff,0,0,0,0
1683344336766,AWP 10,020,202053,Staff,0,0,0,0
1683344336766,AWP 10,021,202054,Staff,0,0,0,0
1683344336766,AWP 10,022,202055,Staff,0,0,0,0
1683344336766,AWP 10,023,202056,Staff,0,0,0,0
1683344336766,AWP 10,024,202057,Staff,0,0,0,0
1683344336766,AWP 10,025,202058,Staff,0,0,0,0
1683344336766,AWP 10,026,202059,Staff,0,0,0,0
1683344337791,AWP 102,001,202032,Staff,0,0,0,0
1683344337791,AWP 102,002,202033,Staff,0,0,0,0
1683344338819,BENG 100,A01,254234,Taylor Amos; Alyssa C,31,0,40,9
1683344339846,BENG 196,001,270013,Engler; Adam J.,9999,0,9999,0
1683344340870,BICD 100R,A01,202018,Smith; Laurie,0,7,32,32
1683344340870,BICD 100R,A02,202019,Smith; Laurie,0,2,32,32
1683344340870,BICD 100R,A03,202020,Smith; Laurie,0,1,32,32
1683344340870,BICD 100R,A04,202021,Smith; Laurie,9,0,32,23
1683344340870,BICD 100R,A05,202022,Smith; Laurie,12,0,32,20
1683344341899,BICD 136,A01,193242,Gustafson-Brown; Cindy,0,2,32,32
1683344341899,BICD 136,A02,193244,Gustafson-Brown; Cindy,14,0,32,18
1683344342931,BIEB 102,A01,193249,Butler; Shannon Rhey,0,2,32,32
1683344342931,BIEB 102,A02,193251,Butler; Shannon Rhey,0,0,32,32
1683344342931,BIEB 102,A03,193253,Butler; Shannon Rhey,0,1,32,32
1683344342931,BIEB 102,A04,193255,Butler; Shannon Rhey,17,0,32,15
1683344342931,BIEB 102,A05,193265,Butler; Shannon Rhey,26,0,32,6
1683344342931,BIEB 102,A06,193269,Butler; Shannon Rhey,16,0,32,16
1683344344981,BIEB 150,A01,193274,Staff,0,0,32,32
1683344344981,BIEB 150,A02,193285,Staff,23,0,32,9
1683344346005,BIEB 194,A00,193286,Kurle; Carolyn M.,22,0,32,10
1683344347030,BILD 1,A01,192291,Staff,16,0,32,16
1683344347030,BILD 1,A02,192292,Staff,30,0,32,2
1683344347030,BILD 1,B01,192520,Reuther; Keefe,0,1,0,0
1683344347030,BILD 1,B02,192532,Reuther; Keefe,0,1,0,0
1683344348056,BILD 3,A01,192556,Butler; Shannon Rhey,0,0,32,32
1683344348056,BILD 3,A02,192581,Butler; Shannon Rhey,5,0,32,27
1683344348056,BILD 3,A03,192611,Butler; Shannon Rhey,23,0,32,9
1683344348056,BILD 3,A04,192612,Butler; Shannon Rhey,25,0,32,7
1683344348056,BILD 3,A05,192613,Butler; Shannon Rhey,27,0,32,5
1683344348056,BILD 3,A06,192679,Butler; Shannon Rhey,27,0,32,5
1683344348056,BILD 3,A07,192682,Butler; Shannon Rhey,22,0,32,10
1683344349082,BILD 4,A01,192836,Reuther; Keefe,0,0,24,24
1683344349082,BILD 4,A02,193044,Reuther; Keefe,4,0,24,20
1683344350107,BILD 10,A01,193142,Gustafson-Brown; Cindy,30,0,32,2
1683344350107,BILD 10,A02,193149,Gustafson-Brown; Cindy,31,0,32,1
1683344351190,BIMM 100,A01,193301,Staff,0,6,32,32
1683344351190,BIMM 100,A02,193312,Staff,0,5,32,32
1683344351190,BIMM 100,A03,193323,Staff,0,8,32,32
1683344352219,BIMM 101,A01,193329,McDonnell; Lisa Marie,0,3,24,24
1683344352219,BIMM 101,A02,193339,McDonnell; Lisa Marie,0,3,24,24
1683344352219,BIMM 101,B01,193354,McDonnell; Lisa Marie,0,3,24,24
1683344352219,BIMM 101,B02,193357,McDonnell; Lisa Marie,0,3,24,24
1683344353247,BIMM 110,A01,193377,Tat; John,0,11,32,32
1683344353247,BIMM 110,A02,193378,Tat; John,1,9,32,31
1683344354273,BIMM 120,A01,206116,Staff,0,0,32,32
1683344354273,BIMM 120,A02,206117,Staff,8,0,32,24
1683344354273,BIMM 120,A03,206121,Staff,21,0,32,11
1683344355302,BIPN 100,A01,193393,Park; Ji Young,0,14,32,32
1683344355302,BIPN 100,A02,193402,Park; Ji Young,0,13,32,32
1683344355302,BIPN 100,A03,193413,Park; Ji Young,0,14,32,32
1683344355302,BIPN 100,A04,193414,Park; Ji Young,0,13,32,32
1683344356327,BIPN 102,A01,193429,Staff,0,0,32,32
1683344356327,BIPN 102,A02,193438,Staff,22,0,32,10
1683344357351,BIPN 106,A01,193450,Reyes Gonzalez; Catalina,0,2,40,40
1683344358377,BIPN 134,A01,193465,Cooke; James Edward,0,0,32,32
1683344358377,BIPN 134,A02,193474,Cooke; James Edward,25,0,32,7
1683344358377,BIPN 134,A03,193485,Cooke; James Edward,29,0,32,3
1683344358377,BIPN 134,A04,193486,Cooke; James Edward,21,0,32,11
1683344358377,BIPN 134,A05,193491,Cooke; James Edward,31,0,32,1
1683344358377,BIPN 134,A06,193501,Cooke; James Edward,30,0,32,2
1683344358377,BIPN 134,A07,193510,Cooke; James Edward,29,0,32,3
1683344360426,BISP 194,A00,222522,Staff,14,0,32,18
1683344361450,CAT 124,A01,202407,Staff,20,0,25,5
1683344362476,CAT 125,A00,202408,Marchisotto; Jennifer Anne,4,0,20,16
1683344363501,CAT 125R,A00,202409,Smith; Lauryn Alissa,0,11,20,20
1683344363501,CAT 125R,B00,202410,Morales; Celeste Georgianna,0,11,20,20
1683344363501,CAT 125R,C00,202411,Irwin; Matthew Joseph,0,10,20,20
1683344364527,CENG 15,A01,204712,Yang; Kesong,0,1,0,0
1683344365552,CENG 114,A00,202070,Jahed Motlagh; Zeinab,5,0,20,15
1683344366578,CGS 105,A00,185477,Wesling; Megan E.,24,0,40,16
1683344367602,CGS 106,A00,185494,Staff,13,0,22,9
1683344368627,CGS 108,A00,185495,Staff,14,0,20,6
1683344369652,CGS 114,A00,185496,Staff,13,0,18,5
1683344370677,CGS 119,A00,185501,Staff,15,0,20,5
1683344371702,CGS 120,A00,185511,Staff,13,0,20,7
1683344372727,CHEM 4,A01,184675,Bussey; Thomas J,96,0,100,4
1683344373751,CHEM 6A,A01,184677,Staff,34,0,60,26
1683344374776,CHEM 6B,A01,184679,Staff,65,0,100,35
1683344375801,CHEM 6C,A01,184681,Bussey; Thomas J,1,0,50,49
1683344375801,CHEM 6C,A02,184682,Bussey; Thomas J,34,0,50,16
1683344376826,CHEM 40A,A01,184684,Albizati; Kim F.,37,0,100,63
1683344377850,CHEM 40B,A01,184686,Albizati; Kim F.,0,20,100,100
1683344378877,CHEM 41B,A01,184690,Staff,52,0,100,48
1683344379902,COGS 3,A01,184715,Boyle; Mary E. T.,0,25,40,40
1683344380926,COGS 14B,A01,185172,Staff,0,15,38,38
1683344381954,COGS 18,A01,184736,Staff,17,0,80,63
1683344382978,COGS 100,A01,184932,Staff,0,5,73,73
1683344384004,COGS 101A,A01,184935,Staff,0,39,30,30
1683344385028,COGS 101B,A01,184944,Staff,0,2,30,30
1683344386054,COGS 101C,A01,184946,Staff,0,12,30,30
1683344387080,COGS 102A,A01,184951,Johnson; Christine M.,2,0,40,38
1683344388108,COGS 107B,A01,184953,Mooshagian; Eric Frederick,0,50,40,40
1683344389131,COGS 118B,A01,184959,Gupta; Anjum,0,48,40,40
1683344390157,COGS 153,A00,184961,Staff,0,15,30,30
1683344391182,COGS 177,A00,184962,Staff,0,20,30,30
1683344392205,COGS 187A,A01,184969,Boyle; Mary E. T.,0,17,40,40
1683344393230,COMM 10,A01,185174,Staff,0,5,25,25
1683344393230,COMM 10,A02,185189,Staff,0,5,25,25
1683344393230,COMM 10,A03,269821,Staff,0,0,0,0
1683344394256,COMM 100B,A01,185475,Staff,0,0,0,2
1683344394256,COMM 100B,A02,185476,Staff,13,0,25,12
1683344395280,COMM 100C,A01,185314,Staff,1,0,25,24
1683344395280,COMM 100C,A02,185327,Staff,19,0,25,6
1683344396304,COMM 110M,A00,185349,Staff,2,0,40,38
1683344397332,COMM 113T,A00,185352,Staff,24,0,40,16
1683344398356,COMM 114I,A00,185353,Staff,33,0,40,7
1683344399380,COMM 131,A00,185354,Staff,19,0,30,11
1683344400405,CSE 8A,A50,185358,Cao; Yingjun,0,46,10,10
1683344401435,CSE 8B,A01,185362,Staff,1,47,50,49
1683344402459,CSE 11,A01,185416,Cao; Yingjun,0,92,10,10
1683344403483,CSE 20,A01,185445,Briones; Jor-el Thomas Caparas,5,0,25,20
1683344404512,CSE 21,A01,185447,Staff,10,0,50,40
1683344405537,CSE 101,A01,185451,Staff,0,13,50,50
1683344405537,CSE 101,B01,185453,Jones; Miles E,0,11,50,50
1683344407589,CSE 141,A01,185458,Eldon; John,20,0,100,80
1683344408615,CSE 141L,A01,185461,Eldon; John,12,0,100,88
1683344409639,CSE 142,A01,185463,Staff,36,0,60,24
1683344409639,CSE 142,B01,201355,Staff,0,7,60,60
1683344410668,CSE 142L,A01,185470,Staff,36,0,60,24
1683344410668,CSE 142L,B01,201417,Staff,0,6,60,60
1683344411694,CSE 190,A00,201433,Staff,32,0,49,17
1683344412719,DOC 1,A01,259136,Strom; Megan C.,7,0,15,8
1683344412719,DOC 1,A02,259137,Strom; Megan C.,14,0,15,1
1683344412719,DOC 1,A03,259138,Strom; Megan C.,14,0,15,1
1683344412719,DOC 1,A04,259139,Strom; Megan C.,14,0,15,1
1683344413746,DOC 100D,A00,259140,Pass; Natalye Joann,16,0,25,9
1683344414774,DSGN 1,A01,184749,Rill; Bryan,0,25,30,30
1683344415800,DSGN 100,A01,185168,Staff,0,2,25,25
1683344416828,ECE 5,A01,185626,Morris; Karcher William,0,10,0,0
1683344417851,ECE 101,A01,185628,Staff,17,0,70,53
1683344418875,ECE 107,A01,185635,Baghdadchi; Saharnaz,0,0,20,20
1683344418875,ECE 107,A02,185638,Baghdadchi; Saharnaz,4,0,20,16
1683344419899,ECE 148,A01,185647,Silberman; Jack,0,0,16,16
1683344420923,ECON 1,A01,185537,Crane; Meredith Helen,54,0,70,16
1683344421949,ECON 3,A01,185549,Crane; Meredith Helen,32,0,70,38
1683344422975,ECON 4,A01,203354,Anderson; John Charles,0,4,10,10
1683344424002,ECON 100A,A01,185574,Staff,0,4,40,40
1683344425028,ECON 100B,A01,185576,Staff,10,22,50,40
1683344426055,ECON 100C,A01,185589,Newhouse; Herbert S,29,0,70,41
1683344427082,ECON 105,A00,185608,Vespa; Emanuel Ignacio,19,0,35,16
1683344428107,ECON 109,A01,185610,Shishkin; Denis,10,0,35,25
1683344429134,ECON 110A,A01,185612,Staff,11,0,40,29
1683344430157,ECON 120A,A01,185615,Staff,20,0,40,20
1683344431180,ECON 120C,A01,185617,Sun; Yixiao,0,20,70,70
1683344432207,ECON 144,A00,203346,Squires; Dale E,3,0,35,32
1683344433232,ECON 171,A01,203349,Newhouse; Herbert S,0,1,35,35
1683344434256,ECON 173A,A01,185621,Toda; Alexis Akira,21,0,35,14
1683344435287,EDS 25,A01,202413,Staff,0,1,0,0
1683344435287,EDS 25,A02,202414,Staff,0,1,0,0
1683344435287,EDS 25,A03,202415,Staff,0,0,0,0
1683344435287,EDS 25,A04,202416,Staff,0,1,0,0
1683344435287,EDS 25,A05,202439,Staff,0,0,0,0
1683344435287,EDS 25,A06,202440,Staff,0,0,0,0
1683344435287,EDS 25,B01,202631,Staff,0,0,0,0
1683344435287,EDS 25,B02,202632,Staff,0,0,0,0
1683344435287,EDS 25,B03,202639,Staff,0,0,0,0
1683344435287,EDS 25,B04,202640,Staff,0,0,0,0
1683344435287,EDS 25,B05,202643,Staff,0,0,0,0
1683344435287,EDS 25,B06,202644,Staff,0,0,0,0
1683344436312,EDS 38,A01,202659,Black; Alison Michelle,24,0,25,1
1683344437338,EDS 115,A00,202652,Staff,18,0,30,12
1683344438361,EDS 125,A00,202649,Staff,14,0,30,16
1683344439384,EDS 126,A01,203332,Staff,30,0,30,0
1683344440408,EDS 139,A00,202838,Staff,16,0,25,9
1683344441436,EDS 146,A01,202655,Staff,14,0,25,11
1683344442461,ENG 15,A00,185667,Staff,0,1,0,0
1683344442461,ENG 15,B00,185672,Staff,0,0,0,0
1683344442461,ENG 15,C00,185675,Staff,0,0,0,0
1683344442461,ENG 15,D00,185682,Staff,0,0,0,0
1683344442461,ENG 15,E00,185684,Staff,0,0,0,0
1683344443483,ETHN 103,A00,185710,Staff,0,4,35,35
1683344444506,ETHN 103A,A00,199228,Man; Simeon S,2,0,9,7
1683344445532,ETHN 109,A00,185711,Staff,18,0,35,17
1683344446556,ETHN 142,A00,185726,Staff,0,4,30,30
1683344447580,ETHN 163J,A00,199229,Man; Simeon S,5,0,8,3
1683344448604,ETHN 168,A00,185727,Staff,8,0,10,2
1683344449630,ETHN 182,A00,185728,Staff,1,0,35,34
1683344450652,ETHN 183,A00,185737,Staff,8,0,18,10
1683344451675,GLBH 111,A01,209361,Burgos; Jose L.,0,0,0,0
1683344453723,HIEU 104,A00,185792,Staff,16,0,20,4
1683344454801,HIEU 115,A00,185800,Staff,1,0,20,19
1683344455824,HIEU 128,A00,185801,Staff,0,7,20,20
1683344456847,HIEU 147,A00,185802,Staff,16,0,20,4
1683344457872,HIEU 154,A00,185823,Staff,12,0,20,8
1683344458899,HILA 102,A00,185826,Staff,13,0,20,7
1683344459928,HILD 2C,A01,185778,Staff,0,12,20,20
1683344460955,HILD 7B,A01,185780,Kwak; Nancy,0,15,32,32
1683344460955,HILD 7B,A02,185781,Kwak; Nancy,0,18,32,32
1683344461979,HILD 30,A01,185791,Staff,14,0,20,6
1683344463009,HISC 119,A00,185830,Golan; Tal,0,9,20,20
1683344464035,HITO 156GS,A00,185831,Patterson; Patrick H.,0,0,0,23
1683344465061,HIUS 103,A00,185832,Man; Simeon S,0,6,20,20
1683344466085,HIUS 117,A00,185836,Kwak; Nancy,2,0,20,18
1683344467109,HIUS 125,A00,185840,Man; Simeon S,0,0,23,23
1683344468135,HIUS 149,A00,185845,Staff,0,0,20,20
1683344469163,HUM 3,A01,185882,Zavodny; Tatiana Sophia,0,7,50,50
1683344469163,HUM 3,B01,185899,Caldwell; Michael Alan,0,18,50,50
1683344470188,HUM 3GS,A00,185900,Patterson; Patrick H.,0,0,0,23
1683344471212,HUM 4,A01,185938,Zroka; Amy Liane,31,0,50,19
1683344471212,HUM 4,B01,185956,Watkins; Eric,0,2,50,50
1683344471212,HUM 4,B02,202209,Watkins; Eric,0,2,50,50
1683344471212,HUM 4,B03,202210,Watkins; Eric,0,2,50,50
1683344472236,HUM 5,A01,185958,West; Geoffrey Scott,3,0,50,47
1683344472236,HUM 5,A02,202215,West; Geoffrey Scott,0,0,50,50
1683344473258,INTL 190,A00,185959,Gagnon; Jeffrey C,0,0,0,9
1683344473258,INTL 190,B00,185960,Lettieri; Michael Joseph,0,0,0,1
1683344474281,JAPN 180,A00,254509,Staff,5,1,30,25
1683344475304,LATI 10,A01,202853,Kennemore; Amy Michelle,4,0,35,31
1683344475304,LATI 10,A02,202854,Kennemore; Amy Michelle,2,0,35,33
1683344475304,LATI 10,A03,270054,Kennemore; Amy Michelle,30,0,30,0
1683344476356,LATI 180,A00,202855,Kennemore; Amy Michelle,11,0,20,9
1683344477383,LAWS 101,A00,201767,Golan; Tal,0,7,40,40
1683344478406,LIFR 1C,A00,185961,Staff,6,0,20,14
1683344479430,LIFR 1CX,A00,185962,Staff,7,0,20,13
1683344480453,LIFR 1D,A00,185963,Staff,9,0,20,11
1683344481477,LIFR 1DX,A00,185964,Staff,9,0,20,11
1683344482500,LIGN 101,A01,186039,Staff,43,0,50,7
1683344483524,LIGN 165,A00,186040,Staff,18,0,50,32
1683344484548,LTCS 108,A00,186041,Staff,6,0,10,4
1683344485574,LTCS 119,A00,186042,Staff,16,0,20,4
1683344486601,LTCS 130,A00,186043,Wesling; Megan E.,15,0,25,10
1683344488654,LTEA 138,A00,186119,Staff,14,0,40,26
1683344489678,LTEN 124,A00,186148,Staff,6,0,25,19
1683344490703,LTEN 178,A00,186149,Staff,7,0,15,8
1683344491730,LTEN 181,A00,186150,Blanco; John D,33,0,40,7
1683344492756,LTWL 120,A00,186160,Staff,20,0,25,5
1683344493780,LTWL 165,A00,186161,Staff,22,0,25,3
1683344494807,LTWR 100,A00,186162,Staff,0,5,15,15
1683344495833,LTWR 102,A00,186163,Doller; Ben,5,0,15,10
1683344496858,MAE 8,A01,186412,Staff,0,0,0,0
1683344497885,MAE 30B,A00,186445,Bahadori; Mohammad Yousef,83,0,100,17
1683344498908,MAE 40,A00,186592,Bewley; Thomas R,9,0,50,41
1683344499935,MAE 101B,A00,186593,Bahadori; Mohammad Yousef,81,0,100,19
1683344500960,MAE 105,A00,186594,Bandaru; Prabhakar,12,0,50,38
1683344501988,MAE 107,A00,186599,Pham; Hieu Tan,0,6,120,120
1683344503012,MAE 148,A01,186660,Silberman; Jack,3,0,16,13
1683344504036,MATH 10A,A01,188095,Staff,1,6,35,34
1683344505062,MATH 10B,A01,188097,Bowers; Adam R.,0,11,30,30
1683344505062,MATH 10B,A02,188099,Bowers; Adam R.,0,11,30,30
1683344505062,MATH 10B,B01,188104,Bowers; Adam R.,0,10,30,30
1683344505062,MATH 10B,B02,188106,Bowers; Adam R.,0,10,30,30
1683344506087,MATH 10C,A01,188111,Staff,0,18,30,30
1683344506087,MATH 10C,A02,188127,Staff,0,17,30,30
1683344506087,MATH 10C,A03,188131,Staff,0,18,30,30
1683344506087,MATH 10C,B01,188218,Staff,18,0,30,12
1683344506087,MATH 10C,B02,188244,Staff,13,0,30,17
1683344506087,MATH 10C,B03,188277,Staff,16,0,30,14
1683344507118,MATH 18,A01,188344,Bach; Quang Tran,18,0,30,12
1683344507118,MATH 18,A02,188345,Bach; Quang Tran,11,0,30,19
1683344507118,MATH 18,B01,188353,Bach; Quang Tran,10,0,30,20
1683344507118,MATH 18,B02,188354,Bach; Quang Tran,20,0,30,10
1683344508146,MATH 20A,A01,188374,Staff,13,0,35,22
1683344509175,MATH 20B,A01,188382,Ohm; Ko Woon,6,0,30,24
1683344509175,MATH 20B,A02,188383,Ohm; Ko Woon,22,0,30,8
1683344509175,MATH 20B,B01,188385,Ohm; Ko Woon,7,0,30,23
1683344509175,MATH 20B,B02,188392,Ohm; Ko Woon,22,0,30,8
1683344510200,MATH 20C,A01,188394,Harel; Guershon,10,0,30,20
1683344510200,MATH 20C,A02,188395,Harel; Guershon,15,0,30,15
1683344510200,MATH 20C,B01,188404,Harel; Guershon,5,0,30,25
1683344510200,MATH 20C,B02,188405,Harel; Guershon,19,0,30,11
1683344511226,MATH 20D,A01,188414,Hammock; Frances H,0,1,30,30
1683344511226,MATH 20D,A02,188415,Hammock; Frances H,3,0,30,27
1683344511226,MATH 20D,B01,188447,Hammock; Frances H,1,0,30,29
1683344511226,MATH 20D,B02,188486,Hammock; Frances H,8,0,30,22
1683344512250,MATH 20E,A01,188649,Staff,21,0,30,9
1683344512250,MATH 20E,A02,188650,Staff,23,0,30,7
1683344512250,MATH 20E,A03,188673,Staff,0,0,30,30
1683344513278,MATH 102,A01,188675,Staff,0,35,35,35
1683344514306,MATH 103B,A01,188681,Staff,3,0,35,32
1683344514306,MATH 103B,B01,188692,Staff,5,0,35,30
1683344515333,MATH 109,A01,188695,Salehi Golsefidy; Alireza,25,0,35,10
1683344515333,MATH 109,A02,188696,Salehi Golsefidy; Alireza,25,0,35,10
1683344516360,MATH 120A,A01,188698,Eggers; John Dietrich,7,0,35,28
1683344517385,MATH 142B,A01,188736,Ioana; Adrian,0,2,30,30
1683344517385,MATH 142B,A02,188741,Ioana; Adrian,1,1,30,29
1683344517385,MATH 142B,A03,188743,Ioana; Adrian,1,3,30,29
1683344518409,MATH 168A,A01,188790,Staff,0,9,35,35
1683344519434,MATH 170A,A01,188803,Nie; Jiawang,0,2,35,35
1683344519434,MATH 170A,A02,188811,Nie; Jiawang,0,0,35,35
1683344519434,MATH 170A,A03,188814,Nie; Jiawang,1,0,35,34
1683344519434,MATH 170A,A04,188815,Nie; Jiawang,13,0,35,22
1683344520458,MATH 193B,A01,188817,Staff,0,0,35,35
1683344520458,MATH 193B,A02,188818,Staff,5,0,35,30
1683344521481,MGT 4,A01,202857,Anderson; John Charles,62,0,80,18
1683344522504,MGT 12,A00,202858,Lindenberger; Wade Douglas,42,0,90,48
1683344523531,MGT 18,A00,202859,Staff,74,0,90,16
1683344524555,MGT 18GS,A00,202860,McKay; Michael J,13,0,28,15
1683344525583,MGT 45,A00,202861,Pecore; Joseph P.,14,0,90,76
1683344526609,MGT 100,A00,202863,Yavorsky; Daniel Ryan,28,0,90,62
1683344527633,MGT 103,A00,202864,Ehrich; Kristine R,1,18,90,89
1683344528658,MGT 112,A00,202865,Ehrich; Kristine R,15,0,90,75
1683344529686,MGT 121A,A00,202868,Staff,0,20,0,0
1683344530709,MGT 131B,A00,202869,Anderson; John Charles,59,0,90,31
1683344531735,MGT 136,A00,202871,Lindenberger; Wade Douglas,84,0,90,6
1683344532760,MGT 164,A00,202873,Staff,0,68,90,91
1683344533786,MGT 164GS,A00,202874,McKay; Mary A,13,0,28,15
1683344534820,MGT 180,A00,202875,Staff,0,50,90,91
1683344535844,MMW 11R,A01,205019,Herbst; Matthew,3,0,30,27
1683344535844,MMW 11R,A02,205026,Herbst; Matthew,29,0,30,1
1683344536870,MMW 15,A01,193512,Chang; Edmond Yi-Teh,0,9,28,28
1683344536870,MMW 15,A02,193513,Chang; Edmond Yi-Teh,0,5,28,28
1683344536870,MMW 15,A03,193514,Chang; Edmond Yi-Teh,0,5,28,28
1683344536870,MMW 15,A04,193515,Chang; Edmond Yi-Teh,0,5,28,28
1683344536870,MMW 15,A05,193516,Chang; Edmond Yi-Teh,0,4,28,28
1683344536870,MMW 15,A06,193517,Chang; Edmond Yi-Teh,0,5,28,28
1683344536870,MMW 15,B01,193519,Chang; Edmond Yi-Teh,0,5,28,28
1683344536870,MMW 15,B02,193520,Chang; Edmond Yi-Teh,0,5,28,28
1683344536870,MMW 15,B03,193521,Chang; Edmond Yi-Teh,0,5,28,28
1683344536870,MMW 15,B04,193522,Chang; Edmond Yi-Teh,0,4,28,28
1683344536870,MMW 15,B05,193523,Chang; Edmond Yi-Teh,0,5,28,28
1683344536870,MMW 15,B06,193524,Chang; Edmond Yi-Teh,0,4,28,28
1683344537951,MMW 122,A01,193526,Rahimi; Babak,0,15,28,28
1683344537951,MMW 122,A02,193527,Rahimi; Babak,0,14,28,28
1683344537951,MMW 122,A03,193528,Rahimi; Babak,0,0,0,0
1683344537951,MMW 122,A04,193529,Rahimi; Babak,0,0,0,0
1683344538978,MUS 1A,A01,186663,Staff,0,20,35,35
1683344540003,MUS 4,A01,186715,Staff,0,12,35,35
1683344541033,MUS 5R,A01,186796,Dubnov; Shlomo,0,17,35,35
1683344542059,MUS 6,A01,186798,Staff,0,4,25,25
1683344543087,MUS 7,A01,186830,Staff,13,0,35,22
1683344544110,MUS 8,A01,186930,Staff,0,26,35,35
1683344545138,MUS 15,A01,186932,Staff,0,16,35,35
1683344545138,MUS 15,B01,186934,Staff,0,15,35,35
1683344546166,MUS 80,A00,186935,Staff,1,0,20,19
1683344546166,MUS 80,B00,186936,Staff,25,0,25,0
1683344547189,NANO 11,A00,204702,Lipomi; Darren John,0,0,0,0
1683344548212,NANO 15,A01,204709,Yang; Kesong,0,1,0,0
1683344549240,NANO 114,A00,202069,Jahed Motlagh; Zeinab,3,0,10,7
1683344550267,PHIL 1,A00,186955,Grush; Rick Scott,32,0,40,8
1683344551295,PHIL 10,A01,186973,Grush; Rick Scott,28,0,35,7
1683344551295,PHIL 10,A02,186974,Grush; Rick Scott,33,0,35,2
1683344552323,PHIL 13,A01,186976,Staff,7,0,35,28
1683344552323,PHIL 13,A02,186977,Staff,16,0,35,19
1683344553351,PHIL 14,A01,186979,Staff,31,0,35,4
1683344553351,PHIL 14,A02,186986,Staff,32,0,35,3
1683344554380,PHIL 28,A01,186988,Staff,16,0,30,14
1683344554380,PHIL 28,A02,186989,Staff,1,0,30,29
1683344554380,PHIL 28,A03,186990,Staff,9,0,30,21
1683344554380,PHIL 28,A04,186991,Staff,26,0,30,4
1683344555404,PHIL 120,A00,186997,Staff,23,0,40,17
1683344556429,PHIL 137,A00,187003,Staff,9,0,40,31
1683344557452,PHIL 150,A00,187015,Staff,47,0,70,23
1683344558533,PHIL 167,A00,187021,Lamey; Andy M.,35,0,40,5
1683344559560,PHIL 174,A01,202226,Staff,17,0,20,3
1683344559560,PHIL 174,A02,202235,Staff,20,0,20,0
1683344560584,PHIL 191A,A00,258918,Staff,0,0,1,1
1683344561612,PHYS 1A,A00,187028,Staff,27,0,60,33
1683344562635,PHYS 1AL,001,187036,Staff,2,0,30,28
1683344562635,PHYS 1AL,002,187049,Staff,18,0,30,12
1683344563660,PHYS 1B,A00,187058,Staff,22,0,60,38
1683344564686,PHYS 1BL,001,187064,Staff,0,0,30,30
1683344564686,PHYS 1BL,002,187070,Staff,5,0,30,25
1683344565710,PHYS 1C,A00,187082,Staff,31,0,120,89
1683344566738,PHYS 1CL,001,187088,Staff,0,9,30,30
1683344566738,PHYS 1CL,002,187089,Staff,0,2,30,30
1683344566738,PHYS 1CL,009,262693,Staff,11,0,30,19
1683344567763,PHYS 2B,A01,187097,Staff,54,0,115,61
1683344568787,PHYS 2C,A01,187099,Staff,67,0,115,48
1683344569811,PHYS 2CL,A01,187101,Staff,5,0,28,23
1683344569811,PHYS 2CL,A02,187102,Staff,15,0,28,13
1683344570840,PHYS 2D,A01,187123,Shotwell; Brian,95,0,115,20
1683344571863,PHYS 4B,A01,187133,Grinstein; Benjamin,35,0,50,15
1683344572888,POLI 10,A00,188819,Staff,0,4,50,50
1683344573912,POLI 11,A00,188827,Staff,43,0,50,7
1683344574940,POLI 13R,A00,188828,Staff,0,1,20,20
1683344575966,POLI 27,A01,188830,Elgin; Samuel Zincke,0,1,70,70
1683344576991,POLI 30,A00,188832,Desposato; Scott,31,0,50,19
1683344578017,POLI 102F,A00,188834,Staff,3,0,40,37
1683344579040,POLI 104A,A00,188852,Staff,14,0,30,16
1683344580067,POLI 104I,A00,188853,Staff,0,6,20,20
1683344581090,POLI 110B,A00,188854,Wiens; David,7,0,20,13
1683344582121,POLI 112A,A00,188855,Wiens; David,5,0,30,25
1683344583148,POLI 117R,A00,188856,Forman; Fonna,0,11,20,20
1683344584173,POLI 118,A00,188857,Ingham; Sean,8,0,20,12
1683344585196,POLI 120G,A00,188858,Staff,9,0,30,21
1683344586219,POLI 131CR,A00,188863,Hoston; Germaine,24,0,50,26
1683344587242,POLI 133,A00,188864,Nellis; Gareth Hb,44,0,50,6
1683344588266,POLI 134D,A00,188865,Desposato; Scott,27,0,30,3
1683344589293,POLI 142A,A00,188871,Gartzke; Erik,22,0,50,28
1683344590319,POLI 142K,A00,188874,Staff,38,0,50,12
1683344591343,POLI 143,A00,188940,Gartzke; Erik,16,0,30,14
1683344592367,POLI 153,A00,188943,Staff,3,0,20,17
1683344593391,POLI 160AA,A00,188944,Staff,12,0,40,28
1683344594415,POLI 170A,A00,188945,Staff,11,0,30,19
1683344596467,PSYC 1,A00,188952,Staff,37,0,90,53
1683344597490,PSYC 2,B00,188953,Staff,19,0,35,16
1683344598516,PSYC 6,A00,188970,Staff,47,0,60,13
1683344599542,PSYC 7,A00,188973,Staff,37,0,45,8
1683344600570,PSYC 60,A01,188980,Rickard; Timothy C.,43,0,60,17
1683344601594,PSYC 70,A01,189001,Steiner; Eric Tomas,23,0,45,22
1683344602618,PSYC 100,A00,189005,Lacefield; Katharine I,0,98,120,120
1683344603642,PSYC 102,A00,189008,Staff,9,0,30,21
1683344604665,PSYC 106,B00,189026,Gorman; Michael R.,34,0,60,26
1683344605691,PSYC 114,B01,189033,Winkielman; Piotr,0,32,30,30
1683344606714,PSYC 131,A00,189036,Anagnostaras; Stephan,0,43,60,60
1683344607741,PSYC 136,A00,189041,Lowe; Angela Beth,0,7,25,25
1683344608764,PSYC 137,A00,189057,Winkielman; Piotr,0,34,25,25
1683344609787,PSYC 144,A00,189107,Wixted; John T,0,7,50,50
1683344611840,PSYC 162,A00,189142,Staff,0,8,85,85
1683344612864,PSYC 172,A00,189144,Gorman; Michael R.,0,7,30,30
1683344614917,PSYC 179,A00,189146,Lacefield; Katharine I,0,84,120,120
1683344615941,PSYC 181,A00,189147,Anagnostaras; Stephan,0,44,90,90
1683344616969,PSYC 190R,A00,189148,Barner; David A.,0,22,80,80
1683344617996,PSYC 191,A00,189275,Rickard; Timothy C.,0,7,25,25
1683344619024,PSYC 193,A00,189276,Chapman; Eddie Nathaniel,0,1,0,4
1683344620050,PSYC 193L,A01,189281,Lowe; Angela Beth,12,0,20,8
1683344620050,PSYC 193L,B01,189285,Staff,28,0,35,7
1683344621079,RELI 149,A00,187137,Rahimi; Babak,7,0,40,33
1683344622104,SE 9,A01,187315,Staff,0,2,18,18
1683344623128,SE 101B,A00,187409,Staff,24,0,30,6
1683344624152,SE 110B,A00,187444,Staff,10,0,40,30
1683344625176,SE 130B,A00,187449,Staff,31,0,40,9
1683344626203,SE 150A,A00,187516,Staff,9,0,20,11
1683344627228,SE 154,A00,187528,Staff,30,0,50,20
1683344628252,SIO 3,A01,258171,Staff,35,0,40,5
1683344629276,SIO 10,A00,187144,Cook; Geoffrey W,0,3,75,75
1683344630304,SIO 45,A00,187152,Cook; Geoffrey W,1,0,100,99
1683344631331,SIO 109R,A00,194486,Staff,0,3,20,20
1683344633379,SIO 187,A01,187233,Kacev; David,12,0,40,28
1683344634404,SOCI 1,A01,258656,Thorpe; Charles Robert,28,0,30,2
1683344634404,SOCI 1,A02,258658,Thorpe; Charles Robert,30,0,30,0
1683344634404,SOCI 1,A03,258661,Thorpe; Charles Robert,25,0,25,0
1683344634404,SOCI 1,A04,258666,Thorpe; Charles Robert,22,0,25,3
1683344634404,SOCI 1,A05,258897,Thorpe; Charles Robert,23,0,25,2
1683344634404,SOCI 1,A06,258898,Thorpe; Charles Robert,25,0,25,0
1683344635427,SOCI 30,A01,258903,Pardo Guerra; Juan Pablo,15,0,30,15
1683344636450,SOCI 102,A00,258904,Staff,9,0,25,16
1683344637474,SOCI 106,A00,258905,Staff,19,0,25,6
1683344638498,SOCI 111,A00,258907,Ribas Norris; Janet Vanesa,26,0,30,4
1683344639522,SOCI 121R,A00,258908,Pardo Guerra; Juan Pablo,10,0,30,20
1683344640545,SOCI 126,A01,203330,Staff,14,0,20,6
1683344641569,SOCI 131,A00,258909,Thorpe; Charles Robert,31,0,60,29
1683344642596,SOCI 135,A00,258910,Payne; Christine Anna,0,9,30,30
1683344643624,SOCI 157,A00,258911,Staff,12,0,30,18
1683344644651,SOCI 184,A00,258912,Staff,25,0,30,5
1683344645675,SOCI 188D,A00,258913,Staff,21,0,30,9
1683344646700,SYN 2,001,187529,Staff,10,0,16,6
1683344646700,SYN 2,002,201452,Staff,0,18,16,16
1683344646700,SYN 2,003,201469,Staff,3,0,16,13
1683344647727,SYN 100,A01,187531,Staff,0,9,20,20
1683344647727,SYN 100,B01,201491,Staff,0,12,20,20
1683344648754,TDAC 1,A00,189286,Walsh; Kim C.,3,0,20,17
1683344648754,TDAC 1,B00,189287,Harting; Carla Kelso,11,0,20,9
1683344649781,TDAC 101,A00,189300,Walsh; Kim C.,16,0,20,4
1683344649781,TDAC 101,B00,189301,Harting; Carla Kelso,18,0,20,2
1683344650810,TDAC 102,A00,189304,Basso; Beatrice,14,0,20,6
1683344651834,TDAC 108,A00,189305,Staff,18,0,20,2
1683344652861,TDDE 131,A00,189310,Staff,19,0,20,1
1683344652861,TDDE 131,B00,189314,Staff,19,0,20,1
1683344652861,TDDE 131,C00,189315,Staff,48,0,50,2
1683344652861,TDDE 131,D00,189316,Staff,14,0,15,1
1683344652861,TDDE 131,E00,204841,Staff,20,0,20,0
1683344653885,TDGE 10,A00,189289,Staff,30,0,50,20
1683344653885,TDGE 10,B00,189290,Havis; Allan,1,0,50,49
1683344654909,TDGE 11,A00,189291,Fulton; Julia,0,3,50,50
1683344654909,TDGE 11,B00,189292,Staff,20,0,25,5
1683344654909,TDGE 11,C00,260270,Staff,0,0,0,0
1683344655936,TDGE 25,A00,189294,Staff,3,0,20,17
1683344656959,TDGE 124,A00,189318,Fulton; Julia,0,8,50,50
1683344657984,TDGE 125,A00,189319,Staff,13,0,25,12
1683344657984,TDGE 125,B00,189320,Staff,23,0,25,2
1683344659008,TDGE 127,A00,189322,Havis; Allan,0,0,50,50
1683344660034,TDHT 101,A00,189323,Staff,18,0,25,7
1683344660034,TDHT 101,B00,189324,Staff,25,0,25,0
1683344661060,TDHT 102,A00,189325,Staff,49,0,50,1
1683344662139,TDMV 1,A00,189295,Arcidiacono; Kristin,19,0,30,11
1683344662139,TDMV 1,B00,189296,Caligagan; Maria T.,24,0,30,6
1683344663164,TDMV 2,A00,189297,Sammartano; Tonnie,28,0,30,2
1683344663164,TDMV 2,B00,189299,Arcidiacono; Kristin,24,0,30,6
1683344664189,TDMV 3,A00,204998,Rincon; Alicia,22,0,30,8
1683344665216,TDMV 120,A00,189458,Sammartano; Tonnie,28,0,30,2
1683344666241,TDMV 138,A00,189541,Jun; Grace Shin Hae,22,0,40,18
1683344667266,TDMV 142,A00,189717,Caligagan; Tony,23,0,30,7
1683344667266,TDMV 142,B00,189718,Caligagan; Maria T.,25,0,30,5
1683344668291,TMC 2,A01,187533,Staff,25,0,25,0
1683344668291,TMC 2,A02,187534,Staff,25,0,25,0
1683344669316,USP 1,A01,187536,Kwak; Nancy,0,16,25,25
1683344670343,USP 5,A01,187538,Staff,10,0,25,15
1683344671367,USP 101,A00,199253,Staff,0,4,0,0
1683344672391,USP 124,A00,187562,Boomhower; Matthew Charles,1,0,30,29
1683344673415,USP 138,A00,187582,Staff,20,0,25,5
1683344674439,USP 152,A01,187597,Staff,4,0,25,21
1683344675463,USP 153,A00,187598,Staff,19,0,25,6
1683344676487,USP 168,A00,187607,Kwak; Nancy,2,0,5,3
1683344677513,USP 173,A00,187619,Staff,4,0,25,21
1683344678538,USP 181,A00,187638,Staff,0,0,25,25
1683344679563,VIS 103,A00,187650,Cruz; Edwin Teddy,23,0,75,52
1683344680588,VIS 110D,A00,187669,Staff,12,0,22,10
1683344681611,VIS 127C,A00,187720,Shen; Kuiyi,67,0,146,79
1683344682634,VIS 149,A00,187731,Yoldas; Pinar,0,14,22,22
1683344683658,VIS 151,A01,188091,Staff,22,0,34,12
1683344683658,VIS 151,A02,188092,Staff,11,0,34,23
1683344684683,VIS 160B,A00,188093,Stalbaum; Brett,0,0,10,10
1683344686732,WCWP 10B,A00,201720,Staff,10,0,15,5
1683344686732,WCWP 10B,B00,201722,Staff,9,0,15,6
1683344687756,WCWP 100,A00,201725,Gagnon; Jeffrey C,0,0,2,2
1683344687756,WCWP 100,B00,201727,Staff,0,4,15,15
1683344690879,ANBI 133,A00,258401,Wilder; Linnea Lorene,34,0,40,6
1683344691903,ANBI 140,A00,258395,Hrvoj Mihic; Branka,18,0,25,7
1683344692927,ANSC 120,A00,258402,Bialecki; Jon Anthony,27,0,40,13
1683344693951,ANSC 144,A00,258400,Staff,14,0,40,26
1683344695998,ANSC 166,A00,258396,Parish; Steven Martin,157,0,175,18
1683344697023,ANSC 180,A00,193533,Staff,9,0,20,11
1683344698048,ANSC 188,A00,258397,Jassal; Aftab,33,0,40,7
1683344699073,ANTH 3,A01,258316,Staff,23,0,30,7
1683344700099,ANTH 5,A00,258394,Semendeferi; Ekaterini,16,0,20,4
1683344701125,ANTH 21,A01,258331,Staff,8,0,40,32
1683344702149,ANTH 103,A00,258398,Varma; Saiba,15,0,25,10
1683344703174,AWP 10,001,202034,Staff,0,0,0,0
1683344703174,AWP 10,002,202035,Staff,0,0,0,0
1683344703174,AWP 10,003,202036,Staff,0,0,0,0
1683344703174,AWP 10,004,202037,Staff,0,0,0,0
1683344703174,AWP 10,005,202038,Staff,0,0,0,0
1683344703174,AWP 10,006,202039,Staff,0,0,0,0
1683344703174,AWP 10,007,202040,Staff,0,0,0,0
1683344703174,AWP 10,008,202041,Staff,0,0,0,0
1683344703174,AWP 10,009,202042,Staff,0,0,0,0
1683344703174,AWP 10,010,202043,Staff,0,0,0,0
1683344703174,AWP 10,011,202044,Staff,0,0,0,0
1683344703174,AWP 10,012,202045,Staff,0,0,0,0
1683344703174,AWP 10,013,202046,Staff,0,0,0,0
1683344703174,AWP 10,014,202047,Staff,0,0,0,0
1683344703174,AWP 10,015,202048,Staff,0,0,0,0
1683344703174,AWP 10,016,202049,Staff,0,0,0,0
1683344703174,AWP 10,017,202050,Staff,0,0,0,0
1683344703174,AWP 10,018,202051,Staff,0,0,0,0
1683344703174,AWP 10,019,202052,Staff,0,0,0,0
1683344703174,AWP 10,020,202053,Staff,0,0,0,0
1683344703174,AWP 10,021,202054,Staff,0,0,0,0
1683344703174,AWP 10,022,202055,Staff,0,0,0,0
1683344703174,AWP 10,023,202056,Staff,0,0,0,0
1683344703174,AWP 10,024,202057,Staff,0,0,0,0
1683344703174,AWP 10,025,202058,Staff,0,0,0,0
1683344703174,AWP 10,026,202059,Staff,0,0,0,0
1683344704198,AWP 102,001,202032,Staff,0,0,0,0
1683344704198,AWP 102,002,202033,Staff,0,0,0,0
1683344705224,BENG 100,A01,254234,Taylor Amos; Alyssa C,31,0,40,9
1683344706249,BENG 196,001,270013,Engler; Adam J.,9999,0,9999,0
1683344707273,BICD 100R,A01,202018,Smith; Laurie,0,7,32,32
1683344707273,BICD 100R,A02,202019,Smith; Laurie,0,2,32,32
1683344707273,BICD 100R,A03,202020,Smith; Laurie,0,1,32,32
1683344707273,BICD 100R,A04,202021,Smith; Laurie,9,0,32,23
1683344707273,BICD 100R,A05,202022,Smith; Laurie,12,0,32,20
1683344708302,BICD 136,A01,193242,Gustafson-Brown; Cindy,0,2,32,32
1683344708302,BICD 136,A02,193244,Gustafson-Brown; Cindy,14,0,32,18
1683344709328,BIEB 102,A01,193249,Butler; Shannon Rhey,0,2,32,32
1683344709328,BIEB 102,A02,193251,Butler; Shannon Rhey,0,0,32,32
1683344709328,BIEB 102,A03,193253,Butler; Shannon Rhey,0,1,32,32
1683344709328,BIEB 102,A04,193255,Butler; Shannon Rhey,17,0,32,15
1683344709328,BIEB 102,A05,193265,Butler; Shannon Rhey,26,0,32,6
1683344709328,BIEB 102,A06,193269,Butler; Shannon Rhey,16,0,32,16
1683344711379,BIEB 150,A01,193274,Staff,0,0,32,32
1683344711379,BIEB 150,A02,193285,Staff,23,0,32,9
1683344712401,BIEB 194,A00,193286,Kurle; Carolyn M.,22,0,32,10
1683344713426,BILD 1,A01,192291,Staff,16,0,32,16
1683344713426,BILD 1,A02,192292,Staff,30,0,32,2
1683344713426,BILD 1,B01,192520,Reuther; Keefe,0,1,0,0
1683344713426,BILD 1,B02,192532,Reuther; Keefe,0,1,0,0
1683344714451,BILD 3,A01,192556,Butler; Shannon Rhey,0,0,32,32
1683344714451,BILD 3,A02,192581,Butler; Shannon Rhey,5,0,32,27
1683344714451,BILD 3,A03,192611,Butler; Shannon Rhey,23,0,32,9
1683344714451,BILD 3,A04,192612,Butler; Shannon Rhey,25,0,32,7
1683344714451,BILD 3,A05,192613,Butler; Shannon Rhey,27,0,32,5
1683344714451,BILD 3,A06,192679,Butler; Shannon Rhey,27,0,32,5
1683344714451,BILD 3,A07,192682,Butler; Shannon Rhey,22,0,32,10
1683344715483,BILD 4,A01,192836,Reuther; Keefe,0,0,24,24
1683344715483,BILD 4,A02,193044,Reuther; Keefe,4,0,24,20
1683344716505,BILD 10,A01,193142,Gustafson-Brown; Cindy,30,0,32,2
1683344716505,BILD 10,A02,193149,Gustafson-Brown; Cindy,31,0,32,1
1683344717534,BIMM 100,A01,193301,Staff,0,6,32,32
1683344717534,BIMM 100,A02,193312,Staff,0,5,32,32
1683344717534,BIMM 100,A03,193323,Staff,0,8,32,32
1683344718558,BIMM 101,A01,193329,McDonnell; Lisa Marie,0,3,24,24
1683344718558,BIMM 101,A02,193339,McDonnell; Lisa Marie,0,3,24,24
1683344718558,BIMM 101,B01,193354,McDonnell; Lisa Marie,0,3,24,24
1683344718558,BIMM 101,B02,193357,McDonnell; Lisa Marie,0,3,24,24
1683344719582,BIMM 110,A01,193377,Tat; John,0,11,32,32
1683344719582,BIMM 110,A02,193378,Tat; John,1,9,32,31
1683344720611,BIMM 120,A01,206116,Staff,0,0,32,32
1683344720611,BIMM 120,A02,206117,Staff,8,0,32,24
1683344720611,BIMM 120,A03,206121,Staff,21,0,32,11
1683344721640,BIPN 100,A01,193393,Park; Ji Young,0,14,32,32
1683344721640,BIPN 100,A02,193402,Park; Ji Young,0,13,32,32
1683344721640,BIPN 100,A03,193413,Park; Ji Young,0,14,32,32
1683344721640,BIPN 100,A04,193414,Park; Ji Young,0,13,32,32
1683344722667,BIPN 102,A01,193429,Staff,0,0,32,32
1683344722667,BIPN 102,A02,193438,Staff,22,0,32,10
1683344723695,BIPN 106,A01,193450,Reyes Gonzalez; Catalina,0,2,40,40
1683344724720,BIPN 134,A01,193465,Cooke; James Edward,0,0,32,32
1683344724720,BIPN 134,A02,193474,Cooke; James Edward,25,0,32,7
1683344724720,BIPN 134,A03,193485,Cooke; James Edward,29,0,32,3
1683344724720,BIPN 134,A04,193486,Cooke; James Edward,21,0,32,11
1683344724720,BIPN 134,A05,193491,Cooke; James Edward,31,0,32,1
1683344724720,BIPN 134,A06,193501,Cooke; James Edward,30,0,32,2
1683344724720,BIPN 134,A07,193510,Cooke; James Edward,29,0,32,3
1683344726766,BISP 194,A00,222522,Staff,14,0,32,18
1683344727793,CAT 124,A01,202407,Staff,20,0,25,5
1683344728820,CAT 125,A00,202408,Marchisotto; Jennifer Anne,4,0,20,16
1683344729844,CAT 125R,A00,202409,Smith; Lauryn Alissa,0,11,20,20
1683344729844,CAT 125R,B00,202410,Morales; Celeste Georgianna,0,11,20,20
1683344729844,CAT 125R,C00,202411,Irwin; Matthew Joseph,0,10,20,20
1683344730872,CENG 15,A01,204712,Yang; Kesong,0,1,0,0
1683344731897,CENG 114,A00,202070,Jahed Motlagh; Zeinab,5,0,20,15
1683344732923,CGS 105,A00,185477,Wesling; Megan E.,24,0,40,16
1683344733947,CGS 106,A00,185494,Staff,13,0,22,9
1683344734972,CGS 108,A00,185495,Staff,14,0,20,6
1683344735995,CGS 114,A00,185496,Staff,13,0,18,5
1683344737022,CGS 119,A00,185501,Staff,15,0,20,5
1683344738046,CGS 120,A00,185511,Staff,13,0,20,7
1683344739072,CHEM 4,A01,184675,Bussey; Thomas J,96,0,100,4
1683344740095,CHEM 6A,A01,184677,Staff,34,0,60,26
1683344741122,CHEM 6B,A01,184679,Staff,65,0,100,35
1683344742146,CHEM 6C,A01,184681,Bussey; Thomas J,1,0,50,49
1683344742146,CHEM 6C,A02,184682,Bussey; Thomas J,34,0,50,16
1683344743173,CHEM 40A,A01,184684,Albizati; Kim F.,37,0,100,63
1683344744200,CHEM 40B,A01,184686,Albizati; Kim F.,0,20,100,100
1683344745228,CHEM 41B,A01,184690,Staff,52,0,100,48
1683344746255,COGS 3,A01,184715,Boyle; Mary E. T.,0,25,40,40
1683344747278,COGS 14B,A01,185172,Staff,0,15,38,38
1683344748302,COGS 18,A01,184736,Staff,17,0,80,63
1683344749326,COGS 100,A01,184932,Staff,0,5,73,73
1683344750351,COGS 101A,A01,184935,Staff,0,39,30,30
1683344751374,COGS 101B,A01,184944,Staff,0,2,30,30
1683344752397,COGS 101C,A01,184946,Staff,0,12,30,30
1683344753419,COGS 102A,A01,184951,Johnson; Christine M.,2,0,40,38
1683344754442,COGS 107B,A01,184953,Mooshagian; Eric Frederick,0,50,40,40
1683344755466,COGS 118B,A01,184959,Gupta; Anjum,0,48,40,40
1683344756490,COGS 153,A00,184961,Staff,0,15,30,30
1683344757517,COGS 177,A00,184962,Staff,0,20,30,30
1683344758540,COGS 187A,A01,184969,Boyle; Mary E. T.,0,17,40,40
1683344759564,COMM 10,A01,185174,Staff,0,5,25,25
1683344759564,COMM 10,A02,185189,Staff,0,5,25,25
1683344759564,COMM 10,A03,269821,Staff,0,0,0,0
1683344760589,COMM 100B,A01,185475,Staff,0,0,0,2
1683344760589,COMM 100B,A02,185476,Staff,13,0,25,12
1683344761615,COMM 100C,A01,185314,Staff,1,0,25,24
1683344761615,COMM 100C,A02,185327,Staff,19,0,25,6
1683344762639,COMM 110M,A00,185349,Staff,2,0,40,38
1683344763666,COMM 113T,A00,185352,Staff,24,0,40,16
1683344764695,COMM 114I,A00,185353,Staff,33,0,40,7
1683344765794,COMM 131,A00,185354,Staff,19,0,30,11
1683344766819,CSE 8A,A50,185358,Cao; Yingjun,0,46,10,10
1683344767847,CSE 8B,A01,185362,Staff,1,47,50,49
1683344768872,CSE 11,A01,185416,Cao; Yingjun,0,92,10,10
1683344769897,CSE 20,A01,185445,Briones; Jor-el Thomas Caparas,5,0,25,20
1683344770923,CSE 21,A01,185447,Staff,10,0,50,40
1683344771948,CSE 101,A01,185451,Staff,0,13,50,50
1683344771948,CSE 101,B01,185453,Jones; Miles E,0,11,50,50
1683344774006,CSE 141,A01,185458,Eldon; John,20,0,100,80
1683344775033,CSE 141L,A01,185461,Eldon; John,12,0,100,88
1683344776061,CSE 142,A01,185463,Staff,36,0,60,24
1683344776061,CSE 142,B01,201355,Staff,0,7,60,60
1683344777089,CSE 142L,A01,185470,Staff,36,0,60,24
1683344777089,CSE 142L,B01,201417,Staff,0,6,60,60
1683344778116,CSE 190,A00,201433,Staff,32,0,49,17
1683344779143,DOC 1,A01,259136,Strom; Megan C.,7,0,15,8
1683344779143,DOC 1,A02,259137,Strom; Megan C.,14,0,15,1
1683344779143,DOC 1,A03,259138,Strom; Megan C.,14,0,15,1
1683344779143,DOC 1,A04,259139,Strom; Megan C.,14,0,15,1
1683344780172,DOC 100D,A00,259140,Pass; Natalye Joann,16,0,25,9
1683344781197,DSGN 1,A01,184749,Rill; Bryan,0,25,30,30
1683344782224,DSGN 100,A01,185168,Staff,0,2,25,25
1683344783249,ECE 5,A01,185626,Morris; Karcher William,0,10,0,0
1683344784279,ECE 101,A01,185628,Staff,17,0,70,53
1683344785304,ECE 107,A01,185635,Baghdadchi; Saharnaz,0,0,20,20
1683344785304,ECE 107,A02,185638,Baghdadchi; Saharnaz,4,0,20,16
1683344786329,ECE 148,A01,185647,Silberman; Jack,0,0,16,16
1683344787353,ECON 1,A01,185537,Crane; Meredith Helen,54,0,70,16
1683344788376,ECON 3,A01,185549,Crane; Meredith Helen,32,0,70,38
1683344789404,ECON 4,A01,203354,Anderson; John Charles,0,4,10,10
1683344790428,ECON 100A,A01,185574,Staff,0,4,40,40
1683344791456,ECON 100B,A01,185576,Staff,10,22,50,40
1683344792481,ECON 100C,A01,185589,Newhouse; Herbert S,29,0,70,41
1683344793508,ECON 105,A00,185608,Vespa; Emanuel Ignacio,19,0,35,16
1683344794535,ECON 109,A01,185610,Shishkin; Denis,10,0,35,25
1683344795560,ECON 110A,A01,185612,Staff,11,0,40,29
1683344796585,ECON 120A,A01,185615,Staff,20,0,40,20
1683344797611,ECON 120C,A01,185617,Sun; Yixiao,0,20,70,70
1683344798636,ECON 144,A00,203346,Squires; Dale E,3,0,35,32
1683344799660,ECON 171,A01,203349,Newhouse; Herbert S,0,1,35,35
1683344800688,ECON 173A,A01,185621,Toda; Alexis Akira,21,0,35,14
1683344801714,EDS 25,A01,202413,Staff,0,1,0,0
1683344801714,EDS 25,A02,202414,Staff,0,1,0,0
1683344801714,EDS 25,A03,202415,Staff,0,0,0,0
1683344801714,EDS 25,A04,202416,Staff,0,1,0,0
1683344801714,EDS 25,A05,202439,Staff,0,0,0,0
1683344801714,EDS 25,A06,202440,Staff,0,0,0,0
1683344801714,EDS 25,B01,202631,Staff,0,0,0,0
1683344801714,EDS 25,B02,202632,Staff,0,0,0,0
1683344801714,EDS 25,B03,202639,Staff,0,0,0,0
1683344801714,EDS 25,B04,202640,Staff,0,0,0,0
1683344801714,EDS 25,B05,202643,Staff,0,0,0,0
1683344801714,EDS 25,B06,202644,Staff,0,0,0,0
1683344802741,EDS 38,A01,202659,Black; Alison Michelle,24,0,25,1
1683344803768,EDS 115,A00,202652,Staff,18,0,30,12
1683344804793,EDS 125,A00,202649,Staff,14,0,30,16
1683344805817,EDS 126,A01,203332,Staff,30,0,30,0
1683344806843,EDS 139,A00,202838,Staff,16,0,25,9
1683344807867,EDS 146,A01,202655,Staff,14,0,25,11
1683344808892,ENG 15,A00,185667,Staff,0,1,0,0
1683344808892,ENG 15,B00,185672,Staff,0,0,0,0
1683344808892,ENG 15,C00,185675,Staff,0,0,0,0
1683344808892,ENG 15,D00,185682,Staff,0,0,0,0
1683344808892,ENG 15,E00,185684,Staff,0,0,0,0
1683344809918,ETHN 103,A00,185710,Staff,0,4,35,35
1683344810942,ETHN 103A,A00,199228,Man; Simeon S,2,0,9,7
1683344811968,ETHN 109,A00,185711,Staff,18,0,35,17
1683344812996,ETHN 142,A00,185726,Staff,0,4,30,30
1683344814027,ETHN 163J,A00,199229,Man; Simeon S,5,0,8,3
1683344815051,ETHN 168,A00,185727,Staff,8,0,10,2
1683344816079,ETHN 182,A00,185728,Staff,1,0,35,34
1683344817106,ETHN 183,A00,185737,Staff,8,0,18,10
1683344818132,GLBH 111,A01,209361,Burgos; Jose L.,0,0,0,0
1683344820180,HIEU 104,A00,185792,Staff,16,0,20,4
1683344821204,HIEU 115,A00,185800,Staff,1,0,20,19
1683344822234,HIEU 128,A00,185801,Staff,0,7,20,20
1683344823258,HIEU 147,A00,185802,Staff,16,0,20,4
1683344824284,HIEU 154,A00,185823,Staff,12,0,20,8
1683344825309,HILA 102,A00,185826,Staff,13,0,20,7
1683344826337,HILD 2C,A01,185778,Staff,0,12,20,20
1683344827365,HILD 7B,A01,185780,Kwak; Nancy,0,15,32,32
1683344827365,HILD 7B,A02,185781,Kwak; Nancy,0,18,32,32
1683344828390,HILD 30,A01,185791,Staff,14,0,20,6
1683344829418,HISC 119,A00,185830,Golan; Tal,0,9,20,20
1683344830445,HITO 156GS,A00,185831,Patterson; Patrick H.,0,0,0,23
1683344831471,HIUS 103,A00,185832,Man; Simeon S,0,6,20,20
1683344832495,HIUS 117,A00,185836,Kwak; Nancy,2,0,20,18
1683344833519,HIUS 125,A00,185840,Man; Simeon S,0,0,23,23
1683344834544,HIUS 149,A00,185845,Staff,0,0,20,20
1683344835569,HUM 3,A01,185882,Zavodny; Tatiana Sophia,0,7,50,50
1683344835569,HUM 3,B01,185899,Caldwell; Michael Alan,0,18,50,50
1683344836598,HUM 3GS,A00,185900,Patterson; Patrick H.,0,0,0,23
1683344837622,HUM 4,A01,185938,Zroka; Amy Liane,31,0,50,19
1683344837622,HUM 4,B01,185956,Watkins; Eric,0,2,50,50
1683344837622,HUM 4,B02,202209,Watkins; Eric,0,2,50,50
1683344837622,HUM 4,B03,202210,Watkins; Eric,0,2,50,50
1683344838645,HUM 5,A01,185958,West; Geoffrey Scott,3,0,50,47
1683344838645,HUM 5,A02,202215,West; Geoffrey Scott,0,0,50,50
1683344839670,INTL 190,A00,185959,Gagnon; Jeffrey C,0,0,0,9
1683344839670,INTL 190,B00,185960,Lettieri; Michael Joseph,0,0,0,1
1683344840694,JAPN 180,A00,254509,Staff,5,1,30,25
1683344841717,LATI 10,A01,202853,Kennemore; Amy Michelle,4,0,35,31
1683344841717,LATI 10,A02,202854,Kennemore; Amy Michelle,2,0,35,33
1683344841717,LATI 10,A03,270054,Kennemore; Amy Michelle,30,0,30,0
1683344842741,LATI 180,A00,202855,Kennemore; Amy Michelle,11,0,20,9
1683344843768,LAWS 101,A00,201767,Golan; Tal,0,7,40,40
1683344844794,LIFR 1C,A00,185961,Staff,6,0,20,14
1683344845818,LIFR 1CX,A00,185962,Staff,7,0,20,13
1683344846843,LIFR 1D,A00,185963,Staff,9,0,20,11
1683344847867,LIFR 1DX,A00,185964,Staff,9,0,20,11
1683344848895,LIGN 101,A01,186039,Staff,43,0,50,7
1683344849921,LIGN 165,A00,186040,Staff,18,0,50,32
1683344850946,LTCS 108,A00,186041,Staff,6,0,10,4
1683344851973,LTCS 119,A00,186042,Staff,16,0,20,4
1683344853001,LTCS 130,A00,186043,Wesling; Megan E.,15,0,25,10
1683344855061,LTEA 138,A00,186119,Staff,14,0,40,26
1683344856086,LTEN 124,A00,186148,Staff,6,0,25,19
1683344857111,LTEN 178,A00,186149,Staff,7,0,15,8
1683344858135,LTEN 181,A00,186150,Blanco; John D,33,0,40,7
1683344859158,LTWL 120,A00,186160,Staff,20,0,25,5
1683344860186,LTWL 165,A00,186161,Staff,22,0,25,3
1683344861210,LTWR 100,A00,186162,Staff,0,5,15,15
1683344862236,LTWR 102,A00,186163,Doller; Ben,5,0,15,10
1683344863263,MAE 8,A01,186412,Staff,0,0,0,0
1683344864288,MAE 30B,A00,186445,Bahadori; Mohammad Yousef,83,0,100,17
1683344865315,MAE 40,A00,186592,Bewley; Thomas R,9,0,50,41
1683344866340,MAE 101B,A00,186593,Bahadori; Mohammad Yousef,81,0,100,19
1683344867364,MAE 105,A00,186594,Bandaru; Prabhakar,12,0,50,38
1683344868391,MAE 107,A00,186599,Pham; Hieu Tan,0,6,120,120
1683344869472,MAE 148,A01,186660,Silberman; Jack,3,0,16,13
1683344870500,MATH 10A,A01,188095,Staff,1,6,35,34
1683344871525,MATH 10B,A01,188097,Bowers; Adam R.,0,11,30,30
1683344871525,MATH 10B,A02,188099,Bowers; Adam R.,0,11,30,30
1683344871525,MATH 10B,B01,188104,Bowers; Adam R.,0,10,30,30
1683344871525,MATH 10B,B02,188106,Bowers; Adam R.,0,10,30,30
1683344872553,MATH 10C,A01,188111,Staff,0,18,30,30
1683344872553,MATH 10C,A02,188127,Staff,0,17,30,30
1683344872553,MATH 10C,A03,188131,Staff,0,18,30,30
1683344872553,MATH 10C,B01,188218,Staff,18,0,30,12
1683344872553,MATH 10C,B02,188244,Staff,13,0,30,17
1683344872553,MATH 10C,B03,188277,Staff,16,0,30,14
1683344873578,MATH 18,A01,188344,Bach; Quang Tran,18,0,30,12
1683344873578,MATH 18,A02,188345,Bach; Quang Tran,11,0,30,19
1683344873578,MATH 18,B01,188353,Bach; Quang Tran,10,0,30,20
1683344873578,MATH 18,B02,188354,Bach; Quang Tran,20,0,30,10
1683344874603,MATH 20A,A01,188374,Staff,13,0,35,22
1683344875637,MATH 20B,A01,188382,Ohm; Ko Woon,6,0,30,24
1683344875637,MATH 20B,A02,188383,Ohm; Ko Woon,22,0,30,8
1683344875637,MATH 20B,B01,188385,Ohm; Ko Woon,7,0,30,23
1683344875637,MATH 20B,B02,188392,Ohm; Ko Woon,22,0,30,8
1683344876662,MATH 20C,A01,188394,Harel; Guershon,10,0,30,20
1683344876662,MATH 20C,A02,188395,Harel; Guershon,15,0,30,15
1683344876662,MATH 20C,B01,188404,Harel; Guershon,5,0,30,25
1683344876662,MATH 20C,B02,188405,Harel; Guershon,19,0,30,11
1683344877687,MATH 20D,A01,188414,Hammock; Frances H,0,1,30,30
1683344877687,MATH 20D,A02,188415,Hammock; Frances H,3,0,30,27
1683344877687,MATH 20D,B01,188447,Hammock; Frances H,1,0,30,29
1683344877687,MATH 20D,B02,188486,Hammock; Frances H,8,0,30,22
1683344878712,MATH 20E,A01,188649,Staff,21,0,30,9
1683344878712,MATH 20E,A02,188650,Staff,23,0,30,7
1683344878712,MATH 20E,A03,188673,Staff,0,0,30,30
1683344879740,MATH 102,A01,188675,Staff,0,35,35,35
1683344880769,MATH 103B,A01,188681,Staff,3,0,35,32
1683344880769,MATH 103B,B01,188692,Staff,5,0,35,30
1683344881808,MATH 109,A01,188695,Salehi Golsefidy; Alireza,25,0,35,10
1683344881808,MATH 109,A02,188696,Salehi Golsefidy; Alireza,25,0,35,10
1683344882834,MATH 120A,A01,188698,Eggers; John Dietrich,7,0,35,28
1683344883860,MATH 142B,A01,188736,Ioana; Adrian,0,2,30,30
1683344883860,MATH 142B,A02,188741,Ioana; Adrian,1,1,30,29
1683344883860,MATH 142B,A03,188743,Ioana; Adrian,1,3,30,29
1683344884883,MATH 168A,A01,188790,Staff,0,9,35,35
1683344885911,MATH 170A,A01,188803,Nie; Jiawang,0,2,35,35
1683344885911,MATH 170A,A02,188811,Nie; Jiawang,0,0,35,35
1683344885911,MATH 170A,A03,188814,Nie; Jiawang,1,0,35,34
1683344885911,MATH 170A,A04,188815,Nie; Jiawang,13,0,35,22
1683344886940,MATH 193B,A01,188817,Staff,0,0,35,35
1683344886940,MATH 193B,A02,188818,Staff,5,0,35,30
1683344887966,MGT 4,A01,202857,Anderson; John Charles,62,0,80,18
1683344888988,MGT 12,A00,202858,Lindenberger; Wade Douglas,42,0,90,48
1683344890016,MGT 18,A00,202859,Staff,74,0,90,16
1683344891042,MGT 18GS,A00,202860,McKay; Michael J,13,0,28,15
1683344892065,MGT 45,A00,202861,Pecore; Joseph P.,14,0,90,76
1683344893090,MGT 100,A00,202863,Yavorsky; Daniel Ryan,28,0,90,62
1683344894115,MGT 103,A00,202864,Ehrich; Kristine R,1,18,90,89
1683344895140,MGT 112,A00,202865,Ehrich; Kristine R,15,0,90,75
1683344896165,MGT 121A,A00,202868,Staff,0,20,0,0
1683344897191,MGT 131B,A00,202869,Anderson; John Charles,59,0,90,31
1683344898215,MGT 136,A00,202871,Lindenberger; Wade Douglas,84,0,90,6
1683344899242,MGT 164,A00,202873,Staff,0,68,90,91
1683344900268,MGT 164GS,A00,202874,McKay; Mary A,13,0,28,15
1683344901293,MGT 180,A00,202875,Staff,0,50,90,91
1683344902320,MMW 11R,A01,205019,Herbst; Matthew,3,0,30,27
1683344902320,MMW 11R,A02,205026,Herbst; Matthew,29,0,30,1
1683344903345,MMW 15,A01,193512,Chang; Edmond Yi-Teh,0,9,28,28
1683344903345,MMW 15,A02,193513,Chang; Edmond Yi-Teh,0,5,28,28
1683344903345,MMW 15,A03,193514,Chang; Edmond Yi-Teh,0,5,28,28
1683344903345,MMW 15,A04,193515,Chang; Edmond Yi-Teh,0,5,28,28
1683344903345,MMW 15,A05,193516,Chang; Edmond Yi-Teh,0,4,28,28
1683344903345,MMW 15,A06,193517,Chang; Edmond Yi-Teh,0,5,28,28
1683344903345,MMW 15,B01,193519,Chang; Edmond Yi-Teh,0,5,28,28
1683344903345,MMW 15,B02,193520,Chang; Edmond Yi-Teh,0,5,28,28
1683344903345,MMW 15,B03,193521,Chang; Edmond Yi-Teh,0,5,28,28
1683344903345,MMW 15,B04,193522,Chang; Edmond Yi-Teh,0,4,28,28
1683344903345,MMW 15,B05,193523,Chang; Edmond Yi-Teh,0,5,28,28
1683344903345,MMW 15,B06,193524,Chang; Edmond Yi-Teh,0,4,28,28
1683344904370,MMW 122,A01,193526,Rahimi; Babak,0,15,28,28
1683344904370,MMW 122,A02,193527,Rahimi; Babak,0,14,28,28
1683344904370,MMW 122,A03,193528,Rahimi; Babak,0,0,0,0
1683344904370,MMW 122,A04,193529,Rahimi; Babak,0,0,0,0
1683344905394,MUS 1A,A01,186663,Staff,0,20,35,35
1683344906421,MUS 4,A01,186715,Staff,0,12,35,35
1683344907446,MUS 5R,A01,186796,Dubnov; Shlomo,0,17,35,35
1683344908471,MUS 6,A01,186798,Staff,0,4,25,25
1683344909496,MUS 7,A01,186830,Staff,13,0,35,22
1683344910524,MUS 8,A01,186930,Staff,0,26,35,35
1683344911549,MUS 15,A01,186932,Staff,0,16,35,35
1683344911549,MUS 15,B01,186934,Staff,0,15,35,35
1683344912574,MUS 80,A00,186935,Staff,1,0,20,19
1683344912574,MUS 80,B00,186936,Staff,25,0,25,0
1683344913599,NANO 11,A00,204702,Lipomi; Darren John,0,0,0,0
1683344914625,NANO 15,A01,204709,Yang; Kesong,0,1,0,0
1683344915648,NANO 114,A00,202069,Jahed Motlagh; Zeinab,3,0,10,7
1683344916675,PHIL 1,A00,186955,Grush; Rick Scott,32,0,40,8
1683344917703,PHIL 10,A01,186973,Grush; Rick Scott,28,0,35,7
1683344917703,PHIL 10,A02,186974,Grush; Rick Scott,33,0,35,2
1683344918730,PHIL 13,A01,186976,Staff,7,0,35,28
1683344918730,PHIL 13,A02,186977,Staff,16,0,35,19
1683344919755,PHIL 14,A01,186979,Staff,31,0,35,4
1683344919755,PHIL 14,A02,186986,Staff,32,0,35,3
1683344920782,PHIL 28,A01,186988,Staff,16,0,30,14
1683344920782,PHIL 28,A02,186989,Staff,1,0,30,29
1683344920782,PHIL 28,A03,186990,Staff,9,0,30,21
1683344920782,PHIL 28,A04,186991,Staff,26,0,30,4
1683344921804,PHIL 120,A00,186997,Staff,23,0,40,17
1683344922841,PHIL 137,A00,187003,Staff,9,0,40,31
1683344923869,PHIL 150,A00,187015,Staff,47,0,70,23
1683344924898,PHIL 167,A00,187021,Lamey; Andy M.,35,0,40,5
1683344925922,PHIL 174,A01,202226,Staff,17,0,20,3
1683344925922,PHIL 174,A02,202235,Staff,20,0,20,0
1683344926945,PHIL 191A,A00,258918,Staff,0,0,1,1
1683344927973,PHYS 1A,A00,187028,Staff,27,0,60,33
1683344929001,PHYS 1AL,001,187036,Staff,2,0,30,28
1683344929001,PHYS 1AL,002,187049,Staff,18,0,30,12
1683344930028,PHYS 1B,A00,187058,Staff,22,0,60,38
1683344931053,PHYS 1BL,001,187064,Staff,0,0,30,30
1683344931053,PHYS 1BL,002,187070,Staff,5,0,30,25
1683344932080,PHYS 1C,A00,187082,Staff,31,0,120,89
1683344933109,PHYS 1CL,001,187088,Staff,0,9,30,30
1683344933109,PHYS 1CL,002,187089,Staff,0,2,30,30
1683344933109,PHYS 1CL,009,262693,Staff,11,0,30,19
1683344934133,PHYS 2B,A01,187097,Staff,54,0,115,61
1683344935161,PHYS 2C,A01,187099,Staff,67,0,115,48
1683344936186,PHYS 2CL,A01,187101,Staff,5,0,28,23
1683344936186,PHYS 2CL,A02,187102,Staff,15,0,28,13
1683344937214,PHYS 2D,A01,187123,Shotwell; Brian,95,0,115,20
1683344938239,PHYS 4B,A01,187133,Grinstein; Benjamin,35,0,50,15
1683344939267,POLI 10,A00,188819,Staff,0,4,50,50
1683344940294,POLI 11,A00,188827,Staff,43,0,50,7
1683344941330,POLI 13R,A00,188828,Staff,0,1,20,20
1683344942356,POLI 27,A01,188830,Elgin; Samuel Zincke,0,1,70,70
1683344943383,POLI 30,A00,188832,Desposato; Scott,31,0,50,19
1683344944407,POLI 102F,A00,188834,Staff,3,0,40,37
1683344945440,POLI 104A,A00,188852,Staff,14,0,30,16
1683344946465,POLI 104I,A00,188853,Staff,0,6,20,20
1683344947490,POLI 110B,A00,188854,Wiens; David,7,0,20,13
1683344948515,POLI 112A,A00,188855,Wiens; David,5,0,30,25
1683344949543,POLI 117R,A00,188856,Forman; Fonna,0,11,20,20
1683344950568,POLI 118,A00,188857,Ingham; Sean,8,0,20,12
1683344951596,POLI 120G,A00,188858,Staff,9,0,30,21
1683344952621,POLI 131CR,A00,188863,Hoston; Germaine,24,0,50,26
1683344953648,POLI 133,A00,188864,Nellis; Gareth Hb,44,0,50,6
1683344954672,POLI 134D,A00,188865,Desposato; Scott,27,0,30,3
1683344955696,POLI 142A,A00,188871,Gartzke; Erik,22,0,50,28
1683344956720,POLI 142K,A00,188874,Staff,38,0,50,12
1683344957744,POLI 143,A00,188940,Gartzke; Erik,16,0,30,14
1683344958767,POLI 153,A00,188943,Staff,3,0,20,17
1683344959792,POLI 160AA,A00,188944,Staff,12,0,40,28
1683344960815,POLI 170A,A00,188945,Staff,11,0,30,19
1683344962866,PSYC 1,A00,188952,Staff,37,0,90,53
1683344963890,PSYC 2,B00,188953,Staff,19,0,35,16
1683344964918,PSYC 6,A00,188970,Staff,47,0,60,13
1683344965943,PSYC 7,A00,188973,Staff,37,0,45,8
1683344966971,PSYC 60,A01,188980,Rickard; Timothy C.,43,0,60,17
1683344968002,PSYC 70,A01,189001,Steiner; Eric Tomas,23,0,45,22
1683344969030,PSYC 100,A00,189005,Lacefield; Katharine I,0,98,120,120
1683344970057,PSYC 102,A00,189008,Staff,9,0,30,21
1683344971085,PSYC 106,B00,189026,Gorman; Michael R.,34,0,60,26
1683344972109,PSYC 114,B01,189033,Winkielman; Piotr,0,32,30,30
1683344973189,PSYC 131,A00,189036,Anagnostaras; Stephan,0,43,60,60
1683344974212,PSYC 136,A00,189041,Lowe; Angela Beth,0,7,25,25
1683344975242,PSYC 137,A00,189057,Winkielman; Piotr,0,34,25,25
1683344976266,PSYC 144,A00,189107,Wixted; John T,0,7,50,50
1683344978318,PSYC 162,A00,189142,Staff,0,8,85,85
1683344979344,PSYC 172,A00,189144,Gorman; Michael R.,0,7,30,30
1683344981393,PSYC 179,A00,189146,Lacefield; Katharine I,0,84,120,120
1683344982420,PSYC 181,A00,189147,Anagnostaras; Stephan,0,44,90,90
1683344983443,PSYC 190R,A00,189148,Barner; David A.,0,22,80,80
1683344984474,PSYC 191,A00,189275,Rickard; Timothy C.,0,7,25,25
1683344985501,PSYC 193,A00,189276,Chapman; Eddie Nathaniel,0,1,0,4
1683344986529,PSYC 193L,A01,189281,Lowe; Angela Beth,12,0,20,8
1683344986529,PSYC 193L,B01,189285,Staff,28,0,35,7
1683344987555,RELI 149,A00,187137,Rahimi; Babak,7,0,40,33
1683344988582,SE 9,A01,187315,Staff,0,2,18,18
1683344989608,SE 101B,A00,187409,Staff,24,0,30,6
1683344990631,SE 110B,A00,187444,Staff,10,0,40,30
1683344991659,SE 130B,A00,187449,Staff,31,0,40,9
1683344992684,SE 150A,A00,187516,Staff,9,0,20,11
1683344993711,SE 154,A00,187528,Staff,30,0,50,20
1683344994736,SIO 3,A01,258171,Staff,35,0,40,5
1683344995760,SIO 10,A00,187144,Cook; Geoffrey W,0,3,75,75
1683344996786,SIO 45,A00,187152,Cook; Geoffrey W,1,0,100,99
1683344997811,SIO 109R,A00,194486,Staff,0,3,20,20
1683344999866,SIO 187,A01,187233,Kacev; David,12,0,40,28
1683345000892,SOCI 1,A01,258656,Thorpe; Charles Robert,28,0,30,2
1683345000892,SOCI 1,A02,258658,Thorpe; Charles Robert,30,0,30,0
1683345000892,SOCI 1,A03,258661,Thorpe; Charles Robert,25,0,25,0
1683345000892,SOCI 1,A04,258666,Thorpe; Charles Robert,22,0,25,3
1683345000892,SOCI 1,A05,258897,Thorpe; Charles Robert,23,0,25,2
1683345000892,SOCI 1,A06,258898,Thorpe; Charles Robert,25,0,25,0
1683345001919,SOCI 30,A01,258903,Pardo Guerra; Juan Pablo,15,0,30,15
1683345002943,SOCI 102,A00,258904,Staff,9,0,25,16
1683345003966,SOCI 106,A00,258905,Staff,19,0,25,6
1683345004990,SOCI 111,A00,258907,Ribas Norris; Janet Vanesa,26,0,30,4
1683345006016,SOCI 121R,A00,258908,Pardo Guerra; Juan Pablo,10,0,30,20
1683345007042,SOCI 126,A01,203330,Staff,14,0,20,6
1683345008066,SOCI 131,A00,258909,Thorpe; Charles Robert,31,0,60,29
1683345009090,SOCI 135,A00,258910,Payne; Christine Anna,0,9,30,30
1683345010115,SOCI 157,A00,258911,Staff,12,0,30,18
1683345011140,SOCI 184,A00,258912,Staff,25,0,30,5
1683345012166,SOCI 188D,A00,258913,Staff,21,0,30,9
1683345013190,SYN 2,001,187529,Staff,10,0,16,6
1683345013190,SYN 2,002,201452,Staff,0,18,16,16
1683345013190,SYN 2,003,201469,Staff,3,0,16,13
1683345014215,SYN 100,A01,187531,Staff,0,9,20,20
1683345014215,SYN 100,B01,201491,Staff,0,12,20,20
1683345015243,TDAC 1,A00,189286,Walsh; Kim C.,3,0,20,17
1683345015243,TDAC 1,B00,189287,Harting; Carla Kelso,11,0,20,9
1683345016270,TDAC 101,A00,189300,Walsh; Kim C.,16,0,20,4
1683345016270,TDAC 101,B00,189301,Harting; Carla Kelso,18,0,20,2
1683345017293,TDAC 102,A00,189304,Basso; Beatrice,14,0,20,6
1683345018322,TDAC 108,A00,189305,Staff,18,0,20,2
1683345019353,TDDE 131,A00,189310,Staff,19,0,20,1
1683345019353,TDDE 131,B00,189314,Staff,19,0,20,1
1683345019353,TDDE 131,C00,189315,Staff,48,0,50,2
1683345019353,TDDE 131,D00,189316,Staff,14,0,15,1
1683345019353,TDDE 131,E00,204841,Staff,20,0,20,0
1683345020383,TDGE 10,A00,189289,Staff,30,0,50,20
1683345020383,TDGE 10,B00,189290,Havis; Allan,1,0,50,49
1683345021407,TDGE 11,A00,189291,Fulton; Julia,0,3,50,50
1683345021407,TDGE 11,B00,189292,Staff,20,0,25,5
1683345021407,TDGE 11,C00,260270,Staff,0,0,0,0
1683345022430,TDGE 25,A00,189294,Staff,3,0,20,17
1683345023455,TDGE 124,A00,189318,Fulton; Julia,0,8,50,50
1683345024480,TDGE 125,A00,189319,Staff,13,0,25,12
1683345024480,TDGE 125,B00,189320,Staff,23,0,25,2
1683345025507,TDGE 127,A00,189322,Havis; Allan,0,0,50,50
1683345026531,TDHT 101,A00,189323,Staff,18,0,25,7
1683345026531,TDHT 101,B00,189324,Staff,25,0,25,0
1683345027556,TDHT 102,A00,189325,Staff,49,0,50,1
1683345028580,TDMV 1,A00,189295,Arcidiacono; Kristin,19,0,30,11
1683345028580,TDMV 1,B00,189296,Caligagan; Maria T.,24,0,30,6
1683345029605,TDMV 2,A00,189297,Sammartano; Tonnie,28,0,30,2
1683345029605,TDMV 2,B00,189299,Arcidiacono; Kristin,24,0,30,6
1683345030628,TDMV 3,A00,204998,Rincon; Alicia,22,0,30,8
1683345031652,TDMV 120,A00,189458,Sammartano; Tonnie,28,0,30,2
1683345032678,TDMV 138,A00,189541,Jun; Grace Shin Hae,22,0,40,18
1683345033703,TDMV 142,A00,189717,Caligagan; Tony,23,0,30,7
1683345033703,TDMV 142,B00,189718,Caligagan; Maria T.,25,0,30,5
1683345034730,TMC 2,A01,187533,Staff,25,0,25,0
1683345034730,TMC 2,A02,187534,Staff,25,0,25,0
1683345035761,USP 1,A01,187536,Kwak; Nancy,0,16,25,25
1683345036790,USP 5,A01,187538,Staff,10,0,25,15
1683345037814,USP 101,A00,199253,Staff,0,4,0,0
1683345038839,USP 124,A00,187562,Boomhower; Matthew Charles,1,0,30,29
1683345039863,USP 138,A00,187582,Staff,20,0,25,5
1683345040887,USP 152,A01,187597,Staff,4,0,25,21
1683345041913,USP 153,A00,187598,Staff,19,0,25,6
1683345042940,USP 168,A00,187607,Kwak; Nancy,2,0,5,3
1683345043967,USP 173,A00,187619,Staff,4,0,25,21
1683345044994,USP 181,A00,187638,Staff,0,0,25,25
1683345046018,VIS 103,A00,187650,Cruz; Edwin Teddy,23,0,75,52
1683345047044,VIS 110D,A00,187669,Staff,12,0,22,10
1683345048068,VIS 127C,A00,187720,Shen; Kuiyi,67,0,146,79
1683345049090,VIS 149,A00,187731,Yoldas; Pinar,0,14,22,22
1683345050117,VIS 151,A01,188091,Staff,22,0,34,12
1683345050117,VIS 151,A02,188092,Staff,11,0,34,23
1683345051141,VIS 160B,A00,188093,Stalbaum; Brett,0,0,10,10
1683345053189,WCWP 10B,A00,201720,Staff,10,0,15,5
1683345053189,WCWP 10B,B00,201722,Staff,9,0,15,6
1683345054213,WCWP 100,A00,201725,Gagnon; Jeffrey C,0,0,2,2
1683345054213,WCWP 100,B00,201727,Staff,0,4,15,15
1683345057344,ANBI 133,A00,258401,Wilder; Linnea Lorene,34,0,40,6
1683345058367,ANBI 140,A00,258395,Hrvoj Mihic; Branka,18,0,25,7
1683345059392,ANSC 120,A00,258402,Bialecki; Jon Anthony,27,0,40,13
1683345060419,ANSC 144,A00,258400,Staff,14,0,40,26
1683345062469,ANSC 166,A00,258396,Parish; Steven Martin,157,0,175,18
1683345063494,ANSC 180,A00,193533,Staff,9,0,20,11
1683345064522,ANSC 188,A00,258397,Jassal; Aftab,33,0,40,7
1683345065550,ANTH 3,A01,258316,Staff,23,0,30,7
1683345066574,ANTH 5,A00,258394,Semendeferi; Ekaterini,16,0,20,4
1683345067599,ANTH 21,A01,258331,Staff,8,0,40,32
1683345068626,ANTH 103,A00,258398,Varma; Saiba,15,0,25,10
1683345069654,AWP 10,001,202034,Staff,0,0,0,0
1683345069654,AWP 10,002,202035,Staff,0,0,0,0
1683345069654,AWP 10,003,202036,Staff,0,0,0,0
1683345069654,AWP 10,004,202037,Staff,0,0,0,0
1683345069654,AWP 10,005,202038,Staff,0,0,0,0
1683345069654,AWP 10,006,202039,Staff,0,0,0,0
1683345069654,AWP 10,007,202040,Staff,0,0,0,0
1683345069654,AWP 10,008,202041,Staff,0,0,0,0
1683345069654,AWP 10,009,202042,Staff,0,0,0,0
1683345069654,AWP 10,010,202043,Staff,0,0,0,0
1683345069654,AWP 10,011,202044,Staff,0,0,0,0
1683345069654,AWP 10,012,202045,Staff,0,0,0,0
1683345069654,AWP 10,013,202046,Staff,0,0,0,0
1683345069654,AWP 10,014,202047,Staff,0,0,0,0
1683345069654,AWP 10,015,202048,Staff,0,0,0,0
1683345069654,AWP 10,016,202049,Staff,0,0,0,0
1683345069654,AWP 10,017,202050,Staff,0,0,0,0
1683345069654,AWP 10,018,202051,Staff,0,0,0,0
1683345069654,AWP 10,019,202052,Staff,0,0,0,0
1683345069654,AWP 10,020,202053,Staff,0,0,0,0
1683345069654,AWP 10,021,202054,Staff,0,0,0,0
1683345069654,AWP 10,022,202055,Staff,0,0,0,0
1683345069654,AWP 10,023,202056,Staff,0,0,0,0
1683345069654,AWP 10,024,202057,Staff,0,0,0,0
1683345069654,AWP 10,025,202058,Staff,0,0,0,0
1683345069654,AWP 10,026,202059,Staff,0,0,0,0
1683345070681,AWP 102,001,202032,Staff,0,0,0,0
1683345070681,AWP 102,002,202033,Staff,0,0,0,0
1683345071709,BENG 100,A01,254234,Taylor Amos; Alyssa C,31,0,40,9
1683345072733,BENG 196,001,270013,Engler; Adam J.,9999,0,9999,0
1683345073757,BICD 100R,A01,202018,Smith; Laurie,0,7,32,32
1683345073757,BICD 100R,A02,202019,Smith; Laurie,0,2,32,32
1683345073757,BICD 100R,A03,202020,Smith; Laurie,0,1,32,32
1683345073757,BICD 100R,A04,202021,Smith; Laurie,9,0,32,23
1683345073757,BICD 100R,A05,202022,Smith; Laurie,12,0,32,20
1683345074783,BICD 136,A01,193242,Gustafson-Brown; Cindy,0,2,32,32
1683345074783,BICD 136,A02,193244,Gustafson-Brown; Cindy,14,0,32,18
1683345075810,BIEB 102,A01,193249,Butler; Shannon Rhey,0,2,32,32
1683345075810,BIEB 102,A02,193251,Butler; Shannon Rhey,0,0,32,32
1683345075810,BIEB 102,A03,193253,Butler; Shannon Rhey,0,1,32,32
1683345075810,BIEB 102,A04,193255,Butler; Shannon Rhey,17,0,32,15
1683345075810,BIEB 102,A05,193265,Butler; Shannon Rhey,26,0,32,6
1683345075810,BIEB 102,A06,193269,Butler; Shannon Rhey,16,0,32,16
1683345077914,BIEB 150,A01,193274,Staff,0,0,32,32
1683345077914,BIEB 150,A02,193285,Staff,23,0,32,9
1683345078939,BIEB 194,A00,193286,Kurle; Carolyn M.,22,0,32,10
1683345079964,BILD 1,A01,192291,Staff,16,0,32,16
1683345079964,BILD 1,A02,192292,Staff,30,0,32,2
1683345079964,BILD 1,B01,192520,Reuther; Keefe,0,1,0,0
1683345079964,BILD 1,B02,192532,Reuther; Keefe,0,1,0,0
1683345080990,BILD 3,A01,192556,Butler; Shannon Rhey,0,0,32,32
1683345080990,BILD 3,A02,192581,Butler; Shannon Rhey,5,0,32,27
1683345080990,BILD 3,A03,192611,Butler; Shannon Rhey,23,0,32,9
1683345080990,BILD 3,A04,192612,Butler; Shannon Rhey,25,0,32,7
1683345080990,BILD 3,A05,192613,Butler; Shannon Rhey,27,0,32,5
1683345080990,BILD 3,A06,192679,Butler; Shannon Rhey,27,0,32,5
1683345080990,BILD 3,A07,192682,Butler; Shannon Rhey,22,0,32,10
1683345082015,BILD 4,A01,192836,Reuther; Keefe,0,0,24,24
1683345082015,BILD 4,A02,193044,Reuther; Keefe,4,0,24,20
1683345083040,BILD 10,A01,193142,Gustafson-Brown; Cindy,30,0,32,2
1683345083040,BILD 10,A02,193149,Gustafson-Brown; Cindy,31,0,32,1
1683345084065,BIMM 100,A01,193301,Staff,0,6,32,32
1683345084065,BIMM 100,A02,193312,Staff,0,5,32,32
1683345084065,BIMM 100,A03,193323,Staff,0,8,32,32
1683345085090,BIMM 101,A01,193329,McDonnell; Lisa Marie,0,3,24,24
1683345085090,BIMM 101,A02,193339,McDonnell; Lisa Marie,0,3,24,24
1683345085090,BIMM 101,B01,193354,McDonnell; Lisa Marie,0,3,24,24
1683345085090,BIMM 101,B02,193357,McDonnell; Lisa Marie,0,3,24,24
1683345086126,BIMM 110,A01,193377,Tat; John,0,11,32,32
1683345086126,BIMM 110,A02,193378,Tat; John,1,9,32,31
1683345087153,BIMM 120,A01,206116,Staff,0,0,32,32
1683345087153,BIMM 120,A02,206117,Staff,8,0,32,24
1683345087153,BIMM 120,A03,206121,Staff,21,0,32,11
1683345088182,BIPN 100,A01,193393,Park; Ji Young,0,14,32,32
1683345088182,BIPN 100,A02,193402,Park; Ji Young,0,13,32,32
1683345088182,BIPN 100,A03,193413,Park; Ji Young,0,14,32,32
1683345088182,BIPN 100,A04,193414,Park; Ji Young,0,13,32,32
1683345089209,BIPN 102,A01,193429,Staff,0,0,32,32
1683345089209,BIPN 102,A02,193438,Staff,22,0,32,10
1683345090237,BIPN 106,A01,193450,Reyes Gonzalez; Catalina,0,2,40,40
1683345091260,BIPN 134,A01,193465,Cooke; James Edward,0,0,32,32
1683345091260,BIPN 134,A02,193474,Cooke; James Edward,25,0,32,7
1683345091260,BIPN 134,A03,193485,Cooke; James Edward,29,0,32,3
1683345091260,BIPN 134,A04,193486,Cooke; James Edward,21,0,32,11
1683345091260,BIPN 134,A05,193491,Cooke; James Edward,31,0,32,1
1683345091260,BIPN 134,A06,193501,Cooke; James Edward,30,0,32,2
1683345091260,BIPN 134,A07,193510,Cooke; James Edward,29,0,32,3
1683345093307,BISP 194,A00,222522,Staff,14,0,32,18
1683345094332,CAT 124,A01,202407,Staff,20,0,25,5
1683345095358,CAT 125,A00,202408,Marchisotto; Jennifer Anne,4,0,20,16
1683345096384,CAT 125R,A00,202409,Smith; Lauryn Alissa,0,11,20,20
1683345096384,CAT 125R,B00,202410,Morales; Celeste Georgianna,0,11,20,20
1683345096384,CAT 125R,C00,202411,Irwin; Matthew Joseph,0,10,20,20
1683345097412,CENG 15,A01,204712,Yang; Kesong,0,1,0,0
1683345098440,CENG 114,A00,202070,Jahed Motlagh; Zeinab,5,0,20,15
1683345099464,CGS 105,A00,185477,Wesling; Megan E.,24,0,40,16
1683345100490,CGS 106,A00,185494,Staff,13,0,22,9
1683345101518,CGS 108,A00,185495,Staff,14,0,20,6
1683345102543,CGS 114,A00,185496,Staff,13,0,18,5
1683345103568,CGS 119,A00,185501,Staff,15,0,20,5
1683345104595,CGS 120,A00,185511,Staff,13,0,20,7
1683345105623,CHEM 4,A01,184675,Bussey; Thomas J,96,0,100,4
1683345106652,CHEM 6A,A01,184677,Staff,34,0,60,26
1683345107680,CHEM 6B,A01,184679,Staff,65,0,100,35
1683345108707,CHEM 6C,A01,184681,Bussey; Thomas J,1,0,50,49
1683345108707,CHEM 6C,A02,184682,Bussey; Thomas J,34,0,50,16
1683345109731,CHEM 40A,A01,184684,Albizati; Kim F.,37,0,100,63
1683345110759,CHEM 40B,A01,184686,Albizati; Kim F.,0,20,100,100
1683345111783,CHEM 41B,A01,184690,Staff,52,0,100,48
1683345112808,COGS 3,A01,184715,Boyle; Mary E. T.,0,25,40,40
1683345113835,COGS 14B,A01,185172,Staff,0,15,38,38
1683345114859,COGS 18,A01,184736,Staff,17,0,80,63
1683345115890,COGS 100,A01,184932,Staff,0,5,73,73
1683345116914,COGS 101A,A01,184935,Staff,0,39,30,30
1683345117942,COGS 101B,A01,184944,Staff,0,2,30,30
1683345118966,COGS 101C,A01,184946,Staff,0,12,30,30
1683345119992,COGS 102A,A01,184951,Johnson; Christine M.,2,0,40,38
1683345121017,COGS 107B,A01,184953,Mooshagian; Eric Frederick,0,50,40,40
1683345122041,COGS 118B,A01,184959,Gupta; Anjum,0,48,40,40
1683345123065,COGS 153,A00,184961,Staff,0,15,30,30
1683345124088,COGS 177,A00,184962,Staff,0,20,30,30
1683345125116,COGS 187A,A01,184969,Boyle; Mary E. T.,0,17,40,40
1683345126141,COMM 10,A01,185174,Staff,0,5,25,25
1683345126141,COMM 10,A02,185189,Staff,0,5,25,25
1683345126141,COMM 10,A03,269821,Staff,0,0,0,0
1683345127167,COMM 100B,A01,185475,Staff,0,0,0,2
1683345127167,COMM 100B,A02,185476,Staff,13,0,25,12
1683345128195,COMM 100C,A01,185314,Staff,1,0,25,24
1683345128195,COMM 100C,A02,185327,Staff,19,0,25,6
1683345129222,COMM 110M,A00,185349,Staff,2,0,40,38
1683345130248,COMM 113T,A00,185352,Staff,24,0,40,16
1683345131278,COMM 114I,A00,185353,Staff,33,0,40,7
1683345132302,COMM 131,A00,185354,Staff,19,0,30,11
1683345133330,CSE 8A,A50,185358,Cao; Yingjun,0,46,10,10
1683345134359,CSE 8B,A01,185362,Staff,1,47,50,49
1683345135388,CSE 11,A01,185416,Cao; Yingjun,0,92,10,10
1683345136411,CSE 20,A01,185445,Briones; Jor-el Thomas Caparas,5,0,25,20
1683345137438,CSE 21,A01,185447,Staff,10,0,50,40
1683345138467,CSE 101,A01,185451,Staff,0,13,50,50
1683345138467,CSE 101,B01,185453,Jones; Miles E,0,11,50,50
1683345140520,CSE 141,A01,185458,Eldon; John,20,0,100,80
1683345141545,CSE 141L,A01,185461,Eldon; John,12,0,100,88
1683345142575,CSE 142,A01,185463,Staff,36,0,60,24
1683345142575,CSE 142,B01,201355,Staff,0,7,60,60
1683345143599,CSE 142L,A01,185470,Staff,36,0,60,24
1683345143599,CSE 142L,B01,201417,Staff,0,6,60,60
1683345144624,CSE 190,A00,201433,Staff,32,0,49,17
1683345145648,DOC 1,A01,259136,Strom; Megan C.,7,0,15,8
1683345145648,DOC 1,A02,259137,Strom; Megan C.,14,0,15,1
1683345145648,DOC 1,A03,259138,Strom; Megan C.,14,0,15,1
1683345145648,DOC 1,A04,259139,Strom; Megan C.,14,0,15,1
1683345146675,DOC 100D,A00,259140,Pass; Natalye Joann,16,0,25,9
1683345147698,DSGN 1,A01,184749,Rill; Bryan,0,25,30,30
1683345148726,DSGN 100,A01,185168,Staff,0,2,25,25
1683345149750,ECE 5,A01,185626,Morris; Karcher William,0,10,0,0
1683345150775,ECE 101,A01,185628,Staff,17,0,70,53
1683345151802,ECE 107,A01,185635,Baghdadchi; Saharnaz,0,0,20,20
1683345151802,ECE 107,A02,185638,Baghdadchi; Saharnaz,4,0,20,16
1683345152830,ECE 148,A01,185647,Silberman; Jack,0,0,16,16
1683345153855,ECON 1,A01,185537,Crane; Meredith Helen,54,0,70,16
1683345154881,ECON 3,A01,185549,Crane; Meredith Helen,32,0,70,38
1683345155906,ECON 4,A01,203354,Anderson; John Charles,0,4,10,10
1683345156932,ECON 100A,A01,185574,Staff,0,4,40,40
1683345157956,ECON 100B,A01,185576,Staff,10,22,50,40
1683345158981,ECON 100C,A01,185589,Newhouse; Herbert S,29,0,70,41
1683345160004,ECON 105,A00,185608,Vespa; Emanuel Ignacio,19,0,35,16
1683345161028,ECON 109,A01,185610,Shishkin; Denis,10,0,35,25
1683345162052,ECON 110A,A01,185612,Staff,11,0,40,29
1683345163074,ECON 120A,A01,185615,Staff,20,0,40,20
1683345164098,ECON 120C,A01,185617,Sun; Yixiao,0,20,70,70
1683345165122,ECON 144,A00,203346,Squires; Dale E,3,0,35,32
1683345166147,ECON 171,A01,203349,Newhouse; Herbert S,0,1,35,35
1683345167172,ECON 173A,A01,185621,Toda; Alexis Akira,21,0,35,14
1683345168202,EDS 25,A01,202413,Staff,0,1,0,0
1683345168202,EDS 25,A02,202414,Staff,0,1,0,0
1683345168202,EDS 25,A03,202415,Staff,0,0,0,0
1683345168202,EDS 25,A04,202416,Staff,0,1,0,0
1683345168202,EDS 25,A05,202439,Staff,0,0,0,0
1683345168202,EDS 25,A06,202440,Staff,0,0,0,0
1683345168202,EDS 25,B01,202631,Staff,0,0,0,0
1683345168202,EDS 25,B02,202632,Staff,0,0,0,0
1683345168202,EDS 25,B03,202639,Staff,0,0,0,0
1683345168202,EDS 25,B04,202640,Staff,0,0,0,0
1683345168202,EDS 25,B05,202643,Staff,0,0,0,0
1683345168202,EDS 25,B06,202644,Staff,0,0,0,0
1683345169224,EDS 38,A01,202659,Black; Alison Michelle,24,0,25,1
1683345170249,EDS 115,A00,202652,Staff,18,0,30,12
1683345171276,EDS 125,A00,202649,Staff,14,0,30,16
1683345172305,EDS 126,A01,203332,Staff,30,0,30,0
1683345173332,EDS 139,A00,202838,Staff,16,0,25,9
1683345174362,EDS 146,A01,202655,Staff,14,0,25,11
1683345175391,ENG 15,A00,185667,Staff,0,1,0,0
1683345175391,ENG 15,B00,185672,Staff,0,0,0,0
1683345175391,ENG 15,C00,185675,Staff,0,0,0,0
1683345175391,ENG 15,D00,185682,Staff,0,0,0,0
1683345175391,ENG 15,E00,185684,Staff,0,0,0,0
1683345176417,ETHN 103,A00,185710,Staff,0,4,35,35
1683345177441,ETHN 103A,A00,199228,Man; Simeon S,2,0,9,7
1683345178468,ETHN 109,A00,185711,Staff,18,0,35,17
1683345179496,ETHN 142,A00,185726,Staff,0,4,30,30
1683345180597,ETHN 163J,A00,199229,Man; Simeon S,5,0,8,3
1683345181623,ETHN 168,A00,185727,Staff,8,0,10,2
1683345182650,ETHN 182,A00,185728,Staff,1,0,35,34
1683345183675,ETHN 183,A00,185737,Staff,8,0,18,10
1683345184700,GLBH 111,A01,209361,Burgos; Jose L.,0,0,0,0
1683345186748,HIEU 104,A00,185792,Staff,16,0,20,4
1683345187772,HIEU 115,A00,185800,Staff,1,0,20,19
1683345188797,HIEU 128,A00,185801,Staff,0,7,20,20
1683345189822,HIEU 147,A00,185802,Staff,16,0,20,4
1683345190847,HIEU 154,A00,185823,Staff,12,0,20,8
1683345191871,HILA 102,A00,185826,Staff,13,0,20,7
1683345192893,HILD 2C,A01,185778,Staff,0,12,20,20
1683345193922,HILD 7B,A01,185780,Kwak; Nancy,0,15,32,32
1683345193922,HILD 7B,A02,185781,Kwak; Nancy,0,18,32,32
1683345194949,HILD 30,A01,185791,Staff,14,0,20,6
1683345195976,HISC 119,A00,185830,Golan; Tal,0,9,20,20
1683345197004,HITO 156GS,A00,185831,Patterson; Patrick H.,0,0,0,23
1683345198027,HIUS 103,A00,185832,Man; Simeon S,0,6,20,20
1683345199055,HIUS 117,A00,185836,Kwak; Nancy,2,0,20,18
1683345200080,HIUS 125,A00,185840,Man; Simeon S,0,0,23,23
1683345201105,HIUS 149,A00,185845,Staff,0,0,20,20
1683345202128,HUM 3,A01,185882,Zavodny; Tatiana Sophia,0,7,50,50
1683345202128,HUM 3,B01,185899,Caldwell; Michael Alan,0,18,50,50
1683345203153,HUM 3GS,A00,185900,Patterson; Patrick H.,0,0,0,23
1683345204183,HUM 4,A01,185938,Zroka; Amy Liane,31,0,50,19
1683345204183,HUM 4,B01,185956,Watkins; Eric,0,2,50,50
1683345204183,HUM 4,B02,202209,Watkins; Eric,0,2,50,50
1683345204183,HUM 4,B03,202210,Watkins; Eric,0,2,50,50
1683345205211,HUM 5,A01,185958,West; Geoffrey Scott,3,0,50,47
1683345205211,HUM 5,A02,202215,West; Geoffrey Scott,0,0,50,50
1683345206238,INTL 190,A00,185959,Gagnon; Jeffrey C,0,0,0,9
1683345206238,INTL 190,B00,185960,Lettieri; Michael Joseph,0,0,0,1
1683345207264,JAPN 180,A00,254509,Staff,5,1,30,25
1683345208287,LATI 10,A01,202853,Kennemore; Amy Michelle,4,0,35,31
1683345208287,LATI 10,A02,202854,Kennemore; Amy Michelle,2,0,35,33
1683345208287,LATI 10,A03,270054,Kennemore; Amy Michelle,30,0,30,0
1683345209317,LATI 180,A00,202855,Kennemore; Amy Michelle,11,0,20,9
1683345210344,LAWS 101,A00,201767,Golan; Tal,0,7,40,40
1683345211369,LIFR 1C,A00,185961,Staff,6,0,20,14
1683345212393,LIFR 1CX,A00,185962,Staff,7,0,20,13
1683345213418,LIFR 1D,A00,185963,Staff,9,0,20,11
1683345214442,LIFR 1DX,A00,185964,Staff,9,0,20,11
1683345215470,LIGN 101,A01,186039,Staff,43,0,50,7
1683345216494,LIGN 165,A00,186040,Staff,18,0,50,32
1683345217519,LTCS 108,A00,186041,Staff,6,0,10,4
1683345218543,LTCS 119,A00,186042,Staff,16,0,20,4
1683345219569,LTCS 130,A00,186043,Wesling; Megan E.,15,0,25,10
1683345221620,LTEA 138,A00,186119,Staff,14,0,40,26
1683345222647,LTEN 124,A00,186148,Staff,6,0,25,19
1683345223675,LTEN 178,A00,186149,Staff,7,0,15,8
1683345224702,LTEN 181,A00,186150,Blanco; John D,33,0,40,7
1683345225730,LTWL 120,A00,186160,Staff,20,0,25,5
1683345226753,LTWL 165,A00,186161,Staff,22,0,25,3
1683345227777,LTWR 100,A00,186162,Staff,0,5,15,15
1683345228800,LTWR 102,A00,186163,Doller; Ben,5,0,15,10
1683345229828,MAE 8,A01,186412,Staff,0,0,0,0
1683345230853,MAE 30B,A00,186445,Bahadori; Mohammad Yousef,83,0,100,17
1683345231878,MAE 40,A00,186592,Bewley; Thomas R,9,0,50,41
1683345232902,MAE 101B,A00,186593,Bahadori; Mohammad Yousef,81,0,100,19
1683345233929,MAE 105,A00,186594,Bandaru; Prabhakar,12,0,50,38
1683345234957,MAE 107,A00,186599,Pham; Hieu Tan,0,6,120,120
1683345235986,MAE 148,A01,186660,Silberman; Jack,3,0,16,13
1683345237013,MATH 10A,A01,188095,Staff,1,6,35,34
1683345238038,MATH 10B,A01,188097,Bowers; Adam R.,0,11,30,30
1683345238038,MATH 10B,A02,188099,Bowers; Adam R.,0,11,30,30
1683345238038,MATH 10B,B01,188104,Bowers; Adam R.,0,10,30,30
1683345238038,MATH 10B,B02,188106,Bowers; Adam R.,0,10,30,30
1683345239064,MATH 10C,A01,188111,Staff,0,18,30,30
1683345239064,MATH 10C,A02,188127,Staff,0,17,30,30
1683345239064,MATH 10C,A03,188131,Staff,0,18,30,30
1683345239064,MATH 10C,B01,188218,Staff,18,0,30,12
1683345239064,MATH 10C,B02,188244,Staff,13,0,30,17
1683345239064,MATH 10C,B03,188277,Staff,16,0,30,14
1683345240088,MATH 18,A01,188344,Bach; Quang Tran,18,0,30,12
1683345240088,MATH 18,A02,188345,Bach; Quang Tran,11,0,30,19
1683345240088,MATH 18,B01,188353,Bach; Quang Tran,10,0,30,20
1683345240088,MATH 18,B02,188354,Bach; Quang Tran,20,0,30,10
1683345241116,MATH 20A,A01,188374,Staff,13,0,35,22
1683345242146,MATH 20B,A01,188382,Ohm; Ko Woon,6,0,30,24
1683345242146,MATH 20B,A02,188383,Ohm; Ko Woon,22,0,30,8
1683345242146,MATH 20B,B01,188385,Ohm; Ko Woon,7,0,30,23
1683345242146,MATH 20B,B02,188392,Ohm; Ko Woon,22,0,30,8
1683345243171,MATH 20C,A01,188394,Harel; Guershon,10,0,30,20
1683345243171,MATH 20C,A02,188395,Harel; Guershon,15,0,30,15
1683345243171,MATH 20C,B01,188404,Harel; Guershon,5,0,30,25
1683345243171,MATH 20C,B02,188405,Harel; Guershon,19,0,30,11
1683345244196,MATH 20D,A01,188414,Hammock; Frances H,0,1,30,30
1683345244196,MATH 20D,A02,188415,Hammock; Frances H,3,0,30,27
1683345244196,MATH 20D,B01,188447,Hammock; Frances H,1,0,30,29
1683345244196,MATH 20D,B02,188486,Hammock; Frances H,8,0,30,22
1683345245225,MATH 20E,A01,188649,Staff,21,0,30,9
1683345245225,MATH 20E,A02,188650,Staff,23,0,30,7
1683345245225,MATH 20E,A03,188673,Staff,0,0,30,30
1683345246252,MATH 102,A01,188675,Staff,0,35,35,35
1683345247281,MATH 103B,A01,188681,Staff,3,0,35,32
1683345247281,MATH 103B,B01,188692,Staff,5,0,35,30
1683345248308,MATH 109,A01,188695,Salehi Golsefidy; Alireza,25,0,35,10
1683345248308,MATH 109,A02,188696,Salehi Golsefidy; Alireza,25,0,35,10
1683345249332,MATH 120A,A01,188698,Eggers; John Dietrich,7,0,35,28
1683345250360,MATH 142B,A01,188736,Ioana; Adrian,0,2,30,30
1683345250360,MATH 142B,A02,188741,Ioana; Adrian,1,1,30,29
1683345250360,MATH 142B,A03,188743,Ioana; Adrian,1,3,30,29
1683345251389,MATH 168A,A01,188790,Staff,0,9,35,35
1683345252419,MATH 170A,A01,188803,Nie; Jiawang,0,2,35,35
1683345252419,MATH 170A,A02,188811,Nie; Jiawang,0,0,35,35
1683345252419,MATH 170A,A03,188814,Nie; Jiawang,1,0,35,34
1683345252419,MATH 170A,A04,188815,Nie; Jiawang,13,0,35,22
1683345253447,MATH 193B,A01,188817,Staff,0,0,35,35
1683345253447,MATH 193B,A02,188818,Staff,5,0,35,30
1683345254471,MGT 4,A01,202857,Anderson; John Charles,62,0,80,18
1683345255495,MGT 12,A00,202858,Lindenberger; Wade Douglas,42,0,90,48
1683345256520,MGT 18,A00,202859,Staff,74,0,90,16
1683345257544,MGT 18GS,A00,202860,McKay; Michael J,13,0,28,15
1683345258568,MGT 45,A00,202861,Pecore; Joseph P.,14,0,90,76
1683345259593,MGT 100,A00,202863,Yavorsky; Daniel Ryan,28,0,90,62
1683345260616,MGT 103,A00,202864,Ehrich; Kristine R,1,18,90,89
1683345261640,MGT 112,A00,202865,Ehrich; Kristine R,15,0,90,75
1683345262664,MGT 121A,A00,202868,Staff,0,20,0,0
1683345263688,MGT 131B,A00,202869,Anderson; John Charles,59,0,90,31
1683345264712,MGT 136,A00,202871,Lindenberger; Wade Douglas,84,0,90,6
1683345265738,MGT 164,A00,202873,Staff,0,68,90,91
1683345266763,MGT 164GS,A00,202874,McKay; Mary A,13,0,28,15
1683345267786,MGT 180,A00,202875,Staff,0,50,90,91
1683345268808,MMW 11R,A01,205019,Herbst; Matthew,3,0,30,27
1683345268808,MMW 11R,A02,205026,Herbst; Matthew,29,0,30,1
1683345269838,MMW 15,A01,193512,Chang; Edmond Yi-Teh,0,9,28,28
1683345269838,MMW 15,A02,193513,Chang; Edmond Yi-Teh,0,5,28,28
1683345269838,MMW 15,A03,193514,Chang; Edmond Yi-Teh,0,5,28,28
1683345269838,MMW 15,A04,193515,Chang; Edmond Yi-Teh,0,5,28,28
1683345269838,MMW 15,A05,193516,Chang; Edmond Yi-Teh,0,4,28,28
1683345269838,MMW 15,A06,193517,Chang; Edmond Yi-Teh,0,5,28,28
1683345269838,MMW 15,B01,193519,Chang; Edmond Yi-Teh,0,5,28,28
1683345269838,MMW 15,B02,193520,Chang; Edmond Yi-Teh,0,5,28,28
1683345269838,MMW 15,B03,193521,Chang; Edmond Yi-Teh,0,5,28,28
1683345269838,MMW 15,B04,193522,Chang; Edmond Yi-Teh,0,4,28,28
1683345269838,MMW 15,B05,193523,Chang; Edmond Yi-Teh,0,5,28,28
1683345269838,MMW 15,B06,193524,Chang; Edmond Yi-Teh,0,4,28,28
1683345270863,MMW 122,A01,193526,Rahimi; Babak,0,15,28,28
1683345270863,MMW 122,A02,193527,Rahimi; Babak,0,14,28,28
1683345270863,MMW 122,A03,193528,Rahimi; Babak,0,0,0,0
1683345270863,MMW 122,A04,193529,Rahimi; Babak,0,0,0,0
1683345271893,MUS 1A,A01,186663,Staff,0,20,35,35
1683345272920,MUS 4,A01,186715,Staff,0,12,35,35
1683345273948,MUS 5R,A01,186796,Dubnov; Shlomo,0,17,35,35
1683345274976,MUS 6,A01,186798,Staff,0,4,25,25
1683345276003,MUS 7,A01,186830,Staff,13,0,35,22
1683345277028,MUS 8,A01,186930,Staff,0,26,35,35
1683345278053,MUS 15,A01,186932,Staff,0,16,35,35
1683345278053,MUS 15,B01,186934,Staff,0,15,35,35
1683345279081,MUS 80,A00,186935,Staff,1,0,20,19
1683345279081,MUS 80,B00,186936,Staff,25,0,25,0
1683345280107,NANO 11,A00,204702,Lipomi; Darren John,0,0,0,0
1683345281134,NANO 15,A01,204709,Yang; Kesong,0,1,0,0
1683345282158,NANO 114,A00,202069,Jahed Motlagh; Zeinab,3,0,10,7
1683345283182,PHIL 1,A00,186955,Grush; Rick Scott,32,0,40,8
1683345284265,PHIL 10,A01,186973,Grush; Rick Scott,28,0,35,7
1683345284265,PHIL 10,A02,186974,Grush; Rick Scott,33,0,35,2
1683345285289,PHIL 13,A01,186976,Staff,7,0,35,28
1683345285289,PHIL 13,A02,186977,Staff,16,0,35,19
1683345286314,PHIL 14,A01,186979,Staff,31,0,35,4
1683345286314,PHIL 14,A02,186986,Staff,32,0,35,3
1683345287342,PHIL 28,A01,186988,Staff,16,0,30,14
1683345287342,PHIL 28,A02,186989,Staff,1,0,30,29
1683345287342,PHIL 28,A03,186990,Staff,9,0,30,21
1683345287342,PHIL 28,A04,186991,Staff,26,0,30,4
1683345288367,PHIL 120,A00,186997,Staff,23,0,40,17
1683345289391,PHIL 137,A00,187003,Staff,9,0,40,31
1683345290414,PHIL 150,A00,187015,Staff,47,0,70,23
1683345291438,PHIL 167,A00,187021,Lamey; Andy M.,35,0,40,5
1683345292465,PHIL 174,A01,202226,Staff,17,0,20,3
1683345292465,PHIL 174,A02,202235,Staff,20,0,20,0
1683345293492,PHIL 191A,A00,258918,Staff,0,0,1,1
1683345294520,PHYS 1A,A00,187028,Staff,27,0,60,33
1683345295547,PHYS 1AL,001,187036,Staff,2,0,30,28
1683345295547,PHYS 1AL,002,187049,Staff,18,0,30,12
1683345296571,PHYS 1B,A00,187058,Staff,22,0,60,38
1683345297596,PHYS 1BL,001,187064,Staff,0,0,30,30
1683345297596,PHYS 1BL,002,187070,Staff,5,0,30,25
1683345298619,PHYS 1C,A00,187082,Staff,31,0,120,89
1683345299648,PHYS 1CL,001,187088,Staff,0,9,30,30
1683345299648,PHYS 1CL,002,187089,Staff,0,2,30,30
1683345299648,PHYS 1CL,009,262693,Staff,11,0,30,19
1683345300675,PHYS 2B,A01,187097,Staff,54,0,115,61
1683345301703,PHYS 2C,A01,187099,Staff,67,0,115,48
1683345302730,PHYS 2CL,A01,187101,Staff,5,0,28,23
1683345302730,PHYS 2CL,A02,187102,Staff,15,0,28,13
1683345303754,PHYS 2D,A01,187123,Shotwell; Brian,95,0,115,20
1683345304778,PHYS 4B,A01,187133,Grinstein; Benjamin,35,0,50,15
1683345305802,POLI 10,A00,188819,Staff,0,4,50,50
1683345306828,POLI 11,A00,188827,Staff,43,0,50,7
1683345307851,POLI 13R,A00,188828,Staff,0,1,20,20
1683345308874,POLI 27,A01,188830,Elgin; Samuel Zincke,0,1,70,70
1683345309902,POLI 30,A00,188832,Desposato; Scott,31,0,50,19
1683345310924,POLI 102F,A00,188834,Staff,3,0,40,37
1683345311951,POLI 104A,A00,188852,Staff,14,0,30,16
1683345312976,POLI 104I,A00,188853,Staff,0,6,20,20
1683345314001,POLI 110B,A00,188854,Wiens; David,7,0,20,13
1683345315024,POLI 112A,A00,188855,Wiens; David,5,0,30,25
1683345316048,POLI 117R,A00,188856,Forman; Fonna,0,11,20,20
1683345317083,POLI 118,A00,188857,Ingham; Sean,8,0,20,12
1683345318109,POLI 120G,A00,188858,Staff,9,0,30,21
1683345319135,POLI 131CR,A00,188863,Hoston; Germaine,24,0,50,26
1683345320161,POLI 133,A00,188864,Nellis; Gareth Hb,44,0,50,6
1683345321185,POLI 134D,A00,188865,Desposato; Scott,27,0,30,3
1683345322212,POLI 142A,A00,188871,Gartzke; Erik,22,0,50,28
1683345323235,POLI 142K,A00,188874,Staff,38,0,50,12
1683345324259,POLI 143,A00,188940,Gartzke; Erik,16,0,30,14
1683345325282,POLI 153,A00,188943,Staff,3,0,20,17
1683345326309,POLI 160AA,A00,188944,Staff,12,0,40,28
1683345327334,POLI 170A,A00,188945,Staff,11,0,30,19
1683345329382,PSYC 1,A00,188952,Staff,37,0,90,53
1683345330404,PSYC 2,B00,188953,Staff,19,0,35,16
1683345331427,PSYC 6,A00,188970,Staff,47,0,60,13
1683345332450,PSYC 7,A00,188973,Staff,37,0,45,8
1683345333480,PSYC 60,A01,188980,Rickard; Timothy C.,43,0,60,17
1683345334504,PSYC 70,A01,189001,Steiner; Eric Tomas,23,0,45,22
1683345335532,PSYC 100,A00,189005,Lacefield; Katharine I,0,98,120,120
1683345336556,PSYC 102,A00,189008,Staff,9,0,30,21
1683345337579,PSYC 106,B00,189026,Gorman; Michael R.,34,0,60,26
1683345338604,PSYC 114,B01,189033,Winkielman; Piotr,0,32,30,30
1683345339628,PSYC 131,A00,189036,Anagnostaras; Stephan,0,43,60,60
1683345340652,PSYC 136,A00,189041,Lowe; Angela Beth,0,7,25,25
1683345341679,PSYC 137,A00,189057,Winkielman; Piotr,0,34,25,25
1683345342704,PSYC 144,A00,189107,Wixted; John T,0,7,50,50
1683345344750,PSYC 162,A00,189142,Staff,0,8,85,85
1683345345774,PSYC 172,A00,189144,Gorman; Michael R.,0,7,30,30
1683345347822,PSYC 179,A00,189146,Lacefield; Katharine I,0,84,120,120
1683345348849,PSYC 181,A00,189147,Anagnostaras; Stephan,0,44,90,90
1683345349876,PSYC 190R,A00,189148,Barner; David A.,0,22,80,80
1683345350904,PSYC 191,A00,189275,Rickard; Timothy C.,0,7,25,25
1683345351930,PSYC 193,A00,189276,Chapman; Eddie Nathaniel,0,1,0,4
1683345352955,PSYC 193L,A01,189281,Lowe; Angela Beth,12,0,20,8
1683345352955,PSYC 193L,B01,189285,Staff,28,0,35,7
1683345353980,RELI 149,A00,187137,Rahimi; Babak,7,0,40,33
1683345355003,SE 9,A01,187315,Staff,0,2,18,18
1683345356031,SE 101B,A00,187409,Staff,24,0,30,6
1683345357056,SE 110B,A00,187444,Staff,10,0,40,30
1683345358083,SE 130B,A00,187449,Staff,31,0,40,9
1683345359111,SE 150A,A00,187516,Staff,9,0,20,11
1683345360136,SE 154,A00,187528,Staff,30,0,50,20
1683345361164,SIO 3,A01,258171,Staff,35,0,40,5
1683345362190,SIO 10,A00,187144,Cook; Geoffrey W,0,3,75,75
1683345363218,SIO 45,A00,187152,Cook; Geoffrey W,1,0,100,99
1683345364245,SIO 109R,A00,194486,Staff,0,3,20,20
1683345366292,SIO 187,A01,187233,Kacev; David,12,0,40,28
1683345367317,SOCI 1,A01,258656,Thorpe; Charles Robert,28,0,30,2
1683345367317,SOCI 1,A02,258658,Thorpe; Charles Robert,30,0,30,0
1683345367317,SOCI 1,A03,258661,Thorpe; Charles Robert,25,0,25,0
1683345367317,SOCI 1,A04,258666,Thorpe; Charles Robert,22,0,25,3
1683345367317,SOCI 1,A05,258897,Thorpe; Charles Robert,23,0,25,2
1683345367317,SOCI 1,A06,258898,Thorpe; Charles Robert,25,0,25,0
1683345368342,SOCI 30,A01,258903,Pardo Guerra; Juan Pablo,15,0,30,15
1683345369367,SOCI 102,A00,258904,Staff,9,0,25,16
1683345370394,SOCI 106,A00,258905,Staff,19,0,25,6
1683345371418,SOCI 111,A00,258907,Ribas Norris; Janet Vanesa,26,0,30,4
1683345372442,SOCI 121R,A00,258908,Pardo Guerra; Juan Pablo,10,0,30,20
1683345373470,SOCI 126,A01,203330,Staff,14,0,20,6
1683345374496,SOCI 131,A00,258909,Thorpe; Charles Robert,31,0,60,29
1683345375523,SOCI 135,A00,258910,Payne; Christine Anna,0,9,30,30
1683345376548,SOCI 157,A00,258911,Staff,12,0,30,18
1683345377576,SOCI 184,A00,258912,Staff,25,0,30,5
1683345378604,SOCI 188D,A00,258913,Staff,21,0,30,9
1683345379632,SYN 2,001,187529,Staff,10,0,16,6
1683345379632,SYN 2,002,201452,Staff,0,18,16,16
1683345379632,SYN 2,003,201469,Staff,3,0,16,13
1683345380661,SYN 100,A01,187531,Staff,0,9,20,20
1683345380661,SYN 100,B01,201491,Staff,0,12,20,20
1683345381689,TDAC 1,A00,189286,Walsh; Kim C.,3,0,20,17
1683345381689,TDAC 1,B00,189287,Harting; Carla Kelso,11,0,20,9
1683345382718,TDAC 101,A00,189300,Walsh; Kim C.,16,0,20,4
1683345382718,TDAC 101,B00,189301,Harting; Carla Kelso,18,0,20,2
1683345383741,TDAC 102,A00,189304,Basso; Beatrice,14,0,20,6
1683345384766,TDAC 108,A00,189305,Staff,18,0,20,2
1683345385791,TDDE 131,A00,189310,Staff,19,0,20,1
1683345385791,TDDE 131,B00,189314,Staff,19,0,20,1
1683345385791,TDDE 131,C00,189315,Staff,48,0,50,2
1683345385791,TDDE 131,D00,189316,Staff,14,0,15,1
1683345385791,TDDE 131,E00,204841,Staff,20,0,20,0
1683345386816,TDGE 10,A00,189289,Staff,30,0,50,20
1683345386816,TDGE 10,B00,189290,Havis; Allan,1,0,50,49
1683345387895,TDGE 11,A00,189291,Fulton; Julia,0,3,50,50
1683345387895,TDGE 11,B00,189292,Staff,20,0,25,5
1683345387895,TDGE 11,C00,260270,Staff,0,0,0,0
1683345388920,TDGE 25,A00,189294,Staff,3,0,20,17
1683345389947,TDGE 124,A00,189318,Fulton; Julia,0,8,50,50
1683345390976,TDGE 125,A00,189319,Staff,13,0,25,12
1683345390976,TDGE 125,B00,189320,Staff,23,0,25,2
1683345392001,TDGE 127,A00,189322,Havis; Allan,0,0,50,50
1683345393026,TDHT 101,A00,189323,Staff,18,0,25,7
1683345393026,TDHT 101,B00,189324,Staff,25,0,25,0
1683345394050,TDHT 102,A00,189325,Staff,49,0,50,1
1683345395078,TDMV 1,A00,189295,Arcidiacono; Kristin,19,0,30,11
1683345395078,TDMV 1,B00,189296,Caligagan; Maria T.,24,0,30,6
1683345396105,TDMV 2,A00,189297,Sammartano; Tonnie,28,0,30,2
1683345396105,TDMV 2,B00,189299,Arcidiacono; Kristin,24,0,30,6
1683345397131,TDMV 3,A00,204998,Rincon; Alicia,22,0,30,8
1683345398158,TDMV 120,A00,189458,Sammartano; Tonnie,28,0,30,2
1683345399185,TDMV 138,A00,189541,Jun; Grace Shin Hae,22,0,40,18
1683345400220,TDMV 142,A00,189717,Caligagan; Tony,23,0,30,7
1683345400220,TDMV 142,B00,189718,Caligagan; Maria T.,25,0,30,5
1683345401247,TMC 2,A01,187533,Staff,25,0,25,0
1683345401247,TMC 2,A02,187534,Staff,25,0,25,0
1683345402272,USP 1,A01,187536,Kwak; Nancy,0,16,25,25
1683345403299,USP 5,A01,187538,Staff,10,0,25,15
1683345404326,USP 101,A00,199253,Staff,0,4,0,0
1683345405348,USP 124,A00,187562,Boomhower; Matthew Charles,1,0,30,29
1683345406373,USP 138,A00,187582,Staff,20,0,25,5
1683345407401,USP 152,A01,187597,Staff,4,0,25,21
1683345408426,USP 153,A00,187598,Staff,19,0,25,6
1683345409455,USP 168,A00,187607,Kwak; Nancy,2,0,5,3
1683345410484,USP 173,A00,187619,Staff,4,0,25,21
1683345411508,USP 181,A00,187638,Staff,0,0,25,25
1683345412535,VIS 103,A00,187650,Cruz; Edwin Teddy,23,0,75,52
1683345413559,VIS 110D,A00,187669,Staff,12,0,22,10
1683345414583,VIS 127C,A00,187720,Shen; Kuiyi,67,0,146,79
1683345415607,VIS 149,A00,187731,Yoldas; Pinar,0,14,22,22
1683345416632,VIS 151,A01,188091,Staff,22,0,34,12
1683345416632,VIS 151,A02,188092,Staff,11,0,34,23
1683345417657,VIS 160B,A00,188093,Stalbaum; Brett,0,0,10,10
1683345419711,WCWP 10B,A00,201720,Staff,10,0,15,5
1683345419711,WCWP 10B,B00,201722,Staff,9,0,15,6
1683345420739,WCWP 100,A00,201725,Gagnon; Jeffrey C,0,0,2,2
1683345420739,WCWP 100,B00,201727,Staff,0,4,15,15
1683345423869,ANBI 133,A00,258401,Wilder; Linnea Lorene,34,0,40,6
1683345424898,ANBI 140,A00,258395,Hrvoj Mihic; Branka,18,0,25,7
1683345425922,ANSC 120,A00,258402,Bialecki; Jon Anthony,27,0,40,13
1683345426948,ANSC 144,A00,258400,Staff,14,0,40,26
1683345429001,ANSC 166,A00,258396,Parish; Steven Martin,157,0,175,18
1683345430031,ANSC 180,A00,193533,Staff,9,0,20,11
1683345431055,ANSC 188,A00,258397,Jassal; Aftab,33,0,40,7
1683345432087,ANTH 3,A01,258316,Staff,23,0,30,7
1683345433112,ANTH 5,A00,258394,Semendeferi; Ekaterini,16,0,20,4
1683345434137,ANTH 21,A01,258331,Staff,8,0,40,32
1683345435164,ANTH 103,A00,258398,Varma; Saiba,15,0,25,10
1683345436188,AWP 10,001,202034,Staff,0,0,0,0
1683345436188,AWP 10,002,202035,Staff,0,0,0,0
1683345436188,AWP 10,003,202036,Staff,0,0,0,0
1683345436188,AWP 10,004,202037,Staff,0,0,0,0
1683345436188,AWP 10,005,202038,Staff,0,0,0,0
1683345436188,AWP 10,006,202039,Staff,0,0,0,0
1683345436188,AWP 10,007,202040,Staff,0,0,0,0
1683345436188,AWP 10,008,202041,Staff,0,0,0,0
1683345436188,AWP 10,009,202042,Staff,0,0,0,0
1683345436188,AWP 10,010,202043,Staff,0,0,0,0
1683345436188,AWP 10,011,202044,Staff,0,0,0,0
1683345436188,AWP 10,012,202045,Staff,0,0,0,0
1683345436188,AWP 10,013,202046,Staff,0,0,0,0
1683345436188,AWP 10,014,202047,Staff,0,0,0,0
1683345436188,AWP 10,015,202048,Staff,0,0,0,0
1683345436188,AWP 10,016,202049,Staff,0,0,0,0
1683345436188,AWP 10,017,202050,Staff,0,0,0,0
1683345436188,AWP 10,018,202051,Staff,0,0,0,0
1683345436188,AWP 10,019,202052,Staff,0,0,0,0
1683345436188,AWP 10,020,202053,Staff,0,0,0,0
1683345436188,AWP 10,021,202054,Staff,0,0,0,0
1683345436188,AWP 10,022,202055,Staff,0,0,0,0
1683345436188,AWP 10,023,202056,Staff,0,0,0,0
1683345436188,AWP 10,024,202057,Staff,0,0,0,0
1683345436188,AWP 10,025,202058,Staff,0,0,0,0
1683345436188,AWP 10,026,202059,Staff,0,0,0,0
1683345437214,AWP 102,001,202032,Staff,0,0,0,0
1683345437214,AWP 102,002,202033,Staff,0,0,0,0
1683345438238,BENG 100,A01,254234,Taylor Amos; Alyssa C,31,0,40,9
1683345439265,BENG 196,001,270013,Engler; Adam J.,9999,0,9999,0
1683345440295,BICD 100R,A01,202018,Smith; Laurie,0,7,32,32
1683345440295,BICD 100R,A02,202019,Smith; Laurie,0,2,32,32
1683345440295,BICD 100R,A03,202020,Smith; Laurie,0,1,32,32
1683345440295,BICD 100R,A04,202021,Smith; Laurie,9,0,32,23
1683345440295,BICD 100R,A05,202022,Smith; Laurie,12,0,32,20
1683345441324,BICD 136,A01,193242,Gustafson-Brown; Cindy,0,2,32,32
1683345441324,BICD 136,A02,193244,Gustafson-Brown; Cindy,14,0,32,18
1683345442348,BIEB 102,A01,193249,Butler; Shannon Rhey,0,2,32,32
1683345442348,BIEB 102,A02,193251,Butler; Shannon Rhey,0,0,32,32
1683345442348,BIEB 102,A03,193253,Butler; Shannon Rhey,0,1,32,32
1683345442348,BIEB 102,A04,193255,Butler; Shannon Rhey,17,0,32,15
1683345442348,BIEB 102,A05,193265,Butler; Shannon Rhey,26,0,32,6
1683345442348,BIEB 102,A06,193269,Butler; Shannon Rhey,16,0,32,16
1683345444405,BIEB 150,A01,193274,Staff,0,0,32,32
1683345444405,BIEB 150,A02,193285,Staff,23,0,32,9
1683345445430,BIEB 194,A00,193286,Kurle; Carolyn M.,22,0,32,10
1683345446460,BILD 1,A01,192291,Staff,16,0,32,16
1683345446460,BILD 1,A02,192292,Staff,30,0,32,2
1683345446460,BILD 1,B01,192520,Reuther; Keefe,0,1,0,0
1683345446460,BILD 1,B02,192532,Reuther; Keefe,0,1,0,0
1683345447485,BILD 3,A01,192556,Butler; Shannon Rhey,0,0,32,32
1683345447485,BILD 3,A02,192581,Butler; Shannon Rhey,5,0,32,27
1683345447485,BILD 3,A03,192611,Butler; Shannon Rhey,23,0,32,9
1683345447485,BILD 3,A04,192612,Butler; Shannon Rhey,25,0,32,7
1683345447485,BILD 3,A05,192613,Butler; Shannon Rhey,27,0,32,5
1683345447485,BILD 3,A06,192679,Butler; Shannon Rhey,27,0,32,5
1683345447485,BILD 3,A07,192682,Butler; Shannon Rhey,22,0,32,10
1683345448510,BILD 4,A01,192836,Reuther; Keefe,0,0,24,24
1683345448510,BILD 4,A02,193044,Reuther; Keefe,4,0,24,20
1683345449535,BILD 10,A01,193142,Gustafson-Brown; Cindy,30,0,32,2
1683345449535,BILD 10,A02,193149,Gustafson-Brown; Cindy,31,0,32,1
1683345450558,BIMM 100,A01,193301,Staff,0,6,32,32
1683345450558,BIMM 100,A02,193312,Staff,0,5,32,32
1683345450558,BIMM 100,A03,193323,Staff,0,8,32,32
1683345451584,BIMM 101,A01,193329,McDonnell; Lisa Marie,0,3,24,24
1683345451584,BIMM 101,A02,193339,McDonnell; Lisa Marie,0,3,24,24
1683345451584,BIMM 101,B01,193354,McDonnell; Lisa Marie,0,3,24,24
1683345451584,BIMM 101,B02,193357,McDonnell; Lisa Marie,0,3,24,24
1683345452608,BIMM 110,A01,193377,Tat; John,0,11,32,32
1683345452608,BIMM 110,A02,193378,Tat; John,1,9,32,31
1683345453633,BIMM 120,A01,206116,Staff,0,0,32,32
1683345453633,BIMM 120,A02,206117,Staff,8,0,32,24
1683345453633,BIMM 120,A03,206121,Staff,21,0,32,11
1683345454659,BIPN 100,A01,193393,Park; Ji Young,0,14,32,32
1683345454659,BIPN 100,A02,193402,Park; Ji Young,0,13,32,32
1683345454659,BIPN 100,A03,193413,Park; Ji Young,0,14,32,32
1683345454659,BIPN 100,A04,193414,Park; Ji Young,0,13,32,32
1683345455688,BIPN 102,A01,193429,Staff,0,0,32,32
1683345455688,BIPN 102,A02,193438,Staff,22,0,32,10
1683345456715,BIPN 106,A01,193450,Reyes Gonzalez; Catalina,0,2,40,40
1683345457744,BIPN 134,A01,193465,Cooke; James Edward,0,0,32,32
1683345457744,BIPN 134,A02,193474,Cooke; James Edward,25,0,32,7
1683345457744,BIPN 134,A03,193485,Cooke; James Edward,29,0,32,3
1683345457744,BIPN 134,A04,193486,Cooke; James Edward,21,0,32,11
1683345457744,BIPN 134,A05,193491,Cooke; James Edward,31,0,32,1
1683345457744,BIPN 134,A06,193501,Cooke; James Edward,30,0,32,2
1683345457744,BIPN 134,A07,193510,Cooke; James Edward,29,0,32,3
1683345459797,BISP 194,A00,222522,Staff,14,0,32,18
1683345460820,CAT 124,A01,202407,Staff,20,0,25,5
1683345461844,CAT 125,A00,202408,Marchisotto; Jennifer Anne,4,0,20,16
1683345462875,CAT 125R,A00,202409,Smith; Lauryn Alissa,0,11,20,20
1683345462875,CAT 125R,B00,202410,Morales; Celeste Georgianna,0,11,20,20
1683345462875,CAT 125R,C00,202411,Irwin; Matthew Joseph,0,10,20,20
1683345463916,CENG 15,A01,204712,Yang; Kesong,0,1,0,0
1683345464943,CENG 114,A00,202070,Jahed Motlagh; Zeinab,5,0,20,15
1683345465967,CGS 105,A00,185477,Wesling; Megan E.,24,0,40,16
1683345466990,CGS 106,A00,185494,Staff,13,0,22,9
1683345468014,CGS 108,A00,185495,Staff,14,0,20,6
1683345469039,CGS 114,A00,185496,Staff,13,0,18,5
1683345470063,CGS 119,A00,185501,Staff,15,0,20,5
1683345471091,CGS 120,A00,185511,Staff,13,0,20,7
1683345472119,CHEM 4,A01,184675,Bussey; Thomas J,96,0,100,4
1683345473145,CHEM 6A,A01,184677,Staff,34,0,60,26
1683345474170,CHEM 6B,A01,184679,Staff,65,0,100,35
1683345475194,CHEM 6C,A01,184681,Bussey; Thomas J,1,0,50,49
1683345475194,CHEM 6C,A02,184682,Bussey; Thomas J,34,0,50,16
1683345476219,CHEM 40A,A01,184684,Albizati; Kim F.,37,0,100,63
1683345477246,CHEM 40B,A01,184686,Albizati; Kim F.,0,20,100,100
1683345478267,CHEM 41B,A01,184690,Staff,52,0,100,48
1683345479296,COGS 3,A01,184715,Boyle; Mary E. T.,0,25,40,40
1683345480319,COGS 14B,A01,185172,Staff,0,15,38,38
1683345481346,COGS 18,A01,184736,Staff,17,0,80,63
1683345482374,COGS 100,A01,184932,Staff,0,5,73,73
1683345483399,COGS 101A,A01,184935,Staff,0,39,30,30
1683345484421,COGS 101B,A01,184944,Staff,0,2,30,30
1683345485452,COGS 101C,A01,184946,Staff,0,12,30,30
1683345486476,COGS 102A,A01,184951,Johnson; Christine M.,2,0,40,38
1683345487500,COGS 107B,A01,184953,Mooshagian; Eric Frederick,0,50,40,40
1683345488525,COGS 118B,A01,184959,Gupta; Anjum,0,48,40,40
1683345489551,COGS 153,A00,184961,Staff,0,15,30,30
1683345490575,COGS 177,A00,184962,Staff,0,20,30,30
1683345491660,COGS 187A,A01,184969,Boyle; Mary E. T.,0,17,40,40
1683345492688,COMM 10,A01,185174,Staff,0,5,25,25
1683345492688,COMM 10,A02,185189,Staff,0,5,25,25
1683345492688,COMM 10,A03,269821,Staff,0,0,0,0
1683345493713,COMM 100B,A01,185475,Staff,0,0,0,2
1683345493713,COMM 100B,A02,185476,Staff,13,0,25,12
1683345494737,COMM 100C,A01,185314,Staff,1,0,25,24
1683345494737,COMM 100C,A02,185327,Staff,19,0,25,6
1683345495763,COMM 110M,A00,185349,Staff,2,0,40,38
1683345496787,COMM 113T,A00,185352,Staff,24,0,40,16
1683345497811,COMM 114I,A00,185353,Staff,33,0,40,7
1683345498835,COMM 131,A00,185354,Staff,19,0,30,11
1683345499863,CSE 8A,A50,185358,Cao; Yingjun,0,46,10,10
1683345500891,CSE 8B,A01,185362,Staff,1,47,50,49
1683345501919,CSE 11,A01,185416,Cao; Yingjun,0,92,10,10
1683345502946,CSE 20,A01,185445,Briones; Jor-el Thomas Caparas,5,0,25,20
1683345503969,CSE 21,A01,185447,Staff,10,0,50,40
1683345504994,CSE 101,A01,185451,Staff,0,13,50,50
1683345504994,CSE 101,B01,185453,Jones; Miles E,0,11,50,50
1683345507042,CSE 141,A01,185458,Eldon; John,20,0,100,80
1683345508069,CSE 141L,A01,185461,Eldon; John,12,0,100,88
1683345509093,CSE 142,A01,185463,Staff,36,0,60,24
1683345509093,CSE 142,B01,201355,Staff,0,7,60,60
1683345510118,CSE 142L,A01,185470,Staff,36,0,60,24
1683345510118,CSE 142L,B01,201417,Staff,0,6,60,60
1683345511144,CSE 190,A00,201433,Staff,32,0,49,17
1683345512171,DOC 1,A01,259136,Strom; Megan C.,7,0,15,8
1683345512171,DOC 1,A02,259137,Strom; Megan C.,14,0,15,1
1683345512171,DOC 1,A03,259138,Strom; Megan C.,14,0,15,1
1683345512171,DOC 1,A04,259139,Strom; Megan C.,14,0,15,1
1683345513199,DOC 100D,A00,259140,Pass; Natalye Joann,16,0,25,9
1683345514222,DSGN 1,A01,184749,Rill; Bryan,0,25,30,30
1683345515247,DSGN 100,A01,185168,Staff,0,2,25,25
1683345516271,ECE 5,A01,185626,Morris; Karcher William,0,10,0,0
1683345517298,ECE 101,A01,185628,Staff,17,0,70,53
1683345518324,ECE 107,A01,185635,Baghdadchi; Saharnaz,0,0,20,20
1683345518324,ECE 107,A02,185638,Baghdadchi; Saharnaz,4,0,20,16
1683345519348,ECE 148,A01,185647,Silberman; Jack,0,0,16,16
1683345520372,ECON 1,A01,185537,Crane; Meredith Helen,54,0,70,16
1683345521396,ECON 3,A01,185549,Crane; Meredith Helen,32,0,70,38
1683345522424,ECON 4,A01,203354,Anderson; John Charles,0,4,10,10
1683345523448,ECON 100A,A01,185574,Staff,0,4,40,40
1683345524472,ECON 100B,A01,185576,Staff,10,22,50,40
1683345525496,ECON 100C,A01,185589,Newhouse; Herbert S,29,0,70,41
1683345526521,ECON 105,A00,185608,Vespa; Emanuel Ignacio,19,0,35,16
1683345527545,ECON 109,A01,185610,Shishkin; Denis,10,0,35,25
1683345528573,ECON 110A,A01,185612,Staff,11,0,40,29
1683345529598,ECON 120A,A01,185615,Staff,20,0,40,20
1683345530622,ECON 120C,A01,185617,Sun; Yixiao,0,21,70,70
1683345531649,ECON 144,A00,203346,Squires; Dale E,3,0,35,32
1683345532677,ECON 171,A01,203349,Newhouse; Herbert S,0,1,35,35
1683345533703,ECON 173A,A01,185621,Toda; Alexis Akira,21,0,35,14
1683345534730,EDS 25,A01,202413,Staff,0,1,0,0
1683345534730,EDS 25,A02,202414,Staff,0,1,0,0
1683345534730,EDS 25,A03,202415,Staff,0,0,0,0
1683345534730,EDS 25,A04,202416,Staff,0,1,0,0
1683345534730,EDS 25,A05,202439,Staff,0,0,0,0
1683345534730,EDS 25,A06,202440,Staff,0,0,0,0
1683345534730,EDS 25,B01,202631,Staff,0,0,0,0
1683345534730,EDS 25,B02,202632,Staff,0,0,0,0
1683345534730,EDS 25,B03,202639,Staff,0,0,0,0
1683345534730,EDS 25,B04,202640,Staff,0,0,0,0
1683345534730,EDS 25,B05,202643,Staff,0,0,0,0
1683345534730,EDS 25,B06,202644,Staff,0,0,0,0
1683345535758,EDS 38,A01,202659,Black; Alison Michelle,24,0,25,1
1683345536782,EDS 115,A00,202652,Staff,18,0,30,12
1683345537809,EDS 125,A00,202649,Staff,14,0,30,16
1683345538838,EDS 126,A01,203332,Staff,30,0,30,0
1683345539864,EDS 139,A00,202838,Staff,16,0,25,9
1683345540892,EDS 146,A01,202655,Staff,14,0,25,11
1683345541918,ENG 15,A00,185667,Staff,0,1,0,0
1683345541918,ENG 15,B00,185672,Staff,0,0,0,0
1683345541918,ENG 15,C00,185675,Staff,0,0,0,0
1683345541918,ENG 15,D00,185682,Staff,0,0,0,0
1683345541918,ENG 15,E00,185684,Staff,0,0,0,0
1683345542943,ETHN 103,A00,185710,Staff,0,4,35,35
1683345543970,ETHN 103A,A00,199228,Man; Simeon S,2,0,9,7
1683345544994,ETHN 109,A00,185711,Staff,18,0,35,17
1683345546021,ETHN 142,A00,185726,Staff,0,4,30,30
1683345547049,ETHN 163J,A00,199229,Man; Simeon S,5,0,8,3
1683345548073,ETHN 168,A00,185727,Staff,8,0,10,2
1683345549100,ETHN 182,A00,185728,Staff,1,0,35,34
1683345550128,ETHN 183,A00,185737,Staff,8,0,18,10
1683345551156,GLBH 111,A01,209361,Burgos; Jose L.,0,0,0,0
1683345553204,HIEU 104,A00,185792,Staff,16,0,20,4
1683345554228,HIEU 115,A00,185800,Staff,1,0,20,19
1683345555253,HIEU 128,A00,185801,Staff,0,7,20,20
1683345556279,HIEU 147,A00,185802,Staff,16,0,20,4
1683345557304,HIEU 154,A00,185823,Staff,12,0,20,8
1683345558328,HILA 102,A00,185826,Staff,13,0,20,7
1683345559352,HILD 2C,A01,185778,Staff,0,12,20,20
1683345560376,HILD 7B,A01,185780,Kwak; Nancy,0,15,32,32
1683345560376,HILD 7B,A02,185781,Kwak; Nancy,0,18,32,32
1683345561399,HILD 30,A01,185791,Staff,14,0,20,6
1683345562425,HISC 119,A00,185830,Golan; Tal,0,9,20,20
1683345563451,HITO 156GS,A00,185831,Patterson; Patrick H.,0,0,0,23
1683345564479,HIUS 103,A00,185832,Man; Simeon S,0,6,20,20
1683345565505,HIUS 117,A00,185836,Kwak; Nancy,2,0,20,18
1683345566532,HIUS 125,A00,185840,Man; Simeon S,0,0,23,23
1683345567560,HIUS 149,A00,185845,Staff,0,0,20,20
1683345568589,HUM 3,A01,185882,Zavodny; Tatiana Sophia,0,7,50,50
1683345568589,HUM 3,B01,185899,Caldwell; Michael Alan,0,18,50,50
1683345569616,HUM 3GS,A00,185900,Patterson; Patrick H.,0,0,0,23
1683345570641,HUM 4,A01,185938,Zroka; Amy Liane,31,0,50,19
1683345570641,HUM 4,B01,185956,Watkins; Eric,0,2,50,50
1683345570641,HUM 4,B02,202209,Watkins; Eric,0,2,50,50
1683345570641,HUM 4,B03,202210,Watkins; Eric,0,2,50,50
1683345571666,HUM 5,A01,185958,West; Geoffrey Scott,3,0,50,47
1683345571666,HUM 5,A02,202215,West; Geoffrey Scott,0,0,50,50
1683345572691,INTL 190,A00,185959,Gagnon; Jeffrey C,0,0,0,9
1683345572691,INTL 190,B00,185960,Lettieri; Michael Joseph,0,0,0,1
1683345573714,JAPN 180,A00,254509,Staff,5,1,30,25
1683345574739,LATI 10,A01,202853,Kennemore; Amy Michelle,4,0,35,31
1683345574739,LATI 10,A02,202854,Kennemore; Amy Michelle,2,0,35,33
1683345574739,LATI 10,A03,270054,Kennemore; Amy Michelle,30,0,30,0
1683345575763,LATI 180,A00,202855,Kennemore; Amy Michelle,11,0,20,9
1683345576787,LAWS 101,A00,201767,Golan; Tal,0,7,40,40
1683345577812,LIFR 1C,A00,185961,Staff,6,0,20,14
1683345578838,LIFR 1CX,A00,185962,Staff,7,0,20,13
1683345579864,LIFR 1D,A00,185963,Staff,9,0,20,11
1683345580888,LIFR 1DX,A00,185964,Staff,9,0,20,11
1683345581916,LIGN 101,A01,186039,Staff,43,0,50,7
1683345582939,LIGN 165,A00,186040,Staff,18,0,50,32
1683345583963,LTCS 108,A00,186041,Staff,6,0,10,4
1683345584986,LTCS 119,A00,186042,Staff,16,0,20,4
1683345586010,LTCS 130,A00,186043,Wesling; Megan E.,15,0,25,10
1683345588060,LTEA 138,A00,186119,Staff,14,0,40,26
1683345589085,LTEN 124,A00,186148,Staff,6,0,25,19
1683345590110,LTEN 178,A00,186149,Staff,7,0,15,8
1683345591137,LTEN 181,A00,186150,Blanco; John D,33,0,40,7
1683345592161,LTWL 120,A00,186160,Staff,20,0,25,5
1683345593189,LTWL 165,A00,186161,Staff,22,0,25,3
1683345594216,LTWR 100,A00,186162,Staff,0,5,15,15
1683345595301,LTWR 102,A00,186163,Doller; Ben,5,0,15,10
1683345596324,MAE 8,A01,186412,Staff,0,0,0,0
1683345597349,MAE 30B,A00,186445,Bahadori; Mohammad Yousef,83,0,100,17
1683345598373,MAE 40,A00,186592,Bewley; Thomas R,9,0,50,41
1683345599401,MAE 101B,A00,186593,Bahadori; Mohammad Yousef,81,0,100,19
1683345600426,MAE 105,A00,186594,Bandaru; Prabhakar,12,0,50,38
1683345601454,MAE 107,A00,186599,Pham; Hieu Tan,0,6,120,120
1683345602482,MAE 148,A01,186660,Silberman; Jack,3,0,16,13
1683345603505,MATH 10A,A01,188095,Staff,1,6,35,34
1683345604530,MATH 10B,A01,188097,Bowers; Adam R.,0,11,30,30
1683345604530,MATH 10B,A02,188099,Bowers; Adam R.,0,11,30,30
1683345604530,MATH 10B,B01,188104,Bowers; Adam R.,0,10,30,30
1683345604530,MATH 10B,B02,188106,Bowers; Adam R.,0,10,30,30
1683345605553,MATH 10C,A01,188111,Staff,0,18,30,30
1683345605553,MATH 10C,A02,188127,Staff,0,17,30,30
1683345605553,MATH 10C,A03,188131,Staff,0,18,30,30
1683345605553,MATH 10C,B01,188218,Staff,18,0,30,12
1683345605553,MATH 10C,B02,188244,Staff,13,0,30,17
1683345605553,MATH 10C,B03,188277,Staff,16,0,30,14
1683345606584,MATH 18,A01,188344,Bach; Quang Tran,18,0,30,12
1683345606584,MATH 18,A02,188345,Bach; Quang Tran,11,0,30,19
1683345606584,MATH 18,B01,188353,Bach; Quang Tran,10,0,30,20
1683345606584,MATH 18,B02,188354,Bach; Quang Tran,20,0,30,10
1683345607610,MATH 20A,A01,188374,Staff,13,0,35,22
1683345608634,MATH 20B,A01,188382,Ohm; Ko Woon,6,0,30,24
1683345608634,MATH 20B,A02,188383,Ohm; Ko Woon,22,0,30,8
1683345608634,MATH 20B,B01,188385,Ohm; Ko Woon,7,0,30,23
1683345608634,MATH 20B,B02,188392,Ohm; Ko Woon,22,0,30,8
1683345609659,MATH 20C,A01,188394,Harel; Guershon,10,0,30,20
1683345609659,MATH 20C,A02,188395,Harel; Guershon,15,0,30,15
1683345609659,MATH 20C,B01,188404,Harel; Guershon,5,0,30,25
1683345609659,MATH 20C,B02,188405,Harel; Guershon,19,0,30,11
1683345610683,MATH 20D,A01,188414,Hammock; Frances H,0,1,30,30
1683345610683,MATH 20D,A02,188415,Hammock; Frances H,3,0,30,27
1683345610683,MATH 20D,B01,188447,Hammock; Frances H,1,0,30,29
1683345610683,MATH 20D,B02,188486,Hammock; Frances H,8,0,30,22
1683345611711,MATH 20E,A01,188649,Staff,21,0,30,9
1683345611711,MATH 20E,A02,188650,Staff,23,0,30,7
1683345611711,MATH 20E,A03,188673,Staff,0,0,30,30
1683345612733,MATH 102,A01,188675,Staff,0,35,35,35
1683345613763,MATH 103B,A01,188681,Staff,3,0,35,32
1683345613763,MATH 103B,B01,188692,Staff,5,0,35,30
1683345614788,MATH 109,A01,188695,Salehi Golsefidy; Alireza,25,0,35,10
1683345614788,MATH 109,A02,188696,Salehi Golsefidy; Alireza,25,0,35,10
1683345615812,MATH 120A,A01,188698,Eggers; John Dietrich,7,0,35,28
1683345616837,MATH 142B,A01,188736,Ioana; Adrian,0,2,30,30
1683345616837,MATH 142B,A02,188741,Ioana; Adrian,1,1,30,29
1683345616837,MATH 142B,A03,188743,Ioana; Adrian,1,3,30,29
1683345617861,MATH 168A,A01,188790,Staff,0,9,35,35
1683345618886,MATH 170A,A01,188803,Nie; Jiawang,0,2,35,35
1683345618886,MATH 170A,A02,188811,Nie; Jiawang,0,0,35,35
1683345618886,MATH 170A,A03,188814,Nie; Jiawang,1,0,35,34
1683345618886,MATH 170A,A04,188815,Nie; Jiawang,13,0,35,22
1683345619914,MATH 193B,A01,188817,Staff,0,0,35,35
1683345619914,MATH 193B,A02,188818,Staff,5,0,35,30
1683345620938,MGT 4,A01,202857,Anderson; John Charles,62,0,80,18
1683345621965,MGT 12,A00,202858,Lindenberger; Wade Douglas,42,0,90,48
1683345622994,MGT 18,A00,202859,Staff,74,0,90,16
1683345624020,MGT 18GS,A00,202860,McKay; Michael J,13,0,28,15
1683345625044,MGT 45,A00,202861,Pecore; Joseph P.,14,0,90,76
1683345626070,MGT 100,A00,202863,Yavorsky; Daniel Ryan,28,0,90,62
1683345627094,MGT 103,A00,202864,Ehrich; Kristine R,1,18,90,89
1683345628120,MGT 112,A00,202865,Ehrich; Kristine R,15,0,90,75
1683345629144,MGT 121A,A00,202868,Staff,0,20,0,0
1683345630169,MGT 131B,A00,202869,Anderson; John Charles,59,0,90,31
1683345631193,MGT 136,A00,202871,Lindenberger; Wade Douglas,84,0,90,6
1683345632220,MGT 164,A00,202873,Staff,0,68,90,91
1683345633246,MGT 164GS,A00,202874,McKay; Mary A,13,0,28,15
1683345634270,MGT 180,A00,202875,Staff,0,50,90,91
1683345635297,MMW 11R,A01,205019,Herbst; Matthew,3,0,30,27
1683345635297,MMW 11R,A02,205026,Herbst; Matthew,29,0,30,1
1683345638910,MMW 15,A01,193512,Chang; Edmond Yi-Teh,0,9,28,28
1683345638910,MMW 15,A02,193513,Chang; Edmond Yi-Teh,0,5,28,28
1683345638910,MMW 15,A03,193514,Chang; Edmond Yi-Teh,0,5,28,28
1683345638910,MMW 15,A04,193515,Chang; Edmond Yi-Teh,0,5,28,28
1683345638910,MMW 15,A05,193516,Chang; Edmond Yi-Teh,0,4,28,28
1683345638910,MMW 15,A06,193517,Chang; Edmond Yi-Teh,0,5,28,28
1683345638910,MMW 15,B01,193519,Chang; Edmond Yi-Teh,0,5,28,28
1683345638910,MMW 15,B02,193520,Chang; Edmond Yi-Teh,0,5,28,28
1683345638910,MMW 15,B03,193521,Chang; Edmond Yi-Teh,0,5,28,28
1683345638910,MMW 15,B04,193522,Chang; Edmond Yi-Teh,0,4,28,28
1683345638910,MMW 15,B05,193523,Chang; Edmond Yi-Teh,0,5,28,28
1683345638910,MMW 15,B06,193524,Chang; Edmond Yi-Teh,0,4,28,28
1683345639938,MMW 122,A01,193526,Rahimi; Babak,0,15,28,28
1683345639938,MMW 122,A02,193527,Rahimi; Babak,0,14,28,28
1683345639938,MMW 122,A03,193528,Rahimi; Babak,0,0,0,0
1683345639938,MMW 122,A04,193529,Rahimi; Babak,0,0,0,0
1683345640964,MUS 1A,A01,186663,Staff,0,20,35,35
1683345641992,MUS 4,A01,186715,Staff,0,12,35,35
1683345643017,MUS 5R,A01,186796,Dubnov; Shlomo,0,17,35,35
1683345644045,MUS 6,A01,186798,Staff,0,4,25,25
1683345645069,MUS 7,A01,186830,Staff,13,0,35,22
1683345646093,MUS 8,A01,186930,Staff,0,26,35,35
1683345647121,MUS 15,A01,186932,Staff,0,16,35,35
1683345647121,MUS 15,B01,186934,Staff,0,15,35,35
1683345648146,MUS 80,A00,186935,Staff,1,0,20,19
1683345648146,MUS 80,B00,186936,Staff,25,0,25,0
1683345649171,NANO 11,A00,204702,Lipomi; Darren John,0,0,0,0
1683345650199,NANO 15,A01,204709,Yang; Kesong,0,1,0,0
1683345651224,NANO 114,A00,202069,Jahed Motlagh; Zeinab,3,0,10,7
1683345652250,PHIL 1,A00,186955,Grush; Rick Scott,32,0,40,8
1683345653274,PHIL 10,A01,186973,Grush; Rick Scott,28,0,35,7
1683345653274,PHIL 10,A02,186974,Grush; Rick Scott,33,0,35,2
1683345654304,PHIL 13,A01,186976,Staff,7,0,35,28
1683345654304,PHIL 13,A02,186977,Staff,16,0,35,19
1683345655327,PHIL 14,A01,186979,Staff,31,0,35,4
1683345655327,PHIL 14,A02,186986,Staff,32,0,35,3
1683345656352,PHIL 28,A01,186988,Staff,16,0,30,14
1683345656352,PHIL 28,A02,186989,Staff,1,0,30,29
1683345656352,PHIL 28,A03,186990,Staff,9,0,30,21
1683345656352,PHIL 28,A04,186991,Staff,26,0,30,4
1683345657377,PHIL 120,A00,186997,Staff,23,0,40,17
1683345658403,PHIL 137,A00,187003,Staff,9,0,40,31
1683345659429,PHIL 150,A00,187015,Staff,47,0,70,23
1683345660453,PHIL 167,A00,187021,Lamey; Andy M.,35,0,40,5
1683345661477,PHIL 174,A01,202226,Staff,17,0,20,3
1683345661477,PHIL 174,A02,202235,Staff,20,0,20,0
1683345662505,PHIL 191A,A00,258918,Staff,0,0,1,1
1683345663529,PHYS 1A,A00,187028,Staff,27,0,60,33
1683345664553,PHYS 1AL,001,187036,Staff,2,0,30,28
1683345664553,PHYS 1AL,002,187049,Staff,18,0,30,12
1683345665580,PHYS 1B,A00,187058,Staff,22,0,60,38
1683345666609,PHYS 1BL,001,187064,Staff,0,0,30,30
1683345666609,PHYS 1BL,002,187070,Staff,5,0,30,25
1683345667636,PHYS 1C,A00,187082,Staff,31,0,120,89
1683345668661,PHYS 1CL,001,187088,Staff,0,9,30,30
1683345668661,PHYS 1CL,002,187089,Staff,0,2,30,30
1683345668661,PHYS 1CL,009,262693,Staff,11,0,30,19
1683345669687,PHYS 2B,A01,187097,Staff,54,0,115,61
1683345670712,PHYS 2C,A01,187099,Staff,67,0,115,48
1683345671739,PHYS 2CL,A01,187101,Staff,5,0,28,23
1683345671739,PHYS 2CL,A02,187102,Staff,15,0,28,13
1683345672767,PHYS 2D,A01,187123,Shotwell; Brian,95,0,115,20
1683345673795,PHYS 4B,A01,187133,Grinstein; Benjamin,35,0,50,15
1683345674822,POLI 10,A00,188819,Staff,0,4,50,50
1683345675850,POLI 11,A00,188827,Staff,43,0,50,7
1683345676877,POLI 13R,A00,188828,Staff,0,1,20,20
1683345677905,POLI 27,A01,188830,Elgin; Samuel Zincke,0,1,70,70
1683345678934,POLI 30,A00,188832,Desposato; Scott,31,0,50,19
1683345679958,POLI 102F,A00,188834,Staff,3,0,40,37
1683345680982,POLI 104A,A00,188852,Staff,14,0,30,16
1683345682006,POLI 104I,A00,188853,Staff,0,6,20,20
1683345683034,POLI 110B,A00,188854,Wiens; David,7,0,20,13
1683345684059,POLI 112A,A00,188855,Wiens; David,5,0,30,25
1683345685081,POLI 117R,A00,188856,Forman; Fonna,0,11,20,20
1683345686110,POLI 118,A00,188857,Ingham; Sean,8,0,20,12
1683345687135,POLI 120G,A00,188858,Staff,9,0,30,21
1683345688159,POLI 131CR,A00,188863,Hoston; Germaine,24,0,50,26
1683345689187,POLI 133,A00,188864,Nellis; Gareth Hb,44,0,50,6
1683345690219,POLI 134D,A00,188865,Desposato; Scott,27,0,30,3
1683345691245,POLI 142A,A00,188871,Gartzke; Erik,22,0,50,28
1683345692272,POLI 142K,A00,188874,Staff,38,0,50,12
1683345693296,POLI 143,A00,188940,Gartzke; Erik,16,0,30,14
1683345694324,POLI 153,A00,188943,Staff,3,0,20,17
1683345695349,POLI 160AA,A00,188944,Staff,12,0,40,28
1683345696376,POLI 170A,A00,188945,Staff,11,0,30,19
1683345698427,PSYC 1,A00,188952,Staff,37,0,90,53
1683345699455,PSYC 2,B00,188953,Staff,19,0,35,16
1683345700479,PSYC 6,A00,188970,Staff,47,0,60,13
1683345701576,PSYC 7,A00,188973,Staff,37,0,45,8
1683345702604,PSYC 60,A01,188980,Rickard; Timothy C.,43,0,60,17
1683345703628,PSYC 70,A01,189001,Steiner; Eric Tomas,23,0,45,22
1683345704652,PSYC 100,A00,189005,Lacefield; Katharine I,0,98,120,120
1683345705676,PSYC 102,A00,189008,Staff,9,0,30,21
1683345706701,PSYC 106,B00,189026,Gorman; Michael R.,34,0,60,26
1683345707729,PSYC 114,B01,189033,Winkielman; Piotr,0,32,30,30
1683345708757,PSYC 131,A00,189036,Anagnostaras; Stephan,0,43,60,60
1683345709781,PSYC 136,A00,189041,Lowe; Angela Beth,0,7,25,25
1683345710806,PSYC 137,A00,189057,Winkielman; Piotr,0,34,25,25
1683345711833,PSYC 144,A00,189107,Wixted; John T,0,7,50,50
1683345713887,PSYC 162,A00,189142,Staff,0,8,85,85
1683345714911,PSYC 172,A00,189144,Gorman; Michael R.,0,7,30,30
1683345716963,PSYC 179,A00,189146,Lacefield; Katharine I,0,84,120,120
1683345717990,PSYC 181,A00,189147,Anagnostaras; Stephan,0,44,90,90
1683345719014,PSYC 190R,A00,189148,Barner; David A.,0,22,80,80
1683345720040,PSYC 191,A00,189275,Rickard; Timothy C.,0,7,25,25
1683345721064,PSYC 193,A00,189276,Chapman; Eddie Nathaniel,0,1,0,4
1683345722093,PSYC 193L,A01,189281,Lowe; Angela Beth,12,0,20,8
1683345722093,PSYC 193L,B01,189285,Staff,28,0,35,7
1683345723120,RELI 149,A00,187137,Rahimi; Babak,7,0,40,33
1683345724145,SE 9,A01,187315,Staff,0,2,18,18
1683345725172,SE 101B,A00,187409,Staff,24,0,30,6
1683345726197,SE 110B,A00,187444,Staff,10,0,40,30
1683345727220,SE 130B,A00,187449,Staff,31,0,40,9
1683345728247,SE 150A,A00,187516,Staff,9,0,20,11
1683345729272,SE 154,A00,187528,Staff,30,0,50,20
1683345730299,SIO 3,A01,258171,Staff,35,0,40,5
1683345731326,SIO 10,A00,187144,Cook; Geoffrey W,0,3,75,75
1683345732350,SIO 45,A00,187152,Cook; Geoffrey W,1,0,100,99
1683345733375,SIO 109R,A00,194486,Staff,0,3,20,20
1683345735430,SIO 187,A01,187233,Kacev; David,12,0,40,28
1683345736458,SOCI 1,A01,258656,Thorpe; Charles Robert,28,0,30,2
1683345736458,SOCI 1,A02,258658,Thorpe; Charles Robert,30,0,30,0
1683345736458,SOCI 1,A03,258661,Thorpe; Charles Robert,25,0,25,0
1683345736458,SOCI 1,A04,258666,Thorpe; Charles Robert,22,0,25,3
1683345736458,SOCI 1,A05,258897,Thorpe; Charles Robert,23,0,25,2
1683345736458,SOCI 1,A06,258898,Thorpe; Charles Robert,25,0,25,0
1683345737484,SOCI 30,A01,258903,Pardo Guerra; Juan Pablo,15,0,30,15
1683345738509,SOCI 102,A00,258904,Staff,9,0,25,16
1683345739537,SOCI 106,A00,258905,Staff,19,0,25,6
1683345740562,SOCI 111,A00,258907,Ribas Norris; Janet Vanesa,26,0,30,4
1683345741590,SOCI 121R,A00,258908,Pardo Guerra; Juan Pablo,10,0,30,20
1683345742615,SOCI 126,A01,203330,Staff,14,0,20,6
1683345743643,SOCI 131,A00,258909,Thorpe; Charles Robert,31,0,60,29
1683345744669,SOCI 135,A00,258910,Payne; Christine Anna,0,9,30,30
1683345745696,SOCI 157,A00,258911,Staff,12,0,30,18
1683345746725,SOCI 184,A00,258912,Staff,25,0,30,5
1683345747749,SOCI 188D,A00,258913,Staff,21,0,30,9
1683345748778,SYN 2,001,187529,Staff,10,0,16,6
1683345748778,SYN 2,002,201452,Staff,0,18,16,16
1683345748778,SYN 2,003,201469,Staff,3,0,16,13
1683345749803,SYN 100,A01,187531,Staff,0,9,20,20
1683345749803,SYN 100,B01,201491,Staff,0,12,20,20
1683345750832,TDAC 1,A00,189286,Walsh; Kim C.,3,0,20,17
1683345750832,TDAC 1,B00,189287,Harting; Carla Kelso,11,0,20,9
1683345751857,TDAC 101,A00,189300,Walsh; Kim C.,16,0,20,4
1683345751857,TDAC 101,B00,189301,Harting; Carla Kelso,18,0,20,2
1683345752885,TDAC 102,A00,189304,Basso; Beatrice,14,0,20,6
1683345753907,TDAC 108,A00,189305,Staff,18,0,20,2
1683345754937,TDDE 131,A00,189310,Staff,19,0,20,1
1683345754937,TDDE 131,B00,189314,Staff,19,0,20,1
1683345754937,TDDE 131,C00,189315,Staff,48,0,50,2
1683345754937,TDDE 131,D00,189316,Staff,14,0,15,1
1683345754937,TDDE 131,E00,204841,Staff,20,0,20,0
1683345755963,TDGE 10,A00,189289,Staff,30,0,50,20
1683345755963,TDGE 10,B00,189290,Havis; Allan,1,0,50,49
1683345756992,TDGE 11,A00,189291,Fulton; Julia,0,3,50,50
1683345756992,TDGE 11,B00,189292,Staff,20,0,25,5
1683345756992,TDGE 11,C00,260270,Staff,0,0,0,0
1683345758019,TDGE 25,A00,189294,Staff,3,0,20,17
1683345759043,TDGE 124,A00,189318,Fulton; Julia,0,8,50,50
1683345760072,TDGE 125,A00,189319,Staff,13,0,25,12
1683345760072,TDGE 125,B00,189320,Staff,23,0,25,2
1683345761099,TDGE 127,A00,189322,Havis; Allan,0,0,50,50
1683345762127,TDHT 101,A00,189323,Staff,18,0,25,7
1683345762127,TDHT 101,B00,189324,Staff,25,0,25,0
1683345763151,TDHT 102,A00,189325,Staff,49,0,50,1
1683345764175,TDMV 1,A00,189295,Arcidiacono; Kristin,19,0,30,11
1683345764175,TDMV 1,B00,189296,Caligagan; Maria T.,24,0,30,6
1683345765200,TDMV 2,A00,189297,Sammartano; Tonnie,28,0,30,2
1683345765200,TDMV 2,B00,189299,Arcidiacono; Kristin,24,0,30,6
1683345766223,TDMV 3,A00,204998,Rincon; Alicia,22,0,30,8
1683345767246,TDMV 120,A00,189458,Sammartano; Tonnie,28,0,30,2
1683345768271,TDMV 138,A00,189541,Jun; Grace Shin Hae,22,0,40,18
1683345769296,TDMV 142,A00,189717,Caligagan; Tony,23,0,30,7
1683345769296,TDMV 142,B00,189718,Caligagan; Maria T.,25,0,30,5
1683345770320,TMC 2,A01,187533,Staff,25,0,25,0
1683345770320,TMC 2,A02,187534,Staff,25,0,25,0
1683345771344,USP 1,A01,187536,Kwak; Nancy,0,16,25,25
1683345772369,USP 5,A01,187538,Staff,10,0,25,15
1683345773397,USP 101,A00,199253,Staff,0,4,0,0
1683345774422,USP 124,A00,187562,Boomhower; Matthew Charles,1,0,30,29
1683345775449,USP 138,A00,187582,Staff,20,0,25,5
1683345776476,USP 152,A01,187597,Staff,4,0,25,21
1683345777508,USP 153,A00,187598,Staff,19,0,25,6
1683345778533,USP 168,A00,187607,Kwak; Nancy,2,0,5,3
1683345779557,USP 173,A00,187619,Staff,4,0,25,21
1683345780582,USP 181,A00,187638,Staff,0,0,25,25
1683345781608,VIS 103,A00,187650,Cruz; Edwin Teddy,23,0,75,52
1683345782636,VIS 110D,A00,187669,Staff,12,0,22,10
1683345783662,VIS 127C,A00,187720,Shen; Kuiyi,67,0,146,79
1683345784690,VIS 149,A00,187731,Yoldas; Pinar,0,14,22,22
1683345785717,VIS 151,A01,188091,Staff,22,0,34,12
1683345785717,VIS 151,A02,188092,Staff,11,0,34,23
1683345786743,VIS 160B,A00,188093,Stalbaum; Brett,0,0,10,10
1683345788794,WCWP 10B,A00,201720,Staff,10,0,15,5
1683345788794,WCWP 10B,B00,201722,Staff,9,0,15,6
1683345789818,WCWP 100,A00,201725,Gagnon; Jeffrey C,0,0,2,2
1683345789818,WCWP 100,B00,201727,Staff,0,4,15,15
1683345792951,ANBI 133,A00,258401,Wilder; Linnea Lorene,34,0,40,6
1683345793977,ANBI 140,A00,258395,Hrvoj Mihic; Branka,18,0,25,7
1683345795001,ANSC 120,A00,258402,Bialecki; Jon Anthony,27,0,40,13
1683345796030,ANSC 144,A00,258400,Staff,14,0,40,26
1683345798077,ANSC 166,A00,258396,Parish; Steven Martin,157,0,175,18
1683345799101,ANSC 180,A00,193533,Staff,9,0,20,11
1683345800125,ANSC 188,A00,258397,Jassal; Aftab,33,0,40,7
1683345801149,ANTH 3,A01,258316,Staff,23,0,30,7
1683345802173,ANTH 5,A00,258394,Semendeferi; Ekaterini,16,0,20,4
1683345803198,ANTH 21,A01,258331,Staff,8,0,40,32
1683345804222,ANTH 103,A00,258398,Varma; Saiba,15,0,25,10
1683345805317,AWP 10,001,202034,Staff,0,0,0,0
1683345805317,AWP 10,002,202035,Staff,0,0,0,0
1683345805317,AWP 10,003,202036,Staff,0,0,0,0
1683345805317,AWP 10,004,202037,Staff,0,0,0,0
1683345805317,AWP 10,005,202038,Staff,0,0,0,0
1683345805317,AWP 10,006,202039,Staff,0,0,0,0
1683345805317,AWP 10,007,202040,Staff,0,0,0,0
1683345805317,AWP 10,008,202041,Staff,0,0,0,0
1683345805317,AWP 10,009,202042,Staff,0,0,0,0
1683345805317,AWP 10,010,202043,Staff,0,0,0,0
1683345805317,AWP 10,011,202044,Staff,0,0,0,0
1683345805317,AWP 10,012,202045,Staff,0,0,0,0
1683345805317,AWP 10,013,202046,Staff,0,0,0,0
1683345805317,AWP 10,014,202047,Staff,0,0,0,0
1683345805317,AWP 10,015,202048,Staff,0,0,0,0
1683345805317,AWP 10,016,202049,Staff,0,0,0,0
1683345805317,AWP 10,017,202050,Staff,0,0,0,0
1683345805317,AWP 10,018,202051,Staff,0,0,0,0
1683345805317,AWP 10,019,202052,Staff,0,0,0,0
1683345805317,AWP 10,020,202053,Staff,0,0,0,0
1683345805317,AWP 10,021,202054,Staff,0,0,0,0
1683345805317,AWP 10,022,202055,Staff,0,0,0,0
1683345805317,AWP 10,023,202056,Staff,0,0,0,0
1683345805317,AWP 10,024,202057,Staff,0,0,0,0
1683345805317,AWP 10,025,202058,Staff,0,0,0,0
1683345805317,AWP 10,026,202059,Staff,0,0,0,0
1683345806343,AWP 102,001,202032,Staff,0,0,0,0
1683345806343,AWP 102,002,202033,Staff,0,0,0,0
1683345807371,BENG 100,A01,254234,Taylor Amos; Alyssa C,31,0,40,9
1683345808394,BENG 196,001,270013,Engler; Adam J.,9999,0,9999,0
1683345809419,BICD 100R,A01,202018,Smith; Laurie,0,7,32,32
1683345809419,BICD 100R,A02,202019,Smith; Laurie,0,2,32,32
1683345809419,BICD 100R,A03,202020,Smith; Laurie,0,1,32,32
1683345809419,BICD 100R,A04,202021,Smith; Laurie,9,0,32,23
1683345809419,BICD 100R,A05,202022,Smith; Laurie,12,0,32,20
1683345810447,BICD 136,A01,193242,Gustafson-Brown; Cindy,0,2,32,32
1683345810447,BICD 136,A02,193244,Gustafson-Brown; Cindy,14,0,32,18
1683345811476,BIEB 102,A01,193249,Butler; Shannon Rhey,0,2,32,32
1683345811476,BIEB 102,A02,193251,Butler; Shannon Rhey,0,0,32,32
1683345811476,BIEB 102,A03,193253,Butler; Shannon Rhey,0,1,32,32
1683345811476,BIEB 102,A04,193255,Butler; Shannon Rhey,17,0,32,15
1683345811476,BIEB 102,A05,193265,Butler; Shannon Rhey,26,0,32,6
1683345811476,BIEB 102,A06,193269,Butler; Shannon Rhey,16,0,32,16
1683345813528,BIEB 150,A01,193274,Staff,0,0,32,32
1683345813528,BIEB 150,A02,193285,Staff,23,0,32,9
1683345814555,BIEB 194,A00,193286,Kurle; Carolyn M.,22,0,32,10
1683345815584,BILD 1,A01,192291,Staff,16,0,32,16
1683345815584,BILD 1,A02,192292,Staff,30,0,32,2
1683345815584,BILD 1,B01,192520,Reuther; Keefe,0,1,0,0
1683345815584,BILD 1,B02,192532,Reuther; Keefe,0,1,0,0
1683345816610,BILD 3,A01,192556,Butler; Shannon Rhey,0,0,32,32
1683345816610,BILD 3,A02,192581,Butler; Shannon Rhey,5,0,32,27
1683345816610,BILD 3,A03,192611,Butler; Shannon Rhey,23,0,32,9
1683345816610,BILD 3,A04,192612,Butler; Shannon Rhey,25,0,32,7
1683345816610,BILD 3,A05,192613,Butler; Shannon Rhey,27,0,32,5
1683345816610,BILD 3,A06,192679,Butler; Shannon Rhey,27,0,32,5
1683345816610,BILD 3,A07,192682,Butler; Shannon Rhey,22,0,32,10
1683345817638,BILD 4,A01,192836,Reuther; Keefe,0,0,24,24
1683345817638,BILD 4,A02,193044,Reuther; Keefe,4,0,24,20
1683345818666,BILD 10,A01,193142,Gustafson-Brown; Cindy,30,0,32,2
1683345818666,BILD 10,A02,193149,Gustafson-Brown; Cindy,31,0,32,1
1683345819689,BIMM 100,A01,193301,Staff,0,6,32,32
1683345819689,BIMM 100,A02,193312,Staff,0,5,32,32
1683345819689,BIMM 100,A03,193323,Staff,0,8,32,32
1683345820718,BIMM 101,A01,193329,McDonnell; Lisa Marie,0,3,24,24
1683345820718,BIMM 101,A02,193339,McDonnell; Lisa Marie,0,3,24,24
1683345820718,BIMM 101,B01,193354,McDonnell; Lisa Marie,0,3,24,24
1683345820718,BIMM 101,B02,193357,McDonnell; Lisa Marie,0,3,24,24
1683345821742,BIMM 110,A01,193377,Tat; John,0,11,32,32
1683345821742,BIMM 110,A02,193378,Tat; John,1,9,32,31
1683345822767,BIMM 120,A01,206116,Staff,0,0,32,32
1683345822767,BIMM 120,A02,206117,Staff,8,0,32,24
1683345822767,BIMM 120,A03,206121,Staff,21,0,32,11
1683345823818,BIPN 100,A01,193393,Park; Ji Young,0,14,32,32
1683345823818,BIPN 100,A02,193402,Park; Ji Young,0,13,32,32
1683345823818,BIPN 100,A03,193413,Park; Ji Young,0,14,32,32
1683345823818,BIPN 100,A04,193414,Park; Ji Young,0,13,32,32
1683345824843,BIPN 102,A01,193429,Staff,0,0,32,32
1683345824843,BIPN 102,A02,193438,Staff,22,0,32,10
1683345825871,BIPN 106,A01,193450,Reyes Gonzalez; Catalina,0,2,40,40
1683345826901,BIPN 134,A01,193465,Cooke; James Edward,0,0,32,32
1683345826901,BIPN 134,A02,193474,Cooke; James Edward,25,0,32,7
1683345826901,BIPN 134,A03,193485,Cooke; James Edward,29,0,32,3
1683345826901,BIPN 134,A04,193486,Cooke; James Edward,21,0,32,11
1683345826901,BIPN 134,A05,193491,Cooke; James Edward,31,0,32,1
1683345826901,BIPN 134,A06,193501,Cooke; James Edward,30,0,32,2
1683345826901,BIPN 134,A07,193510,Cooke; James Edward,29,0,32,3
1683345828949,BISP 194,A00,222522,Staff,14,0,32,18
1683345829981,CAT 124,A01,202407,Staff,20,0,25,5
1683345831012,CAT 125,A00,202408,Marchisotto; Jennifer Anne,4,0,20,16
1683345832042,CAT 125R,A00,202409,Smith; Lauryn Alissa,0,11,20,20
1683345832042,CAT 125R,B00,202410,Morales; Celeste Georgianna,0,11,20,20
1683345832042,CAT 125R,C00,202411,Irwin; Matthew Joseph,0,10,20,20
1683345833068,CENG 15,A01,204712,Yang; Kesong,0,1,0,0
1683345834094,CENG 114,A00,202070,Jahed Motlagh; Zeinab,5,0,20,15
1683345835119,CGS 105,A00,185477,Wesling; Megan E.,24,0,40,16
1683345836145,CGS 106,A00,185494,Staff,13,0,22,9
1683345837203,CGS 108,A00,185495,Staff,14,0,20,6
1683345838226,CGS 114,A00,185496,Staff,13,0,18,5
1683345839251,CGS 119,A00,185501,Staff,15,0,20,5
1683345840277,CGS 120,A00,185511,Staff,13,0,20,7
1683345841306,CHEM 4,A01,184675,Bussey; Thomas J,96,0,100,4
1683345842330,CHEM 6A,A01,184677,Staff,34,0,60,26
1683345843354,CHEM 6B,A01,184679,Staff,65,0,100,35
1683345844379,CHEM 6C,A01,184681,Bussey; Thomas J,1,0,50,49
1683345844379,CHEM 6C,A02,184682,Bussey; Thomas J,34,0,50,16
1683345845403,CHEM 40A,A01,184684,Albizati; Kim F.,37,0,100,63
1683345846431,CHEM 40B,A01,184686,Albizati; Kim F.,0,20,100,100
1683345847460,CHEM 41B,A01,184690,Staff,52,0,100,48
1683345848485,COGS 3,A01,184715,Boyle; Mary E. T.,0,25,40,40
1683345849510,COGS 14B,A01,185172,Staff,0,15,38,38
1683345850536,COGS 18,A01,184736,Staff,17,0,80,63
1683345851564,COGS 100,A01,184932,Staff,0,5,73,73
1683345852592,COGS 101A,A01,184935,Staff,0,39,30,30
1683345853619,COGS 101B,A01,184944,Staff,0,2,30,30
1683345854647,COGS 101C,A01,184946,Staff,0,12,30,30
1683345855669,COGS 102A,A01,184951,Johnson; Christine M.,2,0,40,38
1683345856697,COGS 107B,A01,184953,Mooshagian; Eric Frederick,0,50,40,40
1683345857721,COGS 118B,A01,184959,Gupta; Anjum,0,48,40,40
1683345858745,COGS 153,A00,184961,Staff,0,15,30,30
1683345859772,COGS 177,A00,184962,Staff,0,20,30,30
1683345860799,COGS 187A,A01,184969,Boyle; Mary E. T.,0,17,40,40
1683345861827,COMM 10,A01,185174,Staff,0,5,25,25
1683345861827,COMM 10,A02,185189,Staff,0,5,25,25
1683345861827,COMM 10,A03,269821,Staff,0,0,0,0
1683345862855,COMM 100B,A01,185475,Staff,0,0,0,2
1683345862855,COMM 100B,A02,185476,Staff,13,0,25,12
1683345863882,COMM 100C,A01,185314,Staff,1,0,25,24
1683345863882,COMM 100C,A02,185327,Staff,19,0,25,6
1683345864907,COMM 110M,A00,185349,Staff,2,0,40,38
1683345865933,COMM 113T,A00,185352,Staff,24,0,40,16
1683345866959,COMM 114I,A00,185353,Staff,33,0,40,7
1683345867983,COMM 131,A00,185354,Staff,19,0,30,11
1683345869011,CSE 8A,A50,185358,Cao; Yingjun,0,46,10,10
1683345870038,CSE 8B,A01,185362,Staff,1,47,50,49
1683345871063,CSE 11,A01,185416,Cao; Yingjun,0,92,10,10
1683345872088,CSE 20,A01,185445,Briones; Jor-el Thomas Caparas,5,0,25,20
1683345873112,CSE 21,A01,185447,Staff,10,0,50,40
1683345874146,CSE 101,A01,185451,Staff,0,13,50,50
1683345874146,CSE 101,B01,185453,Jones; Miles E,0,11,50,50
1683345876200,CSE 141,A01,185458,Eldon; John,20,0,100,80
1683345877224,CSE 141L,A01,185461,Eldon; John,12,0,100,88
1683345878252,CSE 142,A01,185463,Staff,36,0,60,24
1683345878252,CSE 142,B01,201355,Staff,0,7,60,60
1683345879279,CSE 142L,A01,185470,Staff,36,0,60,24
1683345879279,CSE 142L,B01,201417,Staff,0,6,60,60
1683345880303,CSE 190,A00,201433,Staff,32,0,49,17
1683345881331,DOC 1,A01,259136,Strom; Megan C.,7,0,15,8
1683345881331,DOC 1,A02,259137,Strom; Megan C.,14,0,15,1
1683345881331,DOC 1,A03,259138,Strom; Megan C.,14,0,15,1
1683345881331,DOC 1,A04,259139,Strom; Megan C.,14,0,15,1
1683345882358,DOC 100D,A00,259140,Pass; Natalye Joann,16,0,25,9
1683345883385,DSGN 1,A01,184749,Rill; Bryan,0,25,30,30
1683345884414,DSGN 100,A01,185168,Staff,0,2,25,25
1683345885441,ECE 5,A01,185626,Morris; Karcher William,0,10,0,0
1683345886468,ECE 101,A01,185628,Staff,17,0,70,53
1683345887495,ECE 107,A01,185635,Baghdadchi; Saharnaz,0,0,20,20
1683345887495,ECE 107,A02,185638,Baghdadchi; Saharnaz,4,0,20,16
1683345888521,ECE 148,A01,185647,Silberman; Jack,0,0,16,16
1683345889545,ECON 1,A01,185537,Crane; Meredith Helen,54,0,70,16
1683345890569,ECON 3,A01,185549,Crane; Meredith Helen,32,0,70,38
1683345891597,ECON 4,A01,203354,Anderson; John Charles,0,4,10,10
1683345892621,ECON 100A,A01,185574,Staff,0,4,40,40
1683345893646,ECON 100B,A01,185576,Staff,10,22,50,40
1683345894675,ECON 100C,A01,185589,Newhouse; Herbert S,29,0,70,41
1683345895699,ECON 105,A00,185608,Vespa; Emanuel Ignacio,19,0,35,16
1683345896726,ECON 109,A01,185610,Shishkin; Denis,10,0,35,25
1683345897752,ECON 110A,A01,185612,Staff,11,0,40,29
1683345898776,ECON 120A,A01,185615,Staff,20,0,40,20
1683345899800,ECON 120C,A01,185617,Sun; Yixiao,0,21,70,70
1683345900828,ECON 144,A00,203346,Squires; Dale E,3,0,35,32
1683345901856,ECON 171,A01,203349,Newhouse; Herbert S,0,1,35,35
1683345902879,ECON 173A,A01,185621,Toda; Alexis Akira,21,0,35,14
1683345903911,EDS 25,A01,202413,Staff,0,1,0,0
1683345903911,EDS 25,A02,202414,Staff,0,1,0,0
1683345903911,EDS 25,A03,202415,Staff,0,0,0,0
1683345903911,EDS 25,A04,202416,Staff,0,1,0,0
1683345903911,EDS 25,A05,202439,Staff,0,0,0,0
1683345903911,EDS 25,A06,202440,Staff,0,0,0,0
1683345903911,EDS 25,B01,202631,Staff,0,0,0,0
1683345903911,EDS 25,B02,202632,Staff,0,0,0,0
1683345903911,EDS 25,B03,202639,Staff,0,0,0,0
1683345903911,EDS 25,B04,202640,Staff,0,0,0,0
1683345903911,EDS 25,B05,202643,Staff,0,0,0,0
1683345903911,EDS 25,B06,202644,Staff,0,0,0,0
1683345904939,EDS 38,A01,202659,Black; Alison Michelle,24,0,25,1
1683345905965,EDS 115,A00,202652,Staff,18,0,30,12
1683345906990,EDS 125,A00,202649,Staff,14,0,30,16
1683345908019,EDS 126,A01,203332,Staff,30,0,30,0
1683345909101,EDS 139,A00,202838,Staff,16,0,25,9
1683345910128,EDS 146,A01,202655,Staff,14,0,25,11
1683345911151,ENG 15,A00,185667,Staff,0,1,0,0
1683345911151,ENG 15,B00,185672,Staff,0,0,0,0
1683345911151,ENG 15,C00,185675,Staff,0,0,0,0
1683345911151,ENG 15,D00,185682,Staff,0,0,0,0
1683345911151,ENG 15,E00,185684,Staff,0,0,0,0
1683345912178,ETHN 103,A00,185710,Staff,0,4,35,35
1683345913204,ETHN 103A,A00,199228,Man; Simeon S,2,0,9,7
1683345914227,ETHN 109,A00,185711,Staff,18,0,35,17
1683345915252,ETHN 142,A00,185726,Staff,0,4,30,30
1683345916275,ETHN 163J,A00,199229,Man; Simeon S,5,0,8,3
1683345917303,ETHN 168,A00,185727,Staff,8,0,10,2
1683345918329,ETHN 182,A00,185728,Staff,1,0,35,34
1683345919353,ETHN 183,A00,185737,Staff,8,0,18,10
1683345920383,GLBH 111,A01,209361,Burgos; Jose L.,0,0,0,0
1683345922431,HIEU 104,A00,185792,Staff,16,0,20,4
1683345923458,HIEU 115,A00,185800,Staff,1,0,20,19
1683345924484,HIEU 128,A00,185801,Staff,0,7,20,20
1683345925511,HIEU 147,A00,185802,Staff,16,0,20,4
1683345926539,HIEU 154,A00,185823,Staff,12,0,20,8
1683345927565,HILA 102,A00,185826,Staff,13,0,20,7
1683345928596,HILD 2C,A01,185778,Staff,0,12,20,20
1683345929623,HILD 7B,A01,185780,Kwak; Nancy,0,15,32,32
1683345929623,HILD 7B,A02,185781,Kwak; Nancy,0,18,32,32
1683345930650,HILD 30,A01,185791,Staff,14,0,20,6
1683345931674,HISC 119,A00,185830,Golan; Tal,0,9,20,20
1683345932701,HITO 156GS,A00,185831,Patterson; Patrick H.,0,0,0,23
1683345933726,HIUS 103,A00,185832,Man; Simeon S,0,6,20,20
1683345934749,HIUS 117,A00,185836,Kwak; Nancy,2,0,20,18
1683345935776,HIUS 125,A00,185840,Man; Simeon S,0,0,23,23
1683345936803,HIUS 149,A00,185845,Staff,0,0,20,20
1683345937830,HUM 3,A01,185882,Zavodny; Tatiana Sophia,0,7,50,50
1683345937830,HUM 3,B01,185899,Caldwell; Michael Alan,0,18,50,50
1683345938854,HUM 3GS,A00,185900,Patterson; Patrick H.,0,0,0,23
1683345939878,HUM 4,A01,185938,Zroka; Amy Liane,31,0,50,19
1683345939878,HUM 4,B01,185956,Watkins; Eric,0,2,50,50
1683345939878,HUM 4,B02,202209,Watkins; Eric,0,2,50,50
1683345939878,HUM 4,B03,202210,Watkins; Eric,0,2,50,50
1683345940907,HUM 5,A01,185958,West; Geoffrey Scott,3,0,50,47
1683345940907,HUM 5,A02,202215,West; Geoffrey Scott,0,0,50,50
1683345941933,INTL 190,A00,185959,Gagnon; Jeffrey C,0,0,0,9
1683345941933,INTL 190,B00,185960,Lettieri; Michael Joseph,0,0,0,1
1683345942957,JAPN 180,A00,254509,Staff,5,1,30,25
1683345943982,LATI 10,A01,202853,Kennemore; Amy Michelle,4,0,35,31
1683345943982,LATI 10,A02,202854,Kennemore; Amy Michelle,2,0,35,33
1683345943982,LATI 10,A03,270054,Kennemore; Amy Michelle,30,0,30,0
1683345945007,LATI 180,A00,202855,Kennemore; Amy Michelle,11,0,20,9
1683345946032,LAWS 101,A00,201767,Golan; Tal,0,7,40,40
1683345947060,LIFR 1C,A00,185961,Staff,6,0,20,14
1683345948086,LIFR 1CX,A00,185962,Staff,7,0,20,13
1683345949112,LIFR 1D,A00,185963,Staff,9,0,20,11
1683345950138,LIFR 1DX,A00,185964,Staff,9,0,20,11
1683345951163,LIGN 101,A01,186039,Staff,43,0,50,7
1683345952191,LIGN 165,A00,186040,Staff,18,0,50,32
1683345953216,LTCS 108,A00,186041,Staff,6,0,10,4
1683345954240,LTCS 119,A00,186042,Staff,16,0,20,4
1683345955267,LTCS 130,A00,186043,Wesling; Megan E.,15,0,25,10
1683345957318,LTEA 138,A00,186119,Staff,14,0,40,26
1683345958345,LTEN 124,A00,186148,Staff,6,0,25,19
1683345959371,LTEN 178,A00,186149,Staff,7,0,15,8
1683345960396,LTEN 181,A00,186150,Blanco; John D,33,0,40,7
1683345961420,LTWL 120,A00,186160,Staff,20,0,25,5
1683345962449,LTWL 165,A00,186161,Staff,22,0,25,3
1683345963477,LTWR 100,A00,186162,Staff,0,5,15,15
1683345964502,LTWR 102,A00,186163,Doller; Ben,5,0,15,10
1683345965527,MAE 8,A01,186412,Staff,0,0,0,0
1683345966552,MAE 30B,A00,186445,Bahadori; Mohammad Yousef,83,0,100,17
1683345967576,MAE 40,A00,186592,Bewley; Thomas R,9,0,50,41
1683345968604,MAE 101B,A00,186593,Bahadori; Mohammad Yousef,81,0,100,19
1683345969631,MAE 105,A00,186594,Bandaru; Prabhakar,12,0,50,38
1683345970661,MAE 107,A00,186599,Pham; Hieu Tan,0,6,120,120
1683345971689,MAE 148,A01,186660,Silberman; Jack,3,0,16,13
1683345972716,MATH 10A,A01,188095,Staff,1,6,35,34
1683345973746,MATH 10B,A01,188097,Bowers; Adam R.,0,11,30,30
1683345973746,MATH 10B,A02,188099,Bowers; Adam R.,0,11,30,30
1683345973746,MATH 10B,B01,188104,Bowers; Adam R.,0,10,30,30
1683345973746,MATH 10B,B02,188106,Bowers; Adam R.,0,10,30,30
1683345974774,MATH 10C,A01,188111,Staff,0,18,30,30
1683345974774,MATH 10C,A02,188127,Staff,0,17,30,30
1683345974774,MATH 10C,A03,188131,Staff,0,18,30,30
1683345974774,MATH 10C,B01,188218,Staff,18,0,30,12
1683345974774,MATH 10C,B02,188244,Staff,13,0,30,17
1683345974774,MATH 10C,B03,188277,Staff,16,0,30,14
1683345975803,MATH 18,A01,188344,Bach; Quang Tran,18,0,30,12
1683345975803,MATH 18,A02,188345,Bach; Quang Tran,11,0,30,19
1683345975803,MATH 18,B01,188353,Bach; Quang Tran,10,0,30,20
1683345975803,MATH 18,B02,188354,Bach; Quang Tran,20,0,30,10
1683345976831,MATH 20A,A01,188374,Staff,13,0,35,22
1683345977861,MATH 20B,A01,188382,Ohm; Ko Woon,6,0,30,24
1683345977861,MATH 20B,A02,188383,Ohm; Ko Woon,22,0,30,8
1683345977861,MATH 20B,B01,188385,Ohm; Ko Woon,7,0,30,23
1683345977861,MATH 20B,B02,188392,Ohm; Ko Woon,22,0,30,8
1683345978886,MATH 20C,A01,188394,Harel; Guershon,10,0,30,20
1683345978886,MATH 20C,A02,188395,Harel; Guershon,15,0,30,15
1683345978886,MATH 20C,B01,188404,Harel; Guershon,5,0,30,25
1683345978886,MATH 20C,B02,188405,Harel; Guershon,19,0,30,11
1683345979911,MATH 20D,A01,188414,Hammock; Frances H,0,1,30,30
1683345979911,MATH 20D,A02,188415,Hammock; Frances H,3,0,30,27
1683345979911,MATH 20D,B01,188447,Hammock; Frances H,1,0,30,29
1683345979911,MATH 20D,B02,188486,Hammock; Frances H,8,0,30,22
1683345980935,MATH 20E,A01,188649,Staff,21,0,30,9
1683345980935,MATH 20E,A02,188650,Staff,23,0,30,7
1683345980935,MATH 20E,A03,188673,Staff,0,0,30,30
1683345981959,MATH 102,A01,188675,Staff,0,35,35,35
1683345982984,MATH 103B,A01,188681,Staff,3,0,35,32
1683345982984,MATH 103B,B01,188692,Staff,5,0,35,30
1683345984009,MATH 109,A01,188695,Salehi Golsefidy; Alireza,25,0,35,10
1683345984009,MATH 109,A02,188696,Salehi Golsefidy; Alireza,25,0,35,10
1683345985034,MATH 120A,A01,188698,Eggers; John Dietrich,7,0,35,28
1683345986062,MATH 142B,A01,188736,Ioana; Adrian,0,2,30,30
1683345986062,MATH 142B,A02,188741,Ioana; Adrian,1,1,30,29
1683345986062,MATH 142B,A03,188743,Ioana; Adrian,1,3,30,29
1683345987089,MATH 168A,A01,188790,Staff,0,9,35,35
1683345988113,MATH 170A,A01,188803,Nie; Jiawang,0,2,35,35
1683345988113,MATH 170A,A02,188811,Nie; Jiawang,0,0,35,35
1683345988113,MATH 170A,A03,188814,Nie; Jiawang,1,0,35,34
1683345988113,MATH 170A,A04,188815,Nie; Jiawang,13,0,35,22
1683345989139,MATH 193B,A01,188817,Staff,0,0,35,35
1683345989139,MATH 193B,A02,188818,Staff,5,0,35,30
1683345990163,MGT 4,A01,202857,Anderson; John Charles,62,0,80,18
1683345991187,MGT 12,A00,202858,Lindenberger; Wade Douglas,42,0,90,48
1683345992214,MGT 18,A00,202859,Staff,74,0,90,16
1683345993241,MGT 18GS,A00,202860,McKay; Michael J,13,0,28,15
1683345994264,MGT 45,A00,202861,Pecore; Joseph P.,14,0,90,76
1683345995291,MGT 100,A00,202863,Yavorsky; Daniel Ryan,28,0,90,62
1683345996319,MGT 103,A00,202864,Ehrich; Kristine R,1,18,90,89
1683345997346,MGT 112,A00,202865,Ehrich; Kristine R,15,0,90,75
1683345998375,MGT 121A,A00,202868,Staff,0,20,0,0
1683345999399,MGT 131B,A00,202869,Anderson; John Charles,59,0,90,31
1683346000422,MGT 136,A00,202871,Lindenberger; Wade Douglas,84,0,90,6
1683346001447,MGT 164,A00,202873,Staff,0,68,90,91
1683346002473,MGT 164GS,A00,202874,McKay; Mary A,13,0,28,15
1683346003498,MGT 180,A00,202875,Staff,0,50,90,91
1683346004523,MMW 11R,A01,205019,Herbst; Matthew,3,0,30,27
1683346004523,MMW 11R,A02,205026,Herbst; Matthew,29,0,30,1
1683346005549,MMW 15,A01,193512,Chang; Edmond Yi-Teh,0,9,28,28
1683346005549,MMW 15,A02,193513,Chang; Edmond Yi-Teh,0,5,28,28
1683346005549,MMW 15,A03,193514,Chang; Edmond Yi-Teh,0,5,28,28
1683346005549,MMW 15,A04,193515,Chang; Edmond Yi-Teh,0,5,28,28
1683346005549,MMW 15,A05,193516,Chang; Edmond Yi-Teh,0,4,28,28
1683346005549,MMW 15,A06,193517,Chang; Edmond Yi-Teh,0,5,28,28
1683346005549,MMW 15,B01,193519,Chang; Edmond Yi-Teh,0,5,28,28
1683346005549,MMW 15,B02,193520,Chang; Edmond Yi-Teh,0,5,28,28
1683346005549,MMW 15,B03,193521,Chang; Edmond Yi-Teh,0,5,28,28
1683346005549,MMW 15,B04,193522,Chang; Edmond Yi-Teh,0,4,28,28
1683346005549,MMW 15,B05,193523,Chang; Edmond Yi-Teh,0,5,28,28
1683346005549,MMW 15,B06,193524,Chang; Edmond Yi-Teh,0,4,28,28
1683346006574,MMW 122,A01,193526,Rahimi; Babak,0,15,28,28
1683346006574,MMW 122,A02,193527,Rahimi; Babak,0,14,28,28
1683346006574,MMW 122,A03,193528,Rahimi; Babak,0,0,0,0
1683346006574,MMW 122,A04,193529,Rahimi; Babak,0,0,0,0
1683346007599,MUS 1A,A01,186663,Staff,0,20,35,35
1683346008626,MUS 4,A01,186715,Staff,0,12,35,35
1683346009654,MUS 5R,A01,186796,Dubnov; Shlomo,0,17,35,35
1683346010682,MUS 6,A01,186798,Staff,0,4,25,25
1683346011707,MUS 7,A01,186830,Staff,13,0,35,22
1683346012791,MUS 8,A01,186930,Staff,0,26,35,35
1683346013823,MUS 15,A01,186932,Staff,0,16,35,35
1683346013823,MUS 15,B01,186934,Staff,0,15,35,35
1683346014851,MUS 80,A00,186935,Staff,1,0,20,19
1683346014851,MUS 80,B00,186936,Staff,25,0,25,0
1683346015879,NANO 11,A00,204702,Lipomi; Darren John,0,0,0,0
1683346016904,NANO 15,A01,204709,Yang; Kesong,0,1,0,0
1683346017934,NANO 114,A00,202069,Jahed Motlagh; Zeinab,3,0,10,7
1683346018962,PHIL 1,A00,186955,Grush; Rick Scott,32,0,40,8
1683346019987,PHIL 10,A01,186973,Grush; Rick Scott,28,0,35,7
1683346019987,PHIL 10,A02,186974,Grush; Rick Scott,33,0,35,2
1683346021012,PHIL 13,A01,186976,Staff,7,0,35,28
1683346021012,PHIL 13,A02,186977,Staff,16,0,35,19
1683346022041,PHIL 14,A01,186979,Staff,31,0,35,4
1683346022041,PHIL 14,A02,186986,Staff,32,0,35,3
1683346023068,PHIL 28,A01,186988,Staff,16,0,30,14
1683346023068,PHIL 28,A02,186989,Staff,1,0,30,29
1683346023068,PHIL 28,A03,186990,Staff,9,0,30,21
1683346023068,PHIL 28,A04,186991,Staff,26,0,30,4
1683346024096,PHIL 120,A00,186997,Staff,23,0,40,17
1683346025121,PHIL 137,A00,187003,Staff,9,0,40,31
1683346026148,PHIL 150,A00,187015,Staff,47,0,70,23
1683346027176,PHIL 167,A00,187021,Lamey; Andy M.,35,0,40,5
1683346028204,PHIL 174,A01,202226,Staff,17,0,20,3
1683346028204,PHIL 174,A02,202235,Staff,20,0,20,0
1683346029229,PHIL 191A,A00,258918,Staff,0,0,1,1
1683346030253,PHYS 1A,A00,187028,Staff,27,0,60,33
1683346031278,PHYS 1AL,001,187036,Staff,2,0,30,28
1683346031278,PHYS 1AL,002,187049,Staff,18,0,30,12
1683346032303,PHYS 1B,A00,187058,Staff,22,0,60,38
1683346033335,PHYS 1BL,001,187064,Staff,0,0,30,30
1683346033335,PHYS 1BL,002,187070,Staff,5,0,30,25
1683346034366,PHYS 1C,A00,187082,Staff,31,0,120,89
1683346035392,PHYS 1CL,001,187088,Staff,0,9,30,30
1683346035392,PHYS 1CL,002,187089,Staff,0,2,30,30
1683346035392,PHYS 1CL,009,262693,Staff,11,0,30,19
1683346036416,PHYS 2B,A01,187097,Staff,54,0,115,61
1683346037447,PHYS 2C,A01,187099,Staff,67,0,115,48
1683346038474,PHYS 2CL,A01,187101,Staff,5,0,28,23
1683346038474,PHYS 2CL,A02,187102,Staff,15,0,28,13
1683346039502,PHYS 2D,A01,187123,Shotwell; Brian,95,0,115,20
1683346040526,PHYS 4B,A01,187133,Grinstein; Benjamin,35,0,50,15
1683346041554,POLI 10,A00,188819,Staff,0,4,50,50
1683346042579,POLI 11,A00,188827,Staff,43,0,50,7
1683346043604,POLI 13R,A00,188828,Staff,0,1,20,20
1683346044629,POLI 27,A01,188830,Elgin; Samuel Zincke,0,1,70,70
1683346045654,POLI 30,A00,188832,Desposato; Scott,31,0,50,19
1683346046682,POLI 102F,A00,188834,Staff,3,0,40,37
1683346047710,POLI 104A,A00,188852,Staff,14,0,30,16
1683346048737,POLI 104I,A00,188853,Staff,0,6,20,20
1683346049761,POLI 110B,A00,188854,Wiens; David,7,0,20,13
1683346050788,POLI 112A,A00,188855,Wiens; David,5,0,30,25
1683346051816,POLI 117R,A00,188856,Forman; Fonna,0,11,20,20
1683346052844,POLI 118,A00,188857,Ingham; Sean,8,0,20,12
1683346053871,POLI 120G,A00,188858,Staff,9,0,30,21
1683346054895,POLI 131CR,A00,188863,Hoston; Germaine,24,0,50,26
1683346055923,POLI 133,A00,188864,Nellis; Gareth Hb,44,0,50,6
1683346056951,POLI 134D,A00,188865,Desposato; Scott,27,0,30,3
1683346057976,POLI 142A,A00,188871,Gartzke; Erik,22,0,50,28
1683346059004,POLI 142K,A00,188874,Staff,38,0,50,12
1683346060034,POLI 143,A00,188940,Gartzke; Erik,16,0,30,14
1683346061067,POLI 153,A00,188943,Staff,3,0,20,17
1683346062092,POLI 160AA,A00,188944,Staff,12,0,40,28
1683346063117,POLI 170A,A00,188945,Staff,11,0,30,19
1683346065167,PSYC 1,A00,188952,Staff,37,0,90,53
1683346066191,PSYC 2,B00,188953,Staff,19,0,35,16
1683346067219,PSYC 6,A00,188970,Staff,47,0,60,13
1683346068246,PSYC 7,A00,188973,Staff,37,0,45,8
1683346069270,PSYC 60,A01,188980,Rickard; Timothy C.,43,0,60,17
1683346070298,PSYC 70,A01,189001,Steiner; Eric Tomas,23,0,45,22
1683346071326,PSYC 100,A00,189005,Lacefield; Katharine I,0,98,120,120
1683346072351,PSYC 102,A00,189008,Staff,9,0,30,21
1683346073375,PSYC 106,B00,189026,Gorman; Michael R.,34,0,60,26
1683346074401,PSYC 114,B01,189033,Winkielman; Piotr,0,32,30,30
1683346075427,PSYC 131,A00,189036,Anagnostaras; Stephan,0,43,60,60
1683346076452,PSYC 136,A00,189041,Lowe; Angela Beth,0,7,25,25
1683346077481,PSYC 137,A00,189057,Winkielman; Piotr,0,34,25,25
1683346078510,PSYC 144,A00,189107,Wixted; John T,0,7,50,50
1683346080563,PSYC 162,A00,189142,Staff,0,8,85,85
1683346081591,PSYC 172,A00,189144,Gorman; Michael R.,0,7,30,30
1683346083646,PSYC 179,A00,189146,Lacefield; Katharine I,0,84,120,120
1683346084674,PSYC 181,A00,189147,Anagnostaras; Stephan,0,44,90,90
1683346085697,PSYC 190R,A00,189148,Barner; David A.,0,22,80,80
1683346086725,PSYC 191,A00,189275,Rickard; Timothy C.,0,7,25,25
1683346087754,PSYC 193,A00,189276,Chapman; Eddie Nathaniel,0,1,0,4
1683346088779,PSYC 193L,A01,189281,Lowe; Angela Beth,12,0,20,8
1683346088779,PSYC 193L,B01,189285,Staff,28,0,35,7
1683346089806,RELI 149,A00,187137,Rahimi; Babak,7,0,40,33
1683346090831,SE 9,A01,187315,Staff,0,2,18,18
1683346091860,SE 101B,A00,187409,Staff,24,0,30,6
1683346092886,SE 110B,A00,187444,Staff,10,0,40,30
1683346093913,SE 130B,A00,187449,Staff,31,0,40,9
1683346094937,SE 150A,A00,187516,Staff,9,0,20,11
1683346095962,SE 154,A00,187528,Staff,30,0,50,20
1683346096986,SIO 3,A01,258171,Staff,35,0,40,5
1683346098017,SIO 10,A00,187144,Cook; Geoffrey W,0,3,75,75
1683346099041,SIO 45,A00,187152,Cook; Geoffrey W,1,0,100,99
1683346100069,SIO 109R,A00,194486,Staff,0,3,20,20
1683346102119,SIO 187,A01,187233,Kacev; David,12,0,40,28
1683346103144,SOCI 1,A01,258656,Thorpe; Charles Robert,28,0,30,2
1683346103144,SOCI 1,A02,258658,Thorpe; Charles Robert,30,0,30,0
1683346103144,SOCI 1,A03,258661,Thorpe; Charles Robert,25,0,25,0
1683346103144,SOCI 1,A04,258666,Thorpe; Charles Robert,22,0,25,3
1683346103144,SOCI 1,A05,258897,Thorpe; Charles Robert,23,0,25,2
1683346103144,SOCI 1,A06,258898,Thorpe; Charles Robert,25,0,25,0
1683346104169,SOCI 30,A01,258903,Pardo Guerra; Juan Pablo,15,0,30,15
1683346105193,SOCI 102,A00,258904,Staff,9,0,25,16
1683346106221,SOCI 106,A00,258905,Staff,19,0,25,6
1683346107249,SOCI 111,A00,258907,Ribas Norris; Janet Vanesa,26,0,30,4
1683346108275,SOCI 121R,A00,258908,Pardo Guerra; Juan Pablo,10,0,30,20
1683346109299,SOCI 126,A01,203330,Staff,14,0,20,6
1683346110324,SOCI 131,A00,258909,Thorpe; Charles Robert,31,0,60,29
1683346111348,SOCI 135,A00,258910,Payne; Christine Anna,0,9,30,30
1683346112376,SOCI 157,A00,258911,Staff,12,0,30,18
1683346113401,SOCI 184,A00,258912,Staff,25,0,30,5
1683346114424,SOCI 188D,A00,258913,Staff,21,0,30,9
1683346115453,SYN 2,001,187529,Staff,10,0,16,6
1683346115453,SYN 2,002,201452,Staff,0,18,16,16
1683346115453,SYN 2,003,201469,Staff,3,0,16,13
1683346116533,SYN 100,A01,187531,Staff,0,9,20,20
1683346116533,SYN 100,B01,201491,Staff,0,12,20,20
1683346117558,TDAC 1,A00,189286,Walsh; Kim C.,3,0,20,17
1683346117558,TDAC 1,B00,189287,Harting; Carla Kelso,11,0,20,9
1683346118583,TDAC 101,A00,189300,Walsh; Kim C.,16,0,20,4
1683346118583,TDAC 101,B00,189301,Harting; Carla Kelso,18,0,20,2
1683346119611,TDAC 102,A00,189304,Basso; Beatrice,14,0,20,6
1683346120636,TDAC 108,A00,189305,Staff,18,0,20,2
1683346121662,TDDE 131,A00,189310,Staff,19,0,20,1
1683346121662,TDDE 131,B00,189314,Staff,19,0,20,1
1683346121662,TDDE 131,C00,189315,Staff,48,0,50,2
1683346121662,TDDE 131,D00,189316,Staff,14,0,15,1
1683346121662,TDDE 131,E00,204841,Staff,20,0,20,0
1683346122687,TDGE 10,A00,189289,Staff,30,0,50,20
1683346122687,TDGE 10,B00,189290,Havis; Allan,1,0,50,49
1683346123716,TDGE 11,A00,189291,Fulton; Julia,0,3,50,50
1683346123716,TDGE 11,B00,189292,Staff,20,0,25,5
1683346123716,TDGE 11,C00,260270,Staff,0,0,0,0
1683346124741,TDGE 25,A00,189294,Staff,3,0,20,17
1683346125769,TDGE 124,A00,189318,Fulton; Julia,0,8,50,50
1683346126795,TDGE 125,A00,189319,Staff,13,0,25,12
1683346126795,TDGE 125,B00,189320,Staff,23,0,25,2
1683346127820,TDGE 127,A00,189322,Havis; Allan,0,0,50,50
1683346128843,TDHT 101,A00,189323,Staff,18,0,25,7
1683346128843,TDHT 101,B00,189324,Staff,25,0,25,0
1683346129867,TDHT 102,A00,189325,Staff,49,0,50,1
1683346130895,TDMV 1,A00,189295,Arcidiacono; Kristin,19,0,30,11
1683346130895,TDMV 1,B00,189296,Caligagan; Maria T.,24,0,30,6
1683346131925,TDMV 2,A00,189297,Sammartano; Tonnie,28,0,30,2
1683346131925,TDMV 2,B00,189299,Arcidiacono; Kristin,24,0,30,6
1683346132954,TDMV 3,A00,204998,Rincon; Alicia,22,0,30,8
1683346133984,TDMV 120,A00,189458,Sammartano; Tonnie,28,0,30,2
1683346135009,TDMV 138,A00,189541,Jun; Grace Shin Hae,22,0,40,18
1683346136034,TDMV 142,A00,189717,Caligagan; Tony,23,0,30,7
1683346136034,TDMV 142,B00,189718,Caligagan; Maria T.,25,0,30,5
1683346137061,TMC 2,A01,187533,Staff,25,0,25,0
1683346137061,TMC 2,A02,187534,Staff,25,0,25,0
1683346138085,USP 1,A01,187536,Kwak; Nancy,0,16,25,25
1683346139112,USP 5,A01,187538,Staff,10,0,25,15
1683346140135,USP 101,A00,199253,Staff,0,4,0,0
1683346141161,USP 124,A00,187562,Boomhower; Matthew Charles,1,0,30,29
1683346142188,USP 138,A00,187582,Staff,20,0,25,5
1683346143213,USP 152,A01,187597,Staff,4,0,25,21
1683346144238,USP 153,A00,187598,Staff,19,0,25,6
1683346145262,USP 168,A00,187607,Kwak; Nancy,2,0,5,3
1683346146289,USP 173,A00,187619,Staff,4,0,25,21
1683346147317,USP 181,A00,187638,Staff,0,0,25,25
1683346148343,VIS 103,A00,187650,Cruz; Edwin Teddy,23,0,75,52
1683346149370,VIS 110D,A00,187669,Staff,12,0,22,10
1683346150396,VIS 127C,A00,187720,Shen; Kuiyi,67,0,146,79
1683346151426,VIS 149,A00,187731,Yoldas; Pinar,0,14,22,22
1683346152451,VIS 151,A01,188091,Staff,22,0,34,12
1683346152451,VIS 151,A02,188092,Staff,11,0,34,23
1683346153476,VIS 160B,A00,188093,Stalbaum; Brett,0,0,10,10
1683346155529,WCWP 10B,A00,201720,Staff,10,0,15,5
1683346155529,WCWP 10B,B00,201722,Staff,9,0,15,6
1683346156558,WCWP 100,A00,201725,Gagnon; Jeffrey C,0,0,2,2
1683346156558,WCWP 100,B00,201727,Staff,0,4,15,15
1683346159651,ANBI 133,A00,258401,Wilder; Linnea Lorene,34,0,40,6
1683346160676,ANBI 140,A00,258395,Hrvoj Mihic; Branka,18,0,25,7
1683346161702,ANSC 120,A00,258402,Bialecki; Jon Anthony,27,0,40,13
1683346162726,ANSC 144,A00,258400,Staff,14,0,40,26
1683346164774,ANSC 166,A00,258396,Parish; Steven Martin,157,0,175,18
1683346165797,ANSC 180,A00,193533,Staff,9,0,20,11
1683346166824,ANSC 188,A00,258397,Jassal; Aftab,33,0,40,7
1683346167850,ANTH 3,A01,258316,Staff,23,0,30,7
1683346168874,ANTH 5,A00,258394,Semendeferi; Ekaterini,16,0,20,4
1683346169901,ANTH 21,A01,258331,Staff,8,0,40,32
1683346170925,ANTH 103,A00,258398,Varma; Saiba,15,0,25,10
1683346171952,AWP 10,001,202034,Staff,0,0,0,0
1683346171952,AWP 10,002,202035,Staff,0,0,0,0
1683346171952,AWP 10,003,202036,Staff,0,0,0,0
1683346171952,AWP 10,004,202037,Staff,0,0,0,0
1683346171952,AWP 10,005,202038,Staff,0,0,0,0
1683346171952,AWP 10,006,202039,Staff,0,0,0,0
1683346171952,AWP 10,007,202040,Staff,0,0,0,0
1683346171952,AWP 10,008,202041,Staff,0,0,0,0
1683346171952,AWP 10,009,202042,Staff,0,0,0,0
1683346171952,AWP 10,010,202043,Staff,0,0,0,0
1683346171952,AWP 10,011,202044,Staff,0,0,0,0
1683346171952,AWP 10,012,202045,Staff,0,0,0,0
1683346171952,AWP 10,013,202046,Staff,0,0,0,0
1683346171952,AWP 10,014,202047,Staff,0,0,0,0
1683346171952,AWP 10,015,202048,Staff,0,0,0,0
1683346171952,AWP 10,016,202049,Staff,0,0,0,0
1683346171952,AWP 10,017,202050,Staff,0,0,0,0
1683346171952,AWP 10,018,202051,Staff,0,0,0,0
1683346171952,AWP 10,019,202052,Staff,0,0,0,0
1683346171952,AWP 10,020,202053,Staff,0,0,0,0
1683346171952,AWP 10,021,202054,Staff,0,0,0,0
1683346171952,AWP 10,022,202055,Staff,0,0,0,0
1683346171952,AWP 10,023,202056,Staff,0,0,0,0
1683346171952,AWP 10,024,202057,Staff,0,0,0,0
1683346171952,AWP 10,025,202058,Staff,0,0,0,0
1683346171952,AWP 10,026,202059,Staff,0,0,0,0
1683346172978,AWP 102,001,202032,Staff,0,0,0,0
1683346172978,AWP 102,002,202033,Staff,0,0,0,0
1683346174005,BENG 100,A01,254234,Taylor Amos; Alyssa C,31,0,40,9
1683346175029,BENG 196,001,270013,Engler; Adam J.,9999,0,9999,0
1683346176056,BICD 100R,A01,202018,Smith; Laurie,0,7,32,32
1683346176056,BICD 100R,A02,202019,Smith; Laurie,0,2,32,32
1683346176056,BICD 100R,A03,202020,Smith; Laurie,0,1,32,32
1683346176056,BICD 100R,A04,202021,Smith; Laurie,9,0,32,23
1683346176056,BICD 100R,A05,202022,Smith; Laurie,12,0,32,20
1683346177083,BICD 136,A01,193242,Gustafson-Brown; Cindy,0,2,32,32
1683346177083,BICD 136,A02,193244,Gustafson-Brown; Cindy,14,0,32,18
1683346178111,BIEB 102,A01,193249,Butler; Shannon Rhey,0,2,32,32
1683346178111,BIEB 102,A02,193251,Butler; Shannon Rhey,0,0,32,32
1683346178111,BIEB 102,A03,193253,Butler; Shannon Rhey,0,1,32,32
1683346178111,BIEB 102,A04,193255,Butler; Shannon Rhey,17,0,32,15
1683346178111,BIEB 102,A05,193265,Butler; Shannon Rhey,26,0,32,6
1683346178111,BIEB 102,A06,193269,Butler; Shannon Rhey,16,0,32,16
1683346180164,BIEB 150,A01,193274,Staff,0,0,32,32
1683346180164,BIEB 150,A02,193285,Staff,23,0,32,9
1683346181189,BIEB 194,A00,193286,Kurle; Carolyn M.,22,0,32,10
1683346182215,BILD 1,A01,192291,Staff,16,0,32,16
1683346182215,BILD 1,A02,192292,Staff,30,0,32,2
1683346182215,BILD 1,B01,192520,Reuther; Keefe,0,1,0,0
1683346182215,BILD 1,B02,192532,Reuther; Keefe,0,1,0,0
1683346183243,BILD 3,A01,192556,Butler; Shannon Rhey,0,0,32,32
1683346183243,BILD 3,A02,192581,Butler; Shannon Rhey,5,0,32,27
1683346183243,BILD 3,A03,192611,Butler; Shannon Rhey,23,0,32,9
1683346183243,BILD 3,A04,192612,Butler; Shannon Rhey,25,0,32,7
1683346183243,BILD 3,A05,192613,Butler; Shannon Rhey,27,0,32,5
1683346183243,BILD 3,A06,192679,Butler; Shannon Rhey,27,0,32,5
1683346183243,BILD 3,A07,192682,Butler; Shannon Rhey,22,0,32,10
1683346184273,BILD 4,A01,192836,Reuther; Keefe,0,0,24,24
1683346184273,BILD 4,A02,193044,Reuther; Keefe,4,0,24,20
1683346185302,BILD 10,A01,193142,Gustafson-Brown; Cindy,30,0,32,2
1683346185302,BILD 10,A02,193149,Gustafson-Brown; Cindy,31,0,32,1
1683346186326,BIMM 100,A01,193301,Staff,0,6,32,32
1683346186326,BIMM 100,A02,193312,Staff,0,5,32,32
1683346186326,BIMM 100,A03,193323,Staff,0,8,32,32
1683346187350,BIMM 101,A01,193329,McDonnell; Lisa Marie,0,3,24,24
1683346187350,BIMM 101,A02,193339,McDonnell; Lisa Marie,0,3,24,24
1683346187350,BIMM 101,B01,193354,McDonnell; Lisa Marie,0,3,24,24
1683346187350,BIMM 101,B02,193357,McDonnell; Lisa Marie,0,3,24,24
1683346188375,BIMM 110,A01,193377,Tat; John,0,11,32,32
1683346188375,BIMM 110,A02,193378,Tat; John,1,9,32,31
1683346189400,BIMM 120,A01,206116,Staff,0,0,32,32
1683346189400,BIMM 120,A02,206117,Staff,8,0,32,24
1683346189400,BIMM 120,A03,206121,Staff,21,0,32,11
1683346190429,BIPN 100,A01,193393,Park; Ji Young,0,14,32,32
1683346190429,BIPN 100,A02,193402,Park; Ji Young,0,13,32,32
1683346190429,BIPN 100,A03,193413,Park; Ji Young,0,14,32,32
1683346190429,BIPN 100,A04,193414,Park; Ji Young,0,13,32,32
1683346191454,BIPN 102,A01,193429,Staff,0,0,32,32
1683346191454,BIPN 102,A02,193438,Staff,22,0,32,10
1683346192482,BIPN 106,A01,193450,Reyes Gonzalez; Catalina,0,2,40,40
1683346193508,BIPN 134,A01,193465,Cooke; James Edward,0,0,32,32
1683346193508,BIPN 134,A02,193474,Cooke; James Edward,25,0,32,7
1683346193508,BIPN 134,A03,193485,Cooke; James Edward,29,0,32,3
1683346193508,BIPN 134,A04,193486,Cooke; James Edward,21,0,32,11
1683346193508,BIPN 134,A05,193491,Cooke; James Edward,31,0,32,1
1683346193508,BIPN 134,A06,193501,Cooke; James Edward,30,0,32,2
1683346193508,BIPN 134,A07,193510,Cooke; James Edward,29,0,32,3
1683346195561,BISP 194,A00,222522,Staff,14,0,32,18
1683346196585,CAT 124,A01,202407,Staff,20,0,25,5
1683346197609,CAT 125,A00,202408,Marchisotto; Jennifer Anne,4,0,20,16
1683346198634,CAT 125R,A00,202409,Smith; Lauryn Alissa,0,11,20,20
1683346198634,CAT 125R,B00,202410,Morales; Celeste Georgianna,0,11,20,20
1683346198634,CAT 125R,C00,202411,Irwin; Matthew Joseph,0,10,20,20
1683346199660,CENG 15,A01,204712,Yang; Kesong,0,1,0,0
1683346200687,CENG 114,A00,202070,Jahed Motlagh; Zeinab,5,0,20,15
1683346201714,CGS 105,A00,185477,Wesling; Megan E.,24,0,40,16
1683346202738,CGS 106,A00,185494,Staff,13,0,22,9
1683346203763,CGS 108,A00,185495,Staff,14,0,20,6
1683346204788,CGS 114,A00,185496,Staff,13,0,18,5
1683346205814,CGS 119,A00,185501,Staff,15,0,20,5
1683346206841,CGS 120,A00,185511,Staff,13,0,20,7
1683346207870,CHEM 4,A01,184675,Bussey; Thomas J,96,0,100,4
1683346208898,CHEM 6A,A01,184677,Staff,34,0,60,26
1683346209922,CHEM 6B,A01,184679,Staff,65,0,100,35
1683346210947,CHEM 6C,A01,184681,Bussey; Thomas J,1,0,50,49
1683346210947,CHEM 6C,A02,184682,Bussey; Thomas J,34,0,50,16
1683346211975,CHEM 40A,A01,184684,Albizati; Kim F.,37,0,100,63
1683346212998,CHEM 40B,A01,184686,Albizati; Kim F.,0,20,100,100
1683346214023,CHEM 41B,A01,184690,Staff,52,0,100,48
1683346215050,COGS 3,A01,184715,Boyle; Mary E. T.,0,25,40,40
1683346216076,COGS 14B,A01,185172,Staff,0,15,38,38
1683346217105,COGS 18,A01,184736,Staff,17,0,80,63
1683346218132,COGS 100,A01,184932,Staff,0,5,73,73
1683346219159,COGS 101A,A01,184935,Staff,0,39,30,30
1683346220260,COGS 101B,A01,184944,Staff,0,2,30,30
1683346221283,COGS 101C,A01,184946,Staff,0,12,30,30
1683346222313,COGS 102A,A01,184951,Johnson; Christine M.,2,0,40,38
1683346223339,COGS 107B,A01,184953,Mooshagian; Eric Frederick,0,50,40,40
1683346224366,COGS 118B,A01,184959,Gupta; Anjum,0,48,40,40
1683346225392,COGS 153,A00,184961,Staff,0,15,30,30
1683346226416,COGS 177,A00,184962,Staff,0,20,30,30
1683346227441,COGS 187A,A01,184969,Boyle; Mary E. T.,0,17,40,40
1683346228464,COMM 10,A01,185174,Staff,0,5,25,25
1683346228464,COMM 10,A02,185189,Staff,0,5,25,25
1683346228464,COMM 10,A03,269821,Staff,0,0,0,0
1683346229490,COMM 100B,A01,185475,Staff,0,0,0,2
1683346229490,COMM 100B,A02,185476,Staff,13,0,25,12
1683346230518,COMM 100C,A01,185314,Staff,1,0,25,24
1683346230518,COMM 100C,A02,185327,Staff,19,0,25,6
1683346231548,COMM 110M,A00,185349,Staff,2,0,40,38
1683346232575,COMM 113T,A00,185352,Staff,24,0,40,16
1683346233601,COMM 114I,A00,185353,Staff,33,0,40,7
1683346234626,COMM 131,A00,185354,Staff,19,0,30,11
1683346235650,CSE 8A,A50,185358,Cao; Yingjun,0,46,10,10
1683346236674,CSE 8B,A01,185362,Staff,1,47,50,49
1683346237698,CSE 11,A01,185416,Cao; Yingjun,0,92,10,10
1683346238726,CSE 20,A01,185445,Briones; Jor-el Thomas Caparas,5,0,25,20
1683346239751,CSE 21,A01,185447,Staff,10,0,50,40
1683346240775,CSE 101,A01,185451,Staff,0,13,50,50
1683346240775,CSE 101,B01,185453,Jones; Miles E,0,11,50,50
1683346242826,CSE 141,A01,185458,Eldon; John,20,0,100,80
1683346243854,CSE 141L,A01,185461,Eldon; John,12,0,100,88
1683346244878,CSE 142,A01,185463,Staff,36,0,60,24
1683346244878,CSE 142,B01,201355,Staff,0,7,60,60
1683346245906,CSE 142L,A01,185470,Staff,36,0,60,24
1683346245906,CSE 142L,B01,201417,Staff,0,6,60,60
1683346246933,CSE 190,A00,201433,Staff,32,0,49,17
1683346247958,DOC 1,A01,259136,Strom; Megan C.,7,0,15,8
1683346247958,DOC 1,A02,259137,Strom; Megan C.,14,0,15,1
1683346247958,DOC 1,A03,259138,Strom; Megan C.,14,0,15,1
1683346247958,DOC 1,A04,259139,Strom; Megan C.,14,0,15,1
1683346248986,DOC 100D,A00,259140,Pass; Natalye Joann,16,0,25,9
1683346250014,DSGN 1,A01,184749,Rill; Bryan,0,25,30,30
1683346251039,DSGN 100,A01,185168,Staff,0,2,25,25
1683346252067,ECE 5,A01,185626,Morris; Karcher William,0,10,0,0
1683346253094,ECE 101,A01,185628,Staff,17,0,70,53
1683346254117,ECE 107,A01,185635,Baghdadchi; Saharnaz,0,0,20,20
1683346254117,ECE 107,A02,185638,Baghdadchi; Saharnaz,4,0,20,16
1683346255140,ECE 148,A01,185647,Silberman; Jack,0,0,16,16
1683346256164,ECON 1,A01,185537,Crane; Meredith Helen,54,0,70,16
1683346257194,ECON 3,A01,185549,Crane; Meredith Helen,32,0,70,38
1683346258217,ECON 4,A01,203354,Anderson; John Charles,0,4,10,10
1683346259241,ECON 100A,A01,185574,Staff,0,4,40,40
1683346260268,ECON 100B,A01,185576,Staff,10,22,50,40
1683346261297,ECON 100C,A01,185589,Newhouse; Herbert S,29,0,70,41
1683346262324,ECON 105,A00,185608,Vespa; Emanuel Ignacio,19,0,35,16
1683346263352,ECON 109,A01,185610,Shishkin; Denis,10,0,35,25
1683346264375,ECON 110A,A01,185612,Staff,11,0,40,29
1683346265403,ECON 120A,A01,185615,Staff,20,0,40,20
1683346266431,ECON 120C,A01,185617,Sun; Yixiao,0,21,70,70
1683346267456,ECON 144,A00,203346,Squires; Dale E,3,0,35,32
1683346268480,ECON 171,A01,203349,Newhouse; Herbert S,0,1,35,35
1683346269505,ECON 173A,A01,185621,Toda; Alexis Akira,21,0,35,14
1683346270529,EDS 25,A01,202413,Staff,0,1,0,0
1683346270529,EDS 25,A02,202414,Staff,0,1,0,0
1683346270529,EDS 25,A03,202415,Staff,0,0,0,0
1683346270529,EDS 25,A04,202416,Staff,0,1,0,0
1683346270529,EDS 25,A05,202439,Staff,0,0,0,0
1683346270529,EDS 25,A06,202440,Staff,0,0,0,0
1683346270529,EDS 25,B01,202631,Staff,0,0,0,0
1683346270529,EDS 25,B02,202632,Staff,0,0,0,0
1683346270529,EDS 25,B03,202639,Staff,0,0,0,0
1683346270529,EDS 25,B04,202640,Staff,0,0,0,0
1683346270529,EDS 25,B05,202643,Staff,0,0,0,0
1683346270529,EDS 25,B06,202644,Staff,0,0,0,0
1683346271556,EDS 38,A01,202659,Black; Alison Michelle,24,0,25,1
1683346272583,EDS 115,A00,202652,Staff,18,0,30,12
1683346273609,EDS 125,A00,202649,Staff,14,0,30,16
1683346274636,EDS 126,A01,203332,Staff,30,0,30,0
1683346275663,EDS 139,A00,202838,Staff,16,0,25,9
1683346276688,EDS 146,A01,202655,Staff,14,0,25,11
1683346277713,ENG 15,A00,185667,Staff,0,1,0,0
1683346277713,ENG 15,B00,185672,Staff,0,0,0,0
1683346277713,ENG 15,C00,185675,Staff,0,0,0,0
1683346277713,ENG 15,D00,185682,Staff,0,0,0,0
1683346277713,ENG 15,E00,185684,Staff,0,0,0,0
1683346278737,ETHN 103,A00,185710,Staff,0,4,35,35
1683346279760,ETHN 103A,A00,199228,Man; Simeon S,2,0,9,7
1683346280784,ETHN 109,A00,185711,Staff,18,0,35,17
1683346281811,ETHN 142,A00,185726,Staff,0,4,30,30
1683346282834,ETHN 163J,A00,199229,Man; Simeon S,5,0,8,3
1683346283857,ETHN 168,A00,185727,Staff,8,0,10,2
1683346284881,ETHN 182,A00,185728,Staff,1,0,35,34
1683346285904,ETHN 183,A00,185737,Staff,8,0,18,10
1683346286928,GLBH 111,A01,209361,Burgos; Jose L.,0,0,0,0
1683346288980,HIEU 104,A00,185792,Staff,16,0,20,4
1683346290008,HIEU 115,A00,185800,Staff,1,0,20,19
1683346291035,HIEU 128,A00,185801,Staff,0,7,20,20
1683346292058,HIEU 147,A00,185802,Staff,16,0,20,4
1683346293082,HIEU 154,A00,185823,Staff,12,0,20,8
1683346294106,HILA 102,A00,185826,Staff,13,0,20,7
1683346295133,HILD 2C,A01,185778,Staff,0,12,20,20
1683346296160,HILD 7B,A01,185780,Kwak; Nancy,0,15,32,32
1683346296160,HILD 7B,A02,185781,Kwak; Nancy,0,18,32,32
1683346297188,HILD 30,A01,185791,Staff,14,0,20,6
1683346298214,HISC 119,A00,185830,Golan; Tal,0,9,20,20
1683346299241,HITO 156GS,A00,185831,Patterson; Patrick H.,0,0,0,23
1683346300264,HIUS 103,A00,185832,Man; Simeon S,0,6,20,20
1683346301287,HIUS 117,A00,185836,Kwak; Nancy,2,0,20,18
1683346302311,HIUS 125,A00,185840,Man; Simeon S,0,0,23,23
1683346303338,HIUS 149,A00,185845,Staff,0,0,20,20
1683346304363,HUM 3,A01,185882,Zavodny; Tatiana Sophia,0,7,50,50
1683346304363,HUM 3,B01,185899,Caldwell; Michael Alan,0,18,50,50
1683346305387,HUM 3GS,A00,185900,Patterson; Patrick H.,0,0,0,23
1683346306412,HUM 4,A01,185938,Zroka; Amy Liane,31,0,50,19
1683346306412,HUM 4,B01,185956,Watkins; Eric,0,2,50,50
1683346306412,HUM 4,B02,202209,Watkins; Eric,0,2,50,50
1683346306412,HUM 4,B03,202210,Watkins; Eric,0,2,50,50
1683346307437,HUM 5,A01,185958,West; Geoffrey Scott,3,0,50,47
1683346307437,HUM 5,A02,202215,West; Geoffrey Scott,0,0,50,50
1683346308461,INTL 190,A00,185959,Gagnon; Jeffrey C,0,0,0,9
1683346308461,INTL 190,B00,185960,Lettieri; Michael Joseph,0,0,0,1
1683346309487,JAPN 180,A00,254509,Staff,5,1,30,25
1683346310515,LATI 10,A01,202853,Kennemore; Amy Michelle,4,0,35,31
1683346310515,LATI 10,A02,202854,Kennemore; Amy Michelle,2,0,35,33
1683346310515,LATI 10,A03,270054,Kennemore; Amy Michelle,30,0,30,0
1683346311541,LATI 180,A00,202855,Kennemore; Amy Michelle,11,0,20,9
1683346312566,LAWS 101,A00,201767,Golan; Tal,0,7,40,40
1683346313593,LIFR 1C,A00,185961,Staff,6,0,20,14
1683346314621,LIFR 1CX,A00,185962,Staff,7,0,20,13
1683346315648,LIFR 1D,A00,185963,Staff,9,0,20,11
1683346316671,LIFR 1DX,A00,185964,Staff,9,0,20,11
1683346317695,LIGN 101,A01,186039,Staff,43,0,50,7
1683346318719,LIGN 165,A00,186040,Staff,18,0,50,32
1683346319745,LTCS 108,A00,186041,Staff,6,0,10,4
1683346320771,LTCS 119,A00,186042,Staff,16,0,20,4
1683346321794,LTCS 130,A00,186043,Wesling; Megan E.,15,0,25,10
1683346323907,LTEA 138,A00,186119,Staff,14,0,40,26
1683346324969,LTEN 124,A00,186148,Staff,6,0,25,19
1683346325993,LTEN 178,A00,186149,Staff,7,0,15,8
1683346327017,LTEN 181,A00,186150,Blanco; John D,33,0,40,7
1683346328041,LTWL 120,A00,186160,Staff,20,0,25,5
1683346329065,LTWL 165,A00,186161,Staff,22,0,25,3
1683346330090,LTWR 100,A00,186162,Staff,0,5,15,15
1683346331115,LTWR 102,A00,186163,Doller; Ben,5,0,15,10
1683346332140,MAE 8,A01,186412,Staff,0,0,0,0
1683346333165,MAE 30B,A00,186445,Bahadori; Mohammad Yousef,83,0,100,17
1683346334190,MAE 40,A00,186592,Bewley; Thomas R,9,0,50,41
1683346335218,MAE 101B,A00,186593,Bahadori; Mohammad Yousef,81,0,100,19
1683346336244,MAE 105,A00,186594,Bandaru; Prabhakar,12,0,50,38
1683346337269,MAE 107,A00,186599,Pham; Hieu Tan,0,6,120,120
1683346338297,MAE 148,A01,186660,Silberman; Jack,3,0,16,13
1683346339326,MATH 10A,A01,188095,Staff,1,6,35,34
1683346340355,MATH 10B,A01,188097,Bowers; Adam R.,0,11,30,30
1683346340355,MATH 10B,A02,188099,Bowers; Adam R.,0,11,30,30
1683346340355,MATH 10B,B01,188104,Bowers; Adam R.,0,10,30,30
1683346340355,MATH 10B,B02,188106,Bowers; Adam R.,0,10,30,30
1683346341384,MATH 10C,A01,188111,Staff,0,18,30,30
1683346341384,MATH 10C,A02,188127,Staff,0,17,30,30
1683346341384,MATH 10C,A03,188131,Staff,0,18,30,30
1683346341384,MATH 10C,B01,188218,Staff,18,0,30,12
1683346341384,MATH 10C,B02,188244,Staff,13,0,30,17
1683346341384,MATH 10C,B03,188277,Staff,16,0,30,14
1683346342412,MATH 18,A01,188344,Bach; Quang Tran,18,0,30,12
1683346342412,MATH 18,A02,188345,Bach; Quang Tran,11,0,30,19
1683346342412,MATH 18,B01,188353,Bach; Quang Tran,10,0,30,20
1683346342412,MATH 18,B02,188354,Bach; Quang Tran,20,0,30,10
1683346343438,MATH 20A,A01,188374,Staff,13,0,35,22
1683346344464,MATH 20B,A01,188382,Ohm; Ko Woon,6,0,30,24
1683346344464,MATH 20B,A02,188383,Ohm; Ko Woon,22,0,30,8
1683346344464,MATH 20B,B01,188385,Ohm; Ko Woon,7,0,30,23
1683346344464,MATH 20B,B02,188392,Ohm; Ko Woon,22,0,30,8
1683346345490,MATH 20C,A01,188394,Harel; Guershon,10,0,30,20
1683346345490,MATH 20C,A02,188395,Harel; Guershon,15,0,30,15
1683346345490,MATH 20C,B01,188404,Harel; Guershon,5,0,30,25
1683346345490,MATH 20C,B02,188405,Harel; Guershon,19,0,30,11
1683346346515,MATH 20D,A01,188414,Hammock; Frances H,0,1,30,30
1683346346515,MATH 20D,A02,188415,Hammock; Frances H,3,0,30,27
1683346346515,MATH 20D,B01,188447,Hammock; Frances H,1,0,30,29
1683346346515,MATH 20D,B02,188486,Hammock; Frances H,8,0,30,22
1683346347544,MATH 20E,A01,188649,Staff,21,0,30,9
1683346347544,MATH 20E,A02,188650,Staff,23,0,30,7
1683346347544,MATH 20E,A03,188673,Staff,0,0,30,30
1683346348571,MATH 102,A01,188675,Staff,0,35,35,35
1683346349600,MATH 103B,A01,188681,Staff,3,0,35,32
1683346349600,MATH 103B,B01,188692,Staff,5,0,35,30
1683346350631,MATH 109,A01,188695,Salehi Golsefidy; Alireza,25,0,35,10
1683346350631,MATH 109,A02,188696,Salehi Golsefidy; Alireza,25,0,35,10
1683346351659,MATH 120A,A01,188698,Eggers; John Dietrich,7,0,35,28
1683346352684,MATH 142B,A01,188736,Ioana; Adrian,0,2,30,30
1683346352684,MATH 142B,A02,188741,Ioana; Adrian,1,1,30,29
1683346352684,MATH 142B,A03,188743,Ioana; Adrian,1,3,30,29
1683346353713,MATH 168A,A01,188790,Staff,0,9,35,35
1683346354738,MATH 170A,A01,188803,Nie; Jiawang,0,2,35,35
1683346354738,MATH 170A,A02,188811,Nie; Jiawang,0,0,35,35
1683346354738,MATH 170A,A03,188814,Nie; Jiawang,1,0,35,34
1683346354738,MATH 170A,A04,188815,Nie; Jiawang,13,0,35,22
1683346355763,MATH 193B,A01,188817,Staff,0,0,35,35
1683346355763,MATH 193B,A02,188818,Staff,5,0,35,30
1683346356788,MGT 4,A01,202857,Anderson; John Charles,62,0,80,18
1683346357813,MGT 12,A00,202858,Lindenberger; Wade Douglas,42,0,90,48
1683346358838,MGT 18,A00,202859,Staff,74,0,90,16
1683346359862,MGT 18GS,A00,202860,McKay; Michael J,13,0,28,15
1683346360888,MGT 45,A00,202861,Pecore; Joseph P.,14,0,90,76
1683346361914,MGT 100,A00,202863,Yavorsky; Daniel Ryan,28,0,90,62
1683346362940,MGT 103,A00,202864,Ehrich; Kristine R,1,18,90,89
1683346363968,MGT 112,A00,202865,Ehrich; Kristine R,15,0,90,75
1683346364996,MGT 121A,A00,202868,Staff,0,20,0,0
1683346366024,MGT 131B,A00,202869,Anderson; John Charles,59,0,90,31
1683346367049,MGT 136,A00,202871,Lindenberger; Wade Douglas,84,0,90,6
1683346368075,MGT 164,A00,202873,Staff,0,68,90,91
1683346369099,MGT 164GS,A00,202874,McKay; Mary A,13,0,28,15
1683346370128,MGT 180,A00,202875,Staff,0,50,90,91
1683346371154,MMW 11R,A01,205019,Herbst; Matthew,3,0,30,27
1683346371154,MMW 11R,A02,205026,Herbst; Matthew,29,0,30,1
1683346372182,MMW 15,A01,193512,Chang; Edmond Yi-Teh,0,9,28,28
1683346372182,MMW 15,A02,193513,Chang; Edmond Yi-Teh,0,5,28,28
1683346372182,MMW 15,A03,193514,Chang; Edmond Yi-Teh,0,5,28,28
1683346372182,MMW 15,A04,193515,Chang; Edmond Yi-Teh,0,5,28,28
1683346372182,MMW 15,A05,193516,Chang; Edmond Yi-Teh,0,4,28,28
1683346372182,MMW 15,A06,193517,Chang; Edmond Yi-Teh,0,5,28,28
1683346372182,MMW 15,B01,193519,Chang; Edmond Yi-Teh,0,5,28,28
1683346372182,MMW 15,B02,193520,Chang; Edmond Yi-Teh,0,5,28,28
1683346372182,MMW 15,B03,193521,Chang; Edmond Yi-Teh,0,5,28,28
1683346372182,MMW 15,B04,193522,Chang; Edmond Yi-Teh,0,4,28,28
1683346372182,MMW 15,B05,193523,Chang; Edmond Yi-Teh,0,5,28,28
1683346372182,MMW 15,B06,193524,Chang; Edmond Yi-Teh,0,4,28,28
1683346373207,MMW 122,A01,193526,Rahimi; Babak,0,15,28,28
1683346373207,MMW 122,A02,193527,Rahimi; Babak,0,14,28,28
1683346373207,MMW 122,A03,193528,Rahimi; Babak,0,0,0,0
1683346373207,MMW 122,A04,193529,Rahimi; Babak,0,0,0,0
1683346374236,MUS 1A,A01,186663,Staff,0,20,35,35
1683346375260,MUS 4,A01,186715,Staff,0,12,35,35
1683346376285,MUS 5R,A01,186796,Dubnov; Shlomo,0,17,35,35
1683346377309,MUS 6,A01,186798,Staff,0,4,25,25
1683346378332,MUS 7,A01,186830,Staff,13,0,35,22
1683346379357,MUS 8,A01,186930,Staff,0,26,35,35
1683346380386,MUS 15,A01,186932,Staff,0,16,35,35
1683346380386,MUS 15,B01,186934,Staff,0,15,35,35
1683346381417,MUS 80,A00,186935,Staff,1,0,20,19
1683346381417,MUS 80,B00,186936,Staff,25,0,25,0
1683346382453,NANO 11,A00,204702,Lipomi; Darren John,0,0,0,0
1683346383482,NANO 15,A01,204709,Yang; Kesong,0,1,0,0
1683346384507,NANO 114,A00,202069,Jahed Motlagh; Zeinab,3,0,10,7
1683346385532,PHIL 1,A00,186955,Grush; Rick Scott,32,0,40,8
1683346386562,PHIL 10,A01,186973,Grush; Rick Scott,28,0,35,7
1683346386562,PHIL 10,A02,186974,Grush; Rick Scott,33,0,35,2
1683346387588,PHIL 13,A01,186976,Staff,7,0,35,28
1683346387588,PHIL 13,A02,186977,Staff,16,0,35,19
1683346388615,PHIL 14,A01,186979,Staff,31,0,35,4
1683346388615,PHIL 14,A02,186986,Staff,32,0,35,3
1683346389640,PHIL 28,A01,186988,Staff,16,0,30,14
1683346389640,PHIL 28,A02,186989,Staff,1,0,30,29
1683346389640,PHIL 28,A03,186990,Staff,9,0,30,21
1683346389640,PHIL 28,A04,186991,Staff,26,0,30,4
1683346390668,PHIL 120,A00,186997,Staff,23,0,40,17
1683346391696,PHIL 137,A00,187003,Staff,9,0,40,31
1683346392722,PHIL 150,A00,187015,Staff,47,0,70,23
1683346393749,PHIL 167,A00,187021,Lamey; Andy M.,35,0,40,5
1683346394774,PHIL 174,A01,202226,Staff,17,0,20,3
1683346394774,PHIL 174,A02,202235,Staff,20,0,20,0
1683346395799,PHIL 191A,A00,258918,Staff,0,0,1,1
1683346396824,PHYS 1A,A00,187028,Staff,27,0,60,33
1683346397850,PHYS 1AL,001,187036,Staff,2,0,30,28
1683346397850,PHYS 1AL,002,187049,Staff,18,0,30,12
1683346398877,PHYS 1B,A00,187058,Staff,22,0,60,38
1683346399902,PHYS 1BL,001,187064,Staff,0,0,30,30
1683346399902,PHYS 1BL,002,187070,Staff,5,0,30,25
1683346400927,PHYS 1C,A00,187082,Staff,31,0,120,89
1683346401956,PHYS 1CL,001,187088,Staff,0,9,30,30
1683346401956,PHYS 1CL,002,187089,Staff,0,2,30,30
1683346401956,PHYS 1CL,009,262693,Staff,11,0,30,19
1683346402983,PHYS 2B,A01,187097,Staff,54,0,115,61
1683346404012,PHYS 2C,A01,187099,Staff,67,0,115,48
1683346405038,PHYS 2CL,A01,187101,Staff,5,0,28,23
1683346405038,PHYS 2CL,A02,187102,Staff,15,0,28,13
1683346406067,PHYS 2D,A01,187123,Shotwell; Brian,95,0,115,20
1683346407096,PHYS 4B,A01,187133,Grinstein; Benjamin,35,0,50,15
1683346408122,POLI 10,A00,188819,Staff,0,4,50,50
1683346409147,POLI 11,A00,188827,Staff,43,0,50,7
1683346410171,POLI 13R,A00,188828,Staff,0,1,20,20
1683346411197,POLI 27,A01,188830,Elgin; Samuel Zincke,0,1,70,70
1683346412222,POLI 30,A00,188832,Desposato; Scott,31,0,50,19
1683346413246,POLI 102F,A00,188834,Staff,3,0,40,37
1683346414272,POLI 104A,A00,188852,Staff,14,0,30,16
1683346415300,POLI 104I,A00,188853,Staff,0,6,20,20
1683346416348,POLI 110B,A00,188854,Wiens; David,7,0,20,13
1683346417373,POLI 112A,A00,188855,Wiens; David,5,0,30,25
1683346418398,POLI 117R,A00,188856,Forman; Fonna,0,11,20,20
1683346419422,POLI 118,A00,188857,Ingham; Sean,8,0,20,12
1683346420446,POLI 120G,A00,188858,Staff,9,0,30,21
1683346421470,POLI 131CR,A00,188863,Hoston; Germaine,24,0,50,26
1683346422495,POLI 133,A00,188864,Nellis; Gareth Hb,44,0,50,6
1683346423525,POLI 134D,A00,188865,Desposato; Scott,27,0,30,3
1683346424549,POLI 142A,A00,188871,Gartzke; Erik,22,0,50,28
1683346425574,POLI 142K,A00,188874,Staff,38,0,50,12
1683346426598,POLI 143,A00,188940,Gartzke; Erik,16,0,30,14
1683346427679,POLI 153,A00,188943,Staff,3,0,20,17
1683346428705,POLI 160AA,A00,188944,Staff,12,0,40,28
1683346429730,POLI 170A,A00,188945,Staff,11,0,30,19
1683346431782,PSYC 1,A00,188952,Staff,37,0,90,53
1683346432806,PSYC 2,B00,188953,Staff,19,0,35,16
1683346433832,PSYC 6,A00,188970,Staff,47,0,60,13
1683346434857,PSYC 7,A00,188973,Staff,37,0,45,8
1683346435886,PSYC 60,A01,188980,Rickard; Timothy C.,43,0,60,17
1683346436909,PSYC 70,A01,189001,Steiner; Eric Tomas,23,0,45,22
1683346437938,PSYC 100,A00,189005,Lacefield; Katharine I,0,98,120,120
1683346438964,PSYC 102,A00,189008,Staff,9,0,30,21
1683346439993,PSYC 106,B00,189026,Gorman; Michael R.,34,0,60,26
1683346441018,PSYC 114,B01,189033,Winkielman; Piotr,0,32,30,30
1683346442043,PSYC 131,A00,189036,Anagnostaras; Stephan,0,43,60,60
1683346443071,PSYC 136,A00,189041,Lowe; Angela Beth,0,7,25,25
1683346444100,PSYC 137,A00,189057,Winkielman; Piotr,0,34,25,25
1683346445128,PSYC 144,A00,189107,Wixted; John T,0,7,50,50
1683346447178,PSYC 162,A00,189142,Staff,0,8,85,85
1683346448203,PSYC 172,A00,189144,Gorman; Michael R.,0,7,30,30
1683346450258,PSYC 179,A00,189146,Lacefield; Katharine I,0,84,120,120
1683346451286,PSYC 181,A00,189147,Anagnostaras; Stephan,0,44,90,90
1683346452311,PSYC 190R,A00,189148,Barner; David A.,0,22,80,80
1683346453335,PSYC 191,A00,189275,Rickard; Timothy C.,0,7,25,25
1683346454364,PSYC 193,A00,189276,Chapman; Eddie Nathaniel,0,1,0,4
1683346455389,PSYC 193L,A01,189281,Lowe; Angela Beth,12,0,20,8
1683346455389,PSYC 193L,B01,189285,Staff,28,0,35,7
1683346456417,RELI 149,A00,187137,Rahimi; Babak,7,0,40,33
1683346457442,SE 9,A01,187315,Staff,0,2,18,18
1683346458466,SE 101B,A00,187409,Staff,24,0,30,6
1683346459496,SE 110B,A00,187444,Staff,10,0,40,30
1683346460519,SE 130B,A00,187449,Staff,31,0,40,9
1683346461543,SE 150A,A00,187516,Staff,9,0,20,11
1683346462570,SE 154,A00,187528,Staff,30,0,50,20
1683346463598,SIO 3,A01,258171,Staff,35,0,40,5
1683346464622,SIO 10,A00,187144,Cook; Geoffrey W,0,3,75,75
1683346465645,SIO 45,A00,187152,Cook; Geoffrey W,1,0,100,99
1683346466670,SIO 109R,A00,194486,Staff,0,3,20,20
1683346468725,SIO 187,A01,187233,Kacev; David,12,0,40,28
1683346469748,SOCI 1,A01,258656,Thorpe; Charles Robert,28,0,30,2
1683346469748,SOCI 1,A02,258658,Thorpe; Charles Robert,30,0,30,0
1683346469748,SOCI 1,A03,258661,Thorpe; Charles Robert,25,0,25,0
1683346469748,SOCI 1,A04,258666,Thorpe; Charles Robert,22,0,25,3
1683346469748,SOCI 1,A05,258897,Thorpe; Charles Robert,23,0,25,2
1683346469748,SOCI 1,A06,258898,Thorpe; Charles Robert,25,0,25,0
1683346470773,SOCI 30,A01,258903,Pardo Guerra; Juan Pablo,15,0,30,15
1683346471798,SOCI 102,A00,258904,Staff,9,0,25,16
1683346472825,SOCI 106,A00,258905,Staff,19,0,25,6
1683346473852,SOCI 111,A00,258907,Ribas Norris; Janet Vanesa,26,0,30,4
1683346474878,SOCI 121R,A00,258908,Pardo Guerra; Juan Pablo,10,0,30,20
1683346475906,SOCI 126,A01,203330,Staff,14,0,20,6
1683346476931,SOCI 131,A00,258909,Thorpe; Charles Robert,31,0,60,29
1683346477959,SOCI 135,A00,258910,Payne; Christine Anna,0,9,30,30
1683346478984,SOCI 157,A00,258911,Staff,12,0,30,18
1683346480012,SOCI 184,A00,258912,Staff,25,0,30,5
1683346481038,SOCI 188D,A00,258913,Staff,21,0,30,9
1683346482068,SYN 2,001,187529,Staff,10,0,16,6
1683346482068,SYN 2,002,201452,Staff,0,18,16,16
1683346482068,SYN 2,003,201469,Staff,3,0,16,13
1683346483098,SYN 100,A01,187531,Staff,0,9,20,20
1683346483098,SYN 100,B01,201491,Staff,0,12,20,20
1683346484123,TDAC 1,A00,189286,Walsh; Kim C.,3,0,20,17
1683346484123,TDAC 1,B00,189287,Harting; Carla Kelso,11,0,20,9
1683346485148,TDAC 101,A00,189300,Walsh; Kim C.,16,0,20,4
1683346485148,TDAC 101,B00,189301,Harting; Carla Kelso,18,0,20,2
1683346486175,TDAC 102,A00,189304,Basso; Beatrice,14,0,20,6
1683346487204,TDAC 108,A00,189305,Staff,18,0,20,2
1683346488232,TDDE 131,A00,189310,Staff,19,0,20,1
1683346488232,TDDE 131,B00,189314,Staff,19,0,20,1
1683346488232,TDDE 131,C00,189315,Staff,48,0,50,2
1683346488232,TDDE 131,D00,189316,Staff,14,0,15,1
1683346488232,TDDE 131,E00,204841,Staff,20,0,20,0
1683346489257,TDGE 10,A00,189289,Staff,30,0,50,20
1683346489257,TDGE 10,B00,189290,Havis; Allan,1,0,50,49
1683346490283,TDGE 11,A00,189291,Fulton; Julia,0,3,50,50
1683346490283,TDGE 11,B00,189292,Staff,20,0,25,5
1683346490283,TDGE 11,C00,260270,Staff,0,0,0,0
1683346491308,TDGE 25,A00,189294,Staff,3,0,20,17
1683346492333,TDGE 124,A00,189318,Fulton; Julia,0,8,50,50
1683346493361,TDGE 125,A00,189319,Staff,13,0,25,12
1683346493361,TDGE 125,B00,189320,Staff,23,0,25,2
1683346494385,TDGE 127,A00,189322,Havis; Allan,0,0,50,50
1683346495409,TDHT 101,A00,189323,Staff,18,0,25,7
1683346495409,TDHT 101,B00,189324,Staff,25,0,25,0
1683346496434,TDHT 102,A00,189325,Staff,49,0,50,1
1683346497459,TDMV 1,A00,189295,Arcidiacono; Kristin,19,0,30,11
1683346497459,TDMV 1,B00,189296,Caligagan; Maria T.,24,0,30,6
1683346498484,TDMV 2,A00,189297,Sammartano; Tonnie,28,0,30,2
1683346498484,TDMV 2,B00,189299,Arcidiacono; Kristin,24,0,30,6
1683346499508,TDMV 3,A00,204998,Rincon; Alicia,22,0,30,8
1683346500533,TDMV 120,A00,189458,Sammartano; Tonnie,28,0,30,2
1683346501556,TDMV 138,A00,189541,Jun; Grace Shin Hae,22,0,40,18
1683346502580,TDMV 142,A00,189717,Caligagan; Tony,23,0,30,7
1683346502580,TDMV 142,B00,189718,Caligagan; Maria T.,25,0,30,5
1683346503608,TMC 2,A01,187533,Staff,25,0,25,0
1683346503608,TMC 2,A02,187534,Staff,25,0,25,0
1683346504638,USP 1,A01,187536,Kwak; Nancy,0,16,25,25
1683346505666,USP 5,A01,187538,Staff,10,0,25,15
1683346506687,USP 101,A00,199253,Staff,0,4,0,0
1683346507714,USP 124,A00,187562,Boomhower; Matthew Charles,1,0,30,29
1683346508739,USP 138,A00,187582,Staff,20,0,25,5
1683346509763,USP 152,A01,187597,Staff,4,0,25,21
1683346510790,USP 153,A00,187598,Staff,19,0,25,6
1683346511817,USP 168,A00,187607,Kwak; Nancy,2,0,5,3
1683346512842,USP 173,A00,187619,Staff,4,0,25,21
1683346513867,USP 181,A00,187638,Staff,0,0,25,25
1683346514891,VIS 103,A00,187650,Cruz; Edwin Teddy,23,0,75,52
1683346515918,VIS 110D,A00,187669,Staff,12,0,22,10
1683346516945,VIS 127C,A00,187720,Shen; Kuiyi,67,0,146,79
1683346517972,VIS 149,A00,187731,Yoldas; Pinar,0,14,22,22
1683346518999,VIS 151,A01,188091,Staff,22,0,34,12
1683346518999,VIS 151,A02,188092,Staff,11,0,34,23
1683346520023,VIS 160B,A00,188093,Stalbaum; Brett,0,0,10,10
1683346522081,WCWP 10B,A00,201720,Staff,10,0,15,5
1683346522081,WCWP 10B,B00,201722,Staff,9,0,15,6
1683346523106,WCWP 100,A00,201725,Gagnon; Jeffrey C,0,0,2,2
1683346523106,WCWP 100,B00,201727,Staff,0,4,15,15
1683346526202,ANBI 133,A00,258401,Wilder; Linnea Lorene,34,0,40,6
1683346527225,ANBI 140,A00,258395,Hrvoj Mihic; Branka,18,0,25,7
1683346528251,ANSC 120,A00,258402,Bialecki; Jon Anthony,27,0,40,13
1683346529276,ANSC 144,A00,258400,Staff,14,0,40,26
1683346531387,ANSC 166,A00,258396,Parish; Steven Martin,157,0,175,18
1683346532412,ANSC 180,A00,193533,Staff,9,0,20,11
1683346533439,ANSC 188,A00,258397,Jassal; Aftab,33,0,40,7
1683346534463,ANTH 3,A01,258316,Staff,23,0,30,7
1683346535488,ANTH 5,A00,258394,Semendeferi; Ekaterini,16,0,20,4
1683346536516,ANTH 21,A01,258331,Staff,8,0,40,32
1683346537540,ANTH 103,A00,258398,Varma; Saiba,15,0,25,10
1683346538568,AWP 10,001,202034,Staff,0,0,0,0
1683346538568,AWP 10,002,202035,Staff,0,0,0,0
1683346538568,AWP 10,003,202036,Staff,0,0,0,0
1683346538568,AWP 10,004,202037,Staff,0,0,0,0
1683346538568,AWP 10,005,202038,Staff,0,0,0,0
1683346538568,AWP 10,006,202039,Staff,0,0,0,0
1683346538568,AWP 10,007,202040,Staff,0,0,0,0
1683346538568,AWP 10,008,202041,Staff,0,0,0,0
1683346538568,AWP 10,009,202042,Staff,0,0,0,0
1683346538568,AWP 10,010,202043,Staff,0,0,0,0
1683346538568,AWP 10,011,202044,Staff,0,0,0,0
1683346538568,AWP 10,012,202045,Staff,0,0,0,0
1683346538568,AWP 10,013,202046,Staff,0,0,0,0
1683346538568,AWP 10,014,202047,Staff,0,0,0,0
1683346538568,AWP 10,015,202048,Staff,0,0,0,0
1683346538568,AWP 10,016,202049,Staff,0,0,0,0
1683346538568,AWP 10,017,202050,Staff,0,0,0,0
1683346538568,AWP 10,018,202051,Staff,0,0,0,0
1683346538568,AWP 10,019,202052,Staff,0,0,0,0
1683346538568,AWP 10,020,202053,Staff,0,0,0,0
1683346538568,AWP 10,021,202054,Staff,0,0,0,0
1683346538568,AWP 10,022,202055,Staff,0,0,0,0
1683346538568,AWP 10,023,202056,Staff,0,0,0,0
1683346538568,AWP 10,024,202057,Staff,0,0,0,0
1683346538568,AWP 10,025,202058,Staff,0,0,0,0
1683346538568,AWP 10,026,202059,Staff,0,0,0,0
1683346539593,AWP 102,001,202032,Staff,0,0,0,0
1683346539593,AWP 102,002,202033,Staff,0,0,0,0
1683346540619,BENG 100,A01,254234,Taylor Amos; Alyssa C,31,0,40,9
1683346541643,BENG 196,001,270013,Engler; Adam J.,9999,0,9999,0
1683346542668,BICD 100R,A01,202018,Smith; Laurie,0,7,32,32
1683346542668,BICD 100R,A02,202019,Smith; Laurie,0,2,32,32
1683346542668,BICD 100R,A03,202020,Smith; Laurie,0,1,32,32
1683346542668,BICD 100R,A04,202021,Smith; Laurie,9,0,32,23
1683346542668,BICD 100R,A05,202022,Smith; Laurie,12,0,32,20
1683346543694,BICD 136,A01,193242,Gustafson-Brown; Cindy,0,2,32,32
1683346543694,BICD 136,A02,193244,Gustafson-Brown; Cindy,14,0,32,18
1683346544721,BIEB 102,A01,193249,Butler; Shannon Rhey,0,2,32,32
1683346544721,BIEB 102,A02,193251,Butler; Shannon Rhey,0,0,32,32
1683346544721,BIEB 102,A03,193253,Butler; Shannon Rhey,0,1,32,32
1683346544721,BIEB 102,A04,193255,Butler; Shannon Rhey,17,0,32,15
1683346544721,BIEB 102,A05,193265,Butler; Shannon Rhey,26,0,32,6
1683346544721,BIEB 102,A06,193269,Butler; Shannon Rhey,16,0,32,16
1683346546776,BIEB 150,A01,193274,Staff,0,0,32,32
1683346546776,BIEB 150,A02,193285,Staff,23,0,32,9
1683346547800,BIEB 194,A00,193286,Kurle; Carolyn M.,22,0,32,10
1683346548829,BILD 1,A01,192291,Staff,16,0,32,16
1683346548829,BILD 1,A02,192292,Staff,30,0,32,2
1683346548829,BILD 1,B01,192520,Reuther; Keefe,0,1,0,0
1683346548829,BILD 1,B02,192532,Reuther; Keefe,0,1,0,0
1683346549859,BILD 3,A01,192556,Butler; Shannon Rhey,0,0,32,32
1683346549859,BILD 3,A02,192581,Butler; Shannon Rhey,5,0,32,27
1683346549859,BILD 3,A03,192611,Butler; Shannon Rhey,23,0,32,9
1683346549859,BILD 3,A04,192612,Butler; Shannon Rhey,25,0,32,7
1683346549859,BILD 3,A05,192613,Butler; Shannon Rhey,27,0,32,5
1683346549859,BILD 3,A06,192679,Butler; Shannon Rhey,27,0,32,5
1683346549859,BILD 3,A07,192682,Butler; Shannon Rhey,22,0,32,10
1683346550888,BILD 4,A01,192836,Reuther; Keefe,0,0,24,24
1683346550888,BILD 4,A02,193044,Reuther; Keefe,4,0,24,20
1683346551914,BILD 10,A01,193142,Gustafson-Brown; Cindy,30,0,32,2
1683346551914,BILD 10,A02,193149,Gustafson-Brown; Cindy,31,0,32,1
1683346552943,BIMM 100,A01,193301,Staff,0,6,32,32
1683346552943,BIMM 100,A02,193312,Staff,0,5,32,32
1683346552943,BIMM 100,A03,193323,Staff,0,8,32,32
1683346553969,BIMM 101,A01,193329,McDonnell; Lisa Marie,0,3,24,24
1683346553969,BIMM 101,A02,193339,McDonnell; Lisa Marie,0,3,24,24
1683346553969,BIMM 101,B01,193354,McDonnell; Lisa Marie,0,3,24,24
1683346553969,BIMM 101,B02,193357,McDonnell; Lisa Marie,0,3,24,24
1683346554997,BIMM 110,A01,193377,Tat; John,0,11,32,32
1683346554997,BIMM 110,A02,193378,Tat; John,1,9,32,31
1683346556022,BIMM 120,A01,206116,Staff,0,0,32,32
1683346556022,BIMM 120,A02,206117,Staff,8,0,32,24
1683346556022,BIMM 120,A03,206121,Staff,21,0,32,11
1683346557047,BIPN 100,A01,193393,Park; Ji Young,0,14,32,32
1683346557047,BIPN 100,A02,193402,Park; Ji Young,0,13,32,32
1683346557047,BIPN 100,A03,193413,Park; Ji Young,0,14,32,32
1683346557047,BIPN 100,A04,193414,Park; Ji Young,0,13,32,32
1683346558074,BIPN 102,A01,193429,Staff,0,0,32,32
1683346558074,BIPN 102,A02,193438,Staff,22,0,32,10
1683346559099,BIPN 106,A01,193450,Reyes Gonzalez; Catalina,0,2,40,40
1683346560124,BIPN 134,A01,193465,Cooke; James Edward,0,0,32,32
1683346560124,BIPN 134,A02,193474,Cooke; James Edward,25,0,32,7
1683346560124,BIPN 134,A03,193485,Cooke; James Edward,29,0,32,3
1683346560124,BIPN 134,A04,193486,Cooke; James Edward,21,0,32,11
1683346560124,BIPN 134,A05,193491,Cooke; James Edward,31,0,32,1
1683346560124,BIPN 134,A06,193501,Cooke; James Edward,30,0,32,2
1683346560124,BIPN 134,A07,193510,Cooke; James Edward,29,0,32,3
1683346562178,BISP 194,A00,222522,Staff,14,0,32,18
1683346563202,CAT 124,A01,202407,Staff,20,0,25,5
1683346564227,CAT 125,A00,202408,Marchisotto; Jennifer Anne,4,0,20,16
1683346565252,CAT 125R,A00,202409,Smith; Lauryn Alissa,0,11,20,20
1683346565252,CAT 125R,B00,202410,Morales; Celeste Georgianna,0,11,20,20
1683346565252,CAT 125R,C00,202411,Irwin; Matthew Joseph,0,10,20,20
1683346566281,CENG 15,A01,204712,Yang; Kesong,0,1,0,0
1683346567309,CENG 114,A00,202070,Jahed Motlagh; Zeinab,5,0,20,15
1683346568334,CGS 105,A00,185477,Wesling; Megan E.,24,0,40,16
1683346569359,CGS 106,A00,185494,Staff,13,0,22,9
1683346570382,CGS 108,A00,185495,Staff,14,0,20,6
1683346571407,CGS 114,A00,185496,Staff,13,0,18,5
1683346572431,CGS 119,A00,185501,Staff,15,0,20,5
1683346573455,CGS 120,A00,185511,Staff,13,0,20,7
1683346574481,CHEM 4,A01,184675,Bussey; Thomas J,96,0,100,4
1683346575510,CHEM 6A,A01,184677,Staff,34,0,60,26
1683346576537,CHEM 6B,A01,184679,Staff,65,0,100,35
1683346577561,CHEM 6C,A01,184681,Bussey; Thomas J,1,0,50,49
1683346577561,CHEM 6C,A02,184682,Bussey; Thomas J,34,0,50,16
1683346578587,CHEM 40A,A01,184684,Albizati; Kim F.,37,0,100,63
1683346579615,CHEM 40B,A01,184686,Albizati; Kim F.,0,20,100,100
1683346580643,CHEM 41B,A01,184690,Staff,52,0,100,48
1683346581671,COGS 3,A01,184715,Boyle; Mary E. T.,0,25,40,40
1683346582700,COGS 14B,A01,185172,Staff,0,15,38,38
1683346583725,COGS 18,A01,184736,Staff,17,0,80,63
1683346584750,COGS 100,A01,184932,Staff,0,5,73,73
1683346585773,COGS 101A,A01,184935,Staff,0,39,30,30
1683346586797,COGS 101B,A01,184944,Staff,0,2,30,30
1683346587822,COGS 101C,A01,184946,Staff,0,12,30,30
1683346588846,COGS 102A,A01,184951,Johnson; Christine M.,2,0,40,38
1683346589869,COGS 107B,A01,184953,Mooshagian; Eric Frederick,0,50,40,40
1683346590896,COGS 118B,A01,184959,Gupta; Anjum,0,48,40,40
1683346591923,COGS 153,A00,184961,Staff,0,15,30,30
1683346592954,COGS 177,A00,184962,Staff,0,20,30,30
1683346593981,COGS 187A,A01,184969,Boyle; Mary E. T.,0,17,40,40
1683346595009,COMM 10,A01,185174,Staff,0,5,25,25
1683346595009,COMM 10,A02,185189,Staff,0,5,25,25
1683346595009,COMM 10,A03,269821,Staff,0,0,0,0
1683346596034,COMM 100B,A01,185475,Staff,0,0,0,2
1683346596034,COMM 100B,A02,185476,Staff,13,0,25,12
1683346597060,COMM 100C,A01,185314,Staff,1,0,25,24
1683346597060,COMM 100C,A02,185327,Staff,19,0,25,6
1683346598085,COMM 110M,A00,185349,Staff,2,0,40,38
1683346599112,COMM 113T,A00,185352,Staff,24,0,40,16
1683346600142,COMM 114I,A00,185353,Staff,33,0,40,7
1683346601166,COMM 131,A00,185354,Staff,19,0,30,11
1683346602195,CSE 8A,A50,185358,Cao; Yingjun,0,46,10,10
1683346603219,CSE 8B,A01,185362,Staff,1,47,50,49
1683346604243,CSE 11,A01,185416,Cao; Yingjun,0,92,10,10
1683346605270,CSE 20,A01,185445,Briones; Jor-el Thomas Caparas,5,0,25,20
1683346606293,CSE 21,A01,185447,Staff,10,0,50,40
1683346607319,CSE 101,A01,185451,Staff,0,13,50,50
1683346607319,CSE 101,B01,185453,Jones; Miles E,0,11,50,50
1683346609370,CSE 141,A01,185458,Eldon; John,20,0,100,80
1683346610398,CSE 141L,A01,185461,Eldon; John,12,0,100,88
1683346611429,CSE 142,A01,185463,Staff,36,0,60,24
1683346611429,CSE 142,B01,201355,Staff,0,7,60,60
1683346612453,CSE 142L,A01,185470,Staff,36,0,60,24
1683346612453,CSE 142L,B01,201417,Staff,0,6,60,60
1683346613477,CSE 190,A00,201433,Staff,32,0,49,17
1683346614501,DOC 1,A01,259136,Strom; Megan C.,7,0,15,8
1683346614501,DOC 1,A02,259137,Strom; Megan C.,14,0,15,1
1683346614501,DOC 1,A03,259138,Strom; Megan C.,14,0,15,1
1683346614501,DOC 1,A04,259139,Strom; Megan C.,14,0,15,1
1683346615525,DOC 100D,A00,259140,Pass; Natalye Joann,16,0,25,9
1683346616550,DSGN 1,A01,184749,Rill; Bryan,0,25,30,30
1683346617572,DSGN 100,A01,185168,Staff,0,2,25,25
1683346618597,ECE 5,A01,185626,Morris; Karcher William,0,10,0,0
1683346619622,ECE 101,A01,185628,Staff,17,0,70,53
1683346620648,ECE 107,A01,185635,Baghdadchi; Saharnaz,0,0,20,20
1683346620648,ECE 107,A02,185638,Baghdadchi; Saharnaz,4,0,20,16
1683346621675,ECE 148,A01,185647,Silberman; Jack,0,0,16,16
1683346622700,ECON 1,A01,185537,Crane; Meredith Helen,54,0,70,16
1683346623728,ECON 3,A01,185549,Crane; Meredith Helen,32,0,70,38
1683346624753,ECON 4,A01,203354,Anderson; John Charles,0,4,10,10
1683346625777,ECON 100A,A01,185574,Staff,0,4,40,40
1683346626807,ECON 100B,A01,185576,Staff,10,22,50,40
1683346627831,ECON 100C,A01,185589,Newhouse; Herbert S,29,0,70,41
1683346628859,ECON 105,A00,185608,Vespa; Emanuel Ignacio,19,0,35,16
1683346629886,ECON 109,A01,185610,Shishkin; Denis,10,0,35,25
1683346630914,ECON 110A,A01,185612,Staff,11,0,40,29
1683346631938,ECON 120A,A01,185615,Staff,20,0,40,20
1683346632963,ECON 120C,A01,185617,Sun; Yixiao,0,21,70,70
1683346633988,ECON 144,A00,203346,Squires; Dale E,3,0,35,32
1683346635073,ECON 171,A01,203349,Newhouse; Herbert S,0,1,35,35
1683346636096,ECON 173A,A01,185621,Toda; Alexis Akira,21,0,35,14
1683346637121,EDS 25,A01,202413,Staff,0,1,0,0
1683346637121,EDS 25,A02,202414,Staff,0,1,0,0
1683346637121,EDS 25,A03,202415,Staff,0,0,0,0
1683346637121,EDS 25,A04,202416,Staff,0,1,0,0
1683346637121,EDS 25,A05,202439,Staff,0,0,0,0
1683346637121,EDS 25,A06,202440,Staff,0,0,0,0
1683346637121,EDS 25,B01,202631,Staff,0,0,0,0
1683346637121,EDS 25,B02,202632,Staff,0,0,0,0
1683346637121,EDS 25,B03,202639,Staff,0,0,0,0
1683346637121,EDS 25,B04,202640,Staff,0,0,0,0
1683346637121,EDS 25,B05,202643,Staff,0,0,0,0
1683346637121,EDS 25,B06,202644,Staff,0,0,0,0
1683346638148,EDS 38,A01,202659,Black; Alison Michelle,24,0,25,1
1683346639176,EDS 115,A00,202652,Staff,18,0,30,12
1683346640201,EDS 125,A00,202649,Staff,14,0,30,16
1683346641226,EDS 126,A01,203332,Staff,30,0,30,0
1683346642250,EDS 139,A00,202838,Staff,16,0,25,9
1683346643273,EDS 146,A01,202655,Staff,14,0,25,11
1683346644299,ENG 15,A00,185667,Staff,0,1,0,0
1683346644299,ENG 15,B00,185672,Staff,0,0,0,0
1683346644299,ENG 15,C00,185675,Staff,0,0,0,0
1683346644299,ENG 15,D00,185682,Staff,0,0,0,0
1683346644299,ENG 15,E00,185684,Staff,0,0,0,0
1683346645323,ETHN 103,A00,185710,Staff,0,4,35,35
1683346646349,ETHN 103A,A00,199228,Man; Simeon S,2,0,9,7
1683346647374,ETHN 109,A00,185711,Staff,18,0,35,17
1683346648399,ETHN 142,A00,185726,Staff,0,4,30,30
1683346649422,ETHN 163J,A00,199229,Man; Simeon S,5,0,8,3
1683346650450,ETHN 168,A00,185727,Staff,8,0,10,2
1683346651478,ETHN 182,A00,185728,Staff,1,0,35,34
1683346652502,ETHN 183,A00,185737,Staff,8,0,18,10
1683346653531,GLBH 111,A01,209361,Burgos; Jose L.,0,0,0,0
1683346655583,HIEU 104,A00,185792,Staff,16,0,20,4
1683346656608,HIEU 115,A00,185800,Staff,1,0,20,19
1683346657633,HIEU 128,A00,185801,Staff,0,7,20,20
1683346658657,HIEU 147,A00,185802,Staff,16,0,20,4
1683346659684,HIEU 154,A00,185823,Staff,12,0,20,8
1683346660710,HILA 102,A00,185826,Staff,13,0,20,7
1683346661739,HILD 2C,A01,185778,Staff,0,12,20,20
1683346662767,HILD 7B,A01,185780,Kwak; Nancy,0,15,32,32
1683346662767,HILD 7B,A02,185781,Kwak; Nancy,0,18,32,32
1683346663792,HILD 30,A01,185791,Staff,14,0,20,6
1683346664816,HISC 119,A00,185830,Golan; Tal,0,9,20,20
1683346665841,HITO 156GS,A00,185831,Patterson; Patrick H.,0,0,0,23
1683346666870,HIUS 103,A00,185832,Man; Simeon S,0,6,20,20
1683346667894,HIUS 117,A00,185836,Kwak; Nancy,2,0,20,18
1683346668918,HIUS 125,A00,185840,Man; Simeon S,0,0,23,23
1683346669942,HIUS 149,A00,185845,Staff,0,0,20,20
1683346670966,HUM 3,A01,185882,Zavodny; Tatiana Sophia,0,7,50,50
1683346670966,HUM 3,B01,185899,Caldwell; Michael Alan,0,18,50,50
1683346671993,HUM 3GS,A00,185900,Patterson; Patrick H.,0,0,0,23
1683346673019,HUM 4,A01,185938,Zroka; Amy Liane,31,0,50,19
1683346673019,HUM 4,B01,185956,Watkins; Eric,0,2,50,50
1683346673019,HUM 4,B02,202209,Watkins; Eric,0,2,50,50
1683346673019,HUM 4,B03,202210,Watkins; Eric,0,2,50,50
1683346674045,HUM 5,A01,185958,West; Geoffrey Scott,3,0,50,47
1683346674045,HUM 5,A02,202215,West; Geoffrey Scott,0,0,50,50
1683346675069,INTL 190,A00,185959,Gagnon; Jeffrey C,0,0,0,9
1683346675069,INTL 190,B00,185960,Lettieri; Michael Joseph,0,0,0,1
1683346676096,JAPN 180,A00,254509,Staff,5,1,30,25
1683346677121,LATI 10,A01,202853,Kennemore; Amy Michelle,4,0,35,31
1683346677121,LATI 10,A02,202854,Kennemore; Amy Michelle,2,0,35,33
1683346677121,LATI 10,A03,270054,Kennemore; Amy Michelle,30,0,30,0
1683346678145,LATI 180,A00,202855,Kennemore; Amy Michelle,11,0,20,9
1683346679172,LAWS 101,A00,201767,Golan; Tal,0,7,40,40
1683346680196,LIFR 1C,A00,185961,Staff,6,0,20,14
1683346681220,LIFR 1CX,A00,185962,Staff,7,0,20,13
1683346682244,LIFR 1D,A00,185963,Staff,9,0,20,11
1683346683268,LIFR 1DX,A00,185964,Staff,9,0,20,11
1683346684292,LIGN 101,A01,186039,Staff,43,0,50,7
1683346685317,LIGN 165,A00,186040,Staff,18,0,50,32
1683346686344,LTCS 108,A00,186041,Staff,6,0,10,4
1683346687370,LTCS 119,A00,186042,Staff,16,0,20,4
1683346688397,LTCS 130,A00,186043,Wesling; Megan E.,15,0,25,10
1683346690449,LTEA 138,A00,186119,Staff,14,0,40,26
1683346691474,LTEN 124,A00,186148,Staff,6,0,25,19
1683346692500,LTEN 178,A00,186149,Staff,7,0,15,8
1683346693525,LTEN 181,A00,186150,Blanco; John D,33,0,40,7
1683346694553,LTWL 120,A00,186160,Staff,20,0,25,5
1683346695578,LTWL 165,A00,186161,Staff,22,0,25,3
1683346696603,LTWR 100,A00,186162,Staff,0,5,15,15
1683346697636,LTWR 102,A00,186163,Doller; Ben,5,0,15,10
1683346698661,MAE 8,A01,186412,Staff,0,0,0,0
1683346699686,MAE 30B,A00,186445,Bahadori; Mohammad Yousef,83,0,100,17
1683346700715,MAE 40,A00,186592,Bewley; Thomas R,9,0,50,41
1683346701740,MAE 101B,A00,186593,Bahadori; Mohammad Yousef,81,0,100,19
1683346702764,MAE 105,A00,186594,Bandaru; Prabhakar,12,0,50,38
1683346703789,MAE 107,A00,186599,Pham; Hieu Tan,0,6,120,120
1683346704814,MAE 148,A01,186660,Silberman; Jack,3,0,16,13
1683346705840,MATH 10A,A01,188095,Staff,1,6,35,34
1683346706865,MATH 10B,A01,188097,Bowers; Adam R.,0,11,30,30
1683346706865,MATH 10B,A02,188099,Bowers; Adam R.,0,11,30,30
1683346706865,MATH 10B,B01,188104,Bowers; Adam R.,0,10,30,30
1683346706865,MATH 10B,B02,188106,Bowers; Adam R.,0,10,30,30
1683346707895,MATH 10C,A01,188111,Staff,0,18,30,30
1683346707895,MATH 10C,A02,188127,Staff,0,17,30,30
1683346707895,MATH 10C,A03,188131,Staff,0,18,30,30
1683346707895,MATH 10C,B01,188218,Staff,18,0,30,12
1683346707895,MATH 10C,B02,188244,Staff,13,0,30,17
1683346707895,MATH 10C,B03,188277,Staff,16,0,30,14
1683346708926,MATH 18,A01,188344,Bach; Quang Tran,18,0,30,12
1683346708926,MATH 18,A02,188345,Bach; Quang Tran,11,0,30,19
1683346708926,MATH 18,B01,188353,Bach; Quang Tran,10,0,30,20
1683346708926,MATH 18,B02,188354,Bach; Quang Tran,20,0,30,10
1683346709953,MATH 20A,A01,188374,Staff,13,0,35,22
1683346710982,MATH 20B,A01,188382,Ohm; Ko Woon,6,0,30,24
1683346710982,MATH 20B,A02,188383,Ohm; Ko Woon,22,0,30,8
1683346710982,MATH 20B,B01,188385,Ohm; Ko Woon,7,0,30,23
1683346710982,MATH 20B,B02,188392,Ohm; Ko Woon,22,0,30,8
1683346712011,MATH 20C,A01,188394,Harel; Guershon,10,0,30,20
1683346712011,MATH 20C,A02,188395,Harel; Guershon,15,0,30,15
1683346712011,MATH 20C,B01,188404,Harel; Guershon,5,0,30,25
1683346712011,MATH 20C,B02,188405,Harel; Guershon,19,0,30,11
1683346713041,MATH 20D,A01,188414,Hammock; Frances H,0,1,30,30
1683346713041,MATH 20D,A02,188415,Hammock; Frances H,3,0,30,27
1683346713041,MATH 20D,B01,188447,Hammock; Frances H,1,0,30,29
1683346713041,MATH 20D,B02,188486,Hammock; Frances H,8,0,30,22
1683346714069,MATH 20E,A01,188649,Staff,21,0,30,9
1683346714069,MATH 20E,A02,188650,Staff,23,0,30,7
1683346714069,MATH 20E,A03,188673,Staff,0,0,30,30
1683346715093,MATH 102,A01,188675,Staff,0,35,35,35
1683346716119,MATH 103B,A01,188681,Staff,3,0,35,32
1683346716119,MATH 103B,B01,188692,Staff,5,0,35,30
1683346717145,MATH 109,A01,188695,Salehi Golsefidy; Alireza,25,0,35,10
1683346717145,MATH 109,A02,188696,Salehi Golsefidy; Alireza,25,0,35,10
1683346718171,MATH 120A,A01,188698,Eggers; John Dietrich,7,0,35,28
1683346719195,MATH 142B,A01,188736,Ioana; Adrian,0,2,30,30
1683346719195,MATH 142B,A02,188741,Ioana; Adrian,1,1,30,29
1683346719195,MATH 142B,A03,188743,Ioana; Adrian,1,3,30,29
1683346720224,MATH 168A,A01,188790,Staff,0,9,35,35
1683346721250,MATH 170A,A01,188803,Nie; Jiawang,0,2,35,35
1683346721250,MATH 170A,A02,188811,Nie; Jiawang,0,0,35,35
1683346721250,MATH 170A,A03,188814,Nie; Jiawang,1,0,35,34
1683346721250,MATH 170A,A04,188815,Nie; Jiawang,13,0,35,22
1683346722273,MATH 193B,A01,188817,Staff,0,0,35,35
1683346722273,MATH 193B,A02,188818,Staff,5,0,35,30
1683346723298,MGT 4,A01,202857,Anderson; John Charles,62,0,80,18
1683346724327,MGT 12,A00,202858,Lindenberger; Wade Douglas,42,0,90,48
1683346725355,MGT 18,A00,202859,Staff,74,0,90,16
1683346726383,MGT 18GS,A00,202860,McKay; Michael J,13,0,28,15
1683346727410,MGT 45,A00,202861,Pecore; Joseph P.,14,0,90,76
1683346728436,MGT 100,A00,202863,Yavorsky; Daniel Ryan,28,0,90,62
1683346729462,MGT 103,A00,202864,Ehrich; Kristine R,1,18,90,89
1683346730486,MGT 112,A00,202865,Ehrich; Kristine R,15,0,90,75
1683346731511,MGT 121A,A00,202868,Staff,0,20,0,0
1683346732536,MGT 131B,A00,202869,Anderson; John Charles,59,0,90,31
1683346733564,MGT 136,A00,202871,Lindenberger; Wade Douglas,84,0,90,6
1683346734588,MGT 164,A00,202873,Staff,0,68,90,91
1683346735611,MGT 164GS,A00,202874,McKay; Mary A,13,0,28,15
1683346736635,MGT 180,A00,202875,Staff,0,50,90,91
1683346737659,MMW 11R,A01,205019,Herbst; Matthew,3,0,30,27
1683346737659,MMW 11R,A02,205026,Herbst; Matthew,29,0,30,1
1683346738741,MMW 15,A01,193512,Chang; Edmond Yi-Teh,0,9,28,28
1683346738741,MMW 15,A02,193513,Chang; Edmond Yi-Teh,0,5,28,28
1683346738741,MMW 15,A03,193514,Chang; Edmond Yi-Teh,0,5,28,28
1683346738741,MMW 15,A04,193515,Chang; Edmond Yi-Teh,0,5,28,28
1683346738741,MMW 15,A05,193516,Chang; Edmond Yi-Teh,0,4,28,28
1683346738741,MMW 15,A06,193517,Chang; Edmond Yi-Teh,0,5,28,28
1683346738741,MMW 15,B01,193519,Chang; Edmond Yi-Teh,0,5,28,28
1683346738741,MMW 15,B02,193520,Chang; Edmond Yi-Teh,0,5,28,28
1683346738741,MMW 15,B03,193521,Chang; Edmond Yi-Teh,0,5,28,28
1683346738741,MMW 15,B04,193522,Chang; Edmond Yi-Teh,0,4,28,28
1683346738741,MMW 15,B05,193523,Chang; Edmond Yi-Teh,0,5,28,28
1683346738741,MMW 15,B06,193524,Chang; Edmond Yi-Teh,0,4,28,28
1683346739766,MMW 122,A01,193526,Rahimi; Babak,0,15,28,28
1683346739766,MMW 122,A02,193527,Rahimi; Babak,0,14,28,28
1683346739766,MMW 122,A03,193528,Rahimi; Babak,0,0,0,0
1683346739766,MMW 122,A04,193529,Rahimi; Babak,0,0,0,0
1683346740795,MUS 1A,A01,186663,Staff,0,20,35,35
1683346741820,MUS 4,A01,186715,Staff,0,12,35,35
1683346742847,MUS 5R,A01,186796,Dubnov; Shlomo,0,17,35,35
1683346743876,MUS 6,A01,186798,Staff,0,4,25,25
1683346744903,MUS 7,A01,186830,Staff,13,0,35,22
1683346745931,MUS 8,A01,186930,Staff,0,26,35,35
1683346746960,MUS 15,A01,186932,Staff,0,16,35,35
1683346746960,MUS 15,B01,186934,Staff,0,15,35,35
1683346747989,MUS 80,A00,186935,Staff,1,0,20,19
1683346747989,MUS 80,B00,186936,Staff,25,0,25,0
1683346749014,NANO 11,A00,204702,Lipomi; Darren John,0,0,0,0
1683346750039,NANO 15,A01,204709,Yang; Kesong,0,1,0,0
1683346751065,NANO 114,A00,202069,Jahed Motlagh; Zeinab,3,0,10,7
1683346752090,PHIL 1,A00,186955,Grush; Rick Scott,32,0,40,8
1683346753117,PHIL 10,A01,186973,Grush; Rick Scott,28,0,35,7
1683346753117,PHIL 10,A02,186974,Grush; Rick Scott,33,0,35,2
1683346754145,PHIL 13,A01,186976,Staff,7,0,35,28
1683346754145,PHIL 13,A02,186977,Staff,16,0,35,19
1683346755173,PHIL 14,A01,186979,Staff,31,0,35,4
1683346755173,PHIL 14,A02,186986,Staff,32,0,35,3
1683346756199,PHIL 28,A01,186988,Staff,16,0,30,14
1683346756199,PHIL 28,A02,186989,Staff,1,0,30,29
1683346756199,PHIL 28,A03,186990,Staff,9,0,30,21
1683346756199,PHIL 28,A04,186991,Staff,26,0,30,4
1683346757224,PHIL 120,A00,186997,Staff,23,0,40,17
1683346758248,PHIL 137,A00,187003,Staff,9,0,40,31
1683346759273,PHIL 150,A00,187015,Staff,47,0,70,23
1683346760301,PHIL 167,A00,187021,Lamey; Andy M.,35,0,40,5
1683346761329,PHIL 174,A01,202226,Staff,17,0,20,3
1683346761329,PHIL 174,A02,202235,Staff,20,0,20,0
1683346762353,PHIL 191A,A00,258918,Staff,0,0,1,1
1683346763381,PHYS 1A,A00,187028,Staff,27,0,60,33
1683346764406,PHYS 1AL,001,187036,Staff,2,0,30,28
1683346764406,PHYS 1AL,002,187049,Staff,18,0,30,12
1683346765433,PHYS 1B,A00,187058,Staff,22,0,60,38
1683346766462,PHYS 1BL,001,187064,Staff,0,0,30,30
1683346766462,PHYS 1BL,002,187070,Staff,5,0,30,25
1683346767490,PHYS 1C,A00,187082,Staff,31,0,120,89
1683346768515,PHYS 1CL,001,187088,Staff,0,9,30,30
1683346768515,PHYS 1CL,002,187089,Staff,0,2,30,30
1683346768515,PHYS 1CL,009,262693,Staff,11,0,30,19
1683346769538,PHYS 2B,A01,187097,Staff,54,0,115,61
1683346770567,PHYS 2C,A01,187099,Staff,67,0,115,48
1683346771591,PHYS 2CL,A01,187101,Staff,5,0,28,23
1683346771591,PHYS 2CL,A02,187102,Staff,15,0,28,13
1683346772615,PHYS 2D,A01,187123,Shotwell; Brian,95,0,115,20
1683346773639,PHYS 4B,A01,187133,Grinstein; Benjamin,35,0,50,15
1683346774663,POLI 10,A00,188819,Staff,0,4,50,50
1683346775686,POLI 11,A00,188827,Staff,43,0,50,7
1683346776713,POLI 13R,A00,188828,Staff,0,1,20,20
1683346777738,POLI 27,A01,188830,Elgin; Samuel Zincke,0,1,70,70
1683346778762,POLI 30,A00,188832,Desposato; Scott,31,0,50,19
1683346779786,POLI 102F,A00,188834,Staff,3,0,40,37
1683346780813,POLI 104A,A00,188852,Staff,14,0,30,16
1683346781838,POLI 104I,A00,188853,Staff,0,6,20,20
1683346782861,POLI 110B,A00,188854,Wiens; David,7,0,20,13
1683346783887,POLI 112A,A00,188855,Wiens; David,5,0,30,25
1683346784911,POLI 117R,A00,188856,Forman; Fonna,0,11,20,20
1683346785936,POLI 118,A00,188857,Ingham; Sean,8,0,20,12
1683346786963,POLI 120G,A00,188858,Staff,9,0,30,21
1683346787990,POLI 131CR,A00,188863,Hoston; Germaine,24,0,50,26
1683346789018,POLI 133,A00,188864,Nellis; Gareth Hb,44,0,50,6
1683346790045,POLI 134D,A00,188865,Desposato; Scott,27,0,30,3
1683346791069,POLI 142A,A00,188871,Gartzke; Erik,22,0,50,28
1683346792093,POLI 142K,A00,188874,Staff,38,0,50,12
1683346793121,POLI 143,A00,188940,Gartzke; Erik,16,0,30,14
1683346794148,POLI 153,A00,188943,Staff,3,0,20,17
1683346795172,POLI 160AA,A00,188944,Staff,12,0,40,28
1683346796197,POLI 170A,A00,188945,Staff,11,0,30,19
1683346798245,PSYC 1,A00,188952,Staff,37,0,90,53
1683346799269,PSYC 2,B00,188953,Staff,19,0,35,16
1683346800292,PSYC 6,A00,188970,Staff,47,0,60,13
1683346801315,PSYC 7,A00,188973,Staff,37,0,45,8
1683346802338,PSYC 60,A01,188980,Rickard; Timothy C.,43,0,60,17
1683346803365,PSYC 70,A01,189001,Steiner; Eric Tomas,23,0,45,22
1683346804390,PSYC 100,A00,189005,Lacefield; Katharine I,0,98,120,120
1683346805413,PSYC 102,A00,189008,Staff,9,0,30,21
1683346806440,PSYC 106,B00,189026,Gorman; Michael R.,34,0,60,26
1683346807467,PSYC 114,B01,189033,Winkielman; Piotr,0,32,30,30
1683346808491,PSYC 131,A00,189036,Anagnostaras; Stephan,0,43,60,60
1683346809519,PSYC 136,A00,189041,Lowe; Angela Beth,0,7,25,25
1683346810547,PSYC 137,A00,189057,Winkielman; Piotr,0,34,25,25
1683346811573,PSYC 144,A00,189107,Wixted; John T,0,7,50,50
1683346813625,PSYC 162,A00,189142,Staff,0,8,85,85
1683346814649,PSYC 172,A00,189144,Gorman; Michael R.,0,7,30,30
1683346816701,PSYC 179,A00,189146,Lacefield; Katharine I,0,84,120,120
1683346817730,PSYC 181,A00,189147,Anagnostaras; Stephan,0,44,90,90
1683346818754,PSYC 190R,A00,189148,Barner; David A.,0,22,80,80
1683346819780,PSYC 191,A00,189275,Rickard; Timothy C.,0,7,25,25
1683346820804,PSYC 193,A00,189276,Chapman; Eddie Nathaniel,0,1,0,4
1683346821828,PSYC 193L,A01,189281,Lowe; Angela Beth,12,0,20,8
1683346821828,PSYC 193L,B01,189285,Staff,28,0,35,7
1683346822852,RELI 149,A00,187137,Rahimi; Babak,7,0,40,33
1683346823876,SE 9,A01,187315,Staff,0,2,18,18
1683346824901,SE 101B,A00,187409,Staff,24,0,30,6
1683346825924,SE 110B,A00,187444,Staff,10,0,40,30
1683346826948,SE 130B,A00,187449,Staff,31,0,40,9
1683346827978,SE 150A,A00,187516,Staff,9,0,20,11
1683346829003,SE 154,A00,187528,Staff,30,0,50,20
1683346830030,SIO 3,A01,258171,Staff,35,0,40,5
1683346831054,SIO 10,A00,187144,Cook; Geoffrey W,0,3,75,75
1683346832078,SIO 45,A00,187152,Cook; Geoffrey W,1,0,100,99
1683346833110,SIO 109R,A00,194486,Staff,0,3,20,20
1683346835166,SIO 187,A01,187233,Kacev; David,12,0,40,28
1683346836191,SOCI 1,A01,258656,Thorpe; Charles Robert,28,0,30,2
1683346836191,SOCI 1,A02,258658,Thorpe; Charles Robert,30,0,30,0
1683346836191,SOCI 1,A03,258661,Thorpe; Charles Robert,25,0,25,0
1683346836191,SOCI 1,A04,258666,Thorpe; Charles Robert,22,0,25,3
1683346836191,SOCI 1,A05,258897,Thorpe; Charles Robert,23,0,25,2
1683346836191,SOCI 1,A06,258898,Thorpe; Charles Robert,25,0,25,0
1683346837215,SOCI 30,A01,258903,Pardo Guerra; Juan Pablo,15,0,30,15
1683346838240,SOCI 102,A00,258904,Staff,9,0,25,16
1683346839264,SOCI 106,A00,258905,Staff,19,0,25,6
1683346840290,SOCI 111,A00,258907,Ribas Norris; Janet Vanesa,26,0,30,4
1683346841313,SOCI 121R,A00,258908,Pardo Guerra; Juan Pablo,10,0,30,20
1683346842393,SOCI 126,A01,203330,Staff,14,0,20,6
1683346843420,SOCI 131,A00,258909,Thorpe; Charles Robert,31,0,60,29
1683346844446,SOCI 135,A00,258910,Payne; Christine Anna,0,9,30,30
1683346845470,SOCI 157,A00,258911,Staff,12,0,30,18
1683346846498,SOCI 184,A00,258912,Staff,25,0,30,5
1683346847527,SOCI 188D,A00,258913,Staff,21,0,30,9
1683346848553,SYN 2,001,187529,Staff,10,0,16,6
1683346848553,SYN 2,002,201452,Staff,0,18,16,16
1683346848553,SYN 2,003,201469,Staff,3,0,16,13
1683346849579,SYN 100,A01,187531,Staff,0,9,20,20
1683346849579,SYN 100,B01,201491,Staff,0,12,20,20
1683346850607,TDAC 1,A00,189286,Walsh; Kim C.,3,0,20,17
1683346850607,TDAC 1,B00,189287,Harting; Carla Kelso,11,0,20,9
1683346851635,TDAC 101,A00,189300,Walsh; Kim C.,16,0,20,4
1683346851635,TDAC 101,B00,189301,Harting; Carla Kelso,18,0,20,2
1683346852659,TDAC 102,A00,189304,Basso; Beatrice,14,0,20,6
1683346853683,TDAC 108,A00,189305,Staff,18,0,20,2
1683346854712,TDDE 131,A00,189310,Staff,19,0,20,1
1683346854712,TDDE 131,B00,189314,Staff,19,0,20,1
1683346854712,TDDE 131,C00,189315,Staff,48,0,50,2
1683346854712,TDDE 131,D00,189316,Staff,14,0,15,1
1683346854712,TDDE 131,E00,204841,Staff,20,0,20,0
1683346855739,TDGE 10,A00,189289,Staff,30,0,50,20
1683346855739,TDGE 10,B00,189290,Havis; Allan,1,0,50,49
1683346856770,TDGE 11,A00,189291,Fulton; Julia,0,3,50,50
1683346856770,TDGE 11,B00,189292,Staff,20,0,25,5
1683346856770,TDGE 11,C00,260270,Staff,0,0,0,0
1683346857794,TDGE 25,A00,189294,Staff,3,0,20,17
1683346858819,TDGE 124,A00,189318,Fulton; Julia,0,8,50,50
1683346859844,TDGE 125,A00,189319,Staff,13,0,25,12
1683346859844,TDGE 125,B00,189320,Staff,23,0,25,2
1683346860869,TDGE 127,A00,189322,Havis; Allan,0,0,50,50
1683346861892,TDHT 101,A00,189323,Staff,18,0,25,7
1683346861892,TDHT 101,B00,189324,Staff,25,0,25,0
1683346862915,TDHT 102,A00,189325,Staff,49,0,50,1
1683346863944,TDMV 1,A00,189295,Arcidiacono; Kristin,19,0,30,11
1683346863944,TDMV 1,B00,189296,Caligagan; Maria T.,24,0,30,6
1683346864972,TDMV 2,A00,189297,Sammartano; Tonnie,28,0,30,2
1683346864972,TDMV 2,B00,189299,Arcidiacono; Kristin,24,0,30,6
1683346865998,TDMV 3,A00,204998,Rincon; Alicia,22,0,30,8
1683346867024,TDMV 120,A00,189458,Sammartano; Tonnie,28,0,30,2
1683346868046,TDMV 138,A00,189541,Jun; Grace Shin Hae,22,0,40,18
1683346869070,TDMV 142,A00,189717,Caligagan; Tony,23,0,30,7
1683346869070,TDMV 142,B00,189718,Caligagan; Maria T.,25,0,30,5
1683346870094,TMC 2,A01,187533,Staff,25,0,25,0
1683346870094,TMC 2,A02,187534,Staff,25,0,25,0
1683346871119,USP 1,A01,187536,Kwak; Nancy,0,17,25,25
1683346872142,USP 5,A01,187538,Staff,10,0,25,15
1683346873164,USP 101,A00,199253,Staff,0,4,0,0
1683346874188,USP 124,A00,187562,Boomhower; Matthew Charles,1,0,30,29
1683346875214,USP 138,A00,187582,Staff,20,0,25,5
1683346876238,USP 152,A01,187597,Staff,4,0,25,21
1683346877262,USP 153,A00,187598,Staff,19,0,25,6
1683346878285,USP 168,A00,187607,Kwak; Nancy,2,0,5,3
1683346879313,USP 173,A00,187619,Staff,4,0,25,21
1683346880337,USP 181,A00,187638,Staff,0,1,25,25
1683346881365,VIS 103,A00,187650,Cruz; Edwin Teddy,23,0,75,52
1683346882391,VIS 110D,A00,187669,Staff,12,0,22,10
1683346883419,VIS 127C,A00,187720,Shen; Kuiyi,67,0,146,79
1683346884445,VIS 149,A00,187731,Yoldas; Pinar,0,14,22,22
1683346885469,VIS 151,A01,188091,Staff,22,0,34,12
1683346885469,VIS 151,A02,188092,Staff,11,0,34,23
1683346886497,VIS 160B,A00,188093,Stalbaum; Brett,0,0,10,10
1683346888548,WCWP 10B,A00,201720,Staff,10,0,15,5
1683346888548,WCWP 10B,B00,201722,Staff,9,0,15,6
1683346889572,WCWP 100,A00,201725,Gagnon; Jeffrey C,0,0,2,2
1683346889572,WCWP 100,B00,201727,Staff,0,4,15,15
1683346892696,ANBI 133,A00,258401,Wilder; Linnea Lorene,34,0,40,6
1683346893719,ANBI 140,A00,258395,Hrvoj Mihic; Branka,18,0,25,7
1683346894749,ANSC 120,A00,258402,Bialecki; Jon Anthony,27,0,40,13
1683346895775,ANSC 144,A00,258400,Staff,14,0,40,26
1683346897826,ANSC 166,A00,258396,Parish; Steven Martin,157,0,175,18
1683346898853,ANSC 180,A00,193533,Staff,9,0,20,11
1683346899877,ANSC 188,A00,258397,Jassal; Aftab,33,0,40,7
1683346900901,ANTH 3,A01,258316,Staff,23,0,30,7
1683346901925,ANTH 5,A00,258394,Semendeferi; Ekaterini,16,0,20,4
1683346902954,ANTH 21,A01,258331,Staff,8,0,40,32
1683346903978,ANTH 103,A00,258398,Varma; Saiba,15,0,25,10
1683346905005,AWP 10,001,202034,Staff,0,0,0,0
1683346905005,AWP 10,002,202035,Staff,0,0,0,0
1683346905005,AWP 10,003,202036,Staff,0,0,0,0
1683346905005,AWP 10,004,202037,Staff,0,0,0,0
1683346905005,AWP 10,005,202038,Staff,0,0,0,0
1683346905005,AWP 10,006,202039,Staff,0,0,0,0
1683346905005,AWP 10,007,202040,Staff,0,0,0,0
1683346905005,AWP 10,008,202041,Staff,0,0,0,0
1683346905005,AWP 10,009,202042,Staff,0,0,0,0
1683346905005,AWP 10,010,202043,Staff,0,0,0,0
1683346905005,AWP 10,011,202044,Staff,0,0,0,0
1683346905005,AWP 10,012,202045,Staff,0,0,0,0
1683346905005,AWP 10,013,202046,Staff,0,0,0,0
1683346905005,AWP 10,014,202047,Staff,0,0,0,0
1683346905005,AWP 10,015,202048,Staff,0,0,0,0
1683346905005,AWP 10,016,202049,Staff,0,0,0,0
1683346905005,AWP 10,017,202050,Staff,0,0,0,0
1683346905005,AWP 10,018,202051,Staff,0,0,0,0
1683346905005,AWP 10,019,202052,Staff,0,0,0,0
1683346905005,AWP 10,020,202053,Staff,0,0,0,0
1683346905005,AWP 10,021,202054,Staff,0,0,0,0
1683346905005,AWP 10,022,202055,Staff,0,0,0,0
1683346905005,AWP 10,023,202056,Staff,0,0,0,0
1683346905005,AWP 10,024,202057,Staff,0,0,0,0
1683346905005,AWP 10,025,202058,Staff,0,0,0,0
1683346905005,AWP 10,026,202059,Staff,0,0,0,0
1683346906032,AWP 102,001,202032,Staff,0,0,0,0
1683346906032,AWP 102,002,202033,Staff,0,0,0,0
1683346907056,BENG 100,A01,254234,Taylor Amos; Alyssa C,31,0,40,9
1683346908081,BENG 196,001,270013,Engler; Adam J.,9999,0,9999,0
1683346909108,BICD 100R,A01,202018,Smith; Laurie,0,7,32,32
1683346909108,BICD 100R,A02,202019,Smith; Laurie,0,2,32,32
1683346909108,BICD 100R,A03,202020,Smith; Laurie,0,1,32,32
1683346909108,BICD 100R,A04,202021,Smith; Laurie,9,0,32,23
1683346909108,BICD 100R,A05,202022,Smith; Laurie,12,0,32,20
1683346910133,BICD 136,A01,193242,Gustafson-Brown; Cindy,0,2,32,32
1683346910133,BICD 136,A02,193244,Gustafson-Brown; Cindy,14,0,32,18
1683346911158,BIEB 102,A01,193249,Butler; Shannon Rhey,0,2,32,32
1683346911158,BIEB 102,A02,193251,Butler; Shannon Rhey,0,0,32,32
1683346911158,BIEB 102,A03,193253,Butler; Shannon Rhey,0,1,32,32
1683346911158,BIEB 102,A04,193255,Butler; Shannon Rhey,17,0,32,15
1683346911158,BIEB 102,A05,193265,Butler; Shannon Rhey,26,0,32,6
1683346911158,BIEB 102,A06,193269,Butler; Shannon Rhey,16,0,32,16
1683346913213,BIEB 150,A01,193274,Staff,0,0,32,32
1683346913213,BIEB 150,A02,193285,Staff,23,0,32,9
1683346914239,BIEB 194,A00,193286,Kurle; Carolyn M.,22,0,32,10
1683346915265,BILD 1,A01,192291,Staff,16,0,32,16
1683346915265,BILD 1,A02,192292,Staff,30,0,32,2
1683346915265,BILD 1,B01,192520,Reuther; Keefe,0,1,0,0
1683346915265,BILD 1,B02,192532,Reuther; Keefe,0,1,0,0
1683346916291,BILD 3,A01,192556,Butler; Shannon Rhey,0,0,32,32
1683346916291,BILD 3,A02,192581,Butler; Shannon Rhey,5,0,32,27
1683346916291,BILD 3,A03,192611,Butler; Shannon Rhey,23,0,32,9
1683346916291,BILD 3,A04,192612,Butler; Shannon Rhey,25,0,32,7
1683346916291,BILD 3,A05,192613,Butler; Shannon Rhey,27,0,32,5
1683346916291,BILD 3,A06,192679,Butler; Shannon Rhey,27,0,32,5
1683346916291,BILD 3,A07,192682,Butler; Shannon Rhey,22,0,32,10
1683346917316,BILD 4,A01,192836,Reuther; Keefe,0,0,24,24
1683346917316,BILD 4,A02,193044,Reuther; Keefe,4,0,24,20
1683346918338,BILD 10,A01,193142,Gustafson-Brown; Cindy,30,0,32,2
1683346918338,BILD 10,A02,193149,Gustafson-Brown; Cindy,31,0,32,1
1683346919362,BIMM 100,A01,193301,Staff,0,6,32,32
1683346919362,BIMM 100,A02,193312,Staff,0,5,32,32
1683346919362,BIMM 100,A03,193323,Staff,0,8,32,32
1683346920388,BIMM 101,A01,193329,McDonnell; Lisa Marie,0,3,24,24
1683346920388,BIMM 101,A02,193339,McDonnell; Lisa Marie,0,3,24,24
1683346920388,BIMM 101,B01,193354,McDonnell; Lisa Marie,0,3,24,24
1683346920388,BIMM 101,B02,193357,McDonnell; Lisa Marie,0,3,24,24
1683346921415,BIMM 110,A01,193377,Tat; John,0,11,32,32
1683346921415,BIMM 110,A02,193378,Tat; John,1,9,32,31
1683346922441,BIMM 120,A01,206116,Staff,0,0,32,32
1683346922441,BIMM 120,A02,206117,Staff,8,0,32,24
1683346922441,BIMM 120,A03,206121,Staff,21,0,32,11
1683346923465,BIPN 100,A01,193393,Park; Ji Young,0,14,32,32
1683346923465,BIPN 100,A02,193402,Park; Ji Young,0,13,32,32
1683346923465,BIPN 100,A03,193413,Park; Ji Young,0,14,32,32
1683346923465,BIPN 100,A04,193414,Park; Ji Young,0,13,32,32
1683346924491,BIPN 102,A01,193429,Staff,0,0,32,32
1683346924491,BIPN 102,A02,193438,Staff,22,0,32,10
1683346925518,BIPN 106,A01,193450,Reyes Gonzalez; Catalina,0,2,40,40
1683346926545,BIPN 134,A01,193465,Cooke; James Edward,0,0,32,32
1683346926545,BIPN 134,A02,193474,Cooke; James Edward,25,0,32,7
1683346926545,BIPN 134,A03,193485,Cooke; James Edward,29,0,32,3
1683346926545,BIPN 134,A04,193486,Cooke; James Edward,21,0,32,11
1683346926545,BIPN 134,A05,193491,Cooke; James Edward,31,0,32,1
1683346926545,BIPN 134,A06,193501,Cooke; James Edward,30,0,32,2
1683346926545,BIPN 134,A07,193510,Cooke; James Edward,29,0,32,3
1683346928595,BISP 194,A00,222522,Staff,14,0,32,18
1683346929623,CAT 124,A01,202407,Staff,20,0,25,5
1683346930651,CAT 125,A00,202408,Marchisotto; Jennifer Anne,4,0,20,16
1683346931675,CAT 125R,A00,202409,Smith; Lauryn Alissa,0,11,20,20
1683346931675,CAT 125R,B00,202410,Morales; Celeste Georgianna,0,11,20,20
1683346931675,CAT 125R,C00,202411,Irwin; Matthew Joseph,0,10,20,20
1683346932701,CENG 15,A01,204712,Yang; Kesong,0,1,0,0
1683346933726,CENG 114,A00,202070,Jahed Motlagh; Zeinab,5,0,20,15
1683346934753,CGS 105,A00,185477,Wesling; Megan E.,24,0,40,16
1683346935781,CGS 106,A00,185494,Staff,13,0,22,9
1683346936809,CGS 108,A00,185495,Staff,14,0,20,6
1683346937844,CGS 114,A00,185496,Staff,13,0,18,5
1683346938868,CGS 119,A00,185501,Staff,15,0,20,5
1683346939892,CGS 120,A00,185511,Staff,13,0,20,7
1683346940922,CHEM 4,A01,184675,Bussey; Thomas J,96,0,100,4
1683346941950,CHEM 6A,A01,184677,Staff,34,0,60,26
1683346942974,CHEM 6B,A01,184679,Staff,65,0,100,35
1683346943998,CHEM 6C,A01,184681,Bussey; Thomas J,1,0,50,49
1683346943998,CHEM 6C,A02,184682,Bussey; Thomas J,34,0,50,16
1683346945023,CHEM 40A,A01,184684,Albizati; Kim F.,37,0,100,63
1683346946105,CHEM 40B,A01,184686,Albizati; Kim F.,0,20,100,100
1683346947130,CHEM 41B,A01,184690,Staff,52,0,100,48
1683346948153,COGS 3,A01,184715,Boyle; Mary E. T.,0,25,40,40
1683346949181,COGS 14B,A01,185172,Staff,0,15,38,38
1683346950207,COGS 18,A01,184736,Staff,17,0,80,63
1683346951232,COGS 100,A01,184932,Staff,0,5,73,73
1683346952260,COGS 101A,A01,184935,Staff,0,39,30,30
1683346953287,COGS 101B,A01,184944,Staff,0,2,30,30
1683346954311,COGS 101C,A01,184946,Staff,0,12,30,30
1683346955335,COGS 102A,A01,184951,Johnson; Christine M.,2,0,40,38
1683346956359,COGS 107B,A01,184953,Mooshagian; Eric Frederick,0,50,40,40
1683346957386,COGS 118B,A01,184959,Gupta; Anjum,0,48,40,40
1683346958410,COGS 153,A00,184961,Staff,0,15,30,30
1683346959435,COGS 177,A00,184962,Staff,0,20,30,30
1683346960459,COGS 187A,A01,184969,Boyle; Mary E. T.,0,17,40,40
1683346961483,COMM 10,A01,185174,Staff,0,5,25,25
1683346961483,COMM 10,A02,185189,Staff,0,5,25,25
1683346961483,COMM 10,A03,269821,Staff,0,0,0,0
1683346962507,COMM 100B,A01,185475,Staff,0,0,0,2
1683346962507,COMM 100B,A02,185476,Staff,13,0,25,12
1683346963531,COMM 100C,A01,185314,Staff,1,0,25,24
1683346963531,COMM 100C,A02,185327,Staff,19,0,25,6
1683346964559,COMM 110M,A00,185349,Staff,2,0,40,38
1683346965587,COMM 113T,A00,185352,Staff,24,0,40,16
1683346966612,COMM 114I,A00,185353,Staff,33,0,40,7
1683346967639,COMM 131,A00,185354,Staff,19,0,30,11
1683346968664,CSE 8A,A50,185358,Cao; Yingjun,0,46,10,10
1683346969689,CSE 8B,A01,185362,Staff,1,47,50,49
1683346970714,CSE 11,A01,185416,Cao; Yingjun,0,92,10,10
1683346971738,CSE 20,A01,185445,Briones; Jor-el Thomas Caparas,5,0,25,20
1683346972763,CSE 21,A01,185447,Staff,10,0,50,40
1683346973788,CSE 101,A01,185451,Staff,0,13,50,50
1683346973788,CSE 101,B01,185453,Jones; Miles E,0,11,50,50
1683346975841,CSE 141,A01,185458,Eldon; John,20,0,100,80
1683346976865,CSE 141L,A01,185461,Eldon; John,12,0,100,88
1683346977893,CSE 142,A01,185463,Staff,36,0,60,24
1683346977893,CSE 142,B01,201355,Staff,0,7,60,60
1683346978921,CSE 142L,A01,185470,Staff,36,0,60,24
1683346978921,CSE 142L,B01,201417,Staff,0,6,60,60
1683346979948,CSE 190,A00,201433,Staff,32,0,49,17
1683346980975,DOC 1,A01,259136,Strom; Megan C.,7,0,15,8
1683346980975,DOC 1,A02,259137,Strom; Megan C.,14,0,15,1
1683346980975,DOC 1,A03,259138,Strom; Megan C.,14,0,15,1
1683346980975,DOC 1,A04,259139,Strom; Megan C.,14,0,15,1
1683346982002,DOC 100D,A00,259140,Pass; Natalye Joann,16,0,25,9
1683346983031,DSGN 1,A01,184749,Rill; Bryan,0,25,30,30
1683346984058,DSGN 100,A01,185168,Staff,0,2,25,25
1683346985082,ECE 5,A01,185626,Morris; Karcher William,0,10,0,0
1683346986105,ECE 101,A01,185628,Staff,17,0,70,53
1683346987130,ECE 107,A01,185635,Baghdadchi; Saharnaz,0,0,20,20
1683346987130,ECE 107,A02,185638,Baghdadchi; Saharnaz,4,0,20,16
1683346988154,ECE 148,A01,185647,Silberman; Jack,0,0,16,16
1683346989183,ECON 1,A01,185537,Crane; Meredith Helen,54,0,70,16
1683346990207,ECON 3,A01,185549,Crane; Meredith Helen,32,0,70,38
1683346991233,ECON 4,A01,203354,Anderson; John Charles,0,4,10,10
1683346992260,ECON 100A,A01,185574,Staff,0,4,40,40
1683346993288,ECON 100B,A01,185576,Staff,10,22,50,40
1683346994317,ECON 100C,A01,185589,Newhouse; Herbert S,29,0,70,41
1683346995341,ECON 105,A00,185608,Vespa; Emanuel Ignacio,19,0,35,16
1683346996365,ECON 109,A01,185610,Shishkin; Denis,10,0,35,25
1683346997390,ECON 110A,A01,185612,Staff,11,0,40,29
1683346998418,ECON 120A,A01,185615,Staff,20,0,40,20
1683346999443,ECON 120C,A01,185617,Sun; Yixiao,0,21,70,70
1683347000470,ECON 144,A00,203346,Squires; Dale E,3,0,35,32
1683347001495,ECON 171,A01,203349,Newhouse; Herbert S,0,1,35,35
1683347002521,ECON 173A,A01,185621,Toda; Alexis Akira,21,0,35,14
1683347003547,EDS 25,A01,202413,Staff,0,1,0,0
1683347003547,EDS 25,A02,202414,Staff,0,1,0,0
1683347003547,EDS 25,A03,202415,Staff,0,0,0,0
1683347003547,EDS 25,A04,202416,Staff,0,1,0,0
1683347003547,EDS 25,A05,202439,Staff,0,0,0,0
1683347003547,EDS 25,A06,202440,Staff,0,0,0,0
1683347003547,EDS 25,B01,202631,Staff,0,0,0,0
1683347003547,EDS 25,B02,202632,Staff,0,0,0,0
1683347003547,EDS 25,B03,202639,Staff,0,0,0,0
1683347003547,EDS 25,B04,202640,Staff,0,0,0,0
1683347003547,EDS 25,B05,202643,Staff,0,0,0,0
1683347003547,EDS 25,B06,202644,Staff,0,0,0,0
1683347004569,EDS 38,A01,202659,Black; Alison Michelle,24,0,25,1
1683347005597,EDS 115,A00,202652,Staff,18,0,30,12
1683347006621,EDS 125,A00,202649,Staff,14,0,30,16
1683347007645,EDS 126,A01,203332,Staff,30,0,30,0
1683347008668,EDS 139,A00,202838,Staff,16,0,25,9
1683347009696,EDS 146,A01,202655,Staff,14,0,25,11
1683347010721,ENG 15,A00,185667,Staff,0,1,0,0
1683347010721,ENG 15,B00,185672,Staff,0,0,0,0
1683347010721,ENG 15,C00,185675,Staff,0,0,0,0
1683347010721,ENG 15,D00,185682,Staff,0,0,0,0
1683347010721,ENG 15,E00,185684,Staff,0,0,0,0
1683347011746,ETHN 103,A00,185710,Staff,0,4,35,35
1683347012773,ETHN 103A,A00,199228,Man; Simeon S,2,0,9,7
1683347013798,ETHN 109,A00,185711,Staff,18,0,35,17
1683347014825,ETHN 142,A00,185726,Staff,0,4,30,30
1683347015853,ETHN 163J,A00,199229,Man; Simeon S,5,0,8,3
1683347016878,ETHN 168,A00,185727,Staff,8,0,10,2
1683347017902,ETHN 182,A00,185728,Staff,1,0,35,34
1683347018931,ETHN 183,A00,185737,Staff,8,0,18,10
1683347019960,GLBH 111,A01,209361,Burgos; Jose L.,0,0,0,0
1683347022013,HIEU 104,A00,185792,Staff,16,0,20,4
1683347023039,HIEU 115,A00,185800,Staff,1,0,20,19
1683347024064,HIEU 128,A00,185801,Staff,0,7,20,20
1683347025091,HIEU 147,A00,185802,Staff,16,0,20,4
1683347026121,HIEU 154,A00,185823,Staff,12,0,20,8
1683347027149,HILA 102,A00,185826,Staff,13,0,20,7
1683347028174,HILD 2C,A01,185778,Staff,0,12,20,20
1683347029199,HILD 7B,A01,185780,Kwak; Nancy,0,15,32,32
1683347029199,HILD 7B,A02,185781,Kwak; Nancy,0,18,32,32
1683347030224,HILD 30,A01,185791,Staff,14,0,20,6
1683347031249,HISC 119,A00,185830,Golan; Tal,0,9,20,20
1683347032272,HITO 156GS,A00,185831,Patterson; Patrick H.,0,0,0,23
1683347033296,HIUS 103,A00,185832,Man; Simeon S,0,6,20,20
1683347034324,HIUS 117,A00,185836,Kwak; Nancy,2,0,20,18
1683347035350,HIUS 125,A00,185840,Man; Simeon S,0,0,23,23
1683347036377,HIUS 149,A00,185845,Staff,0,0,20,20
1683347037401,HUM 3,A01,185882,Zavodny; Tatiana Sophia,0,7,50,50
1683347037401,HUM 3,B01,185899,Caldwell; Michael Alan,0,18,50,50
1683347038428,HUM 3GS,A00,185900,Patterson; Patrick H.,0,0,0,23
1683347039453,HUM 4,A01,185938,Zroka; Amy Liane,31,0,50,19
1683347039453,HUM 4,B01,185956,Watkins; Eric,0,2,50,50
1683347039453,HUM 4,B02,202209,Watkins; Eric,0,2,50,50
1683347039453,HUM 4,B03,202210,Watkins; Eric,0,2,50,50
1683347040481,HUM 5,A01,185958,West; Geoffrey Scott,3,0,50,47
1683347040481,HUM 5,A02,202215,West; Geoffrey Scott,0,0,50,50
1683347041509,INTL 190,A00,185959,Gagnon; Jeffrey C,0,0,0,9
1683347041509,INTL 190,B00,185960,Lettieri; Michael Joseph,0,0,0,1
1683347042536,JAPN 180,A00,254509,Staff,5,1,30,25
1683347043562,LATI 10,A01,202853,Kennemore; Amy Michelle,4,0,35,31
1683347043562,LATI 10,A02,202854,Kennemore; Amy Michelle,2,0,35,33
1683347043562,LATI 10,A03,270054,Kennemore; Amy Michelle,30,0,30,0
1683347044586,LATI 180,A00,202855,Kennemore; Amy Michelle,11,0,20,9
1683347045613,LAWS 101,A00,201767,Golan; Tal,0,7,40,40
1683347046641,LIFR 1C,A00,185961,Staff,6,0,20,14
1683347047664,LIFR 1CX,A00,185962,Staff,7,0,20,13
1683347048688,LIFR 1D,A00,185963,Staff,9,0,20,11
1683347049774,LIFR 1DX,A00,185964,Staff,9,0,20,11
1683347050798,LIGN 101,A01,186039,Staff,43,0,50,7
1683347051825,LIGN 165,A00,186040,Staff,18,0,50,32
1683347052850,LTCS 108,A00,186041,Staff,6,0,10,4
1683347053874,LTCS 119,A00,186042,Staff,16,0,20,4
1683347054899,LTCS 130,A00,186043,Wesling; Megan E.,15,0,25,10
1683347056951,LTEA 138,A00,186119,Staff,14,0,40,26
1683347057976,LTEN 124,A00,186148,Staff,6,0,25,19
1683347059000,LTEN 178,A00,186149,Staff,7,0,15,8
1683347060025,LTEN 181,A00,186150,Blanco; John D,33,0,40,7
1683347061051,LTWL 120,A00,186160,Staff,20,0,25,5
1683347062076,LTWL 165,A00,186161,Staff,22,0,25,3
1683347063102,LTWR 100,A00,186162,Staff,0,5,15,15
1683347064126,LTWR 102,A00,186163,Doller; Ben,5,0,15,10
1683347065151,MAE 8,A01,186412,Staff,0,0,0,0
1683347066183,MAE 30B,A00,186445,Bahadori; Mohammad Yousef,83,0,100,17
1683347067208,MAE 40,A00,186592,Bewley; Thomas R,9,0,50,41
1683347068232,MAE 101B,A00,186593,Bahadori; Mohammad Yousef,81,0,100,19
1683347069261,MAE 105,A00,186594,Bandaru; Prabhakar,12,0,50,38
1683347070289,MAE 107,A00,186599,Pham; Hieu Tan,0,6,120,120
1683347071316,MAE 148,A01,186660,Silberman; Jack,3,0,16,13
1683347072343,MATH 10A,A01,188095,Staff,1,6,35,34
1683347073370,MATH 10B,A01,188097,Bowers; Adam R.,0,11,30,30
1683347073370,MATH 10B,A02,188099,Bowers; Adam R.,0,11,30,30
1683347073370,MATH 10B,B01,188104,Bowers; Adam R.,0,10,30,30
1683347073370,MATH 10B,B02,188106,Bowers; Adam R.,0,10,30,30
1683347074401,MATH 10C,A01,188111,Staff,0,18,30,30
1683347074401,MATH 10C,A02,188127,Staff,0,17,30,30
1683347074401,MATH 10C,A03,188131,Staff,0,18,30,30
1683347074401,MATH 10C,B01,188218,Staff,18,0,30,12
1683347074401,MATH 10C,B02,188244,Staff,13,0,30,17
1683347074401,MATH 10C,B03,188277,Staff,16,0,30,14
1683347075427,MATH 18,A01,188344,Bach; Quang Tran,18,0,30,12
1683347075427,MATH 18,A02,188345,Bach; Quang Tran,11,0,30,19
1683347075427,MATH 18,B01,188353,Bach; Quang Tran,10,0,30,20
1683347075427,MATH 18,B02,188354,Bach; Quang Tran,20,0,30,10
1683347076451,MATH 20A,A01,188374,Staff,13,0,35,22
1683347077480,MATH 20B,A01,188382,Ohm; Ko Woon,6,0,30,24
1683347077480,MATH 20B,A02,188383,Ohm; Ko Woon,22,0,30,8
1683347077480,MATH 20B,B01,188385,Ohm; Ko Woon,7,0,30,23
1683347077480,MATH 20B,B02,188392,Ohm; Ko Woon,22,0,30,8
1683347078509,MATH 20C,A01,188394,Harel; Guershon,10,0,30,20
1683347078509,MATH 20C,A02,188395,Harel; Guershon,15,0,30,15
1683347078509,MATH 20C,B01,188404,Harel; Guershon,5,0,30,25
1683347078509,MATH 20C,B02,188405,Harel; Guershon,19,0,30,11
1683347079538,MATH 20D,A01,188414,Hammock; Frances H,0,1,30,30
1683347079538,MATH 20D,A02,188415,Hammock; Frances H,3,0,30,27
1683347079538,MATH 20D,B01,188447,Hammock; Frances H,1,0,30,29
1683347079538,MATH 20D,B02,188486,Hammock; Frances H,8,0,30,22
1683347080565,MATH 20E,A01,188649,Staff,21,0,30,9
1683347080565,MATH 20E,A02,188650,Staff,23,0,30,7
1683347080565,MATH 20E,A03,188673,Staff,0,0,30,30
1683347081593,MATH 102,A01,188675,Staff,0,35,35,35
1683347082621,MATH 103B,A01,188681,Staff,3,0,35,32
1683347082621,MATH 103B,B01,188692,Staff,5,0,35,30
1683347083646,MATH 109,A01,188695,Salehi Golsefidy; Alireza,25,0,35,10
1683347083646,MATH 109,A02,188696,Salehi Golsefidy; Alireza,25,0,35,10
1683347084670,MATH 120A,A01,188698,Eggers; John Dietrich,7,0,35,28
1683347085699,MATH 142B,A01,188736,Ioana; Adrian,0,2,30,30
1683347085699,MATH 142B,A02,188741,Ioana; Adrian,1,1,30,29
1683347085699,MATH 142B,A03,188743,Ioana; Adrian,1,3,30,29
1683347086724,MATH 168A,A01,188790,Staff,0,9,35,35
1683347087749,MATH 170A,A01,188803,Nie; Jiawang,0,2,35,35
1683347087749,MATH 170A,A02,188811,Nie; Jiawang,0,0,35,35
1683347087749,MATH 170A,A03,188814,Nie; Jiawang,1,0,35,34
1683347087749,MATH 170A,A04,188815,Nie; Jiawang,13,0,35,22
1683347088777,MATH 193B,A01,188817,Staff,0,0,35,35
1683347088777,MATH 193B,A02,188818,Staff,5,0,35,30
1683347089805,MGT 4,A01,202857,Anderson; John Charles,62,0,80,18
1683347090831,MGT 12,A00,202858,Lindenberger; Wade Douglas,42,0,90,48
1683347091859,MGT 18,A00,202859,Staff,74,0,90,16
1683347092884,MGT 18GS,A00,202860,McKay; Michael J,13,0,28,15
1683347093907,MGT 45,A00,202861,Pecore; Joseph P.,14,0,90,76
1683347094935,MGT 100,A00,202863,Yavorsky; Daniel Ryan,28,0,90,62
1683347095962,MGT 103,A00,202864,Ehrich; Kristine R,1,18,90,89
1683347096987,MGT 112,A00,202865,Ehrich; Kristine R,15,0,90,75
1683347098013,MGT 121A,A00,202868,Staff,0,20,0,0
1683347099040,MGT 131B,A00,202869,Anderson; John Charles,59,0,90,31
1683347100068,MGT 136,A00,202871,Lindenberger; Wade Douglas,84,0,90,6
1683347101091,MGT 164,A00,202873,Staff,0,68,90,91
1683347102116,MGT 164GS,A00,202874,McKay; Mary A,13,0,28,15
1683347103141,MGT 180,A00,202875,Staff,0,50,90,91
1683347104165,MMW 11R,A01,205019,Herbst; Matthew,3,0,30,27
1683347104165,MMW 11R,A02,205026,Herbst; Matthew,29,0,30,1
1683347105190,MMW 15,A01,193512,Chang; Edmond Yi-Teh,0,9,28,28
1683347105190,MMW 15,A02,193513,Chang; Edmond Yi-Teh,0,5,28,28
1683347105190,MMW 15,A03,193514,Chang; Edmond Yi-Teh,0,5,28,28
1683347105190,MMW 15,A04,193515,Chang; Edmond Yi-Teh,0,5,28,28
1683347105190,MMW 15,A05,193516,Chang; Edmond Yi-Teh,0,4,28,28
1683347105190,MMW 15,A06,193517,Chang; Edmond Yi-Teh,0,5,28,28
1683347105190,MMW 15,B01,193519,Chang; Edmond Yi-Teh,0,5,28,28
1683347105190,MMW 15,B02,193520,Chang; Edmond Yi-Teh,0,5,28,28
1683347105190,MMW 15,B03,193521,Chang; Edmond Yi-Teh,0,5,28,28
1683347105190,MMW 15,B04,193522,Chang; Edmond Yi-Teh,0,4,28,28
1683347105190,MMW 15,B05,193523,Chang; Edmond Yi-Teh,0,5,28,28
1683347105190,MMW 15,B06,193524,Chang; Edmond Yi-Teh,0,4,28,28
1683347106220,MMW 122,A01,193526,Rahimi; Babak,0,15,28,28
1683347106220,MMW 122,A02,193527,Rahimi; Babak,0,14,28,28
1683347106220,MMW 122,A03,193528,Rahimi; Babak,0,0,0,0
1683347106220,MMW 122,A04,193529,Rahimi; Babak,0,0,0,0
1683347107244,MUS 1A,A01,186663,Staff,0,20,35,35
1683347108269,MUS 4,A01,186715,Staff,0,12,35,35
1683347109293,MUS 5R,A01,186796,Dubnov; Shlomo,0,17,35,35
1683347110322,MUS 6,A01,186798,Staff,0,4,25,25
1683347111347,MUS 7,A01,186830,Staff,13,0,35,22
1683347112371,MUS 8,A01,186930,Staff,0,26,35,35
1683347113396,MUS 15,A01,186932,Staff,0,16,35,35
1683347113396,MUS 15,B01,186934,Staff,0,15,35,35
1683347114422,MUS 80,A00,186935,Staff,1,0,20,19
1683347114422,MUS 80,B00,186936,Staff,25,0,25,0
1683347115449,NANO 11,A00,204702,Lipomi; Darren John,0,0,0,0
1683347116479,NANO 15,A01,204709,Yang; Kesong,0,1,0,0
1683347117506,NANO 114,A00,202069,Jahed Motlagh; Zeinab,3,0,10,7
1683347118533,PHIL 1,A00,186955,Grush; Rick Scott,32,0,40,8
1683347119561,PHIL 10,A01,186973,Grush; Rick Scott,28,0,35,7
1683347119561,PHIL 10,A02,186974,Grush; Rick Scott,33,0,35,2
1683347120589,PHIL 13,A01,186976,Staff,7,0,35,28
1683347120589,PHIL 13,A02,186977,Staff,16,0,35,19
1683347121615,PHIL 14,A01,186979,Staff,31,0,35,4
1683347121615,PHIL 14,A02,186986,Staff,32,0,35,3
1683347122643,PHIL 28,A01,186988,Staff,16,0,30,14
1683347122643,PHIL 28,A02,186989,Staff,1,0,30,29
1683347122643,PHIL 28,A03,186990,Staff,9,0,30,21
1683347122643,PHIL 28,A04,186991,Staff,26,0,30,4
1683347123669,PHIL 120,A00,186997,Staff,23,0,40,17
1683347124694,PHIL 137,A00,187003,Staff,9,0,40,31
1683347125722,PHIL 150,A00,187015,Staff,47,0,70,23
1683347126745,PHIL 167,A00,187021,Lamey; Andy M.,35,0,40,5
1683347127769,PHIL 174,A01,202226,Staff,17,0,20,3
1683347127769,PHIL 174,A02,202235,Staff,20,0,20,0
1683347128795,PHIL 191A,A00,258918,Staff,0,0,1,1
1683347129823,PHYS 1A,A00,187028,Staff,27,0,60,33
1683347130845,PHYS 1AL,001,187036,Staff,2,0,30,28
1683347130845,PHYS 1AL,002,187049,Staff,18,0,30,12
1683347131872,PHYS 1B,A00,187058,Staff,22,0,60,38
1683347132899,PHYS 1BL,001,187064,Staff,0,0,30,30
1683347132899,PHYS 1BL,002,187070,Staff,5,0,30,25
1683347133925,PHYS 1C,A00,187082,Staff,31,0,120,89
1683347134950,PHYS 1CL,001,187088,Staff,0,9,30,30
1683347134950,PHYS 1CL,002,187089,Staff,0,2,30,30
1683347134950,PHYS 1CL,009,262693,Staff,11,0,30,19
1683347135973,PHYS 2B,A01,187097,Staff,54,0,115,61
1683347136998,PHYS 2C,A01,187099,Staff,67,0,115,48
1683347138023,PHYS 2CL,A01,187101,Staff,5,0,28,23
1683347138023,PHYS 2CL,A02,187102,Staff,15,0,28,13
1683347139048,PHYS 2D,A01,187123,Shotwell; Brian,95,0,115,20
1683347140072,PHYS 4B,A01,187133,Grinstein; Benjamin,35,0,50,15
1683347141097,POLI 10,A00,188819,Staff,0,4,50,50
1683347142122,POLI 11,A00,188827,Staff,43,0,50,7
1683347143147,POLI 13R,A00,188828,Staff,0,1,20,20
1683347144174,POLI 27,A01,188830,Elgin; Samuel Zincke,0,1,70,70
1683347145198,POLI 30,A00,188832,Desposato; Scott,31,0,50,19
1683347146225,POLI 102F,A00,188834,Staff,3,0,40,37
1683347147252,POLI 104A,A00,188852,Staff,14,0,30,16
1683347148279,POLI 104I,A00,188853,Staff,0,6,20,20
1683347149302,POLI 110B,A00,188854,Wiens; David,7,0,20,13
1683347150326,POLI 112A,A00,188855,Wiens; David,5,0,30,25
1683347151349,POLI 117R,A00,188856,Forman; Fonna,0,11,20,20
1683347152373,POLI 118,A00,188857,Ingham; Sean,8,0,20,12
1683347153451,POLI 120G,A00,188858,Staff,9,0,30,21
1683347154473,POLI 131CR,A00,188863,Hoston; Germaine,24,0,50,26
1683347155497,POLI 133,A00,188864,Nellis; Gareth Hb,44,0,50,6
1683347156521,POLI 134D,A00,188865,Desposato; Scott,27,0,30,3
1683347157546,POLI 142A,A00,188871,Gartzke; Erik,22,0,50,28
1683347158571,POLI 142K,A00,188874,Staff,38,0,50,12
1683347159599,POLI 143,A00,188940,Gartzke; Erik,16,0,30,14
1683347160624,POLI 153,A00,188943,Staff,3,0,20,17
1683347161655,POLI 160AA,A00,188944,Staff,11,0,40,29
1683347162681,POLI 170A,A00,188945,Staff,11,0,30,19
1683347164733,PSYC 1,A00,188952,Staff,37,0,90,53
1683347165760,PSYC 2,B00,188953,Staff,19,0,35,16
1683347166786,PSYC 6,A00,188970,Staff,47,0,60,13
1683347167813,PSYC 7,A00,188973,Staff,37,0,45,8
1683347168841,PSYC 60,A01,188980,Rickard; Timothy C.,43,0,60,17
1683347169867,PSYC 70,A01,189001,Steiner; Eric Tomas,23,0,45,22
1683347170892,PSYC 100,A00,189005,Lacefield; Katharine I,0,98,120,120
1683347171916,PSYC 102,A00,189008,Staff,9,0,30,21
1683347172941,PSYC 106,B00,189026,Gorman; Michael R.,34,0,60,26
1683347173966,PSYC 114,B01,189033,Winkielman; Piotr,0,32,30,30
1683347174990,PSYC 131,A00,189036,Anagnostaras; Stephan,0,43,60,60
1683347176016,PSYC 136,A00,189041,Lowe; Angela Beth,0,7,25,25
1683347177040,PSYC 137,A00,189057,Winkielman; Piotr,0,34,25,25
1683347178067,PSYC 144,A00,189107,Wixted; John T,0,7,50,50
1683347180121,PSYC 162,A00,189142,Staff,0,8,85,85
1683347181149,PSYC 172,A00,189144,Gorman; Michael R.,0,7,30,30
1683347183202,PSYC 179,A00,189146,Lacefield; Katharine I,0,84,120,120
1683347184230,PSYC 181,A00,189147,Anagnostaras; Stephan,0,44,90,90
1683347185257,PSYC 190R,A00,189148,Barner; David A.,0,22,80,80
1683347186286,PSYC 191,A00,189275,Rickard; Timothy C.,0,7,25,25
1683347187311,PSYC 193,A00,189276,Chapman; Eddie Nathaniel,0,1,0,4
1683347188335,PSYC 193L,A01,189281,Lowe; Angela Beth,12,0,20,8
1683347188335,PSYC 193L,B01,189285,Staff,28,0,35,7
1683347189360,RELI 149,A00,187137,Rahimi; Babak,7,0,40,33
1683347190388,SE 9,A01,187315,Staff,0,2,18,18
1683347191411,SE 101B,A00,187409,Staff,24,0,30,6
1683347192434,SE 110B,A00,187444,Staff,10,0,40,30
1683347193462,SE 130B,A00,187449,Staff,31,0,40,9
1683347194488,SE 150A,A00,187516,Staff,9,0,20,11
1683347195512,SE 154,A00,187528,Staff,30,0,50,20
1683347196539,SIO 3,A01,258171,Staff,35,0,40,5
1683347197567,SIO 10,A00,187144,Cook; Geoffrey W,0,3,75,75
1683347198594,SIO 45,A00,187152,Cook; Geoffrey W,1,0,100,99
1683347199618,SIO 109R,A00,194486,Staff,0,3,20,20
1683347201667,SIO 187,A01,187233,Kacev; David,12,0,40,28
1683347202692,SOCI 1,A01,258656,Thorpe; Charles Robert,28,0,30,2
1683347202692,SOCI 1,A02,258658,Thorpe; Charles Robert,30,0,30,0
1683347202692,SOCI 1,A03,258661,Thorpe; Charles Robert,25,0,25,0
1683347202692,SOCI 1,A04,258666,Thorpe; Charles Robert,22,0,25,3
1683347202692,SOCI 1,A05,258897,Thorpe; Charles Robert,23,0,25,2
1683347202692,SOCI 1,A06,258898,Thorpe; Charles Robert,25,0,25,0
1683347203717,SOCI 30,A01,258903,Pardo Guerra; Juan Pablo,15,0,30,15
1683347204740,SOCI 102,A00,258904,Staff,9,0,25,16
1683347205764,SOCI 106,A00,258905,Staff,19,0,25,6
1683347206789,SOCI 111,A00,258907,Ribas Norris; Janet Vanesa,26,0,30,4
1683347207813,SOCI 121R,A00,258908,Pardo Guerra; Juan Pablo,10,0,30,20
1683347208838,SOCI 126,A01,203330,Staff,14,0,20,6
1683347209862,SOCI 131,A00,258909,Thorpe; Charles Robert,31,0,60,29
1683347210887,SOCI 135,A00,258910,Payne; Christine Anna,0,9,30,30
1683347211911,SOCI 157,A00,258911,Staff,12,0,30,18
1683347212937,SOCI 184,A00,258912,Staff,25,0,30,5
1683347213961,SOCI 188D,A00,258913,Staff,21,0,30,9
1683347214990,SYN 2,001,187529,Staff,10,0,16,6
1683347214990,SYN 2,002,201452,Staff,0,18,16,16
1683347214990,SYN 2,003,201469,Staff,3,0,16,13
1683347216017,SYN 100,A01,187531,Staff,0,9,20,20
1683347216017,SYN 100,B01,201491,Staff,0,12,20,20
1683347217044,TDAC 1,A00,189286,Walsh; Kim C.,3,0,20,17
1683347217044,TDAC 1,B00,189287,Harting; Carla Kelso,11,0,20,9
1683347218069,TDAC 101,A00,189300,Walsh; Kim C.,16,0,20,4
1683347218069,TDAC 101,B00,189301,Harting; Carla Kelso,18,0,20,2
1683347219093,TDAC 102,A00,189304,Basso; Beatrice,14,0,20,6
1683347220121,TDAC 108,A00,189305,Staff,18,0,20,2
1683347221153,TDDE 131,A00,189310,Staff,19,0,20,1
1683347221153,TDDE 131,B00,189314,Staff,19,0,20,1
1683347221153,TDDE 131,C00,189315,Staff,48,0,50,2
1683347221153,TDDE 131,D00,189316,Staff,14,0,15,1
1683347221153,TDDE 131,E00,204841,Staff,20,0,20,0
1683347222176,TDGE 10,A00,189289,Staff,30,0,50,20
1683347222176,TDGE 10,B00,189290,Havis; Allan,1,0,50,49
1683347223201,TDGE 11,A00,189291,Fulton; Julia,0,3,50,50
1683347223201,TDGE 11,B00,189292,Staff,20,0,25,5
1683347223201,TDGE 11,C00,260270,Staff,0,0,0,0
1683347224226,TDGE 25,A00,189294,Staff,3,0,20,17
1683347225249,TDGE 124,A00,189318,Fulton; Julia,0,8,50,50
1683347226273,TDGE 125,A00,189319,Staff,13,0,25,12
1683347226273,TDGE 125,B00,189320,Staff,23,0,25,2
1683347227301,TDGE 127,A00,189322,Havis; Allan,0,0,50,50
1683347228326,TDHT 101,A00,189323,Staff,18,0,25,7
1683347228326,TDHT 101,B00,189324,Staff,25,0,25,0
1683347229354,TDHT 102,A00,189325,Staff,49,0,50,1
1683347230378,TDMV 1,A00,189295,Arcidiacono; Kristin,19,0,30,11
1683347230378,TDMV 1,B00,189296,Caligagan; Maria T.,24,0,30,6
1683347231406,TDMV 2,A00,189297,Sammartano; Tonnie,28,0,30,2
1683347231406,TDMV 2,B00,189299,Arcidiacono; Kristin,24,0,30,6
1683347232433,TDMV 3,A00,204998,Rincon; Alicia,22,0,30,8
1683347233461,TDMV 120,A00,189458,Sammartano; Tonnie,28,0,30,2
1683347234486,TDMV 138,A00,189541,Jun; Grace Shin Hae,22,0,40,18
1683347235509,TDMV 142,A00,189717,Caligagan; Tony,23,0,30,7
1683347235509,TDMV 142,B00,189718,Caligagan; Maria T.,25,0,30,5
1683347236533,TMC 2,A01,187533,Staff,25,0,25,0
1683347236533,TMC 2,A02,187534,Staff,25,0,25,0
1683347237561,USP 1,A01,187536,Kwak; Nancy,0,16,25,25
1683347238585,USP 5,A01,187538,Staff,10,0,25,15
1683347239609,USP 101,A00,199253,Staff,0,4,0,0
1683347240634,USP 124,A00,187562,Boomhower; Matthew Charles,1,0,30,29
1683347241662,USP 138,A00,187582,Staff,20,0,25,5
1683347242689,USP 152,A01,187597,Staff,4,0,25,21
1683347243717,USP 153,A00,187598,Staff,19,0,25,6
1683347244745,USP 168,A00,187607,Kwak; Nancy,2,0,5,3
1683347245772,USP 173,A00,187619,Staff,4,0,25,21
1683347246800,USP 181,A00,187638,Staff,0,1,25,25
1683347247824,VIS 103,A00,187650,Cruz; Edwin Teddy,23,0,75,52
1683347248848,VIS 110D,A00,187669,Staff,12,0,22,10
1683347249873,VIS 127C,A00,187720,Shen; Kuiyi,67,0,146,79
1683347250899,VIS 149,A00,187731,Yoldas; Pinar,0,14,22,22
1683347251926,VIS 151,A01,188091,Staff,22,0,34,12
1683347251926,VIS 151,A02,188092,Staff,11,0,34,23
1683347252954,VIS 160B,A00,188093,Stalbaum; Brett,0,0,10,10
1683347255006,WCWP 10B,A00,201720,Staff,10,0,15,5
1683347255006,WCWP 10B,B00,201722,Staff,9,0,15,6
1683347256032,WCWP 100,A00,201725,Gagnon; Jeffrey C,0,0,2,2
1683347256032,WCWP 100,B00,201727,Staff,0,4,15,15
1683347259223,ANBI 133,A00,258401,Wilder; Linnea Lorene,34,0,40,6
1683347260249,ANBI 140,A00,258395,Hrvoj Mihic; Branka,18,0,25,7
1683347261278,ANSC 120,A00,258402,Bialecki; Jon Anthony,27,0,40,13
1683347262303,ANSC 144,A00,258400,Staff,14,0,40,26
1683347264353,ANSC 166,A00,258396,Parish; Steven Martin,157,0,175,18
1683347265380,ANSC 180,A00,193533,Staff,9,0,20,11
1683347266404,ANSC 188,A00,258397,Jassal; Aftab,33,0,40,7
1683347267429,ANTH 3,A01,258316,Staff,23,0,30,7
1683347268453,ANTH 5,A00,258394,Semendeferi; Ekaterini,16,0,20,4
1683347269477,ANTH 21,A01,258331,Staff,8,0,40,32
1683347270500,ANTH 103,A00,258398,Varma; Saiba,15,0,25,10
1683347271528,AWP 10,001,202034,Staff,0,0,0,0
1683347271528,AWP 10,002,202035,Staff,0,0,0,0
1683347271528,AWP 10,003,202036,Staff,0,0,0,0
1683347271528,AWP 10,004,202037,Staff,0,0,0,0
1683347271528,AWP 10,005,202038,Staff,0,0,0,0
1683347271528,AWP 10,006,202039,Staff,0,0,0,0
1683347271528,AWP 10,007,202040,Staff,0,0,0,0
1683347271528,AWP 10,008,202041,Staff,0,0,0,0
1683347271528,AWP 10,009,202042,Staff,0,0,0,0
1683347271528,AWP 10,010,202043,Staff,0,0,0,0
1683347271528,AWP 10,011,202044,Staff,0,0,0,0
1683347271528,AWP 10,012,202045,Staff,0,0,0,0
1683347271528,AWP 10,013,202046,Staff,0,0,0,0
1683347271528,AWP 10,014,202047,Staff,0,0,0,0
1683347271528,AWP 10,015,202048,Staff,0,0,0,0
1683347271528,AWP 10,016,202049,Staff,0,0,0,0
1683347271528,AWP 10,017,202050,Staff,0,0,0,0
1683347271528,AWP 10,018,202051,Staff,0,0,0,0
1683347271528,AWP 10,019,202052,Staff,0,0,0,0
1683347271528,AWP 10,020,202053,Staff,0,0,0,0
1683347271528,AWP 10,021,202054,Staff,0,0,0,0
1683347271528,AWP 10,022,202055,Staff,0,0,0,0
1683347271528,AWP 10,023,202056,Staff,0,0,0,0
1683347271528,AWP 10,024,202057,Staff,0,0,0,0
1683347271528,AWP 10,025,202058,Staff,0,0,0,0
1683347271528,AWP 10,026,202059,Staff,0,0,0,0
1683347272553,AWP 102,001,202032,Staff,0,0,0,0
1683347272553,AWP 102,002,202033,Staff,0,0,0,0
1683347273581,BENG 100,A01,254234,Taylor Amos; Alyssa C,31,0,40,9
1683347274608,BENG 196,001,270013,Engler; Adam J.,9999,0,9999,0
1683347275633,BICD 100R,A01,202018,Smith; Laurie,0,7,32,32
1683347275633,BICD 100R,A02,202019,Smith; Laurie,0,2,32,32
1683347275633,BICD 100R,A03,202020,Smith; Laurie,0,1,32,32
1683347275633,BICD 100R,A04,202021,Smith; Laurie,9,0,32,23
1683347275633,BICD 100R,A05,202022,Smith; Laurie,12,0,32,20
1683347276679,BICD 136,A01,193242,Gustafson-Brown; Cindy,0,2,32,32
1683347276679,BICD 136,A02,193244,Gustafson-Brown; Cindy,14,0,32,18
1683347277705,BIEB 102,A01,193249,Butler; Shannon Rhey,0,2,32,32
1683347277705,BIEB 102,A02,193251,Butler; Shannon Rhey,0,0,32,32
1683347277705,BIEB 102,A03,193253,Butler; Shannon Rhey,0,1,32,32
1683347277705,BIEB 102,A04,193255,Butler; Shannon Rhey,17,0,32,15
1683347277705,BIEB 102,A05,193265,Butler; Shannon Rhey,26,0,32,6
1683347277705,BIEB 102,A06,193269,Butler; Shannon Rhey,16,0,32,16
1683347279756,BIEB 150,A01,193274,Staff,0,0,32,32
1683347279756,BIEB 150,A02,193285,Staff,23,0,32,9
1683347280782,BIEB 194,A00,193286,Kurle; Carolyn M.,22,0,32,10
1683347281806,BILD 1,A01,192291,Staff,16,0,32,16
1683347281806,BILD 1,A02,192292,Staff,30,0,32,2
1683347281806,BILD 1,B01,192520,Reuther; Keefe,0,1,0,0
1683347281806,BILD 1,B02,192532,Reuther; Keefe,0,1,0,0
1683347282830,BILD 3,A01,192556,Butler; Shannon Rhey,0,0,32,32
1683347282830,BILD 3,A02,192581,Butler; Shannon Rhey,5,0,32,27
1683347282830,BILD 3,A03,192611,Butler; Shannon Rhey,23,0,32,9
1683347282830,BILD 3,A04,192612,Butler; Shannon Rhey,25,0,32,7
1683347282830,BILD 3,A05,192613,Butler; Shannon Rhey,27,0,32,5
1683347282830,BILD 3,A06,192679,Butler; Shannon Rhey,27,0,32,5
1683347282830,BILD 3,A07,192682,Butler; Shannon Rhey,22,0,32,10
1683347283854,BILD 4,A01,192836,Reuther; Keefe,0,0,24,24
1683347283854,BILD 4,A02,193044,Reuther; Keefe,4,0,24,20
1683347284879,BILD 10,A01,193142,Gustafson-Brown; Cindy,30,0,32,2
1683347284879,BILD 10,A02,193149,Gustafson-Brown; Cindy,31,0,32,1
1683347285904,BIMM 100,A01,193301,Staff,0,6,32,32
1683347285904,BIMM 100,A02,193312,Staff,0,5,32,32
1683347285904,BIMM 100,A03,193323,Staff,0,8,32,32
1683347286930,BIMM 101,A01,193329,McDonnell; Lisa Marie,0,3,24,24
1683347286930,BIMM 101,A02,193339,McDonnell; Lisa Marie,0,3,24,24
1683347286930,BIMM 101,B01,193354,McDonnell; Lisa Marie,0,3,24,24
1683347286930,BIMM 101,B02,193357,McDonnell; Lisa Marie,0,3,24,24
1683347287956,BIMM 110,A01,193377,Tat; John,0,11,32,32
1683347287956,BIMM 110,A02,193378,Tat; John,1,9,32,31
1683347288982,BIMM 120,A01,206116,Staff,0,0,32,32
1683347288982,BIMM 120,A02,206117,Staff,8,0,32,24
1683347288982,BIMM 120,A03,206121,Staff,21,0,32,11
1683347290011,BIPN 100,A01,193393,Park; Ji Young,0,14,32,32
1683347290011,BIPN 100,A02,193402,Park; Ji Young,0,13,32,32
1683347290011,BIPN 100,A03,193413,Park; Ji Young,0,14,32,32
1683347290011,BIPN 100,A04,193414,Park; Ji Young,0,13,32,32
1683347291038,BIPN 102,A01,193429,Staff,0,0,32,32
1683347291038,BIPN 102,A02,193438,Staff,22,0,32,10
1683347292062,BIPN 106,A01,193450,Reyes Gonzalez; Catalina,0,2,40,40
1683347293091,BIPN 134,A01,193465,Cooke; James Edward,0,0,32,32
1683347293091,BIPN 134,A02,193474,Cooke; James Edward,25,0,32,7
1683347293091,BIPN 134,A03,193485,Cooke; James Edward,29,0,32,3
1683347293091,BIPN 134,A04,193486,Cooke; James Edward,21,0,32,11
1683347293091,BIPN 134,A05,193491,Cooke; James Edward,31,0,32,1
1683347293091,BIPN 134,A06,193501,Cooke; James Edward,30,0,32,2
1683347293091,BIPN 134,A07,193510,Cooke; James Edward,29,0,32,3
1683347295142,BISP 194,A00,222522,Staff,14,0,32,18
1683347296170,CAT 124,A01,202407,Staff,20,0,25,5
1683347297199,CAT 125,A00,202408,Marchisotto; Jennifer Anne,4,0,20,16
1683347298225,CAT 125R,A00,202409,Smith; Lauryn Alissa,0,11,20,20
1683347298225,CAT 125R,B00,202410,Morales; Celeste Georgianna,0,11,20,20
1683347298225,CAT 125R,C00,202411,Irwin; Matthew Joseph,0,10,20,20
1683347299250,CENG 15,A01,204712,Yang; Kesong,0,1,0,0
1683347300274,CENG 114,A00,202070,Jahed Motlagh; Zeinab,5,0,20,15
1683347301298,CGS 105,A00,185477,Wesling; Megan E.,24,0,40,16
1683347302322,CGS 106,A00,185494,Staff,13,0,22,9
1683347303348,CGS 108,A00,185495,Staff,14,0,20,6
1683347304373,CGS 114,A00,185496,Staff,13,0,18,5
1683347305397,CGS 119,A00,185501,Staff,15,0,20,5
1683347306421,CGS 120,A00,185511,Staff,13,0,20,7
1683347307448,CHEM 4,A01,184675,Bussey; Thomas J,96,0,100,4
1683347308473,CHEM 6A,A01,184677,Staff,34,0,60,26
1683347309497,CHEM 6B,A01,184679,Staff,65,0,100,35
1683347310523,CHEM 6C,A01,184681,Bussey; Thomas J,1,0,50,49
1683347310523,CHEM 6C,A02,184682,Bussey; Thomas J,34,0,50,16
1683347311550,CHEM 40A,A01,184684,Albizati; Kim F.,37,0,100,63
1683347312573,CHEM 40B,A01,184686,Albizati; Kim F.,0,20,100,100
1683347313597,CHEM 41B,A01,184690,Staff,52,0,100,48
1683347314622,COGS 3,A01,184715,Boyle; Mary E. T.,0,25,40,40
1683347315650,COGS 14B,A01,185172,Staff,0,15,38,38
1683347316675,COGS 18,A01,184736,Staff,17,0,80,63
1683347317699,COGS 100,A01,184932,Staff,0,5,73,73
1683347318724,COGS 101A,A01,184935,Staff,0,39,30,30
1683347319748,COGS 101B,A01,184944,Staff,0,2,30,30
1683347320771,COGS 101C,A01,184946,Staff,0,12,30,30
1683347321795,COGS 102A,A01,184951,Johnson; Christine M.,2,0,40,38
1683347322823,COGS 107B,A01,184953,Mooshagian; Eric Frederick,0,50,40,40
1683347323851,COGS 118B,A01,184959,Gupta; Anjum,0,48,40,40
1683347324877,COGS 153,A00,184961,Staff,0,15,30,30
1683347325904,COGS 177,A00,184962,Staff,0,20,30,30
1683347326932,COGS 187A,A01,184969,Boyle; Mary E. T.,0,17,40,40
1683347327957,COMM 10,A01,185174,Staff,0,5,25,25
1683347327957,COMM 10,A02,185189,Staff,0,5,25,25
1683347327957,COMM 10,A03,269821,Staff,0,0,0,0
1683347328980,COMM 100B,A01,185475,Staff,0,0,0,2
1683347328980,COMM 100B,A02,185476,Staff,13,0,25,12
1683347330004,COMM 100C,A01,185314,Staff,1,0,25,24
1683347330004,COMM 100C,A02,185327,Staff,19,0,25,6
1683347331028,COMM 110M,A00,185349,Staff,2,0,40,38
1683347332052,COMM 113T,A00,185352,Staff,24,0,40,16
1683347333077,COMM 114I,A00,185353,Staff,33,0,40,7
1683347334102,COMM 131,A00,185354,Staff,19,0,30,11
1683347335129,CSE 8A,A50,185358,Cao; Yingjun,0,46,10,10
1683347336152,CSE 8B,A01,185362,Staff,1,47,50,49
1683347337180,CSE 11,A01,185416,Cao; Yingjun,0,92,10,10
1683347338203,CSE 20,A01,185445,Briones; Jor-el Thomas Caparas,5,0,25,20
1683347339228,CSE 21,A01,185447,Staff,10,0,50,40
1683347340251,CSE 101,A01,185451,Staff,0,13,50,50
1683347340251,CSE 101,B01,185453,Jones; Miles E,0,11,50,50
1683347342304,CSE 141,A01,185458,Eldon; John,20,0,100,80
1683347343332,CSE 141L,A01,185461,Eldon; John,12,0,100,88
1683347344357,CSE 142,A01,185463,Staff,36,0,60,24
1683347344357,CSE 142,B01,201355,Staff,0,7,60,60
1683347345382,CSE 142L,A01,185470,Staff,36,0,60,24
1683347345382,CSE 142L,B01,201417,Staff,0,6,60,60
1683347346406,CSE 190,A00,201433,Staff,32,0,49,17
1683347347430,DOC 1,A01,259136,Strom; Megan C.,7,0,15,8
1683347347430,DOC 1,A02,259137,Strom; Megan C.,14,0,15,1
1683347347430,DOC 1,A03,259138,Strom; Megan C.,14,0,15,1
1683347347430,DOC 1,A04,259139,Strom; Megan C.,14,0,15,1
1683347348455,DOC 100D,A00,259140,Pass; Natalye Joann,16,0,25,9
1683347349480,DSGN 1,A01,184749,Rill; Bryan,0,25,30,30
1683347350505,DSGN 100,A01,185168,Staff,0,2,25,25
1683347351528,ECE 5,A01,185626,Morris; Karcher William,0,10,0,0
1683347352556,ECE 101,A01,185628,Staff,17,0,70,53
1683347353584,ECE 107,A01,185635,Baghdadchi; Saharnaz,0,0,20,20
1683347353584,ECE 107,A02,185638,Baghdadchi; Saharnaz,4,0,20,16
1683347354610,ECE 148,A01,185647,Silberman; Jack,0,0,16,16
1683347355635,ECON 1,A01,185537,Crane; Meredith Helen,54,0,70,16
1683347356662,ECON 3,A01,185549,Crane; Meredith Helen,32,0,70,38
1683347357687,ECON 4,A01,203354,Anderson; John Charles,0,4,10,10
1683347358715,ECON 100A,A01,185574,Staff,0,4,40,40
1683347359743,ECON 100B,A01,185576,Staff,10,22,50,40
1683347360827,ECON 100C,A01,185589,Newhouse; Herbert S,29,0,70,41
1683347361854,ECON 105,A00,185608,Vespa; Emanuel Ignacio,19,0,35,16
1683347362879,ECON 109,A01,185610,Shishkin; Denis,10,0,35,25
1683347363907,ECON 110A,A01,185612,Staff,11,0,40,29
1683347364931,ECON 120A,A01,185615,Staff,20,0,40,20
1683347365956,ECON 120C,A01,185617,Sun; Yixiao,0,21,70,70
1683347366979,ECON 144,A00,203346,Squires; Dale E,3,0,35,32
1683347368003,ECON 171,A01,203349,Newhouse; Herbert S,0,1,35,35
1683347369028,ECON 173A,A01,185621,Toda; Alexis Akira,21,0,35,14
1683347370058,EDS 25,A01,202413,Staff,0,1,0,0
1683347370058,EDS 25,A02,202414,Staff,0,1,0,0
1683347370058,EDS 25,A03,202415,Staff,0,0,0,0
1683347370058,EDS 25,A04,202416,Staff,0,1,0,0
1683347370058,EDS 25,A05,202439,Staff,0,0,0,0
1683347370058,EDS 25,A06,202440,Staff,0,0,0,0
1683347370058,EDS 25,B01,202631,Staff,0,0,0,0
1683347370058,EDS 25,B02,202632,Staff,0,0,0,0
1683347370058,EDS 25,B03,202639,Staff,0,0,0,0
1683347370058,EDS 25,B04,202640,Staff,0,0,0,0
1683347370058,EDS 25,B05,202643,Staff,0,0,0,0
1683347370058,EDS 25,B06,202644,Staff,0,0,0,0
1683347371089,EDS 38,A01,202659,Black; Alison Michelle,24,0,25,1
1683347372113,EDS 115,A00,202652,Staff,18,0,30,12
1683347373140,EDS 125,A00,202649,Staff,14,0,30,16
1683347374163,EDS 126,A01,203332,Staff,30,0,30,0
1683347375188,EDS 139,A00,202838,Staff,16,0,25,9
1683347376212,EDS 146,A01,202655,Staff,14,0,25,11
1683347377235,ENG 15,A00,185667,Staff,0,1,0,0
1683347377235,ENG 15,B00,185672,Staff,0,0,0,0
1683347377235,ENG 15,C00,185675,Staff,0,0,0,0
1683347377235,ENG 15,D00,185682,Staff,0,0,0,0
1683347377235,ENG 15,E00,185684,Staff,0,0,0,0
1683347378259,ETHN 103,A00,185710,Staff,0,4,35,35
1683347379289,ETHN 103A,A00,199228,Man; Simeon S,2,0,9,7
1683347380314,ETHN 109,A00,185711,Staff,18,0,35,17
1683347381341,ETHN 142,A00,185726,Staff,0,4,30,30
1683347382370,ETHN 163J,A00,199229,Man; Simeon S,5,0,8,3
1683347383396,ETHN 168,A00,185727,Staff,8,0,10,2
1683347384421,ETHN 182,A00,185728,Staff,1,0,35,34
1683347385449,ETHN 183,A00,185737,Staff,8,0,18,10
1683347386475,GLBH 111,A01,209361,Burgos; Jose L.,0,0,0,0
1683347388527,HIEU 104,A00,185792,Staff,16,0,20,4
1683347389553,HIEU 115,A00,185800,Staff,1,0,20,19
1683347390578,HIEU 128,A00,185801,Staff,0,7,20,20
1683347391602,HIEU 147,A00,185802,Staff,16,0,20,4
1683347392626,HIEU 154,A00,185823,Staff,12,0,20,8
1683347393656,HILA 102,A00,185826,Staff,13,0,20,7
1683347394681,HILD 2C,A01,185778,Staff,0,12,20,20
1683347395710,HILD 7B,A01,185780,Kwak; Nancy,0,15,32,32
1683347395710,HILD 7B,A02,185781,Kwak; Nancy,0,18,32,32
1683347396734,HILD 30,A01,185791,Staff,14,0,20,6
1683347397758,HISC 119,A00,185830,Golan; Tal,0,9,20,20
1683347398781,HITO 156GS,A00,185831,Patterson; Patrick H.,0,0,0,23
1683347399809,HIUS 103,A00,185832,Man; Simeon S,0,6,20,20
1683347400837,HIUS 117,A00,185836,Kwak; Nancy,2,0,20,18
1683347401861,HIUS 125,A00,185840,Man; Simeon S,0,0,23,23
1683347402889,HIUS 149,A00,185845,Staff,0,0,20,20
1683347403917,HUM 3,A01,185882,Zavodny; Tatiana Sophia,0,7,50,50
1683347403917,HUM 3,B01,185899,Caldwell; Michael Alan,0,18,50,50
1683347404943,HUM 3GS,A00,185900,Patterson; Patrick H.,0,0,0,23
1683347405971,HUM 4,A01,185938,Zroka; Amy Liane,31,0,50,19
1683347405971,HUM 4,B01,185956,Watkins; Eric,0,2,50,50
1683347405971,HUM 4,B02,202209,Watkins; Eric,0,2,50,50
1683347405971,HUM 4,B03,202210,Watkins; Eric,0,2,50,50
1683347406995,HUM 5,A01,185958,West; Geoffrey Scott,3,0,50,47
1683347406995,HUM 5,A02,202215,West; Geoffrey Scott,0,0,50,50
1683347408021,INTL 190,A00,185959,Gagnon; Jeffrey C,0,0,0,9
1683347408021,INTL 190,B00,185960,Lettieri; Michael Joseph,0,0,0,1
1683347409048,JAPN 180,A00,254509,Staff,5,1,30,25
1683347410072,LATI 10,A01,202853,Kennemore; Amy Michelle,4,0,35,31
1683347410072,LATI 10,A02,202854,Kennemore; Amy Michelle,2,0,35,33
1683347410072,LATI 10,A03,270054,Kennemore; Amy Michelle,30,0,30,0
1683347411096,LATI 180,A00,202855,Kennemore; Amy Michelle,11,0,20,9
1683347412119,LAWS 101,A00,201767,Golan; Tal,0,7,40,40
1683347413145,LIFR 1C,A00,185961,Staff,6,0,20,14
1683347414172,LIFR 1CX,A00,185962,Staff,7,0,20,13
1683347415200,LIFR 1D,A00,185963,Staff,9,0,20,11
1683347416223,LIFR 1DX,A00,185964,Staff,9,0,20,11
1683347417247,LIGN 101,A01,186039,Staff,43,0,50,7
1683347418271,LIGN 165,A00,186040,Staff,18,0,50,32
1683347428569,LTCS 108,A00,186041,Staff,6,0,10,4
1683347429593,LTCS 119,A00,186042,Staff,16,0,20,4
1683347430617,LTCS 130,A00,186043,Wesling; Megan E.,15,0,25,10
1683347432666,LTEA 138,A00,186119,Staff,14,0,40,26
1683347433693,LTEN 124,A00,186148,Staff,6,0,25,19
1683347434722,LTEN 178,A00,186149,Staff,7,0,15,8
1683347435750,LTEN 181,A00,186150,Blanco; John D,33,0,40,7
1683347436777,LTWL 120,A00,186160,Staff,20,0,25,5
1683347437803,LTWL 165,A00,186161,Staff,22,0,25,3
1683347438831,LTWR 100,A00,186162,Staff,0,5,15,15
1683347439857,LTWR 102,A00,186163,Doller; Ben,5,0,15,10
1683347440880,MAE 8,A01,186412,Staff,0,0,0,0
1683347441908,MAE 30B,A00,186445,Bahadori; Mohammad Yousef,83,0,100,17
1683347442936,MAE 40,A00,186592,Bewley; Thomas R,9,0,50,41
1683347443961,MAE 101B,A00,186593,Bahadori; Mohammad Yousef,81,0,100,19
1683347444988,MAE 105,A00,186594,Bandaru; Prabhakar,12,0,50,38
1683347446012,MAE 107,A00,186599,Pham; Hieu Tan,0,6,120,120
1683347447036,MAE 148,A01,186660,Silberman; Jack,3,0,16,13
1683347448061,MATH 10A,A01,188095,Staff,1,6,35,34
1683347449085,MATH 10B,A01,188097,Bowers; Adam R.,0,11,30,30
1683347449085,MATH 10B,A02,188099,Bowers; Adam R.,0,11,30,30
1683347449085,MATH 10B,B01,188104,Bowers; Adam R.,0,10,30,30
1683347449085,MATH 10B,B02,188106,Bowers; Adam R.,0,10,30,30
1683347450110,MATH 10C,A01,188111,Staff,0,18,30,30
1683347450110,MATH 10C,A02,188127,Staff,0,17,30,30
1683347450110,MATH 10C,A03,188131,Staff,0,18,30,30
1683347450110,MATH 10C,B01,188218,Staff,18,0,30,12
1683347450110,MATH 10C,B02,188244,Staff,13,0,30,17
1683347450110,MATH 10C,B03,188277,Staff,16,0,30,14
1683347451135,MATH 18,A01,188344,Bach; Quang Tran,18,0,30,12
1683347451135,MATH 18,A02,188345,Bach; Quang Tran,11,0,30,19
1683347451135,MATH 18,B01,188353,Bach; Quang Tran,10,0,30,20
1683347451135,MATH 18,B02,188354,Bach; Quang Tran,20,0,30,10
1683347452163,MATH 20A,A01,188374,Staff,13,0,35,22
1683347453188,MATH 20B,A01,188382,Ohm; Ko Woon,6,0,30,24
1683347453188,MATH 20B,A02,188383,Ohm; Ko Woon,22,0,30,8
1683347453188,MATH 20B,B01,188385,Ohm; Ko Woon,7,0,30,23
1683347453188,MATH 20B,B02,188392,Ohm; Ko Woon,22,0,30,8
1683347454216,MATH 20C,A01,188394,Harel; Guershon,10,0,30,20
1683347454216,MATH 20C,A02,188395,Harel; Guershon,15,0,30,15
1683347454216,MATH 20C,B01,188404,Harel; Guershon,5,0,30,25
1683347454216,MATH 20C,B02,188405,Harel; Guershon,19,0,30,11
1683347455242,MATH 20D,A01,188414,Hammock; Frances H,0,1,30,30
1683347455242,MATH 20D,A02,188415,Hammock; Frances H,3,0,30,27
1683347455242,MATH 20D,B01,188447,Hammock; Frances H,1,0,30,29
1683347455242,MATH 20D,B02,188486,Hammock; Frances H,8,0,30,22
1683347456265,MATH 20E,A01,188649,Staff,21,0,30,9
1683347456265,MATH 20E,A02,188650,Staff,23,0,30,7
1683347456265,MATH 20E,A03,188673,Staff,0,0,30,30
1683347457293,MATH 102,A01,188675,Staff,0,35,35,35
1683347458320,MATH 103B,A01,188681,Staff,3,0,35,32
1683347458320,MATH 103B,B01,188692,Staff,5,0,35,30
1683347459344,MATH 109,A01,188695,Salehi Golsefidy; Alireza,25,0,35,10
1683347459344,MATH 109,A02,188696,Salehi Golsefidy; Alireza,25,0,35,10
1683347460369,MATH 120A,A01,188698,Eggers; John Dietrich,7,0,35,28
1683347461393,MATH 142B,A01,188736,Ioana; Adrian,0,2,30,30
1683347461393,MATH 142B,A02,188741,Ioana; Adrian,1,1,30,29
1683347461393,MATH 142B,A03,188743,Ioana; Adrian,1,3,30,29
1683347462418,MATH 168A,A01,188790,Staff,0,9,35,35
1683347463445,MATH 170A,A01,188803,Nie; Jiawang,0,2,35,35
1683347463445,MATH 170A,A02,188811,Nie; Jiawang,0,0,35,35
1683347463445,MATH 170A,A03,188814,Nie; Jiawang,1,0,35,34
1683347463445,MATH 170A,A04,188815,Nie; Jiawang,13,0,35,22
1683347464470,MATH 193B,A01,188817,Staff,0,0,35,35
1683347464470,MATH 193B,A02,188818,Staff,5,0,35,30
1683347465494,MGT 4,A01,202857,Anderson; John Charles,62,0,80,18
1683347466519,MGT 12,A00,202858,Lindenberger; Wade Douglas,42,0,90,48
1683347467543,MGT 18,A00,202859,Staff,74,0,90,16
1683347468568,MGT 18GS,A00,202860,McKay; Michael J,13,0,28,15
1683347469592,MGT 45,A00,202861,Pecore; Joseph P.,14,0,90,76
1683347470617,MGT 100,A00,202863,Yavorsky; Daniel Ryan,28,0,90,62
1683347471642,MGT 103,A00,202864,Ehrich; Kristine R,1,18,90,89
1683347472667,MGT 112,A00,202865,Ehrich; Kristine R,15,0,90,75
1683347473746,MGT 121A,A00,202868,Staff,0,20,0,0
1683347474774,MGT 131B,A00,202869,Anderson; John Charles,59,0,90,31
1683347475800,MGT 136,A00,202871,Lindenberger; Wade Douglas,84,0,90,6
1683347476824,MGT 164,A00,202873,Staff,0,68,90,91
1683347477849,MGT 164GS,A00,202874,McKay; Mary A,13,0,28,15
1683347478876,MGT 180,A00,202875,Staff,0,50,90,91
1683347479900,MMW 11R,A01,205019,Herbst; Matthew,3,0,30,27
1683347479900,MMW 11R,A02,205026,Herbst; Matthew,29,0,30,1
1683347480930,MMW 15,A01,193512,Chang; Edmond Yi-Teh,0,9,28,28
1683347480930,MMW 15,A02,193513,Chang; Edmond Yi-Teh,0,5,28,28
1683347480930,MMW 15,A03,193514,Chang; Edmond Yi-Teh,0,5,28,28
1683347480930,MMW 15,A04,193515,Chang; Edmond Yi-Teh,0,5,28,28
1683347480930,MMW 15,A05,193516,Chang; Edmond Yi-Teh,0,4,28,28
1683347480930,MMW 15,A06,193517,Chang; Edmond Yi-Teh,0,5,28,28
1683347480930,MMW 15,B01,193519,Chang; Edmond Yi-Teh,0,5,28,28
1683347480930,MMW 15,B02,193520,Chang; Edmond Yi-Teh,0,5,28,28
1683347480930,MMW 15,B03,193521,Chang; Edmond Yi-Teh,0,5,28,28
1683347480930,MMW 15,B04,193522,Chang; Edmond Yi-Teh,0,4,28,28
1683347480930,MMW 15,B05,193523,Chang; Edmond Yi-Teh,0,5,28,28
1683347480930,MMW 15,B06,193524,Chang; Edmond Yi-Teh,0,4,28,28
1683347481953,MMW 122,A01,193526,Rahimi; Babak,0,15,28,28
1683347481953,MMW 122,A02,193527,Rahimi; Babak,0,14,28,28
1683347481953,MMW 122,A03,193528,Rahimi; Babak,0,0,0,0
1683347481953,MMW 122,A04,193529,Rahimi; Babak,0,0,0,0
1683347482978,MUS 1A,A01,186663,Staff,0,20,35,35
1683347484003,MUS 4,A01,186715,Staff,0,12,35,35
1683347485028,MUS 5R,A01,186796,Dubnov; Shlomo,0,17,35,35
1683347486053,MUS 6,A01,186798,Staff,0,4,25,25
1683347487081,MUS 7,A01,186830,Staff,13,0,35,22
1683347488106,MUS 8,A01,186930,Staff,0,26,35,35
1683347489132,MUS 15,A01,186932,Staff,0,16,35,35
1683347489132,MUS 15,B01,186934,Staff,0,15,35,35
1683347490162,MUS 80,A00,186935,Staff,1,0,20,19
1683347490162,MUS 80,B00,186936,Staff,25,0,25,0
1683347491189,NANO 11,A00,204702,Lipomi; Darren John,0,0,0,0
1683347492214,NANO 15,A01,204709,Yang; Kesong,0,1,0,0
1683347493242,NANO 114,A00,202069,Jahed Motlagh; Zeinab,3,0,10,7
1683347494266,PHIL 1,A00,186955,Grush; Rick Scott,32,0,40,8
1683347495294,PHIL 10,A01,186973,Grush; Rick Scott,28,0,35,7
1683347495294,PHIL 10,A02,186974,Grush; Rick Scott,33,0,35,2
1683347496322,PHIL 13,A01,186976,Staff,7,0,35,28
1683347496322,PHIL 13,A02,186977,Staff,16,0,35,19
1683347497349,PHIL 14,A01,186979,Staff,31,0,35,4
1683347497349,PHIL 14,A02,186986,Staff,32,0,35,3
1683347498373,PHIL 28,A01,186988,Staff,16,0,30,14
1683347498373,PHIL 28,A02,186989,Staff,1,0,30,29
1683347498373,PHIL 28,A03,186990,Staff,9,0,30,21
1683347498373,PHIL 28,A04,186991,Staff,26,0,30,4
1683347499401,PHIL 120,A00,186997,Staff,23,0,40,17
1683347500428,PHIL 137,A00,187003,Staff,9,0,40,31
1683347501454,PHIL 150,A00,187015,Staff,47,0,70,23
1683347502482,PHIL 167,A00,187021,Lamey; Andy M.,35,0,40,5
1683347503509,PHIL 174,A01,202226,Staff,17,0,20,3
1683347503509,PHIL 174,A02,202235,Staff,20,0,20,0
1683347504535,PHIL 191A,A00,258918,Staff,0,0,1,1
1683347505561,PHYS 1A,A00,187028,Staff,27,0,60,33
1683347506587,PHYS 1AL,001,187036,Staff,2,0,30,28
1683347506587,PHYS 1AL,002,187049,Staff,18,0,30,12
1683347507614,PHYS 1B,A00,187058,Staff,22,0,60,38
1683347508642,PHYS 1BL,001,187064,Staff,0,0,30,30
1683347508642,PHYS 1BL,002,187070,Staff,5,0,30,25
1683347509670,PHYS 1C,A00,187082,Staff,31,0,120,89
1683347510698,PHYS 1CL,001,187088,Staff,0,9,30,30
1683347510698,PHYS 1CL,002,187089,Staff,0,2,30,30
1683347510698,PHYS 1CL,009,262693,Staff,11,0,30,19
1683347511724,PHYS 2B,A01,187097,Staff,54,0,115,61
1683347512750,PHYS 2C,A01,187099,Staff,67,0,115,48
1683347513775,PHYS 2CL,A01,187101,Staff,5,0,28,23
1683347513775,PHYS 2CL,A02,187102,Staff,15,0,28,13
1683347514801,PHYS 2D,A01,187123,Shotwell; Brian,95,0,115,20
1683347515825,PHYS 4B,A01,187133,Grinstein; Benjamin,35,0,50,15
1683347516850,POLI 10,A00,188819,Staff,0,4,50,50
1683347517877,POLI 11,A00,188827,Staff,43,0,50,7
1683347518905,POLI 13R,A00,188828,Staff,0,1,20,20
1683347519934,POLI 27,A01,188830,Elgin; Samuel Zincke,0,1,70,70
1683347520962,POLI 30,A00,188832,Desposato; Scott,31,0,50,19
1683347521988,POLI 102F,A00,188834,Staff,3,0,40,37
1683347523012,POLI 104A,A00,188852,Staff,14,0,30,16
1683347524035,POLI 104I,A00,188853,Staff,0,6,20,20
1683347525060,POLI 110B,A00,188854,Wiens; David,7,0,20,13
1683347526084,POLI 112A,A00,188855,Wiens; David,5,0,30,25
1683347527112,POLI 117R,A00,188856,Forman; Fonna,0,11,20,20
1683347528142,POLI 118,A00,188857,Ingham; Sean,8,0,20,12
1683347529169,POLI 120G,A00,188858,Staff,9,0,30,21
1683347530193,POLI 131CR,A00,188863,Hoston; Germaine,24,0,50,26
1683347531221,POLI 133,A00,188864,Nellis; Gareth Hb,44,0,50,6
1683347532245,POLI 134D,A00,188865,Desposato; Scott,27,0,30,3
1683347533269,POLI 142A,A00,188871,Gartzke; Erik,22,0,50,28
1683347534293,POLI 142K,A00,188874,Staff,38,0,50,12
1683347535318,POLI 143,A00,188940,Gartzke; Erik,16,0,30,14
1683347536347,POLI 153,A00,188943,Staff,3,0,20,17
1683347537374,POLI 160AA,A00,188944,Staff,11,0,40,29
1683347538401,POLI 170A,A00,188945,Staff,11,0,30,19
1683347540453,PSYC 1,A00,188952,Staff,37,0,90,53
1683347541478,PSYC 2,B00,188953,Staff,19,0,35,16
1683347542505,PSYC 6,A00,188970,Staff,47,0,60,13
1683347543531,PSYC 7,A00,188973,Staff,37,0,45,8
1683347544560,PSYC 60,A01,188980,Rickard; Timothy C.,43,0,60,17
1683347545586,PSYC 70,A01,189001,Steiner; Eric Tomas,23,0,45,22
1683347546614,PSYC 100,A00,189005,Lacefield; Katharine I,0,98,120,120
1683347547641,PSYC 102,A00,189008,Staff,9,0,30,21
1683347548666,PSYC 106,B00,189026,Gorman; Michael R.,34,0,60,26
1683347549692,PSYC 114,B01,189033,Winkielman; Piotr,0,32,30,30
1683347550720,PSYC 131,A00,189036,Anagnostaras; Stephan,0,43,60,60
1683347551744,PSYC 136,A00,189041,Lowe; Angela Beth,0,7,25,25
1683347552767,PSYC 137,A00,189057,Winkielman; Piotr,0,34,25,25
1683347553795,PSYC 144,A00,189107,Wixted; John T,0,7,50,50
1683347555850,PSYC 162,A00,189142,Staff,0,8,85,85
1683347556878,PSYC 172,A00,189144,Gorman; Michael R.,0,7,30,30
1683347558930,PSYC 179,A00,189146,Lacefield; Katharine I,0,84,120,120
1683347559957,PSYC 181,A00,189147,Anagnostaras; Stephan,0,44,90,90
1683347560982,PSYC 190R,A00,189148,Barner; David A.,0,22,80,80
1683347562012,PSYC 191,A00,189275,Rickard; Timothy C.,0,7,25,25
1683347563041,PSYC 193,A00,189276,Chapman; Eddie Nathaniel,0,1,0,4
1683347564070,PSYC 193L,A01,189281,Lowe; Angela Beth,12,0,20,8
1683347564070,PSYC 193L,B01,189285,Staff,28,0,35,7
1683347565097,RELI 149,A00,187137,Rahimi; Babak,7,0,40,33
1683347566121,SE 9,A01,187315,Staff,0,2,18,18
1683347567148,SE 101B,A00,187409,Staff,24,0,30,6
1683347568172,SE 110B,A00,187444,Staff,10,0,40,30
1683347569197,SE 130B,A00,187449,Staff,31,0,40,9
1683347570222,SE 150A,A00,187516,Staff,9,0,20,11
1683347571247,SE 154,A00,187528,Staff,30,0,50,20
1683347572276,SIO 3,A01,258171,Staff,35,0,40,5
1683347573301,SIO 10,A00,187144,Cook; Geoffrey W,0,3,75,75
1683347574326,SIO 45,A00,187152,Cook; Geoffrey W,1,0,100,99
1683347575353,SIO 109R,A00,194486,Staff,0,3,20,20
1683347577460,SIO 187,A01,187233,Kacev; David,12,0,40,28
1683347578488,SOCI 1,A01,258656,Thorpe; Charles Robert,28,0,30,2
1683347578488,SOCI 1,A02,258658,Thorpe; Charles Robert,30,0,30,0
1683347578488,SOCI 1,A03,258661,Thorpe; Charles Robert,25,0,25,0
1683347578488,SOCI 1,A04,258666,Thorpe; Charles Robert,22,0,25,3
1683347578488,SOCI 1,A05,258897,Thorpe; Charles Robert,23,0,25,2
1683347578488,SOCI 1,A06,258898,Thorpe; Charles Robert,25,0,25,0
1683347579511,SOCI 30,A01,258903,Pardo Guerra; Juan Pablo,15,0,30,15
1683347580535,SOCI 102,A00,258904,Staff,9,0,25,16
1683347581566,SOCI 106,A00,258905,Staff,19,0,25,6
1683347582594,SOCI 111,A00,258907,Ribas Norris; Janet Vanesa,26,0,30,4
1683347583621,SOCI 121R,A00,258908,Pardo Guerra; Juan Pablo,10,0,30,20
1683347584646,SOCI 126,A01,203330,Staff,14,0,20,6
1683347585674,SOCI 131,A00,258909,Thorpe; Charles Robert,31,0,60,29
1683347586699,SOCI 135,A00,258910,Payne; Christine Anna,0,9,30,30
1683347587724,SOCI 157,A00,258911,Staff,12,0,30,18
1683347588749,SOCI 184,A00,258912,Staff,25,0,30,5
1683347589774,SOCI 188D,A00,258913,Staff,21,0,30,9
1683347590799,SYN 2,001,187529,Staff,10,0,16,6
1683347590799,SYN 2,002,201452,Staff,0,18,16,16
1683347590799,SYN 2,003,201469,Staff,3,0,16,13
1683347591827,SYN 100,A01,187531,Staff,0,9,20,20
1683347591827,SYN 100,B01,201491,Staff,0,12,20,20
1683347592850,TDAC 1,A00,189286,Walsh; Kim C.,3,0,20,17
1683347592850,TDAC 1,B00,189287,Harting; Carla Kelso,11,0,20,9
1683347593874,TDAC 101,A00,189300,Walsh; Kim C.,16,0,20,4
1683347593874,TDAC 101,B00,189301,Harting; Carla Kelso,18,0,20,2
1683347594899,TDAC 102,A00,189304,Basso; Beatrice,14,0,20,6
1683347595925,TDAC 108,A00,189305,Staff,18,0,20,2
1683347596950,TDDE 131,A00,189310,Staff,19,0,20,1
1683347596950,TDDE 131,B00,189314,Staff,19,0,20,1
1683347596950,TDDE 131,C00,189315,Staff,48,0,50,2
1683347596950,TDDE 131,D00,189316,Staff,14,0,15,1
1683347596950,TDDE 131,E00,204841,Staff,20,0,20,0
1683347597978,TDGE 10,A00,189289,Staff,30,0,50,20
1683347597978,TDGE 10,B00,189290,Havis; Allan,1,0,50,49
1683347599008,TDGE 11,A00,189291,Fulton; Julia,0,3,50,50
1683347599008,TDGE 11,B00,189292,Staff,20,0,25,5
1683347599008,TDGE 11,C00,260270,Staff,0,0,0,0
1683347600036,TDGE 25,A00,189294,Staff,3,0,20,17
1683347601062,TDGE 124,A00,189318,Fulton; Julia,0,8,50,50
1683347602087,TDGE 125,A00,189319,Staff,13,0,25,12
1683347602087,TDGE 125,B00,189320,Staff,23,0,25,2
1683347603112,TDGE 127,A00,189322,Havis; Allan,0,0,50,50
1683347604138,TDHT 101,A00,189323,Staff,18,0,25,7
1683347604138,TDHT 101,B00,189324,Staff,25,0,25,0
1683347605166,TDHT 102,A00,189325,Staff,49,0,50,1
1683347606193,TDMV 1,A00,189295,Arcidiacono; Kristin,19,0,30,11
1683347606193,TDMV 1,B00,189296,Caligagan; Maria T.,24,0,30,6
1683347607221,TDMV 2,A00,189297,Sammartano; Tonnie,28,0,30,2
1683347607221,TDMV 2,B00,189299,Arcidiacono; Kristin,24,0,30,6
1683347608246,TDMV 3,A00,204998,Rincon; Alicia,22,0,30,8
1683347609270,TDMV 120,A00,189458,Sammartano; Tonnie,28,0,30,2
1683347610298,TDMV 138,A00,189541,Jun; Grace Shin Hae,22,0,40,18
1683347611327,TDMV 142,A00,189717,Caligagan; Tony,23,0,30,7
1683347611327,TDMV 142,B00,189718,Caligagan; Maria T.,25,0,30,5
1683347612352,TMC 2,A01,187533,Staff,25,0,25,0
1683347612352,TMC 2,A02,187534,Staff,25,0,25,0
1683347613380,USP 1,A01,187536,Kwak; Nancy,0,16,25,25
1683347614405,USP 5,A01,187538,Staff,10,0,25,15
1683347615428,USP 101,A00,199253,Staff,0,4,0,0
1683347616455,USP 124,A00,187562,Boomhower; Matthew Charles,1,0,30,29
1683347617482,USP 138,A00,187582,Staff,20,0,25,5
1683347618507,USP 152,A01,187597,Staff,4,0,25,21
1683347619531,USP 153,A00,187598,Staff,19,0,25,6
1683347620559,USP 168,A00,187607,Kwak; Nancy,2,0,5,3
1683347621586,USP 173,A00,187619,Staff,4,0,25,21
1683347622611,USP 181,A00,187638,Staff,0,1,25,25
1683347623633,VIS 103,A00,187650,Cruz; Edwin Teddy,23,0,75,52
1683347624657,VIS 110D,A00,187669,Staff,12,0,22,10
1683347625685,VIS 127C,A00,187720,Shen; Kuiyi,67,0,146,79
1683347626709,VIS 149,A00,187731,Yoldas; Pinar,0,14,22,22
1683347627733,VIS 151,A01,188091,Staff,22,0,34,12
1683347627733,VIS 151,A02,188092,Staff,11,0,34,23
1683347628757,VIS 160B,A00,188093,Stalbaum; Brett,0,0,10,10
1683347630813,WCWP 10B,A00,201720,Staff,10,0,15,5
1683347630813,WCWP 10B,B00,201722,Staff,9,0,15,6
1683347631840,WCWP 100,A00,201725,Gagnon; Jeffrey C,0,0,2,2
1683347631840,WCWP 100,B00,201727,Staff,0,4,15,15
1683347634930,ANBI 133,A00,258401,Wilder; Linnea Lorene,34,0,40,6
1683347635955,ANBI 140,A00,258395,Hrvoj Mihic; Branka,18,0,25,7
1683347636979,ANSC 120,A00,258402,Bialecki; Jon Anthony,27,0,40,13
1683347638003,ANSC 144,A00,258400,Staff,14,0,40,26
1683347640050,ANSC 166,A00,258396,Parish; Steven Martin,157,0,175,18
1683347641082,ANSC 180,A00,193533,Staff,9,0,20,11
1683347642110,ANSC 188,A00,258397,Jassal; Aftab,33,0,40,7
1683347643138,ANTH 3,A01,258316,Staff,23,0,30,7
1683347644169,ANTH 5,A00,258394,Semendeferi; Ekaterini,16,0,20,4
1683347645194,ANTH 21,A01,258331,Staff,8,0,40,32
1683347646218,ANTH 103,A00,258398,Varma; Saiba,15,0,25,10
1683347647245,AWP 10,001,202034,Staff,0,0,0,0
1683347647245,AWP 10,002,202035,Staff,0,0,0,0
1683347647245,AWP 10,003,202036,Staff,0,0,0,0
1683347647245,AWP 10,004,202037,Staff,0,0,0,0
1683347647245,AWP 10,005,202038,Staff,0,0,0,0
1683347647245,AWP 10,006,202039,Staff,0,0,0,0
1683347647245,AWP 10,007,202040,Staff,0,0,0,0
1683347647245,AWP 10,008,202041,Staff,0,0,0,0
1683347647245,AWP 10,009,202042,Staff,0,0,0,0
1683347647245,AWP 10,010,202043,Staff,0,0,0,0
1683347647245,AWP 10,011,202044,Staff,0,0,0,0
1683347647245,AWP 10,012,202045,Staff,0,0,0,0
1683347647245,AWP 10,013,202046,Staff,0,0,0,0
1683347647245,AWP 10,014,202047,Staff,0,0,0,0
1683347647245,AWP 10,015,202048,Staff,0,0,0,0
1683347647245,AWP 10,016,202049,Staff,0,0,0,0
1683347647245,AWP 10,017,202050,Staff,0,0,0,0
1683347647245,AWP 10,018,202051,Staff,0,0,0,0
1683347647245,AWP 10,019,202052,Staff,0,0,0,0
1683347647245,AWP 10,020,202053,Staff,0,0,0,0
1683347647245,AWP 10,021,202054,Staff,0,0,0,0
1683347647245,AWP 10,022,202055,Staff,0,0,0,0
1683347647245,AWP 10,023,202056,Staff,0,0,0,0
1683347647245,AWP 10,024,202057,Staff,0,0,0,0
1683347647245,AWP 10,025,202058,Staff,0,0,0,0
1683347647245,AWP 10,026,202059,Staff,0,0,0,0
1683347648273,AWP 102,001,202032,Staff,0,0,0,0
1683347648273,AWP 102,002,202033,Staff,0,0,0,0
1683347649303,BENG 100,A01,254234,Taylor Amos; Alyssa C,31,0,40,9
1683347650328,BENG 196,001,270013,Engler; Adam J.,9999,0,9999,0
1683347651354,BICD 100R,A01,202018,Smith; Laurie,0,7,32,32
1683347651354,BICD 100R,A02,202019,Smith; Laurie,0,2,32,32
1683347651354,BICD 100R,A03,202020,Smith; Laurie,0,1,32,32
1683347651354,BICD 100R,A04,202021,Smith; Laurie,9,0,32,23
1683347651354,BICD 100R,A05,202022,Smith; Laurie,12,0,32,20
1683347652381,BICD 136,A01,193242,Gustafson-Brown; Cindy,0,2,32,32
1683347652381,BICD 136,A02,193244,Gustafson-Brown; Cindy,14,0,32,18
1683347653409,BIEB 102,A01,193249,Butler; Shannon Rhey,0,2,32,32
1683347653409,BIEB 102,A02,193251,Butler; Shannon Rhey,0,0,32,32
1683347653409,BIEB 102,A03,193253,Butler; Shannon Rhey,0,1,32,32
1683347653409,BIEB 102,A04,193255,Butler; Shannon Rhey,17,0,32,15
1683347653409,BIEB 102,A05,193265,Butler; Shannon Rhey,26,0,32,6
1683347653409,BIEB 102,A06,193269,Butler; Shannon Rhey,16,0,32,16
1683347655461,BIEB 150,A01,193274,Staff,0,0,32,32
1683347655461,BIEB 150,A02,193285,Staff,23,0,32,9
1683347656488,BIEB 194,A00,193286,Kurle; Carolyn M.,22,0,32,10
1683347657513,BILD 1,A01,192291,Staff,16,0,32,16
1683347657513,BILD 1,A02,192292,Staff,30,0,32,2
1683347657513,BILD 1,B01,192520,Reuther; Keefe,0,1,0,0
1683347657513,BILD 1,B02,192532,Reuther; Keefe,0,1,0,0
1683347658543,BILD 3,A01,192556,Butler; Shannon Rhey,0,0,32,32
1683347658543,BILD 3,A02,192581,Butler; Shannon Rhey,5,0,32,27
1683347658543,BILD 3,A03,192611,Butler; Shannon Rhey,23,0,32,9
1683347658543,BILD 3,A04,192612,Butler; Shannon Rhey,25,0,32,7
1683347658543,BILD 3,A05,192613,Butler; Shannon Rhey,27,0,32,5
1683347658543,BILD 3,A06,192679,Butler; Shannon Rhey,27,0,32,5
1683347658543,BILD 3,A07,192682,Butler; Shannon Rhey,22,0,32,10
1683347659573,BILD 4,A01,192836,Reuther; Keefe,0,0,24,24
1683347659573,BILD 4,A02,193044,Reuther; Keefe,4,0,24,20
1683347660598,BILD 10,A01,193142,Gustafson-Brown; Cindy,30,0,32,2
1683347660598,BILD 10,A02,193149,Gustafson-Brown; Cindy,31,0,32,1
1683347661626,BIMM 100,A01,193301,Staff,0,6,32,32
1683347661626,BIMM 100,A02,193312,Staff,0,5,32,32
1683347661626,BIMM 100,A03,193323,Staff,0,8,32,32
1683347662655,BIMM 101,A01,193329,McDonnell; Lisa Marie,0,3,24,24
1683347662655,BIMM 101,A02,193339,McDonnell; Lisa Marie,0,3,24,24
1683347662655,BIMM 101,B01,193354,McDonnell; Lisa Marie,0,3,24,24
1683347662655,BIMM 101,B02,193357,McDonnell; Lisa Marie,0,3,24,24
1683347663678,BIMM 110,A01,193377,Tat; John,0,11,32,32
1683347663678,BIMM 110,A02,193378,Tat; John,1,9,32,31
1683347664703,BIMM 120,A01,206116,Staff,0,0,32,32
1683347664703,BIMM 120,A02,206117,Staff,8,0,32,24
1683347664703,BIMM 120,A03,206121,Staff,21,0,32,11
1683347665727,BIPN 100,A01,193393,Park; Ji Young,0,14,32,32
1683347665727,BIPN 100,A02,193402,Park; Ji Young,0,13,32,32
1683347665727,BIPN 100,A03,193413,Park; Ji Young,0,14,32,32
1683347665727,BIPN 100,A04,193414,Park; Ji Young,0,13,32,32
1683347666754,BIPN 102,A01,193429,Staff,0,0,32,32
1683347666754,BIPN 102,A02,193438,Staff,22,0,32,10
1683347667780,BIPN 106,A01,193450,Reyes Gonzalez; Catalina,0,2,40,40
1683347668805,BIPN 134,A01,193465,Cooke; James Edward,0,0,32,32
1683347668805,BIPN 134,A02,193474,Cooke; James Edward,25,0,32,7
1683347668805,BIPN 134,A03,193485,Cooke; James Edward,29,0,32,3
1683347668805,BIPN 134,A04,193486,Cooke; James Edward,21,0,32,11
1683347668805,BIPN 134,A05,193491,Cooke; James Edward,31,0,32,1
1683347668805,BIPN 134,A06,193501,Cooke; James Edward,30,0,32,2
1683347668805,BIPN 134,A07,193510,Cooke; James Edward,29,0,32,3
1683347670859,BISP 194,A00,222522,Staff,14,0,32,18
1683347671883,CAT 124,A01,202407,Staff,20,0,25,5
1683347672911,CAT 125,A00,202408,Marchisotto; Jennifer Anne,4,0,20,16
1683347673940,CAT 125R,A00,202409,Smith; Lauryn Alissa,0,11,20,20
1683347673940,CAT 125R,B00,202410,Morales; Celeste Georgianna,0,11,20,20
1683347673940,CAT 125R,C00,202411,Irwin; Matthew Joseph,0,10,20,20
1683347674964,CENG 15,A01,204712,Yang; Kesong,0,1,0,0
1683347675991,CENG 114,A00,202070,Jahed Motlagh; Zeinab,5,0,20,15
1683347677019,CGS 105,A00,185477,Wesling; Megan E.,24,0,40,16
1683347678046,CGS 106,A00,185494,Staff,13,0,22,9
1683347679070,CGS 108,A00,185495,Staff,14,0,20,6
1683347680094,CGS 114,A00,185496,Staff,13,0,18,5
1683347681174,CGS 119,A00,185501,Staff,15,0,20,5
1683347682201,CGS 120,A00,185511,Staff,13,0,20,7
1683347683224,CHEM 4,A01,184675,Bussey; Thomas J,96,0,100,4
1683347684252,CHEM 6A,A01,184677,Staff,34,0,60,26
1683347685277,CHEM 6B,A01,184679,Staff,65,0,100,35
1683347686305,CHEM 6C,A01,184681,Bussey; Thomas J,1,0,50,49
1683347686305,CHEM 6C,A02,184682,Bussey; Thomas J,34,0,50,16
1683347687333,CHEM 40A,A01,184684,Albizati; Kim F.,37,0,100,63
1683347688357,CHEM 40B,A01,184686,Albizati; Kim F.,0,20,100,100
1683347689380,CHEM 41B,A01,184690,Staff,52,0,100,48
1683347690403,COGS 3,A01,184715,Boyle; Mary E. T.,0,25,40,40
1683347691427,COGS 14B,A01,185172,Staff,0,15,38,38
1683347692455,COGS 18,A01,184736,Staff,17,0,80,63
1683347693479,COGS 100,A01,184932,Staff,0,5,73,73
1683347694507,COGS 101A,A01,184935,Staff,0,39,30,30
1683347695536,COGS 101B,A01,184944,Staff,0,2,30,30
1683347696564,COGS 101C,A01,184946,Staff,0,12,30,30
1683347697589,COGS 102A,A01,184951,Johnson; Christine M.,2,0,40,38
1683347698614,COGS 107B,A01,184953,Mooshagian; Eric Frederick,0,50,40,40
1683347699642,COGS 118B,A01,184959,Gupta; Anjum,0,48,40,40
1683347700666,COGS 153,A00,184961,Staff,0,15,30,30
1683347701691,COGS 177,A00,184962,Staff,0,20,30,30
1683347702717,COGS 187A,A01,184969,Boyle; Mary E. T.,0,17,40,40
1683347703744,COMM 10,A01,185174,Staff,0,5,25,25
1683347703744,COMM 10,A02,185189,Staff,0,5,25,25
1683347703744,COMM 10,A03,269821,Staff,0,0,0,0
1683347704772,COMM 100B,A01,185475,Staff,0,0,0,2
1683347704772,COMM 100B,A02,185476,Staff,13,0,25,12
1683347705795,COMM 100C,A01,185314,Staff,1,0,25,24
1683347705795,COMM 100C,A02,185327,Staff,19,0,25,6
1683347706819,COMM 110M,A00,185349,Staff,2,0,40,38
1683347707847,COMM 113T,A00,185352,Staff,24,0,40,16
1683347708871,COMM 114I,A00,185353,Staff,33,0,40,7
1683347709900,COMM 131,A00,185354,Staff,19,0,30,11
1683347710927,CSE 8A,A50,185358,Cao; Yingjun,0,46,10,10
1683347711956,CSE 8B,A01,185362,Staff,1,47,50,49
1683347712980,CSE 11,A01,185416,Cao; Yingjun,0,92,10,10
1683347714007,CSE 20,A01,185445,Briones; Jor-el Thomas Caparas,5,0,25,20
1683347715035,CSE 21,A01,185447,Staff,10,0,50,40
1683347716062,CSE 101,A01,185451,Staff,0,13,50,50
1683347716062,CSE 101,B01,185453,Jones; Miles E,0,11,50,50
1683347718110,CSE 141,A01,185458,Eldon; John,20,0,100,80
1683347719134,CSE 141L,A01,185461,Eldon; John,12,0,100,88
1683347720162,CSE 142,A01,185463,Staff,36,0,60,24
1683347720162,CSE 142,B01,201355,Staff,0,7,60,60
1683347721189,CSE 142L,A01,185470,Staff,36,0,60,24
1683347721189,CSE 142L,B01,201417,Staff,0,6,60,60
1683347722215,CSE 190,A00,201433,Staff,32,0,49,17
1683347723239,DOC 1,A01,259136,Strom; Megan C.,7,0,15,8
1683347723239,DOC 1,A02,259137,Strom; Megan C.,14,0,15,1
1683347723239,DOC 1,A03,259138,Strom; Megan C.,14,0,15,1
1683347723239,DOC 1,A04,259139,Strom; Megan C.,14,0,15,1
1683347724266,DOC 100D,A00,259140,Pass; Natalye Joann,16,0,25,9
1683347725291,DSGN 1,A01,184749,Rill; Bryan,0,25,30,30
1683347726315,DSGN 100,A01,185168,Staff,0,2,25,25
1683347727342,ECE 5,A01,185626,Morris; Karcher William,0,10,0,0
1683347728368,ECE 101,A01,185628,Staff,17,0,70,53
1683347729396,ECE 107,A01,185635,Baghdadchi; Saharnaz,0,0,20,20
1683347729396,ECE 107,A02,185638,Baghdadchi; Saharnaz,4,0,20,16
1683347730423,ECE 148,A01,185647,Silberman; Jack,0,0,16,16
1683347731450,ECON 1,A01,185537,Crane; Meredith Helen,54,0,70,16
1683347732474,ECON 3,A01,185549,Crane; Meredith Helen,32,0,70,38
1683347733498,ECON 4,A01,203354,Anderson; John Charles,0,4,10,10
1683347734525,ECON 100A,A01,185574,Staff,0,4,40,40
1683347735549,ECON 100B,A01,185576,Staff,10,22,50,40
1683347736573,ECON 100C,A01,185589,Newhouse; Herbert S,29,0,70,41
1683347737600,ECON 105,A00,185608,Vespa; Emanuel Ignacio,19,0,35,16
1683347738627,ECON 109,A01,185610,Shishkin; Denis,10,0,35,25
1683347739653,ECON 110A,A01,185612,Staff,11,0,40,29
1683347740677,ECON 120A,A01,185615,Staff,20,0,40,20
1683347741700,ECON 120C,A01,185617,Sun; Yixiao,0,21,70,70
1683347742725,ECON 144,A00,203346,Squires; Dale E,3,0,35,32
1683347743752,ECON 171,A01,203349,Newhouse; Herbert S,0,1,35,35
1683347744777,ECON 173A,A01,185621,Toda; Alexis Akira,21,0,35,14
1683347745802,EDS 25,A01,202413,Staff,0,1,0,0
1683347745802,EDS 25,A02,202414,Staff,0,1,0,0
1683347745802,EDS 25,A03,202415,Staff,0,0,0,0
1683347745802,EDS 25,A04,202416,Staff,0,1,0,0
1683347745802,EDS 25,A05,202439,Staff,0,0,0,0
1683347745802,EDS 25,A06,202440,Staff,0,0,0,0
1683347745802,EDS 25,B01,202631,Staff,0,0,0,0
1683347745802,EDS 25,B02,202632,Staff,0,0,0,0
1683347745802,EDS 25,B03,202639,Staff,0,0,0,0
1683347745802,EDS 25,B04,202640,Staff,0,0,0,0
1683347745802,EDS 25,B05,202643,Staff,0,0,0,0
1683347745802,EDS 25,B06,202644,Staff,0,0,0,0
1683347746829,EDS 38,A01,202659,Black; Alison Michelle,24,0,25,1
1683347747853,EDS 115,A00,202652,Staff,18,0,30,12
1683347748881,EDS 125,A00,202649,Staff,14,0,30,16
1683347749910,EDS 126,A01,203332,Staff,30,0,30,0
1683347750934,EDS 139,A00,202838,Staff,16,0,25,9
1683347751962,EDS 146,A01,202655,Staff,14,0,25,11
1683347752990,ENG 15,A00,185667,Staff,0,1,0,0
1683347752990,ENG 15,B00,185672,Staff,0,0,0,0
1683347752990,ENG 15,C00,185675,Staff,0,0,0,0
1683347752990,ENG 15,D00,185682,Staff,0,0,0,0
1683347752990,ENG 15,E00,185684,Staff,0,0,0,0
1683347754013,ETHN 103,A00,185710,Staff,0,4,35,35
1683347755035,ETHN 103A,A00,199228,Man; Simeon S,2,0,9,7
1683347756059,ETHN 109,A00,185711,Staff,18,0,35,17
1683347757086,ETHN 142,A00,185726,Staff,0,4,30,30
1683347758110,ETHN 163J,A00,199229,Man; Simeon S,5,0,8,3
1683347759135,ETHN 168,A00,185727,Staff,8,0,10,2
1683347760160,ETHN 182,A00,185728,Staff,1,0,35,34
1683347761184,ETHN 183,A00,185737,Staff,8,0,18,10
1683347762209,GLBH 111,A01,209361,Burgos; Jose L.,0,0,0,0
1683347764261,HIEU 104,A00,185792,Staff,16,0,20,4
1683347765288,HIEU 115,A00,185800,Staff,1,0,20,19
1683347766318,HIEU 128,A00,185801,Staff,0,7,20,20
1683347767344,HIEU 147,A00,185802,Staff,16,0,20,4
1683347768368,HIEU 154,A00,185823,Staff,12,0,20,8
1683347769393,HILA 102,A00,185826,Staff,13,0,20,7
1683347770420,HILD 2C,A01,185778,Staff,0,12,20,20
1683347771448,HILD 7B,A01,185780,Kwak; Nancy,0,15,32,32
1683347771448,HILD 7B,A02,185781,Kwak; Nancy,0,18,32,32
1683347772475,HILD 30,A01,185791,Staff,14,0,20,6
1683347773499,HISC 119,A00,185830,Golan; Tal,0,9,20,20
1683347774523,HITO 156GS,A00,185831,Patterson; Patrick H.,0,0,0,23
1683347775548,HIUS 103,A00,185832,Man; Simeon S,0,6,20,20
1683347776572,HIUS 117,A00,185836,Kwak; Nancy,2,0,20,18
1683347777597,HIUS 125,A00,185840,Man; Simeon S,0,0,23,23
1683347778622,HIUS 149,A00,185845,Staff,0,0,20,20
1683347779651,HUM 3,A01,185882,Zavodny; Tatiana Sophia,0,7,50,50
1683347779651,HUM 3,B01,185899,Caldwell; Michael Alan,0,18,50,50
1683347780674,HUM 3GS,A00,185900,Patterson; Patrick H.,0,0,0,23
1683347781699,HUM 4,A01,185938,Zroka; Amy Liane,31,0,50,19
1683347781699,HUM 4,B01,185956,Watkins; Eric,0,2,50,50
1683347781699,HUM 4,B02,202209,Watkins; Eric,0,2,50,50
1683347781699,HUM 4,B03,202210,Watkins; Eric,0,2,50,50
1683347782724,HUM 5,A01,185958,West; Geoffrey Scott,3,0,50,47
1683347782724,HUM 5,A02,202215,West; Geoffrey Scott,0,0,50,50
1683347783749,INTL 190,A00,185959,Gagnon; Jeffrey C,0,0,0,9
1683347783749,INTL 190,B00,185960,Lettieri; Michael Joseph,0,0,0,1
1683347784846,JAPN 180,A00,254509,Staff,5,1,30,25
1683347785875,LATI 10,A01,202853,Kennemore; Amy Michelle,4,0,35,31
1683347785875,LATI 10,A02,202854,Kennemore; Amy Michelle,2,0,35,33
1683347785875,LATI 10,A03,270054,Kennemore; Amy Michelle,30,0,30,0
1683347786902,LATI 180,A00,202855,Kennemore; Amy Michelle,11,0,20,9
1683347787930,LAWS 101,A00,201767,Golan; Tal,0,7,40,40
1683347788954,LIFR 1C,A00,185961,Staff,6,0,20,14
1683347789978,LIFR 1CX,A00,185962,Staff,7,0,20,13
1683347791002,LIFR 1D,A00,185963,Staff,9,0,20,11
1683347792028,LIFR 1DX,A00,185964,Staff,9,0,20,11
1683347793052,LIGN 101,A01,186039,Staff,43,0,50,7
1683347794078,LIGN 165,A00,186040,Staff,18,0,50,32
1683347795102,LTCS 108,A00,186041,Staff,6,0,10,4
1683347796128,LTCS 119,A00,186042,Staff,16,0,20,4
1683347797151,LTCS 130,A00,186043,Wesling; Megan E.,15,0,25,10
1683347799203,LTEA 138,A00,186119,Staff,14,0,40,26
1683347800226,LTEN 124,A00,186148,Staff,6,0,25,19
1683347801254,LTEN 178,A00,186149,Staff,7,0,15,8
1683347802278,LTEN 181,A00,186150,Blanco; John D,33,0,40,7
1683347803302,LTWL 120,A00,186160,Staff,20,0,25,5
1683347804326,LTWL 165,A00,186161,Staff,22,0,25,3
1683347805351,LTWR 100,A00,186162,Staff,0,5,15,15
1683347806380,LTWR 102,A00,186163,Doller; Ben,5,0,15,10
1683347807405,MAE 8,A01,186412,Staff,0,0,0,0
1683347808431,MAE 30B,A00,186445,Bahadori; Mohammad Yousef,83,0,100,17
1683347809456,MAE 40,A00,186592,Bewley; Thomas R,9,0,50,41
1683347810481,MAE 101B,A00,186593,Bahadori; Mohammad Yousef,81,0,100,19
1683347811505,MAE 105,A00,186594,Bandaru; Prabhakar,12,0,50,38
1683347812530,MAE 107,A00,186599,Pham; Hieu Tan,0,6,120,120
1683347813559,MAE 148,A01,186660,Silberman; Jack,3,0,16,13
1683347814584,MATH 10A,A01,188095,Staff,1,6,35,34
1683347815608,MATH 10B,A01,188097,Bowers; Adam R.,0,11,30,30
1683347815608,MATH 10B,A02,188099,Bowers; Adam R.,0,11,30,30
1683347815608,MATH 10B,B01,188104,Bowers; Adam R.,0,10,30,30
1683347815608,MATH 10B,B02,188106,Bowers; Adam R.,0,10,30,30
1683347816633,MATH 10C,A01,188111,Staff,0,18,30,30
1683347816633,MATH 10C,A02,188127,Staff,0,17,30,30
1683347816633,MATH 10C,A03,188131,Staff,0,18,30,30
1683347816633,MATH 10C,B01,188218,Staff,18,0,30,12
1683347816633,MATH 10C,B02,188244,Staff,13,0,30,17
1683347816633,MATH 10C,B03,188277,Staff,16,0,30,14
1683347817662,MATH 18,A01,188344,Bach; Quang Tran,18,0,30,12
1683347817662,MATH 18,A02,188345,Bach; Quang Tran,11,0,30,19
1683347817662,MATH 18,B01,188353,Bach; Quang Tran,10,0,30,20
1683347817662,MATH 18,B02,188354,Bach; Quang Tran,20,0,30,10
1683347818687,MATH 20A,A01,188374,Staff,13,0,35,22
1683347819713,MATH 20B,A01,188382,Ohm; Ko Woon,6,0,30,24
1683347819713,MATH 20B,A02,188383,Ohm; Ko Woon,22,0,30,8
1683347819713,MATH 20B,B01,188385,Ohm; Ko Woon,7,0,30,23
1683347819713,MATH 20B,B02,188392,Ohm; Ko Woon,22,0,30,8
1683347820737,MATH 20C,A01,188394,Harel; Guershon,10,0,30,20
1683347820737,MATH 20C,A02,188395,Harel; Guershon,15,0,30,15
1683347820737,MATH 20C,B01,188404,Harel; Guershon,5,0,30,25
1683347820737,MATH 20C,B02,188405,Harel; Guershon,19,0,30,11
1683347821763,MATH 20D,A01,188414,Hammock; Frances H,0,1,30,30
1683347821763,MATH 20D,A02,188415,Hammock; Frances H,3,0,30,27
1683347821763,MATH 20D,B01,188447,Hammock; Frances H,1,0,30,29
1683347821763,MATH 20D,B02,188486,Hammock; Frances H,8,0,30,22
1683347822792,MATH 20E,A01,188649,Staff,21,0,30,9
1683347822792,MATH 20E,A02,188650,Staff,23,0,30,7
1683347822792,MATH 20E,A03,188673,Staff,0,0,30,30
1683347823824,MATH 102,A01,188675,Staff,0,35,35,35
1683347824854,MATH 103B,A01,188681,Staff,3,0,35,32
1683347824854,MATH 103B,B01,188692,Staff,5,0,35,30
1683347825885,MATH 109,A01,188695,Salehi Golsefidy; Alireza,25,0,35,10
1683347825885,MATH 109,A02,188696,Salehi Golsefidy; Alireza,25,0,35,10
1683347826914,MATH 120A,A01,188698,Eggers; John Dietrich,7,0,35,28
1683347827942,MATH 142B,A01,188736,Ioana; Adrian,0,2,30,30
1683347827942,MATH 142B,A02,188741,Ioana; Adrian,1,1,30,29
1683347827942,MATH 142B,A03,188743,Ioana; Adrian,1,3,30,29
1683347828967,MATH 168A,A01,188790,Staff,0,9,35,35
1683347829991,MATH 170A,A01,188803,Nie; Jiawang,0,2,35,35
1683347829991,MATH 170A,A02,188811,Nie; Jiawang,0,0,35,35
1683347829991,MATH 170A,A03,188814,Nie; Jiawang,1,0,35,34
1683347829991,MATH 170A,A04,188815,Nie; Jiawang,13,0,35,22
1683347831015,MATH 193B,A01,188817,Staff,0,0,35,35
1683347831015,MATH 193B,A02,188818,Staff,5,0,35,30
1683347832040,MGT 4,A01,202857,Anderson; John Charles,62,0,80,18
1683347833068,MGT 12,A00,202858,Lindenberger; Wade Douglas,42,0,90,48
1683347834093,MGT 18,A00,202859,Staff,74,0,90,16
1683347835120,MGT 18GS,A00,202860,McKay; Michael J,13,0,28,15
1683347836148,MGT 45,A00,202861,Pecore; Joseph P.,14,0,90,76
1683347837172,MGT 100,A00,202863,Yavorsky; Daniel Ryan,28,0,90,62
1683347838199,MGT 103,A00,202864,Ehrich; Kristine R,1,18,90,89
1683347839225,MGT 112,A00,202865,Ehrich; Kristine R,15,0,90,75
1683347840252,MGT 121A,A00,202868,Staff,0,20,0,0
1683347841281,MGT 131B,A00,202869,Anderson; John Charles,59,0,90,31
1683347842308,MGT 136,A00,202871,Lindenberger; Wade Douglas,84,0,90,6
1683347843335,MGT 164,A00,202873,Staff,0,68,90,91
1683347844362,MGT 164GS,A00,202874,McKay; Mary A,13,0,28,15
1683347845386,MGT 180,A00,202875,Staff,0,50,90,91
1683347846410,MMW 11R,A01,205019,Herbst; Matthew,3,0,30,27
1683347846410,MMW 11R,A02,205026,Herbst; Matthew,29,0,30,1
1683347847435,MMW 15,A01,193512,Chang; Edmond Yi-Teh,0,9,28,28
1683347847435,MMW 15,A02,193513,Chang; Edmond Yi-Teh,0,5,28,28
1683347847435,MMW 15,A03,193514,Chang; Edmond Yi-Teh,0,5,28,28
1683347847435,MMW 15,A04,193515,Chang; Edmond Yi-Teh,0,5,28,28
1683347847435,MMW 15,A05,193516,Chang; Edmond Yi-Teh,0,4,28,28
1683347847435,MMW 15,A06,193517,Chang; Edmond Yi-Teh,0,5,28,28
1683347847435,MMW 15,B01,193519,Chang; Edmond Yi-Teh,0,5,28,28
1683347847435,MMW 15,B02,193520,Chang; Edmond Yi-Teh,0,5,28,28
1683347847435,MMW 15,B03,193521,Chang; Edmond Yi-Teh,0,5,28,28
1683347847435,MMW 15,B04,193522,Chang; Edmond Yi-Teh,0,4,28,28
1683347847435,MMW 15,B05,193523,Chang; Edmond Yi-Teh,0,5,28,28
1683347847435,MMW 15,B06,193524,Chang; Edmond Yi-Teh,0,4,28,28
1683347848460,MMW 122,A01,193526,Rahimi; Babak,0,15,28,28
1683347848460,MMW 122,A02,193527,Rahimi; Babak,0,14,28,28
1683347848460,MMW 122,A03,193528,Rahimi; Babak,0,0,0,0
1683347848460,MMW 122,A04,193529,Rahimi; Babak,0,0,0,0
1683347849484,MUS 1A,A01,186663,Staff,0,20,35,35
1683347850509,MUS 4,A01,186715,Staff,0,12,35,35
1683347851535,MUS 5R,A01,186796,Dubnov; Shlomo,0,17,35,35
1683347852560,MUS 6,A01,186798,Staff,0,4,25,25
1683347853593,MUS 7,A01,186830,Staff,13,0,35,22
1683347854621,MUS 8,A01,186930,Staff,0,26,35,35
1683347855649,MUS 15,A01,186932,Staff,0,16,35,35
1683347855649,MUS 15,B01,186934,Staff,0,15,35,35
1683347856676,MUS 80,A00,186935,Staff,1,0,20,19
1683347856676,MUS 80,B00,186936,Staff,25,0,25,0
1683347857703,NANO 11,A00,204702,Lipomi; Darren John,0,0,0,0
1683347858731,NANO 15,A01,204709,Yang; Kesong,0,1,0,0
1683347859756,NANO 114,A00,202069,Jahed Motlagh; Zeinab,3,0,10,7
1683347860781,PHIL 1,A00,186955,Grush; Rick Scott,32,0,40,8
1683347861805,PHIL 10,A01,186973,Grush; Rick Scott,28,0,35,7
1683347861805,PHIL 10,A02,186974,Grush; Rick Scott,33,0,35,2
1683347862829,PHIL 13,A01,186976,Staff,7,0,35,28
1683347862829,PHIL 13,A02,186977,Staff,16,0,35,19
1683347863857,PHIL 14,A01,186979,Staff,31,0,35,4
1683347863857,PHIL 14,A02,186986,Staff,32,0,35,3
1683347864882,PHIL 28,A01,186988,Staff,16,0,30,14
1683347864882,PHIL 28,A02,186989,Staff,1,0,30,29
1683347864882,PHIL 28,A03,186990,Staff,9,0,30,21
1683347864882,PHIL 28,A04,186991,Staff,26,0,30,4
1683347865909,PHIL 120,A00,186997,Staff,23,0,40,17
1683347866934,PHIL 137,A00,187003,Staff,9,0,40,31
1683347867959,PHIL 150,A00,187015,Staff,47,0,70,23
1683347868984,PHIL 167,A00,187021,Lamey; Andy M.,35,0,40,5
1683347870010,PHIL 174,A01,202226,Staff,17,0,20,3
1683347870010,PHIL 174,A02,202235,Staff,20,0,20,0
1683347871034,PHIL 191A,A00,258918,Staff,0,0,1,1
1683347872059,PHYS 1A,A00,187028,Staff,27,0,60,33
1683347873085,PHYS 1AL,001,187036,Staff,2,0,30,28
1683347873085,PHYS 1AL,002,187049,Staff,18,0,30,12
1683347874109,PHYS 1B,A00,187058,Staff,22,0,60,38
1683347875138,PHYS 1BL,001,187064,Staff,0,0,30,30
1683347875138,PHYS 1BL,002,187070,Staff,5,0,30,25
1683347876163,PHYS 1C,A00,187082,Staff,31,0,120,89
1683347877190,PHYS 1CL,001,187088,Staff,0,9,30,30
1683347877190,PHYS 1CL,002,187089,Staff,0,2,30,30
1683347877190,PHYS 1CL,009,262693,Staff,11,0,30,19
1683347878217,PHYS 2B,A01,187097,Staff,54,0,115,61
1683347879248,PHYS 2C,A01,187099,Staff,67,0,115,48
1683347880273,PHYS 2CL,A01,187101,Staff,5,0,28,23
1683347880273,PHYS 2CL,A02,187102,Staff,15,0,28,13
1683347881301,PHYS 2D,A01,187123,Shotwell; Brian,95,0,115,20
1683347882326,PHYS 4B,A01,187133,Grinstein; Benjamin,35,0,50,15
1683347883350,POLI 10,A00,188819,Staff,0,4,50,50
1683347884374,POLI 11,A00,188827,Staff,43,0,50,7
1683347885403,POLI 13R,A00,188828,Staff,0,1,20,20
1683347886428,POLI 27,A01,188830,Elgin; Samuel Zincke,0,1,70,70
1683347887452,POLI 30,A00,188832,Desposato; Scott,31,0,50,19
1683347888537,POLI 102F,A00,188834,Staff,3,0,40,37
1683347889567,POLI 104A,A00,188852,Staff,14,0,30,16
1683347890596,POLI 104I,A00,188853,Staff,0,6,20,20
1683347891620,POLI 110B,A00,188854,Wiens; David,7,0,20,13
1683347892648,POLI 112A,A00,188855,Wiens; David,5,0,30,25
1683347893676,POLI 117R,A00,188856,Forman; Fonna,0,11,20,20
1683347894700,POLI 118,A00,188857,Ingham; Sean,8,0,20,12
1683347895728,POLI 120G,A00,188858,Staff,9,0,30,21
1683347896756,POLI 131CR,A00,188863,Hoston; Germaine,24,0,50,26
1683347897782,POLI 133,A00,188864,Nellis; Gareth Hb,44,0,50,6
1683347898812,POLI 134D,A00,188865,Desposato; Scott,27,0,30,3
1683347899835,POLI 142A,A00,188871,Gartzke; Erik,22,0,50,28
1683347900861,POLI 142K,A00,188874,Staff,38,0,50,12
1683347901886,POLI 143,A00,188940,Gartzke; Erik,16,0,30,14
1683347902911,POLI 153,A00,188943,Staff,3,0,20,17
1683347903936,POLI 160AA,A00,188944,Staff,11,0,40,29
1683347904964,POLI 170A,A00,188945,Staff,11,0,30,19
1683347907016,PSYC 1,A00,188952,Staff,37,0,90,53
1683347908041,PSYC 2,B00,188953,Staff,19,0,35,16
1683347909070,PSYC 6,A00,188970,Staff,47,0,60,13
1683347910095,PSYC 7,A00,188973,Staff,37,0,45,8
1683347911119,PSYC 60,A01,188980,Rickard; Timothy C.,43,0,60,17
1683347912144,PSYC 70,A01,189001,Steiner; Eric Tomas,23,0,45,22
1683347913171,PSYC 100,A00,189005,Lacefield; Katharine I,0,98,120,120
1683347914195,PSYC 102,A00,189008,Staff,9,0,30,21
1683347915224,PSYC 106,B00,189026,Gorman; Michael R.,34,0,60,26
1683347916249,PSYC 114,B01,189033,Winkielman; Piotr,0,32,30,30
1683347917272,PSYC 131,A00,189036,Anagnostaras; Stephan,0,43,60,60
1683347918298,PSYC 136,A00,189041,Lowe; Angela Beth,0,7,25,25
1683347919321,PSYC 137,A00,189057,Winkielman; Piotr,0,34,25,25
1683347920345,PSYC 144,A00,189107,Wixted; John T,0,7,50,50
1683347922399,PSYC 162,A00,189142,Staff,0,8,85,85
1683347923422,PSYC 172,A00,189144,Gorman; Michael R.,0,7,30,30
1683347925474,PSYC 179,A00,189146,Lacefield; Katharine I,0,84,120,120
1683347926499,PSYC 181,A00,189147,Anagnostaras; Stephan,0,44,90,90
1683347927524,PSYC 190R,A00,189148,Barner; David A.,0,22,80,80
1683347928548,PSYC 191,A00,189275,Rickard; Timothy C.,0,7,25,25
1683347929573,PSYC 193,A00,189276,Chapman; Eddie Nathaniel,0,1,0,4
1683347930599,PSYC 193L,A01,189281,Lowe; Angela Beth,12,0,20,8
1683347930599,PSYC 193L,B01,189285,Staff,28,0,35,7
1683347931623,RELI 149,A00,187137,Rahimi; Babak,7,0,40,33
1683347932647,SE 9,A01,187315,Staff,0,2,18,18
1683347933669,SE 101B,A00,187409,Staff,24,0,30,6
1683347934697,SE 110B,A00,187444,Staff,10,0,40,30
1683347935722,SE 130B,A00,187449,Staff,31,0,40,9
1683347936749,SE 150A,A00,187516,Staff,9,0,20,11
1683347937777,SE 154,A00,187528,Staff,30,0,50,20
1683347938801,SIO 3,A01,258171,Staff,35,0,40,5
1683347939829,SIO 10,A00,187144,Cook; Geoffrey W,0,3,75,75
1683347940856,SIO 45,A00,187152,Cook; Geoffrey W,1,0,100,99
1683347941885,SIO 109R,A00,194486,Staff,0,3,20,20
1683347943935,SIO 187,A01,187233,Kacev; David,12,0,40,28
1683347944960,SOCI 1,A01,258656,Thorpe; Charles Robert,28,0,30,2
1683347944960,SOCI 1,A02,258658,Thorpe; Charles Robert,30,0,30,0
1683347944960,SOCI 1,A03,258661,Thorpe; Charles Robert,25,0,25,0
1683347944960,SOCI 1,A04,258666,Thorpe; Charles Robert,22,0,25,3
1683347944960,SOCI 1,A05,258897,Thorpe; Charles Robert,23,0,25,2
1683347944960,SOCI 1,A06,258898,Thorpe; Charles Robert,25,0,25,0
1683347945988,SOCI 30,A01,258903,Pardo Guerra; Juan Pablo,15,0,30,15
1683347947013,SOCI 102,A00,258904,Staff,9,0,25,16
1683347948039,SOCI 106,A00,258905,Staff,19,0,25,6
1683347949063,SOCI 111,A00,258907,Ribas Norris; Janet Vanesa,26,0,30,4
1683347950087,SOCI 121R,A00,258908,Pardo Guerra; Juan Pablo,10,0,30,20
1683347951111,SOCI 126,A01,203330,Staff,14,0,20,6
1683347952135,SOCI 131,A00,258909,Thorpe; Charles Robert,31,0,60,29
1683347953159,SOCI 135,A00,258910,Payne; Christine Anna,0,9,30,30
1683347954183,SOCI 157,A00,258911,Staff,12,0,30,18
1683347955207,SOCI 184,A00,258912,Staff,25,0,30,5
1683347956234,SOCI 188D,A00,258913,Staff,21,0,30,9
1683347957262,SYN 2,001,187529,Staff,10,0,16,6
1683347957262,SYN 2,002,201452,Staff,0,18,16,16
1683347957262,SYN 2,003,201469,Staff,3,0,16,13
1683347958288,SYN 100,A01,187531,Staff,0,9,20,20
1683347958288,SYN 100,B01,201491,Staff,0,12,20,20
1683347959312,TDAC 1,A00,189286,Walsh; Kim C.,3,0,20,17
1683347959312,TDAC 1,B00,189287,Harting; Carla Kelso,11,0,20,9
1683347960341,TDAC 101,A00,189300,Walsh; Kim C.,16,0,20,4
1683347960341,TDAC 101,B00,189301,Harting; Carla Kelso,18,0,20,2
1683347961369,TDAC 102,A00,189304,Basso; Beatrice,14,0,20,6
1683347962395,TDAC 108,A00,189305,Staff,18,0,20,2
1683347963424,TDDE 131,A00,189310,Staff,19,0,20,1
1683347963424,TDDE 131,B00,189314,Staff,19,0,20,1
1683347963424,TDDE 131,C00,189315,Staff,48,0,50,2
1683347963424,TDDE 131,D00,189316,Staff,14,0,15,1
1683347963424,TDDE 131,E00,204841,Staff,20,0,20,0
1683347964451,TDGE 10,A00,189289,Staff,30,0,50,20
1683347964451,TDGE 10,B00,189290,Havis; Allan,1,0,50,49
1683347965480,TDGE 11,A00,189291,Fulton; Julia,0,3,50,50
1683347965480,TDGE 11,B00,189292,Staff,20,0,25,5
1683347965480,TDGE 11,C00,260270,Staff,0,0,0,0
1683347966505,TDGE 25,A00,189294,Staff,3,0,20,17
1683347967531,TDGE 124,A00,189318,Fulton; Julia,0,8,50,50
1683347968556,TDGE 125,A00,189319,Staff,13,0,25,12
1683347968556,TDGE 125,B00,189320,Staff,23,0,25,2
1683347969580,TDGE 127,A00,189322,Havis; Allan,0,0,50,50
1683347970608,TDHT 101,A00,189323,Staff,18,0,25,7
1683347970608,TDHT 101,B00,189324,Staff,25,0,25,0
1683347971634,TDHT 102,A00,189325,Staff,49,0,50,1
1683347972663,TDMV 1,A00,189295,Arcidiacono; Kristin,19,0,30,11
1683347972663,TDMV 1,B00,189296,Caligagan; Maria T.,24,0,30,6
1683347973693,TDMV 2,A00,189297,Sammartano; Tonnie,28,0,30,2
1683347973693,TDMV 2,B00,189299,Arcidiacono; Kristin,24,0,30,6
1683347974719,TDMV 3,A00,204998,Rincon; Alicia,22,0,30,8
1683347975742,TDMV 120,A00,189458,Sammartano; Tonnie,28,0,30,2
1683347976769,TDMV 138,A00,189541,Jun; Grace Shin Hae,22,0,40,18
1683347977793,TDMV 142,A00,189717,Caligagan; Tony,23,0,30,7
1683347977793,TDMV 142,B00,189718,Caligagan; Maria T.,25,0,30,5
1683347978818,TMC 2,A01,187533,Staff,25,0,25,0
1683347978818,TMC 2,A02,187534,Staff,25,0,25,0
1683347979841,USP 1,A01,187536,Kwak; Nancy,0,16,25,25
1683347980865,USP 5,A01,187538,Staff,10,0,25,15
1683347981892,USP 101,A00,199253,Staff,0,4,0,0
1683347982922,USP 124,A00,187562,Boomhower; Matthew Charles,1,0,30,29
1683347983946,USP 138,A00,187582,Staff,20,0,25,5
1683347984971,USP 152,A01,187597,Staff,4,0,25,21
1683347985997,USP 153,A00,187598,Staff,19,0,25,6
1683347987024,USP 168,A00,187607,Kwak; Nancy,2,0,5,3
1683347988049,USP 173,A00,187619,Staff,4,0,25,21
1683347989075,USP 181,A00,187638,Staff,0,1,25,25
1683347990100,VIS 103,A00,187650,Cruz; Edwin Teddy,23,0,75,52
1683347991125,VIS 110D,A00,187669,Staff,12,0,22,10
1683347992209,VIS 127C,A00,187720,Shen; Kuiyi,67,0,146,79
1683347993236,VIS 149,A00,187731,Yoldas; Pinar,0,14,22,22
1683347994266,VIS 151,A01,188091,Staff,22,0,34,12
1683347994266,VIS 151,A02,188092,Staff,11,0,34,23
1683347995290,VIS 160B,A00,188093,Stalbaum; Brett,0,0,10,10
1683347997349,WCWP 10B,A00,201720,Staff,10,0,15,5
1683347997349,WCWP 10B,B00,201722,Staff,9,0,15,6
1683347998376,WCWP 100,A00,201725,Gagnon; Jeffrey C,0,0,2,2
1683347998376,WCWP 100,B00,201727,Staff,0,4,15,15
1683348001461,ANBI 133,A00,258401,Wilder; Linnea Lorene,34,0,40,6
1683348002485,ANBI 140,A00,258395,Hrvoj Mihic; Branka,18,0,25,7
1683348003508,ANSC 120,A00,258402,Bialecki; Jon Anthony,27,0,40,13
1683348004533,ANSC 144,A00,258400,Staff,14,0,40,26
1683348006579,ANSC 166,A00,258396,Parish; Steven Martin,157,0,175,18
1683348007603,ANSC 180,A00,193533,Staff,9,0,20,11
1683348008626,ANSC 188,A00,258397,Jassal; Aftab,33,0,40,7
1683348009650,ANTH 3,A01,258316,Staff,23,0,30,7
1683348010676,ANTH 5,A00,258394,Semendeferi; Ekaterini,16,0,20,4
1683348011702,ANTH 21,A01,258331,Staff,8,0,40,32
1683348012729,ANTH 103,A00,258398,Varma; Saiba,15,0,25,10
1683348013762,AWP 10,001,202034,Staff,0,0,0,0
1683348013762,AWP 10,002,202035,Staff,0,0,0,0
1683348013762,AWP 10,003,202036,Staff,0,0,0,0
1683348013762,AWP 10,004,202037,Staff,0,0,0,0
1683348013762,AWP 10,005,202038,Staff,0,0,0,0
1683348013762,AWP 10,006,202039,Staff,0,0,0,0
1683348013762,AWP 10,007,202040,Staff,0,0,0,0
1683348013762,AWP 10,008,202041,Staff,0,0,0,0
1683348013762,AWP 10,009,202042,Staff,0,0,0,0
1683348013762,AWP 10,010,202043,Staff,0,0,0,0
1683348013762,AWP 10,011,202044,Staff,0,0,0,0
1683348013762,AWP 10,012,202045,Staff,0,0,0,0
1683348013762,AWP 10,013,202046,Staff,0,0,0,0
1683348013762,AWP 10,014,202047,Staff,0,0,0,0
1683348013762,AWP 10,015,202048,Staff,0,0,0,0
1683348013762,AWP 10,016,202049,Staff,0,0,0,0
1683348013762,AWP 10,017,202050,Staff,0,0,0,0
1683348013762,AWP 10,018,202051,Staff,0,0,0,0
1683348013762,AWP 10,019,202052,Staff,0,0,0,0
1683348013762,AWP 10,020,202053,Staff,0,0,0,0
1683348013762,AWP 10,021,202054,Staff,0,0,0,0
1683348013762,AWP 10,022,202055,Staff,0,0,0,0
1683348013762,AWP 10,023,202056,Staff,0,0,0,0
1683348013762,AWP 10,024,202057,Staff,0,0,0,0
1683348013762,AWP 10,025,202058,Staff,0,0,0,0
1683348013762,AWP 10,026,202059,Staff,0,0,0,0
1683348014787,AWP 102,001,202032,Staff,0,0,0,0
1683348014787,AWP 102,002,202033,Staff,0,0,0,0
1683348015811,BENG 100,A01,254234,Taylor Amos; Alyssa C,31,0,40,9
1683348016837,BENG 196,001,270013,Engler; Adam J.,9999,0,9999,0
1683348017866,BICD 100R,A01,202018,Smith; Laurie,0,7,32,32
1683348017866,BICD 100R,A02,202019,Smith; Laurie,0,2,32,32
1683348017866,BICD 100R,A03,202020,Smith; Laurie,0,1,32,32
1683348017866,BICD 100R,A04,202021,Smith; Laurie,9,0,32,23
1683348017866,BICD 100R,A05,202022,Smith; Laurie,12,0,32,20
1683348018892,BICD 136,A01,193242,Gustafson-Brown; Cindy,0,2,32,32
1683348018892,BICD 136,A02,193244,Gustafson-Brown; Cindy,14,0,32,18
1683348019918,BIEB 102,A01,193249,Butler; Shannon Rhey,0,2,32,32
1683348019918,BIEB 102,A02,193251,Butler; Shannon Rhey,0,0,32,32
1683348019918,BIEB 102,A03,193253,Butler; Shannon Rhey,0,1,32,32
1683348019918,BIEB 102,A04,193255,Butler; Shannon Rhey,17,0,32,15
1683348019918,BIEB 102,A05,193265,Butler; Shannon Rhey,26,0,32,6
1683348019918,BIEB 102,A06,193269,Butler; Shannon Rhey,16,0,32,16
1683348021969,BIEB 150,A01,193274,Staff,0,0,32,32
1683348021969,BIEB 150,A02,193285,Staff,23,0,32,9
1683348022994,BIEB 194,A00,193286,Kurle; Carolyn M.,22,0,32,10
1683348024020,BILD 1,A01,192291,Staff,16,0,32,16
1683348024020,BILD 1,A02,192292,Staff,30,0,32,2
1683348024020,BILD 1,B01,192520,Reuther; Keefe,0,1,0,0
1683348024020,BILD 1,B02,192532,Reuther; Keefe,0,1,0,0
1683348025044,BILD 3,A01,192556,Butler; Shannon Rhey,0,0,32,32
1683348025044,BILD 3,A02,192581,Butler; Shannon Rhey,5,0,32,27
1683348025044,BILD 3,A03,192611,Butler; Shannon Rhey,23,0,32,9
1683348025044,BILD 3,A04,192612,Butler; Shannon Rhey,25,0,32,7
1683348025044,BILD 3,A05,192613,Butler; Shannon Rhey,27,0,32,5
1683348025044,BILD 3,A06,192679,Butler; Shannon Rhey,27,0,32,5
1683348025044,BILD 3,A07,192682,Butler; Shannon Rhey,22,0,32,10
1683348026068,BILD 4,A01,192836,Reuther; Keefe,0,0,24,24
1683348026068,BILD 4,A02,193044,Reuther; Keefe,4,0,24,20
1683348027093,BILD 10,A01,193142,Gustafson-Brown; Cindy,30,0,32,2
1683348027093,BILD 10,A02,193149,Gustafson-Brown; Cindy,31,0,32,1
1683348028125,BIMM 100,A01,193301,Staff,0,6,32,32
1683348028125,BIMM 100,A02,193312,Staff,0,5,32,32
1683348028125,BIMM 100,A03,193323,Staff,0,8,32,32
1683348029150,BIMM 101,A01,193329,McDonnell; Lisa Marie,0,3,24,24
1683348029150,BIMM 101,A02,193339,McDonnell; Lisa Marie,0,3,24,24
1683348029150,BIMM 101,B01,193354,McDonnell; Lisa Marie,0,3,24,24
1683348029150,BIMM 101,B02,193357,McDonnell; Lisa Marie,0,3,24,24
1683348030173,BIMM 110,A01,193377,Tat; John,0,11,32,32
1683348030173,BIMM 110,A02,193378,Tat; John,1,9,32,31
1683348031204,BIMM 120,A01,206116,Staff,0,0,32,32
1683348031204,BIMM 120,A02,206117,Staff,8,0,32,24
1683348031204,BIMM 120,A03,206121,Staff,21,0,32,11
1683348032234,BIPN 100,A01,193393,Park; Ji Young,0,14,32,32
1683348032234,BIPN 100,A02,193402,Park; Ji Young,0,13,32,32
1683348032234,BIPN 100,A03,193413,Park; Ji Young,0,14,32,32
1683348032234,BIPN 100,A04,193414,Park; Ji Young,0,13,32,32
1683348033263,BIPN 102,A01,193429,Staff,0,0,32,32
1683348033263,BIPN 102,A02,193438,Staff,22,0,32,10
1683348034287,BIPN 106,A01,193450,Reyes Gonzalez; Catalina,0,2,40,40
1683348035314,BIPN 134,A01,193465,Cooke; James Edward,0,0,32,32
1683348035314,BIPN 134,A02,193474,Cooke; James Edward,25,0,32,7
1683348035314,BIPN 134,A03,193485,Cooke; James Edward,29,0,32,3
1683348035314,BIPN 134,A04,193486,Cooke; James Edward,21,0,32,11
1683348035314,BIPN 134,A05,193491,Cooke; James Edward,31,0,32,1
1683348035314,BIPN 134,A06,193501,Cooke; James Edward,30,0,32,2
1683348035314,BIPN 134,A07,193510,Cooke; James Edward,29,0,32,3
1683348037365,BISP 194,A00,222522,Staff,14,0,32,18
1683348038389,CAT 124,A01,202407,Staff,20,0,25,5
1683348039414,CAT 125,A00,202408,Marchisotto; Jennifer Anne,4,0,20,16
1683348040440,CAT 125R,A00,202409,Smith; Lauryn Alissa,0,11,20,20
1683348040440,CAT 125R,B00,202410,Morales; Celeste Georgianna,0,11,20,20
1683348040440,CAT 125R,C00,202411,Irwin; Matthew Joseph,0,10,20,20
1683348041466,CENG 15,A01,204712,Yang; Kesong,0,1,0,0
1683348042489,CENG 114,A00,202070,Jahed Motlagh; Zeinab,5,0,20,15
1683348043517,CGS 105,A00,185477,Wesling; Megan E.,24,0,40,16
1683348044541,CGS 106,A00,185494,Staff,13,0,22,9
1683348045567,CGS 108,A00,185495,Staff,14,0,20,6
1683348046591,CGS 114,A00,185496,Staff,13,0,18,5
1683348047613,CGS 119,A00,185501,Staff,15,0,20,5
1683348048637,CGS 120,A00,185511,Staff,13,0,20,7
1683348049662,CHEM 4,A01,184675,Bussey; Thomas J,96,0,100,4
1683348050686,CHEM 6A,A01,184677,Staff,34,0,60,26
1683348051714,CHEM 6B,A01,184679,Staff,65,0,100,35
1683348052740,CHEM 6C,A01,184681,Bussey; Thomas J,1,0,50,49
1683348052740,CHEM 6C,A02,184682,Bussey; Thomas J,34,0,50,16
1683348053764,CHEM 40A,A01,184684,Albizati; Kim F.,37,0,100,63
1683348054791,CHEM 40B,A01,184686,Albizati; Kim F.,0,20,100,100
1683348055815,CHEM 41B,A01,184690,Staff,52,0,100,48
1683348056839,COGS 3,A01,184715,Boyle; Mary E. T.,0,25,40,40
1683348057863,COGS 14B,A01,185172,Staff,0,15,38,38
1683348058887,COGS 18,A01,184736,Staff,17,0,80,63
1683348059913,COGS 100,A01,184932,Staff,0,5,73,73
1683348060940,COGS 101A,A01,184935,Staff,0,39,30,30
1683348061980,COGS 101B,A01,184944,Staff,0,2,30,30
1683348063005,COGS 101C,A01,184946,Staff,0,12,30,30
1683348064032,COGS 102A,A01,184951,Johnson; Christine M.,2,0,40,38
1683348065057,COGS 107B,A01,184953,Mooshagian; Eric Frederick,0,50,40,40
1683348066086,COGS 118B,A01,184959,Gupta; Anjum,0,48,40,40
1683348067114,COGS 153,A00,184961,Staff,0,15,30,30
1683348068142,COGS 177,A00,184962,Staff,0,20,30,30
1683348069167,COGS 187A,A01,184969,Boyle; Mary E. T.,0,17,40,40
1683348070195,COMM 10,A01,185174,Staff,0,5,25,25
1683348070195,COMM 10,A02,185189,Staff,0,5,25,25
1683348070195,COMM 10,A03,269821,Staff,0,0,0,0
1683348071220,COMM 100B,A01,185475,Staff,0,0,0,2
1683348071220,COMM 100B,A02,185476,Staff,13,0,25,12
1683348072245,COMM 100C,A01,185314,Staff,1,0,25,24
1683348072245,COMM 100C,A02,185327,Staff,19,0,25,6
1683348073268,COMM 110M,A00,185349,Staff,2,0,40,38
1683348074295,COMM 113T,A00,185352,Staff,24,0,40,16
1683348075323,COMM 114I,A00,185353,Staff,33,0,40,7
1683348076350,COMM 131,A00,185354,Staff,19,0,30,11
1683348077375,CSE 8A,A50,185358,Cao; Yingjun,0,46,10,10
1683348078401,CSE 8B,A01,185362,Staff,1,47,50,49
1683348079425,CSE 11,A01,185416,Cao; Yingjun,0,92,10,10
1683348080453,CSE 20,A01,185445,Briones; Jor-el Thomas Caparas,5,0,25,20
1683348081481,CSE 21,A01,185447,Staff,10,0,50,40
1683348082506,CSE 101,A01,185451,Staff,0,13,50,50
1683348082506,CSE 101,B01,185453,Jones; Miles E,0,11,50,50
1683348084557,CSE 141,A01,185458,Eldon; John,20,0,100,80
1683348085582,CSE 141L,A01,185461,Eldon; John,12,0,100,88
1683348086607,CSE 142,A01,185463,Staff,36,0,60,24
1683348086607,CSE 142,B01,201355,Staff,0,7,60,60
1683348087631,CSE 142L,A01,185470,Staff,36,0,60,24
1683348087631,CSE 142L,B01,201417,Staff,0,6,60,60
1683348088655,CSE 190,A00,201433,Staff,32,0,49,17
1683348089680,DOC 1,A01,259136,Strom; Megan C.,7,0,15,8
1683348089680,DOC 1,A02,259137,Strom; Megan C.,14,0,15,1
1683348089680,DOC 1,A03,259138,Strom; Megan C.,14,0,15,1
1683348089680,DOC 1,A04,259139,Strom; Megan C.,14,0,15,1
1683348090709,DOC 100D,A00,259140,Pass; Natalye Joann,16,0,25,9
1683348091734,DSGN 1,A01,184749,Rill; Bryan,0,25,30,30
1683348092759,DSGN 100,A01,185168,Staff,0,2,25,25
1683348093783,ECE 5,A01,185626,Morris; Karcher William,0,10,0,0
1683348094808,ECE 101,A01,185628,Staff,17,0,70,53
1683348095886,ECE 107,A01,185635,Baghdadchi; Saharnaz,0,0,20,20
1683348095886,ECE 107,A02,185638,Baghdadchi; Saharnaz,4,0,20,16
1683348096910,ECE 148,A01,185647,Silberman; Jack,0,0,16,16
1683348097939,ECON 1,A01,185537,Crane; Meredith Helen,54,0,70,16
1683348098964,ECON 3,A01,185549,Crane; Meredith Helen,32,0,70,38
1683348099988,ECON 4,A01,203354,Anderson; John Charles,0,4,10,10
1683348101016,ECON 100A,A01,185574,Staff,0,4,40,40
1683348102045,ECON 100B,A01,185576,Staff,10,22,50,40
1683348103069,ECON 100C,A01,185589,Newhouse; Herbert S,29,0,70,41
1683348104094,ECON 105,A00,185608,Vespa; Emanuel Ignacio,19,0,35,16
1683348105123,ECON 109,A01,185610,Shishkin; Denis,10,0,35,25
1683348106150,ECON 110A,A01,185612,Staff,11,0,40,29
1683348107178,ECON 120A,A01,185615,Staff,20,0,40,20
1683348108206,ECON 120C,A01,185617,Sun; Yixiao,0,21,70,70
1683348109232,ECON 144,A00,203346,Squires; Dale E,3,0,35,32
1683348110261,ECON 171,A01,203349,Newhouse; Herbert S,0,1,35,35
1683348111290,ECON 173A,A01,185621,Toda; Alexis Akira,21,0,35,14
1683348112321,EDS 25,A01,202413,Staff,0,1,0,0
1683348112321,EDS 25,A02,202414,Staff,0,1,0,0
1683348112321,EDS 25,A03,202415,Staff,0,0,0,0
1683348112321,EDS 25,A04,202416,Staff,0,1,0,0
1683348112321,EDS 25,A05,202439,Staff,0,0,0,0
1683348112321,EDS 25,A06,202440,Staff,0,0,0,0
1683348112321,EDS 25,B01,202631,Staff,0,0,0,0
1683348112321,EDS 25,B02,202632,Staff,0,0,0,0
1683348112321,EDS 25,B03,202639,Staff,0,0,0,0
1683348112321,EDS 25,B04,202640,Staff,0,0,0,0
1683348112321,EDS 25,B05,202643,Staff,0,0,0,0
1683348112321,EDS 25,B06,202644,Staff,0,0,0,0
1683348113348,EDS 38,A01,202659,Black; Alison Michelle,24,0,25,1
1683348114378,EDS 115,A00,202652,Staff,18,0,30,12
1683348115401,EDS 125,A00,202649,Staff,14,0,30,16
1683348116425,EDS 126,A01,203332,Staff,30,0,30,0
1683348117449,EDS 139,A00,202838,Staff,16,0,25,9
1683348118474,EDS 146,A01,202655,Staff,14,0,25,11
1683348119503,ENG 15,A00,185667,Staff,0,1,0,0
1683348119503,ENG 15,B00,185672,Staff,0,0,0,0
1683348119503,ENG 15,C00,185675,Staff,0,0,0,0
1683348119503,ENG 15,D00,185682,Staff,0,0,0,0
1683348119503,ENG 15,E00,185684,Staff,0,0,0,0
1683348120526,ETHN 103,A00,185710,Staff,0,4,35,35
1683348121552,ETHN 103A,A00,199228,Man; Simeon S,2,0,9,7
1683348122577,ETHN 109,A00,185711,Staff,18,0,35,17
1683348123603,ETHN 142,A00,185726,Staff,0,4,30,30
1683348124631,ETHN 163J,A00,199229,Man; Simeon S,5,0,8,3
1683348125657,ETHN 168,A00,185727,Staff,8,0,10,2
1683348126683,ETHN 182,A00,185728,Staff,1,0,35,34
1683348127711,ETHN 183,A00,185737,Staff,8,0,18,10
1683348128736,GLBH 111,A01,209361,Burgos; Jose L.,0,0,0,0
1683348130788,HIEU 104,A00,185792,Staff,16,0,20,4
1683348131814,HIEU 115,A00,185800,Staff,1,0,20,19
1683348132837,HIEU 128,A00,185801,Staff,0,7,20,20
1683348133861,HIEU 147,A00,185802,Staff,16,0,20,4
1683348134885,HIEU 154,A00,185823,Staff,12,0,20,8
1683348135909,HILA 102,A00,185826,Staff,13,0,20,7
1683348136932,HILD 2C,A01,185778,Staff,0,12,20,20
1683348137957,HILD 7B,A01,185780,Kwak; Nancy,0,15,32,32
1683348137957,HILD 7B,A02,185781,Kwak; Nancy,0,18,32,32
1683348138985,HILD 30,A01,185791,Staff,14,0,20,6
1683348140012,HISC 119,A00,185830,Golan; Tal,0,9,20,20
1683348141037,HITO 156GS,A00,185831,Patterson; Patrick H.,0,0,0,23
1683348142061,HIUS 103,A00,185832,Man; Simeon S,0,6,20,20
1683348143086,HIUS 117,A00,185836,Kwak; Nancy,2,0,20,18
1683348144208,HIUS 125,A00,185840,Man; Simeon S,0,0,23,23
1683348145237,HIUS 149,A00,185845,Staff,0,0,20,20
1683348146263,HUM 3,A01,185882,Zavodny; Tatiana Sophia,0,7,50,50
1683348146263,HUM 3,B01,185899,Caldwell; Michael Alan,0,18,50,50
1683348147290,HUM 3GS,A00,185900,Patterson; Patrick H.,0,0,0,23
1683348148317,HUM 4,A01,185938,Zroka; Amy Liane,31,0,50,19
1683348148317,HUM 4,B01,185956,Watkins; Eric,0,2,50,50
1683348148317,HUM 4,B02,202209,Watkins; Eric,0,2,50,50
1683348148317,HUM 4,B03,202210,Watkins; Eric,0,2,50,50
1683348149343,HUM 5,A01,185958,West; Geoffrey Scott,3,0,50,47
1683348149343,HUM 5,A02,202215,West; Geoffrey Scott,0,0,50,50
1683348150370,INTL 190,A00,185959,Gagnon; Jeffrey C,0,0,0,9
1683348150370,INTL 190,B00,185960,Lettieri; Michael Joseph,0,0,0,1
1683348151394,JAPN 180,A00,254509,Staff,5,1,30,25
1683348152421,LATI 10,A01,202853,Kennemore; Amy Michelle,4,0,35,31
1683348152421,LATI 10,A02,202854,Kennemore; Amy Michelle,2,0,35,33
1683348152421,LATI 10,A03,270054,Kennemore; Amy Michelle,30,0,30,0
1683348153451,LATI 180,A00,202855,Kennemore; Amy Michelle,11,0,20,9
1683348154478,LAWS 101,A00,201767,Golan; Tal,0,7,40,40
1683348155502,LIFR 1C,A00,185961,Staff,6,0,20,14
1683348156530,LIFR 1CX,A00,185962,Staff,7,0,20,13
1683348157558,LIFR 1D,A00,185963,Staff,9,0,20,11
1683348158583,LIFR 1DX,A00,185964,Staff,9,0,20,11
1683348159607,LIGN 101,A01,186039,Staff,43,0,50,7
1683348160631,LIGN 165,A00,186040,Staff,18,0,50,32
1683348161677,LTCS 108,A00,186041,Staff,6,0,10,4
1683348162702,LTCS 119,A00,186042,Staff,16,0,20,4
1683348163727,LTCS 130,A00,186043,Wesling; Megan E.,15,0,25,10
1683348165778,LTEA 138,A00,186119,Staff,14,0,40,26
1683348166803,LTEN 124,A00,186148,Staff,6,0,25,19
1683348167833,LTEN 178,A00,186149,Staff,7,0,15,8
1683348168857,LTEN 181,A00,186150,Blanco; John D,33,0,40,7
1683348169884,LTWL 120,A00,186160,Staff,20,0,25,5
1683348170910,LTWL 165,A00,186161,Staff,22,0,25,3
1683348171938,LTWR 100,A00,186162,Staff,0,5,15,15
1683348172964,LTWR 102,A00,186163,Doller; Ben,5,0,15,10
1683348173987,MAE 8,A01,186412,Staff,0,0,0,0
1683348175015,MAE 30B,A00,186445,Bahadori; Mohammad Yousef,83,0,100,17
1683348176041,MAE 40,A00,186592,Bewley; Thomas R,9,0,50,41
1683348177065,MAE 101B,A00,186593,Bahadori; Mohammad Yousef,81,0,100,19
1683348178086,MAE 105,A00,186594,Bandaru; Prabhakar,12,0,50,38
1683348179110,MAE 107,A00,186599,Pham; Hieu Tan,0,6,120,120
1683348180137,MAE 148,A01,186660,Silberman; Jack,3,0,16,13
1683348181165,MATH 10A,A01,188095,Staff,1,6,35,34
1683348182190,MATH 10B,A01,188097,Bowers; Adam R.,0,11,30,30
1683348182190,MATH 10B,A02,188099,Bowers; Adam R.,0,11,30,30
1683348182190,MATH 10B,B01,188104,Bowers; Adam R.,0,10,30,30
1683348182190,MATH 10B,B02,188106,Bowers; Adam R.,0,10,30,30
1683348183221,MATH 10C,A01,188111,Staff,0,18,30,30
1683348183221,MATH 10C,A02,188127,Staff,0,17,30,30
1683348183221,MATH 10C,A03,188131,Staff,0,18,30,30
1683348183221,MATH 10C,B01,188218,Staff,18,0,30,12
1683348183221,MATH 10C,B02,188244,Staff,13,0,30,17
1683348183221,MATH 10C,B03,188277,Staff,16,0,30,14
1683348184246,MATH 18,A01,188344,Bach; Quang Tran,18,0,30,12
1683348184246,MATH 18,A02,188345,Bach; Quang Tran,11,0,30,19
1683348184246,MATH 18,B01,188353,Bach; Quang Tran,10,0,30,20
1683348184246,MATH 18,B02,188354,Bach; Quang Tran,20,0,30,10
1683348185272,MATH 20A,A01,188374,Staff,13,0,35,22
1683348186301,MATH 20B,A01,188382,Ohm; Ko Woon,6,0,30,24
1683348186301,MATH 20B,A02,188383,Ohm; Ko Woon,22,0,30,8
1683348186301,MATH 20B,B01,188385,Ohm; Ko Woon,7,0,30,23
1683348186301,MATH 20B,B02,188392,Ohm; Ko Woon,22,0,30,8
1683348187329,MATH 20C,A01,188394,Harel; Guershon,10,0,30,20
1683348187329,MATH 20C,A02,188395,Harel; Guershon,15,0,30,15
1683348187329,MATH 20C,B01,188404,Harel; Guershon,5,0,30,25
1683348187329,MATH 20C,B02,188405,Harel; Guershon,19,0,30,11
1683348188359,MATH 20D,A01,188414,Hammock; Frances H,0,1,30,30
1683348188359,MATH 20D,A02,188415,Hammock; Frances H,3,0,30,27
1683348188359,MATH 20D,B01,188447,Hammock; Frances H,1,0,30,29
1683348188359,MATH 20D,B02,188486,Hammock; Frances H,8,0,30,22
1683348189387,MATH 20E,A01,188649,Staff,21,0,30,9
1683348189387,MATH 20E,A02,188650,Staff,23,0,30,7
1683348189387,MATH 20E,A03,188673,Staff,0,0,30,30
1683348190410,MATH 102,A01,188675,Staff,0,35,35,35
1683348191435,MATH 103B,A01,188681,Staff,3,0,35,32
1683348191435,MATH 103B,B01,188692,Staff,5,0,35,30
1683348192459,MATH 109,A01,188695,Salehi Golsefidy; Alireza,25,0,35,10
1683348192459,MATH 109,A02,188696,Salehi Golsefidy; Alireza,25,0,35,10
1683348193483,MATH 120A,A01,188698,Eggers; John Dietrich,7,0,35,28
1683348194511,MATH 142B,A01,188736,Ioana; Adrian,0,2,30,30
1683348194511,MATH 142B,A02,188741,Ioana; Adrian,1,1,30,29
1683348194511,MATH 142B,A03,188743,Ioana; Adrian,1,3,30,29
1683348195539,MATH 168A,A01,188790,Staff,0,9,35,35
1683348196563,MATH 170A,A01,188803,Nie; Jiawang,0,2,35,35
1683348196563,MATH 170A,A02,188811,Nie; Jiawang,0,0,35,35
1683348196563,MATH 170A,A03,188814,Nie; Jiawang,1,0,35,34
1683348196563,MATH 170A,A04,188815,Nie; Jiawang,13,0,35,22
1683348197587,MATH 193B,A01,188817,Staff,0,0,35,35
1683348197587,MATH 193B,A02,188818,Staff,5,0,35,30
1683348198616,MGT 4,A01,202857,Anderson; John Charles,62,0,80,18
1683348199696,MGT 12,A00,202858,Lindenberger; Wade Douglas,42,0,90,48
1683348200720,MGT 18,A00,202859,Staff,74,0,90,16
1683348201747,MGT 18GS,A00,202860,McKay; Michael J,13,0,28,15
1683348202770,MGT 45,A00,202861,Pecore; Joseph P.,14,0,90,76
1683348203795,MGT 100,A00,202863,Yavorsky; Daniel Ryan,28,0,90,62
1683348204825,MGT 103,A00,202864,Ehrich; Kristine R,1,18,90,89
1683348205850,MGT 112,A00,202865,Ehrich; Kristine R,15,0,90,75
1683348206878,MGT 121A,A00,202868,Staff,0,20,0,0
1683348207906,MGT 131B,A00,202869,Anderson; John Charles,59,0,90,31
1683348208930,MGT 136,A00,202871,Lindenberger; Wade Douglas,84,0,90,6
1683348209958,MGT 164,A00,202873,Staff,0,68,90,91
1683348210983,MGT 164GS,A00,202874,McKay; Mary A,13,0,28,15
1683348212007,MGT 180,A00,202875,Staff,0,50,90,91
1683348213031,MMW 11R,A01,205019,Herbst; Matthew,3,0,30,27
1683348213031,MMW 11R,A02,205026,Herbst; Matthew,29,0,30,1
1683348214060,MMW 15,A01,193512,Chang; Edmond Yi-Teh,0,9,28,28
1683348214060,MMW 15,A02,193513,Chang; Edmond Yi-Teh,0,5,28,28
1683348214060,MMW 15,A03,193514,Chang; Edmond Yi-Teh,0,5,28,28
1683348214060,MMW 15,A04,193515,Chang; Edmond Yi-Teh,0,5,28,28
1683348214060,MMW 15,A05,193516,Chang; Edmond Yi-Teh,0,4,28,28
1683348214060,MMW 15,A06,193517,Chang; Edmond Yi-Teh,0,5,28,28
1683348214060,MMW 15,B01,193519,Chang; Edmond Yi-Teh,0,5,28,28
1683348214060,MMW 15,B02,193520,Chang; Edmond Yi-Teh,0,5,28,28
1683348214060,MMW 15,B03,193521,Chang; Edmond Yi-Teh,0,5,28,28
1683348214060,MMW 15,B04,193522,Chang; Edmond Yi-Teh,0,4,28,28
1683348214060,MMW 15,B05,193523,Chang; Edmond Yi-Teh,0,5,28,28
1683348214060,MMW 15,B06,193524,Chang; Edmond Yi-Teh,0,4,28,28
1683348215088,MMW 122,A01,193526,Rahimi; Babak,0,15,28,28
1683348215088,MMW 122,A02,193527,Rahimi; Babak,0,14,28,28
1683348215088,MMW 122,A03,193528,Rahimi; Babak,0,0,0,0
1683348215088,MMW 122,A04,193529,Rahimi; Babak,0,0,0,0
1683348216115,MUS 1A,A01,186663,Staff,0,20,35,35
1683348217141,MUS 4,A01,186715,Staff,0,12,35,35
1683348218165,MUS 5R,A01,186796,Dubnov; Shlomo,0,17,35,35
1683348219190,MUS 6,A01,186798,Staff,0,4,25,25
1683348220214,MUS 7,A01,186830,Staff,13,0,35,22
1683348221238,MUS 8,A01,186930,Staff,0,26,35,35
1683348222264,MUS 15,A01,186932,Staff,0,16,35,35
1683348222264,MUS 15,B01,186934,Staff,0,15,35,35
1683348223288,MUS 80,A00,186935,Staff,1,0,20,19
1683348223288,MUS 80,B00,186936,Staff,25,0,25,0
1683348224316,NANO 11,A00,204702,Lipomi; Darren John,0,0,0,0
1683348225341,NANO 15,A01,204709,Yang; Kesong,0,1,0,0
1683348226365,NANO 114,A00,202069,Jahed Motlagh; Zeinab,3,0,10,7
1683348227392,PHIL 1,A00,186955,Grush; Rick Scott,32,0,40,8
1683348228417,PHIL 10,A01,186973,Grush; Rick Scott,28,0,35,7
1683348228417,PHIL 10,A02,186974,Grush; Rick Scott,33,0,35,2
1683348229442,PHIL 13,A01,186976,Staff,7,0,35,28
1683348229442,PHIL 13,A02,186977,Staff,16,0,35,19
1683348230470,PHIL 14,A01,186979,Staff,31,0,35,4
1683348230470,PHIL 14,A02,186986,Staff,32,0,35,3
1683348231495,PHIL 28,A01,186988,Staff,16,0,30,14
1683348231495,PHIL 28,A02,186989,Staff,1,0,30,29
1683348231495,PHIL 28,A03,186990,Staff,9,0,30,21
1683348231495,PHIL 28,A04,186991,Staff,26,0,30,4
1683348232522,PHIL 120,A00,186997,Staff,23,0,40,17
1683348233548,PHIL 137,A00,187003,Staff,9,0,40,31
1683348234573,PHIL 150,A00,187015,Staff,47,0,70,23
1683348235600,PHIL 167,A00,187021,Lamey; Andy M.,35,0,40,5
1683348236626,PHIL 174,A01,202226,Staff,17,0,20,3
1683348236626,PHIL 174,A02,202235,Staff,20,0,20,0
1683348237652,PHIL 191A,A00,258918,Staff,0,0,1,1
1683348238676,PHYS 1A,A00,187028,Staff,27,0,60,33
1683348239700,PHYS 1AL,001,187036,Staff,2,0,30,28
1683348239700,PHYS 1AL,002,187049,Staff,18,0,30,12
1683348240726,PHYS 1B,A00,187058,Staff,22,0,60,38
1683348241751,PHYS 1BL,001,187064,Staff,0,0,30,30
1683348241751,PHYS 1BL,002,187070,Staff,5,0,30,25
1683348242780,PHYS 1C,A00,187082,Staff,31,0,120,89
1683348243805,PHYS 1CL,001,187088,Staff,0,9,30,30
1683348243805,PHYS 1CL,002,187089,Staff,0,2,30,30
1683348243805,PHYS 1CL,009,262693,Staff,11,0,30,19
1683348244830,PHYS 2B,A01,187097,Staff,54,0,115,61
1683348245855,PHYS 2C,A01,187099,Staff,67,0,115,48
1683348246880,PHYS 2CL,A01,187101,Staff,5,0,28,23
1683348246880,PHYS 2CL,A02,187102,Staff,15,0,28,13
1683348247906,PHYS 2D,A01,187123,Shotwell; Brian,95,0,115,20
1683348248931,PHYS 4B,A01,187133,Grinstein; Benjamin,35,0,50,15
1683348249956,POLI 10,A00,188819,Staff,0,4,50,50
1683348250981,POLI 11,A00,188827,Staff,43,0,50,7
1683348252006,POLI 13R,A00,188828,Staff,0,1,20,20
1683348253038,POLI 27,A01,188830,Elgin; Samuel Zincke,0,1,70,70
1683348254063,POLI 30,A00,188832,Desposato; Scott,31,0,50,19
1683348255090,POLI 102F,A00,188834,Staff,3,0,40,37
1683348256117,POLI 104A,A00,188852,Staff,14,0,30,16
1683348257143,POLI 104I,A00,188853,Staff,0,6,20,20
1683348258170,POLI 110B,A00,188854,Wiens; David,7,0,20,13
1683348259194,POLI 112A,A00,188855,Wiens; David,5,0,30,25
1683348260221,POLI 117R,A00,188856,Forman; Fonna,0,11,20,20
1683348261248,POLI 118,A00,188857,Ingham; Sean,8,0,20,12
1683348262271,POLI 120G,A00,188858,Staff,9,0,30,21
1683348263295,POLI 131CR,A00,188863,Hoston; Germaine,24,0,50,26
1683348264323,POLI 133,A00,188864,Nellis; Gareth Hb,44,0,50,6
1683348265349,POLI 134D,A00,188865,Desposato; Scott,27,0,30,3
1683348266373,POLI 142A,A00,188871,Gartzke; Erik,22,0,50,28
1683348267397,POLI 142K,A00,188874,Staff,38,0,50,12
1683348268421,POLI 143,A00,188940,Gartzke; Erik,16,0,30,14
1683348269449,POLI 153,A00,188943,Staff,3,0,20,17
1683348270476,POLI 160AA,A00,188944,Staff,11,0,40,29
1683348271503,POLI 170A,A00,188945,Staff,11,0,30,19
1683348273560,PSYC 1,A00,188952,Staff,37,0,90,53
1683348274589,PSYC 2,B00,188953,Staff,19,0,35,16
1683348275613,PSYC 6,A00,188970,Staff,47,0,60,13
1683348276641,PSYC 7,A00,188973,Staff,37,0,45,8
1683348277665,PSYC 60,A01,188980,Rickard; Timothy C.,43,0,60,17
1683348278690,PSYC 70,A01,189001,Steiner; Eric Tomas,23,0,45,22
1683348279714,PSYC 100,A00,189005,Lacefield; Katharine I,0,98,120,120
1683348280740,PSYC 102,A00,189008,Staff,9,0,30,21
1683348281767,PSYC 106,B00,189026,Gorman; Michael R.,34,0,60,26
1683348282791,PSYC 114,B01,189033,Winkielman; Piotr,0,32,30,30
1683348283818,PSYC 131,A00,189036,Anagnostaras; Stephan,0,43,60,60
1683348284842,PSYC 136,A00,189041,Lowe; Angela Beth,0,7,25,25
1683348285870,PSYC 137,A00,189057,Winkielman; Piotr,0,34,25,25
1683348286896,PSYC 144,A00,189107,Wixted; John T,0,7,50,50
1683348288950,PSYC 162,A00,189142,Staff,0,8,85,85
1683348289974,PSYC 172,A00,189144,Gorman; Michael R.,0,7,30,30
1683348292026,PSYC 179,A00,189146,Lacefield; Katharine I,0,84,120,120
1683348293050,PSYC 181,A00,189147,Anagnostaras; Stephan,0,44,90,90
1683348294076,PSYC 190R,A00,189148,Barner; David A.,0,22,80,80
1683348295099,PSYC 191,A00,189275,Rickard; Timothy C.,0,7,25,25
1683348296127,PSYC 193,A00,189276,Chapman; Eddie Nathaniel,0,1,0,4
1683348297161,PSYC 193L,A01,189281,Lowe; Angela Beth,12,0,20,8
1683348297161,PSYC 193L,B01,189285,Staff,28,0,35,7
1683348298184,RELI 149,A00,187137,Rahimi; Babak,7,0,40,33
1683348299207,SE 9,A01,187315,Staff,0,2,18,18
1683348300233,SE 101B,A00,187409,Staff,24,0,30,6
1683348301263,SE 110B,A00,187444,Staff,10,0,40,30
1683348302291,SE 130B,A00,187449,Staff,31,0,40,9
1683348303391,SE 150A,A00,187516,Staff,9,0,20,11
1683348304415,SE 154,A00,187528,Staff,30,0,50,20
1683348305442,SIO 3,A01,258171,Staff,35,0,40,5
1683348306469,SIO 10,A00,187144,Cook; Geoffrey W,0,3,75,75
1683348307497,SIO 45,A00,187152,Cook; Geoffrey W,1,0,100,99
1683348308520,SIO 109R,A00,194486,Staff,0,3,20,20
1683348310576,SIO 187,A01,187233,Kacev; David,12,0,40,28
1683348311601,SOCI 1,A01,258656,Thorpe; Charles Robert,28,0,30,2
1683348311601,SOCI 1,A02,258658,Thorpe; Charles Robert,30,0,30,0
1683348311601,SOCI 1,A03,258661,Thorpe; Charles Robert,25,0,25,0
1683348311601,SOCI 1,A04,258666,Thorpe; Charles Robert,22,0,25,3
1683348311601,SOCI 1,A05,258897,Thorpe; Charles Robert,23,0,25,2
1683348311601,SOCI 1,A06,258898,Thorpe; Charles Robert,25,0,25,0
1683348312624,SOCI 30,A01,258903,Pardo Guerra; Juan Pablo,15,0,30,15
1683348313646,SOCI 102,A00,258904,Staff,9,0,25,16
1683348314670,SOCI 106,A00,258905,Staff,19,0,25,6
1683348315692,SOCI 111,A00,258907,Ribas Norris; Janet Vanesa,26,0,30,4
1683348316717,SOCI 121R,A00,258908,Pardo Guerra; Juan Pablo,10,0,30,20
1683348317742,SOCI 126,A01,203330,Staff,14,0,20,6
1683348318768,SOCI 131,A00,258909,Thorpe; Charles Robert,31,0,60,29
1683348319795,SOCI 135,A00,258910,Payne; Christine Anna,0,9,30,30
1683348320819,SOCI 157,A00,258911,Staff,12,0,30,18
1683348321845,SOCI 184,A00,258912,Staff,25,0,30,5
1683348322869,SOCI 188D,A00,258913,Staff,21,0,30,9
1683348323894,SYN 2,001,187529,Staff,10,0,16,6
1683348323894,SYN 2,002,201452,Staff,0,18,16,16
1683348323894,SYN 2,003,201469,Staff,3,0,16,13
1683348324922,SYN 100,A01,187531,Staff,0,9,20,20
1683348324922,SYN 100,B01,201491,Staff,0,12,20,20
1683348325946,TDAC 1,A00,189286,Walsh; Kim C.,3,0,20,17
1683348325946,TDAC 1,B00,189287,Harting; Carla Kelso,11,0,20,9
1683348326969,TDAC 101,A00,189300,Walsh; Kim C.,16,0,20,4
1683348326969,TDAC 101,B00,189301,Harting; Carla Kelso,18,0,20,2
1683348327993,TDAC 102,A00,189304,Basso; Beatrice,14,0,20,6
1683348329018,TDAC 108,A00,189305,Staff,18,0,20,2
1683348330044,TDDE 131,A00,189310,Staff,19,0,20,1
1683348330044,TDDE 131,B00,189314,Staff,19,0,20,1
1683348330044,TDDE 131,C00,189315,Staff,48,0,50,2
1683348330044,TDDE 131,D00,189316,Staff,14,0,15,1
1683348330044,TDDE 131,E00,204841,Staff,20,0,20,0
1683348331069,TDGE 10,A00,189289,Staff,30,0,50,20
1683348331069,TDGE 10,B00,189290,Havis; Allan,1,0,50,49
1683348332098,TDGE 11,A00,189291,Fulton; Julia,0,3,50,50
1683348332098,TDGE 11,B00,189292,Staff,20,0,25,5
1683348332098,TDGE 11,C00,260270,Staff,0,0,0,0
1683348333124,TDGE 25,A00,189294,Staff,3,0,20,17
1683348334149,TDGE 124,A00,189318,Fulton; Julia,0,8,50,50
1683348335172,TDGE 125,A00,189319,Staff,13,0,25,12
1683348335172,TDGE 125,B00,189320,Staff,23,0,25,2
1683348336196,TDGE 127,A00,189322,Havis; Allan,0,0,50,50
1683348337220,TDHT 101,A00,189323,Staff,18,0,25,7
1683348337220,TDHT 101,B00,189324,Staff,25,0,25,0
1683348338245,TDHT 102,A00,189325,Staff,49,0,50,1
1683348339273,TDMV 1,A00,189295,Arcidiacono; Kristin,19,0,30,11
1683348339273,TDMV 1,B00,189296,Caligagan; Maria T.,24,0,30,6
1683348340296,TDMV 2,A00,189297,Sammartano; Tonnie,28,0,30,2
1683348340296,TDMV 2,B00,189299,Arcidiacono; Kristin,24,0,30,6
1683348341320,TDMV 3,A00,204998,Rincon; Alicia,22,0,30,8
1683348342345,TDMV 120,A00,189458,Sammartano; Tonnie,28,0,30,2
1683348343369,TDMV 138,A00,189541,Jun; Grace Shin Hae,22,0,40,18
1683348344396,TDMV 142,A00,189717,Caligagan; Tony,23,0,30,7
1683348344396,TDMV 142,B00,189718,Caligagan; Maria T.,25,0,30,5
1683348345422,TMC 2,A01,187533,Staff,25,0,25,0
1683348345422,TMC 2,A02,187534,Staff,25,0,25,0
1683348346446,USP 1,A01,187536,Kwak; Nancy,0,16,25,25
1683348347471,USP 5,A01,187538,Staff,10,0,25,15
1683348348496,USP 101,A00,199253,Staff,0,4,0,0
1683348349519,USP 124,A00,187562,Boomhower; Matthew Charles,1,0,30,29
1683348350542,USP 138,A00,187582,Staff,20,0,25,5
1683348351570,USP 152,A01,187597,Staff,4,0,25,21
1683348352594,USP 153,A00,187598,Staff,19,0,25,6
1683348353622,USP 168,A00,187607,Kwak; Nancy,2,0,5,3
1683348354645,USP 173,A00,187619,Staff,4,0,25,21
1683348355669,USP 181,A00,187638,Staff,0,1,25,25
1683348356693,VIS 103,A00,187650,Cruz; Edwin Teddy,22,0,75,53
1683348357717,VIS 110D,A00,187669,Staff,12,0,22,10
1683348358744,VIS 127C,A00,187720,Shen; Kuiyi,67,0,146,79
1683348359769,VIS 149,A00,187731,Yoldas; Pinar,0,14,22,22
1683348360797,VIS 151,A01,188091,Staff,22,0,34,12
1683348360797,VIS 151,A02,188092,Staff,11,0,34,23
1683348361825,VIS 160B,A00,188093,Stalbaum; Brett,0,0,10,10
1683348363879,WCWP 10B,A00,201720,Staff,10,0,15,5
1683348363879,WCWP 10B,B00,201722,Staff,9,0,15,6
1683348364908,WCWP 100,A00,201725,Gagnon; Jeffrey C,0,0,2,2
1683348364908,WCWP 100,B00,201727,Staff,0,4,15,15
1683348367999,ANBI 133,A00,258401,Wilder; Linnea Lorene,34,0,40,6
1683348369029,ANBI 140,A00,258395,Hrvoj Mihic; Branka,18,0,25,7
1683348370053,ANSC 120,A00,258402,Bialecki; Jon Anthony,27,0,40,13
1683348371080,ANSC 144,A00,258400,Staff,14,0,40,26
1683348373133,ANSC 166,A00,258396,Parish; Steven Martin,157,0,175,18
1683348374160,ANSC 180,A00,193533,Staff,9,0,20,11
1683348375187,ANSC 188,A00,258397,Jassal; Aftab,33,0,40,7
1683348376211,ANTH 3,A01,258316,Staff,23,0,30,7
1683348377235,ANTH 5,A00,258394,Semendeferi; Ekaterini,16,0,20,4
1683348378261,ANTH 21,A01,258331,Staff,8,0,40,32
1683348379290,ANTH 103,A00,258398,Varma; Saiba,15,0,25,10
1683348380322,AWP 10,001,202034,Staff,0,0,0,0
1683348380322,AWP 10,002,202035,Staff,0,0,0,0
1683348380322,AWP 10,003,202036,Staff,0,0,0,0
1683348380322,AWP 10,004,202037,Staff,0,0,0,0
1683348380322,AWP 10,005,202038,Staff,0,0,0,0
1683348380322,AWP 10,006,202039,Staff,0,0,0,0
1683348380322,AWP 10,007,202040,Staff,0,0,0,0
1683348380322,AWP 10,008,202041,Staff,0,0,0,0
1683348380322,AWP 10,009,202042,Staff,0,0,0,0
1683348380322,AWP 10,010,202043,Staff,0,0,0,0
1683348380322,AWP 10,011,202044,Staff,0,0,0,0
1683348380322,AWP 10,012,202045,Staff,0,0,0,0
1683348380322,AWP 10,013,202046,Staff,0,0,0,0
1683348380322,AWP 10,014,202047,Staff,0,0,0,0
1683348380322,AWP 10,015,202048,Staff,0,0,0,0
1683348380322,AWP 10,016,202049,Staff,0,0,0,0
1683348380322,AWP 10,017,202050,Staff,0,0,0,0
1683348380322,AWP 10,018,202051,Staff,0,0,0,0
1683348380322,AWP 10,019,202052,Staff,0,0,0,0
1683348380322,AWP 10,020,202053,Staff,0,0,0,0
1683348380322,AWP 10,021,202054,Staff,0,0,0,0
1683348380322,AWP 10,022,202055,Staff,0,0,0,0
1683348380322,AWP 10,023,202056,Staff,0,0,0,0
1683348380322,AWP 10,024,202057,Staff,0,0,0,0
1683348380322,AWP 10,025,202058,Staff,0,0,0,0
1683348380322,AWP 10,026,202059,Staff,0,0,0,0
1683348381345,AWP 102,001,202032,Staff,0,0,0,0
1683348381345,AWP 102,002,202033,Staff,0,0,0,0
1683348382374,BENG 100,A01,254234,Taylor Amos; Alyssa C,31,0,40,9
1683348383400,BENG 196,001,270013,Engler; Adam J.,9999,0,9999,0
1683348384430,BICD 100R,A01,202018,Smith; Laurie,0,7,32,32
1683348384430,BICD 100R,A02,202019,Smith; Laurie,0,2,32,32
1683348384430,BICD 100R,A03,202020,Smith; Laurie,0,1,32,32
1683348384430,BICD 100R,A04,202021,Smith; Laurie,9,0,32,23
1683348384430,BICD 100R,A05,202022,Smith; Laurie,12,0,32,20
1683348385458,BICD 136,A01,193242,Gustafson-Brown; Cindy,0,2,32,32
1683348385458,BICD 136,A02,193244,Gustafson-Brown; Cindy,14,0,32,18
1683348386484,BIEB 102,A01,193249,Butler; Shannon Rhey,0,2,32,32
1683348386484,BIEB 102,A02,193251,Butler; Shannon Rhey,0,0,32,32
1683348386484,BIEB 102,A03,193253,Butler; Shannon Rhey,0,1,32,32
1683348386484,BIEB 102,A04,193255,Butler; Shannon Rhey,17,0,32,15
1683348386484,BIEB 102,A05,193265,Butler; Shannon Rhey,26,0,32,6
1683348386484,BIEB 102,A06,193269,Butler; Shannon Rhey,16,0,32,16
1683348388534,BIEB 150,A01,193274,Staff,0,0,32,32
1683348388534,BIEB 150,A02,193285,Staff,23,0,32,9
1683348389558,BIEB 194,A00,193286,Kurle; Carolyn M.,22,0,32,10
1683348390587,BILD 1,A01,192291,Staff,16,0,32,16
1683348390587,BILD 1,A02,192292,Staff,30,0,32,2
1683348390587,BILD 1,B01,192520,Reuther; Keefe,0,1,0,0
1683348390587,BILD 1,B02,192532,Reuther; Keefe,0,1,0,0
1683348391617,BILD 3,A01,192556,Butler; Shannon Rhey,0,0,32,32
1683348391617,BILD 3,A02,192581,Butler; Shannon Rhey,5,0,32,27
1683348391617,BILD 3,A03,192611,Butler; Shannon Rhey,23,0,32,9
1683348391617,BILD 3,A04,192612,Butler; Shannon Rhey,25,0,32,7
1683348391617,BILD 3,A05,192613,Butler; Shannon Rhey,27,0,32,5
1683348391617,BILD 3,A06,192679,Butler; Shannon Rhey,27,0,32,5
1683348391617,BILD 3,A07,192682,Butler; Shannon Rhey,22,0,32,10
1683348392654,BILD 4,A01,192836,Reuther; Keefe,0,0,24,24
1683348392654,BILD 4,A02,193044,Reuther; Keefe,4,0,24,20
1683348393684,BILD 10,A01,193142,Gustafson-Brown; Cindy,30,0,32,2
1683348393684,BILD 10,A02,193149,Gustafson-Brown; Cindy,31,0,32,1
1683348394709,BIMM 100,A01,193301,Staff,0,6,32,32
1683348394709,BIMM 100,A02,193312,Staff,0,5,32,32
1683348394709,BIMM 100,A03,193323,Staff,0,8,32,32
1683348395739,BIMM 101,A01,193329,McDonnell; Lisa Marie,0,3,24,24
1683348395739,BIMM 101,A02,193339,McDonnell; Lisa Marie,0,3,24,24
1683348395739,BIMM 101,B01,193354,McDonnell; Lisa Marie,0,3,24,24
1683348395739,BIMM 101,B02,193357,McDonnell; Lisa Marie,0,3,24,24
1683348396765,BIMM 110,A01,193377,Tat; John,0,11,32,32
1683348396765,BIMM 110,A02,193378,Tat; John,1,9,32,31
1683348397792,BIMM 120,A01,206116,Staff,0,0,32,32
1683348397792,BIMM 120,A02,206117,Staff,8,0,32,24
1683348397792,BIMM 120,A03,206121,Staff,21,0,32,11
1683348398817,BIPN 100,A01,193393,Park; Ji Young,0,14,32,32
1683348398817,BIPN 100,A02,193402,Park; Ji Young,0,13,32,32
1683348398817,BIPN 100,A03,193413,Park; Ji Young,0,14,32,32
1683348398817,BIPN 100,A04,193414,Park; Ji Young,0,13,32,32
1683348399846,BIPN 102,A01,193429,Staff,0,0,32,32
1683348399846,BIPN 102,A02,193438,Staff,22,0,32,10
1683348400871,BIPN 106,A01,193450,Reyes Gonzalez; Catalina,0,2,40,40
1683348401897,BIPN 134,A01,193465,Cooke; James Edward,0,0,32,32
1683348401897,BIPN 134,A02,193474,Cooke; James Edward,25,0,32,7
1683348401897,BIPN 134,A03,193485,Cooke; James Edward,29,0,32,3
1683348401897,BIPN 134,A04,193486,Cooke; James Edward,21,0,32,11
1683348401897,BIPN 134,A05,193491,Cooke; James Edward,31,0,32,1
1683348401897,BIPN 134,A06,193501,Cooke; James Edward,30,0,32,2
1683348401897,BIPN 134,A07,193510,Cooke; James Edward,29,0,32,3
1683348403944,BISP 194,A00,222522,Staff,14,0,32,18
1683348404969,CAT 124,A01,202407,Staff,20,0,25,5
1683348405997,CAT 125,A00,202408,Marchisotto; Jennifer Anne,4,0,20,16
1683348407086,CAT 125R,A00,202409,Smith; Lauryn Alissa,0,11,20,20
1683348407086,CAT 125R,B00,202410,Morales; Celeste Georgianna,0,11,20,20
1683348407086,CAT 125R,C00,202411,Irwin; Matthew Joseph,0,10,20,20
1683348408111,CENG 15,A01,204712,Yang; Kesong,0,1,0,0
1683348409141,CENG 114,A00,202070,Jahed Motlagh; Zeinab,5,0,20,15
1683348410165,CGS 105,A00,185477,Wesling; Megan E.,24,0,40,16
1683348411190,CGS 106,A00,185494,Staff,13,0,22,9
1683348412214,CGS 108,A00,185495,Staff,14,0,20,6
1683348413238,CGS 114,A00,185496,Staff,13,0,18,5
1683348414266,CGS 119,A00,185501,Staff,15,0,20,5
1683348415291,CGS 120,A00,185511,Staff,13,0,20,7
1683348416316,CHEM 4,A01,184675,Bussey; Thomas J,96,0,100,4
1683348417340,CHEM 6A,A01,184677,Staff,34,0,60,26
1683348418363,CHEM 6B,A01,184679,Staff,65,0,100,35
1683348419392,CHEM 6C,A01,184681,Bussey; Thomas J,1,0,50,49
1683348419392,CHEM 6C,A02,184682,Bussey; Thomas J,34,0,50,16
1683348420421,CHEM 40A,A01,184684,Albizati; Kim F.,37,0,100,63
1683348421446,CHEM 40B,A01,184686,Albizati; Kim F.,0,20,100,100
1683348422471,CHEM 41B,A01,184690,Staff,52,0,100,48
1683348423496,COGS 3,A01,184715,Boyle; Mary E. T.,0,25,40,40
1683348424525,COGS 14B,A01,185172,Staff,0,15,38,38
1683348425553,COGS 18,A01,184736,Staff,17,0,80,63
1683348426577,COGS 100,A01,184932,Staff,0,5,73,73
1683348427602,COGS 101A,A01,184935,Staff,0,39,30,30
1683348428630,COGS 101B,A01,184944,Staff,0,2,30,30
1683348429657,COGS 101C,A01,184946,Staff,0,12,30,30
1683348430681,COGS 102A,A01,184951,Johnson; Christine M.,2,0,40,38
1683348431706,COGS 107B,A01,184953,Mooshagian; Eric Frederick,0,50,40,40
1683348432730,COGS 118B,A01,184959,Gupta; Anjum,0,48,40,40
1683348433755,COGS 153,A00,184961,Staff,0,15,30,30
1683348434785,COGS 177,A00,184962,Staff,0,20,30,30
1683348435812,COGS 187A,A01,184969,Boyle; Mary E. T.,0,17,40,40
1683348436838,COMM 10,A01,185174,Staff,0,5,25,25
1683348436838,COMM 10,A02,185189,Staff,0,5,25,25
1683348436838,COMM 10,A03,269821,Staff,0,0,0,0
1683348437862,COMM 100B,A01,185475,Staff,0,0,0,2
1683348437862,COMM 100B,A02,185476,Staff,13,0,25,12
1683348438890,COMM 100C,A01,185314,Staff,1,0,25,24
1683348438890,COMM 100C,A02,185327,Staff,19,0,25,6
1683348439917,COMM 110M,A00,185349,Staff,2,0,40,38
1683348440944,COMM 113T,A00,185352,Staff,24,0,40,16
1683348441969,COMM 114I,A00,185353,Staff,33,0,40,7
1683348442995,COMM 131,A00,185354,Staff,19,0,30,11
1683348444020,CSE 8A,A50,185358,Cao; Yingjun,0,46,10,10
1683348445044,CSE 8B,A01,185362,Staff,1,47,50,49
1683348446069,CSE 11,A01,185416,Cao; Yingjun,0,92,10,10
1683348447096,CSE 20,A01,185445,Briones; Jor-el Thomas Caparas,5,0,25,20
1683348448120,CSE 21,A01,185447,Staff,10,0,50,40
1683348449146,CSE 101,A01,185451,Staff,0,13,50,50
1683348449146,CSE 101,B01,185453,Jones; Miles E,0,11,50,50
1683348451196,CSE 141,A01,185458,Eldon; John,20,0,100,80
1683348452223,CSE 141L,A01,185461,Eldon; John,12,0,100,88
1683348453247,CSE 142,A01,185463,Staff,36,0,60,24
1683348453247,CSE 142,B01,201355,Staff,0,7,60,60
1683348454274,CSE 142L,A01,185470,Staff,36,0,60,24
1683348454274,CSE 142L,B01,201417,Staff,0,6,60,60
1683348455301,CSE 190,A00,201433,Staff,32,0,49,17
1683348456329,DOC 1,A01,259136,Strom; Megan C.,7,0,15,8
1683348456329,DOC 1,A02,259137,Strom; Megan C.,14,0,15,1
1683348456329,DOC 1,A03,259138,Strom; Megan C.,14,0,15,1
1683348456329,DOC 1,A04,259139,Strom; Megan C.,14,0,15,1
1683348457357,DOC 100D,A00,259140,Pass; Natalye Joann,16,0,25,9
1683348458386,DSGN 1,A01,184749,Rill; Bryan,0,25,30,30
1683348459410,DSGN 100,A01,185168,Staff,0,2,25,25
1683348460433,ECE 5,A01,185626,Morris; Karcher William,0,10,0,0
1683348461457,ECE 101,A01,185628,Staff,17,0,70,53
1683348462480,ECE 107,A01,185635,Baghdadchi; Saharnaz,0,0,20,20
1683348462480,ECE 107,A02,185638,Baghdadchi; Saharnaz,4,0,20,16
1683348463504,ECE 148,A01,185647,Silberman; Jack,0,0,16,16
1683348464532,ECON 1,A01,185537,Crane; Meredith Helen,54,0,70,16
1683348465559,ECON 3,A01,185549,Crane; Meredith Helen,32,0,70,38
1683348466586,ECON 4,A01,203354,Anderson; John Charles,0,4,10,10
1683348467612,ECON 100A,A01,185574,Staff,0,4,40,40
1683348468639,ECON 100B,A01,185576,Staff,10,22,50,40
1683348469667,ECON 100C,A01,185589,Newhouse; Herbert S,29,0,70,41
1683348470692,ECON 105,A00,185608,Vespa; Emanuel Ignacio,19,0,35,16
1683348471716,ECON 109,A01,185610,Shishkin; Denis,10,0,35,25
1683348472740,ECON 110A,A01,185612,Staff,11,0,40,29
1683348473764,ECON 120A,A01,185615,Staff,20,0,40,20
1683348474789,ECON 120C,A01,185617,Sun; Yixiao,0,21,70,70
1683348475818,ECON 144,A00,203346,Squires; Dale E,3,0,35,32
1683348476846,ECON 171,A01,203349,Newhouse; Herbert S,0,1,35,35
1683348477874,ECON 173A,A01,185621,Toda; Alexis Akira,21,0,35,14
1683348478900,EDS 25,A01,202413,Staff,0,1,0,0
1683348478900,EDS 25,A02,202414,Staff,0,1,0,0
1683348478900,EDS 25,A03,202415,Staff,0,0,0,0
1683348478900,EDS 25,A04,202416,Staff,0,1,0,0
1683348478900,EDS 25,A05,202439,Staff,0,0,0,0
1683348478900,EDS 25,A06,202440,Staff,0,0,0,0
1683348478900,EDS 25,B01,202631,Staff,0,0,0,0
1683348478900,EDS 25,B02,202632,Staff,0,0,0,0
1683348478900,EDS 25,B03,202639,Staff,0,0,0,0
1683348478900,EDS 25,B04,202640,Staff,0,0,0,0
1683348478900,EDS 25,B05,202643,Staff,0,0,0,0
1683348478900,EDS 25,B06,202644,Staff,0,0,0,0
1683348479933,EDS 38,A01,202659,Black; Alison Michelle,24,0,25,1
1683348480960,EDS 115,A00,202652,Staff,18,0,30,12
1683348481985,EDS 125,A00,202649,Staff,14,0,30,16
1683348483009,EDS 126,A01,203332,Staff,30,0,30,0
1683348484035,EDS 139,A00,202838,Staff,16,0,25,9
1683348485061,EDS 146,A01,202655,Staff,14,0,25,11
1683348486090,ENG 15,A00,185667,Staff,0,1,0,0
1683348486090,ENG 15,B00,185672,Staff,0,0,0,0
1683348486090,ENG 15,C00,185675,Staff,0,0,0,0
1683348486090,ENG 15,D00,185682,Staff,0,0,0,0
1683348486090,ENG 15,E00,185684,Staff,0,0,0,0
1683348487126,ETHN 103,A00,185710,Staff,0,4,35,35
1683348488151,ETHN 103A,A00,199228,Man; Simeon S,2,0,9,7
1683348489178,ETHN 109,A00,185711,Staff,18,0,35,17
1683348490203,ETHN 142,A00,185726,Staff,0,4,30,30
1683348491227,ETHN 163J,A00,199229,Man; Simeon S,5,0,8,3
1683348492253,ETHN 168,A00,185727,Staff,8,0,10,2
1683348493277,ETHN 182,A00,185728,Staff,1,0,35,34
1683348494302,ETHN 183,A00,185737,Staff,8,0,18,10
1683348495326,GLBH 111,A01,209361,Burgos; Jose L.,0,0,0,0
1683348497373,HIEU 104,A00,185792,Staff,16,0,20,4
1683348498400,HIEU 115,A00,185800,Staff,1,0,20,19
1683348499426,HIEU 128,A00,185801,Staff,0,7,20,20
1683348500453,HIEU 147,A00,185802,Staff,16,0,20,4
1683348501485,HIEU 154,A00,185823,Staff,12,0,20,8
1683348502519,HILA 102,A00,185826,Staff,13,0,20,7
1683348503545,HILD 2C,A01,185778,Staff,0,12,20,20
1683348504574,HILD 7B,A01,185780,Kwak; Nancy,0,15,32,32
1683348504574,HILD 7B,A02,185781,Kwak; Nancy,0,18,32,32
1683348505598,HILD 30,A01,185791,Staff,14,0,20,6
1683348506622,HISC 119,A00,185830,Golan; Tal,0,9,20,20
1683348507647,HITO 156GS,A00,185831,Patterson; Patrick H.,0,0,0,23
1683348508673,HIUS 103,A00,185832,Man; Simeon S,0,6,20,20
1683348509697,HIUS 117,A00,185836,Kwak; Nancy,2,0,20,18
1683348510781,HIUS 125,A00,185840,Man; Simeon S,0,0,23,23
1683348511808,HIUS 149,A00,185845,Staff,0,0,20,20
1683348512836,HUM 3,A01,185882,Zavodny; Tatiana Sophia,0,7,50,50
1683348512836,HUM 3,B01,185899,Caldwell; Michael Alan,0,18,50,50
1683348513860,HUM 3GS,A00,185900,Patterson; Patrick H.,0,0,0,23
1683348514885,HUM 4,A01,185938,Zroka; Amy Liane,31,0,50,19
1683348514885,HUM 4,B01,185956,Watkins; Eric,0,3,50,50
1683348514885,HUM 4,B02,202209,Watkins; Eric,0,2,50,50
1683348514885,HUM 4,B03,202210,Watkins; Eric,0,2,50,50
1683348515909,HUM 5,A01,185958,West; Geoffrey Scott,3,0,50,47
1683348515909,HUM 5,A02,202215,West; Geoffrey Scott,0,0,50,50
1683348516933,INTL 190,A00,185959,Gagnon; Jeffrey C,0,0,0,9
1683348516933,INTL 190,B00,185960,Lettieri; Michael Joseph,0,0,0,1
1683348517957,JAPN 180,A00,254509,Staff,5,1,30,25
1683348518982,LATI 10,A01,202853,Kennemore; Amy Michelle,4,0,35,31
1683348518982,LATI 10,A02,202854,Kennemore; Amy Michelle,2,0,35,33
1683348518982,LATI 10,A03,270054,Kennemore; Amy Michelle,30,0,30,0
1683348520006,LATI 180,A00,202855,Kennemore; Amy Michelle,11,0,20,9
1683348521031,LAWS 101,A00,201767,Golan; Tal,0,7,40,40
1683348522059,LIFR 1C,A00,185961,Staff,6,0,20,14
1683348523085,LIFR 1CX,A00,185962,Staff,7,0,20,13
1683348524109,LIFR 1D,A00,185963,Staff,9,0,20,11
1683348525137,LIFR 1DX,A00,185964,Staff,9,0,20,11
1683348526164,LIGN 101,A01,186039,Staff,43,0,50,7
1683348527189,LIGN 165,A00,186040,Staff,18,0,50,32
1683348528213,LTCS 108,A00,186041,Staff,6,0,10,4
1683348529236,LTCS 119,A00,186042,Staff,16,0,20,4
1683348530260,LTCS 130,A00,186043,Wesling; Megan E.,15,0,25,10
1683348532316,LTEA 138,A00,186119,Staff,14,0,40,26
1683348533344,LTEN 124,A00,186148,Staff,6,0,25,19
1683348534370,LTEN 178,A00,186149,Staff,7,0,15,8
1683348535397,LTEN 181,A00,186150,Blanco; John D,33,0,40,7
1683348536421,LTWL 120,A00,186160,Staff,20,0,25,5
1683348537444,LTWL 165,A00,186161,Staff,22,0,25,3
1683348538469,LTWR 100,A00,186162,Staff,0,5,15,15
1683348539494,LTWR 102,A00,186163,Doller; Ben,5,0,15,10
1683348540517,MAE 8,A01,186412,Staff,0,0,0,0
1683348541540,MAE 30B,A00,186445,Bahadori; Mohammad Yousef,83,0,100,17
1683348542572,MAE 40,A00,186592,Bewley; Thomas R,9,0,50,41
1683348543600,MAE 101B,A00,186593,Bahadori; Mohammad Yousef,81,0,100,19
1683348544625,MAE 105,A00,186594,Bandaru; Prabhakar,12,0,50,38
1683348545650,MAE 107,A00,186599,Pham; Hieu Tan,0,6,120,120
1683348546677,MAE 148,A01,186660,Silberman; Jack,3,0,16,13
1683348547701,MATH 10A,A01,188095,Staff,1,6,35,34
1683348548727,MATH 10B,A01,188097,Bowers; Adam R.,0,11,30,30
1683348548727,MATH 10B,A02,188099,Bowers; Adam R.,0,11,30,30
1683348548727,MATH 10B,B01,188104,Bowers; Adam R.,0,10,30,30
1683348548727,MATH 10B,B02,188106,Bowers; Adam R.,0,10,30,30
1683348549764,MATH 10C,A01,188111,Staff,0,18,30,30
1683348549764,MATH 10C,A02,188127,Staff,0,17,30,30
1683348549764,MATH 10C,A03,188131,Staff,0,18,30,30
1683348549764,MATH 10C,B01,188218,Staff,18,0,30,12
1683348549764,MATH 10C,B02,188244,Staff,13,0,30,17
1683348549764,MATH 10C,B03,188277,Staff,16,0,30,14
1683348550793,MATH 18,A01,188344,Bach; Quang Tran,18,0,30,12
1683348550793,MATH 18,A02,188345,Bach; Quang Tran,11,0,30,19
1683348550793,MATH 18,B01,188353,Bach; Quang Tran,10,0,30,20
1683348550793,MATH 18,B02,188354,Bach; Quang Tran,20,0,30,10
1683348551821,MATH 20A,A01,188374,Staff,13,0,35,22
1683348552846,MATH 20B,A01,188382,Ohm; Ko Woon,6,0,30,24
1683348552846,MATH 20B,A02,188383,Ohm; Ko Woon,22,0,30,8
1683348552846,MATH 20B,B01,188385,Ohm; Ko Woon,7,0,30,23
1683348552846,MATH 20B,B02,188392,Ohm; Ko Woon,22,0,30,8
1683348553871,MATH 20C,A01,188394,Harel; Guershon,10,0,30,20
1683348553871,MATH 20C,A02,188395,Harel; Guershon,15,0,30,15
1683348553871,MATH 20C,B01,188404,Harel; Guershon,5,0,30,25
1683348553871,MATH 20C,B02,188405,Harel; Guershon,19,0,30,11
1683348554905,MATH 20D,A01,188414,Hammock; Frances H,0,1,30,30
1683348554905,MATH 20D,A02,188415,Hammock; Frances H,3,0,30,27
1683348554905,MATH 20D,B01,188447,Hammock; Frances H,1,0,30,29
1683348554905,MATH 20D,B02,188486,Hammock; Frances H,8,0,30,22
1683348555928,MATH 20E,A01,188649,Staff,21,0,30,9
1683348555928,MATH 20E,A02,188650,Staff,23,0,30,7
1683348555928,MATH 20E,A03,188673,Staff,0,0,30,30
1683348556951,MATH 102,A01,188675,Staff,0,35,35,35
1683348557980,MATH 103B,A01,188681,Staff,3,0,35,32
1683348557980,MATH 103B,B01,188692,Staff,5,0,35,30
1683348559005,MATH 109,A01,188695,Salehi Golsefidy; Alireza,25,0,35,10
1683348559005,MATH 109,A02,188696,Salehi Golsefidy; Alireza,25,0,35,10
1683348560033,MATH 120A,A01,188698,Eggers; John Dietrich,7,0,35,28
1683348561059,MATH 142B,A01,188736,Ioana; Adrian,0,2,30,30
1683348561059,MATH 142B,A02,188741,Ioana; Adrian,1,1,30,29
1683348561059,MATH 142B,A03,188743,Ioana; Adrian,1,3,30,29
1683348562082,MATH 168A,A01,188790,Staff,0,9,35,35
1683348563107,MATH 170A,A01,188803,Nie; Jiawang,0,2,35,35
1683348563107,MATH 170A,A02,188811,Nie; Jiawang,0,0,35,35
1683348563107,MATH 170A,A03,188814,Nie; Jiawang,1,0,35,34
1683348563107,MATH 170A,A04,188815,Nie; Jiawang,13,0,35,22
1683348564131,MATH 193B,A01,188817,Staff,0,0,35,35
1683348564131,MATH 193B,A02,188818,Staff,5,0,35,30
1683348565159,MGT 4,A01,202857,Anderson; John Charles,62,0,80,18
1683348566187,MGT 12,A00,202858,Lindenberger; Wade Douglas,42,0,90,48
1683348567212,MGT 18,A00,202859,Staff,74,0,90,16
1683348568235,MGT 18GS,A00,202860,McKay; Michael J,13,0,28,15
1683348569259,MGT 45,A00,202861,Pecore; Joseph P.,14,0,90,76
1683348570284,MGT 100,A00,202863,Yavorsky; Daniel Ryan,28,0,90,62
1683348571309,MGT 103,A00,202864,Ehrich; Kristine R,1,18,90,89
1683348572335,MGT 112,A00,202865,Ehrich; Kristine R,15,0,90,75
1683348573364,MGT 121A,A00,202868,Staff,0,20,0,0
1683348574388,MGT 131B,A00,202869,Anderson; John Charles,59,0,90,31
1683348575413,MGT 136,A00,202871,Lindenberger; Wade Douglas,84,0,90,6
1683348576437,MGT 164,A00,202873,Staff,0,68,90,91
1683348577463,MGT 164GS,A00,202874,McKay; Mary A,13,0,28,15
1683348578490,MGT 180,A00,202875,Staff,0,50,90,91
1683348579515,MMW 11R,A01,205019,Herbst; Matthew,3,0,30,27
1683348579515,MMW 11R,A02,205026,Herbst; Matthew,29,0,30,1
1683348580545,MMW 15,A01,193512,Chang; Edmond Yi-Teh,0,9,28,28
1683348580545,MMW 15,A02,193513,Chang; Edmond Yi-Teh,0,5,28,28
1683348580545,MMW 15,A03,193514,Chang; Edmond Yi-Teh,0,5,28,28
1683348580545,MMW 15,A04,193515,Chang; Edmond Yi-Teh,0,5,28,28
1683348580545,MMW 15,A05,193516,Chang; Edmond Yi-Teh,0,4,28,28
1683348580545,MMW 15,A06,193517,Chang; Edmond Yi-Teh,0,5,28,28
1683348580545,MMW 15,B01,193519,Chang; Edmond Yi-Teh,0,5,28,28
1683348580545,MMW 15,B02,193520,Chang; Edmond Yi-Teh,0,5,28,28
1683348580545,MMW 15,B03,193521,Chang; Edmond Yi-Teh,0,5,28,28
1683348580545,MMW 15,B04,193522,Chang; Edmond Yi-Teh,0,4,28,28
1683348580545,MMW 15,B05,193523,Chang; Edmond Yi-Teh,0,5,28,28
1683348580545,MMW 15,B06,193524,Chang; Edmond Yi-Teh,0,4,28,28
1683348581571,MMW 122,A01,193526,Rahimi; Babak,0,15,28,28
1683348581571,MMW 122,A02,193527,Rahimi; Babak,0,14,28,28
1683348581571,MMW 122,A03,193528,Rahimi; Babak,0,0,0,0
1683348581571,MMW 122,A04,193529,Rahimi; Babak,0,0,0,0
1683348582596,MUS 1A,A01,186663,Staff,0,20,35,35
1683348583619,MUS 4,A01,186715,Staff,0,12,35,35
1683348584644,MUS 5R,A01,186796,Dubnov; Shlomo,0,17,35,35
1683348585669,MUS 6,A01,186798,Staff,0,4,25,25
1683348586693,MUS 7,A01,186830,Staff,13,0,35,22
1683348587717,MUS 8,A01,186930,Staff,0,26,35,35
1683348588742,MUS 15,A01,186932,Staff,0,16,35,35
1683348588742,MUS 15,B01,186934,Staff,0,15,35,35
1683348589767,MUS 80,A00,186935,Staff,1,0,20,19
1683348589767,MUS 80,B00,186936,Staff,25,0,25,0
1683348590794,NANO 11,A00,204702,Lipomi; Darren John,0,0,0,0
1683348591822,NANO 15,A01,204709,Yang; Kesong,0,1,0,0
1683348592850,NANO 114,A00,202069,Jahed Motlagh; Zeinab,3,0,10,7
1683348593874,PHIL 1,A00,186955,Grush; Rick Scott,32,0,40,8
1683348594898,PHIL 10,A01,186973,Grush; Rick Scott,28,0,35,7
1683348594898,PHIL 10,A02,186974,Grush; Rick Scott,33,0,35,2
1683348595922,PHIL 13,A01,186976,Staff,7,0,35,28
1683348595922,PHIL 13,A02,186977,Staff,16,0,35,19
1683348596946,PHIL 14,A01,186979,Staff,31,0,35,4
1683348596946,PHIL 14,A02,186986,Staff,32,0,35,3
1683348597970,PHIL 28,A01,186988,Staff,16,0,30,14
1683348597970,PHIL 28,A02,186989,Staff,1,0,30,29
1683348597970,PHIL 28,A03,186990,Staff,9,0,30,21
1683348597970,PHIL 28,A04,186991,Staff,26,0,30,4
1683348598995,PHIL 120,A00,186997,Staff,23,0,40,17
1683348600021,PHIL 137,A00,187003,Staff,9,0,40,31
1683348601045,PHIL 150,A00,187015,Staff,47,0,70,23
1683348602068,PHIL 167,A00,187021,Lamey; Andy M.,35,0,40,5
1683348603093,PHIL 174,A01,202226,Staff,17,0,20,3
1683348603093,PHIL 174,A02,202235,Staff,20,0,20,0
1683348604117,PHIL 191A,A00,258918,Staff,0,0,1,1
1683348605141,PHYS 1A,A00,187028,Staff,27,0,60,33
1683348606166,PHYS 1AL,001,187036,Staff,2,0,30,28
1683348606166,PHYS 1AL,002,187049,Staff,18,0,30,12
1683348607193,PHYS 1B,A00,187058,Staff,22,0,60,38
1683348608220,PHYS 1BL,001,187064,Staff,0,0,30,30
1683348608220,PHYS 1BL,002,187070,Staff,5,0,30,25
1683348609244,PHYS 1C,A00,187082,Staff,31,0,120,89
1683348610268,PHYS 1CL,001,187088,Staff,0,9,30,30
1683348610268,PHYS 1CL,002,187089,Staff,0,2,30,30
1683348610268,PHYS 1CL,009,262693,Staff,11,0,30,19
1683348611293,PHYS 2B,A01,187097,Staff,54,0,115,61
1683348612321,PHYS 2C,A01,187099,Staff,67,0,115,48
1683348613349,PHYS 2CL,A01,187101,Staff,5,0,28,23
1683348613349,PHYS 2CL,A02,187102,Staff,15,0,28,13
1683348614429,PHYS 2D,A01,187123,Shotwell; Brian,95,0,115,20
1683348615457,PHYS 4B,A01,187133,Grinstein; Benjamin,35,0,50,15
1683348616483,POLI 10,A00,188819,Staff,0,4,50,50
1683348617507,POLI 11,A00,188827,Staff,43,0,50,7
1683348618532,POLI 13R,A00,188828,Staff,0,1,20,20
1683348619557,POLI 27,A01,188830,Elgin; Samuel Zincke,0,1,70,70
1683348620581,POLI 30,A00,188832,Desposato; Scott,31,0,50,19
1683348621607,POLI 102F,A00,188834,Staff,3,0,40,37
1683348622631,POLI 104A,A00,188852,Staff,14,0,30,16
1683348623654,POLI 104I,A00,188853,Staff,0,6,20,20
1683348624677,POLI 110B,A00,188854,Wiens; David,7,0,20,13
1683348625703,POLI 112A,A00,188855,Wiens; David,5,0,30,25
1683348626729,POLI 117R,A00,188856,Forman; Fonna,0,11,20,20
1683348627753,POLI 118,A00,188857,Ingham; Sean,8,0,20,12
1683348628780,POLI 120G,A00,188858,Staff,9,0,30,21
1683348629806,POLI 131CR,A00,188863,Hoston; Germaine,24,0,50,26
1683348630833,POLI 133,A00,188864,Nellis; Gareth Hb,44,0,50,6
1683348631857,POLI 134D,A00,188865,Desposato; Scott,27,0,30,3
1683348632881,POLI 142A,A00,188871,Gartzke; Erik,22,0,50,28
1683348633905,POLI 142K,A00,188874,Staff,38,0,50,12
1683348634929,POLI 143,A00,188940,Gartzke; Erik,16,0,30,14
1683348635956,POLI 153,A00,188943,Staff,3,0,20,17
1683348636980,POLI 160AA,A00,188944,Staff,11,0,40,29
1683348638007,POLI 170A,A00,188945,Staff,11,0,30,19
1683348640055,PSYC 1,A00,188952,Staff,37,0,90,53
1683348641081,PSYC 2,B00,188953,Staff,19,0,35,16
1683348642105,PSYC 6,A00,188970,Staff,47,0,60,13
1683348643129,PSYC 7,A00,188973,Staff,37,0,45,8
1683348644153,PSYC 60,A01,188980,Rickard; Timothy C.,43,0,60,17
1683348645177,PSYC 70,A01,189001,Steiner; Eric Tomas,23,0,45,22
1683348646201,PSYC 100,A00,189005,Lacefield; Katharine I,0,98,120,120
1683348647228,PSYC 102,A00,189008,Staff,9,0,30,21
1683348648253,PSYC 106,B00,189026,Gorman; Michael R.,34,0,60,26
1683348649283,PSYC 114,B01,189033,Winkielman; Piotr,0,32,30,30
1683348650311,PSYC 131,A00,189036,Anagnostaras; Stephan,0,43,60,60
1683348651338,PSYC 136,A00,189041,Lowe; Angela Beth,0,7,25,25
1683348652366,PSYC 137,A00,189057,Winkielman; Piotr,0,34,25,25
1683348653393,PSYC 144,A00,189107,Wixted; John T,0,7,50,50
1683348655440,PSYC 162,A00,189142,Staff,0,8,85,85
1683348656467,PSYC 172,A00,189144,Gorman; Michael R.,0,7,30,30
1683348658513,PSYC 179,A00,189146,Lacefield; Katharine I,0,84,120,120
1683348659541,PSYC 181,A00,189147,Anagnostaras; Stephan,0,44,90,90
1683348660568,PSYC 190R,A00,189148,Barner; David A.,0,22,80,80
1683348661597,PSYC 191,A00,189275,Rickard; Timothy C.,0,7,25,25
1683348662625,PSYC 193,A00,189276,Chapman; Eddie Nathaniel,0,1,0,4
1683348663653,PSYC 193L,A01,189281,Lowe; Angela Beth,12,0,20,8
1683348663653,PSYC 193L,B01,189285,Staff,28,0,35,7
1683348664679,RELI 149,A00,187137,Rahimi; Babak,7,0,40,33
1683348665704,SE 9,A01,187315,Staff,0,2,18,18
1683348666734,SE 101B,A00,187409,Staff,24,0,30,6
1683348667763,SE 110B,A00,187444,Staff,10,0,40,30
1683348668787,SE 130B,A00,187449,Staff,31,0,40,9
1683348669817,SE 150A,A00,187516,Staff,9,0,20,11
1683348670842,SE 154,A00,187528,Staff,30,0,50,20
1683348671868,SIO 3,A01,258171,Staff,35,0,40,5
1683348672897,SIO 10,A00,187144,Cook; Geoffrey W,0,3,75,75
1683348673922,SIO 45,A00,187152,Cook; Geoffrey W,1,0,100,99
1683348674944,SIO 109R,A00,194486,Staff,0,3,20,20
1683348676995,SIO 187,A01,187233,Kacev; David,12,0,40,28
1683348678022,SOCI 1,A01,258656,Thorpe; Charles Robert,28,0,30,2
1683348678022,SOCI 1,A02,258658,Thorpe; Charles Robert,30,0,30,0
1683348678022,SOCI 1,A03,258661,Thorpe; Charles Robert,25,0,25,0
1683348678022,SOCI 1,A04,258666,Thorpe; Charles Robert,22,0,25,3
1683348678022,SOCI 1,A05,258897,Thorpe; Charles Robert,23,0,25,2
1683348678022,SOCI 1,A06,258898,Thorpe; Charles Robert,25,0,25,0
1683348679050,SOCI 30,A01,258903,Pardo Guerra; Juan Pablo,15,0,30,15
1683348680074,SOCI 102,A00,258904,Staff,9,0,25,16
1683348681098,SOCI 106,A00,258905,Staff,19,0,25,6
1683348682123,SOCI 111,A00,258907,Ribas Norris; Janet Vanesa,26,0,30,4
1683348683146,SOCI 121R,A00,258908,Pardo Guerra; Juan Pablo,10,0,30,20
1683348684172,SOCI 126,A01,203330,Staff,14,0,20,6
1683348685196,SOCI 131,A00,258909,Thorpe; Charles Robert,31,0,60,29
1683348686224,SOCI 135,A00,258910,Payne; Christine Anna,0,9,30,30
1683348687253,SOCI 157,A00,258911,Staff,12,0,30,18
1683348688278,SOCI 184,A00,258912,Staff,25,0,30,5
1683348689303,SOCI 188D,A00,258913,Staff,21,0,30,9
1683348690329,SYN 2,001,187529,Staff,10,0,16,6
1683348690329,SYN 2,002,201452,Staff,0,18,16,16
1683348690329,SYN 2,003,201469,Staff,3,0,16,13
1683348691357,SYN 100,A01,187531,Staff,0,9,20,20
1683348691357,SYN 100,B01,201491,Staff,0,12,20,20
1683348692387,TDAC 1,A00,189286,Walsh; Kim C.,3,0,20,17
1683348692387,TDAC 1,B00,189287,Harting; Carla Kelso,11,0,20,9
1683348693413,TDAC 101,A00,189300,Walsh; Kim C.,16,0,20,4
1683348693413,TDAC 101,B00,189301,Harting; Carla Kelso,18,0,20,2
1683348694437,TDAC 102,A00,189304,Basso; Beatrice,14,0,20,6
1683348695461,TDAC 108,A00,189305,Staff,18,0,20,2
1683348696490,TDDE 131,A00,189310,Staff,19,0,20,1
1683348696490,TDDE 131,B00,189314,Staff,19,0,20,1
1683348696490,TDDE 131,C00,189315,Staff,48,0,50,2
1683348696490,TDDE 131,D00,189316,Staff,14,0,15,1
1683348696490,TDDE 131,E00,204841,Staff,20,0,20,0
1683348697515,TDGE 10,A00,189289,Staff,30,0,50,20
1683348697515,TDGE 10,B00,189290,Havis; Allan,1,0,50,49
1683348698541,TDGE 11,A00,189291,Fulton; Julia,0,3,50,50
1683348698541,TDGE 11,B00,189292,Staff,20,0,25,5
1683348698541,TDGE 11,C00,260270,Staff,0,0,0,0
1683348699566,TDGE 25,A00,189294,Staff,3,0,20,17
1683348700590,TDGE 124,A00,189318,Fulton; Julia,0,8,50,50
1683348701619,TDGE 125,A00,189319,Staff,13,0,25,12
1683348701619,TDGE 125,B00,189320,Staff,23,0,25,2
1683348702644,TDGE 127,A00,189322,Havis; Allan,0,0,50,50
1683348703670,TDHT 101,A00,189323,Staff,18,0,25,7
1683348703670,TDHT 101,B00,189324,Staff,25,0,25,0
1683348704695,TDHT 102,A00,189325,Staff,49,0,50,1
1683348705719,TDMV 1,A00,189295,Arcidiacono; Kristin,19,0,30,11
1683348705719,TDMV 1,B00,189296,Caligagan; Maria T.,24,0,30,6
1683348706747,TDMV 2,A00,189297,Sammartano; Tonnie,28,0,30,2
1683348706747,TDMV 2,B00,189299,Arcidiacono; Kristin,24,0,30,6
1683348707770,TDMV 3,A00,204998,Rincon; Alicia,22,0,30,8
1683348708794,TDMV 120,A00,189458,Sammartano; Tonnie,28,0,30,2
1683348709823,TDMV 138,A00,189541,Jun; Grace Shin Hae,22,0,40,18
1683348710847,TDMV 142,A00,189717,Caligagan; Tony,23,0,30,7
1683348710847,TDMV 142,B00,189718,Caligagan; Maria T.,25,0,30,5
1683348711874,TMC 2,A01,187533,Staff,25,0,25,0
1683348711874,TMC 2,A02,187534,Staff,25,0,25,0
1683348712899,USP 1,A01,187536,Kwak; Nancy,0,16,25,25
1683348713924,USP 5,A01,187538,Staff,10,0,25,15
1683348714948,USP 101,A00,199253,Staff,0,4,0,0
1683348715972,USP 124,A00,187562,Boomhower; Matthew Charles,1,0,30,29
1683348716997,USP 138,A00,187582,Staff,20,0,25,5
1683348718077,USP 152,A01,187597,Staff,4,0,25,21
1683348719101,USP 153,A00,187598,Staff,19,0,25,6
1683348720126,USP 168,A00,187607,Kwak; Nancy,2,0,5,3
1683348721151,USP 173,A00,187619,Staff,4,0,25,21
1683348722175,USP 181,A00,187638,Staff,0,1,25,25
1683348723204,VIS 103,A00,187650,Cruz; Edwin Teddy,22,0,75,53
1683348724228,VIS 110D,A00,187669,Staff,12,0,22,10
1683348725256,VIS 127C,A00,187720,Shen; Kuiyi,67,0,146,79
1683348726283,VIS 149,A00,187731,Yoldas; Pinar,0,14,22,22
1683348727310,VIS 151,A01,188091,Staff,22,0,34,12
1683348727310,VIS 151,A02,188092,Staff,11,0,34,23
1683348728337,VIS 160B,A00,188093,Stalbaum; Brett,0,0,10,10
1683348730385,WCWP 10B,A00,201720,Staff,10,0,15,5
1683348730385,WCWP 10B,B00,201722,Staff,9,0,15,6
1683348731413,WCWP 100,A00,201725,Gagnon; Jeffrey C,0,0,2,2
1683348731413,WCWP 100,B00,201727,Staff,0,4,15,15
1683348734513,ANBI 133,A00,258401,Wilder; Linnea Lorene,34,0,40,6
1683348735542,ANBI 140,A00,258395,Hrvoj Mihic; Branka,18,0,25,7
1683348736569,ANSC 120,A00,258402,Bialecki; Jon Anthony,27,0,40,13
1683348737595,ANSC 144,A00,258400,Staff,14,0,40,26
1683348739642,ANSC 166,A00,258396,Parish; Steven Martin,157,0,175,18
1683348740667,ANSC 180,A00,193533,Staff,9,0,20,11
1683348741695,ANSC 188,A00,258397,Jassal; Aftab,33,0,40,7
1683348742721,ANTH 3,A01,258316,Staff,23,0,30,7
1683348743745,ANTH 5,A00,258394,Semendeferi; Ekaterini,16,0,20,4
1683348744769,ANTH 21,A01,258331,Staff,8,0,40,32
1683348745793,ANTH 103,A00,258398,Varma; Saiba,15,0,25,10
1683348746826,AWP 10,001,202034,Staff,0,0,0,0
1683348746826,AWP 10,002,202035,Staff,0,0,0,0
1683348746826,AWP 10,003,202036,Staff,0,0,0,0
1683348746826,AWP 10,004,202037,Staff,0,0,0,0
1683348746826,AWP 10,005,202038,Staff,0,0,0,0
1683348746826,AWP 10,006,202039,Staff,0,0,0,0
1683348746826,AWP 10,007,202040,Staff,0,0,0,0
1683348746826,AWP 10,008,202041,Staff,0,0,0,0
1683348746826,AWP 10,009,202042,Staff,0,0,0,0
1683348746826,AWP 10,010,202043,Staff,0,0,0,0
1683348746826,AWP 10,011,202044,Staff,0,0,0,0
1683348746826,AWP 10,012,202045,Staff,0,0,0,0
1683348746826,AWP 10,013,202046,Staff,0,0,0,0
1683348746826,AWP 10,014,202047,Staff,0,0,0,0
1683348746826,AWP 10,015,202048,Staff,0,0,0,0
1683348746826,AWP 10,016,202049,Staff,0,0,0,0
1683348746826,AWP 10,017,202050,Staff,0,0,0,0
1683348746826,AWP 10,018,202051,Staff,0,0,0,0
1683348746826,AWP 10,019,202052,Staff,0,0,0,0
1683348746826,AWP 10,020,202053,Staff,0,0,0,0
1683348746826,AWP 10,021,202054,Staff,0,0,0,0
1683348746826,AWP 10,022,202055,Staff,0,0,0,0
1683348746826,AWP 10,023,202056,Staff,0,0,0,0
1683348746826,AWP 10,024,202057,Staff,0,0,0,0
1683348746826,AWP 10,025,202058,Staff,0,0,0,0
1683348746826,AWP 10,026,202059,Staff,0,0,0,0
1683348747854,AWP 102,001,202032,Staff,0,0,0,0
1683348747854,AWP 102,002,202033,Staff,0,0,0,0
1683348748878,BENG 100,A01,254234,Taylor Amos; Alyssa C,31,0,40,9
1683348749902,BENG 196,001,270013,Engler; Adam J.,9999,0,9999,0
1683348750927,BICD 100R,A01,202018,Smith; Laurie,0,7,32,32
1683348750927,BICD 100R,A02,202019,Smith; Laurie,0,2,32,32
1683348750927,BICD 100R,A03,202020,Smith; Laurie,0,1,32,32
1683348750927,BICD 100R,A04,202021,Smith; Laurie,9,0,32,23
1683348750927,BICD 100R,A05,202022,Smith; Laurie,12,0,32,20
1683348751953,BICD 136,A01,193242,Gustafson-Brown; Cindy,0,2,32,32
1683348751953,BICD 136,A02,193244,Gustafson-Brown; Cindy,14,0,32,18
1683348752978,BIEB 102,A01,193249,Butler; Shannon Rhey,0,2,32,32
1683348752978,BIEB 102,A02,193251,Butler; Shannon Rhey,0,0,32,32
1683348752978,BIEB 102,A03,193253,Butler; Shannon Rhey,0,1,32,32
1683348752978,BIEB 102,A04,193255,Butler; Shannon Rhey,17,0,32,15
1683348752978,BIEB 102,A05,193265,Butler; Shannon Rhey,26,0,32,6
1683348752978,BIEB 102,A06,193269,Butler; Shannon Rhey,16,0,32,16
1683348755029,BIEB 150,A01,193274,Staff,0,0,32,32
1683348755029,BIEB 150,A02,193285,Staff,23,0,32,9
1683348756053,BIEB 194,A00,193286,Kurle; Carolyn M.,22,0,32,10
1683348757080,BILD 1,A01,192291,Staff,16,0,32,16
1683348757080,BILD 1,A02,192292,Staff,30,0,32,2
1683348757080,BILD 1,B01,192520,Reuther; Keefe,0,1,0,0
1683348757080,BILD 1,B02,192532,Reuther; Keefe,0,1,0,0
1683348758106,BILD 3,A01,192556,Butler; Shannon Rhey,0,0,32,32
1683348758106,BILD 3,A02,192581,Butler; Shannon Rhey,5,0,32,27
1683348758106,BILD 3,A03,192611,Butler; Shannon Rhey,23,0,32,9
1683348758106,BILD 3,A04,192612,Butler; Shannon Rhey,25,0,32,7
1683348758106,BILD 3,A05,192613,Butler; Shannon Rhey,27,0,32,5
1683348758106,BILD 3,A06,192679,Butler; Shannon Rhey,27,0,32,5
1683348758106,BILD 3,A07,192682,Butler; Shannon Rhey,22,0,32,10
1683348759130,BILD 4,A01,192836,Reuther; Keefe,0,0,24,24
1683348759130,BILD 4,A02,193044,Reuther; Keefe,4,0,24,20
1683348760154,BILD 10,A01,193142,Gustafson-Brown; Cindy,30,0,32,2
1683348760154,BILD 10,A02,193149,Gustafson-Brown; Cindy,31,0,32,1
1683348761177,BIMM 100,A01,193301,Staff,0,6,32,32
1683348761177,BIMM 100,A02,193312,Staff,0,5,32,32
1683348761177,BIMM 100,A03,193323,Staff,0,8,32,32
1683348762203,BIMM 101,A01,193329,McDonnell; Lisa Marie,0,3,24,24
1683348762203,BIMM 101,A02,193339,McDonnell; Lisa Marie,0,3,24,24
1683348762203,BIMM 101,B01,193354,McDonnell; Lisa Marie,0,3,24,24
1683348762203,BIMM 101,B02,193357,McDonnell; Lisa Marie,0,3,24,24
1683348763227,BIMM 110,A01,193377,Tat; John,0,11,32,32
1683348763227,BIMM 110,A02,193378,Tat; John,1,9,32,31
1683348764252,BIMM 120,A01,206116,Staff,0,0,32,32
1683348764252,BIMM 120,A02,206117,Staff,8,0,32,24
1683348764252,BIMM 120,A03,206121,Staff,21,0,32,11
1683348765277,BIPN 100,A01,193393,Park; Ji Young,0,14,32,32
1683348765277,BIPN 100,A02,193402,Park; Ji Young,0,13,32,32
1683348765277,BIPN 100,A03,193413,Park; Ji Young,0,14,32,32
1683348765277,BIPN 100,A04,193414,Park; Ji Young,0,13,32,32
1683348766300,BIPN 102,A01,193429,Staff,0,0,32,32
1683348766300,BIPN 102,A02,193438,Staff,22,0,32,10
1683348767324,BIPN 106,A01,193450,Reyes Gonzalez; Catalina,0,2,40,40
1683348768353,BIPN 134,A01,193465,Cooke; James Edward,0,0,32,32
1683348768353,BIPN 134,A02,193474,Cooke; James Edward,25,0,32,7
1683348768353,BIPN 134,A03,193485,Cooke; James Edward,29,0,32,3
1683348768353,BIPN 134,A04,193486,Cooke; James Edward,21,0,32,11
1683348768353,BIPN 134,A05,193491,Cooke; James Edward,31,0,32,1
1683348768353,BIPN 134,A06,193501,Cooke; James Edward,30,0,32,2
1683348768353,BIPN 134,A07,193510,Cooke; James Edward,29,0,32,3
1683348770403,BISP 194,A00,222522,Staff,14,0,32,18
1683348771427,CAT 124,A01,202407,Staff,20,0,25,5
1683348772449,CAT 125,A00,202408,Marchisotto; Jennifer Anne,4,0,20,16
1683348773475,CAT 125R,A00,202409,Smith; Lauryn Alissa,0,11,20,20
1683348773475,CAT 125R,B00,202410,Morales; Celeste Georgianna,0,11,20,20
1683348773475,CAT 125R,C00,202411,Irwin; Matthew Joseph,0,10,20,20
1683348774502,CENG 15,A01,204712,Yang; Kesong,0,1,0,0
1683348775527,CENG 114,A00,202070,Jahed Motlagh; Zeinab,5,0,20,15
1683348776554,CGS 105,A00,185477,Wesling; Megan E.,24,0,40,16
1683348777579,CGS 106,A00,185494,Staff,13,0,22,9
1683348778602,CGS 108,A00,185495,Staff,14,0,20,6
1683348779639,CGS 114,A00,185496,Staff,13,0,18,5
1683348780664,CGS 119,A00,185501,Staff,15,0,20,5
1683348781692,CGS 120,A00,185511,Staff,13,0,20,7
1683348782717,CHEM 4,A01,184675,Bussey; Thomas J,96,0,100,4
1683348783744,CHEM 6A,A01,184677,Staff,34,0,60,26
1683348784773,CHEM 6B,A01,184679,Staff,65,0,100,35
1683348785802,CHEM 6C,A01,184681,Bussey; Thomas J,1,0,50,49
1683348785802,CHEM 6C,A02,184682,Bussey; Thomas J,34,0,50,16
1683348786828,CHEM 40A,A01,184684,Albizati; Kim F.,37,0,100,63
1683348787853,CHEM 40B,A01,184686,Albizati; Kim F.,0,20,100,100
1683348788883,CHEM 41B,A01,184690,Staff,52,0,100,48
1683348789908,COGS 3,A01,184715,Boyle; Mary E. T.,0,25,40,40
1683348790936,COGS 14B,A01,185172,Staff,0,15,38,38
1683348791961,COGS 18,A01,184736,Staff,17,0,80,63
1683348792988,COGS 100,A01,184932,Staff,0,5,73,73
1683348794018,COGS 101A,A01,184935,Staff,0,39,30,30
1683348795042,COGS 101B,A01,184944,Staff,0,2,30,30
1683348796066,COGS 101C,A01,184946,Staff,0,12,30,30
1683348797092,COGS 102A,A01,184951,Johnson; Christine M.,2,0,40,38
1683348798115,COGS 107B,A01,184953,Mooshagian; Eric Frederick,0,50,40,40
1683348799139,COGS 118B,A01,184959,Gupta; Anjum,0,48,40,40
1683348800164,COGS 153,A00,184961,Staff,0,15,30,30
1683348801188,COGS 177,A00,184962,Staff,0,20,30,30
1683348802212,COGS 187A,A01,184969,Boyle; Mary E. T.,0,17,40,40
1683348803239,COMM 10,A01,185174,Staff,0,5,25,25
1683348803239,COMM 10,A02,185189,Staff,0,5,25,25
1683348803239,COMM 10,A03,269821,Staff,0,0,0,0
1683348804264,COMM 100B,A01,185475,Staff,0,0,0,2
1683348804264,COMM 100B,A02,185476,Staff,13,0,25,12
1683348805289,COMM 100C,A01,185314,Staff,1,0,25,24
1683348805289,COMM 100C,A02,185327,Staff,19,0,25,6
1683348806314,COMM 110M,A00,185349,Staff,2,0,40,38
1683348807338,COMM 113T,A00,185352,Staff,24,0,40,16
1683348808362,COMM 114I,A00,185353,Staff,33,0,40,7
1683348809387,COMM 131,A00,185354,Staff,19,0,30,11
1683348810412,CSE 8A,A50,185358,Cao; Yingjun,0,46,10,10
1683348811435,CSE 8B,A01,185362,Staff,1,47,50,49
1683348812460,CSE 11,A01,185416,Cao; Yingjun,0,92,10,10
1683348813486,CSE 20,A01,185445,Briones; Jor-el Thomas Caparas,5,0,25,20
1683348814513,CSE 21,A01,185447,Staff,10,0,50,40
1683348815539,CSE 101,A01,185451,Staff,0,13,50,50
1683348815539,CSE 101,B01,185453,Jones; Miles E,0,11,50,50
1683348817594,CSE 141,A01,185458,Eldon; John,20,0,100,80
1683348818622,CSE 141L,A01,185461,Eldon; John,12,0,100,88
1683348819646,CSE 142,A01,185463,Staff,36,0,60,24
1683348819646,CSE 142,B01,201355,Staff,0,7,60,60
1683348820675,CSE 142L,A01,185470,Staff,36,0,60,24
1683348820675,CSE 142L,B01,201417,Staff,0,6,60,60
1683348821755,CSE 190,A00,201433,Staff,32,0,49,17
1683348822782,DOC 1,A01,259136,Strom; Megan C.,7,0,15,8
1683348822782,DOC 1,A02,259137,Strom; Megan C.,14,0,15,1
1683348822782,DOC 1,A03,259138,Strom; Megan C.,14,0,15,1
1683348822782,DOC 1,A04,259139,Strom; Megan C.,14,0,15,1
1683348823807,DOC 100D,A00,259140,Pass; Natalye Joann,16,0,25,9
1683348824837,DSGN 1,A01,184749,Rill; Bryan,0,25,30,30
1683348825864,DSGN 100,A01,185168,Staff,0,2,25,25
1683348826892,ECE 5,A01,185626,Morris; Karcher William,0,10,0,0
1683348827921,ECE 101,A01,185628,Staff,17,0,70,53
1683348828944,ECE 107,A01,185635,Baghdadchi; Saharnaz,0,0,20,20
1683348828944,ECE 107,A02,185638,Baghdadchi; Saharnaz,4,0,20,16
1683348829969,ECE 148,A01,185647,Silberman; Jack,0,0,16,16
1683348830994,ECON 1,A01,185537,Crane; Meredith Helen,54,0,70,16
1683348832018,ECON 3,A01,185549,Crane; Meredith Helen,32,0,70,38
1683348833043,ECON 4,A01,203354,Anderson; John Charles,0,4,10,10
1683348834070,ECON 100A,A01,185574,Staff,0,4,40,40
1683348835096,ECON 100B,A01,185576,Staff,10,22,50,40
1683348836124,ECON 100C,A01,185589,Newhouse; Herbert S,29,0,70,41
1683348837150,ECON 105,A00,185608,Vespa; Emanuel Ignacio,19,0,35,16
1683348838176,ECON 109,A01,185610,Shishkin; Denis,10,0,35,25
1683348839205,ECON 110A,A01,185612,Staff,11,0,40,29
1683348840230,ECON 120A,A01,185615,Staff,20,0,40,20
1683348841258,ECON 120C,A01,185617,Sun; Yixiao,0,21,70,70
1683348842282,ECON 144,A00,203346,Squires; Dale E,3,0,35,32
1683348843308,ECON 171,A01,203349,Newhouse; Herbert S,0,1,35,35
1683348844331,ECON 173A,A01,185621,Toda; Alexis Akira,21,0,35,14
1683348845356,EDS 25,A01,202413,Staff,0,1,0,0
1683348845356,EDS 25,A02,202414,Staff,0,1,0,0
1683348845356,EDS 25,A03,202415,Staff,0,0,0,0
1683348845356,EDS 25,A04,202416,Staff,0,1,0,0
1683348845356,EDS 25,A05,202439,Staff,0,0,0,0
1683348845356,EDS 25,A06,202440,Staff,0,0,0,0
1683348845356,EDS 25,B01,202631,Staff,0,0,0,0
1683348845356,EDS 25,B02,202632,Staff,0,0,0,0
1683348845356,EDS 25,B03,202639,Staff,0,0,0,0
1683348845356,EDS 25,B04,202640,Staff,0,0,0,0
1683348845356,EDS 25,B05,202643,Staff,0,0,0,0
1683348845356,EDS 25,B06,202644,Staff,0,0,0,0
1683348846380,EDS 38,A01,202659,Black; Alison Michelle,24,0,25,1
1683348847403,EDS 115,A00,202652,Staff,18,0,30,12
1683348848428,EDS 125,A00,202649,Staff,14,0,30,16
1683348849455,EDS 126,A01,203332,Staff,30,0,30,0
1683348850479,EDS 139,A00,202838,Staff,16,0,25,9
1683348851506,EDS 146,A01,202655,Staff,14,0,25,11
1683348852534,ENG 15,A00,185667,Staff,0,1,0,0
1683348852534,ENG 15,B00,185672,Staff,0,0,0,0
1683348852534,ENG 15,C00,185675,Staff,0,0,0,0
1683348852534,ENG 15,D00,185682,Staff,0,0,0,0
1683348852534,ENG 15,E00,185684,Staff,0,0,0,0
1683348853558,ETHN 103,A00,185710,Staff,0,4,35,35
1683348854583,ETHN 103A,A00,199228,Man; Simeon S,2,0,9,7
1683348855612,ETHN 109,A00,185711,Staff,18,0,35,17
1683348856639,ETHN 142,A00,185726,Staff,0,4,30,30
1683348857662,ETHN 163J,A00,199229,Man; Simeon S,5,0,8,3
1683348858689,ETHN 168,A00,185727,Staff,8,0,10,2
1683348859712,ETHN 182,A00,185728,Staff,1,0,35,34
1683348860735,ETHN 183,A00,185737,Staff,8,0,18,10
1683348861759,GLBH 111,A01,209361,Burgos; Jose L.,0,0,0,0
1683348863809,HIEU 104,A00,185792,Staff,16,0,20,4
1683348864835,HIEU 115,A00,185800,Staff,1,0,20,19
1683348865862,HIEU 128,A00,185801,Staff,0,7,20,20
1683348866888,HIEU 147,A00,185802,Staff,16,0,20,4
1683348867913,HIEU 154,A00,185823,Staff,12,0,20,8
1683348868937,HILA 102,A00,185826,Staff,13,0,20,7
1683348869962,HILD 2C,A01,185778,Staff,0,12,20,20
1683348870990,HILD 7B,A01,185780,Kwak; Nancy,0,15,32,32
1683348870990,HILD 7B,A02,185781,Kwak; Nancy,0,18,32,32
1683348872014,HILD 30,A01,185791,Staff,14,0,20,6
1683348873036,HISC 119,A00,185830,Golan; Tal,0,9,20,20
1683348874061,HITO 156GS,A00,185831,Patterson; Patrick H.,0,0,0,23
1683348875085,HIUS 103,A00,185832,Man; Simeon S,0,6,20,20
1683348876112,HIUS 117,A00,185836,Kwak; Nancy,2,0,20,18
1683348877139,HIUS 125,A00,185840,Man; Simeon S,0,0,23,23
1683348878166,HIUS 149,A00,185845,Staff,0,0,20,20
1683348879191,HUM 3,A01,185882,Zavodny; Tatiana Sophia,0,7,50,50
1683348879191,HUM 3,B01,185899,Caldwell; Michael Alan,0,18,50,50
1683348880217,HUM 3GS,A00,185900,Patterson; Patrick H.,0,0,0,23
1683348881241,HUM 4,A01,185938,Zroka; Amy Liane,31,0,50,19
1683348881241,HUM 4,B01,185956,Watkins; Eric,0,3,50,50
1683348881241,HUM 4,B02,202209,Watkins; Eric,0,2,50,50
1683348881241,HUM 4,B03,202210,Watkins; Eric,0,2,50,50
1683348882268,HUM 5,A01,185958,West; Geoffrey Scott,3,0,50,47
1683348882268,HUM 5,A02,202215,West; Geoffrey Scott,0,0,50,50
1683348883295,INTL 190,A00,185959,Gagnon; Jeffrey C,0,0,0,9
1683348883295,INTL 190,B00,185960,Lettieri; Michael Joseph,0,0,0,1
1683348884322,JAPN 180,A00,254509,Staff,5,1,30,25
1683348885347,LATI 10,A01,202853,Kennemore; Amy Michelle,4,0,35,31
1683348885347,LATI 10,A02,202854,Kennemore; Amy Michelle,2,0,35,33
1683348885347,LATI 10,A03,270054,Kennemore; Amy Michelle,30,0,30,0
1683348886371,LATI 180,A00,202855,Kennemore; Amy Michelle,11,0,20,9
1683348887398,LAWS 101,A00,201767,Golan; Tal,0,7,40,40
1683348888425,LIFR 1C,A00,185961,Staff,6,0,20,14
1683348889451,LIFR 1CX,A00,185962,Staff,7,0,20,13
1683348890477,LIFR 1D,A00,185963,Staff,9,0,20,11
1683348891503,LIFR 1DX,A00,185964,Staff,9,0,20,11
1683348892527,LIGN 101,A01,186039,Staff,43,0,50,7
1683348893551,LIGN 165,A00,186040,Staff,18,0,50,32
1683348894577,LTCS 108,A00,186041,Staff,6,0,10,4
1683348895604,LTCS 119,A00,186042,Staff,16,0,20,4
1683348896628,LTCS 130,A00,186043,Wesling; Megan E.,15,0,25,10
1683348898679,LTEA 138,A00,186119,Staff,14,0,40,26
1683348899703,LTEN 124,A00,186148,Staff,6,0,25,19
1683348900730,LTEN 178,A00,186149,Staff,7,0,15,8
1683348901757,LTEN 181,A00,186150,Blanco; John D,33,0,40,7
1683348902781,LTWL 120,A00,186160,Staff,20,0,25,5
1683348903806,LTWL 165,A00,186161,Staff,22,0,25,3
1683348904830,LTWR 100,A00,186162,Staff,0,5,15,15
1683348905858,LTWR 102,A00,186163,Doller; Ben,5,0,15,10
1683348906886,MAE 8,A01,186412,Staff,0,0,0,0
1683348907911,MAE 30B,A00,186445,Bahadori; Mohammad Yousef,83,0,100,17
1683348908937,MAE 40,A00,186592,Bewley; Thomas R,9,0,50,41
1683348909966,MAE 101B,A00,186593,Bahadori; Mohammad Yousef,81,0,100,19
1683348910996,MAE 105,A00,186594,Bandaru; Prabhakar,12,0,50,38
1683348912021,MAE 107,A00,186599,Pham; Hieu Tan,0,6,120,120
1683348913047,MAE 148,A01,186660,Silberman; Jack,3,0,16,13
1683348914073,MATH 10A,A01,188095,Staff,1,6,35,34
1683348915098,MATH 10B,A01,188097,Bowers; Adam R.,0,11,30,30
1683348915098,MATH 10B,A02,188099,Bowers; Adam R.,0,11,30,30
1683348915098,MATH 10B,B01,188104,Bowers; Adam R.,0,10,30,30
1683348915098,MATH 10B,B02,188106,Bowers; Adam R.,0,10,30,30
1683348916123,MATH 10C,A01,188111,Staff,0,18,30,30
1683348916123,MATH 10C,A02,188127,Staff,0,17,30,30
1683348916123,MATH 10C,A03,188131,Staff,0,18,30,30
1683348916123,MATH 10C,B01,188218,Staff,18,0,30,12
1683348916123,MATH 10C,B02,188244,Staff,13,0,30,17
1683348916123,MATH 10C,B03,188277,Staff,16,0,30,14
1683348917149,MATH 18,A01,188344,Bach; Quang Tran,18,0,30,12
1683348917149,MATH 18,A02,188345,Bach; Quang Tran,11,0,30,19
1683348917149,MATH 18,B01,188353,Bach; Quang Tran,10,0,30,20
1683348917149,MATH 18,B02,188354,Bach; Quang Tran,20,0,30,10
1683348918175,MATH 20A,A01,188374,Staff,13,0,35,22
1683348919203,MATH 20B,A01,188382,Ohm; Ko Woon,6,0,30,24
1683348919203,MATH 20B,A02,188383,Ohm; Ko Woon,22,0,30,8
1683348919203,MATH 20B,B01,188385,Ohm; Ko Woon,7,0,30,23
1683348919203,MATH 20B,B02,188392,Ohm; Ko Woon,22,0,30,8
1683348920227,MATH 20C,A01,188394,Harel; Guershon,10,0,30,20
1683348920227,MATH 20C,A02,188395,Harel; Guershon,15,0,30,15
1683348920227,MATH 20C,B01,188404,Harel; Guershon,5,0,30,25
1683348920227,MATH 20C,B02,188405,Harel; Guershon,19,0,30,11
1683348921256,MATH 20D,A01,188414,Hammock; Frances H,0,1,30,30
1683348921256,MATH 20D,A02,188415,Hammock; Frances H,3,0,30,27
1683348921256,MATH 20D,B01,188447,Hammock; Frances H,1,0,30,29
1683348921256,MATH 20D,B02,188486,Hammock; Frances H,8,0,30,22
1683348922284,MATH 20E,A01,188649,Staff,21,0,30,9
1683348922284,MATH 20E,A02,188650,Staff,23,0,30,7
1683348922284,MATH 20E,A03,188673,Staff,0,0,30,30
1683348923311,MATH 102,A01,188675,Staff,0,35,35,35
1683348924339,MATH 103B,A01,188681,Staff,3,0,35,32
1683348924339,MATH 103B,B01,188692,Staff,5,0,35,30
1683348925418,MATH 109,A01,188695,Salehi Golsefidy; Alireza,25,0,35,10
1683348925418,MATH 109,A02,188696,Salehi Golsefidy; Alireza,25,0,35,10
1683348926441,MATH 120A,A01,188698,Eggers; John Dietrich,7,0,35,28
1683348927464,MATH 142B,A01,188736,Ioana; Adrian,0,2,30,30
1683348927464,MATH 142B,A02,188741,Ioana; Adrian,1,1,30,29
1683348927464,MATH 142B,A03,188743,Ioana; Adrian,1,3,30,29
1683348928493,MATH 168A,A01,188790,Staff,0,9,35,35
1683348929521,MATH 170A,A01,188803,Nie; Jiawang,0,2,35,35
1683348929521,MATH 170A,A02,188811,Nie; Jiawang,0,0,35,35
1683348929521,MATH 170A,A03,188814,Nie; Jiawang,1,0,35,34
1683348929521,MATH 170A,A04,188815,Nie; Jiawang,13,0,35,22
1683348930548,MATH 193B,A01,188817,Staff,0,0,35,35
1683348930548,MATH 193B,A02,188818,Staff,5,0,35,30
1683348931573,MGT 4,A01,202857,Anderson; John Charles,62,0,80,18
1683348932598,MGT 12,A00,202858,Lindenberger; Wade Douglas,42,0,90,48
1683348933626,MGT 18,A00,202859,Staff,74,0,90,16
1683348934651,MGT 18GS,A00,202860,McKay; Michael J,13,0,28,15
1683348935676,MGT 45,A00,202861,Pecore; Joseph P.,14,0,90,76
1683348936700,MGT 100,A00,202863,Yavorsky; Daniel Ryan,28,0,90,62
1683348937727,MGT 103,A00,202864,Ehrich; Kristine R,1,18,90,89
1683348938755,MGT 112,A00,202865,Ehrich; Kristine R,15,0,90,75
1683348939779,MGT 121A,A00,202868,Staff,0,20,0,0
1683348940812,MGT 131B,A00,202869,Anderson; John Charles,59,0,90,31
1683348941840,MGT 136,A00,202871,Lindenberger; Wade Douglas,84,0,90,6
1683348942867,MGT 164,A00,202873,Staff,0,68,90,91
1683348943894,MGT 164GS,A00,202874,McKay; Mary A,13,0,28,15
1683348944919,MGT 180,A00,202875,Staff,0,50,90,91
1683348945943,MMW 11R,A01,205019,Herbst; Matthew,3,0,30,27
1683348945943,MMW 11R,A02,205026,Herbst; Matthew,29,0,30,1
1683348946974,MMW 15,A01,193512,Chang; Edmond Yi-Teh,0,9,28,28
1683348946974,MMW 15,A02,193513,Chang; Edmond Yi-Teh,0,5,28,28
1683348946974,MMW 15,A03,193514,Chang; Edmond Yi-Teh,0,5,28,28
1683348946974,MMW 15,A04,193515,Chang; Edmond Yi-Teh,0,5,28,28
1683348946974,MMW 15,A05,193516,Chang; Edmond Yi-Teh,0,4,28,28
1683348946974,MMW 15,A06,193517,Chang; Edmond Yi-Teh,0,5,28,28
1683348946974,MMW 15,B01,193519,Chang; Edmond Yi-Teh,0,5,28,28
1683348946974,MMW 15,B02,193520,Chang; Edmond Yi-Teh,0,5,28,28
1683348946974,MMW 15,B03,193521,Chang; Edmond Yi-Teh,0,5,28,28
1683348946974,MMW 15,B04,193522,Chang; Edmond Yi-Teh,0,4,28,28
1683348946974,MMW 15,B05,193523,Chang; Edmond Yi-Teh,0,5,28,28
1683348946974,MMW 15,B06,193524,Chang; Edmond Yi-Teh,0,4,28,28
1683348948000,MMW 122,A01,193526,Rahimi; Babak,0,15,28,28
1683348948000,MMW 122,A02,193527,Rahimi; Babak,0,14,28,28
1683348948000,MMW 122,A03,193528,Rahimi; Babak,0,0,0,0
1683348948000,MMW 122,A04,193529,Rahimi; Babak,0,0,0,0
1683348949025,MUS 1A,A01,186663,Staff,0,20,35,35
1683348950052,MUS 4,A01,186715,Staff,0,12,35,35
1683348951085,MUS 5R,A01,186796,Dubnov; Shlomo,0,17,35,35
1683348952113,MUS 6,A01,186798,Staff,0,4,25,25
1683348953137,MUS 7,A01,186830,Staff,13,0,35,22
1683348954162,MUS 8,A01,186930,Staff,0,26,35,35
1683348955188,MUS 15,A01,186932,Staff,0,16,35,35
1683348955188,MUS 15,B01,186934,Staff,0,15,35,35
1683348956216,MUS 80,A00,186935,Staff,1,0,20,19
1683348956216,MUS 80,B00,186936,Staff,25,0,25,0
1683348957241,NANO 11,A00,204702,Lipomi; Darren John,0,0,0,0
1683348958265,NANO 15,A01,204709,Yang; Kesong,0,1,0,0
1683348959295,NANO 114,A00,202069,Jahed Motlagh; Zeinab,3,0,10,7
1683348960319,PHIL 1,A00,186955,Grush; Rick Scott,32,0,40,8
1683348961347,PHIL 10,A01,186973,Grush; Rick Scott,28,0,35,7
1683348961347,PHIL 10,A02,186974,Grush; Rick Scott,33,0,35,2
1683348962373,PHIL 13,A01,186976,Staff,7,0,35,28
1683348962373,PHIL 13,A02,186977,Staff,16,0,35,19
1683348963400,PHIL 14,A01,186979,Staff,31,0,35,4
1683348963400,PHIL 14,A02,186986,Staff,32,0,35,3
1683348964426,PHIL 28,A01,186988,Staff,16,0,30,14
1683348964426,PHIL 28,A02,186989,Staff,1,0,30,29
1683348964426,PHIL 28,A03,186990,Staff,9,0,30,21
1683348964426,PHIL 28,A04,186991,Staff,26,0,30,4
1683348965451,PHIL 120,A00,186997,Staff,23,0,40,17
1683348966475,PHIL 137,A00,187003,Staff,9,0,40,31
1683348967498,PHIL 150,A00,187015,Staff,47,0,70,23
1683348968521,PHIL 167,A00,187021,Lamey; Andy M.,35,0,40,5
1683348969545,PHIL 174,A01,202226,Staff,17,0,20,3
1683348969545,PHIL 174,A02,202235,Staff,20,0,20,0
1683348970570,PHIL 191A,A00,258918,Staff,0,0,1,1
1683348971595,PHYS 1A,A00,187028,Staff,27,0,60,33
1683348972620,PHYS 1AL,001,187036,Staff,2,0,30,28
1683348972620,PHYS 1AL,002,187049,Staff,18,0,30,12
1683348973648,PHYS 1B,A00,187058,Staff,22,0,60,38
1683348974674,PHYS 1BL,001,187064,Staff,0,0,30,30
1683348974674,PHYS 1BL,002,187070,Staff,5,0,30,25
1683348975699,PHYS 1C,A00,187082,Staff,31,0,120,89
1683348976723,PHYS 1CL,001,187088,Staff,0,9,30,30
1683348976723,PHYS 1CL,002,187089,Staff,0,2,30,30
1683348976723,PHYS 1CL,009,262693,Staff,11,0,30,19
1683348977749,PHYS 2B,A01,187097,Staff,54,0,115,61
1683348978776,PHYS 2C,A01,187099,Staff,67,0,115,48
1683348979801,PHYS 2CL,A01,187101,Staff,5,0,28,23
1683348979801,PHYS 2CL,A02,187102,Staff,15,0,28,13
1683348980824,PHYS 2D,A01,187123,Shotwell; Brian,95,0,115,20
1683348981852,PHYS 4B,A01,187133,Grinstein; Benjamin,35,0,50,15
1683348982876,POLI 10,A00,188819,Staff,0,4,50,50
1683348983904,POLI 11,A00,188827,Staff,43,0,50,7
1683348984931,POLI 13R,A00,188828,Staff,0,1,20,20
1683348985958,POLI 27,A01,188830,Elgin; Samuel Zincke,0,1,70,70
1683348986981,POLI 30,A00,188832,Desposato; Scott,31,0,50,19
1683348988005,POLI 102F,A00,188834,Staff,3,0,40,37
1683348989032,POLI 104A,A00,188852,Staff,14,0,30,16
1683348990056,POLI 104I,A00,188853,Staff,0,6,20,20
1683348991082,POLI 110B,A00,188854,Wiens; David,7,0,20,13
1683348992106,POLI 112A,A00,188855,Wiens; David,5,0,30,25
1683348993132,POLI 117R,A00,188856,Forman; Fonna,0,11,20,20
1683348994159,POLI 118,A00,188857,Ingham; Sean,8,0,20,12
1683348995186,POLI 120G,A00,188858,Staff,9,0,30,21
1683348996210,POLI 131CR,A00,188863,Hoston; Germaine,24,0,50,26
1683348997235,POLI 133,A00,188864,Nellis; Gareth Hb,44,0,50,6
1683348998258,POLI 134D,A00,188865,Desposato; Scott,27,0,30,3
1683348999285,POLI 142A,A00,188871,Gartzke; Erik,22,0,50,28
1683349000312,POLI 142K,A00,188874,Staff,38,0,50,12
1683349001336,POLI 143,A00,188940,Gartzke; Erik,16,0,30,14
1683349002358,POLI 153,A00,188943,Staff,3,0,20,17
1683349003382,POLI 160AA,A00,188944,Staff,11,0,40,29
1683349004409,POLI 170A,A00,188945,Staff,11,0,30,19
1683349006462,PSYC 1,A00,188952,Staff,37,0,90,53
1683349007488,PSYC 2,B00,188953,Staff,19,0,35,16
1683349008512,PSYC 6,A00,188970,Staff,47,0,60,13
1683349009540,PSYC 7,A00,188973,Staff,37,0,45,8
1683349010569,PSYC 60,A01,188980,Rickard; Timothy C.,43,0,60,17
1683349011592,PSYC 70,A01,189001,Steiner; Eric Tomas,23,0,45,22
1683349012616,PSYC 100,A00,189005,Lacefield; Katharine I,0,98,120,120
1683349013643,PSYC 102,A00,189008,Staff,9,0,30,21
1683349014671,PSYC 106,B00,189026,Gorman; Michael R.,34,0,60,26
1683349015695,PSYC 114,B01,189033,Winkielman; Piotr,0,32,30,30
1683349016719,PSYC 131,A00,189036,Anagnostaras; Stephan,0,43,60,60
1683349017742,PSYC 136,A00,189041,Lowe; Angela Beth,0,7,25,25
1683349018766,PSYC 137,A00,189057,Winkielman; Piotr,0,34,25,25
1683349019792,PSYC 144,A00,189107,Wixted; John T,0,7,50,50
1683349021846,PSYC 162,A00,189142,Staff,0,8,85,85
1683349022869,PSYC 172,A00,189144,Gorman; Michael R.,0,7,30,30
1683349024917,PSYC 179,A00,189146,Lacefield; Katharine I,0,84,120,120
1683349025943,PSYC 181,A00,189147,Anagnostaras; Stephan,0,44,90,90
1683349026967,PSYC 190R,A00,189148,Barner; David A.,0,22,80,80
1683349027994,PSYC 191,A00,189275,Rickard; Timothy C.,0,7,25,25
1683349029075,PSYC 193,A00,189276,Chapman; Eddie Nathaniel,0,1,0,4
1683349030099,PSYC 193L,A01,189281,Lowe; Angela Beth,12,0,20,8
1683349030099,PSYC 193L,B01,189285,Staff,28,0,35,7
1683349031126,RELI 149,A00,187137,Rahimi; Babak,7,0,40,33
1683349032153,SE 9,A01,187315,Staff,0,2,18,18
1683349033179,SE 101B,A00,187409,Staff,24,0,30,6
1683349034203,SE 110B,A00,187444,Staff,10,0,40,30
1683349035227,SE 130B,A00,187449,Staff,31,0,40,9
1683349036253,SE 150A,A00,187516,Staff,9,0,20,11
1683349037277,SE 154,A00,187528,Staff,30,0,50,20
1683349038302,SIO 3,A01,258171,Staff,35,0,40,5
1683349039329,SIO 10,A00,187144,Cook; Geoffrey W,0,3,75,75
1683349040356,SIO 45,A00,187152,Cook; Geoffrey W,1,0,100,99
1683349041380,SIO 109R,A00,194486,Staff,0,3,20,20
1683349043434,SIO 187,A01,187233,Kacev; David,12,0,40,28
1683349044460,SOCI 1,A01,258656,Thorpe; Charles Robert,28,0,30,2
1683349044460,SOCI 1,A02,258658,Thorpe; Charles Robert,30,0,30,0
1683349044460,SOCI 1,A03,258661,Thorpe; Charles Robert,25,0,25,0
1683349044460,SOCI 1,A04,258666,Thorpe; Charles Robert,22,0,25,3
1683349044460,SOCI 1,A05,258897,Thorpe; Charles Robert,23,0,25,2
1683349044460,SOCI 1,A06,258898,Thorpe; Charles Robert,25,0,25,0
1683349045483,SOCI 30,A01,258903,Pardo Guerra; Juan Pablo,15,0,30,15
1683349046508,SOCI 102,A00,258904,Staff,9,0,25,16
1683349047531,SOCI 106,A00,258905,Staff,19,0,25,6
1683349048555,SOCI 111,A00,258907,Ribas Norris; Janet Vanesa,26,0,30,4
1683349049584,SOCI 121R,A00,258908,Pardo Guerra; Juan Pablo,10,0,30,20
1683349050608,SOCI 126,A01,203330,Staff,14,0,20,6
1683349051635,SOCI 131,A00,258909,Thorpe; Charles Robert,31,0,60,29
1683349052660,SOCI 135,A00,258910,Payne; Christine Anna,0,9,30,30
1683349053685,SOCI 157,A00,258911,Staff,12,0,30,18
1683349054708,SOCI 184,A00,258912,Staff,25,0,30,5
1683349055736,SOCI 188D,A00,258913,Staff,21,0,30,9
1683349056762,SYN 2,001,187529,Staff,10,0,16,6
1683349056762,SYN 2,002,201452,Staff,0,18,16,16
1683349056762,SYN 2,003,201469,Staff,3,0,16,13
1683349057790,SYN 100,A01,187531,Staff,0,9,20,20
1683349057790,SYN 100,B01,201491,Staff,0,12,20,20
1683349058813,TDAC 1,A00,189286,Walsh; Kim C.,3,0,20,17
1683349058813,TDAC 1,B00,189287,Harting; Carla Kelso,11,0,20,9
1683349059839,TDAC 101,A00,189300,Walsh; Kim C.,16,0,20,4
1683349059839,TDAC 101,B00,189301,Harting; Carla Kelso,18,0,20,2
1683349060863,TDAC 102,A00,189304,Basso; Beatrice,14,0,20,6
1683349061891,TDAC 108,A00,189305,Staff,18,0,20,2
1683349062918,TDDE 131,A00,189310,Staff,19,0,20,1
1683349062918,TDDE 131,B00,189314,Staff,19,0,20,1
1683349062918,TDDE 131,C00,189315,Staff,48,0,50,2
1683349062918,TDDE 131,D00,189316,Staff,14,0,15,1
1683349062918,TDDE 131,E00,204841,Staff,20,0,20,0
1683349063944,TDGE 10,A00,189289,Staff,30,0,50,20
1683349063944,TDGE 10,B00,189290,Havis; Allan,1,0,50,49
1683349064971,TDGE 11,A00,189291,Fulton; Julia,0,3,50,50
1683349064971,TDGE 11,B00,189292,Staff,20,0,25,5
1683349064971,TDGE 11,C00,260270,Staff,0,0,0,0
1683349065997,TDGE 25,A00,189294,Staff,3,0,20,17
1683349067020,TDGE 124,A00,189318,Fulton; Julia,0,8,50,50
1683349068045,TDGE 125,A00,189319,Staff,13,0,25,12
1683349068045,TDGE 125,B00,189320,Staff,23,0,25,2
1683349069070,TDGE 127,A00,189322,Havis; Allan,0,0,50,50
1683349070094,TDHT 101,A00,189323,Staff,18,0,25,7
1683349070094,TDHT 101,B00,189324,Staff,25,0,25,0
1683349071120,TDHT 102,A00,189325,Staff,49,0,50,1
1683349072142,TDMV 1,A00,189295,Arcidiacono; Kristin,19,0,30,11
1683349072142,TDMV 1,B00,189296,Caligagan; Maria T.,24,0,30,6
1683349073166,TDMV 2,A00,189297,Sammartano; Tonnie,28,0,30,2
1683349073166,TDMV 2,B00,189299,Arcidiacono; Kristin,24,0,30,6
1683349074191,TDMV 3,A00,204998,Rincon; Alicia,22,0,30,8
1683349075218,TDMV 120,A00,189458,Sammartano; Tonnie,28,0,30,2
1683349076245,TDMV 138,A00,189541,Jun; Grace Shin Hae,22,0,40,18
1683349077271,TDMV 142,A00,189717,Caligagan; Tony,23,0,30,7
1683349077271,TDMV 142,B00,189718,Caligagan; Maria T.,25,0,30,5
1683349078294,TMC 2,A01,187533,Staff,25,0,25,0
1683349078294,TMC 2,A02,187534,Staff,25,0,25,0
1683349079318,USP 1,A01,187536,Kwak; Nancy,0,16,25,25
1683349080346,USP 5,A01,187538,Staff,10,0,25,15
1683349081372,USP 101,A00,199253,Staff,0,4,0,0
1683349082399,USP 124,A00,187562,Boomhower; Matthew Charles,1,0,30,29
1683349083425,USP 138,A00,187582,Staff,20,0,25,5
1683349084448,USP 152,A01,187597,Staff,4,0,25,21
1683349085471,USP 153,A00,187598,Staff,19,0,25,6
1683349086498,USP 168,A00,187607,Kwak; Nancy,2,0,5,3
1683349087521,USP 173,A00,187619,Staff,4,0,25,21
1683349088546,USP 181,A00,187638,Staff,0,1,25,25
1683349089570,VIS 103,A00,187650,Cruz; Edwin Teddy,22,0,75,53
1683349090594,VIS 110D,A00,187669,Staff,12,0,22,10
1683349091618,VIS 127C,A00,187720,Shen; Kuiyi,67,0,146,79
1683349092642,VIS 149,A00,187731,Yoldas; Pinar,0,14,22,22
1683349093669,VIS 151,A01,188091,Staff,22,0,34,12
1683349093669,VIS 151,A02,188092,Staff,11,0,34,23
1683349094694,VIS 160B,A00,188093,Stalbaum; Brett,0,0,10,10
1683349096741,WCWP 10B,A00,201720,Staff,10,0,15,5
1683349096741,WCWP 10B,B00,201722,Staff,9,0,15,6
1683349097765,WCWP 100,A00,201725,Gagnon; Jeffrey C,0,0,2,2
1683349097765,WCWP 100,B00,201727,Staff,0,4,15,15
1683349100854,ANBI 133,A00,258401,Wilder; Linnea Lorene,34,0,40,6
1683349101878,ANBI 140,A00,258395,Hrvoj Mihic; Branka,18,0,25,7
1683349102902,ANSC 120,A00,258402,Bialecki; Jon Anthony,27,0,40,13
1683349103927,ANSC 144,A00,258400,Staff,14,0,40,26
1683349105975,ANSC 166,A00,258396,Parish; Steven Martin,157,0,175,18
1683349106998,ANSC 180,A00,193533,Staff,9,0,20,11
1683349108022,ANSC 188,A00,258397,Jassal; Aftab,33,0,40,7
1683349109050,ANTH 3,A01,258316,Staff,23,0,30,7
1683349110077,ANTH 5,A00,258394,Semendeferi; Ekaterini,16,0,20,4
1683349111101,ANTH 21,A01,258331,Staff,8,0,40,32
1683349112125,ANTH 103,A00,258398,Varma; Saiba,15,0,25,10
1683349113157,AWP 10,001,202034,Staff,0,0,0,0
1683349113157,AWP 10,002,202035,Staff,0,0,0,0
1683349113157,AWP 10,003,202036,Staff,0,0,0,0
1683349113157,AWP 10,004,202037,Staff,0,0,0,0
1683349113157,AWP 10,005,202038,Staff,0,0,0,0
1683349113157,AWP 10,006,202039,Staff,0,0,0,0
1683349113157,AWP 10,007,202040,Staff,0,0,0,0
1683349113157,AWP 10,008,202041,Staff,0,0,0,0
1683349113157,AWP 10,009,202042,Staff,0,0,0,0
1683349113157,AWP 10,010,202043,Staff,0,0,0,0
1683349113157,AWP 10,011,202044,Staff,0,0,0,0
1683349113157,AWP 10,012,202045,Staff,0,0,0,0
1683349113157,AWP 10,013,202046,Staff,0,0,0,0
1683349113157,AWP 10,014,202047,Staff,0,0,0,0
1683349113157,AWP 10,015,202048,Staff,0,0,0,0
1683349113157,AWP 10,016,202049,Staff,0,0,0,0
1683349113157,AWP 10,017,202050,Staff,0,0,0,0
1683349113157,AWP 10,018,202051,Staff,0,0,0,0
1683349113157,AWP 10,019,202052,Staff,0,0,0,0
1683349113157,AWP 10,020,202053,Staff,0,0,0,0
1683349113157,AWP 10,021,202054,Staff,0,0,0,0
1683349113157,AWP 10,022,202055,Staff,0,0,0,0
1683349113157,AWP 10,023,202056,Staff,0,0,0,0
1683349113157,AWP 10,024,202057,Staff,0,0,0,0
1683349113157,AWP 10,025,202058,Staff,0,0,0,0
1683349113157,AWP 10,026,202059,Staff,0,0,0,0
1683349114181,AWP 102,001,202032,Staff,0,0,0,0
1683349114181,AWP 102,002,202033,Staff,0,0,0,0
1683349115208,BENG 100,A01,254234,Taylor Amos; Alyssa C,31,0,40,9
1683349116234,BENG 196,001,270013,Engler; Adam J.,9999,0,9999,0
1683349117257,BICD 100R,A01,202018,Smith; Laurie,0,7,32,32
1683349117257,BICD 100R,A02,202019,Smith; Laurie,0,2,32,32
1683349117257,BICD 100R,A03,202020,Smith; Laurie,0,1,32,32
1683349117257,BICD 100R,A04,202021,Smith; Laurie,9,0,32,23
1683349117257,BICD 100R,A05,202022,Smith; Laurie,12,0,32,20
1683349118284,BICD 136,A01,193242,Gustafson-Brown; Cindy,0,2,32,32
1683349118284,BICD 136,A02,193244,Gustafson-Brown; Cindy,14,0,32,18
1683349119313,BIEB 102,A01,193249,Butler; Shannon Rhey,0,2,32,32
1683349119313,BIEB 102,A02,193251,Butler; Shannon Rhey,0,0,32,32
1683349119313,BIEB 102,A03,193253,Butler; Shannon Rhey,0,1,32,32
1683349119313,BIEB 102,A04,193255,Butler; Shannon Rhey,17,0,32,15
1683349119313,BIEB 102,A05,193265,Butler; Shannon Rhey,26,0,32,6
1683349119313,BIEB 102,A06,193269,Butler; Shannon Rhey,16,0,32,16
1683349121360,BIEB 150,A01,193274,Staff,0,0,32,32
1683349121360,BIEB 150,A02,193285,Staff,23,0,32,9
1683349122384,BIEB 194,A00,193286,Kurle; Carolyn M.,22,0,32,10
1683349123408,BILD 1,A01,192291,Staff,16,0,32,16
1683349123408,BILD 1,A02,192292,Staff,30,0,32,2
1683349123408,BILD 1,B01,192520,Reuther; Keefe,0,1,0,0
1683349123408,BILD 1,B02,192532,Reuther; Keefe,0,1,0,0
1683349124438,BILD 3,A01,192556,Butler; Shannon Rhey,0,0,32,32
1683349124438,BILD 3,A02,192581,Butler; Shannon Rhey,4,0,32,28
1683349124438,BILD 3,A03,192611,Butler; Shannon Rhey,23,0,32,9
1683349124438,BILD 3,A04,192612,Butler; Shannon Rhey,25,0,32,7
1683349124438,BILD 3,A05,192613,Butler; Shannon Rhey,27,0,32,5
1683349124438,BILD 3,A06,192679,Butler; Shannon Rhey,27,0,32,5
1683349124438,BILD 3,A07,192682,Butler; Shannon Rhey,22,0,32,10
1683349125467,BILD 4,A01,192836,Reuther; Keefe,0,0,24,24
1683349125467,BILD 4,A02,193044,Reuther; Keefe,4,0,24,20
1683349126497,BILD 10,A01,193142,Gustafson-Brown; Cindy,30,0,32,2
1683349126497,BILD 10,A02,193149,Gustafson-Brown; Cindy,31,0,32,1
1683349127523,BIMM 100,A01,193301,Staff,0,6,32,32
1683349127523,BIMM 100,A02,193312,Staff,0,5,32,32
1683349127523,BIMM 100,A03,193323,Staff,0,8,32,32
1683349128553,BIMM 101,A01,193329,McDonnell; Lisa Marie,0,3,24,24
1683349128553,BIMM 101,A02,193339,McDonnell; Lisa Marie,0,3,24,24
1683349128553,BIMM 101,B01,193354,McDonnell; Lisa Marie,0,3,24,24
1683349128553,BIMM 101,B02,193357,McDonnell; Lisa Marie,0,3,24,24
1683349129582,BIMM 110,A01,193377,Tat; John,0,11,32,32
1683349129582,BIMM 110,A02,193378,Tat; John,1,9,32,31
1683349130607,BIMM 120,A01,206116,Staff,0,0,32,32
1683349130607,BIMM 120,A02,206117,Staff,8,0,32,24
1683349130607,BIMM 120,A03,206121,Staff,21,0,32,11
1683349131635,BIPN 100,A01,193393,Park; Ji Young,0,14,32,32
1683349131635,BIPN 100,A02,193402,Park; Ji Young,0,13,32,32
1683349131635,BIPN 100,A03,193413,Park; Ji Young,0,14,32,32
1683349131635,BIPN 100,A04,193414,Park; Ji Young,0,13,32,32
1683349132721,BIPN 102,A01,193429,Staff,0,0,32,32
1683349132721,BIPN 102,A02,193438,Staff,22,0,32,10
1683349133748,BIPN 106,A01,193450,Reyes Gonzalez; Catalina,0,2,40,40
1683349134778,BIPN 134,A01,193465,Cooke; James Edward,0,0,32,32
1683349134778,BIPN 134,A02,193474,Cooke; James Edward,25,0,32,7
1683349134778,BIPN 134,A03,193485,Cooke; James Edward,29,0,32,3
1683349134778,BIPN 134,A04,193486,Cooke; James Edward,21,0,32,11
1683349134778,BIPN 134,A05,193491,Cooke; James Edward,31,0,32,1
1683349134778,BIPN 134,A06,193501,Cooke; James Edward,30,0,32,2
1683349134778,BIPN 134,A07,193510,Cooke; James Edward,29,0,32,3
1683349136829,BISP 194,A00,222522,Staff,14,0,32,18
1683349137854,CAT 124,A01,202407,Staff,20,0,25,5
1683349138882,CAT 125,A00,202408,Marchisotto; Jennifer Anne,4,0,20,16
1683349139906,CAT 125R,A00,202409,Smith; Lauryn Alissa,0,11,20,20
1683349139906,CAT 125R,B00,202410,Morales; Celeste Georgianna,0,11,20,20
1683349139906,CAT 125R,C00,202411,Irwin; Matthew Joseph,0,10,20,20
1683349140933,CENG 15,A01,204712,Yang; Kesong,0,1,0,0
1683349141962,CENG 114,A00,202070,Jahed Motlagh; Zeinab,5,0,20,15
1683349142988,CGS 105,A00,185477,Wesling; Megan E.,24,0,40,16
1683349144015,CGS 106,A00,185494,Staff,13,0,22,9
1683349145042,CGS 108,A00,185495,Staff,14,0,20,6
1683349146069,CGS 114,A00,185496,Staff,13,0,18,5
1683349147091,CGS 119,A00,185501,Staff,15,0,20,5
1683349148116,CGS 120,A00,185511,Staff,13,0,20,7
1683349149146,CHEM 4,A01,184675,Bussey; Thomas J,96,0,100,4
1683349150175,CHEM 6A,A01,184677,Staff,34,0,60,26
1683349151199,CHEM 6B,A01,184679,Staff,65,0,100,35
1683349152223,CHEM 6C,A01,184681,Bussey; Thomas J,1,0,50,49
1683349152223,CHEM 6C,A02,184682,Bussey; Thomas J,34,0,50,16
1683349153248,CHEM 40A,A01,184684,Albizati; Kim F.,37,0,100,63
1683349154276,CHEM 40B,A01,184686,Albizati; Kim F.,0,20,100,100
1683349155300,CHEM 41B,A01,184690,Staff,52,0,100,48
1683349156322,COGS 3,A01,184715,Boyle; Mary E. T.,0,25,40,40
1683349157349,COGS 14B,A01,185172,Staff,0,15,38,38
1683349158373,COGS 18,A01,184736,Staff,17,0,80,63
1683349159396,COGS 100,A01,184932,Staff,0,5,73,73
1683349160421,COGS 101A,A01,184935,Staff,0,39,30,30
1683349161445,COGS 101B,A01,184944,Staff,0,2,30,30
1683349162473,COGS 101C,A01,184946,Staff,0,12,30,30
1683349163497,COGS 102A,A01,184951,Johnson; Christine M.,2,0,40,38
1683349164526,COGS 107B,A01,184953,Mooshagian; Eric Frederick,0,50,40,40
1683349165549,COGS 118B,A01,184959,Gupta; Anjum,0,48,40,40
1683349166577,COGS 153,A00,184961,Staff,0,15,30,30
1683349167605,COGS 177,A00,184962,Staff,0,20,30,30
1683349168630,COGS 187A,A01,184969,Boyle; Mary E. T.,0,17,40,40
1683349169655,COMM 10,A01,185174,Staff,0,5,25,25
1683349169655,COMM 10,A02,185189,Staff,0,5,25,25
1683349169655,COMM 10,A03,269821,Staff,0,0,0,0
1683349170684,COMM 100B,A01,185475,Staff,0,0,0,2
1683349170684,COMM 100B,A02,185476,Staff,13,0,25,12
1683349171712,COMM 100C,A01,185314,Staff,1,0,25,24
1683349171712,COMM 100C,A02,185327,Staff,19,0,25,6
1683349172735,COMM 110M,A00,185349,Staff,2,0,40,38
1683349173759,COMM 113T,A00,185352,Staff,24,0,40,16
1683349174786,COMM 114I,A00,185353,Staff,33,0,40,7
1683349175809,COMM 131,A00,185354,Staff,19,0,30,11
1683349176836,CSE 8A,A50,185358,Cao; Yingjun,0,46,10,10
1683349177860,CSE 8B,A01,185362,Staff,1,47,50,49
1683349178887,CSE 11,A01,185416,Cao; Yingjun,0,92,10,10
1683349179911,CSE 20,A01,185445,Briones; Jor-el Thomas Caparas,5,0,25,20
1683349180935,CSE 21,A01,185447,Staff,10,0,50,40
1683349181961,CSE 101,A01,185451,Staff,0,13,50,50
1683349181961,CSE 101,B01,185453,Jones; Miles E,0,11,50,50
1683349184035,CSE 141,A01,185458,Eldon; John,20,0,100,80
1683349185058,CSE 141L,A01,185461,Eldon; John,12,0,100,88
1683349186082,CSE 142,A01,185463,Staff,36,0,60,24
1683349186082,CSE 142,B01,201355,Staff,0,7,60,60
1683349187107,CSE 142L,A01,185470,Staff,36,0,60,24
1683349187107,CSE 142L,B01,201417,Staff,0,6,60,60
1683349188131,CSE 190,A00,201433,Staff,32,0,49,17
1683349189159,DOC 1,A01,259136,Strom; Megan C.,7,0,15,8
1683349189159,DOC 1,A02,259137,Strom; Megan C.,14,0,15,1
1683349189159,DOC 1,A03,259138,Strom; Megan C.,14,0,15,1
1683349189159,DOC 1,A04,259139,Strom; Megan C.,14,0,15,1
1683349190182,DOC 100D,A00,259140,Pass; Natalye Joann,16,0,25,9
1683349191211,DSGN 1,A01,184749,Rill; Bryan,0,25,30,30
1683349192235,DSGN 100,A01,185168,Staff,0,2,25,25
1683349193260,ECE 5,A01,185626,Morris; Karcher William,0,10,0,0
1683349194285,ECE 101,A01,185628,Staff,17,0,70,53
1683349195310,ECE 107,A01,185635,Baghdadchi; Saharnaz,0,0,20,20
1683349195310,ECE 107,A02,185638,Baghdadchi; Saharnaz,4,0,20,16
1683349196334,ECE 148,A01,185647,Silberman; Jack,0,0,16,16
1683349197359,ECON 1,A01,185537,Crane; Meredith Helen,54,0,70,16
1683349198386,ECON 3,A01,185549,Crane; Meredith Helen,32,0,70,38
1683349199413,ECON 4,A01,203354,Anderson; John Charles,0,4,10,10
1683349200439,ECON 100A,A01,185574,Staff,0,4,40,40
1683349201464,ECON 100B,A01,185576,Staff,10,22,50,40
1683349202489,ECON 100C,A01,185589,Newhouse; Herbert S,29,0,70,41
1683349203512,ECON 105,A00,185608,Vespa; Emanuel Ignacio,19,0,35,16
1683349204540,ECON 109,A01,185610,Shishkin; Denis,10,0,35,25
1683349205567,ECON 110A,A01,185612,Staff,11,0,40,29
1683349206591,ECON 120A,A01,185615,Staff,20,0,40,20
1683349207615,ECON 120C,A01,185617,Sun; Yixiao,0,21,70,70
1683349208642,ECON 144,A00,203346,Squires; Dale E,3,0,35,32
1683349209671,ECON 171,A01,203349,Newhouse; Herbert S,0,1,35,35
1683349210696,ECON 173A,A01,185621,Toda; Alexis Akira,21,0,35,14
1683349211726,EDS 25,A01,202413,Staff,0,1,0,0
1683349211726,EDS 25,A02,202414,Staff,0,1,0,0
1683349211726,EDS 25,A03,202415,Staff,0,0,0,0
1683349211726,EDS 25,A04,202416,Staff,0,1,0,0
1683349211726,EDS 25,A05,202439,Staff,0,0,0,0
1683349211726,EDS 25,A06,202440,Staff,0,0,0,0
1683349211726,EDS 25,B01,202631,Staff,0,0,0,0
1683349211726,EDS 25,B02,202632,Staff,0,0,0,0
1683349211726,EDS 25,B03,202639,Staff,0,0,0,0
1683349211726,EDS 25,B04,202640,Staff,0,0,0,0
1683349211726,EDS 25,B05,202643,Staff,0,0,0,0
1683349211726,EDS 25,B06,202644,Staff,0,0,0,0
1683349212751,EDS 38,A01,202659,Black; Alison Michelle,24,0,25,1
1683349213773,EDS 115,A00,202652,Staff,18,0,30,12
1683349214797,EDS 125,A00,202649,Staff,14,0,30,16
1683349215821,EDS 126,A01,203332,Staff,30,0,30,0
1683349216844,EDS 139,A00,202838,Staff,16,0,25,9
1683349217870,EDS 146,A01,202655,Staff,14,0,25,11
1683349218898,ENG 15,A00,185667,Staff,0,1,0,0
1683349218898,ENG 15,B00,185672,Staff,0,0,0,0
1683349218898,ENG 15,C00,185675,Staff,0,0,0,0
1683349218898,ENG 15,D00,185682,Staff,0,0,0,0
1683349218898,ENG 15,E00,185684,Staff,0,0,0,0
1683349219924,ETHN 103,A00,185710,Staff,0,4,35,35
1683349220947,ETHN 103A,A00,199228,Man; Simeon S,2,0,9,7
1683349221971,ETHN 109,A00,185711,Staff,18,0,35,17
1683349222994,ETHN 142,A00,185726,Staff,0,4,30,30
1683349224021,ETHN 163J,A00,199229,Man; Simeon S,5,0,8,3
1683349225048,ETHN 168,A00,185727,Staff,8,0,10,2
1683349226074,ETHN 182,A00,185728,Staff,1,0,35,34
1683349227100,ETHN 183,A00,185737,Staff,8,0,18,10
1683349228123,GLBH 111,A01,209361,Burgos; Jose L.,0,0,0,0
1683349230172,HIEU 104,A00,185792,Staff,16,0,20,4
1683349231195,HIEU 115,A00,185800,Staff,1,0,20,19
1683349232219,HIEU 128,A00,185801,Staff,0,7,20,20
1683349233245,HIEU 147,A00,185802,Staff,16,0,20,4
1683349234271,HIEU 154,A00,185823,Staff,12,0,20,8
1683349235296,HILA 102,A00,185826,Staff,13,0,20,7
1683349236380,HILD 2C,A01,185778,Staff,0,12,20,20
1683349237404,HILD 7B,A01,185780,Kwak; Nancy,0,15,32,32
1683349237404,HILD 7B,A02,185781,Kwak; Nancy,0,18,32,32
1683349238428,HILD 30,A01,185791,Staff,14,0,20,6
1683349239456,HISC 119,A00,185830,Golan; Tal,0,9,20,20
1683349240482,HITO 156GS,A00,185831,Patterson; Patrick H.,0,0,0,23
1683349241509,HIUS 103,A00,185832,Man; Simeon S,0,6,20,20
1683349242535,HIUS 117,A00,185836,Kwak; Nancy,2,0,20,18
1683349243559,HIUS 125,A00,185840,Man; Simeon S,0,0,23,23
1683349244583,HIUS 149,A00,185845,Staff,0,0,20,20
1683349245607,HUM 3,A01,185882,Zavodny; Tatiana Sophia,0,7,50,50
1683349245607,HUM 3,B01,185899,Caldwell; Michael Alan,0,18,50,50
1683349246630,HUM 3GS,A00,185900,Patterson; Patrick H.,0,0,0,23
1683349247658,HUM 4,A01,185938,Zroka; Amy Liane,31,0,50,19
1683349247658,HUM 4,B01,185956,Watkins; Eric,0,3,50,50
1683349247658,HUM 4,B02,202209,Watkins; Eric,0,2,50,50
1683349247658,HUM 4,B03,202210,Watkins; Eric,0,2,50,50
1683349248685,HUM 5,A01,185958,West; Geoffrey Scott,3,0,50,47
1683349248685,HUM 5,A02,202215,West; Geoffrey Scott,0,0,50,50
1683349249709,INTL 190,A00,185959,Gagnon; Jeffrey C,0,0,0,9
1683349249709,INTL 190,B00,185960,Lettieri; Michael Joseph,0,0,0,1
1683349250735,JAPN 180,A00,254509,Staff,5,1,30,25
1683349251763,LATI 10,A01,202853,Kennemore; Amy Michelle,4,0,35,31
1683349251763,LATI 10,A02,202854,Kennemore; Amy Michelle,2,0,35,33
1683349251763,LATI 10,A03,270054,Kennemore; Amy Michelle,30,0,30,0
1683349252789,LATI 180,A00,202855,Kennemore; Amy Michelle,11,0,20,9
1683349253813,LAWS 101,A00,201767,Golan; Tal,0,7,40,40
1683349254840,LIFR 1C,A00,185961,Staff,6,0,20,14
1683349255863,LIFR 1CX,A00,185962,Staff,7,0,20,13
1683349256889,LIFR 1D,A00,185963,Staff,9,0,20,11
1683349257914,LIFR 1DX,A00,185964,Staff,9,0,20,11
1683349258940,LIGN 101,A01,186039,Staff,43,0,50,7
1683349259964,LIGN 165,A00,186040,Staff,18,0,50,32
1683349260988,LTCS 108,A00,186041,Staff,6,0,10,4
1683349262012,LTCS 119,A00,186042,Staff,16,0,20,4
1683349263039,LTCS 130,A00,186043,Wesling; Megan E.,15,0,25,10
1683349265088,LTEA 138,A00,186119,Staff,14,0,40,26
1683349266113,LTEN 124,A00,186148,Staff,6,0,25,19
1683349267140,LTEN 178,A00,186149,Staff,7,0,15,8
1683349268167,LTEN 181,A00,186150,Blanco; John D,33,0,40,7
1683349269195,LTWL 120,A00,186160,Staff,20,0,25,5
1683349270222,LTWL 165,A00,186161,Staff,22,0,25,3
1683349271250,LTWR 100,A00,186162,Staff,0,5,15,15
1683349272275,LTWR 102,A00,186163,Doller; Ben,5,0,15,10
1683349273301,MAE 8,A01,186412,Staff,0,0,0,0
1683349274329,MAE 30B,A00,186445,Bahadori; Mohammad Yousef,83,0,100,17
1683349275357,MAE 40,A00,186592,Bewley; Thomas R,9,0,50,41
1683349276386,MAE 101B,A00,186593,Bahadori; Mohammad Yousef,81,0,100,19
1683349277415,MAE 105,A00,186594,Bandaru; Prabhakar,12,0,50,38
1683349278441,MAE 107,A00,186599,Pham; Hieu Tan,0,6,120,120
1683349279465,MAE 148,A01,186660,Silberman; Jack,3,0,16,13
1683349280490,MATH 10A,A01,188095,Staff,1,6,35,34
1683349281515,MATH 10B,A01,188097,Bowers; Adam R.,0,11,30,30
1683349281515,MATH 10B,A02,188099,Bowers; Adam R.,0,11,30,30
1683349281515,MATH 10B,B01,188104,Bowers; Adam R.,0,10,30,30
1683349281515,MATH 10B,B02,188106,Bowers; Adam R.,0,10,30,30
1683349282539,MATH 10C,A01,188111,Staff,0,18,30,30
1683349282539,MATH 10C,A02,188127,Staff,0,17,30,30
1683349282539,MATH 10C,A03,188131,Staff,0,18,30,30
1683349282539,MATH 10C,B01,188218,Staff,18,0,30,12
1683349282539,MATH 10C,B02,188244,Staff,13,0,30,17
1683349282539,MATH 10C,B03,188277,Staff,16,0,30,14
1683349283564,MATH 18,A01,188344,Bach; Quang Tran,18,0,30,12
1683349283564,MATH 18,A02,188345,Bach; Quang Tran,11,0,30,19
1683349283564,MATH 18,B01,188353,Bach; Quang Tran,10,0,30,20
1683349283564,MATH 18,B02,188354,Bach; Quang Tran,20,0,30,10
1683349284589,MATH 20A,A01,188374,Staff,13,0,35,22
1683349285615,MATH 20B,A01,188382,Ohm; Ko Woon,6,0,30,24
1683349285615,MATH 20B,A02,188383,Ohm; Ko Woon,22,0,30,8
1683349285615,MATH 20B,B01,188385,Ohm; Ko Woon,7,0,30,23
1683349285615,MATH 20B,B02,188392,Ohm; Ko Woon,22,0,30,8
1683349286642,MATH 20C,A01,188394,Harel; Guershon,10,0,30,20
1683349286642,MATH 20C,A02,188395,Harel; Guershon,15,0,30,15
1683349286642,MATH 20C,B01,188404,Harel; Guershon,5,0,30,25
1683349286642,MATH 20C,B02,188405,Harel; Guershon,19,0,30,11
1683349287673,MATH 20D,A01,188414,Hammock; Frances H,0,1,30,30
1683349287673,MATH 20D,A02,188415,Hammock; Frances H,3,0,30,27
1683349287673,MATH 20D,B01,188447,Hammock; Frances H,1,0,30,29
1683349287673,MATH 20D,B02,188486,Hammock; Frances H,8,0,30,22
1683349288700,MATH 20E,A01,188649,Staff,21,0,30,9
1683349288700,MATH 20E,A02,188650,Staff,23,0,30,7
1683349288700,MATH 20E,A03,188673,Staff,0,0,30,30
1683349289723,MATH 102,A01,188675,Staff,0,35,35,35
1683349290748,MATH 103B,A01,188681,Staff,3,0,35,32
1683349290748,MATH 103B,B01,188692,Staff,5,0,35,30
1683349291775,MATH 109,A01,188695,Salehi Golsefidy; Alireza,25,0,35,10
1683349291775,MATH 109,A02,188696,Salehi Golsefidy; Alireza,25,0,35,10
1683349292803,MATH 120A,A01,188698,Eggers; John Dietrich,7,0,35,28
1683349293831,MATH 142B,A01,188736,Ioana; Adrian,0,2,30,30
1683349293831,MATH 142B,A02,188741,Ioana; Adrian,1,1,30,29
1683349293831,MATH 142B,A03,188743,Ioana; Adrian,1,3,30,29
1683349294856,MATH 168A,A01,188790,Staff,0,9,35,35
1683349295885,MATH 170A,A01,188803,Nie; Jiawang,0,2,35,35
1683349295885,MATH 170A,A02,188811,Nie; Jiawang,0,0,35,35
1683349295885,MATH 170A,A03,188814,Nie; Jiawang,1,0,35,34
1683349295885,MATH 170A,A04,188815,Nie; Jiawang,13,0,35,22
1683349296908,MATH 193B,A01,188817,Staff,0,0,35,35
1683349296908,MATH 193B,A02,188818,Staff,5,0,35,30
1683349297935,MGT 4,A01,202857,Anderson; John Charles,62,0,80,18
1683349298962,MGT 12,A00,202858,Lindenberger; Wade Douglas,42,0,90,48
1683349299987,MGT 18,A00,202859,Staff,74,0,90,16
1683349301013,MGT 18GS,A00,202860,McKay; Michael J,13,0,28,15
1683349302039,MGT 45,A00,202861,Pecore; Joseph P.,14,0,90,76
1683349303067,MGT 100,A00,202863,Yavorsky; Daniel Ryan,28,0,90,62
1683349304092,MGT 103,A00,202864,Ehrich; Kristine R,1,18,90,89
1683349305120,MGT 112,A00,202865,Ehrich; Kristine R,15,0,90,75
1683349306145,MGT 121A,A00,202868,Staff,0,20,0,0
1683349307170,MGT 131B,A00,202869,Anderson; John Charles,59,0,90,31
1683349308197,MGT 136,A00,202871,Lindenberger; Wade Douglas,84,0,90,6
1683349309224,MGT 164,A00,202873,Staff,0,68,90,91
1683349310249,MGT 164GS,A00,202874,McKay; Mary A,13,0,28,15
1683349311273,MGT 180,A00,202875,Staff,0,50,90,91
1683349312299,MMW 11R,A01,205019,Herbst; Matthew,3,0,30,27
1683349312299,MMW 11R,A02,205026,Herbst; Matthew,29,0,30,1
1683349313326,MMW 15,A01,193512,Chang; Edmond Yi-Teh,0,9,28,28
1683349313326,MMW 15,A02,193513,Chang; Edmond Yi-Teh,0,5,28,28
1683349313326,MMW 15,A03,193514,Chang; Edmond Yi-Teh,0,5,28,28
1683349313326,MMW 15,A04,193515,Chang; Edmond Yi-Teh,0,5,28,28
1683349313326,MMW 15,A05,193516,Chang; Edmond Yi-Teh,0,4,28,28
1683349313326,MMW 15,A06,193517,Chang; Edmond Yi-Teh,0,5,28,28
1683349313326,MMW 15,B01,193519,Chang; Edmond Yi-Teh,0,5,28,28
1683349313326,MMW 15,B02,193520,Chang; Edmond Yi-Teh,0,5,28,28
1683349313326,MMW 15,B03,193521,Chang; Edmond Yi-Teh,0,5,28,28
1683349313326,MMW 15,B04,193522,Chang; Edmond Yi-Teh,0,4,28,28
1683349313326,MMW 15,B05,193523,Chang; Edmond Yi-Teh,0,5,28,28
1683349313326,MMW 15,B06,193524,Chang; Edmond Yi-Teh,0,4,28,28
1683349314353,MMW 122,A01,193526,Rahimi; Babak,0,15,28,28
1683349314353,MMW 122,A02,193527,Rahimi; Babak,0,14,28,28
1683349314353,MMW 122,A03,193528,Rahimi; Babak,0,0,0,0
1683349314353,MMW 122,A04,193529,Rahimi; Babak,0,0,0,0
1683349315379,MUS 1A,A01,186663,Staff,0,20,35,35
1683349316403,MUS 4,A01,186715,Staff,0,12,35,35
1683349317430,MUS 5R,A01,186796,Dubnov; Shlomo,0,17,35,35
1683349318458,MUS 6,A01,186798,Staff,0,4,25,25
1683349319483,MUS 7,A01,186830,Staff,13,0,35,22
1683349320511,MUS 8,A01,186930,Staff,0,26,35,35
1683349321539,MUS 15,A01,186932,Staff,0,16,35,35
1683349321539,MUS 15,B01,186934,Staff,0,15,35,35
1683349322567,MUS 80,A00,186935,Staff,1,0,20,19
1683349322567,MUS 80,B00,186936,Staff,25,0,25,0
1683349323591,NANO 11,A00,204702,Lipomi; Darren John,0,0,0,0
1683349324616,NANO 15,A01,204709,Yang; Kesong,0,1,0,0
1683349325641,NANO 114,A00,202069,Jahed Motlagh; Zeinab,3,0,10,7
1683349326666,PHIL 1,A00,186955,Grush; Rick Scott,32,0,40,8
1683349327691,PHIL 10,A01,186973,Grush; Rick Scott,28,0,35,7
1683349327691,PHIL 10,A02,186974,Grush; Rick Scott,33,0,35,2
1683349328717,PHIL 13,A01,186976,Staff,7,0,35,28
1683349328717,PHIL 13,A02,186977,Staff,16,0,35,19
1683349329743,PHIL 14,A01,186979,Staff,31,0,35,4
1683349329743,PHIL 14,A02,186986,Staff,32,0,35,3
1683349330767,PHIL 28,A01,186988,Staff,16,0,30,14
1683349330767,PHIL 28,A02,186989,Staff,1,0,30,29
1683349330767,PHIL 28,A03,186990,Staff,9,0,30,21
1683349330767,PHIL 28,A04,186991,Staff,26,0,30,4
1683349331796,PHIL 120,A00,186997,Staff,23,0,40,17
1683349332821,PHIL 137,A00,187003,Staff,9,0,40,31
1683349333846,PHIL 150,A00,187015,Staff,47,0,70,23
1683349334871,PHIL 167,A00,187021,Lamey; Andy M.,35,0,40,5
1683349335896,PHIL 174,A01,202226,Staff,17,0,20,3
1683349335896,PHIL 174,A02,202235,Staff,20,0,20,0
1683349336923,PHIL 191A,A00,258918,Staff,0,0,1,1
1683349337948,PHYS 1A,A00,187028,Staff,27,0,60,33
1683349338977,PHYS 1AL,001,187036,Staff,2,0,30,28
1683349338977,PHYS 1AL,002,187049,Staff,18,0,30,12
1683349340074,PHYS 1B,A00,187058,Staff,22,0,60,38
1683349341098,PHYS 1BL,001,187064,Staff,0,0,30,30
1683349341098,PHYS 1BL,002,187070,Staff,5,0,30,25
1683349342125,PHYS 1C,A00,187082,Staff,31,0,120,89
1683349343151,PHYS 1CL,001,187088,Staff,0,9,30,30
1683349343151,PHYS 1CL,002,187089,Staff,0,2,30,30
1683349343151,PHYS 1CL,009,262693,Staff,11,0,30,19
1683349344179,PHYS 2B,A01,187097,Staff,54,0,115,61
1683349345202,PHYS 2C,A01,187099,Staff,67,0,115,48
1683349346228,PHYS 2CL,A01,187101,Staff,5,0,28,23
1683349346228,PHYS 2CL,A02,187102,Staff,15,0,28,13
1683349347252,PHYS 2D,A01,187123,Shotwell; Brian,95,0,115,20
1683349348277,PHYS 4B,A01,187133,Grinstein; Benjamin,35,0,50,15
1683349349305,POLI 10,A00,188819,Staff,0,4,50,50
1683349350333,POLI 11,A00,188827,Staff,43,0,50,7
1683349351356,POLI 13R,A00,188828,Staff,0,1,20,20
1683349352384,POLI 27,A01,188830,Elgin; Samuel Zincke,0,1,70,70
1683349353411,POLI 30,A00,188832,Desposato; Scott,31,0,50,19
1683349354437,POLI 102F,A00,188834,Staff,3,0,40,37
1683349355467,POLI 104A,A00,188852,Staff,14,0,30,16
1683349356493,POLI 104I,A00,188853,Staff,0,6,20,20
1683349357520,POLI 110B,A00,188854,Wiens; David,7,0,20,13
1683349358544,POLI 112A,A00,188855,Wiens; David,5,0,30,25
1683349359569,POLI 117R,A00,188856,Forman; Fonna,0,11,20,20
1683349360596,POLI 118,A00,188857,Ingham; Sean,8,0,20,12
1683349361621,POLI 120G,A00,188858,Staff,9,0,30,21
1683349362645,POLI 131CR,A00,188863,Hoston; Germaine,24,0,50,26
1683349363673,POLI 133,A00,188864,Nellis; Gareth Hb,44,0,50,6
1683349364701,POLI 134D,A00,188865,Desposato; Scott,27,0,30,3
1683349365728,POLI 142A,A00,188871,Gartzke; Erik,22,0,50,28
1683349366751,POLI 142K,A00,188874,Staff,38,0,50,12
1683349367778,POLI 143,A00,188940,Gartzke; Erik,16,0,30,14
1683349368803,POLI 153,A00,188943,Staff,3,0,20,17
1683349369828,POLI 160AA,A00,188944,Staff,11,0,40,29
1683349370853,POLI 170A,A00,188945,Staff,11,0,30,19
1683349372902,PSYC 1,A00,188952,Staff,37,0,90,53
1683349373925,PSYC 2,B00,188953,Staff,19,0,35,16
1683349374949,PSYC 6,A00,188970,Staff,47,0,60,13
1683349375974,PSYC 7,A00,188973,Staff,37,0,45,8
1683349376998,PSYC 60,A01,188980,Rickard; Timothy C.,43,0,60,17
1683349378025,PSYC 70,A01,189001,Steiner; Eric Tomas,23,0,45,22
1683349379052,PSYC 100,A00,189005,Lacefield; Katharine I,0,98,120,120
1683349380079,PSYC 102,A00,189008,Staff,9,0,30,21
1683349381109,PSYC 106,B00,189026,Gorman; Michael R.,34,0,60,26
1683349382138,PSYC 114,B01,189033,Winkielman; Piotr,0,32,30,30
1683349383164,PSYC 131,A00,189036,Anagnostaras; Stephan,0,43,60,60
1683349384189,PSYC 136,A00,189041,Lowe; Angela Beth,0,7,25,25
1683349385217,PSYC 137,A00,189057,Winkielman; Piotr,0,34,25,25
1683349386246,PSYC 144,A00,189107,Wixted; John T,0,7,50,50
1683349388297,PSYC 162,A00,189142,Staff,0,8,85,85
1683349389321,PSYC 172,A00,189144,Gorman; Michael R.,0,7,30,30
1683349391374,PSYC 179,A00,189146,Lacefield; Katharine I,0,84,120,120
1683349392398,PSYC 181,A00,189147,Anagnostaras; Stephan,0,44,90,90
1683349393425,PSYC 190R,A00,189148,Barner; David A.,0,22,80,80
1683349394452,PSYC 191,A00,189275,Rickard; Timothy C.,0,7,25,25
1683349395480,PSYC 193,A00,189276,Chapman; Eddie Nathaniel,0,1,0,4
1683349396509,PSYC 193L,A01,189281,Lowe; Angela Beth,12,0,20,8
1683349396509,PSYC 193L,B01,189285,Staff,28,0,35,7
1683349397532,RELI 149,A00,187137,Rahimi; Babak,7,0,40,33
1683349398559,SE 9,A01,187315,Staff,0,2,18,18
1683349399586,SE 101B,A00,187409,Staff,24,0,30,6
1683349400613,SE 110B,A00,187444,Staff,10,0,40,30
1683349401641,SE 130B,A00,187449,Staff,31,0,40,9
1683349402667,SE 150A,A00,187516,Staff,9,0,20,11
1683349403692,SE 154,A00,187528,Staff,30,0,50,20
1683349404717,SIO 3,A01,258171,Staff,35,0,40,5
1683349405742,SIO 10,A00,187144,Cook; Geoffrey W,0,3,75,75
1683349406769,SIO 45,A00,187152,Cook; Geoffrey W,1,0,100,99
1683349407804,SIO 109R,A00,194486,Staff,0,3,20,20
1683349409856,SIO 187,A01,187233,Kacev; David,12,0,40,28
1683349410880,SOCI 1,A01,258656,Thorpe; Charles Robert,28,0,30,2
1683349410880,SOCI 1,A02,258658,Thorpe; Charles Robert,30,0,30,0
1683349410880,SOCI 1,A03,258661,Thorpe; Charles Robert,25,0,25,0
1683349410880,SOCI 1,A04,258666,Thorpe; Charles Robert,22,0,25,3
1683349410880,SOCI 1,A05,258897,Thorpe; Charles Robert,23,0,25,2
1683349410880,SOCI 1,A06,258898,Thorpe; Charles Robert,25,0,25,0
1683349411907,SOCI 30,A01,258903,Pardo Guerra; Juan Pablo,15,0,30,15
1683349412943,SOCI 102,A00,258904,Staff,9,0,25,16
1683349413967,SOCI 106,A00,258905,Staff,19,0,25,6
1683349414991,SOCI 111,A00,258907,Ribas Norris; Janet Vanesa,26,0,30,4
1683349416015,SOCI 121R,A00,258908,Pardo Guerra; Juan Pablo,10,0,30,20
1683349417039,SOCI 126,A01,203330,Staff,14,0,20,6
1683349418063,SOCI 131,A00,258909,Thorpe; Charles Robert,31,0,60,29
1683349419087,SOCI 135,A00,258910,Payne; Christine Anna,0,9,30,30
1683349420111,SOCI 157,A00,258911,Staff,12,0,30,18
1683349421139,SOCI 184,A00,258912,Staff,25,0,30,5
1683349422163,SOCI 188D,A00,258913,Staff,21,0,30,9
1683349423187,SYN 2,001,187529,Staff,10,0,16,6
1683349423187,SYN 2,002,201452,Staff,0,18,16,16
1683349423187,SYN 2,003,201469,Staff,3,0,16,13
1683349424216,SYN 100,A01,187531,Staff,0,9,20,20
1683349424216,SYN 100,B01,201491,Staff,0,12,20,20
1683349425244,TDAC 1,A00,189286,Walsh; Kim C.,3,0,20,17
1683349425244,TDAC 1,B00,189287,Harting; Carla Kelso,11,0,20,9
1683349426268,TDAC 101,A00,189300,Walsh; Kim C.,16,0,20,4
1683349426268,TDAC 101,B00,189301,Harting; Carla Kelso,18,0,20,2
1683349427293,TDAC 102,A00,189304,Basso; Beatrice,14,0,20,6
1683349428318,TDAC 108,A00,189305,Staff,18,0,20,2
1683349429343,TDDE 131,A00,189310,Staff,19,0,20,1
1683349429343,TDDE 131,B00,189314,Staff,19,0,20,1
1683349429343,TDDE 131,C00,189315,Staff,48,0,50,2
1683349429343,TDDE 131,D00,189316,Staff,14,0,15,1
1683349429343,TDDE 131,E00,204841,Staff,20,0,20,0
1683349430368,TDGE 10,A00,189289,Staff,30,0,50,20
1683349430368,TDGE 10,B00,189290,Havis; Allan,1,0,50,49
1683349431398,TDGE 11,A00,189291,Fulton; Julia,0,3,50,50
1683349431398,TDGE 11,B00,189292,Staff,20,0,25,5
1683349431398,TDGE 11,C00,260270,Staff,0,0,0,0
1683349432422,TDGE 25,A00,189294,Staff,3,0,20,17
1683349433446,TDGE 124,A00,189318,Fulton; Julia,0,8,50,50
1683349434474,TDGE 125,A00,189319,Staff,13,0,25,12
1683349434474,TDGE 125,B00,189320,Staff,23,0,25,2
1683349435499,TDGE 127,A00,189322,Havis; Allan,0,0,50,50
1683349436524,TDHT 101,A00,189323,Staff,18,0,25,7
1683349436524,TDHT 101,B00,189324,Staff,25,0,25,0
1683349437548,TDHT 102,A00,189325,Staff,49,0,50,1
1683349438574,TDMV 1,A00,189295,Arcidiacono; Kristin,19,0,30,11
1683349438574,TDMV 1,B00,189296,Caligagan; Maria T.,24,0,30,6
1683349439598,TDMV 2,A00,189297,Sammartano; Tonnie,28,0,30,2
1683349439598,TDMV 2,B00,189299,Arcidiacono; Kristin,24,0,30,6
1683349440621,TDMV 3,A00,204998,Rincon; Alicia,22,0,30,8
1683349441652,TDMV 120,A00,189458,Sammartano; Tonnie,28,0,30,2
1683349442678,TDMV 138,A00,189541,Jun; Grace Shin Hae,22,0,40,18
1683349443764,TDMV 142,A00,189717,Caligagan; Tony,23,0,30,7
1683349443764,TDMV 142,B00,189718,Caligagan; Maria T.,25,0,30,5
1683349444793,TMC 2,A01,187533,Staff,25,0,25,0
1683349444793,TMC 2,A02,187534,Staff,25,0,25,0
1683349445820,USP 1,A01,187536,Kwak; Nancy,0,16,25,25
1683349446844,USP 5,A01,187538,Staff,10,0,25,15
1683349447869,USP 101,A00,199253,Staff,0,4,0,0
1683349448896,USP 124,A00,187562,Boomhower; Matthew Charles,1,0,30,29
1683349449921,USP 138,A00,187582,Staff,20,0,25,5
1683349450949,USP 152,A01,187597,Staff,4,0,25,21
1683349451975,USP 153,A00,187598,Staff,19,0,25,6
1683349453007,USP 168,A00,187607,Kwak; Nancy,2,0,5,3
1683349454035,USP 173,A00,187619,Staff,4,0,25,21
1683349455063,USP 181,A00,187638,Staff,0,1,25,25
1683349456089,VIS 103,A00,187650,Cruz; Edwin Teddy,22,0,75,53
1683349457118,VIS 110D,A00,187669,Staff,12,0,22,10
1683349458141,VIS 127C,A00,187720,Shen; Kuiyi,67,0,146,79
1683349459165,VIS 149,A00,187731,Yoldas; Pinar,0,14,22,22
1683349460193,VIS 151,A01,188091,Staff,22,0,34,12
1683349460193,VIS 151,A02,188092,Staff,11,0,34,23
1683349461220,VIS 160B,A00,188093,Stalbaum; Brett,0,0,10,10
1683349463270,WCWP 10B,A00,201720,Staff,10,0,15,5
1683349463270,WCWP 10B,B00,201722,Staff,9,0,15,6
1683349464294,WCWP 100,A00,201725,Gagnon; Jeffrey C,0,0,2,2
1683349464294,WCWP 100,B00,201727,Staff,0,4,15,15
1683349467389,ANBI 133,A00,258401,Wilder; Linnea Lorene,34,0,40,6
1683349468416,ANBI 140,A00,258395,Hrvoj Mihic; Branka,18,0,25,7
1683349469442,ANSC 120,A00,258402,Bialecki; Jon Anthony,27,0,40,13
1683349470467,ANSC 144,A00,258400,Staff,14,0,40,26
1683349472521,ANSC 166,A00,258396,Parish; Steven Martin,157,0,175,18
1683349473546,ANSC 180,A00,193533,Staff,9,0,20,11
1683349474577,ANSC 188,A00,258397,Jassal; Aftab,33,0,40,7
1683349475605,ANTH 3,A01,258316,Staff,23,0,30,7
1683349476633,ANTH 5,A00,258394,Semendeferi; Ekaterini,16,0,20,4
1683349477661,ANTH 21,A01,258331,Staff,8,0,40,32
1683349478689,ANTH 103,A00,258398,Varma; Saiba,15,0,25,10
1683349479722,AWP 10,001,202034,Staff,0,0,0,0
1683349479722,AWP 10,002,202035,Staff,0,0,0,0
1683349479722,AWP 10,003,202036,Staff,0,0,0,0
1683349479722,AWP 10,004,202037,Staff,0,0,0,0
1683349479722,AWP 10,005,202038,Staff,0,0,0,0
1683349479722,AWP 10,006,202039,Staff,0,0,0,0
1683349479722,AWP 10,007,202040,Staff,0,0,0,0
1683349479722,AWP 10,008,202041,Staff,0,0,0,0
1683349479722,AWP 10,009,202042,Staff,0,0,0,0
1683349479722,AWP 10,010,202043,Staff,0,0,0,0
1683349479722,AWP 10,011,202044,Staff,0,0,0,0
1683349479722,AWP 10,012,202045,Staff,0,0,0,0
1683349479722,AWP 10,013,202046,Staff,0,0,0,0
1683349479722,AWP 10,014,202047,Staff,0,0,0,0
1683349479722,AWP 10,015,202048,Staff,0,0,0,0
1683349479722,AWP 10,016,202049,Staff,0,0,0,0
1683349479722,AWP 10,017,202050,Staff,0,0,0,0
1683349479722,AWP 10,018,202051,Staff,0,0,0,0
1683349479722,AWP 10,019,202052,Staff,0,0,0,0
1683349479722,AWP 10,020,202053,Staff,0,0,0,0
1683349479722,AWP 10,021,202054,Staff,0,0,0,0
1683349479722,AWP 10,022,202055,Staff,0,0,0,0
1683349479722,AWP 10,023,202056,Staff,0,0,0,0
1683349479722,AWP 10,024,202057,Staff,0,0,0,0
1683349479722,AWP 10,025,202058,Staff,0,0,0,0
1683349479722,AWP 10,026,202059,Staff,0,0,0,0
1683349480746,AWP 102,001,202032,Staff,0,0,0,0
1683349480746,AWP 102,002,202033,Staff,0,0,0,0
1683349481772,BENG 100,A01,254234,Taylor Amos; Alyssa C,31,0,40,9
1683349482796,BENG 196,001,270013,Engler; Adam J.,9999,0,9999,0
1683349483822,BICD 100R,A01,202018,Smith; Laurie,0,7,32,32
1683349483822,BICD 100R,A02,202019,Smith; Laurie,0,2,32,32
1683349483822,BICD 100R,A03,202020,Smith; Laurie,0,1,32,32
1683349483822,BICD 100R,A04,202021,Smith; Laurie,9,0,32,23
1683349483822,BICD 100R,A05,202022,Smith; Laurie,12,0,32,20
1683349484847,BICD 136,A01,193242,Gustafson-Brown; Cindy,0,2,32,32
1683349484847,BICD 136,A02,193244,Gustafson-Brown; Cindy,14,0,32,18
1683349485872,BIEB 102,A01,193249,Butler; Shannon Rhey,0,2,32,32
1683349485872,BIEB 102,A02,193251,Butler; Shannon Rhey,0,0,32,32
1683349485872,BIEB 102,A03,193253,Butler; Shannon Rhey,0,1,32,32
1683349485872,BIEB 102,A04,193255,Butler; Shannon Rhey,17,0,32,15
1683349485872,BIEB 102,A05,193265,Butler; Shannon Rhey,26,0,32,6
1683349485872,BIEB 102,A06,193269,Butler; Shannon Rhey,16,0,32,16
1683349487925,BIEB 150,A01,193274,Staff,0,0,32,32
1683349487925,BIEB 150,A02,193285,Staff,23,0,32,9
1683349488952,BIEB 194,A00,193286,Kurle; Carolyn M.,22,0,32,10
1683349489981,BILD 1,A01,192291,Staff,16,0,32,16
1683349489981,BILD 1,A02,192292,Staff,30,0,32,2
1683349489981,BILD 1,B01,192520,Reuther; Keefe,0,1,0,0
1683349489981,BILD 1,B02,192532,Reuther; Keefe,0,1,0,0
1683349491011,BILD 3,A01,192556,Butler; Shannon Rhey,0,0,32,32
1683349491011,BILD 3,A02,192581,Butler; Shannon Rhey,4,0,32,28
1683349491011,BILD 3,A03,192611,Butler; Shannon Rhey,23,0,32,9
1683349491011,BILD 3,A04,192612,Butler; Shannon Rhey,25,0,32,7
1683349491011,BILD 3,A05,192613,Butler; Shannon Rhey,27,0,32,5
1683349491011,BILD 3,A06,192679,Butler; Shannon Rhey,27,0,32,5
1683349491011,BILD 3,A07,192682,Butler; Shannon Rhey,22,0,32,10
1683349492040,BILD 4,A01,192836,Reuther; Keefe,0,0,24,24
1683349492040,BILD 4,A02,193044,Reuther; Keefe,4,0,24,20
1683349493067,BILD 10,A01,193142,Gustafson-Brown; Cindy,30,0,32,2
1683349493067,BILD 10,A02,193149,Gustafson-Brown; Cindy,31,0,32,1
1683349494093,BIMM 100,A01,193301,Staff,0,6,32,32
1683349494093,BIMM 100,A02,193312,Staff,0,5,32,32
1683349494093,BIMM 100,A03,193323,Staff,0,8,32,32
1683349495122,BIMM 101,A01,193329,McDonnell; Lisa Marie,0,3,24,24
1683349495122,BIMM 101,A02,193339,McDonnell; Lisa Marie,0,3,24,24
1683349495122,BIMM 101,B01,193354,McDonnell; Lisa Marie,0,3,24,24
1683349495122,BIMM 101,B02,193357,McDonnell; Lisa Marie,0,3,24,24
1683349496150,BIMM 110,A01,193377,Tat; John,0,11,32,32
1683349496150,BIMM 110,A02,193378,Tat; John,1,9,32,31
1683349497174,BIMM 120,A01,206116,Staff,0,0,32,32
1683349497174,BIMM 120,A02,206117,Staff,8,0,32,24
1683349497174,BIMM 120,A03,206121,Staff,21,0,32,11
1683349498196,BIPN 100,A01,193393,Park; Ji Young,0,14,32,32
1683349498196,BIPN 100,A02,193402,Park; Ji Young,0,13,32,32
1683349498196,BIPN 100,A03,193413,Park; Ji Young,0,14,32,32
1683349498196,BIPN 100,A04,193414,Park; Ji Young,0,13,32,32
1683349499220,BIPN 102,A01,193429,Staff,0,0,32,32
1683349499220,BIPN 102,A02,193438,Staff,22,0,32,10
1683349500245,BIPN 106,A01,193450,Reyes Gonzalez; Catalina,0,2,40,40
1683349501276,BIPN 134,A01,193465,Cooke; James Edward,0,0,32,32
1683349501276,BIPN 134,A02,193474,Cooke; James Edward,25,0,32,7
1683349501276,BIPN 134,A03,193485,Cooke; James Edward,29,0,32,3
1683349501276,BIPN 134,A04,193486,Cooke; James Edward,21,0,32,11
1683349501276,BIPN 134,A05,193491,Cooke; James Edward,31,0,32,1
1683349501276,BIPN 134,A06,193501,Cooke; James Edward,30,0,32,2
1683349501276,BIPN 134,A07,193510,Cooke; James Edward,29,0,32,3
1683349503330,BISP 194,A00,222522,Staff,14,0,32,18
1683349504358,CAT 124,A01,202407,Staff,20,0,25,5
1683349505382,CAT 125,A00,202408,Marchisotto; Jennifer Anne,4,0,20,16
1683349506406,CAT 125R,A00,202409,Smith; Lauryn Alissa,0,11,20,20
1683349506406,CAT 125R,B00,202410,Morales; Celeste Georgianna,0,11,20,20
1683349506406,CAT 125R,C00,202411,Irwin; Matthew Joseph,0,10,20,20
1683349507432,CENG 15,A01,204712,Yang; Kesong,0,1,0,0
1683349508458,CENG 114,A00,202070,Jahed Motlagh; Zeinab,5,0,20,15
1683349509482,CGS 105,A00,185477,Wesling; Megan E.,24,0,40,16
1683349510508,CGS 106,A00,185494,Staff,13,0,22,9
1683349511536,CGS 108,A00,185495,Staff,14,0,20,6
1683349512559,CGS 114,A00,185496,Staff,13,0,18,5
1683349513584,CGS 119,A00,185501,Staff,15,0,20,5
1683349514611,CGS 120,A00,185511,Staff,13,0,20,7
1683349515635,CHEM 4,A01,184675,Bussey; Thomas J,96,0,100,4
1683349516663,CHEM 6A,A01,184677,Staff,34,0,60,26
1683349517690,CHEM 6B,A01,184679,Staff,65,0,100,35
1683349518715,CHEM 6C,A01,184681,Bussey; Thomas J,1,0,50,49
1683349518715,CHEM 6C,A02,184682,Bussey; Thomas J,34,0,50,16
1683349519743,CHEM 40A,A01,184684,Albizati; Kim F.,37,0,100,63
1683349520769,CHEM 40B,A01,184686,Albizati; Kim F.,0,20,100,100
1683349521794,CHEM 41B,A01,184690,Staff,52,0,100,48
1683349522823,COGS 3,A01,184715,Boyle; Mary E. T.,0,25,40,40
1683349523850,COGS 14B,A01,185172,Staff,0,15,38,38
1683349524877,COGS 18,A01,184736,Staff,17,0,80,63
1683349525906,COGS 100,A01,184932,Staff,0,5,73,73
1683349526930,COGS 101A,A01,184935,Staff,0,39,30,30
1683349527954,COGS 101B,A01,184944,Staff,0,2,30,30
1683349528977,COGS 101C,A01,184946,Staff,0,12,30,30
1683349530001,COGS 102A,A01,184951,Johnson; Christine M.,2,0,40,38
1683349531024,COGS 107B,A01,184953,Mooshagian; Eric Frederick,0,50,40,40
1683349532048,COGS 118B,A01,184959,Gupta; Anjum,0,48,40,40
1683349533075,COGS 153,A00,184961,Staff,0,15,30,30
1683349534098,COGS 177,A00,184962,Staff,0,20,30,30
1683349535122,COGS 187A,A01,184969,Boyle; Mary E. T.,0,17,40,40
1683349536146,COMM 10,A01,185174,Staff,0,5,25,25
1683349536146,COMM 10,A02,185189,Staff,0,5,25,25
1683349536146,COMM 10,A03,269821,Staff,0,0,0,0
1683349537170,COMM 100B,A01,185475,Staff,0,0,0,2
1683349537170,COMM 100B,A02,185476,Staff,13,0,25,12
1683349538194,COMM 100C,A01,185314,Staff,1,0,25,24
1683349538194,COMM 100C,A02,185327,Staff,19,0,25,6
1683349539218,COMM 110M,A00,185349,Staff,2,0,40,38
1683349540242,COMM 113T,A00,185352,Staff,24,0,40,16
1683349541268,COMM 114I,A00,185353,Staff,33,0,40,7
1683349542293,COMM 131,A00,185354,Staff,19,0,30,11
1683349543321,CSE 8A,A50,185358,Cao; Yingjun,0,46,10,10
1683349544349,CSE 8B,A01,185362,Staff,1,47,50,49
1683349545373,CSE 11,A01,185416,Cao; Yingjun,0,92,10,10
1683349546397,CSE 20,A01,185445,Briones; Jor-el Thomas Caparas,5,0,25,20
1683349547478,CSE 21,A01,185447,Staff,10,0,50,40
1683349548505,CSE 101,A01,185451,Staff,0,13,50,50
1683349548505,CSE 101,B01,185453,Jones; Miles E,0,11,50,50
1683349550551,CSE 141,A01,185458,Eldon; John,20,0,100,80
1683349551575,CSE 141L,A01,185461,Eldon; John,12,0,100,88
1683349552604,CSE 142,A01,185463,Staff,36,0,60,24
1683349552604,CSE 142,B01,201355,Staff,0,7,60,60
1683349553627,CSE 142L,A01,185470,Staff,36,0,60,24
1683349553627,CSE 142L,B01,201417,Staff,0,6,60,60
1683349554651,CSE 190,A00,201433,Staff,32,0,49,17
1683349555677,DOC 1,A01,259136,Strom; Megan C.,7,0,15,8
1683349555677,DOC 1,A02,259137,Strom; Megan C.,14,0,15,1
1683349555677,DOC 1,A03,259138,Strom; Megan C.,14,0,15,1
1683349555677,DOC 1,A04,259139,Strom; Megan C.,14,0,15,1
1683349556703,DOC 100D,A00,259140,Pass; Natalye Joann,16,0,25,9
1683349557727,DSGN 1,A01,184749,Rill; Bryan,0,25,30,30
1683349558755,DSGN 100,A01,185168,Staff,0,2,25,25
1683349559784,ECE 5,A01,185626,Morris; Karcher William,0,10,0,0
1683349560812,ECE 101,A01,185628,Staff,17,0,70,53
1683349561834,ECE 107,A01,185635,Baghdadchi; Saharnaz,0,0,20,20
1683349561834,ECE 107,A02,185638,Baghdadchi; Saharnaz,4,0,20,16
1683349562859,ECE 148,A01,185647,Silberman; Jack,0,0,16,16
1683349563883,ECON 1,A01,185537,Crane; Meredith Helen,54,0,70,16
1683349564908,ECON 3,A01,185549,Crane; Meredith Helen,32,0,70,38
1683349565933,ECON 4,A01,203354,Anderson; John Charles,0,4,10,10
1683349566957,ECON 100A,A01,185574,Staff,0,4,40,40
1683349567985,ECON 100B,A01,185576,Staff,10,22,50,40
1683349569009,ECON 100C,A01,185589,Newhouse; Herbert S,29,0,70,41
1683349570034,ECON 105,A00,185608,Vespa; Emanuel Ignacio,19,0,35,16
1683349571059,ECON 109,A01,185610,Shishkin; Denis,10,0,35,25
1683349572084,ECON 110A,A01,185612,Staff,11,0,40,29
1683349573112,ECON 120A,A01,185615,Staff,20,0,40,20
1683349574139,ECON 120C,A01,185617,Sun; Yixiao,0,21,70,70
1683349575162,ECON 144,A00,203346,Squires; Dale E,3,0,35,32
1683349576188,ECON 171,A01,203349,Newhouse; Herbert S,0,1,35,35
1683349577214,ECON 173A,A01,185621,Toda; Alexis Akira,21,0,35,14
1683349578244,EDS 25,A01,202413,Staff,0,1,0,0
1683349578244,EDS 25,A02,202414,Staff,0,1,0,0
1683349578244,EDS 25,A03,202415,Staff,0,0,0,0
1683349578244,EDS 25,A04,202416,Staff,0,1,0,0
1683349578244,EDS 25,A05,202439,Staff,0,0,0,0
1683349578244,EDS 25,A06,202440,Staff,0,0,0,0
1683349578244,EDS 25,B01,202631,Staff,0,0,0,0
1683349578244,EDS 25,B02,202632,Staff,0,0,0,0
1683349578244,EDS 25,B03,202639,Staff,0,0,0,0
1683349578244,EDS 25,B04,202640,Staff,0,0,0,0
1683349578244,EDS 25,B05,202643,Staff,0,0,0,0
1683349578244,EDS 25,B06,202644,Staff,0,0,0,0
1683349579267,EDS 38,A01,202659,Black; Alison Michelle,24,0,25,1
1683349580293,EDS 115,A00,202652,Staff,18,0,30,12
1683349581318,EDS 125,A00,202649,Staff,14,0,30,16
1683349582341,EDS 126,A01,203332,Staff,30,0,30,0
1683349583367,EDS 139,A00,202838,Staff,16,0,25,9
1683349584395,EDS 146,A01,202655,Staff,14,0,25,11
1683349585423,ENG 15,A00,185667,Staff,0,1,0,0
1683349585423,ENG 15,B00,185672,Staff,0,0,0,0
1683349585423,ENG 15,C00,185675,Staff,0,0,0,0
1683349585423,ENG 15,D00,185682,Staff,0,0,0,0
1683349585423,ENG 15,E00,185684,Staff,0,0,0,0
1683349586450,ETHN 103,A00,185710,Staff,0,4,35,35
1683349587474,ETHN 103A,A00,199228,Man; Simeon S,2,0,9,7
1683349588502,ETHN 109,A00,185711,Staff,18,0,35,17
1683349589530,ETHN 142,A00,185726,Staff,0,4,30,30
1683349590554,ETHN 163J,A00,199229,Man; Simeon S,5,0,8,3
1683349591589,ETHN 168,A00,185727,Staff,8,0,10,2
1683349592613,ETHN 182,A00,185728,Staff,1,0,35,34
1683349593638,ETHN 183,A00,185737,Staff,8,0,18,10
1683349594665,GLBH 111,A01,209361,Burgos; Jose L.,0,0,0,0
1683349596714,HIEU 104,A00,185792,Staff,16,0,20,4
1683349597738,HIEU 115,A00,185800,Staff,1,0,20,19
1683349598762,HIEU 128,A00,185801,Staff,0,7,20,20
1683349599787,HIEU 147,A00,185802,Staff,16,0,20,4
1683349600810,HIEU 154,A00,185823,Staff,12,0,20,8
1683349601836,HILA 102,A00,185826,Staff,13,0,20,7
1683349602864,HILD 2C,A01,185778,Staff,0,12,20,20
1683349603891,HILD 7B,A01,185780,Kwak; Nancy,0,15,32,32
1683349603891,HILD 7B,A02,185781,Kwak; Nancy,0,18,32,32
1683349604920,HILD 30,A01,185791,Staff,14,0,20,6
1683349605947,HISC 119,A00,185830,Golan; Tal,0,9,20,20
1683349606971,HITO 156GS,A00,185831,Patterson; Patrick H.,0,0,0,23
1683349607997,HIUS 103,A00,185832,Man; Simeon S,0,6,20,20
1683349609021,HIUS 117,A00,185836,Kwak; Nancy,2,0,20,18
1683349610046,HIUS 125,A00,185840,Man; Simeon S,0,0,23,23
1683349611071,HIUS 149,A00,185845,Staff,0,0,20,20
1683349612100,HUM 3,A01,185882,Zavodny; Tatiana Sophia,0,7,50,50
1683349612100,HUM 3,B01,185899,Caldwell; Michael Alan,0,18,50,50
1683349613125,HUM 3GS,A00,185900,Patterson; Patrick H.,0,0,0,23
1683349614150,HUM 4,A01,185938,Zroka; Amy Liane,31,0,50,19
1683349614150,HUM 4,B01,185956,Watkins; Eric,0,3,50,50
1683349614150,HUM 4,B02,202209,Watkins; Eric,0,2,50,50
1683349614150,HUM 4,B03,202210,Watkins; Eric,0,2,50,50
1683349615177,HUM 5,A01,185958,West; Geoffrey Scott,3,0,50,47
1683349615177,HUM 5,A02,202215,West; Geoffrey Scott,0,0,50,50
1683349616205,INTL 190,A00,185959,Gagnon; Jeffrey C,0,0,0,9
1683349616205,INTL 190,B00,185960,Lettieri; Michael Joseph,0,0,0,1
1683349617229,JAPN 180,A00,254509,Staff,5,1,30,25
1683349618253,LATI 10,A01,202853,Kennemore; Amy Michelle,4,0,35,31
1683349618253,LATI 10,A02,202854,Kennemore; Amy Michelle,2,0,35,33
1683349618253,LATI 10,A03,270054,Kennemore; Amy Michelle,30,0,30,0
1683349619280,LATI 180,A00,202855,Kennemore; Amy Michelle,11,0,20,9
1683349620303,LAWS 101,A00,201767,Golan; Tal,0,7,40,40
1683349621327,LIFR 1C,A00,185961,Staff,6,0,20,14
1683349622354,LIFR 1CX,A00,185962,Staff,7,0,20,13
1683349623379,LIFR 1D,A00,185963,Staff,9,0,20,11
1683349624403,LIFR 1DX,A00,185964,Staff,9,0,20,11
1683349625430,LIGN 101,A01,186039,Staff,43,0,50,7
1683349626454,LIGN 165,A00,186040,Staff,18,0,50,32
1683349627479,LTCS 108,A00,186041,Staff,6,0,10,4
1683349628506,LTCS 119,A00,186042,Staff,16,0,20,4
1683349629534,LTCS 130,A00,186043,Wesling; Megan E.,15,0,25,10
1683349631588,LTEA 138,A00,186119,Staff,14,0,40,26
1683349632611,LTEN 124,A00,186148,Staff,6,0,25,19
1683349633638,LTEN 178,A00,186149,Staff,7,0,15,8
1683349634666,LTEN 181,A00,186150,Blanco; John D,33,0,40,7
1683349635690,LTWL 120,A00,186160,Staff,20,0,25,5
1683349636714,LTWL 165,A00,186161,Staff,22,0,25,3
1683349637738,LTWR 100,A00,186162,Staff,0,5,15,15
1683349638762,LTWR 102,A00,186163,Doller; Ben,5,0,15,10
1683349639787,MAE 8,A01,186412,Staff,0,0,0,0
1683349640817,MAE 30B,A00,186445,Bahadori; Mohammad Yousef,83,0,100,17
1683349641843,MAE 40,A00,186592,Bewley; Thomas R,9,0,50,41
1683349642866,MAE 101B,A00,186593,Bahadori; Mohammad Yousef,81,0,100,19
1683349643891,MAE 105,A00,186594,Bandaru; Prabhakar,12,0,50,38
1683349644916,MAE 107,A00,186599,Pham; Hieu Tan,0,6,120,120
1683349645941,MAE 148,A01,186660,Silberman; Jack,3,0,16,13
1683349646970,MATH 10A,A01,188095,Staff,1,6,35,34
1683349647999,MATH 10B,A01,188097,Bowers; Adam R.,0,11,30,30
1683349647999,MATH 10B,A02,188099,Bowers; Adam R.,0,11,30,30
1683349647999,MATH 10B,B01,188104,Bowers; Adam R.,0,10,30,30
1683349647999,MATH 10B,B02,188106,Bowers; Adam R.,0,10,30,30
1683349649029,MATH 10C,A01,188111,Staff,0,18,30,30
1683349649029,MATH 10C,A02,188127,Staff,0,17,30,30
1683349649029,MATH 10C,A03,188131,Staff,0,18,30,30
1683349649029,MATH 10C,B01,188218,Staff,18,0,30,12
1683349649029,MATH 10C,B02,188244,Staff,13,0,30,17
1683349649029,MATH 10C,B03,188277,Staff,16,0,30,14
1683349650063,MATH 18,A01,188344,Bach; Quang Tran,18,0,30,12
1683349650063,MATH 18,A02,188345,Bach; Quang Tran,11,0,30,19
1683349650063,MATH 18,B01,188353,Bach; Quang Tran,10,0,30,20
1683349650063,MATH 18,B02,188354,Bach; Quang Tran,20,0,30,10
1683349651141,MATH 20A,A01,188374,Staff,13,0,35,22
1683349652166,MATH 20B,A01,188382,Ohm; Ko Woon,6,0,30,24
1683349652166,MATH 20B,A02,188383,Ohm; Ko Woon,22,0,30,8
1683349652166,MATH 20B,B01,188385,Ohm; Ko Woon,7,0,30,23
1683349652166,MATH 20B,B02,188392,Ohm; Ko Woon,22,0,30,8
1683349653192,MATH 20C,A01,188394,Harel; Guershon,10,0,30,20
1683349653192,MATH 20C,A02,188395,Harel; Guershon,15,0,30,15
1683349653192,MATH 20C,B01,188404,Harel; Guershon,5,0,30,25
1683349653192,MATH 20C,B02,188405,Harel; Guershon,19,0,30,11
1683349654217,MATH 20D,A01,188414,Hammock; Frances H,0,1,30,30
1683349654217,MATH 20D,A02,188415,Hammock; Frances H,3,0,30,27
1683349654217,MATH 20D,B01,188447,Hammock; Frances H,1,0,30,29
1683349654217,MATH 20D,B02,188486,Hammock; Frances H,8,0,30,22
1683349655245,MATH 20E,A01,188649,Staff,21,0,30,9
1683349655245,MATH 20E,A02,188650,Staff,23,0,30,7
1683349655245,MATH 20E,A03,188673,Staff,0,0,30,30
1683349656271,MATH 102,A01,188675,Staff,0,35,35,35
1683349657296,MATH 103B,A01,188681,Staff,3,0,35,32
1683349657296,MATH 103B,B01,188692,Staff,5,0,35,30
1683349658322,MATH 109,A01,188695,Salehi Golsefidy; Alireza,25,0,35,10
1683349658322,MATH 109,A02,188696,Salehi Golsefidy; Alireza,25,0,35,10
1683349659347,MATH 120A,A01,188698,Eggers; John Dietrich,7,0,35,28
1683349660371,MATH 142B,A01,188736,Ioana; Adrian,0,2,30,30
1683349660371,MATH 142B,A02,188741,Ioana; Adrian,1,1,30,29
1683349660371,MATH 142B,A03,188743,Ioana; Adrian,1,3,30,29
1683349661396,MATH 168A,A01,188790,Staff,0,9,35,35
1683349662420,MATH 170A,A01,188803,Nie; Jiawang,0,2,35,35
1683349662420,MATH 170A,A02,188811,Nie; Jiawang,0,0,35,35
1683349662420,MATH 170A,A03,188814,Nie; Jiawang,1,0,35,34
1683349662420,MATH 170A,A04,188815,Nie; Jiawang,13,0,35,22
1683349663446,MATH 193B,A01,188817,Staff,0,0,35,35
1683349663446,MATH 193B,A02,188818,Staff,5,0,35,30
1683349664470,MGT 4,A01,202857,Anderson; John Charles,62,0,80,18
1683349665495,MGT 12,A00,202858,Lindenberger; Wade Douglas,42,0,90,48
1683349666520,MGT 18,A00,202859,Staff,74,0,90,16
1683349667549,MGT 18GS,A00,202860,McKay; Michael J,13,0,28,15
1683349668577,MGT 45,A00,202861,Pecore; Joseph P.,14,0,90,76
1683349669601,MGT 100,A00,202863,Yavorsky; Daniel Ryan,28,0,90,62
1683349670627,MGT 103,A00,202864,Ehrich; Kristine R,1,18,90,89
1683349671652,MGT 112,A00,202865,Ehrich; Kristine R,15,0,90,75
1683349672678,MGT 121A,A00,202868,Staff,0,20,0,0
1683349673702,MGT 131B,A00,202869,Anderson; John Charles,59,0,90,31
1683349674725,MGT 136,A00,202871,Lindenberger; Wade Douglas,84,0,90,6
1683349675752,MGT 164,A00,202873,Staff,0,68,90,91
1683349676777,MGT 164GS,A00,202874,McKay; Mary A,13,0,28,15
1683349677803,MGT 180,A00,202875,Staff,0,50,90,91
1683349678828,MMW 11R,A01,205019,Herbst; Matthew,3,0,30,27
1683349678828,MMW 11R,A02,205026,Herbst; Matthew,29,0,30,1
1683349679854,MMW 15,A01,193512,Chang; Edmond Yi-Teh,0,9,28,28
1683349679854,MMW 15,A02,193513,Chang; Edmond Yi-Teh,0,5,28,28
1683349679854,MMW 15,A03,193514,Chang; Edmond Yi-Teh,0,5,28,28
1683349679854,MMW 15,A04,193515,Chang; Edmond Yi-Teh,0,5,28,28
1683349679854,MMW 15,A05,193516,Chang; Edmond Yi-Teh,0,4,28,28
1683349679854,MMW 15,A06,193517,Chang; Edmond Yi-Teh,0,5,28,28
1683349679854,MMW 15,B01,193519,Chang; Edmond Yi-Teh,0,5,28,28
1683349679854,MMW 15,B02,193520,Chang; Edmond Yi-Teh,0,5,28,28
1683349679854,MMW 15,B03,193521,Chang; Edmond Yi-Teh,0,5,28,28
1683349679854,MMW 15,B04,193522,Chang; Edmond Yi-Teh,0,4,28,28
1683349679854,MMW 15,B05,193523,Chang; Edmond Yi-Teh,0,5,28,28
1683349679854,MMW 15,B06,193524,Chang; Edmond Yi-Teh,0,4,28,28
1683349680879,MMW 122,A01,193526,Rahimi; Babak,0,15,28,28
1683349680879,MMW 122,A02,193527,Rahimi; Babak,0,14,28,28
1683349680879,MMW 122,A03,193528,Rahimi; Babak,0,0,0,0
1683349680879,MMW 122,A04,193529,Rahimi; Babak,0,0,0,0
1683349681905,MUS 1A,A01,186663,Staff,0,20,35,35
1683349682931,MUS 4,A01,186715,Staff,0,12,35,35
1683349683959,MUS 5R,A01,186796,Dubnov; Shlomo,0,17,35,35
1683349684985,MUS 6,A01,186798,Staff,0,4,25,25
1683349686013,MUS 7,A01,186830,Staff,13,0,35,22
1683349687041,MUS 8,A01,186930,Staff,0,26,35,35
1683349688069,MUS 15,A01,186932,Staff,0,16,35,35
1683349688069,MUS 15,B01,186934,Staff,0,15,35,35
1683349689093,MUS 80,A00,186935,Staff,1,0,20,19
1683349689093,MUS 80,B00,186936,Staff,25,0,25,0
1683349690118,NANO 11,A00,204702,Lipomi; Darren John,0,0,0,0
1683349691146,NANO 15,A01,204709,Yang; Kesong,0,1,0,0
1683349692174,NANO 114,A00,202069,Jahed Motlagh; Zeinab,3,0,10,7
1683349693200,PHIL 1,A00,186955,Grush; Rick Scott,32,0,40,8
1683349694224,PHIL 10,A01,186973,Grush; Rick Scott,28,0,35,7
1683349694224,PHIL 10,A02,186974,Grush; Rick Scott,33,0,35,2
1683349695252,PHIL 13,A01,186976,Staff,7,0,35,28
1683349695252,PHIL 13,A02,186977,Staff,16,0,35,19
1683349696274,PHIL 14,A01,186979,Staff,31,0,35,4
1683349696274,PHIL 14,A02,186986,Staff,32,0,35,3
1683349697301,PHIL 28,A01,186988,Staff,16,0,30,14
1683349697301,PHIL 28,A02,186989,Staff,1,0,30,29
1683349697301,PHIL 28,A03,186990,Staff,9,0,30,21
1683349697301,PHIL 28,A04,186991,Staff,26,0,30,4
1683349698328,PHIL 120,A00,186997,Staff,23,0,40,17
1683349699353,PHIL 137,A00,187003,Staff,9,0,40,31
1683349700378,PHIL 150,A00,187015,Staff,47,0,70,23
1683349701407,PHIL 167,A00,187021,Lamey; Andy M.,35,0,40,5
1683349702433,PHIL 174,A01,202226,Staff,17,0,20,3
1683349702433,PHIL 174,A02,202235,Staff,20,0,20,0
1683349703458,PHIL 191A,A00,258918,Staff,0,0,1,1
1683349704484,PHYS 1A,A00,187028,Staff,27,0,60,33
1683349705513,PHYS 1AL,001,187036,Staff,2,0,30,28
1683349705513,PHYS 1AL,002,187049,Staff,18,0,30,12
1683349706541,PHYS 1B,A00,187058,Staff,22,0,60,38
1683349707569,PHYS 1BL,001,187064,Staff,0,0,30,30
1683349707569,PHYS 1BL,002,187070,Staff,5,0,30,25
1683349708598,PHYS 1C,A00,187082,Staff,31,0,120,89
1683349709621,PHYS 1CL,001,187088,Staff,0,9,30,30
1683349709621,PHYS 1CL,002,187089,Staff,0,2,30,30
1683349709621,PHYS 1CL,009,262693,Staff,11,0,30,19
1683349710649,PHYS 2B,A01,187097,Staff,54,0,115,61
1683349711677,PHYS 2C,A01,187099,Staff,67,0,115,48
1683349712703,PHYS 2CL,A01,187101,Staff,5,0,28,23
1683349712703,PHYS 2CL,A02,187102,Staff,15,0,28,13
1683349713730,PHYS 2D,A01,187123,Shotwell; Brian,95,0,115,20
1683349714758,PHYS 4B,A01,187133,Grinstein; Benjamin,35,0,50,15
1683349715785,POLI 10,A00,188819,Staff,0,4,50,50
1683349716810,POLI 11,A00,188827,Staff,43,0,50,7
1683349717834,POLI 13R,A00,188828,Staff,0,1,20,20
1683349718861,POLI 27,A01,188830,Elgin; Samuel Zincke,0,1,70,70
1683349719887,POLI 30,A00,188832,Desposato; Scott,31,0,50,19
1683349720914,POLI 102F,A00,188834,Staff,3,0,40,37
1683349721938,POLI 104A,A00,188852,Staff,14,0,30,16
1683349722968,POLI 104I,A00,188853,Staff,0,6,20,20
1683349723993,POLI 110B,A00,188854,Wiens; David,7,0,20,13
1683349725021,POLI 112A,A00,188855,Wiens; David,5,0,30,25
1683349726048,POLI 117R,A00,188856,Forman; Fonna,0,11,20,20
1683349727076,POLI 118,A00,188857,Ingham; Sean,8,0,20,12
1683349728101,POLI 120G,A00,188858,Staff,9,0,30,21
1683349729124,POLI 131CR,A00,188863,Hoston; Germaine,24,0,50,26
1683349730152,POLI 133,A00,188864,Nellis; Gareth Hb,44,0,50,6
1683349731179,POLI 134D,A00,188865,Desposato; Scott,27,0,30,3
1683349732205,POLI 142A,A00,188871,Gartzke; Erik,22,0,50,28
1683349733233,POLI 142K,A00,188874,Staff,38,0,50,12
1683349734258,POLI 143,A00,188940,Gartzke; Erik,16,0,30,14
1683349735282,POLI 153,A00,188943,Staff,3,0,20,17
1683349736308,POLI 160AA,A00,188944,Staff,11,0,40,29
1683349737331,POLI 170A,A00,188945,Staff,11,0,30,19
1683349739379,PSYC 1,A00,188952,Staff,37,0,90,53
1683349740404,PSYC 2,B00,188953,Staff,19,0,35,16
1683349741429,PSYC 6,A00,188970,Staff,47,0,60,13
1683349742454,PSYC 7,A00,188973,Staff,37,0,45,8
1683349743479,PSYC 60,A01,188980,Rickard; Timothy C.,43,0,60,17
1683349744506,PSYC 70,A01,189001,Steiner; Eric Tomas,23,0,45,22
1683349745531,PSYC 100,A00,189005,Lacefield; Katharine I,0,98,120,120
1683349746554,PSYC 102,A00,189008,Staff,9,0,30,21
1683349747578,PSYC 106,B00,189026,Gorman; Michael R.,34,0,60,26
1683349748602,PSYC 114,B01,189033,Winkielman; Piotr,0,32,30,30
1683349749626,PSYC 131,A00,189036,Anagnostaras; Stephan,0,43,60,60
1683349750656,PSYC 136,A00,189041,Lowe; Angela Beth,0,7,25,25
1683349751683,PSYC 137,A00,189057,Winkielman; Piotr,0,34,25,25
1683349752711,PSYC 144,A00,189107,Wixted; John T,0,7,50,50
1683349754821,PSYC 162,A00,189142,Staff,0,8,85,85
1683349755846,PSYC 172,A00,189144,Gorman; Michael R.,0,7,30,30
1683349757900,PSYC 179,A00,189146,Lacefield; Katharine I,0,84,120,120
1683349758928,PSYC 181,A00,189147,Anagnostaras; Stephan,0,44,90,90
1683349759952,PSYC 190R,A00,189148,Barner; David A.,0,22,80,80
1683349760977,PSYC 191,A00,189275,Rickard; Timothy C.,0,7,25,25
1683349762004,PSYC 193,A00,189276,Chapman; Eddie Nathaniel,0,1,0,4
1683349763031,PSYC 193L,A01,189281,Lowe; Angela Beth,12,0,20,8
1683349763031,PSYC 193L,B01,189285,Staff,28,0,35,7
1683349764054,RELI 149,A00,187137,Rahimi; Babak,7,0,40,33
1683349765078,SE 9,A01,187315,Staff,0,2,18,18
1683349766101,SE 101B,A00,187409,Staff,24,0,30,6
1683349767126,SE 110B,A00,187444,Staff,10,0,40,30
1683349768149,SE 130B,A00,187449,Staff,31,0,40,9
1683349769174,SE 150A,A00,187516,Staff,9,0,20,11
1683349770199,SE 154,A00,187528,Staff,30,0,50,20
1683349771223,SIO 3,A01,258171,Staff,35,0,40,5
1683349772248,SIO 10,A00,187144,Cook; Geoffrey W,0,3,75,75
1683349773275,SIO 45,A00,187152,Cook; Geoffrey W,1,0,100,99
1683349774301,SIO 109R,A00,194486,Staff,0,3,20,20
1683349776356,SIO 187,A01,187233,Kacev; David,12,0,40,28
1683349777381,SOCI 1,A01,258656,Thorpe; Charles Robert,28,0,30,2
1683349777381,SOCI 1,A02,258658,Thorpe; Charles Robert,30,0,30,0
1683349777381,SOCI 1,A03,258661,Thorpe; Charles Robert,25,0,25,0
1683349777381,SOCI 1,A04,258666,Thorpe; Charles Robert,22,0,25,3
1683349777381,SOCI 1,A05,258897,Thorpe; Charles Robert,23,0,25,2
1683349777381,SOCI 1,A06,258898,Thorpe; Charles Robert,25,0,25,0
1683349778405,SOCI 30,A01,258903,Pardo Guerra; Juan Pablo,15,0,30,15
1683349779428,SOCI 102,A00,258904,Staff,9,0,25,16
1683349780456,SOCI 106,A00,258905,Staff,19,0,25,6
1683349781484,SOCI 111,A00,258907,Ribas Norris; Janet Vanesa,26,0,30,4
1683349782508,SOCI 121R,A00,258908,Pardo Guerra; Juan Pablo,10,0,30,20
1683349783535,SOCI 126,A01,203330,Staff,14,0,20,6
1683349784561,SOCI 131,A00,258909,Thorpe; Charles Robert,31,0,60,29
1683349785585,SOCI 135,A00,258910,Payne; Christine Anna,0,9,30,30
1683349786609,SOCI 157,A00,258911,Staff,12,0,30,18
1683349787633,SOCI 184,A00,258912,Staff,25,0,30,5
1683349788660,SOCI 188D,A00,258913,Staff,21,0,30,9
1683349789688,SYN 2,001,187529,Staff,10,0,16,6
1683349789688,SYN 2,002,201452,Staff,0,18,16,16
1683349789688,SYN 2,003,201469,Staff,3,0,16,13
1683349790720,SYN 100,A01,187531,Staff,0,9,20,20
1683349790720,SYN 100,B01,201491,Staff,0,12,20,20
1683349791745,TDAC 1,A00,189286,Walsh; Kim C.,3,0,20,17
1683349791745,TDAC 1,B00,189287,Harting; Carla Kelso,11,0,20,9
1683349792771,TDAC 101,A00,189300,Walsh; Kim C.,16,0,20,4
1683349792771,TDAC 101,B00,189301,Harting; Carla Kelso,18,0,20,2
1683349793794,TDAC 102,A00,189304,Basso; Beatrice,14,0,20,6
1683349794819,TDAC 108,A00,189305,Staff,18,0,20,2
1683349795845,TDDE 131,A00,189310,Staff,19,0,20,1
1683349795845,TDDE 131,B00,189314,Staff,19,0,20,1
1683349795845,TDDE 131,C00,189315,Staff,48,0,50,2
1683349795845,TDDE 131,D00,189316,Staff,14,0,15,1
1683349795845,TDDE 131,E00,204841,Staff,20,0,20,0
1683349796869,TDGE 10,A00,189289,Staff,30,0,50,20
1683349796869,TDGE 10,B00,189290,Havis; Allan,1,0,50,49
1683349797894,TDGE 11,A00,189291,Fulton; Julia,0,3,50,50
1683349797894,TDGE 11,B00,189292,Staff,20,0,25,5
1683349797894,TDGE 11,C00,260270,Staff,0,0,0,0
1683349798918,TDGE 25,A00,189294,Staff,3,0,20,17
1683349799947,TDGE 124,A00,189318,Fulton; Julia,0,8,50,50
1683349800972,TDGE 125,A00,189319,Staff,13,0,25,12
1683349800972,TDGE 125,B00,189320,Staff,23,0,25,2
1683349802001,TDGE 127,A00,189322,Havis; Allan,0,0,50,50
1683349803028,TDHT 101,A00,189323,Staff,18,0,25,7
1683349803028,TDHT 101,B00,189324,Staff,25,0,25,0
1683349804054,TDHT 102,A00,189325,Staff,49,0,50,1
1683349805079,TDMV 1,A00,189295,Arcidiacono; Kristin,19,0,30,11
1683349805079,TDMV 1,B00,189296,Caligagan; Maria T.,24,0,30,6
1683349806102,TDMV 2,A00,189297,Sammartano; Tonnie,28,0,30,2
1683349806102,TDMV 2,B00,189299,Arcidiacono; Kristin,24,0,30,6
1683349807126,TDMV 3,A00,204998,Rincon; Alicia,22,0,30,8
1683349808155,TDMV 120,A00,189458,Sammartano; Tonnie,28,0,30,2
1683349809199,TDMV 138,A00,189541,Jun; Grace Shin Hae,22,0,40,18
1683349810223,TDMV 142,A00,189717,Caligagan; Tony,23,0,30,7
1683349810223,TDMV 142,B00,189718,Caligagan; Maria T.,25,0,30,5
1683349811247,TMC 2,A01,187533,Staff,25,0,25,0
1683349811247,TMC 2,A02,187534,Staff,25,0,25,0
1683349812272,USP 1,A01,187536,Kwak; Nancy,0,16,25,25
1683349813296,USP 5,A01,187538,Staff,10,0,25,15
1683349814322,USP 101,A00,199253,Staff,0,4,0,0
1683349815346,USP 124,A00,187562,Boomhower; Matthew Charles,1,0,30,29
1683349816370,USP 138,A00,187582,Staff,20,0,25,5
1683349817395,USP 152,A01,187597,Staff,4,0,25,21
1683349818419,USP 153,A00,187598,Staff,19,0,25,6
1683349819443,USP 168,A00,187607,Kwak; Nancy,2,0,5,3
1683349820469,USP 173,A00,187619,Staff,4,0,25,21
1683349821496,USP 181,A00,187638,Staff,0,1,25,25
1683349822525,VIS 103,A00,187650,Cruz; Edwin Teddy,22,0,75,53
1683349823552,VIS 110D,A00,187669,Staff,12,0,22,10
1683349824580,VIS 127C,A00,187720,Shen; Kuiyi,67,0,146,79
1683349825605,VIS 149,A00,187731,Yoldas; Pinar,0,14,22,22
1683349826631,VIS 151,A01,188091,Staff,22,0,34,12
1683349826631,VIS 151,A02,188092,Staff,11,0,34,23
1683349827658,VIS 160B,A00,188093,Stalbaum; Brett,0,0,10,10
1683349829706,WCWP 10B,A00,201720,Staff,10,0,15,5
1683349829706,WCWP 10B,B00,201722,Staff,9,0,15,6
1683349830729,WCWP 100,A00,201725,Gagnon; Jeffrey C,0,0,2,2
1683349830729,WCWP 100,B00,201727,Staff,0,4,15,15
1683349833826,ANBI 133,A00,258401,Wilder; Linnea Lorene,34,0,40,6
1683349834854,ANBI 140,A00,258395,Hrvoj Mihic; Branka,18,0,25,7
1683349835876,ANSC 120,A00,258402,Bialecki; Jon Anthony,27,0,40,13
1683349836902,ANSC 144,A00,258400,Staff,14,0,40,26
1683349838960,ANSC 166,A00,258396,Parish; Steven Martin,157,0,175,18
1683349839984,ANSC 180,A00,193533,Staff,9,0,20,11
1683349841009,ANSC 188,A00,258397,Jassal; Aftab,33,0,40,7
1683349842033,ANTH 3,A01,258316,Staff,23,0,30,7
1683349843060,ANTH 5,A00,258394,Semendeferi; Ekaterini,16,0,20,4
1683349844085,ANTH 21,A01,258331,Staff,8,0,40,32
1683349845110,ANTH 103,A00,258398,Varma; Saiba,15,0,25,10
1683349846136,AWP 10,001,202034,Staff,0,0,0,0
1683349846136,AWP 10,002,202035,Staff,0,0,0,0
1683349846136,AWP 10,003,202036,Staff,0,0,0,0
1683349846136,AWP 10,004,202037,Staff,0,0,0,0
1683349846136,AWP 10,005,202038,Staff,0,0,0,0
1683349846136,AWP 10,006,202039,Staff,0,0,0,0
1683349846136,AWP 10,007,202040,Staff,0,0,0,0
1683349846136,AWP 10,008,202041,Staff,0,0,0,0
1683349846136,AWP 10,009,202042,Staff,0,0,0,0
1683349846136,AWP 10,010,202043,Staff,0,0,0,0
1683349846136,AWP 10,011,202044,Staff,0,0,0,0
1683349846136,AWP 10,012,202045,Staff,0,0,0,0
1683349846136,AWP 10,013,202046,Staff,0,0,0,0
1683349846136,AWP 10,014,202047,Staff,0,0,0,0
1683349846136,AWP 10,015,202048,Staff,0,0,0,0
1683349846136,AWP 10,016,202049,Staff,0,0,0,0
1683349846136,AWP 10,017,202050,Staff,0,0,0,0
1683349846136,AWP 10,018,202051,Staff,0,0,0,0
1683349846136,AWP 10,019,202052,Staff,0,0,0,0
1683349846136,AWP 10,020,202053,Staff,0,0,0,0
1683349846136,AWP 10,021,202054,Staff,0,0,0,0
1683349846136,AWP 10,022,202055,Staff,0,0,0,0
1683349846136,AWP 10,023,202056,Staff,0,0,0,0
1683349846136,AWP 10,024,202057,Staff,0,0,0,0
1683349846136,AWP 10,025,202058,Staff,0,0,0,0
1683349846136,AWP 10,026,202059,Staff,0,0,0,0
1683349847159,AWP 102,001,202032,Staff,0,0,0,0
1683349847159,AWP 102,002,202033,Staff,0,0,0,0
1683349848185,BENG 100,A01,254234,Taylor Amos; Alyssa C,31,0,40,9
1683349849208,BENG 196,001,270013,Engler; Adam J.,9999,0,9999,0
1683349850237,BICD 100R,A01,202018,Smith; Laurie,0,7,32,32
1683349850237,BICD 100R,A02,202019,Smith; Laurie,0,2,32,32
1683349850237,BICD 100R,A03,202020,Smith; Laurie,0,1,32,32
1683349850237,BICD 100R,A04,202021,Smith; Laurie,9,0,32,23
1683349850237,BICD 100R,A05,202022,Smith; Laurie,12,0,32,20
1683349851263,BICD 136,A01,193242,Gustafson-Brown; Cindy,0,2,32,32
1683349851263,BICD 136,A02,193244,Gustafson-Brown; Cindy,14,0,32,18
1683349852291,BIEB 102,A01,193249,Butler; Shannon Rhey,0,2,32,32
1683349852291,BIEB 102,A02,193251,Butler; Shannon Rhey,0,0,32,32
1683349852291,BIEB 102,A03,193253,Butler; Shannon Rhey,0,1,32,32
1683349852291,BIEB 102,A04,193255,Butler; Shannon Rhey,17,0,32,15
1683349852291,BIEB 102,A05,193265,Butler; Shannon Rhey,26,0,32,6
1683349852291,BIEB 102,A06,193269,Butler; Shannon Rhey,16,0,32,16
1683349854347,BIEB 150,A01,193274,Staff,0,0,32,32
1683349854347,BIEB 150,A02,193285,Staff,23,0,32,9
1683349855373,BIEB 194,A00,193286,Kurle; Carolyn M.,22,0,32,10
1683349856399,BILD 1,A01,192291,Staff,16,0,32,16
1683349856399,BILD 1,A02,192292,Staff,30,0,32,2
1683349856399,BILD 1,B01,192520,Reuther; Keefe,0,1,0,0
1683349856399,BILD 1,B02,192532,Reuther; Keefe,0,1,0,0
1683349857424,BILD 3,A01,192556,Butler; Shannon Rhey,0,0,32,32
1683349857424,BILD 3,A02,192581,Butler; Shannon Rhey,4,0,32,28
1683349857424,BILD 3,A03,192611,Butler; Shannon Rhey,23,0,32,9
1683349857424,BILD 3,A04,192612,Butler; Shannon Rhey,25,0,32,7
1683349857424,BILD 3,A05,192613,Butler; Shannon Rhey,27,0,32,5
1683349857424,BILD 3,A06,192679,Butler; Shannon Rhey,27,0,32,5
1683349857424,BILD 3,A07,192682,Butler; Shannon Rhey,22,0,32,10
1683349858512,BILD 4,A01,192836,Reuther; Keefe,0,0,24,24
1683349858512,BILD 4,A02,193044,Reuther; Keefe,4,0,24,20
1683349859539,BILD 10,A01,193142,Gustafson-Brown; Cindy,30,0,32,2
1683349859539,BILD 10,A02,193149,Gustafson-Brown; Cindy,31,0,32,1
1683349860567,BIMM 100,A01,193301,Staff,0,6,32,32
1683349860567,BIMM 100,A02,193312,Staff,0,5,32,32
1683349860567,BIMM 100,A03,193323,Staff,0,8,32,32
1683349861598,BIMM 101,A01,193329,McDonnell; Lisa Marie,0,3,24,24
1683349861598,BIMM 101,A02,193339,McDonnell; Lisa Marie,0,3,24,24
1683349861598,BIMM 101,B01,193354,McDonnell; Lisa Marie,0,3,24,24
1683349861598,BIMM 101,B02,193357,McDonnell; Lisa Marie,0,3,24,24
1683349862623,BIMM 110,A01,193377,Tat; John,0,11,32,32
1683349862623,BIMM 110,A02,193378,Tat; John,1,9,32,31
1683349863655,BIMM 120,A01,206116,Staff,0,0,32,32
1683349863655,BIMM 120,A02,206117,Staff,8,0,32,24
1683349863655,BIMM 120,A03,206121,Staff,21,0,32,11
1683349864683,BIPN 100,A01,193393,Park; Ji Young,0,14,32,32
1683349864683,BIPN 100,A02,193402,Park; Ji Young,0,13,32,32
1683349864683,BIPN 100,A03,193413,Park; Ji Young,0,14,32,32
1683349864683,BIPN 100,A04,193414,Park; Ji Young,0,13,32,32
1683349865709,BIPN 102,A01,193429,Staff,0,0,32,32
1683349865709,BIPN 102,A02,193438,Staff,22,0,32,10
1683349866733,BIPN 106,A01,193450,Reyes Gonzalez; Catalina,0,2,40,40
1683349867764,BIPN 134,A01,193465,Cooke; James Edward,0,0,32,32
1683349867764,BIPN 134,A02,193474,Cooke; James Edward,25,0,32,7
1683349867764,BIPN 134,A03,193485,Cooke; James Edward,29,0,32,3
1683349867764,BIPN 134,A04,193486,Cooke; James Edward,21,0,32,11
1683349867764,BIPN 134,A05,193491,Cooke; James Edward,31,0,32,1
1683349867764,BIPN 134,A06,193501,Cooke; James Edward,30,0,32,2
1683349867764,BIPN 134,A07,193510,Cooke; James Edward,29,0,32,3
1683349869811,BISP 194,A00,222522,Staff,14,0,32,18
1683349870835,CAT 124,A01,202407,Staff,20,0,25,5
1683349871860,CAT 125,A00,202408,Marchisotto; Jennifer Anne,4,0,20,16
1683349872887,CAT 125R,A00,202409,Smith; Lauryn Alissa,0,11,20,20
1683349872887,CAT 125R,B00,202410,Morales; Celeste Georgianna,0,11,20,20
1683349872887,CAT 125R,C00,202411,Irwin; Matthew Joseph,0,10,20,20
1683349873917,CENG 15,A01,204712,Yang; Kesong,0,1,0,0
1683349874940,CENG 114,A00,202070,Jahed Motlagh; Zeinab,5,0,20,15
1683349875964,CGS 105,A00,185477,Wesling; Megan E.,24,0,40,16
1683349876992,CGS 106,A00,185494,Staff,13,0,22,9
1683349878017,CGS 108,A00,185495,Staff,14,0,20,6
1683349879042,CGS 114,A00,185496,Staff,13,0,18,5
1683349880067,CGS 119,A00,185501,Staff,15,0,20,5
1683349881095,CGS 120,A00,185511,Staff,13,0,20,7
1683349882119,CHEM 4,A01,184675,Bussey; Thomas J,96,0,100,4
1683349883143,CHEM 6A,A01,184677,Staff,34,0,60,26
1683349884167,CHEM 6B,A01,184679,Staff,65,0,100,35
1683349885195,CHEM 6C,A01,184681,Bussey; Thomas J,1,0,50,49
1683349885195,CHEM 6C,A02,184682,Bussey; Thomas J,34,0,50,16
1683349886225,CHEM 40A,A01,184684,Albizati; Kim F.,37,0,100,63
1683349887254,CHEM 40B,A01,184686,Albizati; Kim F.,0,20,100,100
1683349888280,CHEM 41B,A01,184690,Staff,52,0,100,48
1683349889304,COGS 3,A01,184715,Boyle; Mary E. T.,0,25,40,40
1683349890333,COGS 14B,A01,185172,Staff,0,15,38,38
1683349891358,COGS 18,A01,184736,Staff,17,0,80,63
1683349892386,COGS 100,A01,184932,Staff,0,5,73,73
1683349893410,COGS 101A,A01,184935,Staff,0,39,30,30
1683349894434,COGS 101B,A01,184944,Staff,0,2,30,30
1683349895458,COGS 101C,A01,184946,Staff,0,12,30,30
1683349896483,COGS 102A,A01,184951,Johnson; Christine M.,2,0,40,38
1683349897510,COGS 107B,A01,184953,Mooshagian; Eric Frederick,0,50,40,40
1683349898534,COGS 118B,A01,184959,Gupta; Anjum,0,48,40,40
1683349899558,COGS 153,A00,184961,Staff,0,15,30,30
1683349900587,COGS 177,A00,184962,Staff,0,20,30,30
1683349901615,COGS 187A,A01,184969,Boyle; Mary E. T.,0,17,40,40
1683349902642,COMM 10,A01,185174,Staff,0,5,25,25
1683349902642,COMM 10,A02,185189,Staff,0,5,25,25
1683349902642,COMM 10,A03,269821,Staff,0,0,0,0
1683349903665,COMM 100B,A01,185475,Staff,0,0,0,2
1683349903665,COMM 100B,A02,185476,Staff,13,0,25,12
1683349904688,COMM 100C,A01,185314,Staff,1,0,25,24
1683349904688,COMM 100C,A02,185327,Staff,19,0,25,6
1683349905714,COMM 110M,A00,185349,Staff,2,0,40,38
1683349906747,COMM 113T,A00,185352,Staff,24,0,40,16
1683349907774,COMM 114I,A00,185353,Staff,33,0,40,7
1683349908802,COMM 131,A00,185354,Staff,19,0,30,11
1683349909827,CSE 8A,A50,185358,Cao; Yingjun,0,46,10,10
1683349910853,CSE 8B,A01,185362,Staff,1,47,50,49
1683349911877,CSE 11,A01,185416,Cao; Yingjun,0,92,10,10
1683349912905,CSE 20,A01,185445,Briones; Jor-el Thomas Caparas,5,0,25,20
1683349913933,CSE 21,A01,185447,Staff,10,0,50,40
1683349914961,CSE 101,A01,185451,Staff,0,13,50,50
1683349914961,CSE 101,B01,185453,Jones; Miles E,0,11,50,50
1683349917015,CSE 141,A01,185458,Eldon; John,20,0,100,80
1683349918043,CSE 141L,A01,185461,Eldon; John,12,0,100,88
1683349919069,CSE 142,A01,185463,Staff,36,0,60,24
1683349919069,CSE 142,B01,201355,Staff,0,7,60,60
1683349920092,CSE 142L,A01,185470,Staff,36,0,60,24
1683349920092,CSE 142L,B01,201417,Staff,0,6,60,60
1683349921124,CSE 190,A00,201433,Staff,32,0,49,17
1683349922153,DOC 1,A01,259136,Strom; Megan C.,7,0,15,8
1683349922153,DOC 1,A02,259137,Strom; Megan C.,14,0,15,1
1683349922153,DOC 1,A03,259138,Strom; Megan C.,14,0,15,1
1683349922153,DOC 1,A04,259139,Strom; Megan C.,14,0,15,1
1683349923177,DOC 100D,A00,259140,Pass; Natalye Joann,16,0,25,9
1683349924206,DSGN 1,A01,184749,Rill; Bryan,0,25,30,30
1683349925233,DSGN 100,A01,185168,Staff,0,2,25,25
1683349926259,ECE 5,A01,185626,Morris; Karcher William,0,10,0,0
1683349927284,ECE 101,A01,185628,Staff,17,0,70,53
1683349928311,ECE 107,A01,185635,Baghdadchi; Saharnaz,0,0,20,20
1683349928311,ECE 107,A02,185638,Baghdadchi; Saharnaz,4,0,20,16
1683349929338,ECE 148,A01,185647,Silberman; Jack,0,0,16,16
1683349930363,ECON 1,A01,185537,Crane; Meredith Helen,54,0,70,16
1683349931391,ECON 3,A01,185549,Crane; Meredith Helen,32,0,70,38
1683349932417,ECON 4,A01,203354,Anderson; John Charles,0,4,10,10
1683349933445,ECON 100A,A01,185574,Staff,0,4,40,40
1683349934470,ECON 100B,A01,185576,Staff,10,22,50,40
1683349935499,ECON 100C,A01,185589,Newhouse; Herbert S,29,0,70,41
1683349936528,ECON 105,A00,185608,Vespa; Emanuel Ignacio,19,0,35,16
1683349937556,ECON 109,A01,185610,Shishkin; Denis,10,0,35,25
1683349938581,ECON 110A,A01,185612,Staff,11,0,40,29
1683349939609,ECON 120A,A01,185615,Staff,20,0,40,20
1683349940634,ECON 120C,A01,185617,Sun; Yixiao,0,21,70,70
1683349941662,ECON 144,A00,203346,Squires; Dale E,3,0,35,32
1683349942690,ECON 171,A01,203349,Newhouse; Herbert S,0,1,35,35
1683349943718,ECON 173A,A01,185621,Toda; Alexis Akira,21,0,35,14
1683349944744,EDS 25,A01,202413,Staff,0,1,0,0
1683349944744,EDS 25,A02,202414,Staff,0,1,0,0
1683349944744,EDS 25,A03,202415,Staff,0,0,0,0
1683349944744,EDS 25,A04,202416,Staff,0,1,0,0
1683349944744,EDS 25,A05,202439,Staff,0,0,0,0
1683349944744,EDS 25,A06,202440,Staff,0,0,0,0
1683349944744,EDS 25,B01,202631,Staff,0,0,0,0
1683349944744,EDS 25,B02,202632,Staff,0,0,0,0
1683349944744,EDS 25,B03,202639,Staff,0,0,0,0
1683349944744,EDS 25,B04,202640,Staff,0,0,0,0
1683349944744,EDS 25,B05,202643,Staff,0,0,0,0
1683349944744,EDS 25,B06,202644,Staff,0,0,0,0
1683349945770,EDS 38,A01,202659,Black; Alison Michelle,24,0,25,1
1683349946796,EDS 115,A00,202652,Staff,18,0,30,12
1683349947819,EDS 125,A00,202649,Staff,14,0,30,16
1683349948844,EDS 126,A01,203332,Staff,30,0,30,0
1683349949869,EDS 139,A00,202838,Staff,16,0,25,9
1683349950896,EDS 146,A01,202655,Staff,14,0,25,11
1683349951941,ENG 15,A00,185667,Staff,0,1,0,0
1683349951941,ENG 15,B00,185672,Staff,0,0,0,0
1683349951941,ENG 15,C00,185675,Staff,0,0,0,0
1683349951941,ENG 15,D00,185682,Staff,0,0,0,0
1683349951941,ENG 15,E00,185684,Staff,0,0,0,0
1683349952965,ETHN 103,A00,185710,Staff,0,4,35,35
1683349953989,ETHN 103A,A00,199228,Man; Simeon S,2,0,9,7
1683349955016,ETHN 109,A00,185711,Staff,18,0,35,17
1683349956041,ETHN 142,A00,185726,Staff,0,4,30,30
1683349957066,ETHN 163J,A00,199229,Man; Simeon S,5,0,8,3
1683349958091,ETHN 168,A00,185727,Staff,8,0,10,2
1683349959115,ETHN 182,A00,185728,Staff,0,0,35,35
1683349960139,ETHN 183,A00,185737,Staff,8,0,18,10
1683349961163,GLBH 111,A01,209361,Burgos; Jose L.,0,0,0,0
1683349963263,HIEU 104,A00,185792,Staff,16,0,20,4
1683349964285,HIEU 115,A00,185800,Staff,1,0,20,19
1683349965308,HIEU 128,A00,185801,Staff,0,7,20,20
1683349966332,HIEU 147,A00,185802,Staff,16,0,20,4
1683349967357,HIEU 154,A00,185823,Staff,12,0,20,8
1683349968381,HILA 102,A00,185826,Staff,13,0,20,7
1683349969406,HILD 2C,A01,185778,Staff,0,12,20,20
1683349970431,HILD 7B,A01,185780,Kwak; Nancy,0,15,32,32
1683349970431,HILD 7B,A02,185781,Kwak; Nancy,0,18,32,32
1683349971459,HILD 30,A01,185791,Staff,14,0,20,6
1683349972485,HISC 119,A00,185830,Golan; Tal,0,9,20,20
1683349973509,HITO 156GS,A00,185831,Patterson; Patrick H.,0,0,0,23
1683349974535,HIUS 103,A00,185832,Man; Simeon S,0,6,20,20
1683349975563,HIUS 117,A00,185836,Kwak; Nancy,2,0,20,18
1683349976590,HIUS 125,A00,185840,Man; Simeon S,0,0,23,23
1683349977615,HIUS 149,A00,185845,Staff,0,0,20,20
1683349978642,HUM 3,A01,185882,Zavodny; Tatiana Sophia,0,7,50,50
1683349978642,HUM 3,B01,185899,Caldwell; Michael Alan,0,18,50,50
1683349979669,HUM 3GS,A00,185900,Patterson; Patrick H.,0,0,0,23
1683349980697,HUM 4,A01,185938,Zroka; Amy Liane,31,0,50,19
1683349980697,HUM 4,B01,185956,Watkins; Eric,0,3,50,50
1683349980697,HUM 4,B02,202209,Watkins; Eric,0,2,50,50
1683349980697,HUM 4,B03,202210,Watkins; Eric,0,2,50,50
1683349981723,HUM 5,A01,185958,West; Geoffrey Scott,3,0,50,47
1683349981723,HUM 5,A02,202215,West; Geoffrey Scott,0,0,50,50
1683349982748,INTL 190,A00,185959,Gagnon; Jeffrey C,0,0,0,9
1683349982748,INTL 190,B00,185960,Lettieri; Michael Joseph,0,0,0,1
1683349983775,JAPN 180,A00,254509,Staff,5,1,30,25
1683349984800,LATI 10,A01,202853,Kennemore; Amy Michelle,4,0,35,31
1683349984800,LATI 10,A02,202854,Kennemore; Amy Michelle,2,0,35,33
1683349984800,LATI 10,A03,270054,Kennemore; Amy Michelle,30,0,30,0
1683349985827,LATI 180,A00,202855,Kennemore; Amy Michelle,11,0,20,9
1683349986852,LAWS 101,A00,201767,Golan; Tal,0,7,40,40
1683349987879,LIFR 1C,A00,185961,Staff,6,0,20,14
1683349988905,LIFR 1CX,A00,185962,Staff,7,0,20,13
1683349989932,LIFR 1D,A00,185963,Staff,9,0,20,11
1683349990957,LIFR 1DX,A00,185964,Staff,9,0,20,11
1683349991980,LIGN 101,A01,186039,Staff,43,0,50,7
1683349993011,LIGN 165,A00,186040,Staff,18,0,50,32
1683349994037,LTCS 108,A00,186041,Staff,6,0,10,4
1683349995063,LTCS 119,A00,186042,Staff,16,0,20,4
1683349996088,LTCS 130,A00,186043,Wesling; Megan E.,15,0,25,10
1683349998137,LTEA 138,A00,186119,Staff,14,0,40,26
1683349999160,LTEN 124,A00,186148,Staff,6,0,25,19
1683350000185,LTEN 178,A00,186149,Staff,7,0,15,8
1683350001211,LTEN 181,A00,186150,Blanco; John D,33,0,40,7
1683350002236,LTWL 120,A00,186160,Staff,20,0,25,5
1683350003261,LTWL 165,A00,186161,Staff,22,0,25,3
1683350004286,LTWR 100,A00,186162,Staff,0,5,15,15
1683350005313,LTWR 102,A00,186163,Doller; Ben,5,0,15,10
1683350006337,MAE 8,A01,186412,Staff,0,0,0,0
1683350007360,MAE 30B,A00,186445,Bahadori; Mohammad Yousef,83,0,100,17
1683350008384,MAE 40,A00,186592,Bewley; Thomas R,9,0,50,41
1683350009409,MAE 101B,A00,186593,Bahadori; Mohammad Yousef,81,0,100,19
1683350010433,MAE 105,A00,186594,Bandaru; Prabhakar,12,0,50,38
1683350011462,MAE 107,A00,186599,Pham; Hieu Tan,0,6,120,120
1683350012488,MAE 148,A01,186660,Silberman; Jack,3,0,16,13
1683350013513,MATH 10A,A01,188095,Staff,1,6,35,34
1683350014542,MATH 10B,A01,188097,Bowers; Adam R.,0,11,30,30
1683350014542,MATH 10B,A02,188099,Bowers; Adam R.,0,11,30,30
1683350014542,MATH 10B,B01,188104,Bowers; Adam R.,0,10,30,30
1683350014542,MATH 10B,B02,188106,Bowers; Adam R.,0,10,30,30
1683350015568,MATH 10C,A01,188111,Staff,0,18,30,30
1683350015568,MATH 10C,A02,188127,Staff,0,17,30,30
1683350015568,MATH 10C,A03,188131,Staff,0,18,30,30
1683350015568,MATH 10C,B01,188218,Staff,18,0,30,12
1683350015568,MATH 10C,B02,188244,Staff,13,0,30,17
1683350015568,MATH 10C,B03,188277,Staff,16,0,30,14
1683350016597,MATH 18,A01,188344,Bach; Quang Tran,18,0,30,12
1683350016597,MATH 18,A02,188345,Bach; Quang Tran,11,0,30,19
1683350016597,MATH 18,B01,188353,Bach; Quang Tran,10,0,30,20
1683350016597,MATH 18,B02,188354,Bach; Quang Tran,20,0,30,10
1683350017625,MATH 20A,A01,188374,Staff,13,0,35,22
1683350018654,MATH 20B,A01,188382,Ohm; Ko Woon,6,0,30,24
1683350018654,MATH 20B,A02,188383,Ohm; Ko Woon,22,0,30,8
1683350018654,MATH 20B,B01,188385,Ohm; Ko Woon,7,0,30,23
1683350018654,MATH 20B,B02,188392,Ohm; Ko Woon,22,0,30,8
1683350019679,MATH 20C,A01,188394,Harel; Guershon,10,0,30,20
1683350019679,MATH 20C,A02,188395,Harel; Guershon,15,0,30,15
1683350019679,MATH 20C,B01,188404,Harel; Guershon,4,0,30,26
1683350019679,MATH 20C,B02,188405,Harel; Guershon,19,0,30,11
1683350020709,MATH 20D,A01,188414,Hammock; Frances H,0,1,30,30
1683350020709,MATH 20D,A02,188415,Hammock; Frances H,3,0,30,27
1683350020709,MATH 20D,B01,188447,Hammock; Frances H,1,0,30,29
1683350020709,MATH 20D,B02,188486,Hammock; Frances H,8,0,30,22
1683350021737,MATH 20E,A01,188649,Staff,21,0,30,9
1683350021737,MATH 20E,A02,188650,Staff,23,0,30,7
1683350021737,MATH 20E,A03,188673,Staff,0,0,30,30
1683350022765,MATH 102,A01,188675,Staff,0,35,35,35
1683350023791,MATH 103B,A01,188681,Staff,3,0,35,32
1683350023791,MATH 103B,B01,188692,Staff,5,0,35,30
1683350024816,MATH 109,A01,188695,Salehi Golsefidy; Alireza,25,0,35,10
1683350024816,MATH 109,A02,188696,Salehi Golsefidy; Alireza,25,0,35,10
1683350025844,MATH 120A,A01,188698,Eggers; John Dietrich,7,0,35,28
1683350026869,MATH 142B,A01,188736,Ioana; Adrian,0,2,30,30
1683350026869,MATH 142B,A02,188741,Ioana; Adrian,1,1,30,29
1683350026869,MATH 142B,A03,188743,Ioana; Adrian,1,3,30,29
1683350027895,MATH 168A,A01,188790,Staff,0,9,35,35
1683350028924,MATH 170A,A01,188803,Nie; Jiawang,0,2,35,35
1683350028924,MATH 170A,A02,188811,Nie; Jiawang,0,0,35,35
1683350028924,MATH 170A,A03,188814,Nie; Jiawang,1,0,35,34
1683350028924,MATH 170A,A04,188815,Nie; Jiawang,13,0,35,22
1683350029948,MATH 193B,A01,188817,Staff,0,0,35,35
1683350029948,MATH 193B,A02,188818,Staff,5,0,35,30
1683350030973,MGT 4,A01,202857,Anderson; John Charles,62,0,80,18
1683350032001,MGT 12,A00,202858,Lindenberger; Wade Douglas,42,0,90,48
1683350033027,MGT 18,A00,202859,Staff,74,0,90,16
1683350034055,MGT 18GS,A00,202860,McKay; Michael J,13,0,28,15
1683350035077,MGT 45,A00,202861,Pecore; Joseph P.,14,0,90,76
1683350036104,MGT 100,A00,202863,Yavorsky; Daniel Ryan,28,0,90,62
1683350037128,MGT 103,A00,202864,Ehrich; Kristine R,1,18,90,89
1683350038151,MGT 112,A00,202865,Ehrich; Kristine R,15,0,90,75
1683350039178,MGT 121A,A00,202868,Staff,0,20,0,0
1683350040202,MGT 131B,A00,202869,Anderson; John Charles,59,0,90,31
1683350041225,MGT 136,A00,202871,Lindenberger; Wade Douglas,84,0,90,6
1683350042253,MGT 164,A00,202873,Staff,0,68,90,91
1683350043278,MGT 164GS,A00,202874,McKay; Mary A,13,0,28,15
1683350044303,MGT 180,A00,202875,Staff,0,50,90,91
1683350045332,MMW 11R,A01,205019,Herbst; Matthew,3,0,30,27
1683350045332,MMW 11R,A02,205026,Herbst; Matthew,29,0,30,1
1683350046364,MMW 15,A01,193512,Chang; Edmond Yi-Teh,0,9,28,28
1683350046364,MMW 15,A02,193513,Chang; Edmond Yi-Teh,0,5,28,28
1683350046364,MMW 15,A03,193514,Chang; Edmond Yi-Teh,0,5,28,28
1683350046364,MMW 15,A04,193515,Chang; Edmond Yi-Teh,0,5,28,28
1683350046364,MMW 15,A05,193516,Chang; Edmond Yi-Teh,0,4,28,28
1683350046364,MMW 15,A06,193517,Chang; Edmond Yi-Teh,0,5,28,28
1683350046364,MMW 15,B01,193519,Chang; Edmond Yi-Teh,0,5,28,28
1683350046364,MMW 15,B02,193520,Chang; Edmond Yi-Teh,0,5,28,28
1683350046364,MMW 15,B03,193521,Chang; Edmond Yi-Teh,0,5,28,28
1683350046364,MMW 15,B04,193522,Chang; Edmond Yi-Teh,0,4,28,28
1683350046364,MMW 15,B05,193523,Chang; Edmond Yi-Teh,0,5,28,28
1683350046364,MMW 15,B06,193524,Chang; Edmond Yi-Teh,0,4,28,28
1683350047392,MMW 122,A01,193526,Rahimi; Babak,0,15,28,28
1683350047392,MMW 122,A02,193527,Rahimi; Babak,0,14,28,28
1683350047392,MMW 122,A03,193528,Rahimi; Babak,0,0,0,0
1683350047392,MMW 122,A04,193529,Rahimi; Babak,0,0,0,0
1683350048418,MUS 1A,A01,186663,Staff,0,20,35,35
1683350049443,MUS 4,A01,186715,Staff,0,12,35,35
1683350050466,MUS 5R,A01,186796,Dubnov; Shlomo,0,17,35,35
1683350051491,MUS 6,A01,186798,Staff,0,4,25,25
1683350052515,MUS 7,A01,186830,Staff,13,0,35,22
1683350053542,MUS 8,A01,186930,Staff,0,26,35,35
1683350054570,MUS 15,A01,186932,Staff,0,16,35,35
1683350054570,MUS 15,B01,186934,Staff,0,15,35,35
1683350055598,MUS 80,A00,186935,Staff,1,0,20,19
1683350055598,MUS 80,B00,186936,Staff,25,0,25,0
1683350056624,NANO 11,A00,204702,Lipomi; Darren John,0,0,0,0
1683350057649,NANO 15,A01,204709,Yang; Kesong,0,1,0,0
1683350058675,NANO 114,A00,202069,Jahed Motlagh; Zeinab,3,0,10,7
1683350059699,PHIL 1,A00,186955,Grush; Rick Scott,32,0,40,8
1683350060723,PHIL 10,A01,186973,Grush; Rick Scott,28,0,35,7
1683350060723,PHIL 10,A02,186974,Grush; Rick Scott,33,0,35,2
1683350061748,PHIL 13,A01,186976,Staff,7,0,35,28
1683350061748,PHIL 13,A02,186977,Staff,16,0,35,19
1683350062776,PHIL 14,A01,186979,Staff,31,0,35,4
1683350062776,PHIL 14,A02,186986,Staff,32,0,35,3
1683350063801,PHIL 28,A01,186988,Staff,16,0,30,14
1683350063801,PHIL 28,A02,186989,Staff,1,0,30,29
1683350063801,PHIL 28,A03,186990,Staff,9,0,30,21
1683350063801,PHIL 28,A04,186991,Staff,26,0,30,4
1683350064826,PHIL 120,A00,186997,Staff,23,0,40,17
1683350065913,PHIL 137,A00,187003,Staff,9,0,40,31
1683350066941,PHIL 150,A00,187015,Staff,47,0,70,23
1683350067973,PHIL 167,A00,187021,Lamey; Andy M.,35,0,40,5
1683350068997,PHIL 174,A01,202226,Staff,17,0,20,3
1683350068997,PHIL 174,A02,202235,Staff,20,0,20,0
1683350070022,PHIL 191A,A00,258918,Staff,0,0,1,1
1683350071049,PHYS 1A,A00,187028,Staff,27,0,60,33
1683350072077,PHYS 1AL,001,187036,Staff,2,0,30,28
1683350072077,PHYS 1AL,002,187049,Staff,18,0,30,12
1683350073102,PHYS 1B,A00,187058,Staff,22,0,60,38
1683350074127,PHYS 1BL,001,187064,Staff,0,0,30,30
1683350074127,PHYS 1BL,002,187070,Staff,5,0,30,25
1683350075151,PHYS 1C,A00,187082,Staff,31,0,120,89
1683350076177,PHYS 1CL,001,187088,Staff,0,9,30,30
1683350076177,PHYS 1CL,002,187089,Staff,0,2,30,30
1683350076177,PHYS 1CL,009,262693,Staff,11,0,30,19
1683350077203,PHYS 2B,A01,187097,Staff,54,0,115,61
1683350078233,PHYS 2C,A01,187099,Staff,67,0,115,48
1683350079260,PHYS 2CL,A01,187101,Staff,5,0,28,23
1683350079260,PHYS 2CL,A02,187102,Staff,15,0,28,13
1683350080289,PHYS 2D,A01,187123,Shotwell; Brian,95,0,115,20
1683350081320,PHYS 4B,A01,187133,Grinstein; Benjamin,35,0,50,15
1683350082345,POLI 10,A00,188819,Staff,0,4,50,50
1683350083370,POLI 11,A00,188827,Staff,43,0,50,7
1683350084396,POLI 13R,A00,188828,Staff,0,1,20,20
1683350085424,POLI 27,A01,188830,Elgin; Samuel Zincke,0,1,70,70
1683350086451,POLI 30,A00,188832,Desposato; Scott,31,0,50,19
1683350087475,POLI 102F,A00,188834,Staff,3,0,40,37
1683350088502,POLI 104A,A00,188852,Staff,14,0,30,16
1683350089526,POLI 104I,A00,188853,Staff,0,6,20,20
1683350090549,POLI 110B,A00,188854,Wiens; David,7,0,20,13
1683350091577,POLI 112A,A00,188855,Wiens; David,5,0,30,25
1683350092604,POLI 117R,A00,188856,Forman; Fonna,0,11,20,20
1683350093628,POLI 118,A00,188857,Ingham; Sean,8,0,20,12
1683350094654,POLI 120G,A00,188858,Staff,9,0,30,21
1683350095682,POLI 131CR,A00,188863,Hoston; Germaine,24,0,50,26
1683350096706,POLI 133,A00,188864,Nellis; Gareth Hb,44,0,50,6
1683350097730,POLI 134D,A00,188865,Desposato; Scott,27,0,30,3
1683350098759,POLI 142A,A00,188871,Gartzke; Erik,22,0,50,28
1683350099782,POLI 142K,A00,188874,Staff,38,0,50,12
1683350100805,POLI 143,A00,188940,Gartzke; Erik,16,0,30,14
1683350101828,POLI 153,A00,188943,Staff,3,0,20,17
1683350102854,POLI 160AA,A00,188944,Staff,11,0,40,29
1683350103880,POLI 170A,A00,188945,Staff,11,0,30,19
1683350105927,PSYC 1,A00,188952,Staff,37,0,90,53
1683350106953,PSYC 2,B00,188953,Staff,19,0,35,16
1683350107980,PSYC 6,A00,188970,Staff,47,0,60,13
1683350109004,PSYC 7,A00,188973,Staff,37,0,45,8
1683350110028,PSYC 60,A01,188980,Rickard; Timothy C.,43,0,60,17
1683350111052,PSYC 70,A01,189001,Steiner; Eric Tomas,23,0,45,22
1683350112077,PSYC 100,A00,189005,Lacefield; Katharine I,0,98,120,120
1683350113100,PSYC 102,A00,189008,Staff,9,0,30,21
1683350114128,PSYC 106,B00,189026,Gorman; Michael R.,34,0,60,26
1683350115152,PSYC 114,B01,189033,Winkielman; Piotr,0,32,30,30
1683350116174,PSYC 131,A00,189036,Anagnostaras; Stephan,0,43,60,60
1683350117201,PSYC 136,A00,189041,Lowe; Angela Beth,0,7,25,25
1683350118225,PSYC 137,A00,189057,Winkielman; Piotr,0,34,25,25
1683350119248,PSYC 144,A00,189107,Wixted; John T,0,7,50,50
1683350121296,PSYC 162,A00,189142,Staff,0,8,85,85
1683350122320,PSYC 172,A00,189144,Gorman; Michael R.,0,7,30,30
1683350124373,PSYC 179,A00,189146,Lacefield; Katharine I,0,84,120,120
1683350125397,PSYC 181,A00,189147,Anagnostaras; Stephan,0,44,90,90
1683350126423,PSYC 190R,A00,189148,Barner; David A.,0,22,80,80
1683350127446,PSYC 191,A00,189275,Rickard; Timothy C.,0,7,25,25
1683350128471,PSYC 193,A00,189276,Chapman; Eddie Nathaniel,0,1,0,4
1683350129495,PSYC 193L,A01,189281,Lowe; Angela Beth,12,0,20,8
1683350129495,PSYC 193L,B01,189285,Staff,28,0,35,7
1683350130522,RELI 149,A00,187137,Rahimi; Babak,7,0,40,33
1683350131547,SE 9,A01,187315,Staff,0,2,18,18
1683350132571,SE 101B,A00,187409,Staff,24,0,30,6
1683350133595,SE 110B,A00,187444,Staff,10,0,40,30
1683350134623,SE 130B,A00,187449,Staff,31,0,40,9
1683350135652,SE 150A,A00,187516,Staff,9,0,20,11
1683350136676,SE 154,A00,187528,Staff,30,0,50,20
1683350137701,SIO 3,A01,258171,Staff,35,0,40,5
1683350138724,SIO 10,A00,187144,Cook; Geoffrey W,0,3,75,75
1683350139749,SIO 45,A00,187152,Cook; Geoffrey W,1,0,100,99
1683350140773,SIO 109R,A00,194486,Staff,0,3,20,20
1683350142824,SIO 187,A01,187233,Kacev; David,12,0,40,28
1683350143848,SOCI 1,A01,258656,Thorpe; Charles Robert,28,0,30,2
1683350143848,SOCI 1,A02,258658,Thorpe; Charles Robert,30,0,30,0
1683350143848,SOCI 1,A03,258661,Thorpe; Charles Robert,25,0,25,0
1683350143848,SOCI 1,A04,258666,Thorpe; Charles Robert,22,0,25,3
1683350143848,SOCI 1,A05,258897,Thorpe; Charles Robert,23,0,25,2
1683350143848,SOCI 1,A06,258898,Thorpe; Charles Robert,25,0,25,0
1683350144873,SOCI 30,A01,258903,Pardo Guerra; Juan Pablo,15,0,30,15
1683350145897,SOCI 102,A00,258904,Staff,9,0,25,16
1683350146924,SOCI 106,A00,258905,Staff,19,0,25,6
1683350147950,SOCI 111,A00,258907,Ribas Norris; Janet Vanesa,26,0,30,4
1683350148976,SOCI 121R,A00,258908,Pardo Guerra; Juan Pablo,10,0,30,20
1683350150005,SOCI 126,A01,203330,Staff,14,0,20,6
1683350151032,SOCI 131,A00,258909,Thorpe; Charles Robert,31,0,60,29
1683350152059,SOCI 135,A00,258910,Payne; Christine Anna,0,9,30,30
1683350153086,SOCI 157,A00,258911,Staff,12,0,30,18
1683350154113,SOCI 184,A00,258912,Staff,25,0,30,5
1683350155139,SOCI 188D,A00,258913,Staff,21,0,30,9
1683350156167,SYN 2,001,187529,Staff,10,0,16,6
1683350156167,SYN 2,002,201452,Staff,0,18,16,16
1683350156167,SYN 2,003,201469,Staff,3,0,16,13
1683350157193,SYN 100,A01,187531,Staff,0,9,20,20
1683350157193,SYN 100,B01,201491,Staff,0,12,20,20
1683350158217,TDAC 1,A00,189286,Walsh; Kim C.,3,0,20,17
1683350158217,TDAC 1,B00,189287,Harting; Carla Kelso,11,0,20,9
1683350159242,TDAC 101,A00,189300,Walsh; Kim C.,16,0,20,4
1683350159242,TDAC 101,B00,189301,Harting; Carla Kelso,18,0,20,2
1683350160270,TDAC 102,A00,189304,Basso; Beatrice,14,0,20,6
1683350161298,TDAC 108,A00,189305,Staff,18,0,20,2
1683350162323,TDDE 131,A00,189310,Staff,19,0,20,1
1683350162323,TDDE 131,B00,189314,Staff,19,0,20,1
1683350162323,TDDE 131,C00,189315,Staff,48,0,50,2
1683350162323,TDDE 131,D00,189316,Staff,14,0,15,1
1683350162323,TDDE 131,E00,204841,Staff,20,0,20,0
1683350163347,TDGE 10,A00,189289,Staff,30,0,50,20
1683350163347,TDGE 10,B00,189290,Havis; Allan,1,0,50,49
1683350164372,TDGE 11,A00,189291,Fulton; Julia,0,3,50,50
1683350164372,TDGE 11,B00,189292,Staff,20,0,25,5
1683350164372,TDGE 11,C00,260270,Staff,0,0,0,0
1683350165400,TDGE 25,A00,189294,Staff,3,0,20,17
1683350166424,TDGE 124,A00,189318,Fulton; Julia,0,8,50,50
1683350167449,TDGE 125,A00,189319,Staff,13,0,25,12
1683350167449,TDGE 125,B00,189320,Staff,23,0,25,2
1683350168474,TDGE 127,A00,189322,Havis; Allan,0,0,50,50
1683350169557,TDHT 101,A00,189323,Staff,18,0,25,7
1683350169557,TDHT 101,B00,189324,Staff,25,0,25,0
1683350170581,TDHT 102,A00,189325,Staff,49,0,50,1
1683350171606,TDMV 1,A00,189295,Arcidiacono; Kristin,19,0,30,11
1683350171606,TDMV 1,B00,189296,Caligagan; Maria T.,24,0,30,6
1683350172630,TDMV 2,A00,189297,Sammartano; Tonnie,28,0,30,2
1683350172630,TDMV 2,B00,189299,Arcidiacono; Kristin,24,0,30,6
1683350173658,TDMV 3,A00,204998,Rincon; Alicia,22,0,30,8
1683350174682,TDMV 120,A00,189458,Sammartano; Tonnie,28,0,30,2
1683350175705,TDMV 138,A00,189541,Jun; Grace Shin Hae,22,0,40,18
1683350176729,TDMV 142,A00,189717,Caligagan; Tony,23,0,30,7
1683350176729,TDMV 142,B00,189718,Caligagan; Maria T.,25,0,30,5
1683350177753,TMC 2,A01,187533,Staff,25,0,25,0
1683350177753,TMC 2,A02,187534,Staff,25,0,25,0
1683350178781,USP 1,A01,187536,Kwak; Nancy,0,16,25,25
1683350179809,USP 5,A01,187538,Staff,10,0,25,15
1683350180836,USP 101,A00,199253,Staff,0,4,0,0
1683350181860,USP 124,A00,187562,Boomhower; Matthew Charles,1,0,30,29
1683350182887,USP 138,A00,187582,Staff,20,0,25,5
1683350183911,USP 152,A01,187597,Staff,4,0,25,21
1683350184935,USP 153,A00,187598,Staff,19,0,25,6
1683350185962,USP 168,A00,187607,Kwak; Nancy,2,0,5,3
1683350186986,USP 173,A00,187619,Staff,4,0,25,21
1683350188021,USP 181,A00,187638,Staff,0,1,25,25
1683350189048,VIS 103,A00,187650,Cruz; Edwin Teddy,22,0,75,53
1683350190076,VIS 110D,A00,187669,Staff,12,0,22,10
1683350191100,VIS 127C,A00,187720,Shen; Kuiyi,67,0,146,79
1683350192124,VIS 149,A00,187731,Yoldas; Pinar,0,14,22,22
1683350193151,VIS 151,A01,188091,Staff,22,0,34,12
1683350193151,VIS 151,A02,188092,Staff,11,0,34,23
1683350194175,VIS 160B,A00,188093,Stalbaum; Brett,0,0,10,10
1683350196224,WCWP 10B,A00,201720,Staff,10,0,15,5
1683350196224,WCWP 10B,B00,201722,Staff,9,0,15,6
1683350197248,WCWP 100,A00,201725,Gagnon; Jeffrey C,0,0,2,2
1683350197248,WCWP 100,B00,201727,Staff,0,4,15,15
1683350200335,ANBI 133,A00,258401,Wilder; Linnea Lorene,34,0,40,6
1683350201362,ANBI 140,A00,258395,Hrvoj Mihic; Branka,18,0,25,7
1683350202389,ANSC 120,A00,258402,Bialecki; Jon Anthony,27,0,40,13
1683350203412,ANSC 144,A00,258400,Staff,14,0,40,26
1683350205459,ANSC 166,A00,258396,Parish; Steven Martin,157,0,175,18
1683350206483,ANSC 180,A00,193533,Staff,9,0,20,11
1683350207508,ANSC 188,A00,258397,Jassal; Aftab,33,0,40,7
1683350208535,ANTH 3,A01,258316,Staff,23,0,30,7
1683350209558,ANTH 5,A00,258394,Semendeferi; Ekaterini,16,0,20,4
1683350210583,ANTH 21,A01,258331,Staff,8,0,40,32
1683350211611,ANTH 103,A00,258398,Varma; Saiba,15,0,25,10
1683350212640,AWP 10,001,202034,Staff,0,0,0,0
1683350212640,AWP 10,002,202035,Staff,0,0,0,0
1683350212640,AWP 10,003,202036,Staff,0,0,0,0
1683350212640,AWP 10,004,202037,Staff,0,0,0,0
1683350212640,AWP 10,005,202038,Staff,0,0,0,0
1683350212640,AWP 10,006,202039,Staff,0,0,0,0
1683350212640,AWP 10,007,202040,Staff,0,0,0,0
1683350212640,AWP 10,008,202041,Staff,0,0,0,0
1683350212640,AWP 10,009,202042,Staff,0,0,0,0
1683350212640,AWP 10,010,202043,Staff,0,0,0,0
1683350212640,AWP 10,011,202044,Staff,0,0,0,0
1683350212640,AWP 10,012,202045,Staff,0,0,0,0
1683350212640,AWP 10,013,202046,Staff,0,0,0,0
1683350212640,AWP 10,014,202047,Staff,0,0,0,0
1683350212640,AWP 10,015,202048,Staff,0,0,0,0
1683350212640,AWP 10,016,202049,Staff,0,0,0,0
1683350212640,AWP 10,017,202050,Staff,0,0,0,0
1683350212640,AWP 10,018,202051,Staff,0,0,0,0
1683350212640,AWP 10,019,202052,Staff,0,0,0,0
1683350212640,AWP 10,020,202053,Staff,0,0,0,0
1683350212640,AWP 10,021,202054,Staff,0,0,0,0
1683350212640,AWP 10,022,202055,Staff,0,0,0,0
1683350212640,AWP 10,023,202056,Staff,0,0,0,0
1683350212640,AWP 10,024,202057,Staff,0,0,0,0
1683350212640,AWP 10,025,202058,Staff,0,0,0,0
1683350212640,AWP 10,026,202059,Staff,0,0,0,0
1683350213663,AWP 102,001,202032,Staff,0,0,0,0
1683350213663,AWP 102,002,202033,Staff,0,0,0,0
1683350214687,BENG 100,A01,254234,Taylor Amos; Alyssa C,31,0,40,9
1683350215712,BENG 196,001,270013,Engler; Adam J.,9999,0,9999,0
1683350216737,BICD 100R,A01,202018,Smith; Laurie,0,7,32,32
1683350216737,BICD 100R,A02,202019,Smith; Laurie,0,2,32,32
1683350216737,BICD 100R,A03,202020,Smith; Laurie,0,1,32,32
1683350216737,BICD 100R,A04,202021,Smith; Laurie,9,0,32,23
1683350216737,BICD 100R,A05,202022,Smith; Laurie,12,0,32,20
1683350217761,BICD 136,A01,193242,Gustafson-Brown; Cindy,0,2,32,32
1683350217761,BICD 136,A02,193244,Gustafson-Brown; Cindy,14,0,32,18
1683350218784,BIEB 102,A01,193249,Butler; Shannon Rhey,0,2,32,32
1683350218784,BIEB 102,A02,193251,Butler; Shannon Rhey,0,0,32,32
1683350218784,BIEB 102,A03,193253,Butler; Shannon Rhey,0,1,32,32
1683350218784,BIEB 102,A04,193255,Butler; Shannon Rhey,17,0,32,15
1683350218784,BIEB 102,A05,193265,Butler; Shannon Rhey,26,0,32,6
1683350218784,BIEB 102,A06,193269,Butler; Shannon Rhey,16,0,32,16
1683350220832,BIEB 150,A01,193274,Staff,0,0,32,32
1683350220832,BIEB 150,A02,193285,Staff,23,0,32,9
1683350221859,BIEB 194,A00,193286,Kurle; Carolyn M.,22,0,32,10
1683350222885,BILD 1,A01,192291,Staff,16,0,32,16
1683350222885,BILD 1,A02,192292,Staff,30,0,32,2
1683350222885,BILD 1,B01,192520,Reuther; Keefe,0,1,0,0
1683350222885,BILD 1,B02,192532,Reuther; Keefe,0,1,0,0
1683350223916,BILD 3,A01,192556,Butler; Shannon Rhey,0,0,32,32
1683350223916,BILD 3,A02,192581,Butler; Shannon Rhey,4,0,32,28
1683350223916,BILD 3,A03,192611,Butler; Shannon Rhey,23,0,32,9
1683350223916,BILD 3,A04,192612,Butler; Shannon Rhey,25,0,32,7
1683350223916,BILD 3,A05,192613,Butler; Shannon Rhey,27,0,32,5
1683350223916,BILD 3,A06,192679,Butler; Shannon Rhey,27,0,32,5
1683350223916,BILD 3,A07,192682,Butler; Shannon Rhey,22,0,32,10
1683350224947,BILD 4,A01,192836,Reuther; Keefe,0,0,24,24
1683350224947,BILD 4,A02,193044,Reuther; Keefe,4,0,24,20
1683350225974,BILD 10,A01,193142,Gustafson-Brown; Cindy,30,0,32,2
1683350225974,BILD 10,A02,193149,Gustafson-Brown; Cindy,31,0,32,1
1683350227006,BIMM 100,A01,193301,Staff,0,6,32,32
1683350227006,BIMM 100,A02,193312,Staff,0,5,32,32
1683350227006,BIMM 100,A03,193323,Staff,0,8,32,32
1683350228032,BIMM 101,A01,193329,McDonnell; Lisa Marie,0,3,24,24
1683350228032,BIMM 101,A02,193339,McDonnell; Lisa Marie,0,3,24,24
1683350228032,BIMM 101,B01,193354,McDonnell; Lisa Marie,0,3,24,24
1683350228032,BIMM 101,B02,193357,McDonnell; Lisa Marie,0,3,24,24
1683350229063,BIMM 110,A01,193377,Tat; John,0,11,32,32
1683350229063,BIMM 110,A02,193378,Tat; John,1,9,32,31
1683350230086,BIMM 120,A01,206116,Staff,0,0,32,32
1683350230086,BIMM 120,A02,206117,Staff,8,0,32,24
1683350230086,BIMM 120,A03,206121,Staff,21,0,32,11
1683350231111,BIPN 100,A01,193393,Park; Ji Young,0,14,32,32
1683350231111,BIPN 100,A02,193402,Park; Ji Young,0,13,32,32
1683350231111,BIPN 100,A03,193413,Park; Ji Young,0,14,32,32
1683350231111,BIPN 100,A04,193414,Park; Ji Young,0,13,32,32
1683350232136,BIPN 102,A01,193429,Staff,0,0,32,32
1683350232136,BIPN 102,A02,193438,Staff,22,0,32,10
1683350233161,BIPN 106,A01,193450,Reyes Gonzalez; Catalina,0,2,40,40
1683350234186,BIPN 134,A01,193465,Cooke; James Edward,0,0,32,32
1683350234186,BIPN 134,A02,193474,Cooke; James Edward,25,0,32,7
1683350234186,BIPN 134,A03,193485,Cooke; James Edward,29,0,32,3
1683350234186,BIPN 134,A04,193486,Cooke; James Edward,21,0,32,11
1683350234186,BIPN 134,A05,193491,Cooke; James Edward,31,0,32,1
1683350234186,BIPN 134,A06,193501,Cooke; James Edward,30,0,32,2
1683350234186,BIPN 134,A07,193510,Cooke; James Edward,29,0,32,3
1683350236239,BISP 194,A00,222522,Staff,14,0,32,18
1683350237264,CAT 124,A01,202407,Staff,20,0,25,5
1683350238290,CAT 125,A00,202408,Marchisotto; Jennifer Anne,4,0,20,16
1683350239318,CAT 125R,A00,202409,Smith; Lauryn Alissa,0,11,20,20
1683350239318,CAT 125R,B00,202410,Morales; Celeste Georgianna,0,11,20,20
1683350239318,CAT 125R,C00,202411,Irwin; Matthew Joseph,0,10,20,20
1683350240341,CENG 15,A01,204712,Yang; Kesong,0,1,0,0
1683350241366,CENG 114,A00,202070,Jahed Motlagh; Zeinab,5,0,20,15
1683350242393,CGS 105,A00,185477,Wesling; Megan E.,24,0,40,16
1683350243417,CGS 106,A00,185494,Staff,13,0,22,9
1683350244441,CGS 108,A00,185495,Staff,14,0,20,6
1683350245465,CGS 114,A00,185496,Staff,13,0,18,5
1683350246489,CGS 119,A00,185501,Staff,15,0,20,5
1683350247514,CGS 120,A00,185511,Staff,13,0,20,7
1683350248544,CHEM 4,A01,184675,Bussey; Thomas J,96,0,100,4
1683350249572,CHEM 6A,A01,184677,Staff,34,0,60,26
1683350250596,CHEM 6B,A01,184679,Staff,65,0,100,35
1683350251623,CHEM 6C,A01,184681,Bussey; Thomas J,1,0,50,49
1683350251623,CHEM 6C,A02,184682,Bussey; Thomas J,34,0,50,16
1683350252648,CHEM 40A,A01,184684,Albizati; Kim F.,37,0,100,63
1683350253675,CHEM 40B,A01,184686,Albizati; Kim F.,0,20,100,100
1683350254701,CHEM 41B,A01,184690,Staff,52,0,100,48
1683350255725,COGS 3,A01,184715,Boyle; Mary E. T.,0,25,40,40
1683350256749,COGS 14B,A01,185172,Staff,0,15,38,38
1683350257773,COGS 18,A01,184736,Staff,17,0,80,63
1683350258799,COGS 100,A01,184932,Staff,0,5,73,73
1683350259823,COGS 101A,A01,184935,Staff,0,39,30,30
1683350260847,COGS 101B,A01,184944,Staff,0,2,30,30
1683350261873,COGS 101C,A01,184946,Staff,0,12,30,30
1683350262897,COGS 102A,A01,184951,Johnson; Christine M.,2,0,40,38
1683350263926,COGS 107B,A01,184953,Mooshagian; Eric Frederick,0,50,40,40
1683350264954,COGS 118B,A01,184959,Gupta; Anjum,0,48,40,40
1683350265982,COGS 153,A00,184961,Staff,0,15,30,30
1683350267010,COGS 177,A00,184962,Staff,0,20,30,30
1683350268038,COGS 187A,A01,184969,Boyle; Mary E. T.,0,17,40,40
1683350269065,COMM 10,A01,185174,Staff,0,5,25,25
1683350269065,COMM 10,A02,185189,Staff,0,5,25,25
1683350269065,COMM 10,A03,269821,Staff,0,0,0,0
1683350270093,COMM 100B,A01,185475,Staff,0,0,0,2
1683350270093,COMM 100B,A02,185476,Staff,13,0,25,12
1683350271117,COMM 100C,A01,185314,Staff,1,0,25,24
1683350271117,COMM 100C,A02,185327,Staff,19,0,25,6
1683350272142,COMM 110M,A00,185349,Staff,2,0,40,38
1683350273226,COMM 113T,A00,185352,Staff,24,0,40,16
1683350274251,COMM 114I,A00,185353,Staff,33,0,40,7
1683350275274,COMM 131,A00,185354,Staff,19,0,30,11
1683350276301,CSE 8A,A50,185358,Cao; Yingjun,0,46,10,10
1683350277327,CSE 8B,A01,185362,Staff,1,47,50,49
1683350278352,CSE 11,A01,185416,Cao; Yingjun,0,92,10,10
1683350279382,CSE 20,A01,185445,Briones; Jor-el Thomas Caparas,5,0,25,20
1683350280406,CSE 21,A01,185447,Staff,10,0,50,40
1683350281435,CSE 101,A01,185451,Staff,0,13,50,50
1683350281435,CSE 101,B01,185453,Jones; Miles E,0,11,50,50
1683350283489,CSE 141,A01,185458,Eldon; John,20,0,100,80
1683350284521,CSE 141L,A01,185461,Eldon; John,12,0,100,88
1683350285548,CSE 142,A01,185463,Staff,36,0,60,24
1683350285548,CSE 142,B01,201355,Staff,0,7,60,60
1683350286573,CSE 142L,A01,185470,Staff,36,0,60,24
1683350286573,CSE 142L,B01,201417,Staff,0,6,60,60
1683350287603,CSE 190,A00,201433,Staff,32,0,49,17
1683350288630,DOC 1,A01,259136,Strom; Megan C.,7,0,15,8
1683350288630,DOC 1,A02,259137,Strom; Megan C.,14,0,15,1
1683350288630,DOC 1,A03,259138,Strom; Megan C.,14,0,15,1
1683350288630,DOC 1,A04,259139,Strom; Megan C.,14,0,15,1
1683350289658,DOC 100D,A00,259140,Pass; Natalye Joann,16,0,25,9
1683350290685,DSGN 1,A01,184749,Rill; Bryan,0,25,30,30
1683350291710,DSGN 100,A01,185168,Staff,0,2,25,25
1683350292735,ECE 5,A01,185626,Morris; Karcher William,0,10,0,0
1683350293760,ECE 101,A01,185628,Staff,17,0,70,53
1683350294785,ECE 107,A01,185635,Baghdadchi; Saharnaz,0,0,20,20
1683350294785,ECE 107,A02,185638,Baghdadchi; Saharnaz,4,0,20,16
1683350295810,ECE 148,A01,185647,Silberman; Jack,0,0,16,16
1683350296835,ECON 1,A01,185537,Crane; Meredith Helen,54,0,70,16
1683350297863,ECON 3,A01,185549,Crane; Meredith Helen,32,0,70,38
1683350298893,ECON 4,A01,203354,Anderson; John Charles,0,4,10,10
1683350299918,ECON 100A,A01,185574,Staff,0,4,40,40
1683350300942,ECON 100B,A01,185576,Staff,10,22,50,40
1683350301969,ECON 100C,A01,185589,Newhouse; Herbert S,29,0,70,41
1683350302997,ECON 105,A00,185608,Vespa; Emanuel Ignacio,19,0,35,16
1683350304025,ECON 109,A01,185610,Shishkin; Denis,10,0,35,25
1683350305049,ECON 110A,A01,185612,Staff,11,0,40,29
1683350306074,ECON 120A,A01,185615,Staff,20,0,40,20
1683350307103,ECON 120C,A01,185617,Sun; Yixiao,0,21,70,70
1683350308127,ECON 144,A00,203346,Squires; Dale E,3,0,35,32
1683350309152,ECON 171,A01,203349,Newhouse; Herbert S,0,1,35,35
1683350310180,ECON 173A,A01,185621,Toda; Alexis Akira,21,0,35,14
1683350311203,EDS 25,A01,202413,Staff,0,1,0,0
1683350311203,EDS 25,A02,202414,Staff,0,1,0,0
1683350311203,EDS 25,A03,202415,Staff,0,0,0,0
1683350311203,EDS 25,A04,202416,Staff,0,1,0,0
1683350311203,EDS 25,A05,202439,Staff,0,0,0,0
1683350311203,EDS 25,A06,202440,Staff,0,0,0,0
1683350311203,EDS 25,B01,202631,Staff,0,0,0,0
1683350311203,EDS 25,B02,202632,Staff,0,0,0,0
1683350311203,EDS 25,B03,202639,Staff,0,0,0,0
1683350311203,EDS 25,B04,202640,Staff,0,0,0,0
1683350311203,EDS 25,B05,202643,Staff,0,0,0,0
1683350311203,EDS 25,B06,202644,Staff,0,0,0,0
1683350312229,EDS 38,A01,202659,Black; Alison Michelle,24,0,25,1
1683350313256,EDS 115,A00,202652,Staff,18,0,30,12
1683350314280,EDS 125,A00,202649,Staff,14,0,30,16
1683350315304,EDS 126,A01,203332,Staff,30,0,30,0
1683350316328,EDS 139,A00,202838,Staff,16,0,25,9
1683350317352,EDS 146,A01,202655,Staff,14,0,25,11
1683350318381,ENG 15,A00,185667,Staff,0,1,0,0
1683350318381,ENG 15,B00,185672,Staff,0,0,0,0
1683350318381,ENG 15,C00,185675,Staff,0,0,0,0
1683350318381,ENG 15,D00,185682,Staff,0,0,0,0
1683350318381,ENG 15,E00,185684,Staff,0,0,0,0
1683350319406,ETHN 103,A00,185710,Staff,0,4,35,35
1683350320433,ETHN 103A,A00,199228,Man; Simeon S,2,0,9,7
1683350321460,ETHN 109,A00,185711,Staff,18,0,35,17
1683350322483,ETHN 142,A00,185726,Staff,0,4,30,30
1683350323506,ETHN 163J,A00,199229,Man; Simeon S,5,0,8,3
1683350324529,ETHN 168,A00,185727,Staff,8,0,10,2
1683350325553,ETHN 182,A00,185728,Staff,0,0,35,35
1683350326578,ETHN 183,A00,185737,Staff,8,0,18,10
1683350327606,GLBH 111,A01,209361,Burgos; Jose L.,0,0,0,0
1683350329658,HIEU 104,A00,185792,Staff,16,0,20,4
1683350330686,HIEU 115,A00,185800,Staff,1,0,20,19
1683350331713,HIEU 128,A00,185801,Staff,0,7,20,20
1683350332744,HIEU 147,A00,185802,Staff,16,0,20,4
1683350333769,HIEU 154,A00,185823,Staff,12,0,20,8
1683350334793,HILA 102,A00,185826,Staff,13,0,20,7
1683350335818,HILD 2C,A01,185778,Staff,0,12,20,20
1683350336842,HILD 7B,A01,185780,Kwak; Nancy,0,15,32,32
1683350336842,HILD 7B,A02,185781,Kwak; Nancy,0,18,32,32
1683350337870,HILD 30,A01,185791,Staff,14,0,20,6
1683350338895,HISC 119,A00,185830,Golan; Tal,0,9,20,20
1683350339920,HITO 156GS,A00,185831,Patterson; Patrick H.,0,0,0,23
1683350340944,HIUS 103,A00,185832,Man; Simeon S,0,6,20,20
1683350341968,HIUS 117,A00,185836,Kwak; Nancy,2,0,20,18
1683350342993,HIUS 125,A00,185840,Man; Simeon S,0,0,23,23
1683350344017,HIUS 149,A00,185845,Staff,0,0,20,20
1683350345042,HUM 3,A01,185882,Zavodny; Tatiana Sophia,0,7,50,50
1683350345042,HUM 3,B01,185899,Caldwell; Michael Alan,0,18,50,50
1683350346070,HUM 3GS,A00,185900,Patterson; Patrick H.,0,0,0,23
1683350347099,HUM 4,A01,185938,Zroka; Amy Liane,31,0,50,19
1683350347099,HUM 4,B01,185956,Watkins; Eric,0,3,50,50
1683350347099,HUM 4,B02,202209,Watkins; Eric,0,2,50,50
1683350347099,HUM 4,B03,202210,Watkins; Eric,0,2,50,50
1683350348124,HUM 5,A01,185958,West; Geoffrey Scott,3,0,50,47
1683350348124,HUM 5,A02,202215,West; Geoffrey Scott,0,0,50,50
1683350349149,INTL 190,A00,185959,Gagnon; Jeffrey C,0,0,0,9
1683350349149,INTL 190,B00,185960,Lettieri; Michael Joseph,0,0,0,1
1683350350173,JAPN 180,A00,254509,Staff,5,1,30,25
1683350351223,LATI 10,A01,202853,Kennemore; Amy Michelle,4,0,35,31
1683350351223,LATI 10,A02,202854,Kennemore; Amy Michelle,2,0,35,33
1683350351223,LATI 10,A03,270054,Kennemore; Amy Michelle,30,0,30,0
1683350352247,LATI 180,A00,202855,Kennemore; Amy Michelle,11,0,20,9
1683350353274,LAWS 101,A00,201767,Golan; Tal,0,7,40,40
1683350354298,LIFR 1C,A00,185961,Staff,6,0,20,14
1683350355323,LIFR 1CX,A00,185962,Staff,7,0,20,13
1683350356346,LIFR 1D,A00,185963,Staff,9,0,20,11
1683350357370,LIFR 1DX,A00,185964,Staff,9,0,20,11
1683350358397,LIGN 101,A01,186039,Staff,43,0,50,7
1683350359421,LIGN 165,A00,186040,Staff,18,0,50,32
1683350360444,LTCS 108,A00,186041,Staff,6,0,10,4
1683350361471,LTCS 119,A00,186042,Staff,16,0,20,4
1683350362499,LTCS 130,A00,186043,Wesling; Megan E.,15,0,25,10
1683350364550,LTEA 138,A00,186119,Staff,14,0,40,26
1683350365574,LTEN 124,A00,186148,Staff,6,0,25,19
1683350366598,LTEN 178,A00,186149,Staff,7,0,15,8
1683350367626,LTEN 181,A00,186150,Blanco; John D,33,0,40,7
1683350368650,LTWL 120,A00,186160,Staff,20,0,25,5
1683350369676,LTWL 165,A00,186161,Staff,22,0,25,3
1683350370700,LTWR 100,A00,186162,Staff,0,5,15,15
1683350371723,LTWR 102,A00,186163,Doller; Ben,5,0,15,10
1683350372747,MAE 8,A01,186412,Staff,0,0,0,0
1683350373770,MAE 30B,A00,186445,Bahadori; Mohammad Yousef,83,0,100,17
1683350374794,MAE 40,A00,186592,Bewley; Thomas R,9,0,50,41
1683350375822,MAE 101B,A00,186593,Bahadori; Mohammad Yousef,81,0,100,19
1683350376918,MAE 105,A00,186594,Bandaru; Prabhakar,12,0,50,38
1683350377943,MAE 107,A00,186599,Pham; Hieu Tan,0,6,120,120
1683350378970,MAE 148,A01,186660,Silberman; Jack,3,0,16,13
1683350379998,MATH 10A,A01,188095,Staff,1,6,35,34
1683350381023,MATH 10B,A01,188097,Bowers; Adam R.,0,11,30,30
1683350381023,MATH 10B,A02,188099,Bowers; Adam R.,0,11,30,30
1683350381023,MATH 10B,B01,188104,Bowers; Adam R.,0,10,30,30
1683350381023,MATH 10B,B02,188106,Bowers; Adam R.,0,10,30,30
1683350382049,MATH 10C,A01,188111,Staff,0,18,30,30
1683350382049,MATH 10C,A02,188127,Staff,0,17,30,30
1683350382049,MATH 10C,A03,188131,Staff,0,18,30,30
1683350382049,MATH 10C,B01,188218,Staff,18,0,30,12
1683350382049,MATH 10C,B02,188244,Staff,13,0,30,17
1683350382049,MATH 10C,B03,188277,Staff,16,0,30,14
1683350383072,MATH 18,A01,188344,Bach; Quang Tran,18,0,30,12
1683350383072,MATH 18,A02,188345,Bach; Quang Tran,11,0,30,19
1683350383072,MATH 18,B01,188353,Bach; Quang Tran,10,0,30,20
1683350383072,MATH 18,B02,188354,Bach; Quang Tran,20,0,30,10
1683350384099,MATH 20A,A01,188374,Staff,12,0,35,23
1683350385125,MATH 20B,A01,188382,Ohm; Ko Woon,6,0,30,24
1683350385125,MATH 20B,A02,188383,Ohm; Ko Woon,22,0,30,8
1683350385125,MATH 20B,B01,188385,Ohm; Ko Woon,7,0,30,23
1683350385125,MATH 20B,B02,188392,Ohm; Ko Woon,22,0,30,8
1683350386153,MATH 20C,A01,188394,Harel; Guershon,10,0,30,20
1683350386153,MATH 20C,A02,188395,Harel; Guershon,15,0,30,15
1683350386153,MATH 20C,B01,188404,Harel; Guershon,4,0,30,26
1683350386153,MATH 20C,B02,188405,Harel; Guershon,19,0,30,11
1683350387183,MATH 20D,A01,188414,Hammock; Frances H,0,1,30,30
1683350387183,MATH 20D,A02,188415,Hammock; Frances H,3,0,30,27
1683350387183,MATH 20D,B01,188447,Hammock; Frances H,1,0,30,29
1683350387183,MATH 20D,B02,188486,Hammock; Frances H,8,0,30,22
1683350388206,MATH 20E,A01,188649,Staff,21,0,30,9
1683350388206,MATH 20E,A02,188650,Staff,23,0,30,7
1683350388206,MATH 20E,A03,188673,Staff,0,0,30,30
1683350389232,MATH 102,A01,188675,Staff,0,35,35,35
1683350390257,MATH 103B,A01,188681,Staff,3,0,35,32
1683350390257,MATH 103B,B01,188692,Staff,5,0,35,30
1683350391281,MATH 109,A01,188695,Salehi Golsefidy; Alireza,25,0,35,10
1683350391281,MATH 109,A02,188696,Salehi Golsefidy; Alireza,25,0,35,10
1683350392308,MATH 120A,A01,188698,Eggers; John Dietrich,7,0,35,28
1683350393335,MATH 142B,A01,188736,Ioana; Adrian,0,2,30,30
1683350393335,MATH 142B,A02,188741,Ioana; Adrian,1,1,30,29
1683350393335,MATH 142B,A03,188743,Ioana; Adrian,2,3,30,28
1683350394360,MATH 168A,A01,188790,Staff,0,9,35,35
1683350395387,MATH 170A,A01,188803,Nie; Jiawang,0,2,35,35
1683350395387,MATH 170A,A02,188811,Nie; Jiawang,0,0,35,35
1683350395387,MATH 170A,A03,188814,Nie; Jiawang,1,0,35,34
1683350395387,MATH 170A,A04,188815,Nie; Jiawang,13,0,35,22
1683350396411,MATH 193B,A01,188817,Staff,0,0,35,35
1683350396411,MATH 193B,A02,188818,Staff,5,0,35,30
1683350397439,MGT 4,A01,202857,Anderson; John Charles,62,0,80,18
1683350398467,MGT 12,A00,202858,Lindenberger; Wade Douglas,42,0,90,48
1683350399491,MGT 18,A00,202859,Staff,74,0,90,16
1683350400518,MGT 18GS,A00,202860,McKay; Michael J,13,0,28,15
1683350401545,MGT 45,A00,202861,Pecore; Joseph P.,14,0,90,76
1683350402570,MGT 100,A00,202863,Yavorsky; Daniel Ryan,28,0,90,62
1683350403594,MGT 103,A00,202864,Ehrich; Kristine R,1,18,90,89
1683350404617,MGT 112,A00,202865,Ehrich; Kristine R,15,0,90,75
1683350405647,MGT 121A,A00,202868,Staff,0,20,0,0
1683350406670,MGT 131B,A00,202869,Anderson; John Charles,59,0,90,31
1683350407699,MGT 136,A00,202871,Lindenberger; Wade Douglas,84,0,90,6
1683350408725,MGT 164,A00,202873,Staff,0,68,90,91
1683350409752,MGT 164GS,A00,202874,McKay; Mary A,13,0,28,15
1683350410776,MGT 180,A00,202875,Staff,0,50,90,91
1683350411802,MMW 11R,A01,205019,Herbst; Matthew,3,0,30,27
1683350411802,MMW 11R,A02,205026,Herbst; Matthew,29,0,30,1
1683350412829,MMW 15,A01,193512,Chang; Edmond Yi-Teh,0,9,28,28
1683350412829,MMW 15,A02,193513,Chang; Edmond Yi-Teh,0,5,28,28
1683350412829,MMW 15,A03,193514,Chang; Edmond Yi-Teh,0,5,28,28
1683350412829,MMW 15,A04,193515,Chang; Edmond Yi-Teh,0,5,28,28
1683350412829,MMW 15,A05,193516,Chang; Edmond Yi-Teh,0,4,28,28
1683350412829,MMW 15,A06,193517,Chang; Edmond Yi-Teh,0,5,28,28
1683350412829,MMW 15,B01,193519,Chang; Edmond Yi-Teh,0,5,28,28
1683350412829,MMW 15,B02,193520,Chang; Edmond Yi-Teh,0,5,28,28
1683350412829,MMW 15,B03,193521,Chang; Edmond Yi-Teh,0,5,28,28
1683350412829,MMW 15,B04,193522,Chang; Edmond Yi-Teh,0,4,28,28
1683350412829,MMW 15,B05,193523,Chang; Edmond Yi-Teh,0,5,28,28
1683350412829,MMW 15,B06,193524,Chang; Edmond Yi-Teh,0,4,28,28
1683350413857,MMW 122,A01,193526,Rahimi; Babak,0,15,28,28
1683350413857,MMW 122,A02,193527,Rahimi; Babak,0,14,28,28
1683350413857,MMW 122,A03,193528,Rahimi; Babak,0,0,0,0
1683350413857,MMW 122,A04,193529,Rahimi; Babak,0,0,0,0
1683350414881,MUS 1A,A01,186663,Staff,0,20,35,35
1683350415905,MUS 4,A01,186715,Staff,0,12,35,35
1683350416933,MUS 5R,A01,186796,Dubnov; Shlomo,0,17,35,35
1683350417958,MUS 6,A01,186798,Staff,0,4,25,25
1683350418984,MUS 7,A01,186830,Staff,13,0,35,22
1683350420011,MUS 8,A01,186930,Staff,0,26,35,35
1683350421035,MUS 15,A01,186932,Staff,0,16,35,35
1683350421035,MUS 15,B01,186934,Staff,0,15,35,35
1683350422060,MUS 80,A00,186935,Staff,1,0,20,19
1683350422060,MUS 80,B00,186936,Staff,25,0,25,0
1683350423084,NANO 11,A00,204702,Lipomi; Darren John,0,0,0,0
1683350424107,NANO 15,A01,204709,Yang; Kesong,0,1,0,0
1683350425129,NANO 114,A00,202069,Jahed Motlagh; Zeinab,3,0,10,7
1683350426156,PHIL 1,A00,186955,Grush; Rick Scott,32,0,40,8
1683350427183,PHIL 10,A01,186973,Grush; Rick Scott,28,0,35,7
1683350427183,PHIL 10,A02,186974,Grush; Rick Scott,33,0,35,2
1683350428209,PHIL 13,A01,186976,Staff,7,0,35,28
1683350428209,PHIL 13,A02,186977,Staff,16,0,35,19
1683350429236,PHIL 14,A01,186979,Staff,31,0,35,4
1683350429236,PHIL 14,A02,186986,Staff,32,0,35,3
1683350430260,PHIL 28,A01,186988,Staff,16,0,30,14
1683350430260,PHIL 28,A02,186989,Staff,1,0,30,29
1683350430260,PHIL 28,A03,186990,Staff,9,0,30,21
1683350430260,PHIL 28,A04,186991,Staff,26,0,30,4
1683350431286,PHIL 120,A00,186997,Staff,23,0,40,17
1683350432312,PHIL 137,A00,187003,Staff,9,0,40,31
1683350433340,PHIL 150,A00,187015,Staff,47,0,70,23
1683350434363,PHIL 167,A00,187021,Lamey; Andy M.,35,0,40,5
1683350435391,PHIL 174,A01,202226,Staff,17,0,20,3
1683350435391,PHIL 174,A02,202235,Staff,20,0,20,0
1683350436417,PHIL 191A,A00,258918,Staff,0,0,1,1
1683350437447,PHYS 1A,A00,187028,Staff,27,0,60,33
1683350438470,PHYS 1AL,001,187036,Staff,2,0,30,28
1683350438470,PHYS 1AL,002,187049,Staff,18,0,30,12
1683350439494,PHYS 1B,A00,187058,Staff,22,0,60,38
1683350440518,PHYS 1BL,001,187064,Staff,0,0,30,30
1683350440518,PHYS 1BL,002,187070,Staff,5,0,30,25
1683350441542,PHYS 1C,A00,187082,Staff,31,0,120,89
1683350442568,PHYS 1CL,001,187088,Staff,0,9,30,30
1683350442568,PHYS 1CL,002,187089,Staff,0,2,30,30
1683350442568,PHYS 1CL,009,262693,Staff,11,0,30,19
1683350443594,PHYS 2B,A01,187097,Staff,54,0,115,61
1683350444617,PHYS 2C,A01,187099,Staff,67,0,115,48
1683350445641,PHYS 2CL,A01,187101,Staff,5,0,28,23
1683350445641,PHYS 2CL,A02,187102,Staff,15,0,28,13
1683350446665,PHYS 2D,A01,187123,Shotwell; Brian,95,0,115,20
1683350447692,PHYS 4B,A01,187133,Grinstein; Benjamin,35,0,50,15
1683350448716,POLI 10,A00,188819,Staff,0,4,50,50
1683350449741,POLI 11,A00,188827,Staff,43,0,50,7
1683350450765,POLI 13R,A00,188828,Staff,0,1,20,20
1683350451789,POLI 27,A01,188830,Elgin; Samuel Zincke,0,1,70,70
1683350452813,POLI 30,A00,188832,Desposato; Scott,31,0,50,19
1683350453838,POLI 102F,A00,188834,Staff,3,0,40,37
1683350454866,POLI 104A,A00,188852,Staff,14,0,30,16
1683350455889,POLI 104I,A00,188853,Staff,0,6,20,20
1683350456917,POLI 110B,A00,188854,Wiens; David,7,0,20,13
1683350457941,POLI 112A,A00,188855,Wiens; David,5,0,30,25
1683350458968,POLI 117R,A00,188856,Forman; Fonna,0,11,20,20
1683350459993,POLI 118,A00,188857,Ingham; Sean,8,0,20,12
1683350461017,POLI 120G,A00,188858,Staff,9,0,30,21
1683350462045,POLI 131CR,A00,188863,Hoston; Germaine,24,0,50,26
1683350463071,POLI 133,A00,188864,Nellis; Gareth Hb,44,0,50,6
1683350464094,POLI 134D,A00,188865,Desposato; Scott,27,0,30,3
1683350465120,POLI 142A,A00,188871,Gartzke; Erik,22,0,50,28
1683350466144,POLI 142K,A00,188874,Staff,38,0,50,12
1683350467168,POLI 143,A00,188940,Gartzke; Erik,16,0,30,14
1683350468192,POLI 153,A00,188943,Staff,3,0,20,17
1683350469214,POLI 160AA,A00,188944,Staff,11,0,40,29
1683350470240,POLI 170A,A00,188945,Staff,11,0,30,19
1683350472290,PSYC 1,A00,188952,Staff,37,0,90,53
1683350473316,PSYC 2,B00,188953,Staff,19,0,35,16
1683350474340,PSYC 6,A00,188970,Staff,47,0,60,13
1683350475366,PSYC 7,A00,188973,Staff,37,0,45,8
1683350476393,PSYC 60,A01,188980,Rickard; Timothy C.,43,0,60,17
1683350477422,PSYC 70,A01,189001,Steiner; Eric Tomas,23,0,45,22
1683350478446,PSYC 100,A00,189005,Lacefield; Katharine I,0,98,120,120
1683350479470,PSYC 102,A00,189008,Staff,9,0,30,21
1683350480550,PSYC 106,B00,189026,Gorman; Michael R.,34,0,60,26
1683350481579,PSYC 114,B01,189033,Winkielman; Piotr,0,32,30,30
1683350482606,PSYC 131,A00,189036,Anagnostaras; Stephan,0,43,60,60
1683350483634,PSYC 136,A00,189041,Lowe; Angela Beth,0,7,25,25
1683350484658,PSYC 137,A00,189057,Winkielman; Piotr,0,34,25,25
1683350485685,PSYC 144,A00,189107,Wixted; John T,0,7,50,50
1683350487764,PSYC 162,A00,189142,Staff,0,8,85,85
1683350488789,PSYC 172,A00,189144,Gorman; Michael R.,0,7,30,30
1683350490836,PSYC 179,A00,189146,Lacefield; Katharine I,0,84,120,120
1683350491861,PSYC 181,A00,189147,Anagnostaras; Stephan,0,44,90,90
1683350492884,PSYC 190R,A00,189148,Barner; David A.,0,22,80,80
1683350493911,PSYC 191,A00,189275,Rickard; Timothy C.,0,7,25,25
1683350494938,PSYC 193,A00,189276,Chapman; Eddie Nathaniel,0,1,0,4
1683350495963,PSYC 193L,A01,189281,Lowe; Angela Beth,12,0,20,8
1683350495963,PSYC 193L,B01,189285,Staff,28,0,35,7
1683350496987,RELI 149,A00,187137,Rahimi; Babak,7,0,40,33
1683350498012,SE 9,A01,187315,Staff,0,2,18,18
1683350499035,SE 101B,A00,187409,Staff,24,0,30,6
1683350500062,SE 110B,A00,187444,Staff,10,0,40,30
1683350501086,SE 130B,A00,187449,Staff,31,0,40,9
1683350502114,SE 150A,A00,187516,Staff,9,0,20,11
1683350503137,SE 154,A00,187528,Staff,30,0,50,20
1683350504163,SIO 3,A01,258171,Staff,35,0,40,5
1683350505187,SIO 10,A00,187144,Cook; Geoffrey W,0,3,75,75
1683350506213,SIO 45,A00,187152,Cook; Geoffrey W,1,0,100,99
1683350507239,SIO 109R,A00,194486,Staff,0,3,20,20
1683350509290,SIO 187,A01,187233,Kacev; David,12,0,40,28
1683350510318,SOCI 1,A01,258656,Thorpe; Charles Robert,28,0,30,2
1683350510318,SOCI 1,A02,258658,Thorpe; Charles Robert,30,0,30,0
1683350510318,SOCI 1,A03,258661,Thorpe; Charles Robert,25,0,25,0
1683350510318,SOCI 1,A04,258666,Thorpe; Charles Robert,22,0,25,3
1683350510318,SOCI 1,A05,258897,Thorpe; Charles Robert,23,0,25,2
1683350510318,SOCI 1,A06,258898,Thorpe; Charles Robert,25,0,25,0
1683350511342,SOCI 30,A01,258903,Pardo Guerra; Juan Pablo,15,0,30,15
1683350512369,SOCI 102,A00,258904,Staff,9,0,25,16
1683350513394,SOCI 106,A00,258905,Staff,19,0,25,6
1683350514422,SOCI 111,A00,258907,Ribas Norris; Janet Vanesa,26,0,30,4
1683350515448,SOCI 121R,A00,258908,Pardo Guerra; Juan Pablo,10,0,30,20
1683350516476,SOCI 126,A01,203330,Staff,14,0,20,6
1683350517502,SOCI 131,A00,258909,Thorpe; Charles Robert,31,0,60,29
1683350518527,SOCI 135,A00,258910,Payne; Christine Anna,0,9,30,30
1683350519549,SOCI 157,A00,258911,Staff,12,0,30,18
1683350520573,SOCI 184,A00,258912,Staff,25,0,30,5
1683350521597,SOCI 188D,A00,258913,Staff,21,0,30,9
1683350522624,SYN 2,001,187529,Staff,10,0,16,6
1683350522624,SYN 2,002,201452,Staff,0,18,16,16
1683350522624,SYN 2,003,201469,Staff,3,0,16,13
1683350523651,SYN 100,A01,187531,Staff,0,9,20,20
1683350523651,SYN 100,B01,201491,Staff,0,12,20,20
1683350524677,TDAC 1,A00,189286,Walsh; Kim C.,3,0,20,17
1683350524677,TDAC 1,B00,189287,Harting; Carla Kelso,11,0,20,9
1683350525704,TDAC 101,A00,189300,Walsh; Kim C.,16,0,20,4
1683350525704,TDAC 101,B00,189301,Harting; Carla Kelso,18,0,20,2
1683350526732,TDAC 102,A00,189304,Basso; Beatrice,14,0,20,6
1683350527759,TDAC 108,A00,189305,Staff,18,0,20,2
1683350528787,TDDE 131,A00,189310,Staff,19,0,20,1
1683350528787,TDDE 131,B00,189314,Staff,19,0,20,1
1683350528787,TDDE 131,C00,189315,Staff,48,0,50,2
1683350528787,TDDE 131,D00,189316,Staff,14,0,15,1
1683350528787,TDDE 131,E00,204841,Staff,20,0,20,0
1683350529815,TDGE 10,A00,189289,Staff,30,0,50,20
1683350529815,TDGE 10,B00,189290,Havis; Allan,1,0,50,49
1683350530842,TDGE 11,A00,189291,Fulton; Julia,0,3,50,50
1683350530842,TDGE 11,B00,189292,Staff,20,0,25,5
1683350530842,TDGE 11,C00,260270,Staff,0,0,0,0
1683350531869,TDGE 25,A00,189294,Staff,3,0,20,17
1683350532894,TDGE 124,A00,189318,Fulton; Julia,0,8,50,50
1683350533919,TDGE 125,A00,189319,Staff,13,0,25,12
1683350533919,TDGE 125,B00,189320,Staff,23,0,25,2
1683350534942,TDGE 127,A00,189322,Havis; Allan,0,0,50,50
1683350535966,TDHT 101,A00,189323,Staff,18,0,25,7
1683350535966,TDHT 101,B00,189324,Staff,25,0,25,0
1683350536991,TDHT 102,A00,189325,Staff,49,0,50,1
1683350538019,TDMV 1,A00,189295,Arcidiacono; Kristin,19,0,30,11
1683350538019,TDMV 1,B00,189296,Caligagan; Maria T.,24,0,30,6
1683350539050,TDMV 2,A00,189297,Sammartano; Tonnie,28,0,30,2
1683350539050,TDMV 2,B00,189299,Arcidiacono; Kristin,24,0,30,6
1683350540075,TDMV 3,A00,204998,Rincon; Alicia,22,0,30,8
1683350541099,TDMV 120,A00,189458,Sammartano; Tonnie,28,0,30,2
1683350542124,TDMV 138,A00,189541,Jun; Grace Shin Hae,22,0,40,18
1683350543151,TDMV 142,A00,189717,Caligagan; Tony,23,0,30,7
1683350543151,TDMV 142,B00,189718,Caligagan; Maria T.,25,0,30,5
1683350544176,TMC 2,A01,187533,Staff,25,0,25,0
1683350544176,TMC 2,A02,187534,Staff,25,0,25,0
1683350545201,USP 1,A01,187536,Kwak; Nancy,0,16,25,25
1683350546225,USP 5,A01,187538,Staff,10,0,25,15
1683350547250,USP 101,A00,199253,Staff,0,4,0,0
1683350548276,USP 124,A00,187562,Boomhower; Matthew Charles,1,0,30,29
1683350549303,USP 138,A00,187582,Staff,20,0,25,5
1683350550329,USP 152,A01,187597,Staff,4,0,25,21
1683350551352,USP 153,A00,187598,Staff,19,0,25,6
1683350552380,USP 168,A00,187607,Kwak; Nancy,2,0,5,3
1683350553407,USP 173,A00,187619,Staff,4,0,25,21
1683350554432,USP 181,A00,187638,Staff,0,1,25,25
1683350555458,VIS 103,A00,187650,Cruz; Edwin Teddy,22,0,75,53
1683350556484,VIS 110D,A00,187669,Staff,12,0,22,10
1683350557511,VIS 127C,A00,187720,Shen; Kuiyi,67,0,146,79
1683350558538,VIS 149,A00,187731,Yoldas; Pinar,0,14,22,22
1683350559566,VIS 151,A01,188091,Staff,22,0,34,12
1683350559566,VIS 151,A02,188092,Staff,11,0,34,23
1683350560589,VIS 160B,A00,188093,Stalbaum; Brett,0,0,10,10
1683350562637,WCWP 10B,A00,201720,Staff,10,0,15,5
1683350562637,WCWP 10B,B00,201722,Staff,9,0,15,6
1683350563661,WCWP 100,A00,201725,Gagnon; Jeffrey C,0,0,2,2
1683350563661,WCWP 100,B00,201727,Staff,0,4,15,15
1683350566754,ANBI 133,A00,258401,Wilder; Linnea Lorene,34,0,40,6
1683350567780,ANBI 140,A00,258395,Hrvoj Mihic; Branka,18,0,25,7
1683350568808,ANSC 120,A00,258402,Bialecki; Jon Anthony,27,0,40,13
1683350569834,ANSC 144,A00,258400,Staff,14,0,40,26
1683350571882,ANSC 166,A00,258396,Parish; Steven Martin,157,0,175,18
1683350572906,ANSC 180,A00,193533,Staff,9,0,20,11
1683350573933,ANSC 188,A00,258397,Jassal; Aftab,33,0,40,7
1683350574958,ANTH 3,A01,258316,Staff,23,0,30,7
1683350575984,ANTH 5,A00,258394,Semendeferi; Ekaterini,16,0,20,4
1683350577033,ANTH 21,A01,258331,Staff,8,0,40,32
1683350578057,ANTH 103,A00,258398,Varma; Saiba,15,0,25,10
1683350579083,AWP 10,001,202034,Staff,0,0,0,0
1683350579083,AWP 10,002,202035,Staff,0,0,0,0
1683350579083,AWP 10,003,202036,Staff,0,0,0,0
1683350579083,AWP 10,004,202037,Staff,0,0,0,0
1683350579083,AWP 10,005,202038,Staff,0,0,0,0
1683350579083,AWP 10,006,202039,Staff,0,0,0,0
1683350579083,AWP 10,007,202040,Staff,0,0,0,0
1683350579083,AWP 10,008,202041,Staff,0,0,0,0
1683350579083,AWP 10,009,202042,Staff,0,0,0,0
1683350579083,AWP 10,010,202043,Staff,0,0,0,0
1683350579083,AWP 10,011,202044,Staff,0,0,0,0
1683350579083,AWP 10,012,202045,Staff,0,0,0,0
1683350579083,AWP 10,013,202046,Staff,0,0,0,0
1683350579083,AWP 10,014,202047,Staff,0,0,0,0
1683350579083,AWP 10,015,202048,Staff,0,0,0,0
1683350579083,AWP 10,016,202049,Staff,0,0,0,0
1683350579083,AWP 10,017,202050,Staff,0,0,0,0
1683350579083,AWP 10,018,202051,Staff,0,0,0,0
1683350579083,AWP 10,019,202052,Staff,0,0,0,0
1683350579083,AWP 10,020,202053,Staff,0,0,0,0
1683350579083,AWP 10,021,202054,Staff,0,0,0,0
1683350579083,AWP 10,022,202055,Staff,0,0,0,0
1683350579083,AWP 10,023,202056,Staff,0,0,0,0
1683350579083,AWP 10,024,202057,Staff,0,0,0,0
1683350579083,AWP 10,025,202058,Staff,0,0,0,0
1683350579083,AWP 10,026,202059,Staff,0,0,0,0
1683350580118,AWP 102,001,202032,Staff,0,0,0,0
1683350580118,AWP 102,002,202033,Staff,0,0,0,0
1683350581142,BENG 100,A01,254234,Taylor Amos; Alyssa C,31,0,40,9
1683350582167,BENG 196,001,270013,Engler; Adam J.,9999,0,9999,0
1683350583193,BICD 100R,A01,202018,Smith; Laurie,0,7,32,32
1683350583193,BICD 100R,A02,202019,Smith; Laurie,0,2,32,32
1683350583193,BICD 100R,A03,202020,Smith; Laurie,0,1,32,32
1683350583193,BICD 100R,A04,202021,Smith; Laurie,9,0,32,23
1683350583193,BICD 100R,A05,202022,Smith; Laurie,12,0,32,20
1683350584277,BICD 136,A01,193242,Gustafson-Brown; Cindy,0,2,32,32
1683350584277,BICD 136,A02,193244,Gustafson-Brown; Cindy,14,0,32,18
1683350585301,BIEB 102,A01,193249,Butler; Shannon Rhey,0,2,32,32
1683350585301,BIEB 102,A02,193251,Butler; Shannon Rhey,0,0,32,32
1683350585301,BIEB 102,A03,193253,Butler; Shannon Rhey,0,1,32,32
1683350585301,BIEB 102,A04,193255,Butler; Shannon Rhey,17,0,32,15
1683350585301,BIEB 102,A05,193265,Butler; Shannon Rhey,26,0,32,6
1683350585301,BIEB 102,A06,193269,Butler; Shannon Rhey,16,0,32,16
1683350587356,BIEB 150,A01,193274,Staff,0,0,32,32
1683350587356,BIEB 150,A02,193285,Staff,23,0,32,9
1683350588382,BIEB 194,A00,193286,Kurle; Carolyn M.,22,0,32,10
1683350589410,BILD 1,A01,192291,Staff,16,0,32,16
1683350589410,BILD 1,A02,192292,Staff,30,0,32,2
1683350589410,BILD 1,B01,192520,Reuther; Keefe,0,1,0,0
1683350589410,BILD 1,B02,192532,Reuther; Keefe,0,1,0,0
1683350590438,BILD 3,A01,192556,Butler; Shannon Rhey,0,0,32,32
1683350590438,BILD 3,A02,192581,Butler; Shannon Rhey,4,0,32,28
1683350590438,BILD 3,A03,192611,Butler; Shannon Rhey,23,0,32,9
1683350590438,BILD 3,A04,192612,Butler; Shannon Rhey,25,0,32,7
1683350590438,BILD 3,A05,192613,Butler; Shannon Rhey,27,0,32,5
1683350590438,BILD 3,A06,192679,Butler; Shannon Rhey,27,0,32,5
1683350590438,BILD 3,A07,192682,Butler; Shannon Rhey,22,0,32,10
1683350591468,BILD 4,A01,192836,Reuther; Keefe,0,0,24,24
1683350591468,BILD 4,A02,193044,Reuther; Keefe,4,0,24,20
1683350592493,BILD 10,A01,193142,Gustafson-Brown; Cindy,30,0,32,2
1683350592493,BILD 10,A02,193149,Gustafson-Brown; Cindy,31,0,32,1
1683350593515,BIMM 100,A01,193301,Staff,0,6,32,32
1683350593515,BIMM 100,A02,193312,Staff,0,5,32,32
1683350593515,BIMM 100,A03,193323,Staff,0,8,32,32
1683350594538,BIMM 101,A01,193329,McDonnell; Lisa Marie,0,3,24,24
1683350594538,BIMM 101,A02,193339,McDonnell; Lisa Marie,0,3,24,24
1683350594538,BIMM 101,B01,193354,McDonnell; Lisa Marie,0,3,24,24
1683350594538,BIMM 101,B02,193357,McDonnell; Lisa Marie,0,3,24,24
1683350595563,BIMM 110,A01,193377,Tat; John,0,11,32,32
1683350595563,BIMM 110,A02,193378,Tat; John,1,9,32,31
1683350596586,BIMM 120,A01,206116,Staff,0,0,32,32
1683350596586,BIMM 120,A02,206117,Staff,8,0,32,24
1683350596586,BIMM 120,A03,206121,Staff,21,0,32,11
1683350597615,BIPN 100,A01,193393,Park; Ji Young,0,14,32,32
1683350597615,BIPN 100,A02,193402,Park; Ji Young,0,13,32,32
1683350597615,BIPN 100,A03,193413,Park; Ji Young,0,14,32,32
1683350597615,BIPN 100,A04,193414,Park; Ji Young,0,13,32,32
1683350598638,BIPN 102,A01,193429,Staff,0,0,32,32
1683350598638,BIPN 102,A02,193438,Staff,22,0,32,10
1683350599667,BIPN 106,A01,193450,Reyes Gonzalez; Catalina,0,2,40,40
1683350600694,BIPN 134,A01,193465,Cooke; James Edward,0,0,32,32
1683350600694,BIPN 134,A02,193474,Cooke; James Edward,25,0,32,7
1683350600694,BIPN 134,A03,193485,Cooke; James Edward,29,0,32,3
1683350600694,BIPN 134,A04,193486,Cooke; James Edward,21,0,32,11
1683350600694,BIPN 134,A05,193491,Cooke; James Edward,31,0,32,1
1683350600694,BIPN 134,A06,193501,Cooke; James Edward,30,0,32,2
1683350600694,BIPN 134,A07,193510,Cooke; James Edward,29,0,32,3
1683350602744,BISP 194,A00,222522,Staff,14,0,32,18
1683350603771,CAT 124,A01,202407,Staff,20,0,25,5
1683350604798,CAT 125,A00,202408,Marchisotto; Jennifer Anne,4,0,20,16
1683350605825,CAT 125R,A00,202409,Smith; Lauryn Alissa,0,11,20,20
1683350605825,CAT 125R,B00,202410,Morales; Celeste Georgianna,0,11,20,20
1683350605825,CAT 125R,C00,202411,Irwin; Matthew Joseph,0,10,20,20
1683350606852,CENG 15,A01,204712,Yang; Kesong,0,1,0,0
1683350607876,CENG 114,A00,202070,Jahed Motlagh; Zeinab,5,0,20,15
1683350608899,CGS 105,A00,185477,Wesling; Megan E.,24,0,40,16
1683350609923,CGS 106,A00,185494,Staff,13,0,22,9
1683350610948,CGS 108,A00,185495,Staff,14,0,20,6
1683350611973,CGS 114,A00,185496,Staff,13,0,18,5
1683350612999,CGS 119,A00,185501,Staff,15,0,20,5
1683350614022,CGS 120,A00,185511,Staff,13,0,20,7
1683350615047,CHEM 4,A01,184675,Bussey; Thomas J,96,0,100,4
1683350616074,CHEM 6A,A01,184677,Staff,34,0,60,26
1683350617099,CHEM 6B,A01,184679,Staff,65,0,100,35
1683350618127,CHEM 6C,A01,184681,Bussey; Thomas J,1,0,50,49
1683350618127,CHEM 6C,A02,184682,Bussey; Thomas J,34,0,50,16
1683350619154,CHEM 40A,A01,184684,Albizati; Kim F.,37,0,100,63
1683350620180,CHEM 40B,A01,184686,Albizati; Kim F.,0,20,100,100
1683350621206,CHEM 41B,A01,184690,Staff,52,0,100,48
1683350622230,COGS 3,A01,184715,Boyle; Mary E. T.,0,25,40,40
1683350623254,COGS 14B,A01,185172,Staff,0,15,38,38
1683350624279,COGS 18,A01,184736,Staff,17,0,80,63
1683350625309,COGS 100,A01,184932,Staff,0,5,73,73
1683350626333,COGS 101A,A01,184935,Staff,0,39,30,30
1683350627356,COGS 101B,A01,184944,Staff,0,2,30,30
1683350628381,COGS 101C,A01,184946,Staff,0,12,30,30
1683350629405,COGS 102A,A01,184951,Johnson; Christine M.,2,0,40,38
1683350630430,COGS 107B,A01,184953,Mooshagian; Eric Frederick,0,50,40,40
1683350631456,COGS 118B,A01,184959,Gupta; Anjum,0,48,40,40
1683350632483,COGS 153,A00,184961,Staff,0,15,30,30
1683350633539,COGS 177,A00,184962,Staff,0,20,30,30
1683350634567,COGS 187A,A01,184969,Boyle; Mary E. T.,0,17,40,40
1683350635593,COMM 10,A01,185174,Staff,0,5,25,25
1683350635593,COMM 10,A02,185189,Staff,0,5,25,25
1683350635593,COMM 10,A03,269821,Staff,0,0,0,0
1683350636616,COMM 100B,A01,185475,Staff,0,0,0,2
1683350636616,COMM 100B,A02,185476,Staff,13,0,25,12
1683350637640,COMM 100C,A01,185314,Staff,1,0,25,24
1683350637640,COMM 100C,A02,185327,Staff,19,0,25,6
1683350638668,COMM 110M,A00,185349,Staff,2,0,40,38
1683350639695,COMM 113T,A00,185352,Staff,24,0,40,16
1683350640723,COMM 114I,A00,185353,Staff,33,0,40,7
1683350641753,COMM 131,A00,185354,Staff,19,0,30,11
1683350642776,CSE 8A,A50,185358,Cao; Yingjun,0,46,10,10
1683350643801,CSE 8B,A01,185362,Staff,1,47,50,49
1683350644826,CSE 11,A01,185416,Cao; Yingjun,0,92,10,10
1683350645850,CSE 20,A01,185445,Briones; Jor-el Thomas Caparas,5,0,25,20
1683350646874,CSE 21,A01,185447,Staff,10,0,50,40
1683350647901,CSE 101,A01,185451,Staff,0,13,50,50
1683350647901,CSE 101,B01,185453,Jones; Miles E,0,11,50,50
1683350649952,CSE 141,A01,185458,Eldon; John,20,0,100,80
1683350650977,CSE 141L,A01,185461,Eldon; John,12,0,100,88
1683350652006,CSE 142,A01,185463,Staff,36,0,60,24
1683350652006,CSE 142,B01,201355,Staff,0,7,60,60
1683350653033,CSE 142L,A01,185470,Staff,36,0,60,24
1683350653033,CSE 142L,B01,201417,Staff,0,6,60,60
1683350654059,CSE 190,A00,201433,Staff,32,0,49,17
1683350655089,DOC 1,A01,259136,Strom; Megan C.,7,0,15,8
1683350655089,DOC 1,A02,259137,Strom; Megan C.,14,0,15,1
1683350655089,DOC 1,A03,259138,Strom; Megan C.,14,0,15,1
1683350655089,DOC 1,A04,259139,Strom; Megan C.,14,0,15,1
1683350656116,DOC 100D,A00,259140,Pass; Natalye Joann,16,0,25,9
1683350657153,DSGN 1,A01,184749,Rill; Bryan,0,25,30,30
1683350658178,DSGN 100,A01,185168,Staff,0,2,25,25
1683350659201,ECE 5,A01,185626,Morris; Karcher William,0,10,0,0
1683350660229,ECE 101,A01,185628,Staff,17,0,70,53
1683350661257,ECE 107,A01,185635,Baghdadchi; Saharnaz,0,0,20,20
1683350661257,ECE 107,A02,185638,Baghdadchi; Saharnaz,4,0,20,16
1683350662285,ECE 148,A01,185647,Silberman; Jack,0,0,16,16
1683350663313,ECON 1,A01,185537,Crane; Meredith Helen,54,0,70,16
1683350664341,ECON 3,A01,185549,Crane; Meredith Helen,32,0,70,38
1683350665363,ECON 4,A01,203354,Anderson; John Charles,0,4,10,10
1683350666387,ECON 100A,A01,185574,Staff,0,4,40,40
1683350667410,ECON 100B,A01,185576,Staff,10,22,50,40
1683350668433,ECON 100C,A01,185589,Newhouse; Herbert S,29,0,70,41
1683350669464,ECON 105,A00,185608,Vespa; Emanuel Ignacio,19,0,35,16
1683350670492,ECON 109,A01,185610,Shishkin; Denis,10,0,35,25
1683350671518,ECON 110A,A01,185612,Staff,11,0,40,29
1683350672543,ECON 120A,A01,185615,Staff,20,0,40,20
1683350673570,ECON 120C,A01,185617,Sun; Yixiao,0,21,70,70
1683350674598,ECON 144,A00,203346,Squires; Dale E,3,0,35,32
1683350675623,ECON 171,A01,203349,Newhouse; Herbert S,0,1,35,35
1683350676650,ECON 173A,A01,185621,Toda; Alexis Akira,21,0,35,14
1683350677681,EDS 25,A01,202413,Staff,0,1,0,0
1683350677681,EDS 25,A02,202414,Staff,0,1,0,0
1683350677681,EDS 25,A03,202415,Staff,0,0,0,0
1683350677681,EDS 25,A04,202416,Staff,0,1,0,0
1683350677681,EDS 25,A05,202439,Staff,0,0,0,0
1683350677681,EDS 25,A06,202440,Staff,0,0,0,0
1683350677681,EDS 25,B01,202631,Staff,0,0,0,0
1683350677681,EDS 25,B02,202632,Staff,0,0,0,0
1683350677681,EDS 25,B03,202639,Staff,0,0,0,0
1683350677681,EDS 25,B04,202640,Staff,0,0,0,0
1683350677681,EDS 25,B05,202643,Staff,0,0,0,0
1683350677681,EDS 25,B06,202644,Staff,0,0,0,0
1683350678704,EDS 38,A01,202659,Black; Alison Michelle,24,0,25,1
1683350679728,EDS 115,A00,202652,Staff,18,0,30,12
1683350680755,EDS 125,A00,202649,Staff,14,0,30,16
1683350681781,EDS 126,A01,203332,Staff,30,0,30,0
1683350682805,EDS 139,A00,202838,Staff,16,0,25,9
1683350683828,EDS 146,A01,202655,Staff,14,0,25,11
1683350684857,ENG 15,A00,185667,Staff,0,1,0,0
1683350684857,ENG 15,B00,185672,Staff,0,0,0,0
1683350684857,ENG 15,C00,185675,Staff,0,0,0,0
1683350684857,ENG 15,D00,185682,Staff,0,0,0,0
1683350684857,ENG 15,E00,185684,Staff,0,0,0,0
1683350685882,ETHN 103,A00,185710,Staff,0,4,35,35
1683350686905,ETHN 103A,A00,199228,Man; Simeon S,2,0,9,7
1683350687983,ETHN 109,A00,185711,Staff,18,0,35,17
1683350689008,ETHN 142,A00,185726,Staff,0,4,30,30
1683350690037,ETHN 163J,A00,199229,Man; Simeon S,5,0,8,3
1683350691062,ETHN 168,A00,185727,Staff,8,0,10,2
1683350692085,ETHN 182,A00,185728,Staff,0,0,35,35
1683350693113,ETHN 183,A00,185737,Staff,8,0,18,10
1683350694138,GLBH 111,A01,209361,Burgos; Jose L.,0,0,0,0
1683350696191,HIEU 104,A00,185792,Staff,16,0,20,4
1683350697218,HIEU 115,A00,185800,Staff,1,0,20,19
1683350698243,HIEU 128,A00,185801,Staff,0,7,20,20
1683350699268,HIEU 147,A00,185802,Staff,16,0,20,4
1683350700296,HIEU 154,A00,185823,Staff,12,0,20,8
1683350701320,HILA 102,A00,185826,Staff,13,0,20,7
1683350702346,HILD 2C,A01,185778,Staff,0,12,20,20
1683350703373,HILD 7B,A01,185780,Kwak; Nancy,0,15,32,32
1683350703373,HILD 7B,A02,185781,Kwak; Nancy,0,18,32,32
1683350704397,HILD 30,A01,185791,Staff,14,0,20,6
1683350705423,HISC 119,A00,185830,Golan; Tal,0,9,20,20
1683350706447,HITO 156GS,A00,185831,Patterson; Patrick H.,0,0,0,23
1683350707471,HIUS 103,A00,185832,Man; Simeon S,0,6,20,20
1683350708495,HIUS 117,A00,185836,Kwak; Nancy,2,0,20,18
1683350709521,HIUS 125,A00,185840,Man; Simeon S,0,0,23,23
1683350710545,HIUS 149,A00,185845,Staff,0,0,20,20
1683350711569,HUM 3,A01,185882,Zavodny; Tatiana Sophia,0,7,50,50
1683350711569,HUM 3,B01,185899,Caldwell; Michael Alan,0,18,50,50
1683350712596,HUM 3GS,A00,185900,Patterson; Patrick H.,0,0,0,23
1683350713620,HUM 4,A01,185938,Zroka; Amy Liane,31,0,50,19
1683350713620,HUM 4,B01,185956,Watkins; Eric,0,3,50,50
1683350713620,HUM 4,B02,202209,Watkins; Eric,0,2,50,50
1683350713620,HUM 4,B03,202210,Watkins; Eric,0,2,50,50
1683350714645,HUM 5,A01,185958,West; Geoffrey Scott,3,0,50,47
1683350714645,HUM 5,A02,202215,West; Geoffrey Scott,0,0,50,50
1683350715673,INTL 190,A00,185959,Gagnon; Jeffrey C,0,0,0,9
1683350715673,INTL 190,B00,185960,Lettieri; Michael Joseph,0,0,0,1
1683350716696,JAPN 180,A00,254509,Staff,5,1,30,25
1683350717720,LATI 10,A01,202853,Kennemore; Amy Michelle,4,0,35,31
1683350717720,LATI 10,A02,202854,Kennemore; Amy Michelle,2,0,35,33
1683350717720,LATI 10,A03,270054,Kennemore; Amy Michelle,30,0,30,0
1683350718746,LATI 180,A00,202855,Kennemore; Amy Michelle,11,0,20,9
1683350719770,LAWS 101,A00,201767,Golan; Tal,0,7,40,40
1683350720794,LIFR 1C,A00,185961,Staff,6,0,20,14
1683350721821,LIFR 1CX,A00,185962,Staff,7,0,20,13
1683350722846,LIFR 1D,A00,185963,Staff,9,0,20,11
1683350723870,LIFR 1DX,A00,185964,Staff,9,0,20,11
1683350724894,LIGN 101,A01,186039,Staff,43,0,50,7
1683350725917,LIGN 165,A00,186040,Staff,18,0,50,32
1683350726940,LTCS 108,A00,186041,Staff,6,0,10,4
1683350727964,LTCS 119,A00,186042,Staff,16,0,20,4
1683350728987,LTCS 130,A00,186043,Wesling; Megan E.,15,0,25,10
1683350731033,LTEA 138,A00,186119,Staff,14,0,40,26
1683350732060,LTEN 124,A00,186148,Staff,6,0,25,19
1683350733085,LTEN 178,A00,186149,Staff,7,0,15,8
1683350734112,LTEN 181,A00,186150,Blanco; John D,33,0,40,7
1683350735139,LTWL 120,A00,186160,Staff,20,0,25,5
1683350736167,LTWL 165,A00,186161,Staff,22,0,25,3
1683350737190,LTWR 100,A00,186162,Staff,0,5,15,15
1683350738218,LTWR 102,A00,186163,Doller; Ben,5,0,15,10
1683350739242,MAE 8,A01,186412,Staff,0,0,0,0
1683350740266,MAE 30B,A00,186445,Bahadori; Mohammad Yousef,83,0,100,17
1683350741289,MAE 40,A00,186592,Bewley; Thomas R,9,0,50,41
1683350742317,MAE 101B,A00,186593,Bahadori; Mohammad Yousef,81,0,100,19
1683350743340,MAE 105,A00,186594,Bandaru; Prabhakar,12,0,50,38
1683350744365,MAE 107,A00,186599,Pham; Hieu Tan,0,6,120,120
1683350745389,MAE 148,A01,186660,Silberman; Jack,3,0,16,13
1683350746413,MATH 10A,A01,188095,Staff,1,6,35,34
1683350747437,MATH 10B,A01,188097,Bowers; Adam R.,0,11,30,30
1683350747437,MATH 10B,A02,188099,Bowers; Adam R.,0,11,30,30
1683350747437,MATH 10B,B01,188104,Bowers; Adam R.,0,10,30,30
1683350747437,MATH 10B,B02,188106,Bowers; Adam R.,0,10,30,30
1683350748461,MATH 10C,A01,188111,Staff,0,18,30,30
1683350748461,MATH 10C,A02,188127,Staff,0,17,30,30
1683350748461,MATH 10C,A03,188131,Staff,0,18,30,30
1683350748461,MATH 10C,B01,188218,Staff,18,0,30,12
1683350748461,MATH 10C,B02,188244,Staff,13,0,30,17
1683350748461,MATH 10C,B03,188277,Staff,16,0,30,14
1683350749486,MATH 18,A01,188344,Bach; Quang Tran,18,0,30,12
1683350749486,MATH 18,A02,188345,Bach; Quang Tran,11,0,30,19
1683350749486,MATH 18,B01,188353,Bach; Quang Tran,10,0,30,20
1683350749486,MATH 18,B02,188354,Bach; Quang Tran,20,0,30,10
1683350750513,MATH 20A,A01,188374,Staff,12,0,35,23
1683350751541,MATH 20B,A01,188382,Ohm; Ko Woon,6,0,30,24
1683350751541,MATH 20B,A02,188383,Ohm; Ko Woon,22,0,30,8
1683350751541,MATH 20B,B01,188385,Ohm; Ko Woon,7,0,30,23
1683350751541,MATH 20B,B02,188392,Ohm; Ko Woon,22,0,30,8
1683350752567,MATH 20C,A01,188394,Harel; Guershon,10,0,30,20
1683350752567,MATH 20C,A02,188395,Harel; Guershon,15,0,30,15
1683350752567,MATH 20C,B01,188404,Harel; Guershon,4,0,30,26
1683350752567,MATH 20C,B02,188405,Harel; Guershon,19,0,30,11
1683350753597,MATH 20D,A01,188414,Hammock; Frances H,0,1,30,30
1683350753597,MATH 20D,A02,188415,Hammock; Frances H,3,0,30,27
1683350753597,MATH 20D,B01,188447,Hammock; Frances H,1,0,30,29
1683350753597,MATH 20D,B02,188486,Hammock; Frances H,8,0,30,22
1683350754621,MATH 20E,A01,188649,Staff,21,0,30,9
1683350754621,MATH 20E,A02,188650,Staff,23,0,30,7
1683350754621,MATH 20E,A03,188673,Staff,0,0,30,30
1683350755648,MATH 102,A01,188675,Staff,0,35,35,35
1683350756671,MATH 103B,A01,188681,Staff,3,0,35,32
1683350756671,MATH 103B,B01,188692,Staff,5,0,35,30
1683350757695,MATH 109,A01,188695,Salehi Golsefidy; Alireza,25,0,35,10
1683350757695,MATH 109,A02,188696,Salehi Golsefidy; Alireza,25,0,35,10
1683350758724,MATH 120A,A01,188698,Eggers; John Dietrich,7,0,35,28
1683350759750,MATH 142B,A01,188736,Ioana; Adrian,0,2,30,30
1683350759750,MATH 142B,A02,188741,Ioana; Adrian,1,1,30,29
1683350759750,MATH 142B,A03,188743,Ioana; Adrian,2,3,30,28
1683350760778,MATH 168A,A01,188790,Staff,0,9,35,35
1683350761804,MATH 170A,A01,188803,Nie; Jiawang,0,2,35,35
1683350761804,MATH 170A,A02,188811,Nie; Jiawang,0,0,35,35
1683350761804,MATH 170A,A03,188814,Nie; Jiawang,1,0,35,34
1683350761804,MATH 170A,A04,188815,Nie; Jiawang,13,0,35,22
1683350762833,MATH 193B,A01,188817,Staff,0,0,35,35
1683350762833,MATH 193B,A02,188818,Staff,5,0,35,30
1683350763866,MGT 4,A01,202857,Anderson; John Charles,62,0,80,18
1683350764894,MGT 12,A00,202858,Lindenberger; Wade Douglas,42,0,90,48
1683350765919,MGT 18,A00,202859,Staff,74,0,90,16
1683350766945,MGT 18GS,A00,202860,McKay; Michael J,13,0,28,15
1683350767970,MGT 45,A00,202861,Pecore; Joseph P.,14,0,90,76
1683350768997,MGT 100,A00,202863,Yavorsky; Daniel Ryan,28,0,90,62
1683350770022,MGT 103,A00,202864,Ehrich; Kristine R,1,18,90,89
1683350771046,MGT 112,A00,202865,Ehrich; Kristine R,15,0,90,75
1683350772070,MGT 121A,A00,202868,Staff,0,20,0,0
1683350773098,MGT 131B,A00,202869,Anderson; John Charles,59,0,90,31
1683350774121,MGT 136,A00,202871,Lindenberger; Wade Douglas,84,0,90,6
1683350775144,MGT 164,A00,202873,Staff,0,68,90,91
1683350776168,MGT 164GS,A00,202874,McKay; Mary A,13,0,28,15
1683350777192,MGT 180,A00,202875,Staff,0,50,90,91
1683350778217,MMW 11R,A01,205019,Herbst; Matthew,3,0,30,27
1683350778217,MMW 11R,A02,205026,Herbst; Matthew,29,0,30,1
1683350779243,MMW 15,A01,193512,Chang; Edmond Yi-Teh,0,9,28,28
1683350779243,MMW 15,A02,193513,Chang; Edmond Yi-Teh,0,5,28,28
1683350779243,MMW 15,A03,193514,Chang; Edmond Yi-Teh,0,5,28,28
1683350779243,MMW 15,A04,193515,Chang; Edmond Yi-Teh,0,5,28,28
1683350779243,MMW 15,A05,193516,Chang; Edmond Yi-Teh,0,4,28,28
1683350779243,MMW 15,A06,193517,Chang; Edmond Yi-Teh,0,5,28,28
1683350779243,MMW 15,B01,193519,Chang; Edmond Yi-Teh,0,5,28,28
1683350779243,MMW 15,B02,193520,Chang; Edmond Yi-Teh,0,5,28,28
1683350779243,MMW 15,B03,193521,Chang; Edmond Yi-Teh,0,5,28,28
1683350779243,MMW 15,B04,193522,Chang; Edmond Yi-Teh,0,4,28,28
1683350779243,MMW 15,B05,193523,Chang; Edmond Yi-Teh,0,5,28,28
1683350779243,MMW 15,B06,193524,Chang; Edmond Yi-Teh,0,4,28,28
1683350780267,MMW 122,A01,193526,Rahimi; Babak,0,15,28,28
1683350780267,MMW 122,A02,193527,Rahimi; Babak,0,14,28,28
1683350780267,MMW 122,A03,193528,Rahimi; Babak,0,0,0,0
1683350780267,MMW 122,A04,193529,Rahimi; Babak,0,0,0,0
1683350781295,MUS 1A,A01,186663,Staff,0,20,35,35
1683350782320,MUS 4,A01,186715,Staff,0,12,35,35
1683350783346,MUS 5R,A01,186796,Dubnov; Shlomo,0,17,35,35
1683350784370,MUS 6,A01,186798,Staff,0,4,25,25
1683350785396,MUS 7,A01,186830,Staff,13,0,35,22
1683350786421,MUS 8,A01,186930,Staff,0,26,35,35
1683350787445,MUS 15,A01,186932,Staff,0,16,35,35
1683350787445,MUS 15,B01,186934,Staff,0,15,35,35
1683350788473,MUS 80,A00,186935,Staff,1,0,20,19
1683350788473,MUS 80,B00,186936,Staff,25,0,25,0
1683350789500,NANO 11,A00,204702,Lipomi; Darren John,0,0,0,0
1683350790525,NANO 15,A01,204709,Yang; Kesong,0,1,0,0
1683350791607,NANO 114,A00,202069,Jahed Motlagh; Zeinab,3,0,10,7
1683350792633,PHIL 1,A00,186955,Grush; Rick Scott,32,0,40,8
1683350793660,PHIL 10,A01,186973,Grush; Rick Scott,28,0,35,7
1683350793660,PHIL 10,A02,186974,Grush; Rick Scott,33,0,35,2
1683350794685,PHIL 13,A01,186976,Staff,7,0,35,28
1683350794685,PHIL 13,A02,186977,Staff,16,0,35,19
1683350795708,PHIL 14,A01,186979,Staff,31,0,35,4
1683350795708,PHIL 14,A02,186986,Staff,32,0,35,3
1683350796733,PHIL 28,A01,186988,Staff,16,0,30,14
1683350796733,PHIL 28,A02,186989,Staff,1,0,30,29
1683350796733,PHIL 28,A03,186990,Staff,9,0,30,21
1683350796733,PHIL 28,A04,186991,Staff,26,0,30,4
1683350797760,PHIL 120,A00,186997,Staff,23,0,40,17
1683350798784,PHIL 137,A00,187003,Staff,9,0,40,31
1683350799836,PHIL 150,A00,187015,Staff,47,0,70,23
1683350800859,PHIL 167,A00,187021,Lamey; Andy M.,35,0,40,5
1683350801886,PHIL 174,A01,202226,Staff,17,0,20,3
1683350801886,PHIL 174,A02,202235,Staff,20,0,20,0
1683350802910,PHIL 191A,A00,258918,Staff,0,0,1,1
1683350803937,PHYS 1A,A00,187028,Staff,27,0,60,33
1683350804962,PHYS 1AL,001,187036,Staff,2,0,30,28
1683350804962,PHYS 1AL,002,187049,Staff,18,0,30,12
1683350805987,PHYS 1B,A00,187058,Staff,22,0,60,38
1683350807015,PHYS 1BL,001,187064,Staff,0,0,30,30
1683350807015,PHYS 1BL,002,187070,Staff,5,0,30,25
1683350808039,PHYS 1C,A00,187082,Staff,31,0,120,89
1683350809069,PHYS 1CL,001,187088,Staff,0,9,30,30
1683350809069,PHYS 1CL,002,187089,Staff,0,2,30,30
1683350809069,PHYS 1CL,009,262693,Staff,11,0,30,19
1683350810094,PHYS 2B,A01,187097,Staff,54,0,115,61
1683350811119,PHYS 2C,A01,187099,Staff,67,0,115,48
1683350812143,PHYS 2CL,A01,187101,Staff,5,0,28,23
1683350812143,PHYS 2CL,A02,187102,Staff,15,0,28,13
1683350813169,PHYS 2D,A01,187123,Shotwell; Brian,95,0,115,20
1683350814194,PHYS 4B,A01,187133,Grinstein; Benjamin,35,0,50,15
1683350815221,POLI 10,A00,188819,Staff,0,4,50,50
1683350816247,POLI 11,A00,188827,Staff,43,0,50,7
1683350817272,POLI 13R,A00,188828,Staff,0,1,20,20
1683350818295,POLI 27,A01,188830,Elgin; Samuel Zincke,0,1,70,70
1683350819319,POLI 30,A00,188832,Desposato; Scott,31,0,50,19
1683350820347,POLI 102F,A00,188834,Staff,3,0,40,37
1683350821370,POLI 104A,A00,188852,Staff,14,0,30,16
1683350822394,POLI 104I,A00,188853,Staff,0,6,20,20
1683350823422,POLI 110B,A00,188854,Wiens; David,7,0,20,13
1683350824450,POLI 112A,A00,188855,Wiens; David,5,0,30,25
1683350825474,POLI 117R,A00,188856,Forman; Fonna,0,11,20,20
1683350826498,POLI 118,A00,188857,Ingham; Sean,8,0,20,12
1683350827523,POLI 120G,A00,188858,Staff,9,0,30,21
1683350828547,POLI 131CR,A00,188863,Hoston; Germaine,24,0,50,26
1683350829571,POLI 133,A00,188864,Nellis; Gareth Hb,44,0,50,6
1683350830599,POLI 134D,A00,188865,Desposato; Scott,27,0,30,3
1683350831624,POLI 142A,A00,188871,Gartzke; Erik,22,0,50,28
1683350832649,POLI 142K,A00,188874,Staff,38,0,50,12
1683350833675,POLI 143,A00,188940,Gartzke; Erik,16,0,30,14
1683350834703,POLI 153,A00,188943,Staff,3,0,20,17
1683350835728,POLI 160AA,A00,188944,Staff,11,0,40,29
1683350836751,POLI 170A,A00,188945,Staff,11,0,30,19
1683350838800,PSYC 1,A00,188952,Staff,37,0,90,53
1683350839848,PSYC 2,B00,188953,Staff,19,0,35,16
1683350840876,PSYC 6,A00,188970,Staff,47,0,60,13
1683350841902,PSYC 7,A00,188973,Staff,37,0,45,8
1683350842930,PSYC 60,A01,188980,Rickard; Timothy C.,43,0,60,17
1683350843959,PSYC 70,A01,189001,Steiner; Eric Tomas,23,0,45,22
1683350844987,PSYC 100,A00,189005,Lacefield; Katharine I,0,98,120,120
1683350846014,PSYC 102,A00,189008,Staff,9,0,30,21
1683350847038,PSYC 106,B00,189026,Gorman; Michael R.,34,0,60,26
1683350848063,PSYC 114,B01,189033,Winkielman; Piotr,0,32,30,30
1683350849086,PSYC 131,A00,189036,Anagnostaras; Stephan,0,43,60,60
1683350850113,PSYC 136,A00,189041,Lowe; Angela Beth,0,7,25,25
1683350851141,PSYC 137,A00,189057,Winkielman; Piotr,0,34,25,25
1683350852168,PSYC 144,A00,189107,Wixted; John T,0,7,50,50
1683350854215,PSYC 162,A00,189142,Staff,0,8,85,85
1683350855242,PSYC 172,A00,189144,Gorman; Michael R.,0,7,30,30
1683350857295,PSYC 179,A00,189146,Lacefield; Katharine I,0,84,120,120
1683350858323,PSYC 181,A00,189147,Anagnostaras; Stephan,0,44,90,90
1683350859346,PSYC 190R,A00,189148,Barner; David A.,0,22,80,80
1683350860376,PSYC 191,A00,189275,Rickard; Timothy C.,0,7,25,25
1683350861403,PSYC 193,A00,189276,Chapman; Eddie Nathaniel,0,1,0,4
1683350862428,PSYC 193L,A01,189281,Lowe; Angela Beth,12,0,20,8
1683350862428,PSYC 193L,B01,189285,Staff,28,0,35,7
1683350863454,RELI 149,A00,187137,Rahimi; Babak,7,0,40,33
1683350864480,SE 9,A01,187315,Staff,0,2,18,18
1683350865507,SE 101B,A00,187409,Staff,24,0,30,6
1683350866533,SE 110B,A00,187444,Staff,10,0,40,30
1683350867557,SE 130B,A00,187449,Staff,31,0,40,9
1683350868579,SE 150A,A00,187516,Staff,9,0,20,11
1683350869603,SE 154,A00,187528,Staff,30,0,50,20
1683350870629,SIO 3,A01,258171,Staff,35,0,40,5
1683350871655,SIO 10,A00,187144,Cook; Geoffrey W,0,3,75,75
1683350872681,SIO 45,A00,187152,Cook; Geoffrey W,1,0,100,99
1683350873703,SIO 109R,A00,194486,Staff,0,3,20,20
1683350875756,SIO 187,A01,187233,Kacev; David,12,0,40,28
1683350876781,SOCI 1,A01,258656,Thorpe; Charles Robert,28,0,30,2
1683350876781,SOCI 1,A02,258658,Thorpe; Charles Robert,30,0,30,0
1683350876781,SOCI 1,A03,258661,Thorpe; Charles Robert,25,0,25,0
1683350876781,SOCI 1,A04,258666,Thorpe; Charles Robert,22,0,25,3
1683350876781,SOCI 1,A05,258897,Thorpe; Charles Robert,23,0,25,2
1683350876781,SOCI 1,A06,258898,Thorpe; Charles Robert,25,0,25,0
1683350877805,SOCI 30,A01,258903,Pardo Guerra; Juan Pablo,15,0,30,15
1683350878830,SOCI 102,A00,258904,Staff,9,0,25,16
1683350879864,SOCI 106,A00,258905,Staff,19,0,25,6
1683350880889,SOCI 111,A00,258907,Ribas Norris; Janet Vanesa,26,0,30,4
1683350881911,SOCI 121R,A00,258908,Pardo Guerra; Juan Pablo,10,0,30,20
1683350882935,SOCI 126,A01,203330,Staff,14,0,20,6
1683350883963,SOCI 131,A00,258909,Thorpe; Charles Robert,31,0,60,29
1683350884986,SOCI 135,A00,258910,Payne; Christine Anna,0,9,30,30
1683350886010,SOCI 157,A00,258911,Staff,12,0,30,18
1683350887035,SOCI 184,A00,258912,Staff,25,0,30,5
1683350888061,SOCI 188D,A00,258913,Staff,21,0,30,9
1683350889088,SYN 2,001,187529,Staff,10,0,16,6
1683350889088,SYN 2,002,201452,Staff,0,18,16,16
1683350889088,SYN 2,003,201469,Staff,3,0,16,13
1683350890111,SYN 100,A01,187531,Staff,0,9,20,20
1683350890111,SYN 100,B01,201491,Staff,0,12,20,20
1683350891136,TDAC 1,A00,189286,Walsh; Kim C.,3,0,20,17
1683350891136,TDAC 1,B00,189287,Harting; Carla Kelso,11,0,20,9
1683350892163,TDAC 101,A00,189300,Walsh; Kim C.,16,0,20,4
1683350892163,TDAC 101,B00,189301,Harting; Carla Kelso,18,0,20,2
1683350893186,TDAC 102,A00,189304,Basso; Beatrice,14,0,20,6
1683350894209,TDAC 108,A00,189305,Staff,18,0,20,2
1683350895310,TDDE 131,A00,189310,Staff,19,0,20,1
1683350895310,TDDE 131,B00,189314,Staff,19,0,20,1
1683350895310,TDDE 131,C00,189315,Staff,48,0,50,2
1683350895310,TDDE 131,D00,189316,Staff,14,0,15,1
1683350895310,TDDE 131,E00,204841,Staff,20,0,20,0
1683350896337,TDGE 10,A00,189289,Staff,30,0,50,20
1683350896337,TDGE 10,B00,189290,Havis; Allan,1,0,50,49
1683350897360,TDGE 11,A00,189291,Fulton; Julia,0,3,50,50
1683350897360,TDGE 11,B00,189292,Staff,20,0,25,5
1683350897360,TDGE 11,C00,260270,Staff,0,0,0,0
1683350898384,TDGE 25,A00,189294,Staff,3,0,20,17
1683350899409,TDGE 124,A00,189318,Fulton; Julia,0,8,50,50
1683350900433,TDGE 125,A00,189319,Staff,13,0,25,12
1683350900433,TDGE 125,B00,189320,Staff,23,0,25,2
1683350901457,TDGE 127,A00,189322,Havis; Allan,0,0,50,50
1683350902485,TDHT 101,A00,189323,Staff,18,0,25,7
1683350902485,TDHT 101,B00,189324,Staff,25,0,25,0
1683350903510,TDHT 102,A00,189325,Staff,49,0,50,1
1683350904538,TDMV 1,A00,189295,Arcidiacono; Kristin,19,0,30,11
1683350904538,TDMV 1,B00,189296,Caligagan; Maria T.,24,0,30,6
1683350905563,TDMV 2,A00,189297,Sammartano; Tonnie,28,0,30,2
1683350905563,TDMV 2,B00,189299,Arcidiacono; Kristin,24,0,30,6
1683350906588,TDMV 3,A00,204998,Rincon; Alicia,22,0,30,8
1683350907615,TDMV 120,A00,189458,Sammartano; Tonnie,28,0,30,2
1683350908643,TDMV 138,A00,189541,Jun; Grace Shin Hae,22,0,40,18
1683350909670,TDMV 142,A00,189717,Caligagan; Tony,23,0,30,7
1683350909670,TDMV 142,B00,189718,Caligagan; Maria T.,25,0,30,5
1683350910695,TMC 2,A01,187533,Staff,25,0,25,0
1683350910695,TMC 2,A02,187534,Staff,25,0,25,0
1683350911722,USP 1,A01,187536,Kwak; Nancy,0,16,25,25
1683350912746,USP 5,A01,187538,Staff,10,0,25,15
1683350913771,USP 101,A00,199253,Staff,0,4,0,0
1683350914798,USP 124,A00,187562,Boomhower; Matthew Charles,1,0,30,29
1683350915822,USP 138,A00,187582,Staff,20,0,25,5
1683350916848,USP 152,A01,187597,Staff,4,0,25,21
1683350917876,USP 153,A00,187598,Staff,19,0,25,6
1683350918901,USP 168,A00,187607,Kwak; Nancy,2,0,5,3
1683350919928,USP 173,A00,187619,Staff,4,0,25,21
1683350920952,USP 181,A00,187638,Staff,0,1,25,25
1683350921977,VIS 103,A00,187650,Cruz; Edwin Teddy,22,0,75,53
1683350923002,VIS 110D,A00,187669,Staff,12,0,22,10
1683350924026,VIS 127C,A00,187720,Shen; Kuiyi,67,0,146,79
1683350925049,VIS 149,A00,187731,Yoldas; Pinar,0,14,22,22
1683350926076,VIS 151,A01,188091,Staff,22,0,34,12
1683350926076,VIS 151,A02,188092,Staff,11,0,34,23
1683350927107,VIS 160B,A00,188093,Stalbaum; Brett,0,0,10,10
1683350929156,WCWP 10B,A00,201720,Staff,10,0,15,5
1683350929156,WCWP 10B,B00,201722,Staff,9,0,15,6
1683350930184,WCWP 100,A00,201725,Gagnon; Jeffrey C,0,0,2,2
1683350930184,WCWP 100,B00,201727,Staff,0,4,15,15
1683350933303,ANBI 133,A00,258401,Wilder; Linnea Lorene,34,0,40,6
1683350934326,ANBI 140,A00,258395,Hrvoj Mihic; Branka,18,0,25,7
1683350935351,ANSC 120,A00,258402,Bialecki; Jon Anthony,27,0,40,13
1683350936373,ANSC 144,A00,258400,Staff,14,0,40,26
1683350938422,ANSC 166,A00,258396,Parish; Steven Martin,157,0,175,18
1683350939444,ANSC 180,A00,193533,Staff,9,0,20,11
1683350940468,ANSC 188,A00,258397,Jassal; Aftab,33,0,40,7
1683350941496,ANTH 3,A01,258316,Staff,23,0,30,7
1683350942523,ANTH 5,A00,258394,Semendeferi; Ekaterini,16,0,20,4
1683350943547,ANTH 21,A01,258331,Staff,8,0,40,32
1683350944576,ANTH 103,A00,258398,Varma; Saiba,15,0,25,10
1683350945601,AWP 10,001,202034,Staff,0,0,0,0
1683350945601,AWP 10,002,202035,Staff,0,0,0,0
1683350945601,AWP 10,003,202036,Staff,0,0,0,0
1683350945601,AWP 10,004,202037,Staff,0,0,0,0
1683350945601,AWP 10,005,202038,Staff,0,0,0,0
1683350945601,AWP 10,006,202039,Staff,0,0,0,0
1683350945601,AWP 10,007,202040,Staff,0,0,0,0
1683350945601,AWP 10,008,202041,Staff,0,0,0,0
1683350945601,AWP 10,009,202042,Staff,0,0,0,0
1683350945601,AWP 10,010,202043,Staff,0,0,0,0
1683350945601,AWP 10,011,202044,Staff,0,0,0,0
1683350945601,AWP 10,012,202045,Staff,0,0,0,0
1683350945601,AWP 10,013,202046,Staff,0,0,0,0
1683350945601,AWP 10,014,202047,Staff,0,0,0,0
1683350945601,AWP 10,015,202048,Staff,0,0,0,0
1683350945601,AWP 10,016,202049,Staff,0,0,0,0
1683350945601,AWP 10,017,202050,Staff,0,0,0,0
1683350945601,AWP 10,018,202051,Staff,0,0,0,0
1683350945601,AWP 10,019,202052,Staff,0,0,0,0
1683350945601,AWP 10,020,202053,Staff,0,0,0,0
1683350945601,AWP 10,021,202054,Staff,0,0,0,0
1683350945601,AWP 10,022,202055,Staff,0,0,0,0
1683350945601,AWP 10,023,202056,Staff,0,0,0,0
1683350945601,AWP 10,024,202057,Staff,0,0,0,0
1683350945601,AWP 10,025,202058,Staff,0,0,0,0
1683350945601,AWP 10,026,202059,Staff,0,0,0,0
1683350946628,AWP 102,001,202032,Staff,0,0,0,0
1683350946628,AWP 102,002,202033,Staff,0,0,0,0
1683350947651,BENG 100,A01,254234,Taylor Amos; Alyssa C,31,0,40,9
1683350948675,BENG 196,001,270013,Engler; Adam J.,9999,0,9999,0
1683350949703,BICD 100R,A01,202018,Smith; Laurie,0,7,32,32
1683350949703,BICD 100R,A02,202019,Smith; Laurie,0,2,32,32
1683350949703,BICD 100R,A03,202020,Smith; Laurie,0,1,32,32
1683350949703,BICD 100R,A04,202021,Smith; Laurie,9,0,32,23
1683350949703,BICD 100R,A05,202022,Smith; Laurie,12,0,32,20
1683350950731,BICD 136,A01,193242,Gustafson-Brown; Cindy,0,2,32,32
1683350950731,BICD 136,A02,193244,Gustafson-Brown; Cindy,14,0,32,18
1683350951758,BIEB 102,A01,193249,Butler; Shannon Rhey,0,2,32,32
1683350951758,BIEB 102,A02,193251,Butler; Shannon Rhey,0,0,32,32
1683350951758,BIEB 102,A03,193253,Butler; Shannon Rhey,0,1,32,32
1683350951758,BIEB 102,A04,193255,Butler; Shannon Rhey,17,0,32,15
1683350951758,BIEB 102,A05,193265,Butler; Shannon Rhey,26,0,32,6
1683350951758,BIEB 102,A06,193269,Butler; Shannon Rhey,16,0,32,16
1683350953804,BIEB 150,A01,193274,Staff,0,0,32,32
1683350953804,BIEB 150,A02,193285,Staff,23,0,32,9
1683350954831,BIEB 194,A00,193286,Kurle; Carolyn M.,22,0,32,10
1683350955855,BILD 1,A01,192291,Staff,16,0,32,16
1683350955855,BILD 1,A02,192292,Staff,30,0,32,2
1683350955855,BILD 1,B01,192520,Reuther; Keefe,0,1,0,0
1683350955855,BILD 1,B02,192532,Reuther; Keefe,0,1,0,0
1683350956879,BILD 3,A01,192556,Butler; Shannon Rhey,0,0,32,32
1683350956879,BILD 3,A02,192581,Butler; Shannon Rhey,4,0,32,28
1683350956879,BILD 3,A03,192611,Butler; Shannon Rhey,23,0,32,9
1683350956879,BILD 3,A04,192612,Butler; Shannon Rhey,25,0,32,7
1683350956879,BILD 3,A05,192613,Butler; Shannon Rhey,27,0,32,5
1683350956879,BILD 3,A06,192679,Butler; Shannon Rhey,27,0,32,5
1683350956879,BILD 3,A07,192682,Butler; Shannon Rhey,22,0,32,10
1683350957904,BILD 4,A01,192836,Reuther; Keefe,0,0,24,24
1683350957904,BILD 4,A02,193044,Reuther; Keefe,4,0,24,20
1683350958931,BILD 10,A01,193142,Gustafson-Brown; Cindy,30,0,32,2
1683350958931,BILD 10,A02,193149,Gustafson-Brown; Cindy,31,0,32,1
1683350959955,BIMM 100,A01,193301,Staff,0,6,32,32
1683350959955,BIMM 100,A02,193312,Staff,0,5,32,32
1683350959955,BIMM 100,A03,193323,Staff,0,8,32,32
1683350960988,BIMM 101,A01,193329,McDonnell; Lisa Marie,0,3,24,24
1683350960988,BIMM 101,A02,193339,McDonnell; Lisa Marie,0,3,24,24
1683350960988,BIMM 101,B01,193354,McDonnell; Lisa Marie,0,3,24,24
1683350960988,BIMM 101,B02,193357,McDonnell; Lisa Marie,0,3,24,24
1683350962012,BIMM 110,A01,193377,Tat; John,0,11,32,32
1683350962012,BIMM 110,A02,193378,Tat; John,0,8,32,32
1683350963036,BIMM 120,A01,206116,Staff,0,0,32,32
1683350963036,BIMM 120,A02,206117,Staff,8,0,32,24
1683350963036,BIMM 120,A03,206121,Staff,21,0,32,11
1683350964064,BIPN 100,A01,193393,Park; Ji Young,0,14,32,32
1683350964064,BIPN 100,A02,193402,Park; Ji Young,0,13,32,32
1683350964064,BIPN 100,A03,193413,Park; Ji Young,0,14,32,32
1683350964064,BIPN 100,A04,193414,Park; Ji Young,0,13,32,32
1683350965086,BIPN 102,A01,193429,Staff,0,0,32,32
1683350965086,BIPN 102,A02,193438,Staff,22,0,32,10
1683350966113,BIPN 106,A01,193450,Reyes Gonzalez; Catalina,0,2,40,40
1683350967141,BIPN 134,A01,193465,Cooke; James Edward,0,0,32,32
1683350967141,BIPN 134,A02,193474,Cooke; James Edward,25,0,32,7
1683350967141,BIPN 134,A03,193485,Cooke; James Edward,29,0,32,3
1683350967141,BIPN 134,A04,193486,Cooke; James Edward,21,0,32,11
1683350967141,BIPN 134,A05,193491,Cooke; James Edward,31,0,32,1
1683350967141,BIPN 134,A06,193501,Cooke; James Edward,30,0,32,2
1683350967141,BIPN 134,A07,193510,Cooke; James Edward,29,0,32,3
1683350969189,BISP 194,A00,222522,Staff,14,0,32,18
1683350970214,CAT 124,A01,202407,Staff,20,0,25,5
1683350971236,CAT 125,A00,202408,Marchisotto; Jennifer Anne,4,0,20,16
1683350972263,CAT 125R,A00,202409,Smith; Lauryn Alissa,0,11,20,20
1683350972263,CAT 125R,B00,202410,Morales; Celeste Georgianna,0,11,20,20
1683350972263,CAT 125R,C00,202411,Irwin; Matthew Joseph,0,10,20,20
1683350973288,CENG 15,A01,204712,Yang; Kesong,0,1,0,0
1683350974312,CENG 114,A00,202070,Jahed Motlagh; Zeinab,5,0,20,15
1683350975336,CGS 105,A00,185477,Wesling; Megan E.,24,0,40,16
1683350976360,CGS 106,A00,185494,Staff,13,0,22,9
1683350977384,CGS 108,A00,185495,Staff,14,0,20,6
1683350978412,CGS 114,A00,185496,Staff,13,0,18,5
1683350979438,CGS 119,A00,185501,Staff,15,0,20,5
1683350980461,CGS 120,A00,185511,Staff,13,0,20,7
1683350981485,CHEM 4,A01,184675,Bussey; Thomas J,96,0,100,4
1683350982513,CHEM 6A,A01,184677,Staff,34,0,60,26
1683350983537,CHEM 6B,A01,184679,Staff,65,0,100,35
1683350984562,CHEM 6C,A01,184681,Bussey; Thomas J,1,0,50,49
1683350984562,CHEM 6C,A02,184682,Bussey; Thomas J,34,0,50,16
1683350985586,CHEM 40A,A01,184684,Albizati; Kim F.,37,0,100,63
1683350986611,CHEM 40B,A01,184686,Albizati; Kim F.,0,20,100,100
1683350987638,CHEM 41B,A01,184690,Staff,52,0,100,48
1683350988661,COGS 3,A01,184715,Boyle; Mary E. T.,0,25,40,40
1683350989685,COGS 14B,A01,185172,Staff,0,15,38,38
1683350990708,COGS 18,A01,184736,Staff,17,0,80,63
1683350991733,COGS 100,A01,184932,Staff,0,5,73,73
1683350992758,COGS 101A,A01,184935,Staff,0,39,30,30
1683350993785,COGS 101B,A01,184944,Staff,0,2,30,30
1683350994809,COGS 101C,A01,184946,Staff,0,12,30,30
1683350995833,COGS 102A,A01,184951,Johnson; Christine M.,2,0,40,38
1683350996858,COGS 107B,A01,184953,Mooshagian; Eric Frederick,0,50,40,40
1683350997882,COGS 118B,A01,184959,Gupta; Anjum,0,48,40,40
1683350998966,COGS 153,A00,184961,Staff,0,15,30,30
1683350999990,COGS 177,A00,184962,Staff,0,20,30,30
1683351001021,COGS 187A,A01,184969,Boyle; Mary E. T.,0,17,40,40
1683351002053,COMM 10,A01,185174,Staff,0,5,25,25
1683351002053,COMM 10,A02,185189,Staff,0,5,25,25
1683351002053,COMM 10,A03,269821,Staff,0,0,0,0
1683351003082,COMM 100B,A01,185475,Staff,0,0,0,2
1683351003082,COMM 100B,A02,185476,Staff,13,0,25,12
1683351004110,COMM 100C,A01,185314,Staff,1,0,25,24
1683351004110,COMM 100C,A02,185327,Staff,19,0,25,6
1683351005134,COMM 110M,A00,185349,Staff,2,0,40,38
1683351006157,COMM 113T,A00,185352,Staff,24,0,40,16
1683351007181,COMM 114I,A00,185353,Staff,33,0,40,7
1683351008204,COMM 131,A00,185354,Staff,19,0,30,11
1683351009232,CSE 8A,A50,185358,Cao; Yingjun,0,46,10,10
1683351010258,CSE 8B,A01,185362,Staff,0,46,50,50
1683351011282,CSE 11,A01,185416,Cao; Yingjun,0,92,10,10
1683351012307,CSE 20,A01,185445,Briones; Jor-el Thomas Caparas,5,0,25,20
1683351013331,CSE 21,A01,185447,Staff,10,0,50,40
1683351014359,CSE 101,A01,185451,Staff,0,13,50,50
1683351014359,CSE 101,B01,185453,Jones; Miles E,0,11,50,50
1683351016410,CSE 141,A01,185458,Eldon; John,20,0,100,80
1683351017433,CSE 141L,A01,185461,Eldon; John,12,0,100,88
1683351018460,CSE 142,A01,185463,Staff,36,0,60,24
1683351018460,CSE 142,B01,201355,Staff,0,7,60,60
1683351019482,CSE 142L,A01,185470,Staff,36,0,60,24
1683351019482,CSE 142L,B01,201417,Staff,0,6,60,60
1683351020505,CSE 190,A00,201433,Staff,32,0,49,17
1683351021529,DOC 1,A01,259136,Strom; Megan C.,7,0,15,8
1683351021529,DOC 1,A02,259137,Strom; Megan C.,14,0,15,1
1683351021529,DOC 1,A03,259138,Strom; Megan C.,14,0,15,1
1683351021529,DOC 1,A04,259139,Strom; Megan C.,14,0,15,1
1683351022556,DOC 100D,A00,259140,Pass; Natalye Joann,16,0,25,9
1683351023581,DSGN 1,A01,184749,Rill; Bryan,0,25,30,30
1683351024610,DSGN 100,A01,185168,Staff,0,2,25,25
1683351025636,ECE 5,A01,185626,Morris; Karcher William,0,10,0,0
1683351026659,ECE 101,A01,185628,Staff,17,0,70,53
1683351027683,ECE 107,A01,185635,Baghdadchi; Saharnaz,0,0,20,20
1683351027683,ECE 107,A02,185638,Baghdadchi; Saharnaz,4,0,20,16
1683351028708,ECE 148,A01,185647,Silberman; Jack,0,0,16,16
1683351029734,ECON 1,A01,185537,Crane; Meredith Helen,54,0,70,16
1683351030762,ECON 3,A01,185549,Crane; Meredith Helen,32,0,70,38
1683351031785,ECON 4,A01,203354,Anderson; John Charles,0,4,10,10
1683351032809,ECON 100A,A01,185574,Staff,0,4,40,40
1683351033833,ECON 100B,A01,185576,Staff,0,12,50,50
1683351034858,ECON 100C,A01,185589,Newhouse; Herbert S,29,0,70,41
1683351035881,ECON 105,A00,185608,Vespa; Emanuel Ignacio,19,0,35,16
1683351036905,ECON 109,A01,185610,Shishkin; Denis,10,0,35,25
1683351037930,ECON 110A,A01,185612,Staff,11,0,40,29
1683351038955,ECON 120A,A01,185615,Staff,20,0,40,20
1683351039981,ECON 120C,A01,185617,Sun; Yixiao,0,21,70,70
1683351041012,ECON 144,A00,203346,Squires; Dale E,3,0,35,32
1683351042040,ECON 171,A01,203349,Newhouse; Herbert S,0,1,35,35
1683351043067,ECON 173A,A01,185621,Toda; Alexis Akira,21,0,35,14
1683351044098,EDS 25,A01,202413,Staff,0,1,0,0
1683351044098,EDS 25,A02,202414,Staff,0,1,0,0
1683351044098,EDS 25,A03,202415,Staff,0,0,0,0
1683351044098,EDS 25,A04,202416,Staff,0,1,0,0
1683351044098,EDS 25,A05,202439,Staff,0,0,0,0
1683351044098,EDS 25,A06,202440,Staff,0,0,0,0
1683351044098,EDS 25,B01,202631,Staff,0,0,0,0
1683351044098,EDS 25,B02,202632,Staff,0,0,0,0
1683351044098,EDS 25,B03,202639,Staff,0,0,0,0
1683351044098,EDS 25,B04,202640,Staff,0,0,0,0
1683351044098,EDS 25,B05,202643,Staff,0,0,0,0
1683351044098,EDS 25,B06,202644,Staff,0,0,0,0
1683351045122,EDS 38,A01,202659,Black; Alison Michelle,24,0,25,1
1683351046145,EDS 115,A00,202652,Staff,18,0,30,12
1683351047169,EDS 125,A00,202649,Staff,14,0,30,16
1683351048193,EDS 126,A01,203332,Staff,30,0,30,0
1683351049216,EDS 139,A00,202838,Staff,16,0,25,9
1683351050239,EDS 146,A01,202655,Staff,14,0,25,11
1683351051271,ENG 15,A00,185667,Staff,0,1,0,0
1683351051271,ENG 15,B00,185672,Staff,0,0,0,0
1683351051271,ENG 15,C00,185675,Staff,0,0,0,0
1683351051271,ENG 15,D00,185682,Staff,0,0,0,0
1683351051271,ENG 15,E00,185684,Staff,0,0,0,0
1683351052296,ETHN 103,A00,185710,Staff,0,4,35,35
1683351053322,ETHN 103A,A00,199228,Man; Simeon S,2,0,9,7
1683351054345,ETHN 109,A00,185711,Staff,18,0,35,17
1683351055367,ETHN 142,A00,185726,Staff,0,4,30,30
1683351056395,ETHN 163J,A00,199229,Man; Simeon S,5,0,8,3
1683351057418,ETHN 168,A00,185727,Staff,8,0,10,2
1683351058441,ETHN 182,A00,185728,Staff,0,0,35,35
1683351059466,ETHN 183,A00,185737,Staff,8,0,18,10
1683351060488,GLBH 111,A01,209361,Burgos; Jose L.,0,0,0,0
1683351062538,HIEU 104,A00,185792,Staff,16,0,20,4
1683351063568,HIEU 115,A00,185800,Staff,1,0,20,19
1683351064591,HIEU 128,A00,185801,Staff,0,7,20,20
1683351065619,HIEU 147,A00,185802,Staff,16,0,20,4
1683351066645,HIEU 154,A00,185823,Staff,12,0,20,8
1683351067671,HILA 102,A00,185826,Staff,13,0,20,7
1683351068695,HILD 2C,A01,185778,Staff,0,12,20,20
1683351069720,HILD 7B,A01,185780,Kwak; Nancy,0,15,32,32
1683351069720,HILD 7B,A02,185781,Kwak; Nancy,0,18,32,32
1683351070743,HILD 30,A01,185791,Staff,14,0,20,6
1683351071768,HISC 119,A00,185830,Golan; Tal,0,9,20,20
1683351072791,HITO 156GS,A00,185831,Patterson; Patrick H.,0,0,0,23
1683351073821,HIUS 103,A00,185832,Man; Simeon S,0,6,20,20
1683351074847,HIUS 117,A00,185836,Kwak; Nancy,2,0,20,18
1683351075876,HIUS 125,A00,185840,Man; Simeon S,0,0,23,23
1683351076904,HIUS 149,A00,185845,Staff,0,0,20,20
1683351077933,HUM 3,A01,185882,Zavodny; Tatiana Sophia,0,7,50,50
1683351077933,HUM 3,B01,185899,Caldwell; Michael Alan,0,18,50,50
1683351078960,HUM 3GS,A00,185900,Patterson; Patrick H.,0,0,0,23
1683351080008,HUM 4,A01,185938,Zroka; Amy Liane,31,0,50,19
1683351080008,HUM 4,B01,185956,Watkins; Eric,0,3,50,50
1683351080008,HUM 4,B02,202209,Watkins; Eric,0,2,50,50
1683351080008,HUM 4,B03,202210,Watkins; Eric,0,2,50,50
1683351081037,HUM 5,A01,185958,West; Geoffrey Scott,3,0,50,47
1683351081037,HUM 5,A02,202215,West; Geoffrey Scott,0,0,50,50
1683351082060,INTL 190,A00,185959,Gagnon; Jeffrey C,0,0,0,9
1683351082060,INTL 190,B00,185960,Lettieri; Michael Joseph,0,0,0,1
1683351083087,JAPN 180,A00,254509,Staff,4,0,30,26
1683351084113,LATI 10,A01,202853,Kennemore; Amy Michelle,4,0,35,31
1683351084113,LATI 10,A02,202854,Kennemore; Amy Michelle,2,0,35,33
1683351084113,LATI 10,A03,270054,Kennemore; Amy Michelle,30,0,30,0
1683351085142,LATI 180,A00,202855,Kennemore; Amy Michelle,11,0,20,9
1683351086169,LAWS 101,A00,201767,Golan; Tal,0,7,40,40
1683351087194,LIFR 1C,A00,185961,Staff,6,0,20,14
1683351088220,LIFR 1CX,A00,185962,Staff,7,0,20,13
1683351089246,LIFR 1D,A00,185963,Staff,9,0,20,11
1683351090270,LIFR 1DX,A00,185964,Staff,9,0,20,11
1683351091295,LIGN 101,A01,186039,Staff,43,0,50,7
1683351092321,LIGN 165,A00,186040,Staff,18,0,50,32
1683351093345,LTCS 108,A00,186041,Staff,6,0,10,4
1683351094369,LTCS 119,A00,186042,Staff,16,0,20,4
1683351095393,LTCS 130,A00,186043,Wesling; Megan E.,15,0,25,10
1683351097445,LTEA 138,A00,186119,Staff,14,0,40,26
1683351098473,LTEN 124,A00,186148,Staff,6,0,25,19
1683351099497,LTEN 178,A00,186149,Staff,7,0,15,8
1683351100524,LTEN 181,A00,186150,Blanco; John D,33,0,40,7
1683351101553,LTWL 120,A00,186160,Staff,20,0,25,5
1683351102634,LTWL 165,A00,186161,Staff,22,0,25,3
1683351103660,LTWR 100,A00,186162,Staff,0,5,15,15
1683351104685,LTWR 102,A00,186163,Doller; Ben,5,0,15,10
1683351105711,MAE 8,A01,186412,Staff,0,0,0,0
1683351106735,MAE 30B,A00,186445,Bahadori; Mohammad Yousef,83,0,100,17
1683351107757,MAE 40,A00,186592,Bewley; Thomas R,9,0,50,41
1683351108782,MAE 101B,A00,186593,Bahadori; Mohammad Yousef,81,0,100,19
1683351109806,MAE 105,A00,186594,Bandaru; Prabhakar,12,0,50,38
1683351110833,MAE 107,A00,186599,Pham; Hieu Tan,0,6,120,120
1683351111857,MAE 148,A01,186660,Silberman; Jack,3,0,16,13
1683351112883,MATH 10A,A01,188095,Staff,0,5,35,35
1683351113915,MATH 10B,A01,188097,Bowers; Adam R.,0,11,30,30
1683351113915,MATH 10B,A02,188099,Bowers; Adam R.,0,11,30,30
1683351113915,MATH 10B,B01,188104,Bowers; Adam R.,0,10,30,30
1683351113915,MATH 10B,B02,188106,Bowers; Adam R.,0,10,30,30
1683351114940,MATH 10C,A01,188111,Staff,0,18,30,30
1683351114940,MATH 10C,A02,188127,Staff,0,17,30,30
1683351114940,MATH 10C,A03,188131,Staff,0,18,30,30
1683351114940,MATH 10C,B01,188218,Staff,18,0,30,12
1683351114940,MATH 10C,B02,188244,Staff,13,0,30,17
1683351114940,MATH 10C,B03,188277,Staff,16,0,30,14
1683351115965,MATH 18,A01,188344,Bach; Quang Tran,18,0,30,12
1683351115965,MATH 18,A02,188345,Bach; Quang Tran,11,0,30,19
1683351115965,MATH 18,B01,188353,Bach; Quang Tran,10,0,30,20
1683351115965,MATH 18,B02,188354,Bach; Quang Tran,20,0,30,10
1683351116988,MATH 20A,A01,188374,Staff,12,0,35,23
1683351118013,MATH 20B,A01,188382,Ohm; Ko Woon,6,0,30,24
1683351118013,MATH 20B,A02,188383,Ohm; Ko Woon,22,0,30,8
1683351118013,MATH 20B,B01,188385,Ohm; Ko Woon,7,0,30,23
1683351118013,MATH 20B,B02,188392,Ohm; Ko Woon,22,0,30,8
1683351119038,MATH 20C,A01,188394,Harel; Guershon,10,0,30,20
1683351119038,MATH 20C,A02,188395,Harel; Guershon,15,0,30,15
1683351119038,MATH 20C,B01,188404,Harel; Guershon,4,0,30,26
1683351119038,MATH 20C,B02,188405,Harel; Guershon,19,0,30,11
1683351120063,MATH 20D,A01,188414,Hammock; Frances H,0,1,30,30
1683351120063,MATH 20D,A02,188415,Hammock; Frances H,3,0,30,27
1683351120063,MATH 20D,B01,188447,Hammock; Frances H,1,0,30,29
1683351120063,MATH 20D,B02,188486,Hammock; Frances H,8,0,30,22
1683351121087,MATH 20E,A01,188649,Staff,21,0,30,9
1683351121087,MATH 20E,A02,188650,Staff,23,0,30,7
1683351121087,MATH 20E,A03,188673,Staff,0,0,30,30
1683351122113,MATH 102,A01,188675,Staff,0,35,35,35
1683351123137,MATH 103B,A01,188681,Staff,3,0,35,32
1683351123137,MATH 103B,B01,188692,Staff,5,0,35,30
1683351124165,MATH 109,A01,188695,Salehi Golsefidy; Alireza,25,0,35,10
1683351124165,MATH 109,A02,188696,Salehi Golsefidy; Alireza,25,0,35,10
1683351125189,MATH 120A,A01,188698,Eggers; John Dietrich,7,0,35,28
1683351126218,MATH 142B,A01,188736,Ioana; Adrian,0,2,30,30
1683351126218,MATH 142B,A02,188741,Ioana; Adrian,0,0,30,30
1683351126218,MATH 142B,A03,188743,Ioana; Adrian,0,1,30,30
1683351127241,MATH 168A,A01,188790,Staff,0,9,35,35
1683351128270,MATH 170A,A01,188803,Nie; Jiawang,0,2,35,35
1683351128270,MATH 170A,A02,188811,Nie; Jiawang,0,0,35,35
1683351128270,MATH 170A,A03,188814,Nie; Jiawang,1,0,35,34
1683351128270,MATH 170A,A04,188815,Nie; Jiawang,13,0,35,22
1683351129293,MATH 193B,A01,188817,Staff,0,0,35,35
1683351129293,MATH 193B,A02,188818,Staff,5,0,35,30
1683351130320,MGT 4,A01,202857,Anderson; John Charles,62,0,80,18
1683351131347,MGT 12,A00,202858,Lindenberger; Wade Douglas,42,0,90,48
1683351132372,MGT 18,A00,202859,Staff,74,0,90,16
1683351133399,MGT 18GS,A00,202860,McKay; Michael J,13,0,28,15
1683351134424,MGT 45,A00,202861,Pecore; Joseph P.,14,0,90,76
1683351135449,MGT 100,A00,202863,Yavorsky; Daniel Ryan,28,0,90,62
1683351136477,MGT 103,A00,202864,Ehrich; Kristine R,0,17,90,90
1683351137505,MGT 112,A00,202865,Ehrich; Kristine R,15,0,90,75
1683351138533,MGT 121A,A00,202868,Staff,0,20,0,0
1683351139561,MGT 131B,A00,202869,Anderson; John Charles,59,0,90,31
1683351140589,MGT 136,A00,202871,Lindenberger; Wade Douglas,84,0,90,6
1683351141616,MGT 164,A00,202873,Staff,0,68,90,91
1683351142640,MGT 164GS,A00,202874,McKay; Mary A,13,0,28,15
1683351143665,MGT 180,A00,202875,Staff,0,50,90,91
1683351144689,MMW 11R,A01,205019,Herbst; Matthew,3,0,30,27
1683351144689,MMW 11R,A02,205026,Herbst; Matthew,29,0,30,1
1683351145715,MMW 15,A01,193512,Chang; Edmond Yi-Teh,0,9,28,28
1683351145715,MMW 15,A02,193513,Chang; Edmond Yi-Teh,0,5,28,28
1683351145715,MMW 15,A03,193514,Chang; Edmond Yi-Teh,0,5,28,28
1683351145715,MMW 15,A04,193515,Chang; Edmond Yi-Teh,0,5,28,28
1683351145715,MMW 15,A05,193516,Chang; Edmond Yi-Teh,0,4,28,28
1683351145715,MMW 15,A06,193517,Chang; Edmond Yi-Teh,0,5,28,28
1683351145715,MMW 15,B01,193519,Chang; Edmond Yi-Teh,0,5,28,28
1683351145715,MMW 15,B02,193520,Chang; Edmond Yi-Teh,0,5,28,28
1683351145715,MMW 15,B03,193521,Chang; Edmond Yi-Teh,0,5,28,28
1683351145715,MMW 15,B04,193522,Chang; Edmond Yi-Teh,0,4,28,28
1683351145715,MMW 15,B05,193523,Chang; Edmond Yi-Teh,0,5,28,28
1683351145715,MMW 15,B06,193524,Chang; Edmond Yi-Teh,0,4,28,28
1683351146743,MMW 122,A01,193526,Rahimi; Babak,0,15,28,28
1683351146743,MMW 122,A02,193527,Rahimi; Babak,0,14,28,28
1683351146743,MMW 122,A03,193528,Rahimi; Babak,0,0,0,0
1683351146743,MMW 122,A04,193529,Rahimi; Babak,0,0,0,0
1683351147767,MUS 1A,A01,186663,Staff,0,20,35,35
1683351148792,MUS 4,A01,186715,Staff,0,12,35,35
1683351149820,MUS 5R,A01,186796,Dubnov; Shlomo,0,17,35,35
1683351150845,MUS 6,A01,186798,Staff,0,4,25,25
1683351151869,MUS 7,A01,186830,Staff,13,0,35,22
1683351152895,MUS 8,A01,186930,Staff,0,26,35,35
1683351153920,MUS 15,A01,186932,Staff,0,16,35,35
1683351153920,MUS 15,B01,186934,Staff,0,15,35,35
1683351154943,MUS 80,A00,186935,Staff,1,0,20,19
1683351154943,MUS 80,B00,186936,Staff,25,0,25,0
1683351155970,NANO 11,A00,204702,Lipomi; Darren John,0,0,0,0
1683351156998,NANO 15,A01,204709,Yang; Kesong,0,1,0,0
1683351158022,NANO 114,A00,202069,Jahed Motlagh; Zeinab,3,0,10,7
1683351159048,PHIL 1,A00,186955,Grush; Rick Scott,32,0,40,8
1683351160073,PHIL 10,A01,186973,Grush; Rick Scott,28,0,35,7
1683351160073,PHIL 10,A02,186974,Grush; Rick Scott,33,0,35,2
1683351161097,PHIL 13,A01,186976,Staff,7,0,35,28
1683351161097,PHIL 13,A02,186977,Staff,16,0,35,19
1683351162123,PHIL 14,A01,186979,Staff,31,0,35,4
1683351162123,PHIL 14,A02,186986,Staff,32,0,35,3
1683351163146,PHIL 28,A01,186988,Staff,16,0,30,14
1683351163146,PHIL 28,A02,186989,Staff,1,0,30,29
1683351163146,PHIL 28,A03,186990,Staff,9,0,30,21
1683351163146,PHIL 28,A04,186991,Staff,26,0,30,4
1683351164173,PHIL 120,A00,186997,Staff,23,0,40,17
1683351165198,PHIL 137,A00,187003,Staff,9,0,40,31
1683351166222,PHIL 150,A00,187015,Staff,47,0,70,23
1683351167244,PHIL 167,A00,187021,Lamey; Andy M.,35,0,40,5
1683351168268,PHIL 174,A01,202226,Staff,17,0,20,3
1683351168268,PHIL 174,A02,202235,Staff,20,0,20,0
1683351169295,PHIL 191A,A00,258918,Staff,0,0,1,1
1683351170322,PHYS 1A,A00,187028,Staff,27,0,60,33
1683351171345,PHYS 1AL,001,187036,Staff,2,0,30,28
1683351171345,PHYS 1AL,002,187049,Staff,18,0,30,12
1683351172368,PHYS 1B,A00,187058,Staff,22,0,60,38
1683351173395,PHYS 1BL,001,187064,Staff,0,0,30,30
1683351173395,PHYS 1BL,002,187070,Staff,5,0,30,25
1683351174424,PHYS 1C,A00,187082,Staff,31,0,120,89
1683351175449,PHYS 1CL,001,187088,Staff,0,9,30,30
1683351175449,PHYS 1CL,002,187089,Staff,0,2,30,30
1683351175449,PHYS 1CL,009,262693,Staff,11,0,30,19
1683351176472,PHYS 2B,A01,187097,Staff,54,0,115,61
1683351177496,PHYS 2C,A01,187099,Staff,67,0,115,48
1683351178525,PHYS 2CL,A01,187101,Staff,5,0,28,23
1683351178525,PHYS 2CL,A02,187102,Staff,15,0,28,13
1683351179549,PHYS 2D,A01,187123,Shotwell; Brian,95,0,115,20
1683351180577,PHYS 4B,A01,187133,Grinstein; Benjamin,35,0,50,15
1683351181603,POLI 10,A00,188819,Staff,0,4,50,50
1683351182627,POLI 11,A00,188827,Staff,43,0,50,7
1683351183655,POLI 13R,A00,188828,Staff,0,1,20,20
1683351184685,POLI 27,A01,188830,Elgin; Samuel Zincke,0,1,70,70
1683351185711,POLI 30,A00,188832,Desposato; Scott,31,0,50,19
1683351186739,POLI 102F,A00,188834,Staff,3,0,40,37
1683351187763,POLI 104A,A00,188852,Staff,14,0,30,16
1683351188790,POLI 104I,A00,188853,Staff,0,6,20,20
1683351189813,POLI 110B,A00,188854,Wiens; David,7,0,20,13
1683351190837,POLI 112A,A00,188855,Wiens; David,5,0,30,25
1683351191860,POLI 117R,A00,188856,Forman; Fonna,0,11,20,20
1683351192887,POLI 118,A00,188857,Ingham; Sean,8,0,20,12
1683351193913,POLI 120G,A00,188858,Staff,9,0,30,21
1683351194939,POLI 131CR,A00,188863,Hoston; Germaine,24,0,50,26
1683351195969,POLI 133,A00,188864,Nellis; Gareth Hb,44,0,50,6
1683351196993,POLI 134D,A00,188865,Desposato; Scott,27,0,30,3
1683351198020,POLI 142A,A00,188871,Gartzke; Erik,22,0,50,28
1683351199046,POLI 142K,A00,188874,Staff,38,0,50,12
1683351200073,POLI 143,A00,188940,Gartzke; Erik,16,0,30,14
1683351201101,POLI 153,A00,188943,Staff,3,0,20,17
1683351202125,POLI 160AA,A00,188944,Staff,11,0,40,29
1683351203149,POLI 170A,A00,188945,Staff,11,0,30,19
1683351205196,PSYC 1,A00,188952,Staff,37,0,90,53
1683351206280,PSYC 2,B00,188953,Staff,19,0,35,16
1683351207306,PSYC 6,A00,188970,Staff,47,0,60,13
1683351208331,PSYC 7,A00,188973,Staff,37,0,45,8
1683351209359,PSYC 60,A01,188980,Rickard; Timothy C.,43,0,60,17
1683351210385,PSYC 70,A01,189001,Steiner; Eric Tomas,23,0,45,22
1683351211409,PSYC 100,A00,189005,Lacefield; Katharine I,0,98,120,120
1683351212436,PSYC 102,A00,189008,Staff,9,0,30,21
1683351213460,PSYC 106,B00,189026,Gorman; Michael R.,34,0,60,26
1683351214487,PSYC 114,B01,189033,Winkielman; Piotr,0,32,30,30
1683351215511,PSYC 131,A00,189036,Anagnostaras; Stephan,0,43,60,60
1683351216539,PSYC 136,A00,189041,Lowe; Angela Beth,0,7,25,25
1683351217564,PSYC 137,A00,189057,Winkielman; Piotr,0,34,25,25
1683351218591,PSYC 144,A00,189107,Wixted; John T,0,7,50,50
1683351220640,PSYC 162,A00,189142,Staff,0,8,85,85
1683351221667,PSYC 172,A00,189144,Gorman; Michael R.,0,7,30,30
1683351223722,PSYC 179,A00,189146,Lacefield; Katharine I,0,84,120,120
1683351224747,PSYC 181,A00,189147,Anagnostaras; Stephan,0,44,90,90
1683351225772,PSYC 190R,A00,189148,Barner; David A.,0,22,80,80
1683351226799,PSYC 191,A00,189275,Rickard; Timothy C.,0,7,25,25
1683351227825,PSYC 193,A00,189276,Chapman; Eddie Nathaniel,0,1,0,4
1683351228852,PSYC 193L,A01,189281,Lowe; Angela Beth,12,0,20,8
1683351228852,PSYC 193L,B01,189285,Staff,28,0,35,7
1683351229875,RELI 149,A00,187137,Rahimi; Babak,7,0,40,33
1683351230901,SE 9,A01,187315,Staff,0,2,18,18
1683351231927,SE 101B,A00,187409,Staff,24,0,30,6
1683351232951,SE 110B,A00,187444,Staff,10,0,40,30
1683351233975,SE 130B,A00,187449,Staff,31,0,40,9
1683351235004,SE 150A,A00,187516,Staff,9,0,20,11
1683351236030,SE 154,A00,187528,Staff,30,0,50,20
1683351237054,SIO 3,A01,258171,Staff,35,0,40,5
1683351238077,SIO 10,A00,187144,Cook; Geoffrey W,0,3,75,75
1683351239101,SIO 45,A00,187152,Cook; Geoffrey W,1,0,100,99
1683351240125,SIO 109R,A00,194486,Staff,0,3,20,20
1683351242176,SIO 187,A01,187233,Kacev; David,12,0,40,28
1683351243201,SOCI 1,A01,258656,Thorpe; Charles Robert,28,0,30,2
1683351243201,SOCI 1,A02,258658,Thorpe; Charles Robert,30,0,30,0
1683351243201,SOCI 1,A03,258661,Thorpe; Charles Robert,25,0,25,0
1683351243201,SOCI 1,A04,258666,Thorpe; Charles Robert,22,0,25,3
1683351243201,SOCI 1,A05,258897,Thorpe; Charles Robert,23,0,25,2
1683351243201,SOCI 1,A06,258898,Thorpe; Charles Robert,25,0,25,0
1683351244224,SOCI 30,A01,258903,Pardo Guerra; Juan Pablo,15,0,30,15
1683351245250,SOCI 102,A00,258904,Staff,9,0,25,16
1683351246273,SOCI 106,A00,258905,Staff,19,0,25,6
1683351247300,SOCI 111,A00,258907,Ribas Norris; Janet Vanesa,26,0,30,4
1683351248327,SOCI 121R,A00,258908,Pardo Guerra; Juan Pablo,10,0,30,20
1683351249355,SOCI 126,A01,203330,Staff,14,0,20,6
1683351250380,SOCI 131,A00,258909,Thorpe; Charles Robert,31,0,60,29
1683351251409,SOCI 135,A00,258910,Payne; Christine Anna,0,9,30,30
1683351252439,SOCI 157,A00,258911,Staff,12,0,30,18
1683351253461,SOCI 184,A00,258912,Staff,25,0,30,5
1683351254486,SOCI 188D,A00,258913,Staff,22,0,30,8
1683351255513,SYN 2,001,187529,Staff,10,0,16,6
1683351255513,SYN 2,002,201452,Staff,0,18,16,16
1683351255513,SYN 2,003,201469,Staff,3,0,16,13
1683351256539,SYN 100,A01,187531,Staff,0,9,20,20
1683351256539,SYN 100,B01,201491,Staff,0,12,20,20
1683351257568,TDAC 1,A00,189286,Walsh; Kim C.,3,0,20,17
1683351257568,TDAC 1,B00,189287,Harting; Carla Kelso,11,0,20,9
1683351258593,TDAC 101,A00,189300,Walsh; Kim C.,16,0,20,4
1683351258593,TDAC 101,B00,189301,Harting; Carla Kelso,18,0,20,2
1683351259619,TDAC 102,A00,189304,Basso; Beatrice,14,0,20,6
1683351260643,TDAC 108,A00,189305,Staff,18,0,20,2
1683351261669,TDDE 131,A00,189310,Staff,19,0,20,1
1683351261669,TDDE 131,B00,189314,Staff,19,0,20,1
1683351261669,TDDE 131,C00,189315,Staff,48,0,50,2
1683351261669,TDDE 131,D00,189316,Staff,14,0,15,1
1683351261669,TDDE 131,E00,204841,Staff,20,0,20,0
1683351262698,TDGE 10,A00,189289,Staff,30,0,50,20
1683351262698,TDGE 10,B00,189290,Havis; Allan,1,0,50,49
1683351263726,TDGE 11,A00,189291,Fulton; Julia,0,3,50,50
1683351263726,TDGE 11,B00,189292,Staff,20,0,25,5
1683351263726,TDGE 11,C00,260270,Staff,0,0,0,0
1683351264753,TDGE 25,A00,189294,Staff,3,0,20,17
1683351265780,TDGE 124,A00,189318,Fulton; Julia,0,8,50,50
1683351266804,TDGE 125,A00,189319,Staff,13,0,25,12
1683351266804,TDGE 125,B00,189320,Staff,23,0,25,2
1683351267831,TDGE 127,A00,189322,Havis; Allan,0,0,50,50
1683351268858,TDHT 101,A00,189323,Staff,18,0,25,7
1683351268858,TDHT 101,B00,189324,Staff,25,0,25,0
1683351269886,TDHT 102,A00,189325,Staff,49,0,50,1
1683351270914,TDMV 1,A00,189295,Arcidiacono; Kristin,19,0,30,11
1683351270914,TDMV 1,B00,189296,Caligagan; Maria T.,24,0,30,6
1683351271938,TDMV 2,A00,189297,Sammartano; Tonnie,28,0,30,2
1683351271938,TDMV 2,B00,189299,Arcidiacono; Kristin,24,0,30,6
1683351272967,TDMV 3,A00,204998,Rincon; Alicia,22,0,30,8
1683351273993,TDMV 120,A00,189458,Sammartano; Tonnie,28,0,30,2
1683351275017,TDMV 138,A00,189541,Jun; Grace Shin Hae,22,0,40,18
1683351276042,TDMV 142,A00,189717,Caligagan; Tony,23,0,30,7
1683351276042,TDMV 142,B00,189718,Caligagan; Maria T.,25,0,30,5
1683351277067,TMC 2,A01,187533,Staff,25,0,25,0
1683351277067,TMC 2,A02,187534,Staff,25,0,25,0
1683351278091,USP 1,A01,187536,Kwak; Nancy,0,16,25,25
1683351279118,USP 5,A01,187538,Staff,10,0,25,15
1683351280143,USP 101,A00,199253,Staff,0,4,0,0
1683351281166,USP 124,A00,187562,Boomhower; Matthew Charles,1,0,30,29
1683351282192,USP 138,A00,187582,Staff,20,0,25,5
1683351283217,USP 152,A01,187597,Staff,4,0,25,21
1683351284241,USP 153,A00,187598,Staff,19,0,25,6
1683351285266,USP 168,A00,187607,Kwak; Nancy,2,0,5,3
1683351286290,USP 173,A00,187619,Staff,4,0,25,21
1683351287313,USP 181,A00,187638,Staff,0,1,25,25
1683351288342,VIS 103,A00,187650,Cruz; Edwin Teddy,22,0,75,53
1683351289366,VIS 110D,A00,187669,Staff,12,0,22,10
1683351290393,VIS 127C,A00,187720,Shen; Kuiyi,67,0,146,79
1683351291418,VIS 149,A00,187731,Yoldas; Pinar,0,14,22,22
1683351292445,VIS 151,A01,188091,Staff,22,0,34,12
1683351292445,VIS 151,A02,188092,Staff,11,0,34,23
1683351293471,VIS 160B,A00,188093,Stalbaum; Brett,0,0,10,10
1683351295521,WCWP 10B,A00,201720,Staff,10,0,15,5
1683351295521,WCWP 10B,B00,201722,Staff,9,0,15,6
1683351296545,WCWP 100,A00,201725,Gagnon; Jeffrey C,0,0,2,2
1683351296545,WCWP 100,B00,201727,Staff,0,4,15,15
1683351299664,ANBI 133,A00,258401,Wilder; Linnea Lorene,34,0,40,6
1683351300688,ANBI 140,A00,258395,Hrvoj Mihic; Branka,18,0,25,7
1683351301711,ANSC 120,A00,258402,Bialecki; Jon Anthony,27,0,40,13
1683351302738,ANSC 144,A00,258400,Staff,14,0,40,26
1683351304787,ANSC 166,A00,258396,Parish; Steven Martin,157,0,175,18
1683351305815,ANSC 180,A00,193533,Staff,9,0,20,11
1683351306839,ANSC 188,A00,258397,Jassal; Aftab,33,0,40,7
1683351307861,ANTH 3,A01,258316,Staff,23,0,30,7
1683351308885,ANTH 5,A00,258394,Semendeferi; Ekaterini,16,0,20,4
1683351309965,ANTH 21,A01,258331,Staff,8,0,40,32
1683351310994,ANTH 103,A00,258398,Varma; Saiba,15,0,25,10
1683351312021,AWP 10,001,202034,Staff,0,0,0,0
1683351312021,AWP 10,002,202035,Staff,0,0,0,0
1683351312021,AWP 10,003,202036,Staff,0,0,0,0
1683351312021,AWP 10,004,202037,Staff,0,0,0,0
1683351312021,AWP 10,005,202038,Staff,0,0,0,0
1683351312021,AWP 10,006,202039,Staff,0,0,0,0
1683351312021,AWP 10,007,202040,Staff,0,0,0,0
1683351312021,AWP 10,008,202041,Staff,0,0,0,0
1683351312021,AWP 10,009,202042,Staff,0,0,0,0
1683351312021,AWP 10,010,202043,Staff,0,0,0,0
1683351312021,AWP 10,011,202044,Staff,0,0,0,0
1683351312021,AWP 10,012,202045,Staff,0,0,0,0
1683351312021,AWP 10,013,202046,Staff,0,0,0,0
1683351312021,AWP 10,014,202047,Staff,0,0,0,0
1683351312021,AWP 10,015,202048,Staff,0,0,0,0
1683351312021,AWP 10,016,202049,Staff,0,0,0,0
1683351312021,AWP 10,017,202050,Staff,0,0,0,0
1683351312021,AWP 10,018,202051,Staff,0,0,0,0
1683351312021,AWP 10,019,202052,Staff,0,0,0,0
1683351312021,AWP 10,020,202053,Staff,0,0,0,0
1683351312021,AWP 10,021,202054,Staff,0,0,0,0
1683351312021,AWP 10,022,202055,Staff,0,0,0,0
1683351312021,AWP 10,023,202056,Staff,0,0,0,0
1683351312021,AWP 10,024,202057,Staff,0,0,0,0
1683351312021,AWP 10,025,202058,Staff,0,0,0,0
1683351312021,AWP 10,026,202059,Staff,0,0,0,0
1683351313044,AWP 102,001,202032,Staff,0,0,0,0
1683351313044,AWP 102,002,202033,Staff,0,0,0,0
1683351314068,BENG 100,A01,254234,Taylor Amos; Alyssa C,31,0,40,9
1683351315092,BENG 196,001,270013,Engler; Adam J.,9999,0,9999,0
1683351316115,BICD 100R,A01,202018,Smith; Laurie,0,7,32,32
1683351316115,BICD 100R,A02,202019,Smith; Laurie,0,2,32,32
1683351316115,BICD 100R,A03,202020,Smith; Laurie,0,1,32,32
1683351316115,BICD 100R,A04,202021,Smith; Laurie,9,0,32,23
1683351316115,BICD 100R,A05,202022,Smith; Laurie,12,0,32,20
1683351317142,BICD 136,A01,193242,Gustafson-Brown; Cindy,0,2,32,32
1683351317142,BICD 136,A02,193244,Gustafson-Brown; Cindy,14,0,32,18
1683351318166,BIEB 102,A01,193249,Butler; Shannon Rhey,0,2,32,32
1683351318166,BIEB 102,A02,193251,Butler; Shannon Rhey,0,0,32,32
1683351318166,BIEB 102,A03,193253,Butler; Shannon Rhey,0,1,32,32
1683351318166,BIEB 102,A04,193255,Butler; Shannon Rhey,17,0,32,15
1683351318166,BIEB 102,A05,193265,Butler; Shannon Rhey,26,0,32,6
1683351318166,BIEB 102,A06,193269,Butler; Shannon Rhey,16,0,32,16
1683351320216,BIEB 150,A01,193274,Staff,0,0,32,32
1683351320216,BIEB 150,A02,193285,Staff,23,0,32,9
1683351321239,BIEB 194,A00,193286,Kurle; Carolyn M.,22,0,32,10
1683351322264,BILD 1,A01,192291,Staff,16,0,32,16
1683351322264,BILD 1,A02,192292,Staff,30,0,32,2
1683351322264,BILD 1,B01,192520,Reuther; Keefe,0,1,0,0
1683351322264,BILD 1,B02,192532,Reuther; Keefe,0,1,0,0
1683351323295,BILD 3,A01,192556,Butler; Shannon Rhey,0,0,32,32
1683351323295,BILD 3,A02,192581,Butler; Shannon Rhey,4,0,32,28
1683351323295,BILD 3,A03,192611,Butler; Shannon Rhey,23,0,32,9
1683351323295,BILD 3,A04,192612,Butler; Shannon Rhey,25,0,32,7
1683351323295,BILD 3,A05,192613,Butler; Shannon Rhey,27,0,32,5
1683351323295,BILD 3,A06,192679,Butler; Shannon Rhey,27,0,32,5
1683351323295,BILD 3,A07,192682,Butler; Shannon Rhey,22,0,32,10
1683351324324,BILD 4,A01,192836,Reuther; Keefe,0,0,24,24
1683351324324,BILD 4,A02,193044,Reuther; Keefe,4,0,24,20
1683351325349,BILD 10,A01,193142,Gustafson-Brown; Cindy,30,0,32,2
1683351325349,BILD 10,A02,193149,Gustafson-Brown; Cindy,31,0,32,1
1683351326374,BIMM 100,A01,193301,Staff,0,6,32,32
1683351326374,BIMM 100,A02,193312,Staff,0,5,32,32
1683351326374,BIMM 100,A03,193323,Staff,0,8,32,32
1683351327401,BIMM 101,A01,193329,McDonnell; Lisa Marie,0,3,24,24
1683351327401,BIMM 101,A02,193339,McDonnell; Lisa Marie,0,3,24,24
1683351327401,BIMM 101,B01,193354,McDonnell; Lisa Marie,0,3,24,24
1683351327401,BIMM 101,B02,193357,McDonnell; Lisa Marie,0,3,24,24
1683351328428,BIMM 110,A01,193377,Tat; John,0,11,32,32
1683351328428,BIMM 110,A02,193378,Tat; John,0,8,32,32
1683351329456,BIMM 120,A01,206116,Staff,0,0,32,32
1683351329456,BIMM 120,A02,206117,Staff,8,0,32,24
1683351329456,BIMM 120,A03,206121,Staff,21,0,32,11
1683351330479,BIPN 100,A01,193393,Park; Ji Young,0,14,32,32
1683351330479,BIPN 100,A02,193402,Park; Ji Young,0,13,32,32
1683351330479,BIPN 100,A03,193413,Park; Ji Young,0,14,32,32
1683351330479,BIPN 100,A04,193414,Park; Ji Young,0,13,32,32
1683351331507,BIPN 102,A01,193429,Staff,0,0,32,32
1683351331507,BIPN 102,A02,193438,Staff,22,0,32,10
1683351332534,BIPN 106,A01,193450,Reyes Gonzalez; Catalina,0,2,40,40
1683351333558,BIPN 134,A01,193465,Cooke; James Edward,0,0,32,32
1683351333558,BIPN 134,A02,193474,Cooke; James Edward,25,0,32,7
1683351333558,BIPN 134,A03,193485,Cooke; James Edward,29,0,32,3
1683351333558,BIPN 134,A04,193486,Cooke; James Edward,21,0,32,11
1683351333558,BIPN 134,A05,193491,Cooke; James Edward,31,0,32,1
1683351333558,BIPN 134,A06,193501,Cooke; James Edward,30,0,32,2
1683351333558,BIPN 134,A07,193510,Cooke; James Edward,29,0,32,3
1683351335609,BISP 194,A00,222522,Staff,14,0,32,18
1683351336634,CAT 124,A01,202407,Staff,20,0,25,5
1683351337662,CAT 125,A00,202408,Marchisotto; Jennifer Anne,4,0,20,16
1683351338688,CAT 125R,A00,202409,Smith; Lauryn Alissa,0,11,20,20
1683351338688,CAT 125R,B00,202410,Morales; Celeste Georgianna,0,11,20,20
1683351338688,CAT 125R,C00,202411,Irwin; Matthew Joseph,0,10,20,20
1683351339716,CENG 15,A01,204712,Yang; Kesong,0,1,0,0
1683351340744,CENG 114,A00,202070,Jahed Motlagh; Zeinab,5,0,20,15
1683351341771,CGS 105,A00,185477,Wesling; Megan E.,24,0,40,16
1683351342801,CGS 106,A00,185494,Staff,13,0,22,9
1683351343826,CGS 108,A00,185495,Staff,14,0,20,6
1683351344851,CGS 114,A00,185496,Staff,13,0,18,5
1683351345875,CGS 119,A00,185501,Staff,15,0,20,5
1683351346896,CGS 120,A00,185511,Staff,13,0,20,7
1683351347921,CHEM 4,A01,184675,Bussey; Thomas J,96,0,100,4
1683351348945,CHEM 6A,A01,184677,Staff,34,0,60,26
1683351349970,CHEM 6B,A01,184679,Staff,65,0,100,35
1683351350996,CHEM 6C,A01,184681,Bussey; Thomas J,1,0,50,49
1683351350996,CHEM 6C,A02,184682,Bussey; Thomas J,34,0,50,16
1683351352037,CHEM 40A,A01,184684,Albizati; Kim F.,37,0,100,63
1683351353061,CHEM 40B,A01,184686,Albizati; Kim F.,0,20,100,100
1683351354085,CHEM 41B,A01,184690,Staff,52,0,100,48
1683351355109,COGS 3,A01,184715,Boyle; Mary E. T.,0,25,40,40
1683351356131,COGS 14B,A01,185172,Staff,0,15,38,38
1683351357158,COGS 18,A01,184736,Staff,17,0,80,63
1683351358184,COGS 100,A01,184932,Staff,0,5,73,73
1683351359211,COGS 101A,A01,184935,Staff,0,39,30,30
1683351360238,COGS 101B,A01,184944,Staff,0,2,30,30
1683351361266,COGS 101C,A01,184946,Staff,0,12,30,30
1683351362289,COGS 102A,A01,184951,Johnson; Christine M.,2,0,40,38
1683351363319,COGS 107B,A01,184953,Mooshagian; Eric Frederick,0,50,40,40
1683351364342,COGS 118B,A01,184959,Gupta; Anjum,0,48,40,40
1683351365367,COGS 153,A00,184961,Staff,0,15,30,30
1683351366395,COGS 177,A00,184962,Staff,0,20,30,30
1683351367417,COGS 187A,A01,184969,Boyle; Mary E. T.,0,17,40,40
1683351368441,COMM 10,A01,185174,Staff,0,5,25,25
1683351368441,COMM 10,A02,185189,Staff,0,5,25,25
1683351368441,COMM 10,A03,269821,Staff,0,0,0,0
1683351369465,COMM 100B,A01,185475,Staff,0,0,0,2
1683351369465,COMM 100B,A02,185476,Staff,13,0,25,12
1683351370491,COMM 100C,A01,185314,Staff,1,0,25,24
1683351370491,COMM 100C,A02,185327,Staff,19,0,25,6
1683351371515,COMM 110M,A00,185349,Staff,2,0,40,38
1683351372539,COMM 113T,A00,185352,Staff,24,0,40,16
1683351373566,COMM 114I,A00,185353,Staff,33,0,40,7
1683351374593,COMM 131,A00,185354,Staff,19,0,30,11
1683351375619,CSE 8A,A50,185358,Cao; Yingjun,0,46,10,10
1683351376646,CSE 8B,A01,185362,Staff,0,46,50,50
1683351377671,CSE 11,A01,185416,Cao; Yingjun,0,92,10,10
1683351378697,CSE 20,A01,185445,Briones; Jor-el Thomas Caparas,5,0,25,20
1683351379725,CSE 21,A01,185447,Staff,10,0,50,40
1683351380754,CSE 101,A01,185451,Staff,0,13,50,50
1683351380754,CSE 101,B01,185453,Jones; Miles E,0,11,50,50
1683351382809,CSE 141,A01,185458,Eldon; John,20,0,100,80
1683351383837,CSE 141L,A01,185461,Eldon; John,12,0,100,88
1683351384862,CSE 142,A01,185463,Staff,36,0,60,24
1683351384862,CSE 142,B01,201355,Staff,0,7,60,60
1683351385886,CSE 142L,A01,185470,Staff,36,0,60,24
1683351385886,CSE 142L,B01,201417,Staff,0,6,60,60
1683351386909,CSE 190,A00,201433,Staff,32,0,49,17
1683351387934,DOC 1,A01,259136,Strom; Megan C.,7,0,15,8
1683351387934,DOC 1,A02,259137,Strom; Megan C.,14,0,15,1
1683351387934,DOC 1,A03,259138,Strom; Megan C.,14,0,15,1
1683351387934,DOC 1,A04,259139,Strom; Megan C.,14,0,15,1
1683351388959,DOC 100D,A00,259140,Pass; Natalye Joann,16,0,25,9
1683351389986,DSGN 1,A01,184749,Rill; Bryan,0,25,30,30
1683351391011,DSGN 100,A01,185168,Staff,0,2,25,25
1683351392038,ECE 5,A01,185626,Morris; Karcher William,0,10,0,0
1683351393068,ECE 101,A01,185628,Staff,17,0,70,53
1683351394093,ECE 107,A01,185635,Baghdadchi; Saharnaz,0,0,20,20
1683351394093,ECE 107,A02,185638,Baghdadchi; Saharnaz,4,0,20,16
1683351395119,ECE 148,A01,185647,Silberman; Jack,0,0,16,16
1683351396145,ECON 1,A01,185537,Crane; Meredith Helen,54,0,70,16
1683351397171,ECON 3,A01,185549,Crane; Meredith Helen,32,0,70,38
1683351398198,ECON 4,A01,203354,Anderson; John Charles,0,4,10,10
1683351399222,ECON 100A,A01,185574,Staff,0,4,40,40
1683351400245,ECON 100B,A01,185576,Staff,0,12,50,50
1683351401271,ECON 100C,A01,185589,Newhouse; Herbert S,29,0,70,41
1683351402294,ECON 105,A00,185608,Vespa; Emanuel Ignacio,19,0,35,16
1683351403320,ECON 109,A01,185610,Shishkin; Denis,10,0,35,25
1683351404344,ECON 110A,A01,185612,Staff,11,0,40,29
1683351405367,ECON 120A,A01,185615,Staff,20,0,40,20
1683351406392,ECON 120C,A01,185617,Sun; Yixiao,0,21,70,70
1683351407416,ECON 144,A00,203346,Squires; Dale E,3,0,35,32
1683351408445,ECON 171,A01,203349,Newhouse; Herbert S,0,1,35,35
1683351409472,ECON 173A,A01,185621,Toda; Alexis Akira,21,0,35,14
1683351410502,EDS 25,A01,202413,Staff,0,1,0,0
1683351410502,EDS 25,A02,202414,Staff,0,1,0,0
1683351410502,EDS 25,A03,202415,Staff,0,0,0,0
1683351410502,EDS 25,A04,202416,Staff,0,1,0,0
1683351410502,EDS 25,A05,202439,Staff,0,0,0,0
1683351410502,EDS 25,A06,202440,Staff,0,0,0,0
1683351410502,EDS 25,B01,202631,Staff,0,0,0,0
1683351410502,EDS 25,B02,202632,Staff,0,0,0,0
1683351410502,EDS 25,B03,202639,Staff,0,0,0,0
1683351410502,EDS 25,B04,202640,Staff,0,0,0,0
1683351410502,EDS 25,B05,202643,Staff,0,0,0,0
1683351410502,EDS 25,B06,202644,Staff,0,0,0,0
1683351411524,EDS 38,A01,202659,Black; Alison Michelle,24,0,25,1
1683351412548,EDS 115,A00,202652,Staff,18,0,30,12
1683351413645,EDS 125,A00,202649,Staff,14,0,30,16
1683351414672,EDS 126,A01,203332,Staff,30,0,30,0
1683351415695,EDS 139,A00,202838,Staff,16,0,25,9
1683351416722,EDS 146,A01,202655,Staff,14,0,25,11
1683351417753,ENG 15,A00,185667,Staff,0,1,0,0
1683351417753,ENG 15,B00,185672,Staff,0,0,0,0
1683351417753,ENG 15,C00,185675,Staff,0,0,0,0
1683351417753,ENG 15,D00,185682,Staff,0,0,0,0
1683351417753,ENG 15,E00,185684,Staff,0,0,0,0
1683351418779,ETHN 103,A00,185710,Staff,0,4,35,35
1683351419803,ETHN 103A,A00,199228,Man; Simeon S,2,0,9,7
1683351420826,ETHN 109,A00,185711,Staff,18,0,35,17
1683351421852,ETHN 142,A00,185726,Staff,0,4,30,30
1683351422879,ETHN 163J,A00,199229,Man; Simeon S,5,0,8,3
1683351423906,ETHN 168,A00,185727,Staff,8,0,10,2
1683351424929,ETHN 182,A00,185728,Staff,0,0,35,35
1683351425954,ETHN 183,A00,185737,Staff,8,0,18,10
1683351426982,GLBH 111,A01,209361,Burgos; Jose L.,0,0,0,0
1683351429032,HIEU 104,A00,185792,Staff,16,0,20,4
1683351430056,HIEU 115,A00,185800,Staff,1,0,20,19
1683351431083,HIEU 128,A00,185801,Staff,0,7,20,20
1683351432121,HIEU 147,A00,185802,Staff,16,0,20,4
1683351433146,HIEU 154,A00,185823,Staff,12,0,20,8
1683351434174,HILA 102,A00,185826,Staff,13,0,20,7
1683351435201,HILD 2C,A01,185778,Staff,0,12,20,20
1683351436228,HILD 7B,A01,185780,Kwak; Nancy,0,15,32,32
1683351436228,HILD 7B,A02,185781,Kwak; Nancy,0,18,32,32
1683351437255,HILD 30,A01,185791,Staff,14,0,20,6
1683351438281,HISC 119,A00,185830,Golan; Tal,0,9,20,20
1683351439303,HITO 156GS,A00,185831,Patterson; Patrick H.,0,0,0,23
1683351440327,HIUS 103,A00,185832,Man; Simeon S,0,6,20,20
1683351441354,HIUS 117,A00,185836,Kwak; Nancy,2,0,20,18
1683351442378,HIUS 125,A00,185840,Man; Simeon S,0,0,23,23
1683351443403,HIUS 149,A00,185845,Staff,0,0,20,20
1683351444434,HUM 3,A01,185882,Zavodny; Tatiana Sophia,0,7,50,50
1683351444434,HUM 3,B01,185899,Caldwell; Michael Alan,0,18,50,50
1683351445459,HUM 3GS,A00,185900,Patterson; Patrick H.,0,0,0,23
1683351446489,HUM 4,A01,185938,Zroka; Amy Liane,31,0,50,19
1683351446489,HUM 4,B01,185956,Watkins; Eric,0,3,50,50
1683351446489,HUM 4,B02,202209,Watkins; Eric,0,2,50,50
1683351446489,HUM 4,B03,202210,Watkins; Eric,0,2,50,50
1683351447514,HUM 5,A01,185958,West; Geoffrey Scott,3,0,50,47
1683351447514,HUM 5,A02,202215,West; Geoffrey Scott,0,0,50,50
1683351448539,INTL 190,A00,185959,Gagnon; Jeffrey C,0,0,0,9
1683351448539,INTL 190,B00,185960,Lettieri; Michael Joseph,0,0,0,1
1683351449566,JAPN 180,A00,254509,Staff,4,0,30,26
1683351450590,LATI 10,A01,202853,Kennemore; Amy Michelle,4,0,35,31
1683351450590,LATI 10,A02,202854,Kennemore; Amy Michelle,2,0,35,33
1683351450590,LATI 10,A03,270054,Kennemore; Amy Michelle,30,0,30,0
1683351451614,LATI 180,A00,202855,Kennemore; Amy Michelle,11,0,20,9
1683351452641,LAWS 101,A00,201767,Golan; Tal,0,7,40,40
1683351453664,LIFR 1C,A00,185961,Staff,6,0,20,14
1683351454691,LIFR 1CX,A00,185962,Staff,7,0,20,13
1683351455720,LIFR 1D,A00,185963,Staff,9,0,20,11
1683351456744,LIFR 1DX,A00,185964,Staff,9,0,20,11
1683351457769,LIGN 101,A01,186039,Staff,43,0,50,7
1683351458794,LIGN 165,A00,186040,Staff,18,0,50,32
1683351459817,LTCS 108,A00,186041,Staff,6,0,10,4
1683351460840,LTCS 119,A00,186042,Staff,16,0,20,4
1683351461863,LTCS 130,A00,186043,Wesling; Megan E.,15,0,25,10
1683351463914,LTEA 138,A00,186119,Staff,14,0,40,26
1683351464938,LTEN 124,A00,186148,Staff,6,0,25,19
1683351465962,LTEN 178,A00,186149,Staff,7,0,15,8
1683351466986,LTEN 181,A00,186150,Blanco; John D,33,0,40,7
1683351468017,LTWL 120,A00,186160,Staff,20,0,25,5
1683351469043,LTWL 165,A00,186161,Staff,22,0,25,3
1683351470068,LTWR 100,A00,186162,Staff,0,5,15,15
1683351471092,LTWR 102,A00,186163,Doller; Ben,5,0,15,10
1683351472116,MAE 8,A01,186412,Staff,0,0,0,0
1683351473143,MAE 30B,A00,186445,Bahadori; Mohammad Yousef,83,0,100,17
1683351474166,MAE 40,A00,186592,Bewley; Thomas R,9,0,50,41
1683351475194,MAE 101B,A00,186593,Bahadori; Mohammad Yousef,81,0,100,19
1683351476223,MAE 105,A00,186594,Bandaru; Prabhakar,12,0,50,38
1683351477246,MAE 107,A00,186599,Pham; Hieu Tan,0,6,120,120
1683351478268,MAE 148,A01,186660,Silberman; Jack,3,0,16,13
1683351479292,MATH 10A,A01,188095,Staff,0,5,35,35
1683351480319,MATH 10B,A01,188097,Bowers; Adam R.,0,11,30,30
1683351480319,MATH 10B,A02,188099,Bowers; Adam R.,0,11,30,30
1683351480319,MATH 10B,B01,188104,Bowers; Adam R.,0,10,30,30
1683351480319,MATH 10B,B02,188106,Bowers; Adam R.,0,10,30,30
1683351481351,MATH 10C,A01,188111,Staff,0,18,30,30
1683351481351,MATH 10C,A02,188127,Staff,0,17,30,30
1683351481351,MATH 10C,A03,188131,Staff,0,18,30,30
1683351481351,MATH 10C,B01,188218,Staff,18,0,30,12
1683351481351,MATH 10C,B02,188244,Staff,13,0,30,17
1683351481351,MATH 10C,B03,188277,Staff,16,0,30,14
1683351482380,MATH 18,A01,188344,Bach; Quang Tran,18,0,30,12
1683351482380,MATH 18,A02,188345,Bach; Quang Tran,11,0,30,19
1683351482380,MATH 18,B01,188353,Bach; Quang Tran,10,0,30,20
1683351482380,MATH 18,B02,188354,Bach; Quang Tran,20,0,30,10
1683351483403,MATH 20A,A01,188374,Staff,12,0,35,23
1683351484426,MATH 20B,A01,188382,Ohm; Ko Woon,6,0,30,24
1683351484426,MATH 20B,A02,188383,Ohm; Ko Woon,22,0,30,8
1683351484426,MATH 20B,B01,188385,Ohm; Ko Woon,7,0,30,23
1683351484426,MATH 20B,B02,188392,Ohm; Ko Woon,22,0,30,8
1683351485451,MATH 20C,A01,188394,Harel; Guershon,10,0,30,20
1683351485451,MATH 20C,A02,188395,Harel; Guershon,15,0,30,15
1683351485451,MATH 20C,B01,188404,Harel; Guershon,4,0,30,26
1683351485451,MATH 20C,B02,188405,Harel; Guershon,19,0,30,11
1683351486476,MATH 20D,A01,188414,Hammock; Frances H,0,1,30,30
1683351486476,MATH 20D,A02,188415,Hammock; Frances H,3,0,30,27
1683351486476,MATH 20D,B01,188447,Hammock; Frances H,1,0,30,29
1683351486476,MATH 20D,B02,188486,Hammock; Frances H,8,0,30,22
1683351487505,MATH 20E,A01,188649,Staff,21,0,30,9
1683351487505,MATH 20E,A02,188650,Staff,23,0,30,7
1683351487505,MATH 20E,A03,188673,Staff,0,0,30,30
1683351488529,MATH 102,A01,188675,Staff,0,35,35,35
1683351489553,MATH 103B,A01,188681,Staff,3,0,35,32
1683351489553,MATH 103B,B01,188692,Staff,5,0,35,30
1683351490578,MATH 109,A01,188695,Salehi Golsefidy; Alireza,25,0,35,10
1683351490578,MATH 109,A02,188696,Salehi Golsefidy; Alireza,25,0,35,10
1683351491605,MATH 120A,A01,188698,Eggers; John Dietrich,7,0,35,28
1683351492632,MATH 142B,A01,188736,Ioana; Adrian,0,2,30,30
1683351492632,MATH 142B,A02,188741,Ioana; Adrian,0,0,30,30
1683351492632,MATH 142B,A03,188743,Ioana; Adrian,0,1,30,30
1683351493655,MATH 168A,A01,188790,Staff,0,9,35,35
1683351494681,MATH 170A,A01,188803,Nie; Jiawang,0,2,35,35
1683351494681,MATH 170A,A02,188811,Nie; Jiawang,0,0,35,35
1683351494681,MATH 170A,A03,188814,Nie; Jiawang,1,0,35,34
1683351494681,MATH 170A,A04,188815,Nie; Jiawang,13,0,35,22
1683351495705,MATH 193B,A01,188817,Staff,0,0,35,35
1683351495705,MATH 193B,A02,188818,Staff,5,0,35,30
1683351496729,MGT 4,A01,202857,Anderson; John Charles,62,0,80,18
1683351497753,MGT 12,A00,202858,Lindenberger; Wade Douglas,42,0,90,48
1683351498777,MGT 18,A00,202859,Staff,74,0,90,16
1683351499801,MGT 18GS,A00,202860,McKay; Michael J,13,0,28,15
1683351500828,MGT 45,A00,202861,Pecore; Joseph P.,14,0,90,76
1683351501853,MGT 100,A00,202863,Yavorsky; Daniel Ryan,28,0,90,62
1683351502877,MGT 103,A00,202864,Ehrich; Kristine R,0,17,90,90
1683351503904,MGT 112,A00,202865,Ehrich; Kristine R,15,0,90,75
1683351504930,MGT 121A,A00,202868,Staff,0,20,0,0
1683351505954,MGT 131B,A00,202869,Anderson; John Charles,59,0,90,31
1683351506978,MGT 136,A00,202871,Lindenberger; Wade Douglas,84,0,90,6
1683351508007,MGT 164,A00,202873,Staff,0,68,90,91
1683351509034,MGT 164GS,A00,202874,McKay; Mary A,13,0,28,15
1683351510060,MGT 180,A00,202875,Staff,0,50,90,91
1683351511085,MMW 11R,A01,205019,Herbst; Matthew,3,0,30,27
1683351511085,MMW 11R,A02,205026,Herbst; Matthew,29,0,30,1
1683351512114,MMW 15,A01,193512,Chang; Edmond Yi-Teh,0,9,28,28
1683351512114,MMW 15,A02,193513,Chang; Edmond Yi-Teh,0,5,28,28
1683351512114,MMW 15,A03,193514,Chang; Edmond Yi-Teh,0,5,28,28
1683351512114,MMW 15,A04,193515,Chang; Edmond Yi-Teh,0,5,28,28
1683351512114,MMW 15,A05,193516,Chang; Edmond Yi-Teh,0,4,28,28
1683351512114,MMW 15,A06,193517,Chang; Edmond Yi-Teh,0,5,28,28
1683351512114,MMW 15,B01,193519,Chang; Edmond Yi-Teh,0,5,28,28
1683351512114,MMW 15,B02,193520,Chang; Edmond Yi-Teh,0,5,28,28
1683351512114,MMW 15,B03,193521,Chang; Edmond Yi-Teh,0,5,28,28
1683351512114,MMW 15,B04,193522,Chang; Edmond Yi-Teh,0,4,28,28
1683351512114,MMW 15,B05,193523,Chang; Edmond Yi-Teh,0,5,28,28
1683351512114,MMW 15,B06,193524,Chang; Edmond Yi-Teh,0,4,28,28
1683351513141,MMW 122,A01,193526,Rahimi; Babak,0,15,28,28
1683351513141,MMW 122,A02,193527,Rahimi; Babak,0,14,28,28
1683351513141,MMW 122,A03,193528,Rahimi; Babak,0,0,0,0
1683351513141,MMW 122,A04,193529,Rahimi; Babak,0,0,0,0
1683351514167,MUS 1A,A01,186663,Staff,0,20,35,35
1683351515195,MUS 4,A01,186715,Staff,0,12,35,35
1683351516220,MUS 5R,A01,186796,Dubnov; Shlomo,0,17,35,35
1683351517300,MUS 6,A01,186798,Staff,0,4,25,25
1683351518324,MUS 7,A01,186830,Staff,13,0,35,22
1683351519349,MUS 8,A01,186930,Staff,0,26,35,35
1683351520376,MUS 15,A01,186932,Staff,0,16,35,35
1683351520376,MUS 15,B01,186934,Staff,0,15,35,35
1683351521406,MUS 80,A00,186935,Staff,1,0,20,19
1683351521406,MUS 80,B00,186936,Staff,25,0,25,0
1683351522429,NANO 11,A00,204702,Lipomi; Darren John,0,0,0,0
1683351523461,NANO 15,A01,204709,Yang; Kesong,0,1,0,0
1683351524489,NANO 114,A00,202069,Jahed Motlagh; Zeinab,3,0,10,7
1683351525513,PHIL 1,A00,186955,Grush; Rick Scott,32,0,40,8
1683351526541,PHIL 10,A01,186973,Grush; Rick Scott,28,0,35,7
1683351526541,PHIL 10,A02,186974,Grush; Rick Scott,33,0,35,2
1683351527565,PHIL 13,A01,186976,Staff,7,0,35,28
1683351527565,PHIL 13,A02,186977,Staff,16,0,35,19
1683351528590,PHIL 14,A01,186979,Staff,31,0,35,4
1683351528590,PHIL 14,A02,186986,Staff,32,0,35,3
1683351529618,PHIL 28,A01,186988,Staff,16,0,30,14
1683351529618,PHIL 28,A02,186989,Staff,1,0,30,29
1683351529618,PHIL 28,A03,186990,Staff,9,0,30,21
1683351529618,PHIL 28,A04,186991,Staff,26,0,30,4
1683351530642,PHIL 120,A00,186997,Staff,23,0,40,17
1683351531668,PHIL 137,A00,187003,Staff,9,0,40,31
1683351532694,PHIL 150,A00,187015,Staff,47,0,70,23
1683351533716,PHIL 167,A00,187021,Lamey; Andy M.,35,0,40,5
1683351534740,PHIL 174,A01,202226,Staff,17,0,20,3
1683351534740,PHIL 174,A02,202235,Staff,20,0,20,0
1683351535763,PHIL 191A,A00,258918,Staff,0,0,1,1
1683351536787,PHYS 1A,A00,187028,Staff,27,0,60,33
1683351537816,PHYS 1AL,001,187036,Staff,2,0,30,28
1683351537816,PHYS 1AL,002,187049,Staff,18,0,30,12
1683351538841,PHYS 1B,A00,187058,Staff,22,0,60,38
1683351539868,PHYS 1BL,001,187064,Staff,0,0,30,30
1683351539868,PHYS 1BL,002,187070,Staff,5,0,30,25
1683351540893,PHYS 1C,A00,187082,Staff,31,0,120,89
1683351541918,PHYS 1CL,001,187088,Staff,0,9,30,30
1683351541918,PHYS 1CL,002,187089,Staff,0,2,30,30
1683351541918,PHYS 1CL,009,262693,Staff,11,0,30,19
1683351542942,PHYS 2B,A01,187097,Staff,54,0,115,61
1683351543974,PHYS 2C,A01,187099,Staff,67,0,115,48
1683351545002,PHYS 2CL,A01,187101,Staff,5,0,28,23
1683351545002,PHYS 2CL,A02,187102,Staff,15,0,28,13
1683351546026,PHYS 2D,A01,187123,Shotwell; Brian,95,0,115,20
1683351547051,PHYS 4B,A01,187133,Grinstein; Benjamin,35,0,50,15
1683351548078,POLI 10,A00,188819,Staff,0,4,50,50
1683351549105,POLI 11,A00,188827,Staff,43,0,50,7
1683351550129,POLI 13R,A00,188828,Staff,0,1,20,20
1683351551157,POLI 27,A01,188830,Elgin; Samuel Zincke,0,1,70,70
1683351552182,POLI 30,A00,188832,Desposato; Scott,31,0,50,19
1683351553205,POLI 102F,A00,188834,Staff,3,0,40,37
1683351554232,POLI 104A,A00,188852,Staff,14,0,30,16
1683351555257,POLI 104I,A00,188853,Staff,0,6,20,20
1683351556284,POLI 110B,A00,188854,Wiens; David,7,0,20,13
1683351557313,POLI 112A,A00,188855,Wiens; David,5,0,30,25
1683351558335,POLI 117R,A00,188856,Forman; Fonna,0,11,20,20
1683351559359,POLI 118,A00,188857,Ingham; Sean,8,0,20,12
1683351560385,POLI 120G,A00,188858,Staff,9,0,30,21
1683351561411,POLI 131CR,A00,188863,Hoston; Germaine,24,0,50,26
1683351562434,POLI 133,A00,188864,Nellis; Gareth Hb,44,0,50,6
1683351563462,POLI 134D,A00,188865,Desposato; Scott,27,0,30,3
1683351564489,POLI 142A,A00,188871,Gartzke; Erik,22,0,50,28
1683351565517,POLI 142K,A00,188874,Staff,38,0,50,12
1683351566546,POLI 143,A00,188940,Gartzke; Erik,16,0,30,14
1683351567571,POLI 153,A00,188943,Staff,3,0,20,17
1683351568599,POLI 160AA,A00,188944,Staff,11,0,40,29
1683351569627,POLI 170A,A00,188945,Staff,11,0,30,19
1683351571678,PSYC 1,A00,188952,Staff,37,0,90,53
1683351572705,PSYC 2,B00,188953,Staff,19,0,35,16
1683351573730,PSYC 6,A00,188970,Staff,47,0,60,13
1683351574754,PSYC 7,A00,188973,Staff,37,0,45,8
1683351575778,PSYC 60,A01,188980,Rickard; Timothy C.,43,0,60,17
1683351576804,PSYC 70,A01,189001,Steiner; Eric Tomas,23,0,45,22
1683351577829,PSYC 100,A00,189005,Lacefield; Katharine I,0,98,120,120
1683351578856,PSYC 102,A00,189008,Staff,9,0,30,21
1683351579882,PSYC 106,B00,189026,Gorman; Michael R.,34,0,60,26
1683351580908,PSYC 114,B01,189033,Winkielman; Piotr,0,32,30,30
1683351581931,PSYC 131,A00,189036,Anagnostaras; Stephan,0,43,60,60
1683351582957,PSYC 136,A00,189041,Lowe; Angela Beth,0,7,25,25
1683351583982,PSYC 137,A00,189057,Winkielman; Piotr,0,34,25,25
1683351585005,PSYC 144,A00,189107,Wixted; John T,0,7,50,50
1683351587053,PSYC 162,A00,189142,Staff,0,8,85,85
1683351588078,PSYC 172,A00,189144,Gorman; Michael R.,0,7,30,30
1683351590132,PSYC 179,A00,189146,Lacefield; Katharine I,0,84,120,120
1683351591157,PSYC 181,A00,189147,Anagnostaras; Stephan,0,44,90,90
1683351592182,PSYC 190R,A00,189148,Barner; David A.,0,22,80,80
1683351593208,PSYC 191,A00,189275,Rickard; Timothy C.,0,7,25,25
1683351594235,PSYC 193,A00,189276,Chapman; Eddie Nathaniel,0,1,0,4
1683351595262,PSYC 193L,A01,189281,Lowe; Angela Beth,12,0,20,8
1683351595262,PSYC 193L,B01,189285,Staff,28,0,35,7
1683351596287,RELI 149,A00,187137,Rahimi; Babak,7,0,40,33
1683351597311,SE 9,A01,187315,Staff,0,2,18,18
1683351598333,SE 101B,A00,187409,Staff,24,0,30,6
1683351599356,SE 110B,A00,187444,Staff,10,0,40,30
1683351600384,SE 130B,A00,187449,Staff,31,0,40,9
1683351601411,SE 150A,A00,187516,Staff,9,0,20,11
1683351602435,SE 154,A00,187528,Staff,30,0,50,20
1683351603462,SIO 3,A01,258171,Staff,35,0,40,5
1683351604489,SIO 10,A00,187144,Cook; Geoffrey W,0,3,75,75
1683351605517,SIO 45,A00,187152,Cook; Geoffrey W,1,0,100,99
1683351606541,SIO 109R,A00,194486,Staff,0,3,20,20
1683351608594,SIO 187,A01,187233,Kacev; David,12,0,40,28
1683351609620,SOCI 1,A01,258656,Thorpe; Charles Robert,28,0,30,2
1683351609620,SOCI 1,A02,258658,Thorpe; Charles Robert,30,0,30,0
1683351609620,SOCI 1,A03,258661,Thorpe; Charles Robert,25,0,25,0
1683351609620,SOCI 1,A04,258666,Thorpe; Charles Robert,22,0,25,3
1683351609620,SOCI 1,A05,258897,Thorpe; Charles Robert,23,0,25,2
1683351609620,SOCI 1,A06,258898,Thorpe; Charles Robert,25,0,25,0
1683351610648,SOCI 30,A01,258903,Pardo Guerra; Juan Pablo,15,0,30,15
1683351611673,SOCI 102,A00,258904,Staff,9,0,25,16
1683351612697,SOCI 106,A00,258905,Staff,19,0,25,6
1683351613723,SOCI 111,A00,258907,Ribas Norris; Janet Vanesa,26,0,30,4
1683351614751,SOCI 121R,A00,258908,Pardo Guerra; Juan Pablo,10,0,30,20
1683351615774,SOCI 126,A01,203330,Staff,14,0,20,6
1683351616798,SOCI 131,A00,258909,Thorpe; Charles Robert,31,0,60,29
1683351617822,SOCI 135,A00,258910,Payne; Christine Anna,0,9,30,30
1683351618847,SOCI 157,A00,258911,Staff,12,0,30,18
1683351619875,SOCI 184,A00,258912,Staff,25,0,30,5
1683351620955,SOCI 188D,A00,258913,Staff,22,0,30,8
1683351621978,SYN 2,001,187529,Staff,10,0,16,6
1683351621978,SYN 2,002,201452,Staff,0,18,16,16
1683351621978,SYN 2,003,201469,Staff,3,0,16,13
1683351623002,SYN 100,A01,187531,Staff,0,9,20,20
1683351623002,SYN 100,B01,201491,Staff,0,12,20,20
1683351624028,TDAC 1,A00,189286,Walsh; Kim C.,3,0,20,17
1683351624028,TDAC 1,B00,189287,Harting; Carla Kelso,11,0,20,9
1683351625052,TDAC 101,A00,189300,Walsh; Kim C.,16,0,20,4
1683351625052,TDAC 101,B00,189301,Harting; Carla Kelso,18,0,20,2
1683351626077,TDAC 102,A00,189304,Basso; Beatrice,14,0,20,6
1683351627101,TDAC 108,A00,189305,Staff,18,0,20,2
1683351628129,TDDE 131,A00,189310,Staff,19,0,20,1
1683351628129,TDDE 131,B00,189314,Staff,19,0,20,1
1683351628129,TDDE 131,C00,189315,Staff,48,0,50,2
1683351628129,TDDE 131,D00,189316,Staff,14,0,15,1
1683351628129,TDDE 131,E00,204841,Staff,20,0,20,0
1683351629155,TDGE 10,A00,189289,Staff,30,0,50,20
1683351629155,TDGE 10,B00,189290,Havis; Allan,1,0,50,49
1683351630182,TDGE 11,A00,189291,Fulton; Julia,0,3,50,50
1683351630182,TDGE 11,B00,189292,Staff,20,0,25,5
1683351630182,TDGE 11,C00,260270,Staff,0,0,0,0
1683351631223,TDGE 25,A00,189294,Staff,3,0,20,17
1683351632246,TDGE 124,A00,189318,Fulton; Julia,0,8,50,50
1683351633274,TDGE 125,A00,189319,Staff,13,0,25,12
1683351633274,TDGE 125,B00,189320,Staff,23,0,25,2
1683351634300,TDGE 127,A00,189322,Havis; Allan,0,0,50,50
1683351635326,TDHT 101,A00,189323,Staff,18,0,25,7
1683351635326,TDHT 101,B00,189324,Staff,25,0,25,0
1683351636353,TDHT 102,A00,189325,Staff,49,0,50,1
1683351637377,TDMV 1,A00,189295,Arcidiacono; Kristin,19,0,30,11
1683351637377,TDMV 1,B00,189296,Caligagan; Maria T.,24,0,30,6
1683351638405,TDMV 2,A00,189297,Sammartano; Tonnie,28,0,30,2
1683351638405,TDMV 2,B00,189299,Arcidiacono; Kristin,24,0,30,6
1683351639427,TDMV 3,A00,204998,Rincon; Alicia,22,0,30,8
1683351640452,TDMV 120,A00,189458,Sammartano; Tonnie,28,0,30,2
1683351641481,TDMV 138,A00,189541,Jun; Grace Shin Hae,22,0,40,18
1683351642507,TDMV 142,A00,189717,Caligagan; Tony,23,0,30,7
1683351642507,TDMV 142,B00,189718,Caligagan; Maria T.,25,0,30,5
1683351643534,TMC 2,A01,187533,Staff,25,0,25,0
1683351643534,TMC 2,A02,187534,Staff,25,0,25,0
1683351644558,USP 1,A01,187536,Kwak; Nancy,0,16,25,25
1683351645582,USP 5,A01,187538,Staff,10,0,25,15
1683351646609,USP 101,A00,199253,Staff,0,4,0,0
1683351647632,USP 124,A00,187562,Boomhower; Matthew Charles,1,0,30,29
1683351648656,USP 138,A00,187582,Staff,20,0,25,5
1683351649680,USP 152,A01,187597,Staff,4,0,25,21
1683351650706,USP 153,A00,187598,Staff,19,0,25,6
1683351651733,USP 168,A00,187607,Kwak; Nancy,2,0,5,3
1683351652760,USP 173,A00,187619,Staff,4,0,25,21
1683351653784,USP 181,A00,187638,Staff,0,1,25,25
1683351654813,VIS 103,A00,187650,Cruz; Edwin Teddy,22,0,75,53
1683351655836,VIS 110D,A00,187669,Staff,12,0,22,10
1683351656860,VIS 127C,A00,187720,Shen; Kuiyi,67,0,146,79
1683351657888,VIS 149,A00,187731,Yoldas; Pinar,0,14,22,22
1683351658915,VIS 151,A01,188091,Staff,22,0,34,12
1683351658915,VIS 151,A02,188092,Staff,11,0,34,23
1683351659939,VIS 160B,A00,188093,Stalbaum; Brett,0,0,10,10
1683351661990,WCWP 10B,A00,201720,Staff,10,0,15,5
1683351661990,WCWP 10B,B00,201722,Staff,9,0,15,6
1683351663017,WCWP 100,A00,201725,Gagnon; Jeffrey C,0,0,2,2
1683351663017,WCWP 100,B00,201727,Staff,0,4,15,15
1683351666110,ANBI 133,A00,258401,Wilder; Linnea Lorene,34,0,40,6
1683351667138,ANBI 140,A00,258395,Hrvoj Mihic; Branka,18,0,25,7
1683351668162,ANSC 120,A00,258402,Bialecki; Jon Anthony,27,0,40,13
1683351669189,ANSC 144,A00,258400,Staff,14,0,40,26
1683351671238,ANSC 166,A00,258396,Parish; Steven Martin,157,0,175,18
1683351672264,ANSC 180,A00,193533,Staff,9,0,20,11
1683351673288,ANSC 188,A00,258397,Jassal; Aftab,33,0,40,7
1683351674317,ANTH 3,A01,258316,Staff,23,0,30,7
1683351675344,ANTH 5,A00,258394,Semendeferi; Ekaterini,16,0,20,4
1683351676367,ANTH 21,A01,258331,Staff,8,0,40,32
1683351677391,ANTH 103,A00,258398,Varma; Saiba,15,0,25,10
1683351678419,AWP 10,001,202034,Staff,0,0,0,0
1683351678419,AWP 10,002,202035,Staff,0,0,0,0
1683351678419,AWP 10,003,202036,Staff,0,0,0,0
1683351678419,AWP 10,004,202037,Staff,0,0,0,0
1683351678419,AWP 10,005,202038,Staff,0,0,0,0
1683351678419,AWP 10,006,202039,Staff,0,0,0,0
1683351678419,AWP 10,007,202040,Staff,0,0,0,0
1683351678419,AWP 10,008,202041,Staff,0,0,0,0
1683351678419,AWP 10,009,202042,Staff,0,0,0,0
1683351678419,AWP 10,010,202043,Staff,0,0,0,0
1683351678419,AWP 10,011,202044,Staff,0,0,0,0
1683351678419,AWP 10,012,202045,Staff,0,0,0,0
1683351678419,AWP 10,013,202046,Staff,0,0,0,0
1683351678419,AWP 10,014,202047,Staff,0,0,0,0
1683351678419,AWP 10,015,202048,Staff,0,0,0,0
1683351678419,AWP 10,016,202049,Staff,0,0,0,0
1683351678419,AWP 10,017,202050,Staff,0,0,0,0
1683351678419,AWP 10,018,202051,Staff,0,0,0,0
1683351678419,AWP 10,019,202052,Staff,0,0,0,0
1683351678419,AWP 10,020,202053,Staff,0,0,0,0
1683351678419,AWP 10,021,202054,Staff,0,0,0,0
1683351678419,AWP 10,022,202055,Staff,0,0,0,0
1683351678419,AWP 10,023,202056,Staff,0,0,0,0
1683351678419,AWP 10,024,202057,Staff,0,0,0,0
1683351678419,AWP 10,025,202058,Staff,0,0,0,0
1683351678419,AWP 10,026,202059,Staff,0,0,0,0
1683351679441,AWP 102,001,202032,Staff,0,0,0,0
1683351679441,AWP 102,002,202033,Staff,0,0,0,0
1683351680466,BENG 100,A01,254234,Taylor Amos; Alyssa C,31,0,40,9
1683351681491,BENG 196,001,270013,Engler; Adam J.,9999,0,9999,0
1683351682521,BICD 100R,A01,202018,Smith; Laurie,0,7,32,32
1683351682521,BICD 100R,A02,202019,Smith; Laurie,0,2,32,32
1683351682521,BICD 100R,A03,202020,Smith; Laurie,0,1,32,32
1683351682521,BICD 100R,A04,202021,Smith; Laurie,9,0,32,23
1683351682521,BICD 100R,A05,202022,Smith; Laurie,12,0,32,20
1683351683545,BICD 136,A01,193242,Gustafson-Brown; Cindy,0,2,32,32
1683351683545,BICD 136,A02,193244,Gustafson-Brown; Cindy,14,0,32,18
1683351684570,BIEB 102,A01,193249,Butler; Shannon Rhey,0,2,32,32
1683351684570,BIEB 102,A02,193251,Butler; Shannon Rhey,0,0,32,32
1683351684570,BIEB 102,A03,193253,Butler; Shannon Rhey,0,1,32,32
1683351684570,BIEB 102,A04,193255,Butler; Shannon Rhey,17,0,32,15
1683351684570,BIEB 102,A05,193265,Butler; Shannon Rhey,26,0,32,6
1683351684570,BIEB 102,A06,193269,Butler; Shannon Rhey,16,0,32,16
1683351686619,BIEB 150,A01,193274,Staff,0,0,32,32
1683351686619,BIEB 150,A02,193285,Staff,23,0,32,9
1683351687647,BIEB 194,A00,193286,Kurle; Carolyn M.,22,0,32,10
1683351688672,BILD 1,A01,192291,Staff,16,0,32,16
1683351688672,BILD 1,A02,192292,Staff,30,0,32,2
1683351688672,BILD 1,B01,192520,Reuther; Keefe,0,1,0,0
1683351688672,BILD 1,B02,192532,Reuther; Keefe,0,1,0,0
1683351689696,BILD 3,A01,192556,Butler; Shannon Rhey,0,0,32,32
1683351689696,BILD 3,A02,192581,Butler; Shannon Rhey,4,0,32,28
1683351689696,BILD 3,A03,192611,Butler; Shannon Rhey,23,0,32,9
1683351689696,BILD 3,A04,192612,Butler; Shannon Rhey,25,0,32,7
1683351689696,BILD 3,A05,192613,Butler; Shannon Rhey,27,0,32,5
1683351689696,BILD 3,A06,192679,Butler; Shannon Rhey,27,0,32,5
1683351689696,BILD 3,A07,192682,Butler; Shannon Rhey,22,0,32,10
1683351690720,BILD 4,A01,192836,Reuther; Keefe,0,0,24,24
1683351690720,BILD 4,A02,193044,Reuther; Keefe,4,0,24,20
1683351691742,BILD 10,A01,193142,Gustafson-Brown; Cindy,30,0,32,2
1683351691742,BILD 10,A02,193149,Gustafson-Brown; Cindy,31,0,32,1
1683351692766,BIMM 100,A01,193301,Staff,0,6,32,32
1683351692766,BIMM 100,A02,193312,Staff,0,5,32,32
1683351692766,BIMM 100,A03,193323,Staff,0,8,32,32
1683351693791,BIMM 101,A01,193329,McDonnell; Lisa Marie,0,3,24,24
1683351693791,BIMM 101,A02,193339,McDonnell; Lisa Marie,0,3,24,24
1683351693791,BIMM 101,B01,193354,McDonnell; Lisa Marie,0,3,24,24
1683351693791,BIMM 101,B02,193357,McDonnell; Lisa Marie,0,3,24,24
1683351694815,BIMM 110,A01,193377,Tat; John,0,11,32,32
1683351694815,BIMM 110,A02,193378,Tat; John,0,8,32,32
1683351695839,BIMM 120,A01,206116,Staff,0,0,32,32
1683351695839,BIMM 120,A02,206117,Staff,8,0,32,24
1683351695839,BIMM 120,A03,206121,Staff,21,0,32,11
1683351696863,BIPN 100,A01,193393,Park; Ji Young,0,14,32,32
1683351696863,BIPN 100,A02,193402,Park; Ji Young,0,13,32,32
1683351696863,BIPN 100,A03,193413,Park; Ji Young,0,14,32,32
1683351696863,BIPN 100,A04,193414,Park; Ji Young,0,13,32,32
1683351697888,BIPN 102,A01,193429,Staff,0,0,32,32
1683351697888,BIPN 102,A02,193438,Staff,22,0,32,10
1683351698916,BIPN 106,A01,193450,Reyes Gonzalez; Catalina,0,2,40,40
1683351699945,BIPN 134,A01,193465,Cooke; James Edward,0,0,32,32
1683351699945,BIPN 134,A02,193474,Cooke; James Edward,25,0,32,7
1683351699945,BIPN 134,A03,193485,Cooke; James Edward,29,0,32,3
1683351699945,BIPN 134,A04,193486,Cooke; James Edward,21,0,32,11
1683351699945,BIPN 134,A05,193491,Cooke; James Edward,31,0,32,1
1683351699945,BIPN 134,A06,193501,Cooke; James Edward,30,0,32,2
1683351699945,BIPN 134,A07,193510,Cooke; James Edward,29,0,32,3
1683351701996,BISP 194,A00,222522,Staff,14,0,32,18
1683351703022,CAT 124,A01,202407,Staff,20,0,25,5
1683351704050,CAT 125,A00,202408,Marchisotto; Jennifer Anne,4,0,20,16
1683351705075,CAT 125R,A00,202409,Smith; Lauryn Alissa,0,11,20,20
1683351705075,CAT 125R,B00,202410,Morales; Celeste Georgianna,0,11,20,20
1683351705075,CAT 125R,C00,202411,Irwin; Matthew Joseph,0,10,20,20
1683351706103,CENG 15,A01,204712,Yang; Kesong,0,1,0,0
1683351707132,CENG 114,A00,202070,Jahed Motlagh; Zeinab,5,0,20,15
1683351708159,CGS 105,A00,185477,Wesling; Megan E.,24,0,40,16
1683351709185,CGS 106,A00,185494,Staff,13,0,22,9
1683351710213,CGS 108,A00,185495,Staff,14,0,20,6
1683351711237,CGS 114,A00,185496,Staff,13,0,18,5
1683351712260,CGS 119,A00,185501,Staff,15,0,20,5
1683351713284,CGS 120,A00,185511,Staff,13,0,20,7
1683351714309,CHEM 4,A01,184675,Bussey; Thomas J,96,0,100,4
1683351715335,CHEM 6A,A01,184677,Staff,34,0,60,26
1683351716359,CHEM 6B,A01,184679,Staff,65,0,100,35
1683351717387,CHEM 6C,A01,184681,Bussey; Thomas J,1,0,50,49
1683351717387,CHEM 6C,A02,184682,Bussey; Thomas J,34,0,50,16
1683351718418,CHEM 40A,A01,184684,Albizati; Kim F.,37,0,100,63
1683351719446,CHEM 40B,A01,184686,Albizati; Kim F.,0,20,100,100
1683351720469,CHEM 41B,A01,184690,Staff,52,0,100,48
1683351721492,COGS 3,A01,184715,Boyle; Mary E. T.,0,25,40,40
1683351722518,COGS 14B,A01,185172,Staff,0,15,38,38
1683351723543,COGS 18,A01,184736,Staff,17,0,80,63
1683351724624,COGS 100,A01,184932,Staff,0,5,73,73
1683351725649,COGS 101A,A01,184935,Staff,0,39,30,30
1683351726675,COGS 101B,A01,184944,Staff,0,2,30,30
1683351727702,COGS 101C,A01,184946,Staff,0,12,30,30
1683351728725,COGS 102A,A01,184951,Johnson; Christine M.,2,0,40,38
1683351729752,COGS 107B,A01,184953,Mooshagian; Eric Frederick,0,50,40,40
1683351730779,COGS 118B,A01,184959,Gupta; Anjum,0,48,40,40
1683351731803,COGS 153,A00,184961,Staff,0,15,30,30
1683351732827,COGS 177,A00,184962,Staff,0,20,30,30
1683351733854,COGS 187A,A01,184969,Boyle; Mary E. T.,0,17,40,40
1683351734881,COMM 10,A01,185174,Staff,0,5,25,25
1683351734881,COMM 10,A02,185189,Staff,0,5,25,25
1683351734881,COMM 10,A03,269821,Staff,0,0,0,0
1683351735908,COMM 100B,A01,185475,Staff,0,0,0,2
1683351735908,COMM 100B,A02,185476,Staff,13,0,25,12
1683351736935,COMM 100C,A01,185314,Staff,1,0,25,24
1683351736935,COMM 100C,A02,185327,Staff,19,0,25,6
1683351737962,COMM 110M,A00,185349,Staff,2,0,40,38
1683351738985,COMM 113T,A00,185352,Staff,24,0,40,16
1683351740009,COMM 114I,A00,185353,Staff,33,0,40,7
1683351741038,COMM 131,A00,185354,Staff,19,0,30,11
1683351742060,CSE 8A,A50,185358,Cao; Yingjun,0,46,10,10
1683351743083,CSE 8B,A01,185362,Staff,0,46,50,50
1683351744110,CSE 11,A01,185416,Cao; Yingjun,0,92,10,10
1683351745134,CSE 20,A01,185445,Briones; Jor-el Thomas Caparas,5,0,25,20
1683351746161,CSE 21,A01,185447,Staff,10,0,50,40
1683351747188,CSE 101,A01,185451,Staff,0,13,50,50
1683351747188,CSE 101,B01,185453,Jones; Miles E,0,11,50,50
1683351749238,CSE 141,A01,185458,Eldon; John,20,0,100,80
1683351750262,CSE 141L,A01,185461,Eldon; John,12,0,100,88
1683351751286,CSE 142,A01,185463,Staff,36,0,60,24
1683351751286,CSE 142,B01,201355,Staff,0,7,60,60
1683351752311,CSE 142L,A01,185470,Staff,36,0,60,24
1683351752311,CSE 142L,B01,201417,Staff,0,6,60,60
1683351753334,CSE 190,A00,201433,Staff,32,0,49,17
1683351754362,DOC 1,A01,259136,Strom; Megan C.,7,0,15,8
1683351754362,DOC 1,A02,259137,Strom; Megan C.,14,0,15,1
1683351754362,DOC 1,A03,259138,Strom; Megan C.,14,0,15,1
1683351754362,DOC 1,A04,259139,Strom; Megan C.,14,0,15,1
1683351755385,DOC 100D,A00,259140,Pass; Natalye Joann,16,0,25,9
1683351756409,DSGN 1,A01,184749,Rill; Bryan,0,25,30,30
1683351757434,DSGN 100,A01,185168,Staff,0,2,25,25
1683351758458,ECE 5,A01,185626,Morris; Karcher William,0,10,0,0
1683351759483,ECE 101,A01,185628,Staff,17,0,70,53
1683351760507,ECE 107,A01,185635,Baghdadchi; Saharnaz,0,0,20,20
1683351760507,ECE 107,A02,185638,Baghdadchi; Saharnaz,4,0,20,16
1683351761531,ECE 148,A01,185647,Silberman; Jack,0,0,16,16
1683351762555,ECON 1,A01,185537,Crane; Meredith Helen,54,0,70,16
1683351763579,ECON 3,A01,185549,Crane; Meredith Helen,32,0,70,38
1683351764605,ECON 4,A01,203354,Anderson; John Charles,0,4,10,10
1683351765630,ECON 100A,A01,185574,Staff,0,4,40,40
1683351766654,ECON 100B,A01,185576,Staff,0,12,50,50
1683351767677,ECON 100C,A01,185589,Newhouse; Herbert S,29,0,70,41
1683351768703,ECON 105,A00,185608,Vespa; Emanuel Ignacio,19,0,35,16
1683351769726,ECON 109,A01,185610,Shishkin; Denis,10,0,35,25
1683351770750,ECON 110A,A01,185612,Staff,11,0,40,29
1683351771774,ECON 120A,A01,185615,Staff,20,0,40,20
1683351772797,ECON 120C,A01,185617,Sun; Yixiao,0,21,70,70
1683351773821,ECON 144,A00,203346,Squires; Dale E,3,0,35,32
1683351774846,ECON 171,A01,203349,Newhouse; Herbert S,0,1,35,35
1683351775873,ECON 173A,A01,185621,Toda; Alexis Akira,21,0,35,14
1683351776898,EDS 25,A01,202413,Staff,0,1,0,0
1683351776898,EDS 25,A02,202414,Staff,0,1,0,0
1683351776898,EDS 25,A03,202415,Staff,0,0,0,0
1683351776898,EDS 25,A04,202416,Staff,0,1,0,0
1683351776898,EDS 25,A05,202439,Staff,0,0,0,0
1683351776898,EDS 25,A06,202440,Staff,0,0,0,0
1683351776898,EDS 25,B01,202631,Staff,0,0,0,0
1683351776898,EDS 25,B02,202632,Staff,0,0,0,0
1683351776898,EDS 25,B03,202639,Staff,0,0,0,0
1683351776898,EDS 25,B04,202640,Staff,0,0,0,0
1683351776898,EDS 25,B05,202643,Staff,0,0,0,0
1683351776898,EDS 25,B06,202644,Staff,0,0,0,0
1683351777922,EDS 38,A01,202659,Black; Alison Michelle,24,0,25,1
1683351778947,EDS 115,A00,202652,Staff,18,0,30,12
1683351779974,EDS 125,A00,202649,Staff,14,0,30,16
1683351780999,EDS 126,A01,203332,Staff,30,0,30,0
1683351782022,EDS 139,A00,202838,Staff,16,0,25,9
1683351783046,EDS 146,A01,202655,Staff,14,0,25,11
1683351784074,ENG 15,A00,185667,Staff,0,1,0,0
1683351784074,ENG 15,B00,185672,Staff,0,0,0,0
1683351784074,ENG 15,C00,185675,Staff,0,0,0,0
1683351784074,ENG 15,D00,185682,Staff,0,0,0,0
1683351784074,ENG 15,E00,185684,Staff,0,0,0,0
1683351785101,ETHN 103,A00,185710,Staff,0,4,35,35
1683351786127,ETHN 103A,A00,199228,Man; Simeon S,2,0,9,7
1683351787151,ETHN 109,A00,185711,Staff,18,0,35,17
1683351788178,ETHN 142,A00,185726,Staff,0,4,30,30
1683351789204,ETHN 163J,A00,199229,Man; Simeon S,5,0,8,3
1683351790227,ETHN 168,A00,185727,Staff,8,0,10,2
1683351791253,ETHN 182,A00,185728,Staff,0,0,35,35
1683351792279,ETHN 183,A00,185737,Staff,8,0,18,10
1683351793303,GLBH 111,A01,209361,Burgos; Jose L.,0,0,0,0
1683351795352,HIEU 104,A00,185792,Staff,16,0,20,4
1683351796384,HIEU 115,A00,185800,Staff,1,0,20,19
1683351797411,HIEU 128,A00,185801,Staff,0,7,20,20
1683351798435,HIEU 147,A00,185802,Staff,16,0,20,4
1683351799462,HIEU 154,A00,185823,Staff,12,0,20,8
1683351800489,HILA 102,A00,185826,Staff,13,0,20,7
1683351801513,HILD 2C,A01,185778,Staff,0,12,20,20
1683351802537,HILD 7B,A01,185780,Kwak; Nancy,0,15,32,32
1683351802537,HILD 7B,A02,185781,Kwak; Nancy,0,18,32,32
1683351803561,HILD 30,A01,185791,Staff,14,0,20,6
1683351804586,HISC 119,A00,185830,Golan; Tal,0,9,20,20
1683351805609,HITO 156GS,A00,185831,Patterson; Patrick H.,0,0,0,23
1683351806633,HIUS 103,A00,185832,Man; Simeon S,0,6,20,20
1683351807657,HIUS 117,A00,185836,Kwak; Nancy,2,0,20,18
1683351808680,HIUS 125,A00,185840,Man; Simeon S,0,0,23,23
1683351809704,HIUS 149,A00,185845,Staff,0,0,20,20
1683351810727,HUM 3,A01,185882,Zavodny; Tatiana Sophia,0,7,50,50
1683351810727,HUM 3,B01,185899,Caldwell; Michael Alan,0,18,50,50
1683351811754,HUM 3GS,A00,185900,Patterson; Patrick H.,0,0,0,23
1683351812779,HUM 4,A01,185938,Zroka; Amy Liane,31,0,50,19
1683351812779,HUM 4,B01,185956,Watkins; Eric,0,3,50,50
1683351812779,HUM 4,B02,202209,Watkins; Eric,0,2,50,50
1683351812779,HUM 4,B03,202210,Watkins; Eric,0,2,50,50
1683351813803,HUM 5,A01,185958,West; Geoffrey Scott,3,0,50,47
1683351813803,HUM 5,A02,202215,West; Geoffrey Scott,0,0,50,50
1683351814829,INTL 190,A00,185959,Gagnon; Jeffrey C,0,0,0,9
1683351814829,INTL 190,B00,185960,Lettieri; Michael Joseph,0,0,0,1
1683351815854,JAPN 180,A00,254509,Staff,4,0,30,26
1683351816879,LATI 10,A01,202853,Kennemore; Amy Michelle,4,0,35,31
1683351816879,LATI 10,A02,202854,Kennemore; Amy Michelle,2,0,35,33
1683351816879,LATI 10,A03,270054,Kennemore; Amy Michelle,30,0,30,0
1683351817904,LATI 180,A00,202855,Kennemore; Amy Michelle,11,0,20,9
1683351818928,LAWS 101,A00,201767,Golan; Tal,0,7,40,40
1683351819952,LIFR 1C,A00,185961,Staff,6,0,20,14
1683351820976,LIFR 1CX,A00,185962,Staff,7,0,20,13
1683351822000,LIFR 1D,A00,185963,Staff,9,0,20,11
1683351823027,LIFR 1DX,A00,185964,Staff,9,0,20,11
1683351824051,LIGN 101,A01,186039,Staff,43,0,50,7
1683351825075,LIGN 165,A00,186040,Staff,18,0,50,32
1683351826098,LTCS 108,A00,186041,Staff,6,0,10,4
1683351827122,LTCS 119,A00,186042,Staff,16,0,20,4
1683351828204,LTCS 130,A00,186043,Wesling; Megan E.,15,0,25,10
1683351830252,LTEA 138,A00,186119,Staff,14,0,40,26
1683351831274,LTEN 124,A00,186148,Staff,6,0,25,19
1683351832299,LTEN 178,A00,186149,Staff,7,0,15,8
1683351833323,LTEN 181,A00,186150,Blanco; John D,33,0,40,7
1683351834347,LTWL 120,A00,186160,Staff,20,0,25,5
1683351835374,LTWL 165,A00,186161,Staff,22,0,25,3
1683351836397,LTWR 100,A00,186162,Staff,0,5,15,15
1683351837421,LTWR 102,A00,186163,Doller; Ben,5,0,15,10
1683351838444,MAE 8,A01,186412,Staff,0,0,0,0
1683351839469,MAE 30B,A00,186445,Bahadori; Mohammad Yousef,83,0,100,17
1683351840497,MAE 40,A00,186592,Bewley; Thomas R,9,0,50,41
1683351841523,MAE 101B,A00,186593,Bahadori; Mohammad Yousef,81,0,100,19
1683351842555,MAE 105,A00,186594,Bandaru; Prabhakar,12,0,50,38
1683351843582,MAE 107,A00,186599,Pham; Hieu Tan,0,6,120,120
1683351844606,MAE 148,A01,186660,Silberman; Jack,3,0,16,13
1683351845631,MATH 10A,A01,188095,Staff,0,5,35,35
1683351846657,MATH 10B,A01,188097,Bowers; Adam R.,0,11,30,30
1683351846657,MATH 10B,A02,188099,Bowers; Adam R.,0,11,30,30
1683351846657,MATH 10B,B01,188104,Bowers; Adam R.,0,10,30,30
1683351846657,MATH 10B,B02,188106,Bowers; Adam R.,0,10,30,30
1683351847687,MATH 10C,A01,188111,Staff,0,18,30,30
1683351847687,MATH 10C,A02,188127,Staff,0,17,30,30
1683351847687,MATH 10C,A03,188131,Staff,0,18,30,30
1683351847687,MATH 10C,B01,188218,Staff,18,0,30,12
1683351847687,MATH 10C,B02,188244,Staff,13,0,30,17
1683351847687,MATH 10C,B03,188277,Staff,16,0,30,14
1683351848711,MATH 18,A01,188344,Bach; Quang Tran,18,0,30,12
1683351848711,MATH 18,A02,188345,Bach; Quang Tran,11,0,30,19
1683351848711,MATH 18,B01,188353,Bach; Quang Tran,10,0,30,20
1683351848711,MATH 18,B02,188354,Bach; Quang Tran,20,0,30,10
1683351849735,MATH 20A,A01,188374,Staff,12,0,35,23
1683351850764,MATH 20B,A01,188382,Ohm; Ko Woon,6,0,30,24
1683351850764,MATH 20B,A02,188383,Ohm; Ko Woon,22,0,30,8
1683351850764,MATH 20B,B01,188385,Ohm; Ko Woon,7,0,30,23
1683351850764,MATH 20B,B02,188392,Ohm; Ko Woon,22,0,30,8
1683351851789,MATH 20C,A01,188394,Harel; Guershon,10,0,30,20
1683351851789,MATH 20C,A02,188395,Harel; Guershon,15,0,30,15
1683351851789,MATH 20C,B01,188404,Harel; Guershon,4,0,30,26
1683351851789,MATH 20C,B02,188405,Harel; Guershon,19,0,30,11
1683351852818,MATH 20D,A01,188414,Hammock; Frances H,0,1,30,30
1683351852818,MATH 20D,A02,188415,Hammock; Frances H,3,0,30,27
1683351852818,MATH 20D,B01,188447,Hammock; Frances H,1,0,30,29
1683351852818,MATH 20D,B02,188486,Hammock; Frances H,8,0,30,22
1683351853846,MATH 20E,A01,188649,Staff,21,0,30,9
1683351853846,MATH 20E,A02,188650,Staff,23,0,30,7
1683351853846,MATH 20E,A03,188673,Staff,0,0,30,30
1683351854870,MATH 102,A01,188675,Staff,0,35,35,35
1683351855894,MATH 103B,A01,188681,Staff,3,0,35,32
1683351855894,MATH 103B,B01,188692,Staff,5,0,35,30
1683351856918,MATH 109,A01,188695,Salehi Golsefidy; Alireza,25,0,35,10
1683351856918,MATH 109,A02,188696,Salehi Golsefidy; Alireza,25,0,35,10
1683351857947,MATH 120A,A01,188698,Eggers; John Dietrich,7,0,35,28
1683351858971,MATH 142B,A01,188736,Ioana; Adrian,0,2,30,30
1683351858971,MATH 142B,A02,188741,Ioana; Adrian,0,0,30,30
1683351858971,MATH 142B,A03,188743,Ioana; Adrian,0,1,30,30
1683351859995,MATH 168A,A01,188790,Staff,0,9,35,35
1683351861023,MATH 170A,A01,188803,Nie; Jiawang,0,2,35,35
1683351861023,MATH 170A,A02,188811,Nie; Jiawang,0,0,35,35
1683351861023,MATH 170A,A03,188814,Nie; Jiawang,1,0,35,34
1683351861023,MATH 170A,A04,188815,Nie; Jiawang,13,0,35,22
1683351862050,MATH 193B,A01,188817,Staff,0,0,35,35
1683351862050,MATH 193B,A02,188818,Staff,5,0,35,30
1683351863077,MGT 4,A01,202857,Anderson; John Charles,62,0,80,18
1683351864103,MGT 12,A00,202858,Lindenberger; Wade Douglas,42,0,90,48
1683351865128,MGT 18,A00,202859,Staff,74,0,90,16
1683351866153,MGT 18GS,A00,202860,McKay; Michael J,13,0,28,15
1683351867176,MGT 45,A00,202861,Pecore; Joseph P.,14,0,90,76
1683351868199,MGT 100,A00,202863,Yavorsky; Daniel Ryan,28,0,90,62
1683351869222,MGT 103,A00,202864,Ehrich; Kristine R,0,17,90,90
1683351870247,MGT 112,A00,202865,Ehrich; Kristine R,15,0,90,75
1683351871271,MGT 121A,A00,202868,Staff,0,20,0,0
1683351872299,MGT 131B,A00,202869,Anderson; John Charles,59,0,90,31
1683351873325,MGT 136,A00,202871,Lindenberger; Wade Douglas,84,0,90,6
1683351874350,MGT 164,A00,202873,Staff,0,68,90,91
1683351875374,MGT 164GS,A00,202874,McKay; Mary A,13,0,28,15
1683351876398,MGT 180,A00,202875,Staff,0,50,90,91
1683351877421,MMW 11R,A01,205019,Herbst; Matthew,3,0,30,27
1683351877421,MMW 11R,A02,205026,Herbst; Matthew,29,0,30,1
1683351878447,MMW 15,A01,193512,Chang; Edmond Yi-Teh,0,9,28,28
1683351878447,MMW 15,A02,193513,Chang; Edmond Yi-Teh,0,5,28,28
1683351878447,MMW 15,A03,193514,Chang; Edmond Yi-Teh,0,5,28,28
1683351878447,MMW 15,A04,193515,Chang; Edmond Yi-Teh,0,5,28,28
1683351878447,MMW 15,A05,193516,Chang; Edmond Yi-Teh,0,4,28,28
1683351878447,MMW 15,A06,193517,Chang; Edmond Yi-Teh,0,5,28,28
1683351878447,MMW 15,B01,193519,Chang; Edmond Yi-Teh,0,5,28,28
1683351878447,MMW 15,B02,193520,Chang; Edmond Yi-Teh,0,5,28,28
1683351878447,MMW 15,B03,193521,Chang; Edmond Yi-Teh,0,5,28,28
1683351878447,MMW 15,B04,193522,Chang; Edmond Yi-Teh,0,4,28,28
1683351878447,MMW 15,B05,193523,Chang; Edmond Yi-Teh,0,5,28,28
1683351878447,MMW 15,B06,193524,Chang; Edmond Yi-Teh,0,4,28,28
1683351879471,MMW 122,A01,193526,Rahimi; Babak,0,15,28,28
1683351879471,MMW 122,A02,193527,Rahimi; Babak,0,14,28,28
1683351879471,MMW 122,A03,193528,Rahimi; Babak,0,0,0,0
1683351879471,MMW 122,A04,193529,Rahimi; Babak,0,0,0,0
1683351880500,MUS 1A,A01,186663,Staff,0,20,35,35
1683351881524,MUS 4,A01,186715,Staff,0,12,35,35
1683351882549,MUS 5R,A01,186796,Dubnov; Shlomo,0,17,35,35
1683351883577,MUS 6,A01,186798,Staff,0,4,25,25
1683351884603,MUS 7,A01,186830,Staff,13,0,35,22
1683351885630,MUS 8,A01,186930,Staff,0,26,35,35
1683351886658,MUS 15,A01,186932,Staff,0,16,35,35
1683351886658,MUS 15,B01,186934,Staff,0,15,35,35
1683351887682,MUS 80,A00,186935,Staff,1,0,20,19
1683351887682,MUS 80,B00,186936,Staff,25,0,25,0
1683351888709,NANO 11,A00,204702,Lipomi; Darren John,0,0,0,0
1683351889738,NANO 15,A01,204709,Yang; Kesong,0,1,0,0
1683351890766,NANO 114,A00,202069,Jahed Motlagh; Zeinab,3,0,10,7
1683351891792,PHIL 1,A00,186955,Grush; Rick Scott,32,0,40,8
1683351892816,PHIL 10,A01,186973,Grush; Rick Scott,28,0,35,7
1683351892816,PHIL 10,A02,186974,Grush; Rick Scott,33,0,35,2
1683351893844,PHIL 13,A01,186976,Staff,7,0,35,28
1683351893844,PHIL 13,A02,186977,Staff,16,0,35,19
1683351894868,PHIL 14,A01,186979,Staff,31,0,35,4
1683351894868,PHIL 14,A02,186986,Staff,32,0,35,3
1683351895892,PHIL 28,A01,186988,Staff,16,0,30,14
1683351895892,PHIL 28,A02,186989,Staff,1,0,30,29
1683351895892,PHIL 28,A03,186990,Staff,9,0,30,21
1683351895892,PHIL 28,A04,186991,Staff,26,0,30,4
1683351896915,PHIL 120,A00,186997,Staff,23,0,40,17
1683351897943,PHIL 137,A00,187003,Staff,9,0,40,31
1683351898968,PHIL 150,A00,187015,Staff,47,0,70,23
1683351899992,PHIL 167,A00,187021,Lamey; Andy M.,35,0,40,5
1683351901016,PHIL 174,A01,202226,Staff,17,0,20,3
1683351901016,PHIL 174,A02,202235,Staff,20,0,20,0
1683351902040,PHIL 191A,A00,258918,Staff,0,0,1,1
1683351903066,PHYS 1A,A00,187028,Staff,27,0,60,33
1683351904088,PHYS 1AL,001,187036,Staff,2,0,30,28
1683351904088,PHYS 1AL,002,187049,Staff,18,0,30,12
1683351905115,PHYS 1B,A00,187058,Staff,22,0,60,38
1683351906141,PHYS 1BL,001,187064,Staff,0,0,30,30
1683351906141,PHYS 1BL,002,187070,Staff,5,0,30,25
1683351907164,PHYS 1C,A00,187082,Staff,31,0,120,89
1683351908189,PHYS 1CL,001,187088,Staff,0,9,30,30
1683351908189,PHYS 1CL,002,187089,Staff,0,2,30,30
1683351908189,PHYS 1CL,009,262693,Staff,11,0,30,19
1683351909215,PHYS 2B,A01,187097,Staff,54,0,115,61
1683351910242,PHYS 2C,A01,187099,Staff,67,0,115,48
1683351911270,PHYS 2CL,A01,187101,Staff,5,0,28,23
1683351911270,PHYS 2CL,A02,187102,Staff,15,0,28,13
1683351912298,PHYS 2D,A01,187123,Shotwell; Brian,95,0,115,20
1683351913322,PHYS 4B,A01,187133,Grinstein; Benjamin,35,0,50,15
1683351914350,POLI 10,A00,188819,Staff,0,4,50,50
1683351915373,POLI 11,A00,188827,Staff,43,0,50,7
1683351916395,POLI 13R,A00,188828,Staff,0,1,20,20
1683351917420,POLI 27,A01,188830,Elgin; Samuel Zincke,0,1,70,70
1683351918442,POLI 30,A00,188832,Desposato; Scott,31,0,50,19
1683351919466,POLI 102F,A00,188834,Staff,3,0,40,37
1683351920492,POLI 104A,A00,188852,Staff,14,0,30,16
1683351921515,POLI 104I,A00,188853,Staff,0,6,20,20
1683351922543,POLI 110B,A00,188854,Wiens; David,7,0,20,13
1683351923568,POLI 112A,A00,188855,Wiens; David,5,0,30,25
1683351924593,POLI 117R,A00,188856,Forman; Fonna,0,11,20,20
1683351925748,POLI 118,A00,188857,Ingham; Sean,8,0,20,12
1683351926775,POLI 120G,A00,188858,Staff,9,0,30,21
1683351927802,POLI 131CR,A00,188863,Hoston; Germaine,24,0,50,26
1683351928830,POLI 133,A00,188864,Nellis; Gareth Hb,44,0,50,6
1683351929854,POLI 134D,A00,188865,Desposato; Scott,27,0,30,3
1683351930880,POLI 142A,A00,188871,Gartzke; Erik,22,0,50,28
1683351931964,POLI 142K,A00,188874,Staff,38,0,50,12
1683351932988,POLI 143,A00,188940,Gartzke; Erik,16,0,30,14
1683351934014,POLI 153,A00,188943,Staff,3,0,20,17
1683351935037,POLI 160AA,A00,188944,Staff,11,0,40,29
1683351936061,POLI 170A,A00,188945,Staff,11,0,30,19
1683351938112,PSYC 1,A00,188952,Staff,37,0,90,53
1683351939138,PSYC 2,B00,188953,Staff,19,0,35,16
1683351940165,PSYC 6,A00,188970,Staff,47,0,60,13
1683351941192,PSYC 7,A00,188973,Staff,37,0,45,8
1683351942217,PSYC 60,A01,188980,Rickard; Timothy C.,43,0,60,17
1683351943240,PSYC 70,A01,189001,Steiner; Eric Tomas,23,0,45,22
1683351944267,PSYC 100,A00,189005,Lacefield; Katharine I,0,98,120,120
1683351945290,PSYC 102,A00,189008,Staff,9,0,30,21
1683351946314,PSYC 106,B00,189026,Gorman; Michael R.,34,0,60,26
1683351947338,PSYC 114,B01,189033,Winkielman; Piotr,0,32,30,30
1683351948362,PSYC 131,A00,189036,Anagnostaras; Stephan,0,43,60,60
1683351949388,PSYC 136,A00,189041,Lowe; Angela Beth,0,7,25,25
1683351950416,PSYC 137,A00,189057,Winkielman; Piotr,0,34,25,25
1683351951443,PSYC 144,A00,189107,Wixted; John T,0,7,50,50
1683351953491,PSYC 162,A00,189142,Staff,0,8,85,85
1683351954514,PSYC 172,A00,189144,Gorman; Michael R.,0,7,30,30
1683351956564,PSYC 179,A00,189146,Lacefield; Katharine I,0,84,120,120
1683351957591,PSYC 181,A00,189147,Anagnostaras; Stephan,0,44,90,90
1683351958618,PSYC 190R,A00,189148,Barner; David A.,0,22,80,80
1683351959642,PSYC 191,A00,189275,Rickard; Timothy C.,0,7,25,25
1683351960667,PSYC 193,A00,189276,Chapman; Eddie Nathaniel,0,1,0,4
1683351961692,PSYC 193L,A01,189281,Lowe; Angela Beth,12,0,20,8
1683351961692,PSYC 193L,B01,189285,Staff,28,0,35,7
1683351962718,RELI 149,A00,187137,Rahimi; Babak,7,0,40,33
1683351963741,SE 9,A01,187315,Staff,0,2,18,18
1683351964764,SE 101B,A00,187409,Staff,24,0,30,6
1683351965788,SE 110B,A00,187444,Staff,10,0,40,30
1683351966813,SE 130B,A00,187449,Staff,31,0,40,9
1683351967841,SE 150A,A00,187516,Staff,9,0,20,11
1683351968865,SE 154,A00,187528,Staff,30,0,50,20
1683351969889,SIO 3,A01,258171,Staff,35,0,40,5
1683351970915,SIO 10,A00,187144,Cook; Geoffrey W,0,3,75,75
1683351971942,SIO 45,A00,187152,Cook; Geoffrey W,1,0,100,99
1683351972968,SIO 109R,A00,194486,Staff,0,3,20,20
1683351975016,SIO 187,A01,187233,Kacev; David,12,0,40,28
1683351976046,SOCI 1,A01,258656,Thorpe; Charles Robert,28,0,30,2
1683351976046,SOCI 1,A02,258658,Thorpe; Charles Robert,30,0,30,0
1683351976046,SOCI 1,A03,258661,Thorpe; Charles Robert,25,0,25,0
1683351976046,SOCI 1,A04,258666,Thorpe; Charles Robert,22,0,25,3
1683351976046,SOCI 1,A05,258897,Thorpe; Charles Robert,23,0,25,2
1683351976046,SOCI 1,A06,258898,Thorpe; Charles Robert,25,0,25,0
1683351977075,SOCI 30,A01,258903,Pardo Guerra; Juan Pablo,15,0,30,15
1683351978102,SOCI 102,A00,258904,Staff,9,0,25,16
1683351979126,SOCI 106,A00,258905,Staff,19,0,25,6
1683351980151,SOCI 111,A00,258907,Ribas Norris; Janet Vanesa,26,0,30,4
1683351981179,SOCI 121R,A00,258908,Pardo Guerra; Juan Pablo,10,0,30,20
1683351982203,SOCI 126,A01,203330,Staff,14,0,20,6
1683351983227,SOCI 131,A00,258909,Thorpe; Charles Robert,31,0,60,29
1683351984251,SOCI 135,A00,258910,Payne; Christine Anna,0,9,30,30
1683351985276,SOCI 157,A00,258911,Staff,12,0,30,18
1683351986300,SOCI 184,A00,258912,Staff,25,0,30,5
1683351987327,SOCI 188D,A00,258913,Staff,22,0,30,8
1683351988351,SYN 2,001,187529,Staff,10,0,16,6
1683351988351,SYN 2,002,201452,Staff,0,18,16,16
1683351988351,SYN 2,003,201469,Staff,3,0,16,13
1683351989379,SYN 100,A01,187531,Staff,0,9,20,20
1683351989379,SYN 100,B01,201491,Staff,0,12,20,20
1683351990406,TDAC 1,A00,189286,Walsh; Kim C.,3,0,20,17
1683351990406,TDAC 1,B00,189287,Harting; Carla Kelso,11,0,20,9
1683351991430,TDAC 101,A00,189300,Walsh; Kim C.,16,0,20,4
1683351991430,TDAC 101,B00,189301,Harting; Carla Kelso,18,0,20,2
1683351992454,TDAC 102,A00,189304,Basso; Beatrice,14,0,20,6
1683351993480,TDAC 108,A00,189305,Staff,18,0,20,2
1683351994511,TDDE 131,A00,189310,Staff,19,0,20,1
1683351994511,TDDE 131,B00,189314,Staff,19,0,20,1
1683351994511,TDDE 131,C00,189315,Staff,48,0,50,2
1683351994511,TDDE 131,D00,189316,Staff,14,0,15,1
1683351994511,TDDE 131,E00,204841,Staff,20,0,20,0
1683351995540,TDGE 10,A00,189289,Staff,30,0,50,20
1683351995540,TDGE 10,B00,189290,Havis; Allan,1,0,50,49
1683351996565,TDGE 11,A00,189291,Fulton; Julia,0,3,50,50
1683351996565,TDGE 11,B00,189292,Staff,20,0,25,5
1683351996565,TDGE 11,C00,260270,Staff,0,0,0,0
1683351997593,TDGE 25,A00,189294,Staff,3,0,20,17
1683351998617,TDGE 124,A00,189318,Fulton; Julia,0,8,50,50
1683351999644,TDGE 125,A00,189319,Staff,13,0,25,12
1683351999644,TDGE 125,B00,189320,Staff,23,0,25,2
1683352000670,TDGE 127,A00,189322,Havis; Allan,0,0,50,50
1683352001698,TDHT 101,A00,189323,Staff,18,0,25,7
1683352001698,TDHT 101,B00,189324,Staff,25,0,25,0
1683352002725,TDHT 102,A00,189325,Staff,49,0,50,1
1683352003749,TDMV 1,A00,189295,Arcidiacono; Kristin,19,0,30,11
1683352003749,TDMV 1,B00,189296,Caligagan; Maria T.,24,0,30,6
1683352004773,TDMV 2,A00,189297,Sammartano; Tonnie,28,0,30,2
1683352004773,TDMV 2,B00,189299,Arcidiacono; Kristin,24,0,30,6
1683352005802,TDMV 3,A00,204998,Rincon; Alicia,22,0,30,8
1683352006825,TDMV 120,A00,189458,Sammartano; Tonnie,28,0,30,2
1683352007848,TDMV 138,A00,189541,Jun; Grace Shin Hae,22,0,40,18
1683352008871,TDMV 142,A00,189717,Caligagan; Tony,23,0,30,7
1683352008871,TDMV 142,B00,189718,Caligagan; Maria T.,25,0,30,5
1683352009895,TMC 2,A01,187533,Staff,25,0,25,0
1683352009895,TMC 2,A02,187534,Staff,25,0,25,0
1683352010923,USP 1,A01,187536,Kwak; Nancy,0,16,25,25
1683352011949,USP 5,A01,187538,Staff,10,0,25,15
1683352012974,USP 101,A00,199253,Staff,0,4,0,0
1683352014001,USP 124,A00,187562,Boomhower; Matthew Charles,1,0,30,29
1683352015029,USP 138,A00,187582,Staff,20,0,25,5
1683352016057,USP 152,A01,187597,Staff,4,0,25,21
1683352017081,USP 153,A00,187598,Staff,19,0,25,6
1683352018104,USP 168,A00,187607,Kwak; Nancy,2,0,5,3
1683352019128,USP 173,A00,187619,Staff,4,0,25,21
1683352020155,USP 181,A00,187638,Staff,0,2,25,25
1683352021182,VIS 103,A00,187650,Cruz; Edwin Teddy,22,0,75,53
1683352022210,VIS 110D,A00,187669,Staff,12,0,22,10
1683352023233,VIS 127C,A00,187720,Shen; Kuiyi,67,0,146,79
1683352024256,VIS 149,A00,187731,Yoldas; Pinar,0,14,22,22
1683352025281,VIS 151,A01,188091,Staff,22,0,34,12
1683352025281,VIS 151,A02,188092,Staff,11,0,34,23
1683352026305,VIS 160B,A00,188093,Stalbaum; Brett,0,0,10,10
1683352028354,WCWP 10B,A00,201720,Staff,10,0,15,5
1683352028354,WCWP 10B,B00,201722,Staff,9,0,15,6
1683352029381,WCWP 100,A00,201725,Gagnon; Jeffrey C,0,0,2,2
1683352029381,WCWP 100,B00,201727,Staff,0,4,15,15
1683352032513,ANBI 133,A00,258401,Wilder; Linnea Lorene,34,0,40,6
1683352033537,ANBI 140,A00,258395,Hrvoj Mihic; Branka,18,0,25,7
1683352034562,ANSC 120,A00,258402,Bialecki; Jon Anthony,27,0,40,13
1683352035641,ANSC 144,A00,258400,Staff,14,0,40,26
1683352037690,ANSC 166,A00,258396,Parish; Steven Martin,157,0,175,18
1683352038718,ANSC 180,A00,193533,Staff,9,0,20,11
1683352039743,ANSC 188,A00,258397,Jassal; Aftab,33,0,40,7
1683352040770,ANTH 3,A01,258316,Staff,23,0,30,7
1683352041793,ANTH 5,A00,258394,Semendeferi; Ekaterini,16,0,20,4
1683352042818,ANTH 21,A01,258331,Staff,8,0,40,32
1683352043843,ANTH 103,A00,258398,Varma; Saiba,15,0,25,10
1683352044870,AWP 10,001,202034,Staff,0,0,0,0
1683352044870,AWP 10,002,202035,Staff,0,0,0,0
1683352044870,AWP 10,003,202036,Staff,0,0,0,0
1683352044870,AWP 10,004,202037,Staff,0,0,0,0
1683352044870,AWP 10,005,202038,Staff,0,0,0,0
1683352044870,AWP 10,006,202039,Staff,0,0,0,0
1683352044870,AWP 10,007,202040,Staff,0,0,0,0
1683352044870,AWP 10,008,202041,Staff,0,0,0,0
1683352044870,AWP 10,009,202042,Staff,0,0,0,0
1683352044870,AWP 10,010,202043,Staff,0,0,0,0
1683352044870,AWP 10,011,202044,Staff,0,0,0,0
1683352044870,AWP 10,012,202045,Staff,0,0,0,0
1683352044870,AWP 10,013,202046,Staff,0,0,0,0
1683352044870,AWP 10,014,202047,Staff,0,0,0,0
1683352044870,AWP 10,015,202048,Staff,0,0,0,0
1683352044870,AWP 10,016,202049,Staff,0,0,0,0
1683352044870,AWP 10,017,202050,Staff,0,0,0,0
1683352044870,AWP 10,018,202051,Staff,0,0,0,0
1683352044870,AWP 10,019,202052,Staff,0,0,0,0
1683352044870,AWP 10,020,202053,Staff,0,0,0,0
1683352044870,AWP 10,021,202054,Staff,0,0,0,0
1683352044870,AWP 10,022,202055,Staff,0,0,0,0
1683352044870,AWP 10,023,202056,Staff,0,0,0,0
1683352044870,AWP 10,024,202057,Staff,0,0,0,0
1683352044870,AWP 10,025,202058,Staff,0,0,0,0
1683352044870,AWP 10,026,202059,Staff,0,0,0,0
1683352045898,AWP 102,001,202032,Staff,0,0,0,0
1683352045898,AWP 102,002,202033,Staff,0,0,0,0
1683352046923,BENG 100,A01,254234,Taylor Amos; Alyssa C,31,0,40,9
1683352047950,BENG 196,001,270013,Engler; Adam J.,9999,0,9999,0
1683352048979,BICD 100R,A01,202018,Smith; Laurie,0,7,32,32
1683352048979,BICD 100R,A02,202019,Smith; Laurie,0,2,32,32
1683352048979,BICD 100R,A03,202020,Smith; Laurie,0,1,32,32
1683352048979,BICD 100R,A04,202021,Smith; Laurie,9,0,32,23
1683352048979,BICD 100R,A05,202022,Smith; Laurie,12,0,32,20
1683352050007,BICD 136,A01,193242,Gustafson-Brown; Cindy,0,2,32,32
1683352050007,BICD 136,A02,193244,Gustafson-Brown; Cindy,14,0,32,18
1683352051034,BIEB 102,A01,193249,Butler; Shannon Rhey,0,2,32,32
1683352051034,BIEB 102,A02,193251,Butler; Shannon Rhey,0,0,32,32
1683352051034,BIEB 102,A03,193253,Butler; Shannon Rhey,0,1,32,32
1683352051034,BIEB 102,A04,193255,Butler; Shannon Rhey,17,0,32,15
1683352051034,BIEB 102,A05,193265,Butler; Shannon Rhey,26,0,32,6
1683352051034,BIEB 102,A06,193269,Butler; Shannon Rhey,16,0,32,16
1683352053087,BIEB 150,A01,193274,Staff,0,0,32,32
1683352053087,BIEB 150,A02,193285,Staff,23,0,32,9
1683352054113,BIEB 194,A00,193286,Kurle; Carolyn M.,22,0,32,10
1683352055142,BILD 1,A01,192291,Staff,16,0,32,16
1683352055142,BILD 1,A02,192292,Staff,30,0,32,2
1683352055142,BILD 1,B01,192520,Reuther; Keefe,0,1,0,0
1683352055142,BILD 1,B02,192532,Reuther; Keefe,0,1,0,0
1683352056171,BILD 3,A01,192556,Butler; Shannon Rhey,0,0,32,32
1683352056171,BILD 3,A02,192581,Butler; Shannon Rhey,4,0,32,28
1683352056171,BILD 3,A03,192611,Butler; Shannon Rhey,23,0,32,9
1683352056171,BILD 3,A04,192612,Butler; Shannon Rhey,25,0,32,7
1683352056171,BILD 3,A05,192613,Butler; Shannon Rhey,27,0,32,5
1683352056171,BILD 3,A06,192679,Butler; Shannon Rhey,27,0,32,5
1683352056171,BILD 3,A07,192682,Butler; Shannon Rhey,22,0,32,10
1683352057199,BILD 4,A01,192836,Reuther; Keefe,0,0,24,24
1683352057199,BILD 4,A02,193044,Reuther; Keefe,4,0,24,20
1683352058222,BILD 10,A01,193142,Gustafson-Brown; Cindy,30,0,32,2
1683352058222,BILD 10,A02,193149,Gustafson-Brown; Cindy,31,0,32,1
1683352059246,BIMM 100,A01,193301,Staff,0,6,32,32
1683352059246,BIMM 100,A02,193312,Staff,0,5,32,32
1683352059246,BIMM 100,A03,193323,Staff,0,8,32,32
1683352060271,BIMM 101,A01,193329,McDonnell; Lisa Marie,0,3,24,24
1683352060271,BIMM 101,A02,193339,McDonnell; Lisa Marie,0,3,24,24
1683352060271,BIMM 101,B01,193354,McDonnell; Lisa Marie,0,3,24,24
1683352060271,BIMM 101,B02,193357,McDonnell; Lisa Marie,0,3,24,24
1683352061299,BIMM 110,A01,193377,Tat; John,0,11,32,32
1683352061299,BIMM 110,A02,193378,Tat; John,0,8,32,32
1683352062326,BIMM 120,A01,206116,Staff,0,0,32,32
1683352062326,BIMM 120,A02,206117,Staff,8,0,32,24
1683352062326,BIMM 120,A03,206121,Staff,21,0,32,11
1683352063355,BIPN 100,A01,193393,Park; Ji Young,0,14,32,32
1683352063355,BIPN 100,A02,193402,Park; Ji Young,0,13,32,32
1683352063355,BIPN 100,A03,193413,Park; Ji Young,0,14,32,32
1683352063355,BIPN 100,A04,193414,Park; Ji Young,0,13,32,32
1683352064382,BIPN 102,A01,193429,Staff,0,0,32,32
1683352064382,BIPN 102,A02,193438,Staff,22,0,32,10
1683352065406,BIPN 106,A01,193450,Reyes Gonzalez; Catalina,0,2,40,40
1683352066432,BIPN 134,A01,193465,Cooke; James Edward,0,0,32,32
1683352066432,BIPN 134,A02,193474,Cooke; James Edward,25,0,32,7
1683352066432,BIPN 134,A03,193485,Cooke; James Edward,29,0,32,3
1683352066432,BIPN 134,A04,193486,Cooke; James Edward,21,0,32,11
1683352066432,BIPN 134,A05,193491,Cooke; James Edward,31,0,32,1
1683352066432,BIPN 134,A06,193501,Cooke; James Edward,30,0,32,2
1683352066432,BIPN 134,A07,193510,Cooke; James Edward,29,0,32,3
1683352068480,BISP 194,A00,222522,Staff,14,0,32,18
1683352069504,CAT 124,A01,202407,Staff,20,0,25,5
1683352070532,CAT 125,A00,202408,Marchisotto; Jennifer Anne,4,0,20,16
1683352071558,CAT 125R,A00,202409,Smith; Lauryn Alissa,0,11,20,20
1683352071558,CAT 125R,B00,202410,Morales; Celeste Georgianna,0,11,20,20
1683352071558,CAT 125R,C00,202411,Irwin; Matthew Joseph,0,10,20,20
1683352072582,CENG 15,A01,204712,Yang; Kesong,0,1,0,0
1683352073606,CENG 114,A00,202070,Jahed Motlagh; Zeinab,5,0,20,15
1683352074631,CGS 105,A00,185477,Wesling; Megan E.,24,0,40,16
1683352075656,CGS 106,A00,185494,Staff,13,0,22,9
1683352076679,CGS 108,A00,185495,Staff,14,0,20,6
1683352077705,CGS 114,A00,185496,Staff,13,0,18,5
1683352078729,CGS 119,A00,185501,Staff,15,0,20,5
1683352079756,CGS 120,A00,185511,Staff,13,0,20,7
1683352080785,CHEM 4,A01,184675,Bussey; Thomas J,96,0,100,4
1683352081813,CHEM 6A,A01,184677,Staff,34,0,60,26
1683352082838,CHEM 6B,A01,184679,Staff,65,0,100,35
1683352083862,CHEM 6C,A01,184681,Bussey; Thomas J,1,0,50,49
1683352083862,CHEM 6C,A02,184682,Bussey; Thomas J,34,0,50,16
1683352084887,CHEM 40A,A01,184684,Albizati; Kim F.,37,0,100,63
1683352085913,CHEM 40B,A01,184686,Albizati; Kim F.,0,20,100,100
1683352086940,CHEM 41B,A01,184690,Staff,52,0,100,48
1683352087970,COGS 3,A01,184715,Boyle; Mary E. T.,0,25,40,40
1683352088994,COGS 14B,A01,185172,Staff,0,15,38,38
1683352090019,COGS 18,A01,184736,Staff,17,0,80,63
1683352091047,COGS 100,A01,184932,Staff,0,5,73,73
1683352092077,COGS 101A,A01,184935,Staff,0,39,30,30
1683352093104,COGS 101B,A01,184944,Staff,0,2,30,30
1683352094127,COGS 101C,A01,184946,Staff,0,12,30,30
1683352095151,COGS 102A,A01,184951,Johnson; Christine M.,2,0,40,38
1683352096173,COGS 107B,A01,184953,Mooshagian; Eric Frederick,0,50,40,40
1683352097201,COGS 118B,A01,184959,Gupta; Anjum,0,48,40,40
1683352098228,COGS 153,A00,184961,Staff,0,15,30,30
1683352099250,COGS 177,A00,184962,Staff,0,20,30,30
1683352100277,COGS 187A,A01,184969,Boyle; Mary E. T.,0,17,40,40
1683352101304,COMM 10,A01,185174,Staff,0,5,25,25
1683352101304,COMM 10,A02,185189,Staff,0,5,25,25
1683352101304,COMM 10,A03,269821,Staff,0,0,0,0
1683352102331,COMM 100B,A01,185475,Staff,0,0,0,2
1683352102331,COMM 100B,A02,185476,Staff,13,0,25,12
1683352103357,COMM 100C,A01,185314,Staff,1,0,25,24
1683352103357,COMM 100C,A02,185327,Staff,19,0,25,6
1683352104382,COMM 110M,A00,185349,Staff,2,0,40,38
1683352105404,COMM 113T,A00,185352,Staff,24,0,40,16
1683352106427,COMM 114I,A00,185353,Staff,33,0,40,7
1683352107450,COMM 131,A00,185354,Staff,19,0,30,11
1683352108478,CSE 8A,A50,185358,Cao; Yingjun,0,46,10,10
1683352109502,CSE 8B,A01,185362,Staff,0,46,50,50
1683352110527,CSE 11,A01,185416,Cao; Yingjun,0,92,10,10
1683352111555,CSE 20,A01,185445,Briones; Jor-el Thomas Caparas,5,0,25,20
1683352112580,CSE 21,A01,185447,Staff,10,0,50,40
1683352113605,CSE 101,A01,185451,Staff,0,13,50,50
1683352113605,CSE 101,B01,185453,Jones; Miles E,0,11,50,50
1683352115653,CSE 141,A01,185458,Eldon; John,20,0,100,80
1683352116677,CSE 141L,A01,185461,Eldon; John,12,0,100,88
1683352117705,CSE 142,A01,185463,Staff,36,0,60,24
1683352117705,CSE 142,B01,201355,Staff,0,7,60,60
1683352118731,CSE 142L,A01,185470,Staff,36,0,60,24
1683352118731,CSE 142L,B01,201417,Staff,0,6,60,60
1683352119755,CSE 190,A00,201433,Staff,32,0,49,17
1683352120784,DOC 1,A01,259136,Strom; Megan C.,7,0,15,8
1683352120784,DOC 1,A02,259137,Strom; Megan C.,14,0,15,1
1683352120784,DOC 1,A03,259138,Strom; Megan C.,14,0,15,1
1683352120784,DOC 1,A04,259139,Strom; Megan C.,14,0,15,1
1683352121807,DOC 100D,A00,259140,Pass; Natalye Joann,16,0,25,9
1683352122832,DSGN 1,A01,184749,Rill; Bryan,0,25,30,30
1683352123860,DSGN 100,A01,185168,Staff,0,2,25,25
1683352124889,ECE 5,A01,185626,Morris; Karcher William,0,10,0,0
1683352125917,ECE 101,A01,185628,Staff,17,0,70,53
1683352126941,ECE 107,A01,185635,Baghdadchi; Saharnaz,0,0,20,20
1683352126941,ECE 107,A02,185638,Baghdadchi; Saharnaz,4,0,20,16
1683352127969,ECE 148,A01,185647,Silberman; Jack,0,0,16,16
1683352128996,ECON 1,A01,185537,Crane; Meredith Helen,54,0,70,16
1683352130022,ECON 3,A01,185549,Crane; Meredith Helen,32,0,70,38
1683352131046,ECON 4,A01,203354,Anderson; John Charles,0,4,10,10
1683352132070,ECON 100A,A01,185574,Staff,0,4,40,40
1683352133093,ECON 100B,A01,185576,Staff,0,12,50,50
1683352134117,ECON 100C,A01,185589,Newhouse; Herbert S,29,0,70,41
1683352135139,ECON 105,A00,185608,Vespa; Emanuel Ignacio,19,0,35,16
1683352136165,ECON 109,A01,185610,Shishkin; Denis,10,0,35,25
1683352137188,ECON 110A,A01,185612,Staff,11,0,40,29
1683352138214,ECON 120A,A01,185615,Staff,20,0,40,20
1683352139295,ECON 120C,A01,185617,Sun; Yixiao,0,21,70,70
1683352140323,ECON 144,A00,203346,Squires; Dale E,3,0,35,32
1683352141357,ECON 171,A01,203349,Newhouse; Herbert S,0,1,35,35
1683352142381,ECON 173A,A01,185621,Toda; Alexis Akira,21,0,35,14
1683352143407,EDS 25,A01,202413,Staff,0,1,0,0
1683352143407,EDS 25,A02,202414,Staff,0,1,0,0
1683352143407,EDS 25,A03,202415,Staff,0,0,0,0
1683352143407,EDS 25,A04,202416,Staff,0,1,0,0
1683352143407,EDS 25,A05,202439,Staff,0,0,0,0
1683352143407,EDS 25,A06,202440,Staff,0,0,0,0
1683352143407,EDS 25,B01,202631,Staff,0,0,0,0
1683352143407,EDS 25,B02,202632,Staff,0,0,0,0
1683352143407,EDS 25,B03,202639,Staff,0,0,0,0
1683352143407,EDS 25,B04,202640,Staff,0,0,0,0
1683352143407,EDS 25,B05,202643,Staff,0,0,0,0
1683352143407,EDS 25,B06,202644,Staff,0,0,0,0
1683352144436,EDS 38,A01,202659,Black; Alison Michelle,24,0,25,1
1683352145463,EDS 115,A00,202652,Staff,18,0,30,12
1683352146488,EDS 125,A00,202649,Staff,14,0,30,16
1683352147514,EDS 126,A01,203332,Staff,30,0,30,0
1683352148541,EDS 139,A00,202838,Staff,16,0,25,9
1683352149566,EDS 146,A01,202655,Staff,14,0,25,11
1683352150596,ENG 15,A00,185667,Staff,0,1,0,0
1683352150596,ENG 15,B00,185672,Staff,0,0,0,0
1683352150596,ENG 15,C00,185675,Staff,0,0,0,0
1683352150596,ENG 15,D00,185682,Staff,0,0,0,0
1683352150596,ENG 15,E00,185684,Staff,0,0,0,0
1683352151620,ETHN 103,A00,185710,Staff,0,4,35,35
1683352152647,ETHN 103A,A00,199228,Man; Simeon S,2,0,9,7
1683352153671,ETHN 109,A00,185711,Staff,18,0,35,17
1683352154695,ETHN 142,A00,185726,Staff,0,4,30,30
1683352155720,ETHN 163J,A00,199229,Man; Simeon S,5,0,8,3
1683352156743,ETHN 168,A00,185727,Staff,8,0,10,2
1683352157767,ETHN 182,A00,185728,Staff,0,0,35,35
1683352158791,ETHN 183,A00,185737,Staff,8,0,18,10
1683352159815,GLBH 111,A01,209361,Burgos; Jose L.,0,0,0,0
1683352161866,HIEU 104,A00,185792,Staff,16,0,20,4
1683352162891,HIEU 115,A00,185800,Staff,1,0,20,19
1683352163914,HIEU 128,A00,185801,Staff,0,7,20,20
1683352164938,HIEU 147,A00,185802,Staff,16,0,20,4
1683352165962,HIEU 154,A00,185823,Staff,12,0,20,8
1683352166989,HILA 102,A00,185826,Staff,13,0,20,7
1683352168016,HILD 2C,A01,185778,Staff,0,12,20,20
1683352169044,HILD 7B,A01,185780,Kwak; Nancy,0,15,32,32
1683352169044,HILD 7B,A02,185781,Kwak; Nancy,0,18,32,32
1683352170069,HILD 30,A01,185791,Staff,14,0,20,6
1683352171096,HISC 119,A00,185830,Golan; Tal,0,9,20,20
1683352172123,HITO 156GS,A00,185831,Patterson; Patrick H.,0,0,0,23
1683352173148,HIUS 103,A00,185832,Man; Simeon S,0,6,20,20
1683352174175,HIUS 117,A00,185836,Kwak; Nancy,2,0,20,18
1683352175200,HIUS 125,A00,185840,Man; Simeon S,0,0,23,23
1683352176223,HIUS 149,A00,185845,Staff,0,0,20,20
1683352177252,HUM 3,A01,185882,Zavodny; Tatiana Sophia,0,7,50,50
1683352177252,HUM 3,B01,185899,Caldwell; Michael Alan,0,18,50,50
1683352178282,HUM 3GS,A00,185900,Patterson; Patrick H.,0,0,0,23
1683352179311,HUM 4,A01,185938,Zroka; Amy Liane,31,0,50,19
1683352179311,HUM 4,B01,185956,Watkins; Eric,0,3,50,50
1683352179311,HUM 4,B02,202209,Watkins; Eric,0,2,50,50
1683352179311,HUM 4,B03,202210,Watkins; Eric,0,2,50,50
1683352180335,HUM 5,A01,185958,West; Geoffrey Scott,3,0,50,47
1683352180335,HUM 5,A02,202215,West; Geoffrey Scott,0,0,50,50
1683352181358,INTL 190,A00,185959,Gagnon; Jeffrey C,0,0,0,9
1683352181358,INTL 190,B00,185960,Lettieri; Michael Joseph,0,0,0,1
1683352182384,JAPN 180,A00,254509,Staff,4,0,30,26
1683352183412,LATI 10,A01,202853,Kennemore; Amy Michelle,4,0,35,31
1683352183412,LATI 10,A02,202854,Kennemore; Amy Michelle,2,0,35,33
1683352183412,LATI 10,A03,270054,Kennemore; Amy Michelle,30,0,30,0
1683352184439,LATI 180,A00,202855,Kennemore; Amy Michelle,11,0,20,9
1683352185463,LAWS 101,A00,201767,Golan; Tal,0,7,40,40
1683352186487,LIFR 1C,A00,185961,Staff,6,0,20,14
1683352187514,LIFR 1CX,A00,185962,Staff,7,0,20,13
1683352188539,LIFR 1D,A00,185963,Staff,9,0,20,11
1683352189567,LIFR 1DX,A00,185964,Staff,9,0,20,11
1683352190594,LIGN 101,A01,186039,Staff,43,0,50,7
1683352191617,LIGN 165,A00,186040,Staff,18,0,50,32
1683352192642,LTCS 108,A00,186041,Staff,6,0,10,4
1683352193669,LTCS 119,A00,186042,Staff,16,0,20,4
1683352194693,LTCS 130,A00,186043,Wesling; Megan E.,15,0,25,10
1683352196746,LTEA 138,A00,186119,Staff,14,0,40,26
1683352197772,LTEN 124,A00,186148,Staff,6,0,25,19
1683352198799,LTEN 178,A00,186149,Staff,7,0,15,8
1683352199824,LTEN 181,A00,186150,Blanco; John D,33,0,40,7
1683352200851,LTWL 120,A00,186160,Staff,20,0,25,5
1683352201881,LTWL 165,A00,186161,Staff,22,0,25,3
1683352202907,LTWR 100,A00,186162,Staff,0,5,15,15
1683352203933,LTWR 102,A00,186163,Doller; Ben,5,0,15,10
1683352204957,MAE 8,A01,186412,Staff,0,0,0,0
1683352205981,MAE 30B,A00,186445,Bahadori; Mohammad Yousef,83,0,100,17
1683352207034,MAE 40,A00,186592,Bewley; Thomas R,9,0,50,41
1683352208061,MAE 101B,A00,186593,Bahadori; Mohammad Yousef,81,0,100,19
1683352209089,MAE 105,A00,186594,Bandaru; Prabhakar,12,0,50,38
1683352210115,MAE 107,A00,186599,Pham; Hieu Tan,0,6,120,120
1683352211141,MAE 148,A01,186660,Silberman; Jack,3,0,16,13
1683352212166,MATH 10A,A01,188095,Staff,0,5,35,35
1683352213190,MATH 10B,A01,188097,Bowers; Adam R.,0,11,30,30
1683352213190,MATH 10B,A02,188099,Bowers; Adam R.,0,11,30,30
1683352213190,MATH 10B,B01,188104,Bowers; Adam R.,0,10,30,30
1683352213190,MATH 10B,B02,188106,Bowers; Adam R.,0,10,30,30
1683352214215,MATH 10C,A01,188111,Staff,0,18,30,30
1683352214215,MATH 10C,A02,188127,Staff,0,17,30,30
1683352214215,MATH 10C,A03,188131,Staff,0,18,30,30
1683352214215,MATH 10C,B01,188218,Staff,18,0,30,12
1683352214215,MATH 10C,B02,188244,Staff,13,0,30,17
1683352214215,MATH 10C,B03,188277,Staff,16,0,30,14
1683352215238,MATH 18,A01,188344,Bach; Quang Tran,18,0,30,12
1683352215238,MATH 18,A02,188345,Bach; Quang Tran,11,0,30,19
1683352215238,MATH 18,B01,188353,Bach; Quang Tran,10,0,30,20
1683352215238,MATH 18,B02,188354,Bach; Quang Tran,20,0,30,10
1683352216260,MATH 20A,A01,188374,Staff,12,0,35,23
1683352217285,MATH 20B,A01,188382,Ohm; Ko Woon,6,0,30,24
1683352217285,MATH 20B,A02,188383,Ohm; Ko Woon,22,0,30,8
1683352217285,MATH 20B,B01,188385,Ohm; Ko Woon,7,0,30,23
1683352217285,MATH 20B,B02,188392,Ohm; Ko Woon,22,0,30,8
1683352218308,MATH 20C,A01,188394,Harel; Guershon,10,0,30,20
1683352218308,MATH 20C,A02,188395,Harel; Guershon,15,0,30,15
1683352218308,MATH 20C,B01,188404,Harel; Guershon,4,0,30,26
1683352218308,MATH 20C,B02,188405,Harel; Guershon,19,0,30,11
1683352219337,MATH 20D,A01,188414,Hammock; Frances H,0,1,30,30
1683352219337,MATH 20D,A02,188415,Hammock; Frances H,3,0,30,27
1683352219337,MATH 20D,B01,188447,Hammock; Frances H,1,0,30,29
1683352219337,MATH 20D,B02,188486,Hammock; Frances H,8,0,30,22
1683352220362,MATH 20E,A01,188649,Staff,21,0,30,9
1683352220362,MATH 20E,A02,188650,Staff,23,0,30,7
1683352220362,MATH 20E,A03,188673,Staff,0,0,30,30
1683352221385,MATH 102,A01,188675,Staff,0,35,35,35
1683352222413,MATH 103B,A01,188681,Staff,3,0,35,32
1683352222413,MATH 103B,B01,188692,Staff,5,0,35,30
1683352223437,MATH 109,A01,188695,Salehi Golsefidy; Alireza,25,0,35,10
1683352223437,MATH 109,A02,188696,Salehi Golsefidy; Alireza,25,0,35,10
1683352224461,MATH 120A,A01,188698,Eggers; John Dietrich,7,0,35,28
1683352225486,MATH 142B,A01,188736,Ioana; Adrian,0,2,30,30
1683352225486,MATH 142B,A02,188741,Ioana; Adrian,0,0,30,30
1683352225486,MATH 142B,A03,188743,Ioana; Adrian,0,1,30,30
1683352226511,MATH 168A,A01,188790,Staff,0,9,35,35
1683352227535,MATH 170A,A01,188803,Nie; Jiawang,0,2,35,35
1683352227535,MATH 170A,A02,188811,Nie; Jiawang,0,0,35,35
1683352227535,MATH 170A,A03,188814,Nie; Jiawang,1,0,35,34
1683352227535,MATH 170A,A04,188815,Nie; Jiawang,13,0,35,22
1683352228559,MATH 193B,A01,188817,Staff,0,0,35,35
1683352228559,MATH 193B,A02,188818,Staff,5,0,35,30
1683352229585,MGT 4,A01,202857,Anderson; John Charles,62,0,80,18
1683352230609,MGT 12,A00,202858,Lindenberger; Wade Douglas,42,0,90,48
1683352231631,MGT 18,A00,202859,Staff,74,0,90,16
1683352232654,MGT 18GS,A00,202860,McKay; Michael J,13,0,28,15
1683352233680,MGT 45,A00,202861,Pecore; Joseph P.,14,0,90,76
1683352234728,MGT 100,A00,202863,Yavorsky; Daniel Ryan,28,0,90,62
1683352235755,MGT 103,A00,202864,Ehrich; Kristine R,0,17,90,90
1683352236782,MGT 112,A00,202865,Ehrich; Kristine R,15,0,90,75
1683352237806,MGT 121A,A00,202868,Staff,0,20,0,0
1683352238835,MGT 131B,A00,202869,Anderson; John Charles,59,0,90,31
1683352239858,MGT 136,A00,202871,Lindenberger; Wade Douglas,84,0,90,6
1683352240881,MGT 164,A00,202873,Staff,0,68,90,91
1683352241905,MGT 164GS,A00,202874,McKay; Mary A,13,0,28,15
1683352242987,MGT 180,A00,202875,Staff,0,50,90,91
1683352244011,MMW 11R,A01,205019,Herbst; Matthew,3,0,30,27
1683352244011,MMW 11R,A02,205026,Herbst; Matthew,29,0,30,1
1683352245035,MMW 15,A01,193512,Chang; Edmond Yi-Teh,0,9,28,28
1683352245035,MMW 15,A02,193513,Chang; Edmond Yi-Teh,0,5,28,28
1683352245035,MMW 15,A03,193514,Chang; Edmond Yi-Teh,0,5,28,28
1683352245035,MMW 15,A04,193515,Chang; Edmond Yi-Teh,0,5,28,28
1683352245035,MMW 15,A05,193516,Chang; Edmond Yi-Teh,0,4,28,28
1683352245035,MMW 15,A06,193517,Chang; Edmond Yi-Teh,0,5,28,28
1683352245035,MMW 15,B01,193519,Chang; Edmond Yi-Teh,0,5,28,28
1683352245035,MMW 15,B02,193520,Chang; Edmond Yi-Teh,0,5,28,28
1683352245035,MMW 15,B03,193521,Chang; Edmond Yi-Teh,0,5,28,28
1683352245035,MMW 15,B04,193522,Chang; Edmond Yi-Teh,0,4,28,28
1683352245035,MMW 15,B05,193523,Chang; Edmond Yi-Teh,0,5,28,28
1683352245035,MMW 15,B06,193524,Chang; Edmond Yi-Teh,0,4,28,28
1683352246059,MMW 122,A01,193526,Rahimi; Babak,0,15,28,28
1683352246059,MMW 122,A02,193527,Rahimi; Babak,0,14,28,28
1683352246059,MMW 122,A03,193528,Rahimi; Babak,0,0,0,0
1683352246059,MMW 122,A04,193529,Rahimi; Babak,0,0,0,0
1683352247086,MUS 1A,A01,186663,Staff,0,20,35,35
1683352248110,MUS 4,A01,186715,Staff,0,12,35,35
1683352249134,MUS 5R,A01,186796,Dubnov; Shlomo,0,17,35,35
1683352250159,MUS 6,A01,186798,Staff,0,4,25,25
1683352251183,MUS 7,A01,186830,Staff,13,0,35,22
1683352252207,MUS 8,A01,186930,Staff,0,26,35,35
1683352253236,MUS 15,A01,186932,Staff,0,16,35,35
1683352253236,MUS 15,B01,186934,Staff,0,15,35,35
1683352254264,MUS 80,A00,186935,Staff,1,0,20,19
1683352254264,MUS 80,B00,186936,Staff,25,0,25,0
1683352255291,NANO 11,A00,204702,Lipomi; Darren John,0,0,0,0
1683352256318,NANO 15,A01,204709,Yang; Kesong,0,1,0,0
1683352257345,NANO 114,A00,202069,Jahed Motlagh; Zeinab,3,0,10,7
1683352258369,PHIL 1,A00,186955,Grush; Rick Scott,32,0,40,8
1683352259396,PHIL 10,A01,186973,Grush; Rick Scott,28,0,35,7
1683352259396,PHIL 10,A02,186974,Grush; Rick Scott,33,0,35,2
1683352260423,PHIL 13,A01,186976,Staff,7,0,35,28
1683352260423,PHIL 13,A02,186977,Staff,16,0,35,19
1683352261451,PHIL 14,A01,186979,Staff,31,0,35,4
1683352261451,PHIL 14,A02,186986,Staff,32,0,35,3
1683352262480,PHIL 28,A01,186988,Staff,16,0,30,14
1683352262480,PHIL 28,A02,186989,Staff,1,0,30,29
1683352262480,PHIL 28,A03,186990,Staff,9,0,30,21
1683352262480,PHIL 28,A04,186991,Staff,26,0,30,4
1683352263504,PHIL 120,A00,186997,Staff,23,0,40,17
1683352264530,PHIL 137,A00,187003,Staff,9,0,40,31
1683352265554,PHIL 150,A00,187015,Staff,47,0,70,23
1683352266579,PHIL 167,A00,187021,Lamey; Andy M.,35,0,40,5
1683352267606,PHIL 174,A01,202226,Staff,17,0,20,3
1683352267606,PHIL 174,A02,202235,Staff,20,0,20,0
1683352268629,PHIL 191A,A00,258918,Staff,0,0,1,1
1683352269654,PHYS 1A,A00,187028,Staff,27,0,60,33
1683352270679,PHYS 1AL,001,187036,Staff,2,0,30,28
1683352270679,PHYS 1AL,002,187049,Staff,18,0,30,12
1683352271706,PHYS 1B,A00,187058,Staff,22,0,60,38
1683352272730,PHYS 1BL,001,187064,Staff,0,0,30,30
1683352272730,PHYS 1BL,002,187070,Staff,5,0,30,25
1683352273755,PHYS 1C,A00,187082,Staff,31,0,120,89
1683352274783,PHYS 1CL,001,187088,Staff,0,9,30,30
1683352274783,PHYS 1CL,002,187089,Staff,0,2,30,30
1683352274783,PHYS 1CL,009,262693,Staff,11,0,30,19
1683352275810,PHYS 2B,A01,187097,Staff,54,0,115,61
1683352276835,PHYS 2C,A01,187099,Staff,67,0,115,48
1683352277859,PHYS 2CL,A01,187101,Staff,5,0,28,23
1683352277859,PHYS 2CL,A02,187102,Staff,15,0,28,13
1683352278884,PHYS 2D,A01,187123,Shotwell; Brian,95,0,115,20
1683352279907,PHYS 4B,A01,187133,Grinstein; Benjamin,35,0,50,15
1683352280933,POLI 10,A00,188819,Staff,0,4,50,50
1683352281960,POLI 11,A00,188827,Staff,43,0,50,7
1683352282987,POLI 13R,A00,188828,Staff,0,1,20,20
1683352284014,POLI 27,A01,188830,Elgin; Samuel Zincke,0,1,70,70
1683352285041,POLI 30,A00,188832,Desposato; Scott,31,0,50,19
1683352286065,POLI 102F,A00,188834,Staff,3,0,40,37
1683352287089,POLI 104A,A00,188852,Staff,14,0,30,16
1683352288114,POLI 104I,A00,188853,Staff,0,6,20,20
1683352289137,POLI 110B,A00,188854,Wiens; David,7,0,20,13
1683352290161,POLI 112A,A00,188855,Wiens; David,5,0,30,25
1683352291188,POLI 117R,A00,188856,Forman; Fonna,0,11,20,20
1683352292215,POLI 118,A00,188857,Ingham; Sean,8,0,20,12
1683352293239,POLI 120G,A00,188858,Staff,9,0,30,21
1683352294261,POLI 131CR,A00,188863,Hoston; Germaine,24,0,50,26
1683352295284,POLI 133,A00,188864,Nellis; Gareth Hb,44,0,50,6
1683352296309,POLI 134D,A00,188865,Desposato; Scott,27,0,30,3
1683352297334,POLI 142A,A00,188871,Gartzke; Erik,22,0,50,28
1683352298360,POLI 142K,A00,188874,Staff,38,0,50,12
1683352299386,POLI 143,A00,188940,Gartzke; Erik,16,0,30,14
1683352300410,POLI 153,A00,188943,Staff,3,0,20,17
1683352301434,POLI 160AA,A00,188944,Staff,11,0,40,29
1683352302456,POLI 170A,A00,188945,Staff,11,0,30,19
1683352304502,PSYC 1,A00,188952,Staff,37,0,90,53
1683352305526,PSYC 2,B00,188953,Staff,19,0,35,16
1683352306550,PSYC 6,A00,188970,Staff,47,0,60,13
1683352307577,PSYC 7,A00,188973,Staff,37,0,45,8
1683352308607,PSYC 60,A01,188980,Rickard; Timothy C.,43,0,60,17
1683352309635,PSYC 70,A01,189001,Steiner; Eric Tomas,23,0,45,22
1683352310659,PSYC 100,A00,189005,Lacefield; Katharine I,0,98,120,120
1683352311683,PSYC 102,A00,189008,Staff,9,0,30,21
1683352312707,PSYC 106,B00,189026,Gorman; Michael R.,34,0,60,26
1683352313731,PSYC 114,B01,189033,Winkielman; Piotr,0,32,30,30
1683352314754,PSYC 131,A00,189036,Anagnostaras; Stephan,0,43,60,60
1683352315778,PSYC 136,A00,189041,Lowe; Angela Beth,0,7,25,25
1683352316802,PSYC 137,A00,189057,Winkielman; Piotr,0,34,25,25
1683352317829,PSYC 144,A00,189107,Wixted; John T,0,7,50,50
1683352319880,PSYC 162,A00,189142,Staff,0,8,85,85
1683352320905,PSYC 172,A00,189144,Gorman; Michael R.,0,7,30,30
1683352322963,PSYC 179,A00,189146,Lacefield; Katharine I,0,84,120,120
1683352323990,PSYC 181,A00,189147,Anagnostaras; Stephan,0,44,90,90
1683352325019,PSYC 190R,A00,189148,Barner; David A.,0,22,80,80
1683352326043,PSYC 191,A00,189275,Rickard; Timothy C.,0,7,25,25
1683352327068,PSYC 193,A00,189276,Chapman; Eddie Nathaniel,0,1,0,4
1683352328093,PSYC 193L,A01,189281,Lowe; Angela Beth,12,0,20,8
1683352328093,PSYC 193L,B01,189285,Staff,28,0,35,7
1683352329120,RELI 149,A00,187137,Rahimi; Babak,7,0,40,33
1683352330147,SE 9,A01,187315,Staff,0,2,18,18
1683352331173,SE 101B,A00,187409,Staff,24,0,30,6
1683352332199,SE 110B,A00,187444,Staff,10,0,40,30
1683352333225,SE 130B,A00,187449,Staff,31,0,40,9
1683352334251,SE 150A,A00,187516,Staff,9,0,20,11
1683352335277,SE 154,A00,187528,Staff,30,0,50,20
1683352336301,SIO 3,A01,258171,Staff,35,0,40,5
1683352337324,SIO 10,A00,187144,Cook; Geoffrey W,0,3,75,75
1683352338350,SIO 45,A00,187152,Cook; Geoffrey W,1,0,100,99
1683352339375,SIO 109R,A00,194486,Staff,0,3,20,20
1683352341427,SIO 187,A01,187233,Kacev; David,12,0,40,28
1683352342457,SOCI 1,A01,258656,Thorpe; Charles Robert,28,0,30,2
1683352342457,SOCI 1,A02,258658,Thorpe; Charles Robert,30,0,30,0
1683352342457,SOCI 1,A03,258661,Thorpe; Charles Robert,25,0,25,0
1683352342457,SOCI 1,A04,258666,Thorpe; Charles Robert,22,0,25,3
1683352342457,SOCI 1,A05,258897,Thorpe; Charles Robert,23,0,25,2
1683352342457,SOCI 1,A06,258898,Thorpe; Charles Robert,25,0,25,0
1683352343486,SOCI 30,A01,258903,Pardo Guerra; Juan Pablo,15,0,30,15
1683352344514,SOCI 102,A00,258904,Staff,9,0,25,16
1683352345542,SOCI 106,A00,258905,Staff,19,0,25,6
1683352346625,SOCI 111,A00,258907,Ribas Norris; Janet Vanesa,26,0,30,4
1683352347652,SOCI 121R,A00,258908,Pardo Guerra; Juan Pablo,10,0,30,20
1683352348681,SOCI 126,A01,203330,Staff,14,0,20,6
1683352349709,SOCI 131,A00,258909,Thorpe; Charles Robert,31,0,60,29
1683352350734,SOCI 135,A00,258910,Payne; Christine Anna,0,9,30,30
1683352351759,SOCI 157,A00,258911,Staff,12,0,30,18
1683352352787,SOCI 184,A00,258912,Staff,25,0,30,5
1683352353813,SOCI 188D,A00,258913,Staff,22,0,30,8
1683352354840,SYN 2,001,187529,Staff,10,0,16,6
1683352354840,SYN 2,002,201452,Staff,0,18,16,16
1683352354840,SYN 2,003,201469,Staff,3,0,16,13
1683352355865,SYN 100,A01,187531,Staff,0,9,20,20
1683352355865,SYN 100,B01,201491,Staff,0,12,20,20
1683352356889,TDAC 1,A00,189286,Walsh; Kim C.,3,0,20,17
1683352356889,TDAC 1,B00,189287,Harting; Carla Kelso,11,0,20,9
1683352357914,TDAC 101,A00,189300,Walsh; Kim C.,16,0,20,4
1683352357914,TDAC 101,B00,189301,Harting; Carla Kelso,18,0,20,2
1683352358940,TDAC 102,A00,189304,Basso; Beatrice,14,0,20,6
1683352359967,TDAC 108,A00,189305,Staff,18,0,20,2
1683352360997,TDDE 131,A00,189310,Staff,19,0,20,1
1683352360997,TDDE 131,B00,189314,Staff,19,0,20,1
1683352360997,TDDE 131,C00,189315,Staff,48,0,50,2
1683352360997,TDDE 131,D00,189316,Staff,14,0,15,1
1683352360997,TDDE 131,E00,204841,Staff,20,0,20,0
1683352362020,TDGE 10,A00,189289,Staff,30,0,50,20
1683352362020,TDGE 10,B00,189290,Havis; Allan,1,0,50,49
1683352363046,TDGE 11,A00,189291,Fulton; Julia,0,3,50,50
1683352363046,TDGE 11,B00,189292,Staff,20,0,25,5
1683352363046,TDGE 11,C00,260270,Staff,0,0,0,0
1683352364070,TDGE 25,A00,189294,Staff,3,0,20,17
1683352365093,TDGE 124,A00,189318,Fulton; Julia,0,8,50,50
1683352366118,TDGE 125,A00,189319,Staff,13,0,25,12
1683352366118,TDGE 125,B00,189320,Staff,23,0,25,2
1683352367145,TDGE 127,A00,189322,Havis; Allan,0,0,50,50
1683352368170,TDHT 101,A00,189323,Staff,18,0,25,7
1683352368170,TDHT 101,B00,189324,Staff,25,0,25,0
1683352369199,TDHT 102,A00,189325,Staff,49,0,50,1
1683352370227,TDMV 1,A00,189295,Arcidiacono; Kristin,19,0,30,11
1683352370227,TDMV 1,B00,189296,Caligagan; Maria T.,24,0,30,6
1683352371254,TDMV 2,A00,189297,Sammartano; Tonnie,28,0,30,2
1683352371254,TDMV 2,B00,189299,Arcidiacono; Kristin,24,0,30,6
1683352372278,TDMV 3,A00,204998,Rincon; Alicia,22,0,30,8
1683352373301,TDMV 120,A00,189458,Sammartano; Tonnie,28,0,30,2
1683352374327,TDMV 138,A00,189541,Jun; Grace Shin Hae,22,0,40,18
1683352375351,TDMV 142,A00,189717,Caligagan; Tony,23,0,30,7
1683352375351,TDMV 142,B00,189718,Caligagan; Maria T.,25,0,30,5
1683352376378,TMC 2,A01,187533,Staff,25,0,25,0
1683352376378,TMC 2,A02,187534,Staff,25,0,25,0
1683352377405,USP 1,A01,187536,Kwak; Nancy,0,16,25,25
1683352378430,USP 5,A01,187538,Staff,10,0,25,15
1683352379453,USP 101,A00,199253,Staff,0,4,0,0
1683352380477,USP 124,A00,187562,Boomhower; Matthew Charles,1,0,30,29
1683352381504,USP 138,A00,187582,Staff,20,0,25,5
1683352382531,USP 152,A01,187597,Staff,4,0,25,21
1683352383560,USP 153,A00,187598,Staff,19,0,25,6
1683352384588,USP 168,A00,187607,Kwak; Nancy,2,0,5,3
1683352385613,USP 173,A00,187619,Staff,4,0,25,21
1683352386640,USP 181,A00,187638,Staff,0,2,25,25
1683352387665,VIS 103,A00,187650,Cruz; Edwin Teddy,22,0,75,53
1683352388693,VIS 110D,A00,187669,Staff,12,0,22,10
1683352389718,VIS 127C,A00,187720,Shen; Kuiyi,67,0,146,79
1683352390744,VIS 149,A00,187731,Yoldas; Pinar,0,14,22,22
1683352391768,VIS 151,A01,188091,Staff,22,0,34,12
1683352391768,VIS 151,A02,188092,Staff,11,0,34,23
1683352392793,VIS 160B,A00,188093,Stalbaum; Brett,0,0,10,10
1683352394846,WCWP 10B,A00,201720,Staff,10,0,15,5
1683352394846,WCWP 10B,B00,201722,Staff,9,0,15,6
1683352395871,WCWP 100,A00,201725,Gagnon; Jeffrey C,0,0,2,2
1683352395871,WCWP 100,B00,201727,Staff,0,4,15,15
1683352398996,ANBI 133,A00,258401,Wilder; Linnea Lorene,34,0,40,6
1683352400023,ANBI 140,A00,258395,Hrvoj Mihic; Branka,18,0,25,7
1683352401050,ANSC 120,A00,258402,Bialecki; Jon Anthony,27,0,40,13
1683352402076,ANSC 144,A00,258400,Staff,14,0,40,26
1683352404125,ANSC 166,A00,258396,Parish; Steven Martin,157,0,175,18
1683352405151,ANSC 180,A00,193533,Staff,9,0,20,11
1683352406174,ANSC 188,A00,258397,Jassal; Aftab,33,0,40,7
1683352407199,ANTH 3,A01,258316,Staff,23,0,30,7
1683352408222,ANTH 5,A00,258394,Semendeferi; Ekaterini,16,0,20,4
1683352409250,ANTH 21,A01,258331,Staff,8,0,40,32
1683352410273,ANTH 103,A00,258398,Varma; Saiba,15,0,25,10
1683352411301,AWP 10,001,202034,Staff,0,0,0,0
1683352411301,AWP 10,002,202035,Staff,0,0,0,0
1683352411301,AWP 10,003,202036,Staff,0,0,0,0
1683352411301,AWP 10,004,202037,Staff,0,0,0,0
1683352411301,AWP 10,005,202038,Staff,0,0,0,0
1683352411301,AWP 10,006,202039,Staff,0,0,0,0
1683352411301,AWP 10,007,202040,Staff,0,0,0,0
1683352411301,AWP 10,008,202041,Staff,0,0,0,0
1683352411301,AWP 10,009,202042,Staff,0,0,0,0
1683352411301,AWP 10,010,202043,Staff,0,0,0,0
1683352411301,AWP 10,011,202044,Staff,0,0,0,0
1683352411301,AWP 10,012,202045,Staff,0,0,0,0
1683352411301,AWP 10,013,202046,Staff,0,0,0,0
1683352411301,AWP 10,014,202047,Staff,0,0,0,0
1683352411301,AWP 10,015,202048,Staff,0,0,0,0
1683352411301,AWP 10,016,202049,Staff,0,0,0,0
1683352411301,AWP 10,017,202050,Staff,0,0,0,0
1683352411301,AWP 10,018,202051,Staff,0,0,0,0
1683352411301,AWP 10,019,202052,Staff,0,0,0,0
1683352411301,AWP 10,020,202053,Staff,0,0,0,0
1683352411301,AWP 10,021,202054,Staff,0,0,0,0
1683352411301,AWP 10,022,202055,Staff,0,0,0,0
1683352411301,AWP 10,023,202056,Staff,0,0,0,0
1683352411301,AWP 10,024,202057,Staff,0,0,0,0
1683352411301,AWP 10,025,202058,Staff,0,0,0,0
1683352411301,AWP 10,026,202059,Staff,0,0,0,0
1683352412326,AWP 102,001,202032,Staff,0,0,0,0
1683352412326,AWP 102,002,202033,Staff,0,0,0,0
1683352413352,BENG 100,A01,254234,Taylor Amos; Alyssa C,31,0,40,9
1683352414376,BENG 196,001,270013,Engler; Adam J.,9999,0,9999,0
1683352415406,BICD 100R,A01,202018,Smith; Laurie,0,7,32,32
1683352415406,BICD 100R,A02,202019,Smith; Laurie,0,2,32,32
1683352415406,BICD 100R,A03,202020,Smith; Laurie,0,1,32,32
1683352415406,BICD 100R,A04,202021,Smith; Laurie,9,0,32,23
1683352415406,BICD 100R,A05,202022,Smith; Laurie,12,0,32,20
1683352416434,BICD 136,A01,193242,Gustafson-Brown; Cindy,0,2,32,32
1683352416434,BICD 136,A02,193244,Gustafson-Brown; Cindy,14,0,32,18
1683352417466,BIEB 102,A01,193249,Butler; Shannon Rhey,0,2,32,32
1683352417466,BIEB 102,A02,193251,Butler; Shannon Rhey,0,0,32,32
1683352417466,BIEB 102,A03,193253,Butler; Shannon Rhey,0,1,32,32
1683352417466,BIEB 102,A04,193255,Butler; Shannon Rhey,17,0,32,15
1683352417466,BIEB 102,A05,193265,Butler; Shannon Rhey,26,0,32,6
1683352417466,BIEB 102,A06,193269,Butler; Shannon Rhey,16,0,32,16
1683352419521,BIEB 150,A01,193274,Staff,0,0,32,32
1683352419521,BIEB 150,A02,193285,Staff,23,0,32,9
1683352420545,BIEB 194,A00,193286,Kurle; Carolyn M.,22,0,32,10
1683352421574,BILD 1,A01,192291,Staff,16,0,32,16
1683352421574,BILD 1,A02,192292,Staff,30,0,32,2
1683352421574,BILD 1,B01,192520,Reuther; Keefe,0,1,0,0
1683352421574,BILD 1,B02,192532,Reuther; Keefe,0,1,0,0
1683352422599,BILD 3,A01,192556,Butler; Shannon Rhey,0,0,32,32
1683352422599,BILD 3,A02,192581,Butler; Shannon Rhey,4,0,32,28
1683352422599,BILD 3,A03,192611,Butler; Shannon Rhey,23,0,32,9
1683352422599,BILD 3,A04,192612,Butler; Shannon Rhey,25,0,32,7
1683352422599,BILD 3,A05,192613,Butler; Shannon Rhey,27,0,32,5
1683352422599,BILD 3,A06,192679,Butler; Shannon Rhey,27,0,32,5
1683352422599,BILD 3,A07,192682,Butler; Shannon Rhey,22,0,32,10
1683352423628,BILD 4,A01,192836,Reuther; Keefe,0,0,24,24
1683352423628,BILD 4,A02,193044,Reuther; Keefe,4,0,24,20
1683352424652,BILD 10,A01,193142,Gustafson-Brown; Cindy,30,0,32,2
1683352424652,BILD 10,A02,193149,Gustafson-Brown; Cindy,31,0,32,1
1683352425680,BIMM 100,A01,193301,Staff,0,6,32,32
1683352425680,BIMM 100,A02,193312,Staff,0,5,32,32
1683352425680,BIMM 100,A03,193323,Staff,0,8,32,32
1683352426706,BIMM 101,A01,193329,McDonnell; Lisa Marie,0,3,24,24
1683352426706,BIMM 101,A02,193339,McDonnell; Lisa Marie,0,3,24,24
1683352426706,BIMM 101,B01,193354,McDonnell; Lisa Marie,0,3,24,24
1683352426706,BIMM 101,B02,193357,McDonnell; Lisa Marie,0,3,24,24
1683352427730,BIMM 110,A01,193377,Tat; John,0,11,32,32
1683352427730,BIMM 110,A02,193378,Tat; John,0,8,32,32
1683352428755,BIMM 120,A01,206116,Staff,0,0,32,32
1683352428755,BIMM 120,A02,206117,Staff,8,0,32,24
1683352428755,BIMM 120,A03,206121,Staff,21,0,32,11
1683352429780,BIPN 100,A01,193393,Park; Ji Young,0,14,32,32
1683352429780,BIPN 100,A02,193402,Park; Ji Young,0,13,32,32
1683352429780,BIPN 100,A03,193413,Park; Ji Young,0,14,32,32
1683352429780,BIPN 100,A04,193414,Park; Ji Young,0,13,32,32
1683352430805,BIPN 102,A01,193429,Staff,0,0,32,32
1683352430805,BIPN 102,A02,193438,Staff,22,0,32,10
1683352431831,BIPN 106,A01,193450,Reyes Gonzalez; Catalina,0,2,40,40
1683352432857,BIPN 134,A01,193465,Cooke; James Edward,0,0,32,32
1683352432857,BIPN 134,A02,193474,Cooke; James Edward,25,0,32,7
1683352432857,BIPN 134,A03,193485,Cooke; James Edward,29,0,32,3
1683352432857,BIPN 134,A04,193486,Cooke; James Edward,21,0,32,11
1683352432857,BIPN 134,A05,193491,Cooke; James Edward,31,0,32,1
1683352432857,BIPN 134,A06,193501,Cooke; James Edward,30,0,32,2
1683352432857,BIPN 134,A07,193510,Cooke; James Edward,29,0,32,3
1683352434905,BISP 194,A00,222522,Staff,14,0,32,18
1683352435931,CAT 124,A01,202407,Staff,20,0,25,5
1683352436958,CAT 125,A00,202408,Marchisotto; Jennifer Anne,4,0,20,16
1683352437986,CAT 125R,A00,202409,Smith; Lauryn Alissa,0,11,20,20
1683352437986,CAT 125R,B00,202410,Morales; Celeste Georgianna,0,11,20,20
1683352437986,CAT 125R,C00,202411,Irwin; Matthew Joseph,0,10,20,20
1683352439014,CENG 15,A01,204712,Yang; Kesong,0,1,0,0
1683352440041,CENG 114,A00,202070,Jahed Motlagh; Zeinab,5,0,20,15
1683352441071,CGS 105,A00,185477,Wesling; Megan E.,24,0,40,16
1683352442099,CGS 106,A00,185494,Staff,13,0,22,9
1683352443123,CGS 108,A00,185495,Staff,14,0,20,6
1683352444147,CGS 114,A00,185496,Staff,13,0,18,5
1683352445170,CGS 119,A00,185501,Staff,15,0,20,5
1683352446194,CGS 120,A00,185511,Staff,13,0,20,7
1683352447218,CHEM 4,A01,184675,Bussey; Thomas J,96,0,100,4
1683352448246,CHEM 6A,A01,184677,Staff,34,0,60,26
1683352449272,CHEM 6B,A01,184679,Staff,65,0,100,35
1683352450370,CHEM 6C,A01,184681,Bussey; Thomas J,1,0,50,49
1683352450370,CHEM 6C,A02,184682,Bussey; Thomas J,34,0,50,16
1683352451395,CHEM 40A,A01,184684,Albizati; Kim F.,37,0,100,63
1683352452419,CHEM 40B,A01,184686,Albizati; Kim F.,0,20,100,100
1683352453441,CHEM 41B,A01,184690,Staff,52,0,100,48
1683352454465,COGS 3,A01,184715,Boyle; Mary E. T.,0,25,40,40
1683352455493,COGS 14B,A01,185172,Staff,0,15,38,38
1683352456519,COGS 18,A01,184736,Staff,17,0,80,63
1683352457543,COGS 100,A01,184932,Staff,0,5,73,73
1683352458572,COGS 101A,A01,184935,Staff,0,39,30,30
1683352459599,COGS 101B,A01,184944,Staff,0,2,30,30
1683352460622,COGS 101C,A01,184946,Staff,0,12,30,30
1683352461645,COGS 102A,A01,184951,Johnson; Christine M.,2,0,40,38
1683352462669,COGS 107B,A01,184953,Mooshagian; Eric Frederick,0,50,40,40
1683352463693,COGS 118B,A01,184959,Gupta; Anjum,0,48,40,40
1683352464720,COGS 153,A00,184961,Staff,0,15,30,30
1683352465744,COGS 177,A00,184962,Staff,0,20,30,30
1683352466767,COGS 187A,A01,184969,Boyle; Mary E. T.,0,17,40,40
1683352467791,COMM 10,A01,185174,Staff,0,5,25,25
1683352467791,COMM 10,A02,185189,Staff,0,5,25,25
1683352467791,COMM 10,A03,269821,Staff,0,0,0,0
1683352468818,COMM 100B,A01,185475,Staff,0,0,0,2
1683352468818,COMM 100B,A02,185476,Staff,13,0,25,12
1683352469846,COMM 100C,A01,185314,Staff,1,0,25,24
1683352469846,COMM 100C,A02,185327,Staff,19,0,25,6
1683352470872,COMM 110M,A00,185349,Staff,2,0,40,38
1683352471898,COMM 113T,A00,185352,Staff,24,0,40,16
1683352472924,COMM 114I,A00,185353,Staff,33,0,40,7
1683352473949,COMM 131,A00,185354,Staff,19,0,30,11
1683352474972,CSE 8A,A50,185358,Cao; Yingjun,0,46,10,10
1683352475998,CSE 8B,A01,185362,Staff,0,46,50,50
1683352477022,CSE 11,A01,185416,Cao; Yingjun,0,92,10,10
1683352478048,CSE 20,A01,185445,Briones; Jor-el Thomas Caparas,5,0,25,20
1683352479073,CSE 21,A01,185447,Staff,10,0,50,40
1683352480103,CSE 101,A01,185451,Staff,0,13,50,50
1683352480103,CSE 101,B01,185453,Jones; Miles E,0,11,50,50
1683352482150,CSE 141,A01,185458,Eldon; John,20,0,100,80
1683352483176,CSE 141L,A01,185461,Eldon; John,12,0,100,88
1683352484199,CSE 142,A01,185463,Staff,36,0,60,24
1683352484199,CSE 142,B01,201355,Staff,0,7,60,60
1683352485225,CSE 142L,A01,185470,Staff,36,0,60,24
1683352485225,CSE 142L,B01,201417,Staff,0,6,60,60
1683352486252,CSE 190,A00,201433,Staff,32,0,49,17
1683352487280,DOC 1,A01,259136,Strom; Megan C.,7,0,15,8
1683352487280,DOC 1,A02,259137,Strom; Megan C.,14,0,15,1
1683352487280,DOC 1,A03,259138,Strom; Megan C.,14,0,15,1
1683352487280,DOC 1,A04,259139,Strom; Megan C.,14,0,15,1
1683352488304,DOC 100D,A00,259140,Pass; Natalye Joann,16,0,25,9
1683352489327,DSGN 1,A01,184749,Rill; Bryan,0,25,30,30
1683352490354,DSGN 100,A01,185168,Staff,0,2,25,25
1683352491381,ECE 5,A01,185626,Morris; Karcher William,0,10,0,0
1683352492407,ECE 101,A01,185628,Staff,17,0,70,53
1683352493435,ECE 107,A01,185635,Baghdadchi; Saharnaz,0,0,20,20
1683352493435,ECE 107,A02,185638,Baghdadchi; Saharnaz,4,0,20,16
1683352494462,ECE 148,A01,185647,Silberman; Jack,0,0,16,16
1683352495489,ECON 1,A01,185537,Crane; Meredith Helen,54,0,70,16
1683352496512,ECON 3,A01,185549,Crane; Meredith Helen,32,0,70,38
1683352497534,ECON 4,A01,203354,Anderson; John Charles,0,4,10,10
1683352498558,ECON 100A,A01,185574,Staff,0,4,40,40
1683352499581,ECON 100B,A01,185576,Staff,0,12,50,50
1683352500604,ECON 100C,A01,185589,Newhouse; Herbert S,29,0,70,41
1683352501632,ECON 105,A00,185608,Vespa; Emanuel Ignacio,19,0,35,16
1683352502666,ECON 109,A01,185610,Shishkin; Denis,10,0,35,25
1683352503694,ECON 110A,A01,185612,Staff,11,0,40,29
1683352504721,ECON 120A,A01,185615,Staff,20,0,40,20
1683352505751,ECON 120C,A01,185617,Sun; Yixiao,0,21,70,70
1683352506775,ECON 144,A00,203346,Squires; Dale E,3,0,35,32
1683352507802,ECON 171,A01,203349,Newhouse; Herbert S,0,1,35,35
1683352508829,ECON 173A,A01,185621,Toda; Alexis Akira,21,0,35,14
1683352509859,EDS 25,A01,202413,Staff,0,1,0,0
1683352509859,EDS 25,A02,202414,Staff,0,1,0,0
1683352509859,EDS 25,A03,202415,Staff,0,0,0,0
1683352509859,EDS 25,A04,202416,Staff,0,1,0,0
1683352509859,EDS 25,A05,202439,Staff,0,0,0,0
1683352509859,EDS 25,A06,202440,Staff,0,0,0,0
1683352509859,EDS 25,B01,202631,Staff,0,0,0,0
1683352509859,EDS 25,B02,202632,Staff,0,0,0,0
1683352509859,EDS 25,B03,202639,Staff,0,0,0,0
1683352509859,EDS 25,B04,202640,Staff,0,0,0,0
1683352509859,EDS 25,B05,202643,Staff,0,0,0,0
1683352509859,EDS 25,B06,202644,Staff,0,0,0,0
1683352510883,EDS 38,A01,202659,Black; Alison Michelle,24,0,25,1
1683352511908,EDS 115,A00,202652,Staff,18,0,30,12
1683352512931,EDS 125,A00,202649,Staff,14,0,30,16
1683352513955,EDS 126,A01,203332,Staff,30,0,30,0
1683352514977,EDS 139,A00,202838,Staff,16,0,25,9
1683352516004,EDS 146,A01,202655,Staff,14,0,25,11
1683352517029,ENG 15,A00,185667,Staff,0,1,0,0
1683352517029,ENG 15,B00,185672,Staff,0,0,0,0
1683352517029,ENG 15,C00,185675,Staff,0,0,0,0
1683352517029,ENG 15,D00,185682,Staff,0,0,0,0
1683352517029,ENG 15,E00,185684,Staff,0,0,0,0
1683352518053,ETHN 103,A00,185710,Staff,0,4,35,35
1683352519077,ETHN 103A,A00,199228,Man; Simeon S,2,0,9,7
1683352520101,ETHN 109,A00,185711,Staff,18,0,35,17
1683352521123,ETHN 142,A00,185726,Staff,0,4,30,30
1683352522146,ETHN 163J,A00,199229,Man; Simeon S,5,0,8,3
1683352523169,ETHN 168,A00,185727,Staff,8,0,10,2
1683352524193,ETHN 182,A00,185728,Staff,0,0,35,35
1683352525216,ETHN 183,A00,185737,Staff,8,0,18,10
1683352526238,GLBH 111,A01,209361,Burgos; Jose L.,0,0,0,0
1683352528292,HIEU 104,A00,185792,Staff,16,0,20,4
1683352529319,HIEU 115,A00,185800,Staff,1,0,20,19
1683352530345,HIEU 128,A00,185801,Staff,0,7,20,20
1683352531367,HIEU 147,A00,185802,Staff,16,0,20,4
1683352532390,HIEU 154,A00,185823,Staff,12,0,20,8
1683352533414,HILA 102,A00,185826,Staff,13,0,20,7
1683352534437,HILD 2C,A01,185778,Staff,0,12,20,20
1683352535461,HILD 7B,A01,185780,Kwak; Nancy,0,15,32,32
1683352535461,HILD 7B,A02,185781,Kwak; Nancy,0,18,32,32
1683352536485,HILD 30,A01,185791,Staff,14,0,20,6
1683352537509,HISC 119,A00,185830,Golan; Tal,0,9,20,20
1683352538534,HITO 156GS,A00,185831,Patterson; Patrick H.,0,0,0,23
1683352539561,HIUS 103,A00,185832,Man; Simeon S,0,6,20,20
1683352540584,HIUS 117,A00,185836,Kwak; Nancy,2,0,20,18
1683352541612,HIUS 125,A00,185840,Man; Simeon S,0,0,23,23
1683352542634,HIUS 149,A00,185845,Staff,0,0,20,20
1683352543657,HUM 3,A01,185882,Zavodny; Tatiana Sophia,0,7,50,50
1683352543657,HUM 3,B01,185899,Caldwell; Michael Alan,0,18,50,50
1683352544681,HUM 3GS,A00,185900,Patterson; Patrick H.,0,0,0,23
1683352545706,HUM 4,A01,185938,Zroka; Amy Liane,31,0,50,19
1683352545706,HUM 4,B01,185956,Watkins; Eric,0,3,50,50
1683352545706,HUM 4,B02,202209,Watkins; Eric,0,2,50,50
1683352545706,HUM 4,B03,202210,Watkins; Eric,0,2,50,50
1683352546734,HUM 5,A01,185958,West; Geoffrey Scott,3,0,50,47
1683352546734,HUM 5,A02,202215,West; Geoffrey Scott,0,0,50,50
1683352547756,INTL 190,A00,185959,Gagnon; Jeffrey C,0,0,0,9
1683352547756,INTL 190,B00,185960,Lettieri; Michael Joseph,0,0,0,1
1683352548783,JAPN 180,A00,254509,Staff,4,0,30,26
1683352549807,LATI 10,A01,202853,Kennemore; Amy Michelle,4,0,35,31
1683352549807,LATI 10,A02,202854,Kennemore; Amy Michelle,2,0,35,33
1683352549807,LATI 10,A03,270054,Kennemore; Amy Michelle,30,0,30,0
1683352550831,LATI 180,A00,202855,Kennemore; Amy Michelle,11,0,20,9
1683352551855,LAWS 101,A00,201767,Golan; Tal,0,7,40,40
1683352552880,LIFR 1C,A00,185961,Staff,6,0,20,14
1683352553961,LIFR 1CX,A00,185962,Staff,7,0,20,13
1683352554984,LIFR 1D,A00,185963,Staff,9,0,20,11
1683352556014,LIFR 1DX,A00,185964,Staff,9,0,20,11
1683352557041,LIGN 101,A01,186039,Staff,43,0,50,7
1683352558065,LIGN 165,A00,186040,Staff,18,0,50,32
1683352559089,LTCS 108,A00,186041,Staff,6,0,10,4
1683352560113,LTCS 119,A00,186042,Staff,16,0,20,4
1683352561140,LTCS 130,A00,186043,Wesling; Megan E.,15,0,25,10
1683352563188,LTEA 138,A00,186119,Staff,14,0,40,26
1683352564212,LTEN 124,A00,186148,Staff,6,0,25,19
1683352565237,LTEN 178,A00,186149,Staff,7,0,15,8
1683352566264,LTEN 181,A00,186150,Blanco; John D,33,0,40,7
1683352567288,LTWL 120,A00,186160,Staff,20,0,25,5
1683352568315,LTWL 165,A00,186161,Staff,22,0,25,3
1683352569339,LTWR 100,A00,186162,Staff,0,5,15,15
1683352570360,LTWR 102,A00,186163,Doller; Ben,5,0,15,10
1683352571387,MAE 8,A01,186412,Staff,0,0,0,0
1683352572412,MAE 30B,A00,186445,Bahadori; Mohammad Yousef,83,0,100,17
1683352573439,MAE 40,A00,186592,Bewley; Thomas R,9,0,50,41
1683352574463,MAE 101B,A00,186593,Bahadori; Mohammad Yousef,81,0,100,19
1683352575487,MAE 105,A00,186594,Bandaru; Prabhakar,12,0,50,38
1683352576513,MAE 107,A00,186599,Pham; Hieu Tan,0,6,120,120
1683352577536,MAE 148,A01,186660,Silberman; Jack,3,0,16,13
1683352578560,MATH 10A,A01,188095,Staff,0,5,35,35
1683352579586,MATH 10B,A01,188097,Bowers; Adam R.,0,11,30,30
1683352579586,MATH 10B,A02,188099,Bowers; Adam R.,0,11,30,30
1683352579586,MATH 10B,B01,188104,Bowers; Adam R.,0,10,30,30
1683352579586,MATH 10B,B02,188106,Bowers; Adam R.,0,10,30,30
1683352580612,MATH 10C,A01,188111,Staff,0,18,30,30
1683352580612,MATH 10C,A02,188127,Staff,0,17,30,30
1683352580612,MATH 10C,A03,188131,Staff,0,18,30,30
1683352580612,MATH 10C,B01,188218,Staff,18,0,30,12
1683352580612,MATH 10C,B02,188244,Staff,13,0,30,17
1683352580612,MATH 10C,B03,188277,Staff,16,0,30,14
1683352581640,MATH 18,A01,188344,Bach; Quang Tran,18,0,30,12
1683352581640,MATH 18,A02,188345,Bach; Quang Tran,11,0,30,19
1683352581640,MATH 18,B01,188353,Bach; Quang Tran,10,0,30,20
1683352581640,MATH 18,B02,188354,Bach; Quang Tran,20,0,30,10
1683352582666,MATH 20A,A01,188374,Staff,12,0,35,23
1683352583691,MATH 20B,A01,188382,Ohm; Ko Woon,6,0,30,24
1683352583691,MATH 20B,A02,188383,Ohm; Ko Woon,22,0,30,8
1683352583691,MATH 20B,B01,188385,Ohm; Ko Woon,7,0,30,23
1683352583691,MATH 20B,B02,188392,Ohm; Ko Woon,22,0,30,8
1683352584715,MATH 20C,A01,188394,Harel; Guershon,10,0,30,20
1683352584715,MATH 20C,A02,188395,Harel; Guershon,15,0,30,15
1683352584715,MATH 20C,B01,188404,Harel; Guershon,4,0,30,26
1683352584715,MATH 20C,B02,188405,Harel; Guershon,19,0,30,11
1683352585744,MATH 20D,A01,188414,Hammock; Frances H,0,1,30,30
1683352585744,MATH 20D,A02,188415,Hammock; Frances H,3,0,30,27
1683352585744,MATH 20D,B01,188447,Hammock; Frances H,1,0,30,29
1683352585744,MATH 20D,B02,188486,Hammock; Frances H,8,0,30,22
1683352586769,MATH 20E,A01,188649,Staff,21,0,30,9
1683352586769,MATH 20E,A02,188650,Staff,23,0,30,7
1683352586769,MATH 20E,A03,188673,Staff,0,0,30,30
1683352587793,MATH 102,A01,188675,Staff,0,35,35,35
1683352588820,MATH 103B,A01,188681,Staff,3,0,35,32
1683352588820,MATH 103B,B01,188692,Staff,5,0,35,30
1683352589846,MATH 109,A01,188695,Salehi Golsefidy; Alireza,25,0,35,10
1683352589846,MATH 109,A02,188696,Salehi Golsefidy; Alireza,25,0,35,10
1683352590874,MATH 120A,A01,188698,Eggers; John Dietrich,7,0,35,28
1683352591897,MATH 142B,A01,188736,Ioana; Adrian,0,2,30,30
1683352591897,MATH 142B,A02,188741,Ioana; Adrian,0,0,30,30
1683352591897,MATH 142B,A03,188743,Ioana; Adrian,0,1,30,30
1683352592921,MATH 168A,A01,188790,Staff,0,9,35,35
1683352593948,MATH 170A,A01,188803,Nie; Jiawang,0,2,35,35
1683352593948,MATH 170A,A02,188811,Nie; Jiawang,0,0,35,35
1683352593948,MATH 170A,A03,188814,Nie; Jiawang,1,0,35,34
1683352593948,MATH 170A,A04,188815,Nie; Jiawang,13,0,35,22
1683352594979,MATH 193B,A01,188817,Staff,0,0,35,35
1683352594979,MATH 193B,A02,188818,Staff,5,0,35,30
1683352596007,MGT 4,A01,202857,Anderson; John Charles,62,0,80,18
1683352597034,MGT 12,A00,202858,Lindenberger; Wade Douglas,42,0,90,48
1683352598059,MGT 18,A00,202859,Staff,74,0,90,16
1683352599085,MGT 18GS,A00,202860,McKay; Michael J,13,0,28,15
1683352600113,MGT 45,A00,202861,Pecore; Joseph P.,14,0,90,76
1683352601139,MGT 100,A00,202863,Yavorsky; Daniel Ryan,28,0,90,62
1683352602166,MGT 103,A00,202864,Ehrich; Kristine R,0,17,90,90
1683352603193,MGT 112,A00,202865,Ehrich; Kristine R,15,0,90,75
1683352604223,MGT 121A,A00,202868,Staff,0,20,0,0
1683352605248,MGT 131B,A00,202869,Anderson; John Charles,59,0,90,31
1683352606271,MGT 136,A00,202871,Lindenberger; Wade Douglas,84,0,90,6
1683352607299,MGT 164,A00,202873,Staff,0,68,90,91
1683352608325,MGT 164GS,A00,202874,McKay; Mary A,13,0,28,15
1683352609347,MGT 180,A00,202875,Staff,0,50,90,91
1683352610371,MMW 11R,A01,205019,Herbst; Matthew,3,0,30,27
1683352610371,MMW 11R,A02,205026,Herbst; Matthew,29,0,30,1
1683352611398,MMW 15,A01,193512,Chang; Edmond Yi-Teh,0,9,28,28
1683352611398,MMW 15,A02,193513,Chang; Edmond Yi-Teh,0,5,28,28
1683352611398,MMW 15,A03,193514,Chang; Edmond Yi-Teh,0,5,28,28
1683352611398,MMW 15,A04,193515,Chang; Edmond Yi-Teh,0,5,28,28
1683352611398,MMW 15,A05,193516,Chang; Edmond Yi-Teh,0,4,28,28
1683352611398,MMW 15,A06,193517,Chang; Edmond Yi-Teh,0,5,28,28
1683352611398,MMW 15,B01,193519,Chang; Edmond Yi-Teh,0,5,28,28
1683352611398,MMW 15,B02,193520,Chang; Edmond Yi-Teh,0,5,28,28
1683352611398,MMW 15,B03,193521,Chang; Edmond Yi-Teh,0,5,28,28
1683352611398,MMW 15,B04,193522,Chang; Edmond Yi-Teh,0,4,28,28
1683352611398,MMW 15,B05,193523,Chang; Edmond Yi-Teh,0,5,28,28
1683352611398,MMW 15,B06,193524,Chang; Edmond Yi-Teh,0,4,28,28
1683352612424,MMW 122,A01,193526,Rahimi; Babak,0,15,28,28
1683352612424,MMW 122,A02,193527,Rahimi; Babak,0,14,28,28
1683352612424,MMW 122,A03,193528,Rahimi; Babak,0,0,0,0
1683352612424,MMW 122,A04,193529,Rahimi; Babak,0,0,0,0
1683352613449,MUS 1A,A01,186663,Staff,0,20,35,35
1683352614471,MUS 4,A01,186715,Staff,0,12,35,35
1683352615494,MUS 5R,A01,186796,Dubnov; Shlomo,0,17,35,35
1683352616517,MUS 6,A01,186798,Staff,0,4,25,25
1683352617543,MUS 7,A01,186830,Staff,13,0,35,22
1683352618569,MUS 8,A01,186930,Staff,0,26,35,35
1683352619596,MUS 15,A01,186932,Staff,0,16,35,35
1683352619596,MUS 15,B01,186934,Staff,0,15,35,35
1683352620622,MUS 80,A00,186935,Staff,1,0,20,19
1683352620622,MUS 80,B00,186936,Staff,25,0,25,0
1683352621650,NANO 11,A00,204702,Lipomi; Darren John,0,0,0,0
1683352622675,NANO 15,A01,204709,Yang; Kesong,0,1,0,0
1683352623698,NANO 114,A00,202069,Jahed Motlagh; Zeinab,3,0,10,7
1683352624724,PHIL 1,A00,186955,Grush; Rick Scott,32,0,40,8
1683352625749,PHIL 10,A01,186973,Grush; Rick Scott,28,0,35,7
1683352625749,PHIL 10,A02,186974,Grush; Rick Scott,33,0,35,2
1683352626776,PHIL 13,A01,186976,Staff,7,0,35,28
1683352626776,PHIL 13,A02,186977,Staff,16,0,35,19
1683352627800,PHIL 14,A01,186979,Staff,31,0,35,4
1683352627800,PHIL 14,A02,186986,Staff,32,0,35,3
1683352628824,PHIL 28,A01,186988,Staff,16,0,30,14
1683352628824,PHIL 28,A02,186989,Staff,1,0,30,29
1683352628824,PHIL 28,A03,186990,Staff,9,0,30,21
1683352628824,PHIL 28,A04,186991,Staff,26,0,30,4
1683352629850,PHIL 120,A00,186997,Staff,23,0,40,17
1683352630873,PHIL 137,A00,187003,Staff,9,0,40,31
1683352631898,PHIL 150,A00,187015,Staff,47,0,70,23
1683352632922,PHIL 167,A00,187021,Lamey; Andy M.,35,0,40,5
1683352633946,PHIL 174,A01,202226,Staff,17,0,20,3
1683352633946,PHIL 174,A02,202235,Staff,20,0,20,0
1683352634970,PHIL 191A,A00,258918,Staff,0,0,1,1
1683352635997,PHYS 1A,A00,187028,Staff,27,0,60,33
1683352637023,PHYS 1AL,001,187036,Staff,2,0,30,28
1683352637023,PHYS 1AL,002,187049,Staff,18,0,30,12
1683352638049,PHYS 1B,A00,187058,Staff,22,0,60,38
1683352639074,PHYS 1BL,001,187064,Staff,0,0,30,30
1683352639074,PHYS 1BL,002,187070,Staff,5,0,30,25
1683352640098,PHYS 1C,A00,187082,Staff,31,0,120,89
1683352641123,PHYS 1CL,001,187088,Staff,0,9,30,30
1683352641123,PHYS 1CL,002,187089,Staff,0,2,30,30
1683352641123,PHYS 1CL,009,262693,Staff,11,0,30,19
1683352642148,PHYS 2B,A01,187097,Staff,54,0,115,61
1683352643175,PHYS 2C,A01,187099,Staff,67,0,115,48
1683352644199,PHYS 2CL,A01,187101,Staff,5,0,28,23
1683352644199,PHYS 2CL,A02,187102,Staff,15,0,28,13
1683352645223,PHYS 2D,A01,187123,Shotwell; Brian,95,0,115,20
1683352646247,PHYS 4B,A01,187133,Grinstein; Benjamin,35,0,50,15
1683352647274,POLI 10,A00,188819,Staff,0,4,50,50
1683352648298,POLI 11,A00,188827,Staff,43,0,50,7
1683352649324,POLI 13R,A00,188828,Staff,0,1,20,20
1683352650348,POLI 27,A01,188830,Elgin; Samuel Zincke,0,1,70,70
1683352651374,POLI 30,A00,188832,Desposato; Scott,31,0,50,19
1683352652398,POLI 102F,A00,188834,Staff,3,0,40,37
1683352653422,POLI 104A,A00,188852,Staff,14,0,30,16
1683352654445,POLI 104I,A00,188853,Staff,0,6,20,20
1683352655469,POLI 110B,A00,188854,Wiens; David,7,0,20,13
1683352656496,POLI 112A,A00,188855,Wiens; David,5,0,30,25
1683352657578,POLI 117R,A00,188856,Forman; Fonna,0,11,20,20
1683352658602,POLI 118,A00,188857,Ingham; Sean,8,0,20,12
1683352659628,POLI 120G,A00,188858,Staff,9,0,30,21
1683352660654,POLI 131CR,A00,188863,Hoston; Germaine,24,0,50,26
1683352661683,POLI 133,A00,188864,Nellis; Gareth Hb,44,0,50,6
1683352662707,POLI 134D,A00,188865,Desposato; Scott,27,0,30,3
1683352663734,POLI 142A,A00,188871,Gartzke; Erik,22,0,50,28
1683352664759,POLI 142K,A00,188874,Staff,38,0,50,12
1683352665789,POLI 143,A00,188940,Gartzke; Erik,16,0,30,14
1683352666812,POLI 153,A00,188943,Staff,3,0,20,17
1683352667835,POLI 160AA,A00,188944,Staff,11,0,40,29
1683352668862,POLI 170A,A00,188945,Staff,11,0,30,19
1683352670917,PSYC 1,A00,188952,Staff,37,0,90,53
1683352671941,PSYC 2,B00,188953,Staff,19,0,35,16
1683352672967,PSYC 6,A00,188970,Staff,47,0,60,13
1683352673992,PSYC 7,A00,188973,Staff,37,0,45,8
1683352675017,PSYC 60,A01,188980,Rickard; Timothy C.,43,0,60,17
1683352676045,PSYC 70,A01,189001,Steiner; Eric Tomas,23,0,45,22
1683352677068,PSYC 100,A00,189005,Lacefield; Katharine I,0,98,120,120
1683352678093,PSYC 102,A00,189008,Staff,9,0,30,21
1683352679118,PSYC 106,B00,189026,Gorman; Michael R.,34,0,60,26
1683352680142,PSYC 114,B01,189033,Winkielman; Piotr,0,32,30,30
1683352681164,PSYC 131,A00,189036,Anagnostaras; Stephan,0,43,60,60
1683352682187,PSYC 136,A00,189041,Lowe; Angela Beth,0,7,25,25
1683352683212,PSYC 137,A00,189057,Winkielman; Piotr,0,34,25,25
1683352684235,PSYC 144,A00,189107,Wixted; John T,0,7,50,50
1683352686284,PSYC 162,A00,189142,Staff,0,8,85,85
1683352687307,PSYC 172,A00,189144,Gorman; Michael R.,0,7,30,30
1683352689360,PSYC 179,A00,189146,Lacefield; Katharine I,0,84,120,120
1683352690384,PSYC 181,A00,189147,Anagnostaras; Stephan,0,44,90,90
1683352691411,PSYC 190R,A00,189148,Barner; David A.,0,22,80,80
1683352692436,PSYC 191,A00,189275,Rickard; Timothy C.,0,7,25,25
1683352693460,PSYC 193,A00,189276,Chapman; Eddie Nathaniel,0,1,0,4
1683352694489,PSYC 193L,A01,189281,Lowe; Angela Beth,12,0,20,8
1683352694489,PSYC 193L,B01,189285,Staff,28,0,35,7
1683352695512,RELI 149,A00,187137,Rahimi; Babak,7,0,40,33
1683352696539,SE 9,A01,187315,Staff,0,2,18,18
1683352697563,SE 101B,A00,187409,Staff,24,0,30,6
1683352698591,SE 110B,A00,187444,Staff,10,0,40,30
1683352699616,SE 130B,A00,187449,Staff,31,0,40,9
1683352700647,SE 150A,A00,187516,Staff,9,0,20,11
1683352701671,SE 154,A00,187528,Staff,30,0,50,20
1683352702698,SIO 3,A01,258171,Staff,35,0,40,5
1683352703721,SIO 10,A00,187144,Cook; Geoffrey W,0,3,75,75
1683352704746,SIO 45,A00,187152,Cook; Geoffrey W,1,0,100,99
1683352705773,SIO 109R,A00,194486,Staff,0,3,20,20
1683352707824,SIO 187,A01,187233,Kacev; David,12,0,40,28
1683352708849,SOCI 1,A01,258656,Thorpe; Charles Robert,28,0,30,2
1683352708849,SOCI 1,A02,258658,Thorpe; Charles Robert,30,0,30,0
1683352708849,SOCI 1,A03,258661,Thorpe; Charles Robert,25,0,25,0
1683352708849,SOCI 1,A04,258666,Thorpe; Charles Robert,22,0,25,3
1683352708849,SOCI 1,A05,258897,Thorpe; Charles Robert,23,0,25,2
1683352708849,SOCI 1,A06,258898,Thorpe; Charles Robert,25,0,25,0
1683352709876,SOCI 30,A01,258903,Pardo Guerra; Juan Pablo,15,0,30,15
1683352710900,SOCI 102,A00,258904,Staff,9,0,25,16
1683352711923,SOCI 106,A00,258905,Staff,19,0,25,6
1683352712945,SOCI 111,A00,258907,Ribas Norris; Janet Vanesa,26,0,30,4
1683352713970,SOCI 121R,A00,258908,Pardo Guerra; Juan Pablo,10,0,30,20
1683352714994,SOCI 126,A01,203330,Staff,14,0,20,6
1683352716019,SOCI 131,A00,258909,Thorpe; Charles Robert,31,0,60,29
1683352717043,SOCI 135,A00,258910,Payne; Christine Anna,0,9,30,30
1683352718068,SOCI 157,A00,258911,Staff,12,0,30,18
1683352719092,SOCI 184,A00,258912,Staff,25,0,30,5
1683352720115,SOCI 188D,A00,258913,Staff,22,0,30,8
1683352721141,SYN 2,001,187529,Staff,10,0,16,6
1683352721141,SYN 2,002,201452,Staff,0,18,16,16
1683352721141,SYN 2,003,201469,Staff,3,0,16,13
1683352722168,SYN 100,A01,187531,Staff,0,9,20,20
1683352722168,SYN 100,B01,201491,Staff,0,12,20,20
1683352723190,TDAC 1,A00,189286,Walsh; Kim C.,3,0,20,17
1683352723190,TDAC 1,B00,189287,Harting; Carla Kelso,11,0,20,9
1683352724213,TDAC 101,A00,189300,Walsh; Kim C.,16,0,20,4
1683352724213,TDAC 101,B00,189301,Harting; Carla Kelso,18,0,20,2
1683352725240,TDAC 102,A00,189304,Basso; Beatrice,14,0,20,6
1683352726263,TDAC 108,A00,189305,Staff,18,0,20,2
1683352727288,TDDE 131,A00,189310,Staff,19,0,20,1
1683352727288,TDDE 131,B00,189314,Staff,19,0,20,1
1683352727288,TDDE 131,C00,189315,Staff,48,0,50,2
1683352727288,TDDE 131,D00,189316,Staff,14,0,15,1
1683352727288,TDDE 131,E00,204841,Staff,20,0,20,0
1683352728312,TDGE 10,A00,189289,Staff,30,0,50,20
1683352728312,TDGE 10,B00,189290,Havis; Allan,1,0,50,49
1683352729335,TDGE 11,A00,189291,Fulton; Julia,0,3,50,50
1683352729335,TDGE 11,B00,189292,Staff,20,0,25,5
1683352729335,TDGE 11,C00,260270,Staff,0,0,0,0
1683352730362,TDGE 25,A00,189294,Staff,3,0,20,17
1683352731386,TDGE 124,A00,189318,Fulton; Julia,0,8,50,50
1683352732410,TDGE 125,A00,189319,Staff,13,0,25,12
1683352732410,TDGE 125,B00,189320,Staff,23,0,25,2
1683352733438,TDGE 127,A00,189322,Havis; Allan,0,0,50,50
1683352734462,TDHT 101,A00,189323,Staff,18,0,25,7
1683352734462,TDHT 101,B00,189324,Staff,25,0,25,0
1683352735485,TDHT 102,A00,189325,Staff,49,0,50,1
1683352736509,TDMV 1,A00,189295,Arcidiacono; Kristin,19,0,30,11
1683352736509,TDMV 1,B00,189296,Caligagan; Maria T.,24,0,30,6
1683352737533,TDMV 2,A00,189297,Sammartano; Tonnie,28,0,30,2
1683352737533,TDMV 2,B00,189299,Arcidiacono; Kristin,24,0,30,6
1683352738555,TDMV 3,A00,204998,Rincon; Alicia,22,0,30,8
1683352739579,TDMV 120,A00,189458,Sammartano; Tonnie,28,0,30,2
1683352740603,TDMV 138,A00,189541,Jun; Grace Shin Hae,22,0,40,18
1683352741631,TDMV 142,A00,189717,Caligagan; Tony,23,0,30,7
1683352741631,TDMV 142,B00,189718,Caligagan; Maria T.,25,0,30,5
1683352742654,TMC 2,A01,187533,Staff,25,0,25,0
1683352742654,TMC 2,A02,187534,Staff,25,0,25,0
1683352743678,USP 1,A01,187536,Kwak; Nancy,0,16,25,25
1683352744703,USP 5,A01,187538,Staff,10,0,25,15
1683352745727,USP 101,A00,199253,Staff,0,4,0,0
1683352746752,USP 124,A00,187562,Boomhower; Matthew Charles,1,0,30,29
1683352747775,USP 138,A00,187582,Staff,20,0,25,5
1683352748799,USP 152,A01,187597,Staff,4,0,25,21
1683352749823,USP 153,A00,187598,Staff,19,0,25,6
1683352750850,USP 168,A00,187607,Kwak; Nancy,2,0,5,3
1683352751877,USP 173,A00,187619,Staff,4,0,25,21
1683352752900,USP 181,A00,187638,Staff,0,2,25,25
1683352753924,VIS 103,A00,187650,Cruz; Edwin Teddy,22,0,75,53
1683352754947,VIS 110D,A00,187669,Staff,12,0,22,10
1683352755974,VIS 127C,A00,187720,Shen; Kuiyi,67,0,146,79
1683352757001,VIS 149,A00,187731,Yoldas; Pinar,0,14,22,22
1683352758028,VIS 151,A01,188091,Staff,22,0,34,12
1683352758028,VIS 151,A02,188092,Staff,11,0,34,23
1683352759052,VIS 160B,A00,188093,Stalbaum; Brett,0,0,10,10
1683352761156,WCWP 10B,A00,201720,Staff,10,0,15,5
1683352761156,WCWP 10B,B00,201722,Staff,9,0,15,6
1683352762179,WCWP 100,A00,201725,Gagnon; Jeffrey C,0,0,2,2
1683352762179,WCWP 100,B00,201727,Staff,0,4,15,15
1683352765301,ANBI 133,A00,258401,Wilder; Linnea Lorene,34,0,40,6
1683352766328,ANBI 140,A00,258395,Hrvoj Mihic; Branka,18,0,25,7
1683352767354,ANSC 120,A00,258402,Bialecki; Jon Anthony,27,0,40,13
1683352768379,ANSC 144,A00,258400,Staff,14,0,40,26
1683352770429,ANSC 166,A00,258396,Parish; Steven Martin,157,0,175,18
1683352771452,ANSC 180,A00,193533,Staff,9,0,20,11
1683352772475,ANSC 188,A00,258397,Jassal; Aftab,33,0,40,7
1683352773499,ANTH 3,A01,258316,Staff,23,0,30,7
1683352774525,ANTH 5,A00,258394,Semendeferi; Ekaterini,16,0,20,4
1683352775552,ANTH 21,A01,258331,Staff,8,0,40,32
1683352776579,ANTH 103,A00,258398,Varma; Saiba,15,0,25,10
1683352777609,AWP 10,001,202034,Staff,0,0,0,0
1683352777609,AWP 10,002,202035,Staff,0,0,0,0
1683352777609,AWP 10,003,202036,Staff,0,0,0,0
1683352777609,AWP 10,004,202037,Staff,0,0,0,0
1683352777609,AWP 10,005,202038,Staff,0,0,0,0
1683352777609,AWP 10,006,202039,Staff,0,0,0,0
1683352777609,AWP 10,007,202040,Staff,0,0,0,0
1683352777609,AWP 10,008,202041,Staff,0,0,0,0
1683352777609,AWP 10,009,202042,Staff,0,0,0,0
1683352777609,AWP 10,010,202043,Staff,0,0,0,0
1683352777609,AWP 10,011,202044,Staff,0,0,0,0
1683352777609,AWP 10,012,202045,Staff,0,0,0,0
1683352777609,AWP 10,013,202046,Staff,0,0,0,0
1683352777609,AWP 10,014,202047,Staff,0,0,0,0
1683352777609,AWP 10,015,202048,Staff,0,0,0,0
1683352777609,AWP 10,016,202049,Staff,0,0,0,0
1683352777609,AWP 10,017,202050,Staff,0,0,0,0
1683352777609,AWP 10,018,202051,Staff,0,0,0,0
1683352777609,AWP 10,019,202052,Staff,0,0,0,0
1683352777609,AWP 10,020,202053,Staff,0,0,0,0
1683352777609,AWP 10,021,202054,Staff,0,0,0,0
1683352777609,AWP 10,022,202055,Staff,0,0,0,0
1683352777609,AWP 10,023,202056,Staff,0,0,0,0
1683352777609,AWP 10,024,202057,Staff,0,0,0,0
1683352777609,AWP 10,025,202058,Staff,0,0,0,0
1683352777609,AWP 10,026,202059,Staff,0,0,0,0
1683352778636,AWP 102,001,202032,Staff,0,0,0,0
1683352778636,AWP 102,002,202033,Staff,0,0,0,0
1683352779660,BENG 100,A01,254234,Taylor Amos; Alyssa C,31,0,40,9
1683352780684,BENG 196,001,270013,Engler; Adam J.,9999,0,9999,0
1683352781714,BICD 100R,A01,202018,Smith; Laurie,0,7,32,32
1683352781714,BICD 100R,A02,202019,Smith; Laurie,0,2,32,32
1683352781714,BICD 100R,A03,202020,Smith; Laurie,0,1,32,32
1683352781714,BICD 100R,A04,202021,Smith; Laurie,9,0,32,23
1683352781714,BICD 100R,A05,202022,Smith; Laurie,12,0,32,20
1683352782741,BICD 136,A01,193242,Gustafson-Brown; Cindy,0,2,32,32
1683352782741,BICD 136,A02,193244,Gustafson-Brown; Cindy,14,0,32,18
1683352783766,BIEB 102,A01,193249,Butler; Shannon Rhey,0,2,32,32
1683352783766,BIEB 102,A02,193251,Butler; Shannon Rhey,0,0,32,32
1683352783766,BIEB 102,A03,193253,Butler; Shannon Rhey,0,1,32,32
1683352783766,BIEB 102,A04,193255,Butler; Shannon Rhey,17,0,32,15
1683352783766,BIEB 102,A05,193265,Butler; Shannon Rhey,26,0,32,6
1683352783766,BIEB 102,A06,193269,Butler; Shannon Rhey,16,0,32,16
1683352785822,BIEB 150,A01,193274,Staff,0,0,32,32
1683352785822,BIEB 150,A02,193285,Staff,23,0,32,9
1683352786849,BIEB 194,A00,193286,Kurle; Carolyn M.,22,0,32,10
1683352787877,BILD 1,A01,192291,Staff,16,0,32,16
1683352787877,BILD 1,A02,192292,Staff,30,0,32,2
1683352787877,BILD 1,B01,192520,Reuther; Keefe,0,1,0,0
1683352787877,BILD 1,B02,192532,Reuther; Keefe,0,1,0,0
1683352788903,BILD 3,A01,192556,Butler; Shannon Rhey,0,0,32,32
1683352788903,BILD 3,A02,192581,Butler; Shannon Rhey,4,0,32,28
1683352788903,BILD 3,A03,192611,Butler; Shannon Rhey,23,0,32,9
1683352788903,BILD 3,A04,192612,Butler; Shannon Rhey,25,0,32,7
1683352788903,BILD 3,A05,192613,Butler; Shannon Rhey,27,0,32,5
1683352788903,BILD 3,A06,192679,Butler; Shannon Rhey,27,0,32,5
1683352788903,BILD 3,A07,192682,Butler; Shannon Rhey,22,0,32,10
1683352789928,BILD 4,A01,192836,Reuther; Keefe,0,0,24,24
1683352789928,BILD 4,A02,193044,Reuther; Keefe,4,0,24,20
1683352790952,BILD 10,A01,193142,Gustafson-Brown; Cindy,30,0,32,2
1683352790952,BILD 10,A02,193149,Gustafson-Brown; Cindy,31,0,32,1
1683352791976,BIMM 100,A01,193301,Staff,0,6,32,32
1683352791976,BIMM 100,A02,193312,Staff,0,5,32,32
1683352791976,BIMM 100,A03,193323,Staff,0,8,32,32
1683352793001,BIMM 101,A01,193329,McDonnell; Lisa Marie,0,3,24,24
1683352793001,BIMM 101,A02,193339,McDonnell; Lisa Marie,0,3,24,24
1683352793001,BIMM 101,B01,193354,McDonnell; Lisa Marie,0,3,24,24
1683352793001,BIMM 101,B02,193357,McDonnell; Lisa Marie,0,3,24,24
1683352794027,BIMM 110,A01,193377,Tat; John,0,11,32,32
1683352794027,BIMM 110,A02,193378,Tat; John,0,9,32,32
1683352795054,BIMM 120,A01,206116,Staff,0,0,32,32
1683352795054,BIMM 120,A02,206117,Staff,8,0,32,24
1683352795054,BIMM 120,A03,206121,Staff,21,0,32,11
1683352796082,BIPN 100,A01,193393,Park; Ji Young,0,14,32,32
1683352796082,BIPN 100,A02,193402,Park; Ji Young,0,13,32,32
1683352796082,BIPN 100,A03,193413,Park; Ji Young,0,14,32,32
1683352796082,BIPN 100,A04,193414,Park; Ji Young,0,13,32,32
1683352797105,BIPN 102,A01,193429,Staff,0,0,32,32
1683352797105,BIPN 102,A02,193438,Staff,22,0,32,10
1683352798127,BIPN 106,A01,193450,Reyes Gonzalez; Catalina,0,2,40,40
1683352799156,BIPN 134,A01,193465,Cooke; James Edward,0,0,32,32
1683352799156,BIPN 134,A02,193474,Cooke; James Edward,25,0,32,7
1683352799156,BIPN 134,A03,193485,Cooke; James Edward,29,0,32,3
1683352799156,BIPN 134,A04,193486,Cooke; James Edward,21,0,32,11
1683352799156,BIPN 134,A05,193491,Cooke; James Edward,31,0,32,1
1683352799156,BIPN 134,A06,193501,Cooke; James Edward,30,0,32,2
1683352799156,BIPN 134,A07,193510,Cooke; James Edward,29,0,32,3
1683352801203,BISP 194,A00,222522,Staff,14,0,32,18
1683352802227,CAT 124,A01,202407,Staff,20,0,25,5
1683352803250,CAT 125,A00,202408,Marchisotto; Jennifer Anne,4,0,20,16
1683352804278,CAT 125R,A00,202409,Smith; Lauryn Alissa,0,11,20,20
1683352804278,CAT 125R,B00,202410,Morales; Celeste Georgianna,0,11,20,20
1683352804278,CAT 125R,C00,202411,Irwin; Matthew Joseph,0,10,20,20
1683352805300,CENG 15,A01,204712,Yang; Kesong,0,1,0,0
1683352806327,CENG 114,A00,202070,Jahed Motlagh; Zeinab,5,0,20,15
1683352807351,CGS 105,A00,185477,Wesling; Megan E.,24,0,40,16
1683352808376,CGS 106,A00,185494,Staff,13,0,22,9
1683352809403,CGS 108,A00,185495,Staff,14,0,20,6
1683352810427,CGS 114,A00,185496,Staff,13,0,18,5
1683352811454,CGS 119,A00,185501,Staff,15,0,20,5
1683352812480,CGS 120,A00,185511,Staff,13,0,20,7
1683352813505,CHEM 4,A01,184675,Bussey; Thomas J,96,0,100,4
1683352814530,CHEM 6A,A01,184677,Staff,34,0,60,26
1683352815554,CHEM 6B,A01,184679,Staff,65,0,100,35
1683352816578,CHEM 6C,A01,184681,Bussey; Thomas J,1,0,50,49
1683352816578,CHEM 6C,A02,184682,Bussey; Thomas J,34,0,50,16
1683352817605,CHEM 40A,A01,184684,Albizati; Kim F.,37,0,100,63
1683352818630,CHEM 40B,A01,184686,Albizati; Kim F.,0,20,100,100
1683352819659,CHEM 41B,A01,184690,Staff,52,0,100,48
1683352820683,COGS 3,A01,184715,Boyle; Mary E. T.,0,25,40,40
1683352821711,COGS 14B,A01,185172,Staff,0,15,38,38
1683352822738,COGS 18,A01,184736,Staff,17,0,80,63
1683352823762,COGS 100,A01,184932,Staff,0,5,73,73
1683352824789,COGS 101A,A01,184935,Staff,0,39,30,30
1683352825814,COGS 101B,A01,184944,Staff,0,2,30,30
1683352826839,COGS 101C,A01,184946,Staff,0,12,30,30
1683352827863,COGS 102A,A01,184951,Johnson; Christine M.,2,0,40,38
1683352828887,COGS 107B,A01,184953,Mooshagian; Eric Frederick,0,50,40,40
1683352829911,COGS 118B,A01,184959,Gupta; Anjum,0,48,40,40
1683352830938,COGS 153,A00,184961,Staff,0,15,30,30
1683352831966,COGS 177,A00,184962,Staff,0,20,30,30
1683352832991,COGS 187A,A01,184969,Boyle; Mary E. T.,0,17,40,40
1683352834021,COMM 10,A01,185174,Staff,0,5,25,25
1683352834021,COMM 10,A02,185189,Staff,0,5,25,25
1683352834021,COMM 10,A03,269821,Staff,0,0,0,0
1683352835046,COMM 100B,A01,185475,Staff,0,0,0,2
1683352835046,COMM 100B,A02,185476,Staff,13,0,25,12
1683352836071,COMM 100C,A01,185314,Staff,1,0,25,24
1683352836071,COMM 100C,A02,185327,Staff,19,0,25,6
1683352837098,COMM 110M,A00,185349,Staff,2,0,40,38
1683352838122,COMM 113T,A00,185352,Staff,24,0,40,16
1683352839151,COMM 114I,A00,185353,Staff,33,0,40,7
1683352840174,COMM 131,A00,185354,Staff,19,0,30,11
1683352841199,CSE 8A,A50,185358,Cao; Yingjun,0,46,10,10
1683352842229,CSE 8B,A01,185362,Staff,0,46,50,50
1683352843253,CSE 11,A01,185416,Cao; Yingjun,0,92,10,10
1683352844282,CSE 20,A01,185445,Briones; Jor-el Thomas Caparas,5,0,25,20
1683352845309,CSE 21,A01,185447,Staff,10,0,50,40
1683352846334,CSE 101,A01,185451,Staff,0,13,50,50
1683352846334,CSE 101,B01,185453,Jones; Miles E,0,11,50,50
1683352848388,CSE 141,A01,185458,Eldon; John,20,0,100,80
1683352849427,CSE 141L,A01,185461,Eldon; John,12,0,100,88
1683352850456,CSE 142,A01,185463,Staff,36,0,60,24
1683352850456,CSE 142,B01,201355,Staff,0,7,60,60
1683352851483,CSE 142L,A01,185470,Staff,36,0,60,24
1683352851483,CSE 142L,B01,201417,Staff,0,6,60,60
1683352852509,CSE 190,A00,201433,Staff,32,0,49,17
1683352853534,DOC 1,A01,259136,Strom; Megan C.,7,0,15,8
1683352853534,DOC 1,A02,259137,Strom; Megan C.,14,0,15,1
1683352853534,DOC 1,A03,259138,Strom; Megan C.,14,0,15,1
1683352853534,DOC 1,A04,259139,Strom; Megan C.,14,0,15,1
1683352854557,DOC 100D,A00,259140,Pass; Natalye Joann,16,0,25,9
1683352855581,DSGN 1,A01,184749,Rill; Bryan,0,25,30,30
1683352856605,DSGN 100,A01,185168,Staff,0,2,25,25
1683352857630,ECE 5,A01,185626,Morris; Karcher William,0,10,0,0
1683352858658,ECE 101,A01,185628,Staff,17,0,70,53
1683352859685,ECE 107,A01,185635,Baghdadchi; Saharnaz,0,0,20,20
1683352859685,ECE 107,A02,185638,Baghdadchi; Saharnaz,4,0,20,16
1683352860709,ECE 148,A01,185647,Silberman; Jack,0,0,16,16
1683352861739,ECON 1,A01,185537,Crane; Meredith Helen,54,0,70,16
1683352862771,ECON 3,A01,185549,Crane; Meredith Helen,32,0,70,38
1683352863801,ECON 4,A01,203354,Anderson; John Charles,0,4,10,10
1683352864879,ECON 100A,A01,185574,Staff,0,4,40,40
1683352865904,ECON 100B,A01,185576,Staff,0,12,50,50
1683352866932,ECON 100C,A01,185589,Newhouse; Herbert S,29,0,70,41
1683352867956,ECON 105,A00,185608,Vespa; Emanuel Ignacio,19,0,35,16
1683352868979,ECON 109,A01,185610,Shishkin; Denis,10,0,35,25
1683352870006,ECON 110A,A01,185612,Staff,11,0,40,29
1683352871035,ECON 120A,A01,185615,Staff,20,0,40,20
1683352872061,ECON 120C,A01,185617,Sun; Yixiao,0,21,70,70
1683352873089,ECON 144,A00,203346,Squires; Dale E,3,0,35,32
1683352874117,ECON 171,A01,203349,Newhouse; Herbert S,0,1,35,35
1683352875144,ECON 173A,A01,185621,Toda; Alexis Akira,21,0,35,14
1683352876170,EDS 25,A01,202413,Staff,0,1,0,0
1683352876170,EDS 25,A02,202414,Staff,0,1,0,0
1683352876170,EDS 25,A03,202415,Staff,0,0,0,0
1683352876170,EDS 25,A04,202416,Staff,0,1,0,0
1683352876170,EDS 25,A05,202439,Staff,0,0,0,0
1683352876170,EDS 25,A06,202440,Staff,0,0,0,0
1683352876170,EDS 25,B01,202631,Staff,0,0,0,0
1683352876170,EDS 25,B02,202632,Staff,0,0,0,0
1683352876170,EDS 25,B03,202639,Staff,0,0,0,0
1683352876170,EDS 25,B04,202640,Staff,0,0,0,0
1683352876170,EDS 25,B05,202643,Staff,0,0,0,0
1683352876170,EDS 25,B06,202644,Staff,0,0,0,0
1683352877195,EDS 38,A01,202659,Black; Alison Michelle,24,0,25,1
1683352878219,EDS 115,A00,202652,Staff,18,0,30,12
1683352879245,EDS 125,A00,202649,Staff,14,0,30,16
1683352880273,EDS 126,A01,203332,Staff,30,0,30,0
1683352881302,EDS 139,A00,202838,Staff,16,0,25,9
1683352882326,EDS 146,A01,202655,Staff,14,0,25,11
1683352883353,ENG 15,A00,185667,Staff,0,1,0,0
1683352883353,ENG 15,B00,185672,Staff,0,0,0,0
1683352883353,ENG 15,C00,185675,Staff,0,0,0,0
1683352883353,ENG 15,D00,185682,Staff,0,0,0,0
1683352883353,ENG 15,E00,185684,Staff,0,0,0,0
1683352884377,ETHN 103,A00,185710,Staff,0,4,35,35
1683352885404,ETHN 103A,A00,199228,Man; Simeon S,2,0,9,7
1683352886428,ETHN 109,A00,185711,Staff,18,0,35,17
1683352887452,ETHN 142,A00,185726,Staff,0,4,30,30
1683352888479,ETHN 163J,A00,199229,Man; Simeon S,5,0,8,3
1683352889501,ETHN 168,A00,185727,Staff,8,0,10,2
1683352890525,ETHN 182,A00,185728,Staff,0,0,35,35
1683352891548,ETHN 183,A00,185737,Staff,8,0,18,10
1683352892571,GLBH 111,A01,209361,Burgos; Jose L.,0,0,0,0
1683352894619,HIEU 104,A00,185792,Staff,16,0,20,4
1683352895646,HIEU 115,A00,185800,Staff,1,0,20,19
1683352896673,HIEU 128,A00,185801,Staff,0,7,20,20
1683352897696,HIEU 147,A00,185802,Staff,16,0,20,4
1683352898722,HIEU 154,A00,185823,Staff,12,0,20,8
1683352899746,HILA 102,A00,185826,Staff,13,0,20,7
1683352900770,HILD 2C,A01,185778,Staff,0,12,20,20
1683352901795,HILD 7B,A01,185780,Kwak; Nancy,0,15,32,32
1683352901795,HILD 7B,A02,185781,Kwak; Nancy,0,18,32,32
1683352902819,HILD 30,A01,185791,Staff,14,0,20,6
1683352903847,HISC 119,A00,185830,Golan; Tal,0,9,20,20
1683352904873,HITO 156GS,A00,185831,Patterson; Patrick H.,0,0,0,23
1683352905898,HIUS 103,A00,185832,Man; Simeon S,0,6,20,20
1683352906925,HIUS 117,A00,185836,Kwak; Nancy,2,0,20,18
1683352907951,HIUS 125,A00,185840,Man; Simeon S,0,0,23,23
1683352908974,HIUS 149,A00,185845,Staff,0,0,20,20
1683352909999,HUM 3,A01,185882,Zavodny; Tatiana Sophia,0,7,50,50
1683352909999,HUM 3,B01,185899,Caldwell; Michael Alan,0,18,50,50
1683352911025,HUM 3GS,A00,185900,Patterson; Patrick H.,0,0,0,23
1683352912049,HUM 4,A01,185938,Zroka; Amy Liane,31,0,50,19
1683352912049,HUM 4,B01,185956,Watkins; Eric,0,3,50,50
1683352912049,HUM 4,B02,202209,Watkins; Eric,0,2,50,50
1683352912049,HUM 4,B03,202210,Watkins; Eric,0,2,50,50
1683352913074,HUM 5,A01,185958,West; Geoffrey Scott,3,0,50,47
1683352913074,HUM 5,A02,202215,West; Geoffrey Scott,0,0,50,50
1683352914101,INTL 190,A00,185959,Gagnon; Jeffrey C,0,0,0,9
1683352914101,INTL 190,B00,185960,Lettieri; Michael Joseph,0,0,0,1
1683352915125,JAPN 180,A00,254509,Staff,4,0,30,26
1683352916151,LATI 10,A01,202853,Kennemore; Amy Michelle,4,0,35,31
1683352916151,LATI 10,A02,202854,Kennemore; Amy Michelle,2,0,35,33
1683352916151,LATI 10,A03,270054,Kennemore; Amy Michelle,30,0,30,0
1683352917178,LATI 180,A00,202855,Kennemore; Amy Michelle,11,0,20,9
1683352918200,LAWS 101,A00,201767,Golan; Tal,0,7,40,40
1683352919226,LIFR 1C,A00,185961,Staff,6,0,20,14
1683352920249,LIFR 1CX,A00,185962,Staff,7,0,20,13
1683352921273,LIFR 1D,A00,185963,Staff,9,0,20,11
1683352922302,LIFR 1DX,A00,185964,Staff,9,0,20,11
1683352923325,LIGN 101,A01,186039,Staff,43,0,50,7
1683352924349,LIGN 165,A00,186040,Staff,18,0,50,32
1683352925383,LTCS 108,A00,186041,Staff,6,0,10,4
1683352926406,LTCS 119,A00,186042,Staff,16,0,20,4
1683352927430,LTCS 130,A00,186043,Wesling; Megan E.,15,0,25,10
1683352929482,LTEA 138,A00,186119,Staff,14,0,40,26
1683352930506,LTEN 124,A00,186148,Staff,6,0,25,19
1683352931533,LTEN 178,A00,186149,Staff,7,0,15,8
1683352932556,LTEN 181,A00,186150,Blanco; John D,33,0,40,7
1683352933587,LTWL 120,A00,186160,Staff,20,0,25,5
1683352934613,LTWL 165,A00,186161,Staff,22,0,25,3
1683352935637,LTWR 100,A00,186162,Staff,0,5,15,15
1683352936667,LTWR 102,A00,186163,Doller; Ben,5,0,15,10
1683352937692,MAE 8,A01,186412,Staff,0,0,0,0
1683352938718,MAE 30B,A00,186445,Bahadori; Mohammad Yousef,83,0,100,17
1683352939742,MAE 40,A00,186592,Bewley; Thomas R,9,0,50,41
1683352940770,MAE 101B,A00,186593,Bahadori; Mohammad Yousef,81,0,100,19
1683352941795,MAE 105,A00,186594,Bandaru; Prabhakar,12,0,50,38
1683352942820,MAE 107,A00,186599,Pham; Hieu Tan,0,6,120,120
1683352943844,MAE 148,A01,186660,Silberman; Jack,3,0,16,13
1683352944872,MATH 10A,A01,188095,Staff,0,5,35,35
1683352945898,MATH 10B,A01,188097,Bowers; Adam R.,0,11,30,30
1683352945898,MATH 10B,A02,188099,Bowers; Adam R.,0,11,30,30
1683352945898,MATH 10B,B01,188104,Bowers; Adam R.,0,10,30,30
1683352945898,MATH 10B,B02,188106,Bowers; Adam R.,0,10,30,30
1683352946927,MATH 10C,A01,188111,Staff,0,18,30,30
1683352946927,MATH 10C,A02,188127,Staff,0,17,30,30
1683352946927,MATH 10C,A03,188131,Staff,0,18,30,30
1683352946927,MATH 10C,B01,188218,Staff,18,0,30,12
1683352946927,MATH 10C,B02,188244,Staff,13,0,30,17
1683352946927,MATH 10C,B03,188277,Staff,16,0,30,14
1683352947952,MATH 18,A01,188344,Bach; Quang Tran,18,0,30,12
1683352947952,MATH 18,A02,188345,Bach; Quang Tran,11,0,30,19
1683352947952,MATH 18,B01,188353,Bach; Quang Tran,10,0,30,20
1683352947952,MATH 18,B02,188354,Bach; Quang Tran,20,0,30,10
1683352948978,MATH 20A,A01,188374,Staff,12,0,35,23
1683352950007,MATH 20B,A01,188382,Ohm; Ko Woon,6,0,30,24
1683352950007,MATH 20B,A02,188383,Ohm; Ko Woon,22,0,30,8
1683352950007,MATH 20B,B01,188385,Ohm; Ko Woon,7,0,30,23
1683352950007,MATH 20B,B02,188392,Ohm; Ko Woon,22,0,30,8
1683352951033,MATH 20C,A01,188394,Harel; Guershon,10,0,30,20
1683352951033,MATH 20C,A02,188395,Harel; Guershon,15,0,30,15
1683352951033,MATH 20C,B01,188404,Harel; Guershon,4,0,30,26
1683352951033,MATH 20C,B02,188405,Harel; Guershon,19,0,30,11
1683352952064,MATH 20D,A01,188414,Hammock; Frances H,0,1,30,30
1683352952064,MATH 20D,A02,188415,Hammock; Frances H,3,0,30,27
1683352952064,MATH 20D,B01,188447,Hammock; Frances H,1,0,30,29
1683352952064,MATH 20D,B02,188486,Hammock; Frances H,8,0,30,22
1683352953087,MATH 20E,A01,188649,Staff,21,0,30,9
1683352953087,MATH 20E,A02,188650,Staff,23,0,30,7
1683352953087,MATH 20E,A03,188673,Staff,0,0,30,30
1683352954111,MATH 102,A01,188675,Staff,0,35,35,35
1683352955145,MATH 103B,A01,188681,Staff,3,0,35,32
1683352955145,MATH 103B,B01,188692,Staff,5,0,35,30
1683352956170,MATH 109,A01,188695,Salehi Golsefidy; Alireza,25,0,35,10
1683352956170,MATH 109,A02,188696,Salehi Golsefidy; Alireza,25,0,35,10
1683352957202,MATH 120A,A01,188698,Eggers; John Dietrich,7,0,35,28
1683352958230,MATH 142B,A01,188736,Ioana; Adrian,0,2,30,30
1683352958230,MATH 142B,A02,188741,Ioana; Adrian,0,0,30,30
1683352958230,MATH 142B,A03,188743,Ioana; Adrian,0,1,30,30
1683352959254,MATH 168A,A01,188790,Staff,0,9,35,35
1683352960285,MATH 170A,A01,188803,Nie; Jiawang,0,2,35,35
1683352960285,MATH 170A,A02,188811,Nie; Jiawang,0,0,35,35
1683352960285,MATH 170A,A03,188814,Nie; Jiawang,1,0,35,34
1683352960285,MATH 170A,A04,188815,Nie; Jiawang,13,0,35,22
1683352961310,MATH 193B,A01,188817,Staff,0,0,35,35
1683352961310,MATH 193B,A02,188818,Staff,5,0,35,30
1683352962334,MGT 4,A01,202857,Anderson; John Charles,62,0,80,18
1683352963361,MGT 12,A00,202858,Lindenberger; Wade Douglas,42,0,90,48
1683352964393,MGT 18,A00,202859,Staff,74,0,90,16
1683352965416,MGT 18GS,A00,202860,McKay; Michael J,13,0,28,15
1683352966439,MGT 45,A00,202861,Pecore; Joseph P.,14,0,90,76
1683352967464,MGT 100,A00,202863,Yavorsky; Daniel Ryan,28,0,90,62
1683352968561,MGT 103,A00,202864,Ehrich; Kristine R,0,17,90,90
1683352969592,MGT 112,A00,202865,Ehrich; Kristine R,15,0,90,75
1683352970622,MGT 121A,A00,202868,Staff,0,20,0,0
1683352971650,MGT 131B,A00,202869,Anderson; John Charles,59,0,90,31
1683352972684,MGT 136,A00,202871,Lindenberger; Wade Douglas,84,0,90,6
1683352973711,MGT 164,A00,202873,Staff,0,68,90,91
1683352974740,MGT 164GS,A00,202874,McKay; Mary A,13,0,28,15
1683352975764,MGT 180,A00,202875,Staff,0,50,90,91
1683352976788,MMW 11R,A01,205019,Herbst; Matthew,3,0,30,27
1683352976788,MMW 11R,A02,205026,Herbst; Matthew,29,0,30,1
1683352977813,MMW 15,A01,193512,Chang; Edmond Yi-Teh,0,9,28,28
1683352977813,MMW 15,A02,193513,Chang; Edmond Yi-Teh,0,5,28,28
1683352977813,MMW 15,A03,193514,Chang; Edmond Yi-Teh,0,5,28,28
1683352977813,MMW 15,A04,193515,Chang; Edmond Yi-Teh,0,5,28,28
1683352977813,MMW 15,A05,193516,Chang; Edmond Yi-Teh,0,4,28,28
1683352977813,MMW 15,A06,193517,Chang; Edmond Yi-Teh,0,5,28,28
1683352977813,MMW 15,B01,193519,Chang; Edmond Yi-Teh,0,5,28,28
1683352977813,MMW 15,B02,193520,Chang; Edmond Yi-Teh,0,5,28,28
1683352977813,MMW 15,B03,193521,Chang; Edmond Yi-Teh,0,5,28,28
1683352977813,MMW 15,B04,193522,Chang; Edmond Yi-Teh,0,4,28,28
1683352977813,MMW 15,B05,193523,Chang; Edmond Yi-Teh,0,5,28,28
1683352977813,MMW 15,B06,193524,Chang; Edmond Yi-Teh,0,4,28,28
1683352978837,MMW 122,A01,193526,Rahimi; Babak,0,15,28,28
1683352978837,MMW 122,A02,193527,Rahimi; Babak,0,14,28,28
1683352978837,MMW 122,A03,193528,Rahimi; Babak,0,0,0,0
1683352978837,MMW 122,A04,193529,Rahimi; Babak,0,0,0,0
1683352979865,MUS 1A,A01,186663,Staff,0,20,35,35
1683352980889,MUS 4,A01,186715,Staff,0,12,35,35
1683352981914,MUS 5R,A01,186796,Dubnov; Shlomo,0,17,35,35
1683352982942,MUS 6,A01,186798,Staff,0,4,25,25
1683352983972,MUS 7,A01,186830,Staff,13,0,35,22
1683352984996,MUS 8,A01,186930,Staff,0,26,35,35
1683352986028,MUS 15,A01,186932,Staff,0,16,35,35
1683352986028,MUS 15,B01,186934,Staff,0,15,35,35
1683352987062,MUS 80,A00,186935,Staff,1,0,20,19
1683352987062,MUS 80,B00,186936,Staff,25,0,25,0
1683352988087,NANO 11,A00,204702,Lipomi; Darren John,0,0,0,0
1683352989118,NANO 15,A01,204709,Yang; Kesong,0,1,0,0
1683352990143,NANO 114,A00,202069,Jahed Motlagh; Zeinab,3,0,10,7
1683352991174,PHIL 1,A00,186955,Grush; Rick Scott,32,0,40,8
1683352992198,PHIL 10,A01,186973,Grush; Rick Scott,28,0,35,7
1683352992198,PHIL 10,A02,186974,Grush; Rick Scott,33,0,35,2
1683352993222,PHIL 13,A01,186976,Staff,7,0,35,28
1683352993222,PHIL 13,A02,186977,Staff,16,0,35,19
1683352994247,PHIL 14,A01,186979,Staff,31,0,35,4
1683352994247,PHIL 14,A02,186986,Staff,32,0,35,3
1683352995270,PHIL 28,A01,186988,Staff,16,0,30,14
1683352995270,PHIL 28,A02,186989,Staff,1,0,30,29
1683352995270,PHIL 28,A03,186990,Staff,9,0,30,21
1683352995270,PHIL 28,A04,186991,Staff,26,0,30,4
1683352996293,PHIL 120,A00,186997,Staff,23,0,40,17
1683352997318,PHIL 137,A00,187003,Staff,9,0,40,31
1683352998342,PHIL 150,A00,187015,Staff,47,0,70,23
1683352999370,PHIL 167,A00,187021,Lamey; Andy M.,35,0,40,5
1683353000393,PHIL 174,A01,202226,Staff,17,0,20,3
1683353000393,PHIL 174,A02,202235,Staff,20,0,20,0
1683353001416,PHIL 191A,A00,258918,Staff,0,0,1,1
1683353002442,PHYS 1A,A00,187028,Staff,27,0,60,33
1683353003468,PHYS 1AL,001,187036,Staff,2,0,30,28
1683353003468,PHYS 1AL,002,187049,Staff,18,0,30,12
1683353004493,PHYS 1B,A00,187058,Staff,22,0,60,38
1683353005517,PHYS 1BL,001,187064,Staff,0,0,30,30
1683353005517,PHYS 1BL,002,187070,Staff,5,0,30,25
1683353006544,PHYS 1C,A00,187082,Staff,31,0,120,89
1683353007568,PHYS 1CL,001,187088,Staff,0,9,30,30
1683353007568,PHYS 1CL,002,187089,Staff,0,2,30,30
1683353007568,PHYS 1CL,009,262693,Staff,11,0,30,19
1683353008592,PHYS 2B,A01,187097,Staff,54,0,115,61
1683353009616,PHYS 2C,A01,187099,Staff,67,0,115,48
1683353010641,PHYS 2CL,A01,187101,Staff,5,0,28,23
1683353010641,PHYS 2CL,A02,187102,Staff,15,0,28,13
1683353011671,PHYS 2D,A01,187123,Shotwell; Brian,95,0,115,20
1683353012704,PHYS 4B,A01,187133,Grinstein; Benjamin,35,0,50,15
1683353013729,POLI 10,A00,188819,Staff,0,4,50,50
1683353014755,POLI 11,A00,188827,Staff,43,0,50,7
1683353015784,POLI 13R,A00,188828,Staff,0,1,20,20
1683353016813,POLI 27,A01,188830,Elgin; Samuel Zincke,0,1,70,70
1683353017837,POLI 30,A00,188832,Desposato; Scott,31,0,50,19
1683353018860,POLI 102F,A00,188834,Staff,3,0,40,37
1683353019887,POLI 104A,A00,188852,Staff,14,0,30,16
1683353020910,POLI 104I,A00,188853,Staff,0,6,20,20
1683353021935,POLI 110B,A00,188854,Wiens; David,7,0,20,13
1683353022962,POLI 112A,A00,188855,Wiens; David,5,0,30,25
1683353023986,POLI 117R,A00,188856,Forman; Fonna,0,11,20,20
1683353025011,POLI 118,A00,188857,Ingham; Sean,8,0,20,12
1683353026037,POLI 120G,A00,188858,Staff,9,0,30,21
1683353027062,POLI 131CR,A00,188863,Hoston; Germaine,24,0,50,26
1683353028098,POLI 133,A00,188864,Nellis; Gareth Hb,44,0,50,6
1683353029126,POLI 134D,A00,188865,Desposato; Scott,27,0,30,3
1683353030152,POLI 142A,A00,188871,Gartzke; Erik,22,0,50,28
1683353031175,POLI 142K,A00,188874,Staff,38,0,50,12
1683353032208,POLI 143,A00,188940,Gartzke; Erik,16,0,30,14
1683353033237,POLI 153,A00,188943,Staff,3,0,20,17
1683353034260,POLI 160AA,A00,188944,Staff,11,0,40,29
1683353035285,POLI 170A,A00,188945,Staff,11,0,30,19
1683353037333,PSYC 1,A00,188952,Staff,37,0,90,53
1683353038358,PSYC 2,B00,188953,Staff,19,0,35,16
1683353039386,PSYC 6,A00,188970,Staff,47,0,60,13
1683353040414,PSYC 7,A00,188973,Staff,37,0,45,8
1683353041437,PSYC 60,A01,188980,Rickard; Timothy C.,43,0,60,17
1683353042464,PSYC 70,A01,189001,Steiner; Eric Tomas,23,0,45,22
1683353043493,PSYC 100,A00,189005,Lacefield; Katharine I,0,98,120,120
1683353044521,PSYC 102,A00,189008,Staff,9,0,30,21
1683353045546,PSYC 106,B00,189026,Gorman; Michael R.,34,0,60,26
1683353046570,PSYC 114,B01,189033,Winkielman; Piotr,0,32,30,30
1683353047593,PSYC 131,A00,189036,Anagnostaras; Stephan,0,43,60,60
1683353048617,PSYC 136,A00,189041,Lowe; Angela Beth,0,7,25,25
1683353049642,PSYC 137,A00,189057,Winkielman; Piotr,0,34,25,25
1683353050671,PSYC 144,A00,189107,Wixted; John T,0,7,50,50
1683353052722,PSYC 162,A00,189142,Staff,0,8,85,85
1683353053746,PSYC 172,A00,189144,Gorman; Michael R.,0,7,30,30
1683353055798,PSYC 179,A00,189146,Lacefield; Katharine I,0,84,120,120
1683353056822,PSYC 181,A00,189147,Anagnostaras; Stephan,0,44,90,90
1683353057849,PSYC 190R,A00,189148,Barner; David A.,0,22,80,80
1683353058877,PSYC 191,A00,189275,Rickard; Timothy C.,0,7,25,25
1683353059902,PSYC 193,A00,189276,Chapman; Eddie Nathaniel,0,1,0,4
1683353060927,PSYC 193L,A01,189281,Lowe; Angela Beth,12,0,20,8
1683353060927,PSYC 193L,B01,189285,Staff,28,0,35,7
1683353061954,RELI 149,A00,187137,Rahimi; Babak,7,0,40,33
1683353062982,SE 9,A01,187315,Staff,0,2,18,18
1683353064009,SE 101B,A00,187409,Staff,24,0,30,6
1683353065034,SE 110B,A00,187444,Staff,10,0,40,30
1683353066057,SE 130B,A00,187449,Staff,31,0,40,9
1683353067080,SE 150A,A00,187516,Staff,9,0,20,11
1683353068107,SE 154,A00,187528,Staff,30,0,50,20
1683353069136,SIO 3,A01,258171,Staff,35,0,40,5
1683353070164,SIO 10,A00,187144,Cook; Geoffrey W,0,3,75,75
1683353071187,SIO 45,A00,187152,Cook; Geoffrey W,1,0,100,99
1683353072267,SIO 109R,A00,194486,Staff,0,3,20,20
1683353074317,SIO 187,A01,187233,Kacev; David,12,0,40,28
1683353075346,SOCI 1,A01,258656,Thorpe; Charles Robert,28,0,30,2
1683353075346,SOCI 1,A02,258658,Thorpe; Charles Robert,30,0,30,0
1683353075346,SOCI 1,A03,258661,Thorpe; Charles Robert,25,0,25,0
1683353075346,SOCI 1,A04,258666,Thorpe; Charles Robert,22,0,25,3
1683353075346,SOCI 1,A05,258897,Thorpe; Charles Robert,23,0,25,2
1683353075346,SOCI 1,A06,258898,Thorpe; Charles Robert,25,0,25,0
1683353076372,SOCI 30,A01,258903,Pardo Guerra; Juan Pablo,15,0,30,15
1683353077399,SOCI 102,A00,258904,Staff,9,0,25,16
1683353078421,SOCI 106,A00,258905,Staff,19,0,25,6
1683353079448,SOCI 111,A00,258907,Ribas Norris; Janet Vanesa,26,0,30,4
1683353080471,SOCI 121R,A00,258908,Pardo Guerra; Juan Pablo,10,0,30,20
1683353081495,SOCI 126,A01,203330,Staff,14,0,20,6
1683353082522,SOCI 131,A00,258909,Thorpe; Charles Robert,31,0,60,29
1683353083546,SOCI 135,A00,258910,Payne; Christine Anna,0,9,30,30
1683353084570,SOCI 157,A00,258911,Staff,12,0,30,18
1683353085600,SOCI 184,A00,258912,Staff,25,0,30,5
1683353086633,SOCI 188D,A00,258913,Staff,22,0,30,8
1683353087665,SYN 2,001,187529,Staff,10,0,16,6
1683353087665,SYN 2,002,201452,Staff,0,18,16,16
1683353087665,SYN 2,003,201469,Staff,3,0,16,13
1683353088695,SYN 100,A01,187531,Staff,0,9,20,20
1683353088695,SYN 100,B01,201491,Staff,0,12,20,20
1683353089719,TDAC 1,A00,189286,Walsh; Kim C.,3,0,20,17
1683353089719,TDAC 1,B00,189287,Harting; Carla Kelso,11,0,20,9
1683353090744,TDAC 101,A00,189300,Walsh; Kim C.,16,0,20,4
1683353090744,TDAC 101,B00,189301,Harting; Carla Kelso,18,0,20,2
1683353091769,TDAC 102,A00,189304,Basso; Beatrice,14,0,20,6
1683353092797,TDAC 108,A00,189305,Staff,18,0,20,2
1683353093828,TDDE 131,A00,189310,Staff,19,0,20,1
1683353093828,TDDE 131,B00,189314,Staff,19,0,20,1
1683353093828,TDDE 131,C00,189315,Staff,48,0,50,2
1683353093828,TDDE 131,D00,189316,Staff,14,0,15,1
1683353093828,TDDE 131,E00,204841,Staff,20,0,20,0
1683353094857,TDGE 10,A00,189289,Staff,30,0,50,20
1683353094857,TDGE 10,B00,189290,Havis; Allan,1,0,50,49
1683353095881,TDGE 11,A00,189291,Fulton; Julia,0,3,50,50
1683353095881,TDGE 11,B00,189292,Staff,20,0,25,5
1683353095881,TDGE 11,C00,260270,Staff,0,0,0,0
1683353096906,TDGE 25,A00,189294,Staff,3,0,20,17
1683353097931,TDGE 124,A00,189318,Fulton; Julia,0,8,50,50
1683353098960,TDGE 125,A00,189319,Staff,13,0,25,12
1683353098960,TDGE 125,B00,189320,Staff,23,0,25,2
1683353099987,TDGE 127,A00,189322,Havis; Allan,0,0,50,50
1683353101011,TDHT 101,A00,189323,Staff,18,0,25,7
1683353101011,TDHT 101,B00,189324,Staff,25,0,25,0
1683353102038,TDHT 102,A00,189325,Staff,49,0,50,1
1683353103069,TDMV 1,A00,189295,Arcidiacono; Kristin,19,0,30,11
1683353103069,TDMV 1,B00,189296,Caligagan; Maria T.,24,0,30,6
1683353104098,TDMV 2,A00,189297,Sammartano; Tonnie,28,0,30,2
1683353104098,TDMV 2,B00,189299,Arcidiacono; Kristin,24,0,30,6
1683353105126,TDMV 3,A00,204998,Rincon; Alicia,22,0,30,8
1683353106152,TDMV 120,A00,189458,Sammartano; Tonnie,28,0,30,2
1683353107181,TDMV 138,A00,189541,Jun; Grace Shin Hae,22,0,40,18
1683353108210,TDMV 142,A00,189717,Caligagan; Tony,23,0,30,7
1683353108210,TDMV 142,B00,189718,Caligagan; Maria T.,25,0,30,5
1683353109235,TMC 2,A01,187533,Staff,25,0,25,0
1683353109235,TMC 2,A02,187534,Staff,25,0,25,0
1683353110258,USP 1,A01,187536,Kwak; Nancy,0,16,25,25
1683353111286,USP 5,A01,187538,Staff,10,0,25,15
1683353112314,USP 101,A00,199253,Staff,0,4,0,0
1683353113340,USP 124,A00,187562,Boomhower; Matthew Charles,1,0,30,29
1683353114365,USP 138,A00,187582,Staff,20,0,25,5
1683353115392,USP 152,A01,187597,Staff,4,0,25,21
1683353116417,USP 153,A00,187598,Staff,19,0,25,6
1683353117444,USP 168,A00,187607,Kwak; Nancy,2,0,5,3
1683353118468,USP 173,A00,187619,Staff,4,0,25,21
1683353119497,USP 181,A00,187638,Staff,0,2,25,25
1683353120521,VIS 103,A00,187650,Cruz; Edwin Teddy,22,0,75,53
1683353121546,VIS 110D,A00,187669,Staff,12,0,22,10
1683353122574,VIS 127C,A00,187720,Shen; Kuiyi,67,0,146,79
1683353123599,VIS 149,A00,187731,Yoldas; Pinar,0,14,22,22
1683353124623,VIS 151,A01,188091,Staff,22,0,34,12
1683353124623,VIS 151,A02,188092,Staff,11,0,34,23
1683353125647,VIS 160B,A00,188093,Stalbaum; Brett,0,0,10,10
1683353127703,WCWP 10B,A00,201720,Staff,10,0,15,5
1683353127703,WCWP 10B,B00,201722,Staff,9,0,15,6
1683353128726,WCWP 100,A00,201725,Gagnon; Jeffrey C,0,0,2,2
1683353128726,WCWP 100,B00,201727,Staff,0,4,15,15
1683353131871,ANBI 133,A00,258401,Wilder; Linnea Lorene,34,0,40,6
1683353132894,ANBI 140,A00,258395,Hrvoj Mihic; Branka,18,0,25,7
1683353133917,ANSC 120,A00,258402,Bialecki; Jon Anthony,27,0,40,13
1683353134943,ANSC 144,A00,258400,Staff,14,0,40,26
1683353136994,ANSC 166,A00,258396,Parish; Steven Martin,157,0,175,18
1683353138020,ANSC 180,A00,193533,Staff,9,0,20,11
1683353139044,ANSC 188,A00,258397,Jassal; Aftab,33,0,40,7
1683353140068,ANTH 3,A01,258316,Staff,23,0,30,7
1683353141097,ANTH 5,A00,258394,Semendeferi; Ekaterini,16,0,20,4
1683353142120,ANTH 21,A01,258331,Staff,8,0,40,32
1683353143144,ANTH 103,A00,258398,Varma; Saiba,15,0,25,10
1683353144171,AWP 10,001,202034,Staff,0,0,0,0
1683353144171,AWP 10,002,202035,Staff,0,0,0,0
1683353144171,AWP 10,003,202036,Staff,0,0,0,0
1683353144171,AWP 10,004,202037,Staff,0,0,0,0
1683353144171,AWP 10,005,202038,Staff,0,0,0,0
1683353144171,AWP 10,006,202039,Staff,0,0,0,0
1683353144171,AWP 10,007,202040,Staff,0,0,0,0
1683353144171,AWP 10,008,202041,Staff,0,0,0,0
1683353144171,AWP 10,009,202042,Staff,0,0,0,0
1683353144171,AWP 10,010,202043,Staff,0,0,0,0
1683353144171,AWP 10,011,202044,Staff,0,0,0,0
1683353144171,AWP 10,012,202045,Staff,0,0,0,0
1683353144171,AWP 10,013,202046,Staff,0,0,0,0
1683353144171,AWP 10,014,202047,Staff,0,0,0,0
1683353144171,AWP 10,015,202048,Staff,0,0,0,0
1683353144171,AWP 10,016,202049,Staff,0,0,0,0
1683353144171,AWP 10,017,202050,Staff,0,0,0,0
1683353144171,AWP 10,018,202051,Staff,0,0,0,0
1683353144171,AWP 10,019,202052,Staff,0,0,0,0
1683353144171,AWP 10,020,202053,Staff,0,0,0,0
1683353144171,AWP 10,021,202054,Staff,0,0,0,0
1683353144171,AWP 10,022,202055,Staff,0,0,0,0
1683353144171,AWP 10,023,202056,Staff,0,0,0,0
1683353144171,AWP 10,024,202057,Staff,0,0,0,0
1683353144171,AWP 10,025,202058,Staff,0,0,0,0
1683353144171,AWP 10,026,202059,Staff,0,0,0,0
1683353145196,AWP 102,001,202032,Staff,0,0,0,0
1683353145196,AWP 102,002,202033,Staff,0,0,0,0
1683353146220,BENG 100,A01,254234,Taylor Amos; Alyssa C,31,0,40,9
1683353147242,BENG 196,001,270013,Engler; Adam J.,9999,0,9999,0
1683353148271,BICD 100R,A01,202018,Smith; Laurie,0,7,32,32
1683353148271,BICD 100R,A02,202019,Smith; Laurie,0,2,32,32
1683353148271,BICD 100R,A03,202020,Smith; Laurie,0,1,32,32
1683353148271,BICD 100R,A04,202021,Smith; Laurie,9,0,32,23
1683353148271,BICD 100R,A05,202022,Smith; Laurie,12,0,32,20
1683353149296,BICD 136,A01,193242,Gustafson-Brown; Cindy,0,2,32,32
1683353149296,BICD 136,A02,193244,Gustafson-Brown; Cindy,14,0,32,18
1683353150322,BIEB 102,A01,193249,Butler; Shannon Rhey,0,2,32,32
1683353150322,BIEB 102,A02,193251,Butler; Shannon Rhey,0,0,32,32
1683353150322,BIEB 102,A03,193253,Butler; Shannon Rhey,0,1,32,32
1683353150322,BIEB 102,A04,193255,Butler; Shannon Rhey,17,0,32,15
1683353150322,BIEB 102,A05,193265,Butler; Shannon Rhey,26,0,32,6
1683353150322,BIEB 102,A06,193269,Butler; Shannon Rhey,16,0,32,16
1683353152376,BIEB 150,A01,193274,Staff,0,0,32,32
1683353152376,BIEB 150,A02,193285,Staff,23,0,32,9
1683353153404,BIEB 194,A00,193286,Kurle; Carolyn M.,22,0,32,10
1683353154433,BILD 1,A01,192291,Staff,16,0,32,16
1683353154433,BILD 1,A02,192292,Staff,30,0,32,2
1683353154433,BILD 1,B01,192520,Reuther; Keefe,0,1,0,0
1683353154433,BILD 1,B02,192532,Reuther; Keefe,0,1,0,0
1683353155478,BILD 3,A01,192556,Butler; Shannon Rhey,0,0,32,32
1683353155478,BILD 3,A02,192581,Butler; Shannon Rhey,4,0,32,28
1683353155478,BILD 3,A03,192611,Butler; Shannon Rhey,23,0,32,9
1683353155478,BILD 3,A04,192612,Butler; Shannon Rhey,25,0,32,7
1683353155478,BILD 3,A05,192613,Butler; Shannon Rhey,27,0,32,5
1683353155478,BILD 3,A06,192679,Butler; Shannon Rhey,27,0,32,5
1683353155478,BILD 3,A07,192682,Butler; Shannon Rhey,22,0,32,10
1683353156507,BILD 4,A01,192836,Reuther; Keefe,0,0,24,24
1683353156507,BILD 4,A02,193044,Reuther; Keefe,4,0,24,20
1683353157532,BILD 10,A01,193142,Gustafson-Brown; Cindy,30,0,32,2
1683353157532,BILD 10,A02,193149,Gustafson-Brown; Cindy,31,0,32,1
1683353158560,BIMM 100,A01,193301,Staff,0,6,32,32
1683353158560,BIMM 100,A02,193312,Staff,0,5,32,32
1683353158560,BIMM 100,A03,193323,Staff,0,8,32,32
1683353159593,BIMM 101,A01,193329,McDonnell; Lisa Marie,0,3,24,24
1683353159593,BIMM 101,A02,193339,McDonnell; Lisa Marie,0,3,24,24
1683353159593,BIMM 101,B01,193354,McDonnell; Lisa Marie,0,3,24,24
1683353159593,BIMM 101,B02,193357,McDonnell; Lisa Marie,0,3,24,24
1683353160617,BIMM 110,A01,193377,Tat; John,0,11,32,32
1683353160617,BIMM 110,A02,193378,Tat; John,0,9,32,32
1683353161648,BIMM 120,A01,206116,Staff,0,0,32,32
1683353161648,BIMM 120,A02,206117,Staff,8,0,32,24
1683353161648,BIMM 120,A03,206121,Staff,21,0,32,11
1683353162678,BIPN 100,A01,193393,Park; Ji Young,0,14,32,32
1683353162678,BIPN 100,A02,193402,Park; Ji Young,0,13,32,32
1683353162678,BIPN 100,A03,193413,Park; Ji Young,0,14,32,32
1683353162678,BIPN 100,A04,193414,Park; Ji Young,0,13,32,32
1683353163702,BIPN 102,A01,193429,Staff,0,0,32,32
1683353163702,BIPN 102,A02,193438,Staff,22,0,32,10
1683353164724,BIPN 106,A01,193450,Reyes Gonzalez; Catalina,0,2,40,40
1683353165750,BIPN 134,A01,193465,Cooke; James Edward,0,0,32,32
1683353165750,BIPN 134,A02,193474,Cooke; James Edward,25,0,32,7
1683353165750,BIPN 134,A03,193485,Cooke; James Edward,29,0,32,3
1683353165750,BIPN 134,A04,193486,Cooke; James Edward,21,0,32,11
1683353165750,BIPN 134,A05,193491,Cooke; James Edward,31,0,32,1
1683353165750,BIPN 134,A06,193501,Cooke; James Edward,30,0,32,2
1683353165750,BIPN 134,A07,193510,Cooke; James Edward,29,0,32,3
1683353167806,BISP 194,A00,222522,Staff,14,0,32,18
1683353168830,CAT 124,A01,202407,Staff,20,0,25,5
1683353169858,CAT 125,A00,202408,Marchisotto; Jennifer Anne,4,0,20,16
1683353170884,CAT 125R,A00,202409,Smith; Lauryn Alissa,0,11,20,20
1683353170884,CAT 125R,B00,202410,Morales; Celeste Georgianna,0,11,20,20
1683353170884,CAT 125R,C00,202411,Irwin; Matthew Joseph,0,10,20,20
1683353171913,CENG 15,A01,204712,Yang; Kesong,0,1,0,0
1683353172941,CENG 114,A00,202070,Jahed Motlagh; Zeinab,5,0,20,15
1683353173968,CGS 105,A00,185477,Wesling; Megan E.,24,0,40,16
1683353174997,CGS 106,A00,185494,Staff,13,0,22,9
1683353176077,CGS 108,A00,185495,Staff,14,0,20,6
1683353177103,CGS 114,A00,185496,Staff,13,0,18,5
1683353178129,CGS 119,A00,185501,Staff,15,0,20,5
1683353179156,CGS 120,A00,185511,Staff,13,0,20,7
1683353180186,CHEM 4,A01,184675,Bussey; Thomas J,96,0,100,4
1683353181262,CHEM 6A,A01,184677,Staff,34,0,60,26
1683353182287,CHEM 6B,A01,184679,Staff,65,0,100,35
1683353183312,CHEM 6C,A01,184681,Bussey; Thomas J,1,0,50,49
1683353183312,CHEM 6C,A02,184682,Bussey; Thomas J,34,0,50,16
1683353184337,CHEM 40A,A01,184684,Albizati; Kim F.,37,0,100,63
1683353185362,CHEM 40B,A01,184686,Albizati; Kim F.,0,20,100,100
1683353186387,CHEM 41B,A01,184690,Staff,52,0,100,48
1683353187411,COGS 3,A01,184715,Boyle; Mary E. T.,0,25,40,40
1683353188435,COGS 14B,A01,185172,Staff,0,15,38,38
1683353189464,COGS 18,A01,184736,Staff,17,0,80,63
1683353190491,COGS 100,A01,184932,Staff,0,5,73,73
1683353191516,COGS 101A,A01,184935,Staff,0,39,30,30
1683353192541,COGS 101B,A01,184944,Staff,0,2,30,30
1683353193567,COGS 101C,A01,184946,Staff,0,12,30,30
1683353194595,COGS 102A,A01,184951,Johnson; Christine M.,2,0,40,38
1683353195620,COGS 107B,A01,184953,Mooshagian; Eric Frederick,0,50,40,40
1683353196645,COGS 118B,A01,184959,Gupta; Anjum,0,48,40,40
1683353197675,COGS 153,A00,184961,Staff,0,15,30,30
1683353198700,COGS 177,A00,184962,Staff,0,20,30,30
1683353199728,COGS 187A,A01,184969,Boyle; Mary E. T.,0,17,40,40
1683353200751,COMM 10,A01,185174,Staff,0,5,25,25
1683353200751,COMM 10,A02,185189,Staff,0,5,25,25
1683353200751,COMM 10,A03,269821,Staff,0,0,0,0
1683353201775,COMM 100B,A01,185475,Staff,0,0,0,2
1683353201775,COMM 100B,A02,185476,Staff,13,0,25,12
1683353202799,COMM 100C,A01,185314,Staff,1,0,25,24
1683353202799,COMM 100C,A02,185327,Staff,19,0,25,6
1683353203827,COMM 110M,A00,185349,Staff,2,0,40,38
1683353204853,COMM 113T,A00,185352,Staff,24,0,40,16
1683353205877,COMM 114I,A00,185353,Staff,33,0,40,7
1683353206901,COMM 131,A00,185354,Staff,19,0,30,11
1683353207924,CSE 8A,A50,185358,Cao; Yingjun,0,46,10,10
1683353208949,CSE 8B,A01,185362,Staff,0,46,50,50
1683353209972,CSE 11,A01,185416,Cao; Yingjun,0,92,10,10
1683353210997,CSE 20,A01,185445,Briones; Jor-el Thomas Caparas,5,0,25,20
1683353212021,CSE 21,A01,185447,Staff,10,0,50,40
1683353213046,CSE 101,A01,185451,Staff,0,13,50,50
1683353213046,CSE 101,B01,185453,Jones; Miles E,0,11,50,50
1683353215094,CSE 141,A01,185458,Eldon; John,20,0,100,80
1683353216119,CSE 141L,A01,185461,Eldon; John,12,0,100,88
1683353217144,CSE 142,A01,185463,Staff,36,0,60,24
1683353217144,CSE 142,B01,201355,Staff,0,7,60,60
1683353218172,CSE 142L,A01,185470,Staff,36,0,60,24
1683353218172,CSE 142L,B01,201417,Staff,0,6,60,60
1683353219196,CSE 190,A00,201433,Staff,32,0,49,17
1683353220225,DOC 1,A01,259136,Strom; Megan C.,7,0,15,8
1683353220225,DOC 1,A02,259137,Strom; Megan C.,14,0,15,1
1683353220225,DOC 1,A03,259138,Strom; Megan C.,14,0,15,1
1683353220225,DOC 1,A04,259139,Strom; Megan C.,14,0,15,1
1683353221254,DOC 100D,A00,259140,Pass; Natalye Joann,16,0,25,9
1683353222281,DSGN 1,A01,184749,Rill; Bryan,0,25,30,30
1683353223306,DSGN 100,A01,185168,Staff,0,2,25,25
1683353224333,ECE 5,A01,185626,Morris; Karcher William,0,10,0,0
1683353225357,ECE 101,A01,185628,Staff,17,0,70,53
1683353226383,ECE 107,A01,185635,Baghdadchi; Saharnaz,0,0,20,20
1683353226383,ECE 107,A02,185638,Baghdadchi; Saharnaz,4,0,20,16
1683353227411,ECE 148,A01,185647,Silberman; Jack,0,0,16,16
1683353228435,ECON 1,A01,185537,Crane; Meredith Helen,54,0,70,16
1683353229459,ECON 3,A01,185549,Crane; Meredith Helen,32,0,70,38
1683353230483,ECON 4,A01,203354,Anderson; John Charles,0,4,10,10
1683353231510,ECON 100A,A01,185574,Staff,0,4,40,40
1683353232536,ECON 100B,A01,185576,Staff,0,12,50,50
1683353233560,ECON 100C,A01,185589,Newhouse; Herbert S,29,0,70,41
1683353234588,ECON 105,A00,185608,Vespa; Emanuel Ignacio,19,0,35,16
1683353235615,ECON 109,A01,185610,Shishkin; Denis,10,0,35,25
1683353236640,ECON 110A,A01,185612,Staff,11,0,40,29
1683353237664,ECON 120A,A01,185615,Staff,20,0,40,20
1683353238692,ECON 120C,A01,185617,Sun; Yixiao,0,21,70,70
1683353239721,ECON 144,A00,203346,Squires; Dale E,3,0,35,32
1683353240745,ECON 171,A01,203349,Newhouse; Herbert S,0,1,35,35
1683353241770,ECON 173A,A01,185621,Toda; Alexis Akira,21,0,35,14
1683353242795,EDS 25,A01,202413,Staff,0,1,0,0
1683353242795,EDS 25,A02,202414,Staff,0,1,0,0
1683353242795,EDS 25,A03,202415,Staff,0,0,0,0
1683353242795,EDS 25,A04,202416,Staff,0,1,0,0
1683353242795,EDS 25,A05,202439,Staff,0,0,0,0
1683353242795,EDS 25,A06,202440,Staff,0,0,0,0
1683353242795,EDS 25,B01,202631,Staff,0,0,0,0
1683353242795,EDS 25,B02,202632,Staff,0,0,0,0
1683353242795,EDS 25,B03,202639,Staff,0,0,0,0
1683353242795,EDS 25,B04,202640,Staff,0,0,0,0
1683353242795,EDS 25,B05,202643,Staff,0,0,0,0
1683353242795,EDS 25,B06,202644,Staff,0,0,0,0
1683353243824,EDS 38,A01,202659,Black; Alison Michelle,24,0,25,1
1683353244849,EDS 115,A00,202652,Staff,18,0,30,12
1683353245873,EDS 125,A00,202649,Staff,14,0,30,16
1683353246900,EDS 126,A01,203332,Staff,30,0,30,0
1683353247926,EDS 139,A00,202838,Staff,16,0,25,9
1683353248949,EDS 146,A01,202655,Staff,14,0,25,11
1683353249978,ENG 15,A00,185667,Staff,0,1,0,0
1683353249978,ENG 15,B00,185672,Staff,0,0,0,0
1683353249978,ENG 15,C00,185675,Staff,0,0,0,0
1683353249978,ENG 15,D00,185682,Staff,0,0,0,0
1683353249978,ENG 15,E00,185684,Staff,0,0,0,0
1683353251006,ETHN 103,A00,185710,Staff,0,4,35,35
1683353252034,ETHN 103A,A00,199228,Man; Simeon S,2,0,9,7
1683353253060,ETHN 109,A00,185711,Staff,18,0,35,17
1683353254086,ETHN 142,A00,185726,Staff,0,4,30,30
1683353255113,ETHN 163J,A00,199229,Man; Simeon S,5,0,8,3
1683353256136,ETHN 168,A00,185727,Staff,8,0,10,2
1683353257160,ETHN 182,A00,185728,Staff,0,0,35,35
1683353258183,ETHN 183,A00,185737,Staff,8,0,18,10
1683353259207,GLBH 111,A01,209361,Burgos; Jose L.,0,0,0,0
1683353261256,HIEU 104,A00,185792,Staff,16,0,20,4
1683353262282,HIEU 115,A00,185800,Staff,1,0,20,19
1683353263309,HIEU 128,A00,185801,Staff,0,7,20,20
1683353264336,HIEU 147,A00,185802,Staff,16,0,20,4
1683353265363,HIEU 154,A00,185823,Staff,12,0,20,8
1683353266389,HILA 102,A00,185826,Staff,13,0,20,7
1683353267417,HILD 2C,A01,185778,Staff,0,12,20,20
1683353268444,HILD 7B,A01,185780,Kwak; Nancy,0,15,32,32
1683353268444,HILD 7B,A02,185781,Kwak; Nancy,0,18,32,32
1683353269471,HILD 30,A01,185791,Staff,14,0,20,6
1683353270498,HISC 119,A00,185830,Golan; Tal,0,9,20,20
1683353271525,HITO 156GS,A00,185831,Patterson; Patrick H.,0,0,0,23
1683353272552,HIUS 103,A00,185832,Man; Simeon S,0,6,20,20
1683353273576,HIUS 117,A00,185836,Kwak; Nancy,2,0,20,18
1683353274600,HIUS 125,A00,185840,Man; Simeon S,0,0,23,23
1683353275624,HIUS 149,A00,185845,Staff,0,0,20,20
1683353276647,HUM 3,A01,185882,Zavodny; Tatiana Sophia,0,7,50,50
1683353276647,HUM 3,B01,185899,Caldwell; Michael Alan,0,18,50,50
1683353277673,HUM 3GS,A00,185900,Patterson; Patrick H.,0,0,0,23
1683353278697,HUM 4,A01,185938,Zroka; Amy Liane,31,0,50,19
1683353278697,HUM 4,B01,185956,Watkins; Eric,0,3,50,50
1683353278697,HUM 4,B02,202209,Watkins; Eric,0,2,50,50
1683353278697,HUM 4,B03,202210,Watkins; Eric,0,2,50,50
1683353279782,HUM 5,A01,185958,West; Geoffrey Scott,3,0,50,47
1683353279782,HUM 5,A02,202215,West; Geoffrey Scott,0,0,50,50
1683353280808,INTL 190,A00,185959,Gagnon; Jeffrey C,0,0,0,9
1683353280808,INTL 190,B00,185960,Lettieri; Michael Joseph,0,0,0,1
1683353281831,JAPN 180,A00,254509,Staff,4,0,30,26
1683353282866,LATI 10,A01,202853,Kennemore; Amy Michelle,4,0,35,31
1683353282866,LATI 10,A02,202854,Kennemore; Amy Michelle,2,0,35,33
1683353282866,LATI 10,A03,270054,Kennemore; Amy Michelle,30,0,30,0
1683353283891,LATI 180,A00,202855,Kennemore; Amy Michelle,11,0,20,9
1683353284915,LAWS 101,A00,201767,Golan; Tal,0,7,40,40
1683353285942,LIFR 1C,A00,185961,Staff,6,0,20,14
1683353286968,LIFR 1CX,A00,185962,Staff,7,0,20,13
1683353287995,LIFR 1D,A00,185963,Staff,9,0,20,11
1683353289020,LIFR 1DX,A00,185964,Staff,9,0,20,11
1683353290044,LIGN 101,A01,186039,Staff,43,0,50,7
1683353291070,LIGN 165,A00,186040,Staff,18,0,50,32
1683353292093,LTCS 108,A00,186041,Staff,6,0,10,4
1683353293117,LTCS 119,A00,186042,Staff,16,0,20,4
1683353294140,LTCS 130,A00,186043,Wesling; Megan E.,15,0,25,10
1683353296191,LTEA 138,A00,186119,Staff,14,0,40,26
1683353297220,LTEN 124,A00,186148,Staff,6,0,25,19
1683353298244,LTEN 178,A00,186149,Staff,7,0,15,8
1683353299268,LTEN 181,A00,186150,Blanco; John D,33,0,40,7
1683353300292,LTWL 120,A00,186160,Staff,20,0,25,5
1683353301335,LTWL 165,A00,186161,Staff,22,0,25,3
1683353302356,LTWR 100,A00,186162,Staff,0,5,15,15
1683353303379,LTWR 102,A00,186163,Doller; Ben,5,0,15,10
1683353304402,MAE 8,A01,186412,Staff,0,0,0,0
1683353305426,MAE 30B,A00,186445,Bahadori; Mohammad Yousef,83,0,100,17
1683353306450,MAE 40,A00,186592,Bewley; Thomas R,9,0,50,41
1683353307475,MAE 101B,A00,186593,Bahadori; Mohammad Yousef,81,0,100,19
1683353308502,MAE 105,A00,186594,Bandaru; Prabhakar,12,0,50,38
1683353309528,MAE 107,A00,186599,Pham; Hieu Tan,0,6,120,120
1683353310554,MAE 148,A01,186660,Silberman; Jack,3,0,16,13
1683353311578,MATH 10A,A01,188095,Staff,0,5,35,35
1683353312608,MATH 10B,A01,188097,Bowers; Adam R.,0,11,30,30
1683353312608,MATH 10B,A02,188099,Bowers; Adam R.,0,11,30,30
1683353312608,MATH 10B,B01,188104,Bowers; Adam R.,0,10,30,30
1683353312608,MATH 10B,B02,188106,Bowers; Adam R.,0,10,30,30
1683353313640,MATH 10C,A01,188111,Staff,0,18,30,30
1683353313640,MATH 10C,A02,188127,Staff,0,17,30,30
1683353313640,MATH 10C,A03,188131,Staff,0,18,30,30
1683353313640,MATH 10C,B01,188218,Staff,18,0,30,12
1683353313640,MATH 10C,B02,188244,Staff,13,0,30,17
1683353313640,MATH 10C,B03,188277,Staff,16,0,30,14
1683353314666,MATH 18,A01,188344,Bach; Quang Tran,18,0,30,12
1683353314666,MATH 18,A02,188345,Bach; Quang Tran,11,0,30,19
1683353314666,MATH 18,B01,188353,Bach; Quang Tran,10,0,30,20
1683353314666,MATH 18,B02,188354,Bach; Quang Tran,20,0,30,10
1683353315691,MATH 20A,A01,188374,Staff,12,0,35,23
1683353316720,MATH 20B,A01,188382,Ohm; Ko Woon,6,0,30,24
1683353316720,MATH 20B,A02,188383,Ohm; Ko Woon,22,0,30,8
1683353316720,MATH 20B,B01,188385,Ohm; Ko Woon,7,0,30,23
1683353316720,MATH 20B,B02,188392,Ohm; Ko Woon,22,0,30,8
1683353317743,MATH 20C,A01,188394,Harel; Guershon,10,0,30,20
1683353317743,MATH 20C,A02,188395,Harel; Guershon,15,0,30,15
1683353317743,MATH 20C,B01,188404,Harel; Guershon,4,0,30,26
1683353317743,MATH 20C,B02,188405,Harel; Guershon,19,0,30,11
1683353318775,MATH 20D,A01,188414,Hammock; Frances H,0,1,30,30
1683353318775,MATH 20D,A02,188415,Hammock; Frances H,3,0,30,27
1683353318775,MATH 20D,B01,188447,Hammock; Frances H,1,0,30,29
1683353318775,MATH 20D,B02,188486,Hammock; Frances H,8,0,30,22
1683353319799,MATH 20E,A01,188649,Staff,21,0,30,9
1683353319799,MATH 20E,A02,188650,Staff,23,0,30,7
1683353319799,MATH 20E,A03,188673,Staff,0,0,30,30
1683353320826,MATH 102,A01,188675,Staff,0,35,35,35
1683353321856,MATH 103B,A01,188681,Staff,3,0,35,32
1683353321856,MATH 103B,B01,188692,Staff,5,0,35,30
1683353322881,MATH 109,A01,188695,Salehi Golsefidy; Alireza,25,0,35,10
1683353322881,MATH 109,A02,188696,Salehi Golsefidy; Alireza,25,0,35,10
1683353323908,MATH 120A,A01,188698,Eggers; John Dietrich,7,0,35,28
1683353324931,MATH 142B,A01,188736,Ioana; Adrian,0,2,30,30
1683353324931,MATH 142B,A02,188741,Ioana; Adrian,0,0,30,30
1683353324931,MATH 142B,A03,188743,Ioana; Adrian,0,1,30,30
1683353325955,MATH 168A,A01,188790,Staff,0,9,35,35
1683353326982,MATH 170A,A01,188803,Nie; Jiawang,0,2,35,35
1683353326982,MATH 170A,A02,188811,Nie; Jiawang,0,0,35,35
1683353326982,MATH 170A,A03,188814,Nie; Jiawang,1,0,35,34
1683353326982,MATH 170A,A04,188815,Nie; Jiawang,13,0,35,22
1683353328012,MATH 193B,A01,188817,Staff,0,0,35,35
1683353328012,MATH 193B,A02,188818,Staff,5,0,35,30
1683353329041,MGT 4,A01,202857,Anderson; John Charles,61,0,80,19
1683353330064,MGT 12,A00,202858,Lindenberger; Wade Douglas,42,0,90,48
1683353331089,MGT 18,A00,202859,Staff,74,0,90,16
1683353332117,MGT 18GS,A00,202860,McKay; Michael J,13,0,28,15
1683353333146,MGT 45,A00,202861,Pecore; Joseph P.,14,0,90,76
1683353334173,MGT 100,A00,202863,Yavorsky; Daniel Ryan,28,0,90,62
1683353335198,MGT 103,A00,202864,Ehrich; Kristine R,0,17,90,90
1683353336223,MGT 112,A00,202865,Ehrich; Kristine R,15,0,90,75
1683353337251,MGT 121A,A00,202868,Staff,0,20,0,0
1683353338274,MGT 131B,A00,202869,Anderson; John Charles,59,0,90,31
1683353339298,MGT 136,A00,202871,Lindenberger; Wade Douglas,84,0,90,6
1683353340323,MGT 164,A00,202873,Staff,0,68,90,91
1683353341352,MGT 164GS,A00,202874,McKay; Mary A,13,0,28,15
1683353342376,MGT 180,A00,202875,Staff,0,50,90,91
1683353343400,MMW 11R,A01,205019,Herbst; Matthew,3,0,30,27
1683353343400,MMW 11R,A02,205026,Herbst; Matthew,29,0,30,1
1683353344432,MMW 15,A01,193512,Chang; Edmond Yi-Teh,0,9,28,28
1683353344432,MMW 15,A02,193513,Chang; Edmond Yi-Teh,0,5,28,28
1683353344432,MMW 15,A03,193514,Chang; Edmond Yi-Teh,0,5,28,28
1683353344432,MMW 15,A04,193515,Chang; Edmond Yi-Teh,0,5,28,28
1683353344432,MMW 15,A05,193516,Chang; Edmond Yi-Teh,0,4,28,28
1683353344432,MMW 15,A06,193517,Chang; Edmond Yi-Teh,0,5,28,28
1683353344432,MMW 15,B01,193519,Chang; Edmond Yi-Teh,0,5,28,28
1683353344432,MMW 15,B02,193520,Chang; Edmond Yi-Teh,0,5,28,28
1683353344432,MMW 15,B03,193521,Chang; Edmond Yi-Teh,0,5,28,28
1683353344432,MMW 15,B04,193522,Chang; Edmond Yi-Teh,0,4,28,28
1683353344432,MMW 15,B05,193523,Chang; Edmond Yi-Teh,0,5,28,28
1683353344432,MMW 15,B06,193524,Chang; Edmond Yi-Teh,0,4,28,28
1683353345460,MMW 122,A01,193526,Rahimi; Babak,0,15,28,28
1683353345460,MMW 122,A02,193527,Rahimi; Babak,0,14,28,28
1683353345460,MMW 122,A03,193528,Rahimi; Babak,0,0,0,0
1683353345460,MMW 122,A04,193529,Rahimi; Babak,0,0,0,0
1683353346485,MUS 1A,A01,186663,Staff,0,20,35,35
1683353347509,MUS 4,A01,186715,Staff,0,12,35,35
1683353348537,MUS 5R,A01,186796,Dubnov; Shlomo,0,17,35,35
1683353349563,MUS 6,A01,186798,Staff,0,4,25,25
1683353350588,MUS 7,A01,186830,Staff,13,0,35,22
1683353351617,MUS 8,A01,186930,Staff,0,26,35,35
1683353352642,MUS 15,A01,186932,Staff,0,16,35,35
1683353352642,MUS 15,B01,186934,Staff,0,15,35,35
1683353353670,MUS 80,A00,186935,Staff,1,0,20,19
1683353353670,MUS 80,B00,186936,Staff,25,0,25,0
1683353354695,NANO 11,A00,204702,Lipomi; Darren John,0,0,0,0
1683353355724,NANO 15,A01,204709,Yang; Kesong,0,1,0,0
1683353356752,NANO 114,A00,202069,Jahed Motlagh; Zeinab,3,0,10,7
1683353357779,PHIL 1,A00,186955,Grush; Rick Scott,32,0,40,8
1683353358805,PHIL 10,A01,186973,Grush; Rick Scott,28,0,35,7
1683353358805,PHIL 10,A02,186974,Grush; Rick Scott,33,0,35,2
1683353359829,PHIL 13,A01,186976,Staff,7,0,35,28
1683353359829,PHIL 13,A02,186977,Staff,16,0,35,19
1683353360860,PHIL 14,A01,186979,Staff,31,0,35,4
1683353360860,PHIL 14,A02,186986,Staff,32,0,35,3
1683353361889,PHIL 28,A01,186988,Staff,16,0,30,14
1683353361889,PHIL 28,A02,186989,Staff,1,0,30,29
1683353361889,PHIL 28,A03,186990,Staff,9,0,30,21
1683353361889,PHIL 28,A04,186991,Staff,26,0,30,4
1683353362920,PHIL 120,A00,186997,Staff,23,0,40,17
1683353363945,PHIL 137,A00,187003,Staff,9,0,40,31
1683353364976,PHIL 150,A00,187015,Staff,47,0,70,23
1683353366001,PHIL 167,A00,187021,Lamey; Andy M.,35,0,40,5
1683353367025,PHIL 174,A01,202226,Staff,17,0,20,3
1683353367025,PHIL 174,A02,202235,Staff,20,0,20,0
1683353368051,PHIL 191A,A00,258918,Staff,0,0,1,1
1683353369076,PHYS 1A,A00,187028,Staff,27,0,60,33
1683353370101,PHYS 1AL,001,187036,Staff,2,0,30,28
1683353370101,PHYS 1AL,002,187049,Staff,18,0,30,12
1683353371128,PHYS 1B,A00,187058,Staff,22,0,60,38
1683353372152,PHYS 1BL,001,187064,Staff,0,0,30,30
1683353372152,PHYS 1BL,002,187070,Staff,5,0,30,25
1683353373177,PHYS 1C,A00,187082,Staff,31,0,120,89
1683353374204,PHYS 1CL,001,187088,Staff,0,9,30,30
1683353374204,PHYS 1CL,002,187089,Staff,0,2,30,30
1683353374204,PHYS 1CL,009,262693,Staff,11,0,30,19
1683353375229,PHYS 2B,A01,187097,Staff,54,0,115,61
1683353376252,PHYS 2C,A01,187099,Staff,67,0,115,48
1683353377277,PHYS 2CL,A01,187101,Staff,5,0,28,23
1683353377277,PHYS 2CL,A02,187102,Staff,15,0,28,13
1683353378301,PHYS 2D,A01,187123,Shotwell; Brian,95,0,115,20
1683353379330,PHYS 4B,A01,187133,Grinstein; Benjamin,35,0,50,15
1683353380358,POLI 10,A00,188819,Staff,0,4,50,50
1683353381383,POLI 11,A00,188827,Staff,43,0,50,7
1683353382407,POLI 13R,A00,188828,Staff,0,1,20,20
1683353383494,POLI 27,A01,188830,Elgin; Samuel Zincke,0,1,70,70
1683353384518,POLI 30,A00,188832,Desposato; Scott,31,0,50,19
1683353385544,POLI 102F,A00,188834,Staff,3,0,40,37
1683353386572,POLI 104A,A00,188852,Staff,14,0,30,16
1683353387596,POLI 104I,A00,188853,Staff,0,6,20,20
1683353388621,POLI 110B,A00,188854,Wiens; David,7,0,20,13
1683353389645,POLI 112A,A00,188855,Wiens; David,5,0,30,25
1683353390671,POLI 117R,A00,188856,Forman; Fonna,0,11,20,20
1683353391701,POLI 118,A00,188857,Ingham; Sean,8,0,20,12
1683353392729,POLI 120G,A00,188858,Staff,9,0,30,21
1683353393753,POLI 131CR,A00,188863,Hoston; Germaine,23,0,50,27
1683353394778,POLI 133,A00,188864,Nellis; Gareth Hb,44,0,50,6
1683353395802,POLI 134D,A00,188865,Desposato; Scott,27,0,30,3
1683353396830,POLI 142A,A00,188871,Gartzke; Erik,22,0,50,28
1683353397856,POLI 142K,A00,188874,Staff,38,0,50,12
1683353398879,POLI 143,A00,188940,Gartzke; Erik,16,0,30,14
1683353399902,POLI 153,A00,188943,Staff,3,0,20,17
1683353400930,POLI 160AA,A00,188944,Staff,11,0,40,29
1683353401959,POLI 170A,A00,188945,Staff,11,0,30,19
1683353404014,PSYC 1,A00,188952,Staff,37,0,90,53
1683353405040,PSYC 2,B00,188953,Staff,19,0,35,16
1683353406064,PSYC 6,A00,188970,Staff,47,0,60,13
1683353407092,PSYC 7,A00,188973,Staff,37,0,45,8
1683353408118,PSYC 60,A01,188980,Rickard; Timothy C.,43,0,60,17
1683353409142,PSYC 70,A01,189001,Steiner; Eric Tomas,23,0,45,22
1683353410165,PSYC 100,A00,189005,Lacefield; Katharine I,0,98,120,120
1683353411193,PSYC 102,A00,189008,Staff,9,0,30,21
1683353412216,PSYC 106,B00,189026,Gorman; Michael R.,34,0,60,26
1683353413238,PSYC 114,B01,189033,Winkielman; Piotr,0,32,30,30
1683353414262,PSYC 131,A00,189036,Anagnostaras; Stephan,0,43,60,60
1683353415290,PSYC 136,A00,189041,Lowe; Angela Beth,0,7,25,25
1683353416316,PSYC 137,A00,189057,Winkielman; Piotr,0,34,25,25
1683353417342,PSYC 144,A00,189107,Wixted; John T,0,7,50,50
1683353419392,PSYC 162,A00,189142,Staff,0,8,85,85
1683353420418,PSYC 172,A00,189144,Gorman; Michael R.,0,7,30,30
1683353422468,PSYC 179,A00,189146,Lacefield; Katharine I,0,84,120,120
1683353423491,PSYC 181,A00,189147,Anagnostaras; Stephan,0,44,90,90
1683353424519,PSYC 190R,A00,189148,Barner; David A.,0,22,80,80
1683353425546,PSYC 191,A00,189275,Rickard; Timothy C.,0,7,25,25
1683353426570,PSYC 193,A00,189276,Chapman; Eddie Nathaniel,0,1,0,4
1683353427598,PSYC 193L,A01,189281,Lowe; Angela Beth,12,0,20,8
1683353427598,PSYC 193L,B01,189285,Staff,28,0,35,7
1683353428621,RELI 149,A00,187137,Rahimi; Babak,7,0,40,33
1683353429649,SE 9,A01,187315,Staff,0,2,18,18
1683353430675,SE 101B,A00,187409,Staff,24,0,30,6
1683353431703,SE 110B,A00,187444,Staff,10,0,40,30
1683353432730,SE 130B,A00,187449,Staff,31,0,40,9
1683353433754,SE 150A,A00,187516,Staff,9,0,20,11
1683353434777,SE 154,A00,187528,Staff,30,0,50,20
1683353435801,SIO 3,A01,258171,Staff,35,0,40,5
1683353436825,SIO 10,A00,187144,Cook; Geoffrey W,0,3,75,75
1683353437851,SIO 45,A00,187152,Cook; Geoffrey W,1,0,100,99
1683353438874,SIO 109R,A00,194486,Staff,0,3,20,20
1683353440925,SIO 187,A01,187233,Kacev; David,12,0,40,28
1683353441949,SOCI 1,A01,258656,Thorpe; Charles Robert,28,0,30,2
1683353441949,SOCI 1,A02,258658,Thorpe; Charles Robert,30,0,30,0
1683353441949,SOCI 1,A03,258661,Thorpe; Charles Robert,25,0,25,0
1683353441949,SOCI 1,A04,258666,Thorpe; Charles Robert,22,0,25,3
1683353441949,SOCI 1,A05,258897,Thorpe; Charles Robert,23,0,25,2
1683353441949,SOCI 1,A06,258898,Thorpe; Charles Robert,25,0,25,0
1683353442977,SOCI 30,A01,258903,Pardo Guerra; Juan Pablo,15,0,30,15
1683353444004,SOCI 102,A00,258904,Staff,9,0,25,16
1683353445031,SOCI 106,A00,258905,Staff,19,0,25,6
1683353446055,SOCI 111,A00,258907,Ribas Norris; Janet Vanesa,26,0,30,4
1683353447079,SOCI 121R,A00,258908,Pardo Guerra; Juan Pablo,10,0,30,20
1683353448104,SOCI 126,A01,203330,Staff,14,0,20,6
1683353449132,SOCI 131,A00,258909,Thorpe; Charles Robert,31,0,60,29
1683353450161,SOCI 135,A00,258910,Payne; Christine Anna,0,9,30,30
1683353451189,SOCI 157,A00,258911,Staff,12,0,30,18
1683353452213,SOCI 184,A00,258912,Staff,25,0,30,5
1683353453240,SOCI 188D,A00,258913,Staff,22,0,30,8
1683353454268,SYN 2,001,187529,Staff,10,0,16,6
1683353454268,SYN 2,002,201452,Staff,0,18,16,16
1683353454268,SYN 2,003,201469,Staff,3,0,16,13
1683353455295,SYN 100,A01,187531,Staff,0,9,20,20
1683353455295,SYN 100,B01,201491,Staff,0,12,20,20
1683353456323,TDAC 1,A00,189286,Walsh; Kim C.,3,0,20,17
1683353456323,TDAC 1,B00,189287,Harting; Carla Kelso,11,0,20,9
1683353457350,TDAC 101,A00,189300,Walsh; Kim C.,16,0,20,4
1683353457350,TDAC 101,B00,189301,Harting; Carla Kelso,18,0,20,2
1683353458374,TDAC 102,A00,189304,Basso; Beatrice,14,0,20,6
1683353459403,TDAC 108,A00,189305,Staff,18,0,20,2
1683353460431,TDDE 131,A00,189310,Staff,19,0,20,1
1683353460431,TDDE 131,B00,189314,Staff,19,0,20,1
1683353460431,TDDE 131,C00,189315,Staff,48,0,50,2
1683353460431,TDDE 131,D00,189316,Staff,14,0,15,1
1683353460431,TDDE 131,E00,204841,Staff,20,0,20,0
1683353461456,TDGE 10,A00,189289,Staff,30,0,50,20
1683353461456,TDGE 10,B00,189290,Havis; Allan,1,0,50,49
1683353462482,TDGE 11,A00,189291,Fulton; Julia,0,3,50,50
1683353462482,TDGE 11,B00,189292,Staff,20,0,25,5
1683353462482,TDGE 11,C00,260270,Staff,0,0,0,0
1683353463507,TDGE 25,A00,189294,Staff,3,0,20,17
1683353464531,TDGE 124,A00,189318,Fulton; Julia,0,8,50,50
1683353465557,TDGE 125,A00,189319,Staff,13,0,25,12
1683353465557,TDGE 125,B00,189320,Staff,23,0,25,2
1683353466584,TDGE 127,A00,189322,Havis; Allan,0,0,50,50
1683353467610,TDHT 101,A00,189323,Staff,18,0,25,7
1683353467610,TDHT 101,B00,189324,Staff,25,0,25,0
1683353468639,TDHT 102,A00,189325,Staff,49,0,50,1
1683353469663,TDMV 1,A00,189295,Arcidiacono; Kristin,19,0,30,11
1683353469663,TDMV 1,B00,189296,Caligagan; Maria T.,24,0,30,6
1683353470688,TDMV 2,A00,189297,Sammartano; Tonnie,28,0,30,2
1683353470688,TDMV 2,B00,189299,Arcidiacono; Kristin,24,0,30,6
1683353471716,TDMV 3,A00,204998,Rincon; Alicia,22,0,30,8
1683353472744,TDMV 120,A00,189458,Sammartano; Tonnie,28,0,30,2
1683353473769,TDMV 138,A00,189541,Jun; Grace Shin Hae,22,0,40,18
1683353474798,TDMV 142,A00,189717,Caligagan; Tony,23,0,30,7
1683353474798,TDMV 142,B00,189718,Caligagan; Maria T.,25,0,30,5
1683353475827,TMC 2,A01,187533,Staff,25,0,25,0
1683353475827,TMC 2,A02,187534,Staff,25,0,25,0
1683353476850,USP 1,A01,187536,Kwak; Nancy,0,16,25,25
1683353477877,USP 5,A01,187538,Staff,10,0,25,15
1683353478906,USP 101,A00,199253,Staff,0,4,0,0
1683353479932,USP 124,A00,187562,Boomhower; Matthew Charles,1,0,30,29
1683353480956,USP 138,A00,187582,Staff,20,0,25,5
1683353481981,USP 152,A01,187597,Staff,4,0,25,21
1683353483008,USP 153,A00,187598,Staff,19,0,25,6
1683353484038,USP 168,A00,187607,Kwak; Nancy,2,0,5,3
1683353485061,USP 173,A00,187619,Staff,4,0,25,21
1683353486089,USP 181,A00,187638,Staff,0,3,25,25
1683353487185,VIS 103,A00,187650,Cruz; Edwin Teddy,22,0,75,53
1683353488208,VIS 110D,A00,187669,Staff,12,0,22,10
1683353489237,VIS 127C,A00,187720,Shen; Kuiyi,67,0,146,79
1683353490261,VIS 149,A00,187731,Yoldas; Pinar,0,14,22,22
1683353491288,VIS 151,A01,188091,Staff,22,0,34,12
1683353491288,VIS 151,A02,188092,Staff,11,0,34,23
1683353492313,VIS 160B,A00,188093,Stalbaum; Brett,0,0,10,10
1683353494359,WCWP 10B,A00,201720,Staff,10,0,15,5
1683353494359,WCWP 10B,B00,201722,Staff,9,0,15,6
1683353495387,WCWP 100,A00,201725,Gagnon; Jeffrey C,0,0,2,2
1683353495387,WCWP 100,B00,201727,Staff,0,4,15,15
1683353498523,ANBI 133,A00,258401,Wilder; Linnea Lorene,34,0,40,6
1683353499547,ANBI 140,A00,258395,Hrvoj Mihic; Branka,18,0,25,7
1683353500572,ANSC 120,A00,258402,Bialecki; Jon Anthony,27,0,40,13
1683353501600,ANSC 144,A00,258400,Staff,14,0,40,26
1683353503649,ANSC 166,A00,258396,Parish; Steven Martin,157,0,175,18
1683353504677,ANSC 180,A00,193533,Staff,9,0,20,11
1683353505701,ANSC 188,A00,258397,Jassal; Aftab,33,0,40,7
1683353506728,ANTH 3,A01,258316,Staff,23,0,30,7
1683353507752,ANTH 5,A00,258394,Semendeferi; Ekaterini,16,0,20,4
1683353508779,ANTH 21,A01,258331,Staff,8,0,40,32
1683353509806,ANTH 103,A00,258398,Varma; Saiba,15,0,25,10
1683353510833,AWP 10,001,202034,Staff,0,0,0,0
1683353510833,AWP 10,002,202035,Staff,0,0,0,0
1683353510833,AWP 10,003,202036,Staff,0,0,0,0
1683353510833,AWP 10,004,202037,Staff,0,0,0,0
1683353510833,AWP 10,005,202038,Staff,0,0,0,0
1683353510833,AWP 10,006,202039,Staff,0,0,0,0
1683353510833,AWP 10,007,202040,Staff,0,0,0,0
1683353510833,AWP 10,008,202041,Staff,0,0,0,0
1683353510833,AWP 10,009,202042,Staff,0,0,0,0
1683353510833,AWP 10,010,202043,Staff,0,0,0,0
1683353510833,AWP 10,011,202044,Staff,0,0,0,0
1683353510833,AWP 10,012,202045,Staff,0,0,0,0
1683353510833,AWP 10,013,202046,Staff,0,0,0,0
1683353510833,AWP 10,014,202047,Staff,0,0,0,0
1683353510833,AWP 10,015,202048,Staff,0,0,0,0
1683353510833,AWP 10,016,202049,Staff,0,0,0,0
1683353510833,AWP 10,017,202050,Staff,0,0,0,0
1683353510833,AWP 10,018,202051,Staff,0,0,0,0
1683353510833,AWP 10,019,202052,Staff,0,0,0,0
1683353510833,AWP 10,020,202053,Staff,0,0,0,0
1683353510833,AWP 10,021,202054,Staff,0,0,0,0
1683353510833,AWP 10,022,202055,Staff,0,0,0,0
1683353510833,AWP 10,023,202056,Staff,0,0,0,0
1683353510833,AWP 10,024,202057,Staff,0,0,0,0
1683353510833,AWP 10,025,202058,Staff,0,0,0,0
1683353510833,AWP 10,026,202059,Staff,0,0,0,0
1683353511861,AWP 102,001,202032,Staff,0,0,0,0
1683353511861,AWP 102,002,202033,Staff,0,0,0,0
1683353512889,BENG 100,A01,254234,Taylor Amos; Alyssa C,31,0,40,9
1683353513916,BENG 196,001,270013,Engler; Adam J.,9999,0,9999,0
1683353514947,BICD 100R,A01,202018,Smith; Laurie,0,7,32,32
1683353514947,BICD 100R,A02,202019,Smith; Laurie,0,2,32,32
1683353514947,BICD 100R,A03,202020,Smith; Laurie,0,1,32,32
1683353514947,BICD 100R,A04,202021,Smith; Laurie,9,0,32,23
1683353514947,BICD 100R,A05,202022,Smith; Laurie,12,0,32,20
1683353515978,BICD 136,A01,193242,Gustafson-Brown; Cindy,0,2,32,32
1683353515978,BICD 136,A02,193244,Gustafson-Brown; Cindy,14,0,32,18
1683353517003,BIEB 102,A01,193249,Butler; Shannon Rhey,0,2,32,32
1683353517003,BIEB 102,A02,193251,Butler; Shannon Rhey,0,0,32,32
1683353517003,BIEB 102,A03,193253,Butler; Shannon Rhey,0,1,32,32
1683353517003,BIEB 102,A04,193255,Butler; Shannon Rhey,17,0,32,15
1683353517003,BIEB 102,A05,193265,Butler; Shannon Rhey,26,0,32,6
1683353517003,BIEB 102,A06,193269,Butler; Shannon Rhey,16,0,32,16
1683353519053,BIEB 150,A01,193274,Staff,0,0,32,32
1683353519053,BIEB 150,A02,193285,Staff,23,0,32,9
1683353520079,BIEB 194,A00,193286,Kurle; Carolyn M.,22,0,32,10
1683353521104,BILD 1,A01,192291,Staff,16,0,32,16
1683353521104,BILD 1,A02,192292,Staff,30,0,32,2
1683353521104,BILD 1,B01,192520,Reuther; Keefe,0,1,0,0
1683353521104,BILD 1,B02,192532,Reuther; Keefe,0,1,0,0
1683353522135,BILD 3,A01,192556,Butler; Shannon Rhey,0,0,32,32
1683353522135,BILD 3,A02,192581,Butler; Shannon Rhey,4,0,32,28
1683353522135,BILD 3,A03,192611,Butler; Shannon Rhey,23,0,32,9
1683353522135,BILD 3,A04,192612,Butler; Shannon Rhey,25,0,32,7
1683353522135,BILD 3,A05,192613,Butler; Shannon Rhey,27,0,32,5
1683353522135,BILD 3,A06,192679,Butler; Shannon Rhey,27,0,32,5
1683353522135,BILD 3,A07,192682,Butler; Shannon Rhey,22,0,32,10
1683353523163,BILD 4,A01,192836,Reuther; Keefe,0,0,24,24
1683353523163,BILD 4,A02,193044,Reuther; Keefe,4,0,24,20
1683353524189,BILD 10,A01,193142,Gustafson-Brown; Cindy,30,0,32,2
1683353524189,BILD 10,A02,193149,Gustafson-Brown; Cindy,31,0,32,1
1683353525218,BIMM 100,A01,193301,Staff,0,6,32,32
1683353525218,BIMM 100,A02,193312,Staff,0,5,32,32
1683353525218,BIMM 100,A03,193323,Staff,0,8,32,32
1683353526249,BIMM 101,A01,193329,McDonnell; Lisa Marie,0,3,24,24
1683353526249,BIMM 101,A02,193339,McDonnell; Lisa Marie,0,3,24,24
1683353526249,BIMM 101,B01,193354,McDonnell; Lisa Marie,0,3,24,24
1683353526249,BIMM 101,B02,193357,McDonnell; Lisa Marie,0,3,24,24
1683353527273,BIMM 110,A01,193377,Tat; John,0,11,32,32
1683353527273,BIMM 110,A02,193378,Tat; John,0,9,32,32
1683353528298,BIMM 120,A01,206116,Staff,0,0,32,32
1683353528298,BIMM 120,A02,206117,Staff,8,0,32,24
1683353528298,BIMM 120,A03,206121,Staff,21,0,32,11
1683353529324,BIPN 100,A01,193393,Park; Ji Young,0,14,32,32
1683353529324,BIPN 100,A02,193402,Park; Ji Young,0,13,32,32
1683353529324,BIPN 100,A03,193413,Park; Ji Young,0,14,32,32
1683353529324,BIPN 100,A04,193414,Park; Ji Young,0,13,32,32
1683353530350,BIPN 102,A01,193429,Staff,0,0,32,32
1683353530350,BIPN 102,A02,193438,Staff,22,0,32,10
1683353531379,BIPN 106,A01,193450,Reyes Gonzalez; Catalina,0,2,40,40
1683353532409,BIPN 134,A01,193465,Cooke; James Edward,1,0,32,31
1683353532409,BIPN 134,A02,193474,Cooke; James Edward,25,0,32,7
1683353532409,BIPN 134,A03,193485,Cooke; James Edward,29,0,32,3
1683353532409,BIPN 134,A04,193486,Cooke; James Edward,21,0,32,11
1683353532409,BIPN 134,A05,193491,Cooke; James Edward,31,0,32,1
1683353532409,BIPN 134,A06,193501,Cooke; James Edward,30,0,32,2
1683353532409,BIPN 134,A07,193510,Cooke; James Edward,29,0,32,3
1683353534464,BISP 194,A00,222522,Staff,14,0,32,18
1683353535492,CAT 124,A01,202407,Staff,20,0,25,5
1683353536517,CAT 125,A00,202408,Marchisotto; Jennifer Anne,4,0,20,16
1683353537542,CAT 125R,A00,202409,Smith; Lauryn Alissa,0,11,20,20
1683353537542,CAT 125R,B00,202410,Morales; Celeste Georgianna,0,11,20,20
1683353537542,CAT 125R,C00,202411,Irwin; Matthew Joseph,0,10,20,20
1683353538588,CENG 15,A01,204712,Yang; Kesong,0,1,0,0
1683353539612,CENG 114,A00,202070,Jahed Motlagh; Zeinab,5,0,20,15
1683353540637,CGS 105,A00,185477,Wesling; Megan E.,24,0,40,16
1683353541662,CGS 106,A00,185494,Staff,13,0,22,9
1683353542693,CGS 108,A00,185495,Staff,14,0,20,6
1683353543719,CGS 114,A00,185496,Staff,13,0,18,5
1683353544746,CGS 119,A00,185501,Staff,15,0,20,5
1683353545770,CGS 120,A00,185511,Staff,13,0,20,7
1683353546796,CHEM 4,A01,184675,Bussey; Thomas J,96,0,100,4
1683353547821,CHEM 6A,A01,184677,Staff,34,0,60,26
1683353548847,CHEM 6B,A01,184679,Staff,65,0,100,35
1683353549873,CHEM 6C,A01,184681,Bussey; Thomas J,1,0,50,49
1683353549873,CHEM 6C,A02,184682,Bussey; Thomas J,34,0,50,16
1683353550901,CHEM 40A,A01,184684,Albizati; Kim F.,37,0,100,63
1683353551925,CHEM 40B,A01,184686,Albizati; Kim F.,0,20,100,100
1683353552950,CHEM 41B,A01,184690,Staff,52,0,100,48
1683353553976,COGS 3,A01,184715,Boyle; Mary E. T.,0,25,40,40
1683353555003,COGS 14B,A01,185172,Staff,0,15,38,38
1683353556028,COGS 18,A01,184736,Staff,17,0,80,63
1683353557054,COGS 100,A01,184932,Staff,0,5,73,73
1683353558082,COGS 101A,A01,184935,Staff,0,39,30,30
1683353559107,COGS 101B,A01,184944,Staff,0,2,30,30
1683353560135,COGS 101C,A01,184946,Staff,0,12,30,30
1683353561159,COGS 102A,A01,184951,Johnson; Christine M.,2,0,40,38
1683353562188,COGS 107B,A01,184953,Mooshagian; Eric Frederick,0,50,40,40
1683353563212,COGS 118B,A01,184959,Gupta; Anjum,0,48,40,40
1683353564240,COGS 153,A00,184961,Staff,0,15,30,30
1683353565268,COGS 177,A00,184962,Staff,0,20,30,30
1683353566297,COGS 187A,A01,184969,Boyle; Mary E. T.,0,17,40,40
1683353567325,COMM 10,A01,185174,Staff,0,5,25,25
1683353567325,COMM 10,A02,185189,Staff,0,5,25,25
1683353567325,COMM 10,A03,269821,Staff,0,0,0,0
1683353568353,COMM 100B,A01,185475,Staff,0,0,0,2
1683353568353,COMM 100B,A02,185476,Staff,13,0,25,12
1683353569379,COMM 100C,A01,185314,Staff,1,0,25,24
1683353569379,COMM 100C,A02,185327,Staff,19,0,25,6
1683353570406,COMM 110M,A00,185349,Staff,2,0,40,38
1683353571441,COMM 113T,A00,185352,Staff,24,0,40,16
1683353572467,COMM 114I,A00,185353,Staff,33,0,40,7
1683353573491,COMM 131,A00,185354,Staff,19,0,30,11
1683353574516,CSE 8A,A50,185358,Cao; Yingjun,0,46,10,10
1683353575544,CSE 8B,A01,185362,Staff,0,46,50,50
1683353576574,CSE 11,A01,185416,Cao; Yingjun,0,92,10,10
1683353577600,CSE 20,A01,185445,Briones; Jor-el Thomas Caparas,5,0,25,20
1683353578626,CSE 21,A01,185447,Staff,10,0,50,40
1683353579652,CSE 101,A01,185451,Staff,0,13,50,50
1683353579652,CSE 101,B01,185453,Jones; Miles E,0,11,50,50
1683353581705,CSE 141,A01,185458,Eldon; John,20,0,100,80
1683353582730,CSE 141L,A01,185461,Eldon; John,12,0,100,88
1683353583755,CSE 142,A01,185463,Staff,36,0,60,24
1683353583755,CSE 142,B01,201355,Staff,0,7,60,60
1683353584780,CSE 142L,A01,185470,Staff,36,0,60,24
1683353584780,CSE 142L,B01,201417,Staff,0,6,60,60
1683353585805,CSE 190,A00,201433,Staff,32,0,49,17
1683353586830,DOC 1,A01,259136,Strom; Megan C.,7,0,15,8
1683353586830,DOC 1,A02,259137,Strom; Megan C.,14,0,15,1
1683353586830,DOC 1,A03,259138,Strom; Megan C.,14,0,15,1
1683353586830,DOC 1,A04,259139,Strom; Megan C.,14,0,15,1
1683353587858,DOC 100D,A00,259140,Pass; Natalye Joann,16,0,25,9
1683353588884,DSGN 1,A01,184749,Rill; Bryan,0,25,30,30
1683353589917,DSGN 100,A01,185168,Staff,0,2,25,25
1683353591004,ECE 5,A01,185626,Morris; Karcher William,0,10,0,0
1683353592029,ECE 101,A01,185628,Staff,17,0,70,53
1683353593059,ECE 107,A01,185635,Baghdadchi; Saharnaz,0,0,20,20
1683353593059,ECE 107,A02,185638,Baghdadchi; Saharnaz,4,0,20,16
1683353594084,ECE 148,A01,185647,Silberman; Jack,0,0,16,16
1683353595109,ECON 1,A01,185537,Crane; Meredith Helen,54,0,70,16
1683353596134,ECON 3,A01,185549,Crane; Meredith Helen,32,0,70,38
1683353597158,ECON 4,A01,203354,Anderson; John Charles,0,4,10,10
1683353598182,ECON 100A,A01,185574,Staff,0,4,40,40
1683353599209,ECON 100B,A01,185576,Staff,0,12,50,50
1683353600240,ECON 100C,A01,185589,Newhouse; Herbert S,29,0,70,41
1683353601264,ECON 105,A00,185608,Vespa; Emanuel Ignacio,19,0,35,16
1683353602293,ECON 109,A01,185610,Shishkin; Denis,10,0,35,25
1683353603318,ECON 110A,A01,185612,Staff,11,0,40,29
1683353604347,ECON 120A,A01,185615,Staff,20,0,40,20
1683353605374,ECON 120C,A01,185617,Sun; Yixiao,0,21,70,70
1683353606402,ECON 144,A00,203346,Squires; Dale E,3,0,35,32
1683353607427,ECON 171,A01,203349,Newhouse; Herbert S,0,1,35,35
1683353608455,ECON 173A,A01,185621,Toda; Alexis Akira,21,0,35,14
1683353609486,EDS 25,A01,202413,Staff,0,1,0,0
1683353609486,EDS 25,A02,202414,Staff,0,1,0,0
1683353609486,EDS 25,A03,202415,Staff,0,0,0,0
1683353609486,EDS 25,A04,202416,Staff,0,1,0,0
1683353609486,EDS 25,A05,202439,Staff,0,0,0,0
1683353609486,EDS 25,A06,202440,Staff,0,0,0,0
1683353609486,EDS 25,B01,202631,Staff,0,0,0,0
1683353609486,EDS 25,B02,202632,Staff,0,0,0,0
1683353609486,EDS 25,B03,202639,Staff,0,0,0,0
1683353609486,EDS 25,B04,202640,Staff,0,0,0,0
1683353609486,EDS 25,B05,202643,Staff,0,0,0,0
1683353609486,EDS 25,B06,202644,Staff,0,0,0,0
1683353610513,EDS 38,A01,202659,Black; Alison Michelle,24,0,25,1
1683353611542,EDS 115,A00,202652,Staff,18,0,30,12
1683353612566,EDS 125,A00,202649,Staff,14,0,30,16
1683353613591,EDS 126,A01,203332,Staff,30,0,30,0
1683353614614,EDS 139,A00,202838,Staff,16,0,25,9
1683353615642,EDS 146,A01,202655,Staff,14,0,25,11
1683353616668,ENG 15,A00,185667,Staff,0,1,0,0
1683353616668,ENG 15,B00,185672,Staff,0,0,0,0
1683353616668,ENG 15,C00,185675,Staff,0,0,0,0
1683353616668,ENG 15,D00,185682,Staff,0,0,0,0
1683353616668,ENG 15,E00,185684,Staff,0,0,0,0
1683353617692,ETHN 103,A00,185710,Staff,0,4,35,35
1683353618721,ETHN 103A,A00,199228,Man; Simeon S,2,0,9,7
1683353619745,ETHN 109,A00,185711,Staff,18,0,35,17
1683353620772,ETHN 142,A00,185726,Staff,0,4,30,30
1683353621800,ETHN 163J,A00,199229,Man; Simeon S,5,0,8,3
1683353622827,ETHN 168,A00,185727,Staff,8,0,10,2
1683353623852,ETHN 182,A00,185728,Staff,0,0,35,35
1683353624878,ETHN 183,A00,185737,Staff,8,0,18,10
1683353625905,GLBH 111,A01,209361,Burgos; Jose L.,0,0,0,0
1683353627955,HIEU 104,A00,185792,Staff,16,0,20,4
1683353628983,HIEU 115,A00,185800,Staff,1,0,20,19
1683353630009,HIEU 128,A00,185801,Staff,0,7,20,20
1683353631032,HIEU 147,A00,185802,Staff,16,0,20,4
1683353632060,HIEU 154,A00,185823,Staff,12,0,20,8
1683353633087,HILA 102,A00,185826,Staff,13,0,20,7
1683353634113,HILD 2C,A01,185778,Staff,0,12,20,20
1683353635141,HILD 7B,A01,185780,Kwak; Nancy,0,15,32,32
1683353635141,HILD 7B,A02,185781,Kwak; Nancy,0,18,32,32
1683353636165,HILD 30,A01,185791,Staff,14,0,20,6
1683353637193,HISC 119,A00,185830,Golan; Tal,0,9,20,20
1683353638218,HITO 156GS,A00,185831,Patterson; Patrick H.,0,0,0,23
1683353639241,HIUS 103,A00,185832,Man; Simeon S,0,6,20,20
1683353640264,HIUS 117,A00,185836,Kwak; Nancy,2,0,20,18
1683353641289,HIUS 125,A00,185840,Man; Simeon S,0,0,23,23
1683353642313,HIUS 149,A00,185845,Staff,0,0,20,20
1683353643341,HUM 3,A01,185882,Zavodny; Tatiana Sophia,0,7,50,50
1683353643341,HUM 3,B01,185899,Caldwell; Michael Alan,0,18,50,50
1683353644365,HUM 3GS,A00,185900,Patterson; Patrick H.,0,0,0,23
1683353645388,HUM 4,A01,185938,Zroka; Amy Liane,31,0,50,19
1683353645388,HUM 4,B01,185956,Watkins; Eric,0,3,50,50
1683353645388,HUM 4,B02,202209,Watkins; Eric,0,2,50,50
1683353645388,HUM 4,B03,202210,Watkins; Eric,0,2,50,50
1683353646412,HUM 5,A01,185958,West; Geoffrey Scott,3,0,50,47
1683353646412,HUM 5,A02,202215,West; Geoffrey Scott,0,0,50,50
1683353647438,INTL 190,A00,185959,Gagnon; Jeffrey C,0,0,0,9
1683353647438,INTL 190,B00,185960,Lettieri; Michael Joseph,0,0,0,1
1683353648465,JAPN 180,A00,254509,Staff,4,0,30,26
1683353649494,LATI 10,A01,202853,Kennemore; Amy Michelle,4,0,35,31
1683353649494,LATI 10,A02,202854,Kennemore; Amy Michelle,2,0,35,33
1683353649494,LATI 10,A03,270054,Kennemore; Amy Michelle,30,0,30,0
1683353650522,LATI 180,A00,202855,Kennemore; Amy Michelle,11,0,20,9
1683353651547,LAWS 101,A00,201767,Golan; Tal,0,7,40,40
1683353652571,LIFR 1C,A00,185961,Staff,6,0,20,14
1683353653595,LIFR 1CX,A00,185962,Staff,7,0,20,13
1683353654620,LIFR 1D,A00,185963,Staff,9,0,20,11
1683353655648,LIFR 1DX,A00,185964,Staff,9,0,20,11
1683353656676,LIGN 101,A01,186039,Staff,43,0,50,7
1683353657703,LIGN 165,A00,186040,Staff,18,0,50,32
1683353658730,LTCS 108,A00,186041,Staff,6,0,10,4
1683353659757,LTCS 119,A00,186042,Staff,16,0,20,4
1683353660784,LTCS 130,A00,186043,Wesling; Megan E.,15,0,25,10
1683353662834,LTEA 138,A00,186119,Staff,14,0,40,26
1683353663858,LTEN 124,A00,186148,Staff,6,0,25,19
1683353664887,LTEN 178,A00,186149,Staff,7,0,15,8
1683353665916,LTEN 181,A00,186150,Blanco; John D,33,0,40,7
1683353666939,LTWL 120,A00,186160,Staff,20,0,25,5
1683353667964,LTWL 165,A00,186161,Staff,22,0,25,3
1683353668992,LTWR 100,A00,186162,Staff,0,5,15,15
1683353670015,LTWR 102,A00,186163,Doller; Ben,5,0,15,10
1683353671040,MAE 8,A01,186412,Staff,0,0,0,0
1683353672068,MAE 30B,A00,186445,Bahadori; Mohammad Yousef,83,0,100,17
1683353673092,MAE 40,A00,186592,Bewley; Thomas R,9,0,50,41
1683353674115,MAE 101B,A00,186593,Bahadori; Mohammad Yousef,81,0,100,19
1683353675142,MAE 105,A00,186594,Bandaru; Prabhakar,12,0,50,38
1683353676167,MAE 107,A00,186599,Pham; Hieu Tan,0,6,120,120
1683353677194,MAE 148,A01,186660,Silberman; Jack,3,0,16,13
1683353678222,MATH 10A,A01,188095,Staff,0,5,35,35
1683353679252,MATH 10B,A01,188097,Bowers; Adam R.,0,11,30,30
1683353679252,MATH 10B,A02,188099,Bowers; Adam R.,0,11,30,30
1683353679252,MATH 10B,B01,188104,Bowers; Adam R.,0,10,30,30
1683353679252,MATH 10B,B02,188106,Bowers; Adam R.,0,10,30,30
1683353680276,MATH 10C,A01,188111,Staff,0,18,30,30
1683353680276,MATH 10C,A02,188127,Staff,0,17,30,30
1683353680276,MATH 10C,A03,188131,Staff,0,18,30,30
1683353680276,MATH 10C,B01,188218,Staff,18,0,30,12
1683353680276,MATH 10C,B02,188244,Staff,13,0,30,17
1683353680276,MATH 10C,B03,188277,Staff,16,0,30,14
1683353681302,MATH 18,A01,188344,Bach; Quang Tran,18,0,30,12
1683353681302,MATH 18,A02,188345,Bach; Quang Tran,11,0,30,19
1683353681302,MATH 18,B01,188353,Bach; Quang Tran,10,0,30,20
1683353681302,MATH 18,B02,188354,Bach; Quang Tran,20,0,30,10
1683353682326,MATH 20A,A01,188374,Staff,12,0,35,23
1683353683355,MATH 20B,A01,188382,Ohm; Ko Woon,6,0,30,24
1683353683355,MATH 20B,A02,188383,Ohm; Ko Woon,22,0,30,8
1683353683355,MATH 20B,B01,188385,Ohm; Ko Woon,7,0,30,23
1683353683355,MATH 20B,B02,188392,Ohm; Ko Woon,22,0,30,8
1683353684379,MATH 20C,A01,188394,Harel; Guershon,10,0,30,20
1683353684379,MATH 20C,A02,188395,Harel; Guershon,15,0,30,15
1683353684379,MATH 20C,B01,188404,Harel; Guershon,4,0,30,26
1683353684379,MATH 20C,B02,188405,Harel; Guershon,19,0,30,11
1683353685403,MATH 20D,A01,188414,Hammock; Frances H,0,1,30,30
1683353685403,MATH 20D,A02,188415,Hammock; Frances H,3,0,30,27
1683353685403,MATH 20D,B01,188447,Hammock; Frances H,1,0,30,29
1683353685403,MATH 20D,B02,188486,Hammock; Frances H,8,0,30,22
1683353686426,MATH 20E,A01,188649,Staff,21,0,30,9
1683353686426,MATH 20E,A02,188650,Staff,23,0,30,7
1683353686426,MATH 20E,A03,188673,Staff,0,0,30,30
1683353687450,MATH 102,A01,188675,Staff,0,35,35,35
1683353688479,MATH 103B,A01,188681,Staff,3,0,35,32
1683353688479,MATH 103B,B01,188692,Staff,5,0,35,30
1683353689504,MATH 109,A01,188695,Salehi Golsefidy; Alireza,25,0,35,10
1683353689504,MATH 109,A02,188696,Salehi Golsefidy; Alireza,25,0,35,10
1683353690531,MATH 120A,A01,188698,Eggers; John Dietrich,7,0,35,28
1683353691555,MATH 142B,A01,188736,Ioana; Adrian,0,2,30,30
1683353691555,MATH 142B,A02,188741,Ioana; Adrian,0,0,30,30
1683353691555,MATH 142B,A03,188743,Ioana; Adrian,0,1,30,30
1683353692583,MATH 168A,A01,188790,Staff,0,9,35,35
1683353693607,MATH 170A,A01,188803,Nie; Jiawang,0,2,35,35
1683353693607,MATH 170A,A02,188811,Nie; Jiawang,0,0,35,35
1683353693607,MATH 170A,A03,188814,Nie; Jiawang,1,0,35,34
1683353693607,MATH 170A,A04,188815,Nie; Jiawang,13,0,35,22
1683353694687,MATH 193B,A01,188817,Staff,0,0,35,35
1683353694687,MATH 193B,A02,188818,Staff,5,0,35,30
1683353695711,MGT 4,A01,202857,Anderson; John Charles,61,0,80,19
1683353696737,MGT 12,A00,202858,Lindenberger; Wade Douglas,42,0,90,48
1683353697761,MGT 18,A00,202859,Staff,74,0,90,16
1683353698786,MGT 18GS,A00,202860,McKay; Michael J,13,0,28,15
1683353699815,MGT 45,A00,202861,Pecore; Joseph P.,14,0,90,76
1683353700839,MGT 100,A00,202863,Yavorsky; Daniel Ryan,28,0,90,62
1683353701867,MGT 103,A00,202864,Ehrich; Kristine R,0,17,90,90
1683353702895,MGT 112,A00,202865,Ehrich; Kristine R,15,0,90,75
1683353703922,MGT 121A,A00,202868,Staff,0,20,0,0
1683353704947,MGT 131B,A00,202869,Anderson; John Charles,59,0,90,31
1683353705972,MGT 136,A00,202871,Lindenberger; Wade Douglas,84,0,90,6
1683353706996,MGT 164,A00,202873,Staff,0,68,90,91
1683353708019,MGT 164GS,A00,202874,McKay; Mary A,13,0,28,15
1683353709043,MGT 180,A00,202875,Staff,0,50,90,91
1683353710070,MMW 11R,A01,205019,Herbst; Matthew,3,0,30,27
1683353710070,MMW 11R,A02,205026,Herbst; Matthew,29,0,30,1
1683353711095,MMW 15,A01,193512,Chang; Edmond Yi-Teh,0,9,28,28
1683353711095,MMW 15,A02,193513,Chang; Edmond Yi-Teh,0,5,28,28
1683353711095,MMW 15,A03,193514,Chang; Edmond Yi-Teh,0,5,28,28
1683353711095,MMW 15,A04,193515,Chang; Edmond Yi-Teh,0,5,28,28
1683353711095,MMW 15,A05,193516,Chang; Edmond Yi-Teh,0,4,28,28
1683353711095,MMW 15,A06,193517,Chang; Edmond Yi-Teh,0,5,28,28
1683353711095,MMW 15,B01,193519,Chang; Edmond Yi-Teh,0,5,28,28
1683353711095,MMW 15,B02,193520,Chang; Edmond Yi-Teh,0,5,28,28
1683353711095,MMW 15,B03,193521,Chang; Edmond Yi-Teh,0,5,28,28
1683353711095,MMW 15,B04,193522,Chang; Edmond Yi-Teh,0,4,28,28
1683353711095,MMW 15,B05,193523,Chang; Edmond Yi-Teh,0,5,28,28
1683353711095,MMW 15,B06,193524,Chang; Edmond Yi-Teh,0,4,28,28
1683353712118,MMW 122,A01,193526,Rahimi; Babak,0,15,28,28
1683353712118,MMW 122,A02,193527,Rahimi; Babak,0,14,28,28
1683353712118,MMW 122,A03,193528,Rahimi; Babak,0,0,0,0
1683353712118,MMW 122,A04,193529,Rahimi; Babak,0,0,0,0
1683353713141,MUS 1A,A01,186663,Staff,0,20,35,35
1683353714167,MUS 4,A01,186715,Staff,0,12,35,35
1683353715190,MUS 5R,A01,186796,Dubnov; Shlomo,0,17,35,35
1683353716213,MUS 6,A01,186798,Staff,0,4,25,25
1683353717237,MUS 7,A01,186830,Staff,13,0,35,22
1683353718265,MUS 8,A01,186930,Staff,0,26,35,35
1683353719289,MUS 15,A01,186932,Staff,0,16,35,35
1683353719289,MUS 15,B01,186934,Staff,0,15,35,35
1683353720313,MUS 80,A00,186935,Staff,1,0,20,19
1683353720313,MUS 80,B00,186936,Staff,25,0,25,0
1683353721341,NANO 11,A00,204702,Lipomi; Darren John,0,0,0,0
1683353722366,NANO 15,A01,204709,Yang; Kesong,0,1,0,0
1683353723391,NANO 114,A00,202069,Jahed Motlagh; Zeinab,3,0,10,7
1683353724414,PHIL 1,A00,186955,Grush; Rick Scott,32,0,40,8
1683353725437,PHIL 10,A01,186973,Grush; Rick Scott,28,0,35,7
1683353725437,PHIL 10,A02,186974,Grush; Rick Scott,33,0,35,2
1683353726462,PHIL 13,A01,186976,Staff,7,0,35,28
1683353726462,PHIL 13,A02,186977,Staff,16,0,35,19
1683353727484,PHIL 14,A01,186979,Staff,31,0,35,4
1683353727484,PHIL 14,A02,186986,Staff,32,0,35,3
1683353728508,PHIL 28,A01,186988,Staff,16,0,30,14
1683353728508,PHIL 28,A02,186989,Staff,1,0,30,29
1683353728508,PHIL 28,A03,186990,Staff,9,0,30,21
1683353728508,PHIL 28,A04,186991,Staff,26,0,30,4
1683353729533,PHIL 120,A00,186997,Staff,23,0,40,17
1683353730560,PHIL 137,A00,187003,Staff,9,0,40,31
1683353731587,PHIL 150,A00,187015,Staff,47,0,70,23
1683353732610,PHIL 167,A00,187021,Lamey; Andy M.,35,0,40,5
1683353733636,PHIL 174,A01,202226,Staff,17,0,20,3
1683353733636,PHIL 174,A02,202235,Staff,20,0,20,0
1683353734663,PHIL 191A,A00,258918,Staff,0,0,1,1
1683353735687,PHYS 1A,A00,187028,Staff,27,0,60,33
1683353736718,PHYS 1AL,001,187036,Staff,2,0,30,28
1683353736718,PHYS 1AL,002,187049,Staff,18,0,30,12
1683353737743,PHYS 1B,A00,187058,Staff,22,0,60,38
1683353738767,PHYS 1BL,001,187064,Staff,0,0,30,30
1683353738767,PHYS 1BL,002,187070,Staff,5,0,30,25
1683353739792,PHYS 1C,A00,187082,Staff,31,0,120,89
1683353740815,PHYS 1CL,001,187088,Staff,0,9,30,30
1683353740815,PHYS 1CL,002,187089,Staff,0,2,30,30
1683353740815,PHYS 1CL,009,262693,Staff,11,0,30,19
1683353741842,PHYS 2B,A01,187097,Staff,54,0,115,61
1683353742870,PHYS 2C,A01,187099,Staff,67,0,115,48
1683353743897,PHYS 2CL,A01,187101,Staff,5,0,28,23
1683353743897,PHYS 2CL,A02,187102,Staff,15,0,28,13
1683353744921,PHYS 2D,A01,187123,Shotwell; Brian,95,0,115,20
1683353745945,PHYS 4B,A01,187133,Grinstein; Benjamin,35,0,50,15
1683353746973,POLI 10,A00,188819,Staff,0,4,50,50
1683353748000,POLI 11,A00,188827,Staff,43,0,50,7
1683353749026,POLI 13R,A00,188828,Staff,0,1,20,20
1683353750055,POLI 27,A01,188830,Elgin; Samuel Zincke,0,1,70,70
1683353751083,POLI 30,A00,188832,Desposato; Scott,31,0,50,19
1683353752111,POLI 102F,A00,188834,Staff,3,0,40,37
1683353753138,POLI 104A,A00,188852,Staff,14,0,30,16
1683353754166,POLI 104I,A00,188853,Staff,0,6,20,20
1683353755194,POLI 110B,A00,188854,Wiens; David,7,0,20,13
1683353756221,POLI 112A,A00,188855,Wiens; David,5,0,30,25
1683353757244,POLI 117R,A00,188856,Forman; Fonna,0,11,20,20
1683353758270,POLI 118,A00,188857,Ingham; Sean,8,0,20,12
1683353759300,POLI 120G,A00,188858,Staff,9,0,30,21
1683353760327,POLI 131CR,A00,188863,Hoston; Germaine,23,0,50,27
1683353761351,POLI 133,A00,188864,Nellis; Gareth Hb,44,0,50,6
1683353762376,POLI 134D,A00,188865,Desposato; Scott,27,0,30,3
1683353763399,POLI 142A,A00,188871,Gartzke; Erik,22,0,50,28
1683353764424,POLI 142K,A00,188874,Staff,38,0,50,12
1683353765447,POLI 143,A00,188940,Gartzke; Erik,16,0,30,14
1683353766476,POLI 153,A00,188943,Staff,3,0,20,17
1683353767499,POLI 160AA,A00,188944,Staff,11,0,40,29
1683353768526,POLI 170A,A00,188945,Staff,11,0,30,19
1683353770578,PSYC 1,A00,188952,Staff,37,0,90,53
1683353771602,PSYC 2,B00,188953,Staff,19,0,35,16
1683353772626,PSYC 6,A00,188970,Staff,47,0,60,13
1683353773650,PSYC 7,A00,188973,Staff,37,0,45,8
1683353774673,PSYC 60,A01,188980,Rickard; Timothy C.,43,0,60,17
1683353775697,PSYC 70,A01,189001,Steiner; Eric Tomas,23,0,45,22
1683353776721,PSYC 100,A00,189005,Lacefield; Katharine I,0,98,120,120
1683353777743,PSYC 102,A00,189008,Staff,9,0,30,21
1683353778765,PSYC 106,B00,189026,Gorman; Michael R.,34,0,60,26
1683353779789,PSYC 114,B01,189033,Winkielman; Piotr,0,32,30,30
1683353780818,PSYC 131,A00,189036,Anagnostaras; Stephan,0,43,60,60
1683353781844,PSYC 136,A00,189041,Lowe; Angela Beth,0,7,25,25
1683353782869,PSYC 137,A00,189057,Winkielman; Piotr,0,34,25,25
1683353783892,PSYC 144,A00,189107,Wixted; John T,0,7,50,50
1683353785940,PSYC 162,A00,189142,Staff,0,8,85,85
1683353786964,PSYC 172,A00,189144,Gorman; Michael R.,0,7,30,30
1683353789016,PSYC 179,A00,189146,Lacefield; Katharine I,0,84,120,120
1683353790041,PSYC 181,A00,189147,Anagnostaras; Stephan,0,44,90,90
1683353791069,PSYC 190R,A00,189148,Barner; David A.,0,22,80,80
1683353792094,PSYC 191,A00,189275,Rickard; Timothy C.,0,7,25,25
1683353793119,PSYC 193,A00,189276,Chapman; Eddie Nathaniel,0,1,0,4
1683353794145,PSYC 193L,A01,189281,Lowe; Angela Beth,12,0,20,8
1683353794145,PSYC 193L,B01,189285,Staff,28,0,35,7
1683353795169,RELI 149,A00,187137,Rahimi; Babak,7,0,40,33
1683353796193,SE 9,A01,187315,Staff,0,2,18,18
1683353797217,SE 101B,A00,187409,Staff,24,0,30,6
1683353798300,SE 110B,A00,187444,Staff,10,0,40,30
1683353799324,SE 130B,A00,187449,Staff,31,0,40,9
1683353800350,SE 150A,A00,187516,Staff,9,0,20,11
1683353801377,SE 154,A00,187528,Staff,30,0,50,20
1683353802405,SIO 3,A01,258171,Staff,35,0,40,5
1683353803430,SIO 10,A00,187144,Cook; Geoffrey W,0,3,75,75
1683353804452,SIO 45,A00,187152,Cook; Geoffrey W,1,0,100,99
1683353805475,SIO 109R,A00,194486,Staff,0,3,20,20
1683353807527,SIO 187,A01,187233,Kacev; David,12,0,40,28
1683353808552,SOCI 1,A01,258656,Thorpe; Charles Robert,28,0,30,2
1683353808552,SOCI 1,A02,258658,Thorpe; Charles Robert,30,0,30,0
1683353808552,SOCI 1,A03,258661,Thorpe; Charles Robert,25,0,25,0
1683353808552,SOCI 1,A04,258666,Thorpe; Charles Robert,22,0,25,3
1683353808552,SOCI 1,A05,258897,Thorpe; Charles Robert,23,0,25,2
1683353808552,SOCI 1,A06,258898,Thorpe; Charles Robert,25,0,25,0
1683353809577,SOCI 30,A01,258903,Pardo Guerra; Juan Pablo,15,0,30,15
1683353810601,SOCI 102,A00,258904,Staff,9,0,25,16
1683353811628,SOCI 106,A00,258905,Staff,19,0,25,6
1683353812656,SOCI 111,A00,258907,Ribas Norris; Janet Vanesa,26,0,30,4
1683353813678,SOCI 121R,A00,258908,Pardo Guerra; Juan Pablo,10,0,30,20
1683353814702,SOCI 126,A01,203330,Staff,14,0,20,6
1683353815728,SOCI 131,A00,258909,Thorpe; Charles Robert,31,0,60,29
1683353816751,SOCI 135,A00,258910,Payne; Christine Anna,0,9,30,30
1683353817774,SOCI 157,A00,258911,Staff,12,0,30,18
1683353818798,SOCI 184,A00,258912,Staff,25,0,30,5
1683353819826,SOCI 188D,A00,258913,Staff,22,0,30,8
1683353820854,SYN 2,001,187529,Staff,10,0,16,6
1683353820854,SYN 2,002,201452,Staff,0,18,16,16
1683353820854,SYN 2,003,201469,Staff,3,0,16,13
1683353821885,SYN 100,A01,187531,Staff,0,9,20,20
1683353821885,SYN 100,B01,201491,Staff,0,12,20,20
1683353822909,TDAC 1,A00,189286,Walsh; Kim C.,3,0,20,17
1683353822909,TDAC 1,B00,189287,Harting; Carla Kelso,11,0,20,9
1683353823935,TDAC 101,A00,189300,Walsh; Kim C.,16,0,20,4
1683353823935,TDAC 101,B00,189301,Harting; Carla Kelso,18,0,20,2
1683353824960,TDAC 102,A00,189304,Basso; Beatrice,14,0,20,6
1683353825985,TDAC 108,A00,189305,Staff,18,0,20,2
1683353827017,TDDE 131,A00,189310,Staff,19,0,20,1
1683353827017,TDDE 131,B00,189314,Staff,19,0,20,1
1683353827017,TDDE 131,C00,189315,Staff,48,0,50,2
1683353827017,TDDE 131,D00,189316,Staff,14,0,15,1
1683353827017,TDDE 131,E00,204841,Staff,20,0,20,0
1683353828044,TDGE 10,A00,189289,Staff,30,0,50,20
1683353828044,TDGE 10,B00,189290,Havis; Allan,1,0,50,49
1683353829068,TDGE 11,A00,189291,Fulton; Julia,0,3,50,50
1683353829068,TDGE 11,B00,189292,Staff,20,0,25,5
1683353829068,TDGE 11,C00,260270,Staff,0,0,0,0
1683353830090,TDGE 25,A00,189294,Staff,3,0,20,17
1683353831114,TDGE 124,A00,189318,Fulton; Julia,0,8,50,50
1683353832141,TDGE 125,A00,189319,Staff,13,0,25,12
1683353832141,TDGE 125,B00,189320,Staff,23,0,25,2
1683353833164,TDGE 127,A00,189322,Havis; Allan,0,0,50,50
1683353834191,TDHT 101,A00,189323,Staff,18,0,25,7
1683353834191,TDHT 101,B00,189324,Staff,25,0,25,0
1683353835218,TDHT 102,A00,189325,Staff,49,0,50,1
1683353836242,TDMV 1,A00,189295,Arcidiacono; Kristin,19,0,30,11
1683353836242,TDMV 1,B00,189296,Caligagan; Maria T.,24,0,30,6
1683353837271,TDMV 2,A00,189297,Sammartano; Tonnie,28,0,30,2
1683353837271,TDMV 2,B00,189299,Arcidiacono; Kristin,24,0,30,6
1683353838297,TDMV 3,A00,204998,Rincon; Alicia,22,0,30,8
1683353839324,TDMV 120,A00,189458,Sammartano; Tonnie,28,0,30,2
1683353840350,TDMV 138,A00,189541,Jun; Grace Shin Hae,22,0,40,18
1683353841374,TDMV 142,A00,189717,Caligagan; Tony,23,0,30,7
1683353841374,TDMV 142,B00,189718,Caligagan; Maria T.,25,0,30,5
1683353842399,TMC 2,A01,187533,Staff,25,0,25,0
1683353842399,TMC 2,A02,187534,Staff,25,0,25,0
1683353843425,USP 1,A01,187536,Kwak; Nancy,0,16,25,25
1683353844452,USP 5,A01,187538,Staff,10,0,25,15
1683353845475,USP 101,A00,199253,Staff,0,4,0,0
1683353846500,USP 124,A00,187562,Boomhower; Matthew Charles,1,0,30,29
1683353847525,USP 138,A00,187582,Staff,20,0,25,5
1683353848550,USP 152,A01,187597,Staff,4,0,25,21
1683353849574,USP 153,A00,187598,Staff,19,0,25,6
1683353850597,USP 168,A00,187607,Kwak; Nancy,2,0,5,3
1683353851622,USP 173,A00,187619,Staff,4,0,25,21
1683353852648,USP 181,A00,187638,Staff,0,3,25,25
1683353853672,VIS 103,A00,187650,Cruz; Edwin Teddy,22,0,75,53
1683353854696,VIS 110D,A00,187669,Staff,12,0,22,10
1683353855721,VIS 127C,A00,187720,Shen; Kuiyi,67,0,146,79
1683353856747,VIS 149,A00,187731,Yoldas; Pinar,0,14,22,22
1683353857773,VIS 151,A01,188091,Staff,22,0,34,12
1683353857773,VIS 151,A02,188092,Staff,11,0,34,23
1683353858797,VIS 160B,A00,188093,Stalbaum; Brett,0,0,10,10
1683353860844,WCWP 10B,A00,201720,Staff,10,0,15,5
1683353860844,WCWP 10B,B00,201722,Staff,9,0,15,6
1683353861869,WCWP 100,A00,201725,Gagnon; Jeffrey C,0,0,2,2
1683353861869,WCWP 100,B00,201727,Staff,0,4,15,15
1683353865003,ANBI 133,A00,258401,Wilder; Linnea Lorene,34,0,40,6
1683353866025,ANBI 140,A00,258395,Hrvoj Mihic; Branka,18,0,25,7
1683353867050,ANSC 120,A00,258402,Bialecki; Jon Anthony,27,0,40,13
1683353868075,ANSC 144,A00,258400,Staff,14,0,40,26
1683353870131,ANSC 166,A00,258396,Parish; Steven Martin,157,0,175,18
1683353871160,ANSC 180,A00,193533,Staff,9,0,20,11
1683353872186,ANSC 188,A00,258397,Jassal; Aftab,33,0,40,7
1683353873211,ANTH 3,A01,258316,Staff,23,0,30,7
1683353874238,ANTH 5,A00,258394,Semendeferi; Ekaterini,16,0,20,4
1683353875266,ANTH 21,A01,258331,Staff,8,0,40,32
1683353876295,ANTH 103,A00,258398,Varma; Saiba,15,0,25,10
1683353877321,AWP 10,001,202034,Staff,0,0,0,0
1683353877321,AWP 10,002,202035,Staff,0,0,0,0
1683353877321,AWP 10,003,202036,Staff,0,0,0,0
1683353877321,AWP 10,004,202037,Staff,0,0,0,0
1683353877321,AWP 10,005,202038,Staff,0,0,0,0
1683353877321,AWP 10,006,202039,Staff,0,0,0,0
1683353877321,AWP 10,007,202040,Staff,0,0,0,0
1683353877321,AWP 10,008,202041,Staff,0,0,0,0
1683353877321,AWP 10,009,202042,Staff,0,0,0,0
1683353877321,AWP 10,010,202043,Staff,0,0,0,0
1683353877321,AWP 10,011,202044,Staff,0,0,0,0
1683353877321,AWP 10,012,202045,Staff,0,0,0,0
1683353877321,AWP 10,013,202046,Staff,0,0,0,0
1683353877321,AWP 10,014,202047,Staff,0,0,0,0
1683353877321,AWP 10,015,202048,Staff,0,0,0,0
1683353877321,AWP 10,016,202049,Staff,0,0,0,0
1683353877321,AWP 10,017,202050,Staff,0,0,0,0
1683353877321,AWP 10,018,202051,Staff,0,0,0,0
1683353877321,AWP 10,019,202052,Staff,0,0,0,0
1683353877321,AWP 10,020,202053,Staff,0,0,0,0
1683353877321,AWP 10,021,202054,Staff,0,0,0,0
1683353877321,AWP 10,022,202055,Staff,0,0,0,0
1683353877321,AWP 10,023,202056,Staff,0,0,0,0
1683353877321,AWP 10,024,202057,Staff,0,0,0,0
1683353877321,AWP 10,025,202058,Staff,0,0,0,0
1683353877321,AWP 10,026,202059,Staff,0,0,0,0
1683353878345,AWP 102,001,202032,Staff,0,0,0,0
1683353878345,AWP 102,002,202033,Staff,0,0,0,0
1683353879373,BENG 100,A01,254234,Taylor Amos; Alyssa C,31,0,40,9
1683353880397,BENG 196,001,270013,Engler; Adam J.,9999,0,9999,0
1683353881422,BICD 100R,A01,202018,Smith; Laurie,0,7,32,32
1683353881422,BICD 100R,A02,202019,Smith; Laurie,0,2,32,32
1683353881422,BICD 100R,A03,202020,Smith; Laurie,0,1,32,32
1683353881422,BICD 100R,A04,202021,Smith; Laurie,9,0,32,23
1683353881422,BICD 100R,A05,202022,Smith; Laurie,12,0,32,20
1683353882451,BICD 136,A01,193242,Gustafson-Brown; Cindy,0,2,32,32
1683353882451,BICD 136,A02,193244,Gustafson-Brown; Cindy,14,0,32,18
1683353883477,BIEB 102,A01,193249,Butler; Shannon Rhey,0,2,32,32
1683353883477,BIEB 102,A02,193251,Butler; Shannon Rhey,0,0,32,32
1683353883477,BIEB 102,A03,193253,Butler; Shannon Rhey,0,1,32,32
1683353883477,BIEB 102,A04,193255,Butler; Shannon Rhey,17,0,32,15
1683353883477,BIEB 102,A05,193265,Butler; Shannon Rhey,26,0,32,6
1683353883477,BIEB 102,A06,193269,Butler; Shannon Rhey,16,0,32,16
1683353885526,BIEB 150,A01,193274,Staff,0,0,32,32
1683353885526,BIEB 150,A02,193285,Staff,23,0,32,9
1683353886554,BIEB 194,A00,193286,Kurle; Carolyn M.,22,0,32,10
1683353887578,BILD 1,A01,192291,Staff,16,0,32,16
1683353887578,BILD 1,A02,192292,Staff,30,0,32,2
1683353887578,BILD 1,B01,192520,Reuther; Keefe,0,1,0,0
1683353887578,BILD 1,B02,192532,Reuther; Keefe,0,1,0,0
1683353888608,BILD 3,A01,192556,Butler; Shannon Rhey,0,0,32,32
1683353888608,BILD 3,A02,192581,Butler; Shannon Rhey,4,0,32,28
1683353888608,BILD 3,A03,192611,Butler; Shannon Rhey,23,0,32,9
1683353888608,BILD 3,A04,192612,Butler; Shannon Rhey,25,0,32,7
1683353888608,BILD 3,A05,192613,Butler; Shannon Rhey,27,0,32,5
1683353888608,BILD 3,A06,192679,Butler; Shannon Rhey,27,0,32,5
1683353888608,BILD 3,A07,192682,Butler; Shannon Rhey,22,0,32,10
1683353889632,BILD 4,A01,192836,Reuther; Keefe,0,0,24,24
1683353889632,BILD 4,A02,193044,Reuther; Keefe,4,0,24,20
1683353890657,BILD 10,A01,193142,Gustafson-Brown; Cindy,30,0,32,2
1683353890657,BILD 10,A02,193149,Gustafson-Brown; Cindy,31,0,32,1
1683353891684,BIMM 100,A01,193301,Staff,0,6,32,32
1683353891684,BIMM 100,A02,193312,Staff,0,5,32,32
1683353891684,BIMM 100,A03,193323,Staff,0,8,32,32
1683353892710,BIMM 101,A01,193329,McDonnell; Lisa Marie,0,3,24,24
1683353892710,BIMM 101,A02,193339,McDonnell; Lisa Marie,0,3,24,24
1683353892710,BIMM 101,B01,193354,McDonnell; Lisa Marie,0,3,24,24
1683353892710,BIMM 101,B02,193357,McDonnell; Lisa Marie,0,3,24,24
1683353893733,BIMM 110,A01,193377,Tat; John,0,11,32,32
1683353893733,BIMM 110,A02,193378,Tat; John,0,9,32,32
1683353894757,BIMM 120,A01,206116,Staff,0,0,32,32
1683353894757,BIMM 120,A02,206117,Staff,8,0,32,24
1683353894757,BIMM 120,A03,206121,Staff,21,0,32,11
1683353895781,BIPN 100,A01,193393,Park; Ji Young,0,14,32,32
1683353895781,BIPN 100,A02,193402,Park; Ji Young,0,13,32,32
1683353895781,BIPN 100,A03,193413,Park; Ji Young,0,14,32,32
1683353895781,BIPN 100,A04,193414,Park; Ji Young,0,13,32,32
1683353896811,BIPN 102,A01,193429,Staff,0,0,32,32
1683353896811,BIPN 102,A02,193438,Staff,22,0,32,10
1683353897834,BIPN 106,A01,193450,Reyes Gonzalez; Catalina,0,2,40,40
1683353898858,BIPN 134,A01,193465,Cooke; James Edward,1,0,32,31
1683353898858,BIPN 134,A02,193474,Cooke; James Edward,25,0,32,7
1683353898858,BIPN 134,A03,193485,Cooke; James Edward,29,0,32,3
1683353898858,BIPN 134,A04,193486,Cooke; James Edward,21,0,32,11
1683353898858,BIPN 134,A05,193491,Cooke; James Edward,31,0,32,1
1683353898858,BIPN 134,A06,193501,Cooke; James Edward,30,0,32,2
1683353898858,BIPN 134,A07,193510,Cooke; James Edward,29,0,32,3
1683353900912,BISP 194,A00,222522,Staff,14,0,32,18
1683353901995,CAT 124,A01,202407,Staff,20,0,25,5
1683353903023,CAT 125,A00,202408,Marchisotto; Jennifer Anne,4,0,20,16
1683353904049,CAT 125R,A00,202409,Smith; Lauryn Alissa,0,11,20,20
1683353904049,CAT 125R,B00,202410,Morales; Celeste Georgianna,0,11,20,20
1683353904049,CAT 125R,C00,202411,Irwin; Matthew Joseph,0,10,20,20
1683353905081,CENG 15,A01,204712,Yang; Kesong,0,1,0,0
1683353906111,CENG 114,A00,202070,Jahed Motlagh; Zeinab,5,0,20,15
1683353907134,CGS 105,A00,185477,Wesling; Megan E.,24,0,40,16
1683353908158,CGS 106,A00,185494,Staff,13,0,22,9
1683353909181,CGS 108,A00,185495,Staff,14,0,20,6
1683353910204,CGS 114,A00,185496,Staff,13,0,18,5
1683353911227,CGS 119,A00,185501,Staff,15,0,20,5
1683353912251,CGS 120,A00,185511,Staff,13,0,20,7
1683353913275,CHEM 4,A01,184675,Bussey; Thomas J,96,0,100,4
1683353914298,CHEM 6A,A01,184677,Staff,34,0,60,26
1683353915320,CHEM 6B,A01,184679,Staff,65,0,100,35
1683353916344,CHEM 6C,A01,184681,Bussey; Thomas J,1,0,50,49
1683353916344,CHEM 6C,A02,184682,Bussey; Thomas J,34,0,50,16
1683353917372,CHEM 40A,A01,184684,Albizati; Kim F.,37,0,100,63
1683353918399,CHEM 40B,A01,184686,Albizati; Kim F.,0,20,100,100
1683353919427,CHEM 41B,A01,184690,Staff,52,0,100,48
1683353920453,COGS 3,A01,184715,Boyle; Mary E. T.,0,25,40,40
1683353921476,COGS 14B,A01,185172,Staff,0,15,38,38
1683353922504,COGS 18,A01,184736,Staff,17,0,80,63
1683353923529,COGS 100,A01,184932,Staff,0,5,73,73
1683353924554,COGS 101A,A01,184935,Staff,0,39,30,30
1683353925578,COGS 101B,A01,184944,Staff,0,2,30,30
1683353926605,COGS 101C,A01,184946,Staff,0,12,30,30
1683353927632,COGS 102A,A01,184951,Johnson; Christine M.,2,0,40,38
1683353928656,COGS 107B,A01,184953,Mooshagian; Eric Frederick,0,50,40,40
1683353929679,COGS 118B,A01,184959,Gupta; Anjum,0,48,40,40
1683353930705,COGS 153,A00,184961,Staff,0,15,30,30
1683353931728,COGS 177,A00,184962,Staff,0,20,30,30
1683353932752,COGS 187A,A01,184969,Boyle; Mary E. T.,0,17,40,40
1683353933783,COMM 10,A01,185174,Staff,0,5,25,25
1683353933783,COMM 10,A02,185189,Staff,0,5,25,25
1683353933783,COMM 10,A03,269821,Staff,0,0,0,0
1683353934806,COMM 100B,A01,185475,Staff,0,0,0,2
1683353934806,COMM 100B,A02,185476,Staff,13,0,25,12
1683353935829,COMM 100C,A01,185314,Staff,1,0,25,24
1683353935829,COMM 100C,A02,185327,Staff,19,0,25,6
1683353936855,COMM 110M,A00,185349,Staff,2,0,40,38
1683353937879,COMM 113T,A00,185352,Staff,24,0,40,16
1683353938903,COMM 114I,A00,185353,Staff,33,0,40,7
1683353939929,COMM 131,A00,185354,Staff,19,0,30,11
1683353940957,CSE 8A,A50,185358,Cao; Yingjun,0,46,10,10
1683353941981,CSE 8B,A01,185362,Staff,0,46,50,50
1683353943005,CSE 11,A01,185416,Cao; Yingjun,0,92,10,10
1683353944028,CSE 20,A01,185445,Briones; Jor-el Thomas Caparas,5,0,25,20
1683353945053,CSE 21,A01,185447,Staff,10,0,50,40
1683353946079,CSE 101,A01,185451,Staff,0,13,50,50
1683353946079,CSE 101,B01,185453,Jones; Miles E,0,11,50,50
1683353948129,CSE 141,A01,185458,Eldon; John,20,0,100,80
1683353949154,CSE 141L,A01,185461,Eldon; John,12,0,100,88
1683353950181,CSE 142,A01,185463,Staff,36,0,60,24
1683353950181,CSE 142,B01,201355,Staff,0,7,60,60
1683353951210,CSE 142L,A01,185470,Staff,36,0,60,24
1683353951210,CSE 142L,B01,201417,Staff,0,6,60,60
1683353952237,CSE 190,A00,201433,Staff,32,0,49,17
1683353953260,DOC 1,A01,259136,Strom; Megan C.,7,0,15,8
1683353953260,DOC 1,A02,259137,Strom; Megan C.,14,0,15,1
1683353953260,DOC 1,A03,259138,Strom; Megan C.,14,0,15,1
1683353953260,DOC 1,A04,259139,Strom; Megan C.,14,0,15,1
1683353954284,DOC 100D,A00,259140,Pass; Natalye Joann,16,0,25,9
1683353955308,DSGN 1,A01,184749,Rill; Bryan,0,25,30,30
1683353956331,DSGN 100,A01,185168,Staff,0,2,25,25
1683353957355,ECE 5,A01,185626,Morris; Karcher William,0,10,0,0
1683353958380,ECE 101,A01,185628,Staff,17,0,70,53
1683353959403,ECE 107,A01,185635,Baghdadchi; Saharnaz,0,0,20,20
1683353959403,ECE 107,A02,185638,Baghdadchi; Saharnaz,4,0,20,16
1683353960431,ECE 148,A01,185647,Silberman; Jack,0,0,16,16
1683353961454,ECON 1,A01,185537,Crane; Meredith Helen,54,0,70,16
1683353962478,ECON 3,A01,185549,Crane; Meredith Helen,32,0,70,38
1683353963502,ECON 4,A01,203354,Anderson; John Charles,0,4,10,10
1683353964525,ECON 100A,A01,185574,Staff,0,4,40,40
1683353965548,ECON 100B,A01,185576,Staff,0,12,50,50
1683353966578,ECON 100C,A01,185589,Newhouse; Herbert S,29,0,70,41
1683353967603,ECON 105,A00,185608,Vespa; Emanuel Ignacio,19,0,35,16
1683353968631,ECON 109,A01,185610,Shishkin; Denis,10,0,35,25
1683353969655,ECON 110A,A01,185612,Staff,11,0,40,29
1683353970683,ECON 120A,A01,185615,Staff,20,0,40,20
1683353971708,ECON 120C,A01,185617,Sun; Yixiao,0,21,70,70
1683353972732,ECON 144,A00,203346,Squires; Dale E,3,0,35,32
1683353973759,ECON 171,A01,203349,Newhouse; Herbert S,0,1,35,35
1683353974792,ECON 173A,A01,185621,Toda; Alexis Akira,21,0,35,14
1683353975826,EDS 25,A01,202413,Staff,0,1,0,0
1683353975826,EDS 25,A02,202414,Staff,0,1,0,0
1683353975826,EDS 25,A03,202415,Staff,0,0,0,0
1683353975826,EDS 25,A04,202416,Staff,0,1,0,0
1683353975826,EDS 25,A05,202439,Staff,0,0,0,0
1683353975826,EDS 25,A06,202440,Staff,0,0,0,0
1683353975826,EDS 25,B01,202631,Staff,0,0,0,0
1683353975826,EDS 25,B02,202632,Staff,0,0,0,0
1683353975826,EDS 25,B03,202639,Staff,0,0,0,0
1683353975826,EDS 25,B04,202640,Staff,0,0,0,0
1683353975826,EDS 25,B05,202643,Staff,0,0,0,0
1683353975826,EDS 25,B06,202644,Staff,0,0,0,0
1683353976851,EDS 38,A01,202659,Black; Alison Michelle,24,0,25,1
1683353977881,EDS 115,A00,202652,Staff,18,0,30,12
1683353978905,EDS 125,A00,202649,Staff,14,0,30,16
1683353979930,EDS 126,A01,203332,Staff,30,0,30,0
1683353980954,EDS 139,A00,202838,Staff,16,0,25,9
1683353981978,EDS 146,A01,202655,Staff,14,0,25,11
1683353983003,ENG 15,A00,185667,Staff,0,1,0,0
1683353983003,ENG 15,B00,185672,Staff,0,0,0,0
1683353983003,ENG 15,C00,185675,Staff,0,0,0,0
1683353983003,ENG 15,D00,185682,Staff,0,0,0,0
1683353983003,ENG 15,E00,185684,Staff,0,0,0,0
1683353984034,ETHN 103,A00,185710,Staff,0,4,35,35
1683353985061,ETHN 103A,A00,199228,Man; Simeon S,2,0,9,7
1683353986088,ETHN 109,A00,185711,Staff,18,0,35,17
1683353987112,ETHN 142,A00,185726,Staff,0,4,30,30
1683353988139,ETHN 163J,A00,199229,Man; Simeon S,5,0,8,3
1683353989165,ETHN 168,A00,185727,Staff,8,0,10,2
1683353990189,ETHN 182,A00,185728,Staff,0,0,35,35
1683353991214,ETHN 183,A00,185737,Staff,8,0,18,10
1683353992238,GLBH 111,A01,209361,Burgos; Jose L.,0,0,0,0
1683353994289,HIEU 104,A00,185792,Staff,16,0,20,4
1683353995314,HIEU 115,A00,185800,Staff,1,0,20,19
1683353996337,HIEU 128,A00,185801,Staff,0,7,20,20
1683353997362,HIEU 147,A00,185802,Staff,16,0,20,4
1683353998384,HIEU 154,A00,185823,Staff,12,0,20,8
1683353999410,HILA 102,A00,185826,Staff,13,0,20,7
1683354000437,HILD 2C,A01,185778,Staff,0,12,20,20
1683354001462,HILD 7B,A01,185780,Kwak; Nancy,0,15,32,32
1683354001462,HILD 7B,A02,185781,Kwak; Nancy,0,18,32,32
1683354002487,HILD 30,A01,185791,Staff,14,0,20,6
1683354003511,HISC 119,A00,185830,Golan; Tal,0,9,20,20
1683354004538,HITO 156GS,A00,185831,Patterson; Patrick H.,0,0,0,23
1683354005644,HIUS 103,A00,185832,Man; Simeon S,0,6,20,20
1683354006668,HIUS 117,A00,185836,Kwak; Nancy,2,0,20,18
1683354007693,HIUS 125,A00,185840,Man; Simeon S,0,0,23,23
1683354008717,HIUS 149,A00,185845,Staff,0,0,20,20
1683354009742,HUM 3,A01,185882,Zavodny; Tatiana Sophia,0,7,50,50
1683354009742,HUM 3,B01,185899,Caldwell; Michael Alan,0,18,50,50
1683354010766,HUM 3GS,A00,185900,Patterson; Patrick H.,0,0,0,23
1683354011795,HUM 4,A01,185938,Zroka; Amy Liane,31,0,50,19
1683354011795,HUM 4,B01,185956,Watkins; Eric,0,3,50,50
1683354011795,HUM 4,B02,202209,Watkins; Eric,0,2,50,50
1683354011795,HUM 4,B03,202210,Watkins; Eric,0,2,50,50
1683354012819,HUM 5,A01,185958,West; Geoffrey Scott,3,0,50,47
1683354012819,HUM 5,A02,202215,West; Geoffrey Scott,0,0,50,50
1683354013842,INTL 190,A00,185959,Gagnon; Jeffrey C,0,0,0,9
1683354013842,INTL 190,B00,185960,Lettieri; Michael Joseph,0,0,0,1
1683354014868,JAPN 180,A00,254509,Staff,4,0,30,26
1683354015893,LATI 10,A01,202853,Kennemore; Amy Michelle,4,0,35,31
1683354015893,LATI 10,A02,202854,Kennemore; Amy Michelle,2,0,35,33
1683354015893,LATI 10,A03,270054,Kennemore; Amy Michelle,30,0,30,0
1683354016916,LATI 180,A00,202855,Kennemore; Amy Michelle,11,0,20,9
1683354017940,LAWS 101,A00,201767,Golan; Tal,0,7,40,40
1683354018964,LIFR 1C,A00,185961,Staff,6,0,20,14
1683354019991,LIFR 1CX,A00,185962,Staff,7,0,20,13
1683354021017,LIFR 1D,A00,185963,Staff,9,0,20,11
1683354022042,LIFR 1DX,A00,185964,Staff,9,0,20,11
1683354023067,LIGN 101,A01,186039,Staff,43,0,50,7
1683354024091,LIGN 165,A00,186040,Staff,18,0,50,32
1683354025117,LTCS 108,A00,186041,Staff,6,0,10,4
1683354026142,LTCS 119,A00,186042,Staff,16,0,20,4
1683354027169,LTCS 130,A00,186043,Wesling; Megan E.,15,0,25,10
1683354029217,LTEA 138,A00,186119,Staff,14,0,40,26
1683354030244,LTEN 124,A00,186148,Staff,6,0,25,19
1683354031271,LTEN 178,A00,186149,Staff,7,0,15,8
1683354032298,LTEN 181,A00,186150,Blanco; John D,33,0,40,7
1683354033324,LTWL 120,A00,186160,Staff,20,0,25,5
1683354034347,LTWL 165,A00,186161,Staff,22,0,25,3
1683354035373,LTWR 100,A00,186162,Staff,0,5,15,15
1683354036397,LTWR 102,A00,186163,Doller; Ben,5,0,15,10
1683354037419,MAE 8,A01,186412,Staff,0,0,0,0
1683354038442,MAE 30B,A00,186445,Bahadori; Mohammad Yousef,83,0,100,17
1683354039467,MAE 40,A00,186592,Bewley; Thomas R,10,0,50,40
1683354040493,MAE 101B,A00,186593,Bahadori; Mohammad Yousef,81,0,100,19
1683354041517,MAE 105,A00,186594,Bandaru; Prabhakar,12,0,50,38
1683354042544,MAE 107,A00,186599,Pham; Hieu Tan,0,7,120,120
1683354043573,MAE 148,A01,186660,Silberman; Jack,3,0,16,13
1683354044597,MATH 10A,A01,188095,Staff,0,5,35,35
1683354045622,MATH 10B,A01,188097,Bowers; Adam R.,0,11,30,30
1683354045622,MATH 10B,A02,188099,Bowers; Adam R.,0,11,30,30
1683354045622,MATH 10B,B01,188104,Bowers; Adam R.,0,10,30,30
1683354045622,MATH 10B,B02,188106,Bowers; Adam R.,0,10,30,30
1683354046648,MATH 10C,A01,188111,Staff,0,18,30,30
1683354046648,MATH 10C,A02,188127,Staff,0,17,30,30
1683354046648,MATH 10C,A03,188131,Staff,0,18,30,30
1683354046648,MATH 10C,B01,188218,Staff,18,0,30,12
1683354046648,MATH 10C,B02,188244,Staff,13,0,30,17
1683354046648,MATH 10C,B03,188277,Staff,16,0,30,14
1683354047676,MATH 18,A01,188344,Bach; Quang Tran,18,0,30,12
1683354047676,MATH 18,A02,188345,Bach; Quang Tran,11,0,30,19
1683354047676,MATH 18,B01,188353,Bach; Quang Tran,10,0,30,20
1683354047676,MATH 18,B02,188354,Bach; Quang Tran,20,0,30,10
1683354048702,MATH 20A,A01,188374,Staff,12,0,35,23
1683354049730,MATH 20B,A01,188382,Ohm; Ko Woon,6,0,30,24
1683354049730,MATH 20B,A02,188383,Ohm; Ko Woon,22,0,30,8
1683354049730,MATH 20B,B01,188385,Ohm; Ko Woon,7,0,30,23
1683354049730,MATH 20B,B02,188392,Ohm; Ko Woon,22,0,30,8
1683354050758,MATH 20C,A01,188394,Harel; Guershon,10,0,30,20
1683354050758,MATH 20C,A02,188395,Harel; Guershon,15,0,30,15
1683354050758,MATH 20C,B01,188404,Harel; Guershon,4,0,30,26
1683354050758,MATH 20C,B02,188405,Harel; Guershon,19,0,30,11
1683354051784,MATH 20D,A01,188414,Hammock; Frances H,0,1,30,30
1683354051784,MATH 20D,A02,188415,Hammock; Frances H,3,0,30,27
1683354051784,MATH 20D,B01,188447,Hammock; Frances H,1,0,30,29
1683354051784,MATH 20D,B02,188486,Hammock; Frances H,8,0,30,22
1683354052808,MATH 20E,A01,188649,Staff,21,0,30,9
1683354052808,MATH 20E,A02,188650,Staff,23,0,30,7
1683354052808,MATH 20E,A03,188673,Staff,0,0,30,30
1683354053832,MATH 102,A01,188675,Staff,0,35,35,35
1683354054861,MATH 103B,A01,188681,Staff,3,0,35,32
1683354054861,MATH 103B,B01,188692,Staff,5,0,35,30
1683354055887,MATH 109,A01,188695,Salehi Golsefidy; Alireza,25,0,35,10
1683354055887,MATH 109,A02,188696,Salehi Golsefidy; Alireza,25,0,35,10
1683354056911,MATH 120A,A01,188698,Eggers; John Dietrich,7,0,35,28
1683354057936,MATH 142B,A01,188736,Ioana; Adrian,0,2,30,30
1683354057936,MATH 142B,A02,188741,Ioana; Adrian,0,0,30,30
1683354057936,MATH 142B,A03,188743,Ioana; Adrian,0,1,30,30
1683354058958,MATH 168A,A01,188790,Staff,0,9,35,35
1683354059987,MATH 170A,A01,188803,Nie; Jiawang,0,2,35,35
1683354059987,MATH 170A,A02,188811,Nie; Jiawang,0,0,35,35
1683354059987,MATH 170A,A03,188814,Nie; Jiawang,1,0,35,34
1683354059987,MATH 170A,A04,188815,Nie; Jiawang,13,0,35,22
1683354061015,MATH 193B,A01,188817,Staff,0,0,35,35
1683354061015,MATH 193B,A02,188818,Staff,5,0,35,30
1683354062045,MGT 4,A01,202857,Anderson; John Charles,61,0,80,19
1683354063070,MGT 12,A00,202858,Lindenberger; Wade Douglas,42,0,90,48
1683354064096,MGT 18,A00,202859,Staff,74,0,90,16
1683354065121,MGT 18GS,A00,202860,McKay; Michael J,13,0,28,15
1683354066148,MGT 45,A00,202861,Pecore; Joseph P.,14,0,90,76
1683354067177,MGT 100,A00,202863,Yavorsky; Daniel Ryan,28,0,90,62
1683354068201,MGT 103,A00,202864,Ehrich; Kristine R,0,17,90,90
1683354069229,MGT 112,A00,202865,Ehrich; Kristine R,15,0,90,75
1683354070252,MGT 121A,A00,202868,Staff,0,20,0,0
1683354071276,MGT 131B,A00,202869,Anderson; John Charles,59,0,90,31
1683354072303,MGT 136,A00,202871,Lindenberger; Wade Douglas,84,0,90,6
1683354073329,MGT 164,A00,202873,Staff,0,68,90,91
1683354074357,MGT 164GS,A00,202874,McKay; Mary A,13,0,28,15
1683354075382,MGT 180,A00,202875,Staff,0,50,90,91
1683354076408,MMW 11R,A01,205019,Herbst; Matthew,3,0,30,27
1683354076408,MMW 11R,A02,205026,Herbst; Matthew,29,0,30,1
1683354077440,MMW 15,A01,193512,Chang; Edmond Yi-Teh,0,9,28,28
1683354077440,MMW 15,A02,193513,Chang; Edmond Yi-Teh,0,5,28,28
1683354077440,MMW 15,A03,193514,Chang; Edmond Yi-Teh,0,5,28,28
1683354077440,MMW 15,A04,193515,Chang; Edmond Yi-Teh,0,5,28,28
1683354077440,MMW 15,A05,193516,Chang; Edmond Yi-Teh,0,4,28,28
1683354077440,MMW 15,A06,193517,Chang; Edmond Yi-Teh,0,5,28,28
1683354077440,MMW 15,B01,193519,Chang; Edmond Yi-Teh,0,5,28,28
1683354077440,MMW 15,B02,193520,Chang; Edmond Yi-Teh,0,5,28,28
1683354077440,MMW 15,B03,193521,Chang; Edmond Yi-Teh,0,5,28,28
1683354077440,MMW 15,B04,193522,Chang; Edmond Yi-Teh,0,4,28,28
1683354077440,MMW 15,B05,193523,Chang; Edmond Yi-Teh,0,5,28,28
1683354077440,MMW 15,B06,193524,Chang; Edmond Yi-Teh,0,4,28,28
1683354078464,MMW 122,A01,193526,Rahimi; Babak,0,15,28,28
1683354078464,MMW 122,A02,193527,Rahimi; Babak,0,14,28,28
1683354078464,MMW 122,A03,193528,Rahimi; Babak,0,0,0,0
1683354078464,MMW 122,A04,193529,Rahimi; Babak,0,0,0,0
1683354079491,MUS 1A,A01,186663,Staff,0,20,35,35
1683354080516,MUS 4,A01,186715,Staff,0,12,35,35
1683354081541,MUS 5R,A01,186796,Dubnov; Shlomo,0,17,35,35
1683354082568,MUS 6,A01,186798,Staff,0,4,25,25
1683354083595,MUS 7,A01,186830,Staff,13,0,35,22
1683354084620,MUS 8,A01,186930,Staff,0,26,35,35
1683354085644,MUS 15,A01,186932,Staff,0,16,35,35
1683354085644,MUS 15,B01,186934,Staff,0,15,35,35
1683354086671,MUS 80,A00,186935,Staff,1,0,20,19
1683354086671,MUS 80,B00,186936,Staff,25,0,25,0
1683354087697,NANO 11,A00,204702,Lipomi; Darren John,0,0,0,0
1683354088721,NANO 15,A01,204709,Yang; Kesong,0,1,0,0
1683354089748,NANO 114,A00,202069,Jahed Motlagh; Zeinab,3,0,10,7
1683354090771,PHIL 1,A00,186955,Grush; Rick Scott,32,0,40,8
1683354091798,PHIL 10,A01,186973,Grush; Rick Scott,28,0,35,7
1683354091798,PHIL 10,A02,186974,Grush; Rick Scott,33,0,35,2
1683354092821,PHIL 13,A01,186976,Staff,7,0,35,28
1683354092821,PHIL 13,A02,186977,Staff,16,0,35,19
1683354093849,PHIL 14,A01,186979,Staff,31,0,35,4
1683354093849,PHIL 14,A02,186986,Staff,32,0,35,3
1683354094876,PHIL 28,A01,186988,Staff,16,0,30,14
1683354094876,PHIL 28,A02,186989,Staff,1,0,30,29
1683354094876,PHIL 28,A03,186990,Staff,9,0,30,21
1683354094876,PHIL 28,A04,186991,Staff,26,0,30,4
1683354095902,PHIL 120,A00,186997,Staff,23,0,40,17
1683354096928,PHIL 137,A00,187003,Staff,9,0,40,31
1683354097956,PHIL 150,A00,187015,Staff,47,0,70,23
1683354098983,PHIL 167,A00,187021,Lamey; Andy M.,35,0,40,5
1683354100009,PHIL 174,A01,202226,Staff,17,0,20,3
1683354100009,PHIL 174,A02,202235,Staff,20,0,20,0
1683354101041,PHIL 191A,A00,258918,Staff,0,0,1,1
1683354102065,PHYS 1A,A00,187028,Staff,27,0,60,33
1683354103091,PHYS 1AL,001,187036,Staff,2,0,30,28
1683354103091,PHYS 1AL,002,187049,Staff,18,0,30,12
1683354104117,PHYS 1B,A00,187058,Staff,22,0,60,38
1683354105147,PHYS 1BL,001,187064,Staff,0,0,30,30
1683354105147,PHYS 1BL,002,187070,Staff,5,0,30,25
1683354106170,PHYS 1C,A00,187082,Staff,31,0,120,89
1683354107198,PHYS 1CL,001,187088,Staff,0,9,30,30
1683354107198,PHYS 1CL,002,187089,Staff,0,2,30,30
1683354107198,PHYS 1CL,009,262693,Staff,11,0,30,19
1683354108222,PHYS 2B,A01,187097,Staff,54,0,115,61
1683354109301,PHYS 2C,A01,187099,Staff,67,0,115,48
1683354110327,PHYS 2CL,A01,187101,Staff,5,0,28,23
1683354110327,PHYS 2CL,A02,187102,Staff,15,0,28,13
1683354111349,PHYS 2D,A01,187123,Shotwell; Brian,95,0,115,20
1683354112373,PHYS 4B,A01,187133,Grinstein; Benjamin,35,0,50,15
1683354113397,POLI 10,A00,188819,Staff,0,4,50,50
1683354114424,POLI 11,A00,188827,Staff,43,0,50,7
1683354115449,POLI 13R,A00,188828,Staff,0,1,20,20
1683354116476,POLI 27,A01,188830,Elgin; Samuel Zincke,0,1,70,70
1683354117504,POLI 30,A00,188832,Desposato; Scott,31,0,50,19
1683354118533,POLI 102F,A00,188834,Staff,3,0,40,37
1683354119558,POLI 104A,A00,188852,Staff,14,0,30,16
1683354120583,POLI 104I,A00,188853,Staff,0,6,20,20
1683354121607,POLI 110B,A00,188854,Wiens; David,7,0,20,13
1683354122633,POLI 112A,A00,188855,Wiens; David,5,0,30,25
1683354123656,POLI 117R,A00,188856,Forman; Fonna,0,11,20,20
1683354124686,POLI 118,A00,188857,Ingham; Sean,8,0,20,12
1683354125713,POLI 120G,A00,188858,Staff,9,0,30,21
1683354126737,POLI 131CR,A00,188863,Hoston; Germaine,23,0,50,27
1683354127762,POLI 133,A00,188864,Nellis; Gareth Hb,44,0,50,6
1683354128786,POLI 134D,A00,188865,Desposato; Scott,27,0,30,3
1683354129816,POLI 142A,A00,188871,Gartzke; Erik,22,0,50,28
1683354130843,POLI 142K,A00,188874,Staff,38,0,50,12
1683354131870,POLI 143,A00,188940,Gartzke; Erik,16,0,30,14
1683354132893,POLI 153,A00,188943,Staff,3,0,20,17
1683354133916,POLI 160AA,A00,188944,Staff,11,0,40,29
1683354134940,POLI 170A,A00,188945,Staff,11,0,30,19
1683354136990,PSYC 1,A00,188952,Staff,37,0,90,53
1683354138018,PSYC 2,B00,188953,Staff,19,0,35,16
1683354139043,PSYC 6,A00,188970,Staff,47,0,60,13
1683354140068,PSYC 7,A00,188973,Staff,37,0,45,8
1683354141097,PSYC 60,A01,188980,Rickard; Timothy C.,43,0,60,17
1683354142124,PSYC 70,A01,189001,Steiner; Eric Tomas,23,0,45,22
1683354143153,PSYC 100,A00,189005,Lacefield; Katharine I,0,98,120,120
1683354144178,PSYC 102,A00,189008,Staff,9,0,30,21
1683354145208,PSYC 106,B00,189026,Gorman; Michael R.,34,0,60,26
1683354146232,PSYC 114,B01,189033,Winkielman; Piotr,0,32,30,30
1683354147262,PSYC 131,A00,189036,Anagnostaras; Stephan,0,43,60,60
1683354148288,PSYC 136,A00,189041,Lowe; Angela Beth,0,7,25,25
1683354149313,PSYC 137,A00,189057,Winkielman; Piotr,0,34,25,25
1683354150335,PSYC 144,A00,189107,Wixted; John T,0,7,50,50
1683354152384,PSYC 162,A00,189142,Staff,0,8,85,85
1683354153411,PSYC 172,A00,189144,Gorman; Michael R.,0,7,30,30
1683354155463,PSYC 179,A00,189146,Lacefield; Katharine I,0,84,120,120
1683354156490,PSYC 181,A00,189147,Anagnostaras; Stephan,0,44,90,90
1683354157517,PSYC 190R,A00,189148,Barner; David A.,0,22,80,80
1683354158545,PSYC 191,A00,189275,Rickard; Timothy C.,0,7,25,25
1683354159573,PSYC 193,A00,189276,Chapman; Eddie Nathaniel,0,1,0,4
1683354160600,PSYC 193L,A01,189281,Lowe; Angela Beth,12,0,20,8
1683354160600,PSYC 193L,B01,189285,Staff,28,0,35,7
1683354161626,RELI 149,A00,187137,Rahimi; Babak,7,0,40,33
1683354162654,SE 9,A01,187315,Staff,0,2,18,18
1683354163681,SE 101B,A00,187409,Staff,24,0,30,6
1683354164706,SE 110B,A00,187444,Staff,10,0,40,30
1683354165730,SE 130B,A00,187449,Staff,31,0,40,9
1683354166754,SE 150A,A00,187516,Staff,9,0,20,11
1683354167779,SE 154,A00,187528,Staff,30,0,50,20
1683354168802,SIO 3,A01,258171,Staff,35,0,40,5
1683354169831,SIO 10,A00,187144,Cook; Geoffrey W,0,3,75,75
1683354170857,SIO 45,A00,187152,Cook; Geoffrey W,1,0,100,99
1683354171882,SIO 109R,A00,194486,Staff,0,3,20,20
1683354173934,SIO 187,A01,187233,Kacev; David,12,0,40,28
1683354174960,SOCI 1,A01,258656,Thorpe; Charles Robert,28,0,30,2
1683354174960,SOCI 1,A02,258658,Thorpe; Charles Robert,30,0,30,0
1683354174960,SOCI 1,A03,258661,Thorpe; Charles Robert,25,0,25,0
1683354174960,SOCI 1,A04,258666,Thorpe; Charles Robert,22,0,25,3
1683354174960,SOCI 1,A05,258897,Thorpe; Charles Robert,23,0,25,2
1683354174960,SOCI 1,A06,258898,Thorpe; Charles Robert,25,0,25,0
1683354175985,SOCI 30,A01,258903,Pardo Guerra; Juan Pablo,15,0,30,15
1683354177012,SOCI 102,A00,258904,Staff,9,0,25,16
1683354178035,SOCI 106,A00,258905,Staff,19,0,25,6
1683354179059,SOCI 111,A00,258907,Ribas Norris; Janet Vanesa,26,0,30,4
1683354180082,SOCI 121R,A00,258908,Pardo Guerra; Juan Pablo,10,0,30,20
1683354181112,SOCI 126,A01,203330,Staff,14,0,20,6
1683354182137,SOCI 131,A00,258909,Thorpe; Charles Robert,31,0,60,29
1683354183162,SOCI 135,A00,258910,Payne; Christine Anna,0,9,30,30
1683354184190,SOCI 157,A00,258911,Staff,12,0,30,18
1683354185214,SOCI 184,A00,258912,Staff,25,0,30,5
1683354186238,SOCI 188D,A00,258913,Staff,22,0,30,8
1683354187265,SYN 2,001,187529,Staff,10,0,16,6
1683354187265,SYN 2,002,201452,Staff,0,18,16,16
1683354187265,SYN 2,003,201469,Staff,3,0,16,13
1683354188291,SYN 100,A01,187531,Staff,0,9,20,20
1683354188291,SYN 100,B01,201491,Staff,0,12,20,20
1683354189321,TDAC 1,A00,189286,Walsh; Kim C.,3,0,20,17
1683354189321,TDAC 1,B00,189287,Harting; Carla Kelso,11,0,20,9
1683354190345,TDAC 101,A00,189300,Walsh; Kim C.,16,0,20,4
1683354190345,TDAC 101,B00,189301,Harting; Carla Kelso,18,0,20,2
1683354191369,TDAC 102,A00,189304,Basso; Beatrice,14,0,20,6
1683354192394,TDAC 108,A00,189305,Staff,18,0,20,2
1683354193422,TDDE 131,A00,189310,Staff,19,0,20,1
1683354193422,TDDE 131,B00,189314,Staff,19,0,20,1
1683354193422,TDDE 131,C00,189315,Staff,48,0,50,2
1683354193422,TDDE 131,D00,189316,Staff,14,0,15,1
1683354193422,TDDE 131,E00,204841,Staff,20,0,20,0
1683354194447,TDGE 10,A00,189289,Staff,30,0,50,20
1683354194447,TDGE 10,B00,189290,Havis; Allan,1,0,50,49
1683354195473,TDGE 11,A00,189291,Fulton; Julia,0,3,50,50
1683354195473,TDGE 11,B00,189292,Staff,20,0,25,5
1683354195473,TDGE 11,C00,260270,Staff,0,0,0,0
1683354196499,TDGE 25,A00,189294,Staff,3,0,20,17
1683354197527,TDGE 124,A00,189318,Fulton; Julia,0,8,50,50
1683354198550,TDGE 125,A00,189319,Staff,13,0,25,12
1683354198550,TDGE 125,B00,189320,Staff,23,0,25,2
1683354199578,TDGE 127,A00,189322,Havis; Allan,0,0,50,50
1683354200603,TDHT 101,A00,189323,Staff,18,0,25,7
1683354200603,TDHT 101,B00,189324,Staff,25,0,25,0
1683354201627,TDHT 102,A00,189325,Staff,49,0,50,1
1683354202654,TDMV 1,A00,189295,Arcidiacono; Kristin,19,0,30,11
1683354202654,TDMV 1,B00,189296,Caligagan; Maria T.,24,0,30,6
1683354203681,TDMV 2,A00,189297,Sammartano; Tonnie,28,0,30,2
1683354203681,TDMV 2,B00,189299,Arcidiacono; Kristin,24,0,30,6
1683354204709,TDMV 3,A00,204998,Rincon; Alicia,22,0,30,8
1683354205734,TDMV 120,A00,189458,Sammartano; Tonnie,28,0,30,2
1683354206758,TDMV 138,A00,189541,Jun; Grace Shin Hae,22,0,40,18
1683354207785,TDMV 142,A00,189717,Caligagan; Tony,23,0,30,7
1683354207785,TDMV 142,B00,189718,Caligagan; Maria T.,25,0,30,5
1683354208812,TMC 2,A01,187533,Staff,25,0,25,0
1683354208812,TMC 2,A02,187534,Staff,25,0,25,0
1683354209835,USP 1,A01,187536,Kwak; Nancy,0,16,25,25
1683354210858,USP 5,A01,187538,Staff,10,0,25,15
1683354211883,USP 101,A00,199253,Staff,0,4,0,0
1683354212961,USP 124,A00,187562,Boomhower; Matthew Charles,1,0,30,29
1683354213987,USP 138,A00,187582,Staff,20,0,25,5
1683354215011,USP 152,A01,187597,Staff,4,0,25,21
1683354216039,USP 153,A00,187598,Staff,19,0,25,6
1683354217068,USP 168,A00,187607,Kwak; Nancy,2,0,5,3
1683354218092,USP 173,A00,187619,Staff,4,0,25,21
1683354219120,USP 181,A00,187638,Staff,0,3,25,25
1683354220147,VIS 103,A00,187650,Cruz; Edwin Teddy,22,0,75,53
1683354221171,VIS 110D,A00,187669,Staff,12,0,22,10
1683354222195,VIS 127C,A00,187720,Shen; Kuiyi,67,0,146,79
1683354223221,VIS 149,A00,187731,Yoldas; Pinar,0,14,22,22
1683354224245,VIS 151,A01,188091,Staff,22,0,34,12
1683354224245,VIS 151,A02,188092,Staff,11,0,34,23
1683354225269,VIS 160B,A00,188093,Stalbaum; Brett,0,0,10,10
1683354227322,WCWP 10B,A00,201720,Staff,10,0,15,5
1683354227322,WCWP 10B,B00,201722,Staff,9,0,15,6
1683354228349,WCWP 100,A00,201725,Gagnon; Jeffrey C,0,0,2,2
1683354228349,WCWP 100,B00,201727,Staff,0,4,15,15
1683354231435,ANBI 133,A00,258401,Wilder; Linnea Lorene,34,0,40,6
1683354232461,ANBI 140,A00,258395,Hrvoj Mihic; Branka,18,0,25,7
1683354233485,ANSC 120,A00,258402,Bialecki; Jon Anthony,27,0,40,13
1683354234509,ANSC 144,A00,258400,Staff,14,0,40,26
1683354236566,ANSC 166,A00,258396,Parish; Steven Martin,157,0,175,18
1683354237593,ANSC 180,A00,193533,Staff,9,0,20,11
1683354238617,ANSC 188,A00,258397,Jassal; Aftab,33,0,40,7
1683354239646,ANTH 3,A01,258316,Staff,23,0,30,7
1683354240673,ANTH 5,A00,258394,Semendeferi; Ekaterini,16,0,20,4
1683354241701,ANTH 21,A01,258331,Staff,8,0,40,32
1683354242725,ANTH 103,A00,258398,Varma; Saiba,15,0,25,10
1683354243755,AWP 10,001,202034,Staff,0,0,0,0
1683354243755,AWP 10,002,202035,Staff,0,0,0,0
1683354243755,AWP 10,003,202036,Staff,0,0,0,0
1683354243755,AWP 10,004,202037,Staff,0,0,0,0
1683354243755,AWP 10,005,202038,Staff,0,0,0,0
1683354243755,AWP 10,006,202039,Staff,0,0,0,0
1683354243755,AWP 10,007,202040,Staff,0,0,0,0
1683354243755,AWP 10,008,202041,Staff,0,0,0,0
1683354243755,AWP 10,009,202042,Staff,0,0,0,0
1683354243755,AWP 10,010,202043,Staff,0,0,0,0
1683354243755,AWP 10,011,202044,Staff,0,0,0,0
1683354243755,AWP 10,012,202045,Staff,0,0,0,0
1683354243755,AWP 10,013,202046,Staff,0,0,0,0
1683354243755,AWP 10,014,202047,Staff,0,0,0,0
1683354243755,AWP 10,015,202048,Staff,0,0,0,0
1683354243755,AWP 10,016,202049,Staff,0,0,0,0
1683354243755,AWP 10,017,202050,Staff,0,0,0,0
1683354243755,AWP 10,018,202051,Staff,0,0,0,0
1683354243755,AWP 10,019,202052,Staff,0,0,0,0
1683354243755,AWP 10,020,202053,Staff,0,0,0,0
1683354243755,AWP 10,021,202054,Staff,0,0,0,0
1683354243755,AWP 10,022,202055,Staff,0,0,0,0
1683354243755,AWP 10,023,202056,Staff,0,0,0,0
1683354243755,AWP 10,024,202057,Staff,0,0,0,0
1683354243755,AWP 10,025,202058,Staff,0,0,0,0
1683354243755,AWP 10,026,202059,Staff,0,0,0,0
1683354244779,AWP 102,001,202032,Staff,0,0,0,0
1683354244779,AWP 102,002,202033,Staff,0,0,0,0
1683354245804,BENG 100,A01,254234,Taylor Amos; Alyssa C,31,0,40,9
1683354246830,BENG 196,001,270013,Engler; Adam J.,9999,0,9999,0
1683354247855,BICD 100R,A01,202018,Smith; Laurie,0,7,32,32
1683354247855,BICD 100R,A02,202019,Smith; Laurie,0,2,32,32
1683354247855,BICD 100R,A03,202020,Smith; Laurie,0,1,32,32
1683354247855,BICD 100R,A04,202021,Smith; Laurie,9,0,32,23
1683354247855,BICD 100R,A05,202022,Smith; Laurie,12,0,32,20
1683354248880,BICD 136,A01,193242,Gustafson-Brown; Cindy,0,2,32,32
1683354248880,BICD 136,A02,193244,Gustafson-Brown; Cindy,14,0,32,18
1683354249912,BIEB 102,A01,193249,Butler; Shannon Rhey,0,2,32,32
1683354249912,BIEB 102,A02,193251,Butler; Shannon Rhey,0,0,32,32
1683354249912,BIEB 102,A03,193253,Butler; Shannon Rhey,0,1,32,32
1683354249912,BIEB 102,A04,193255,Butler; Shannon Rhey,17,0,32,15
1683354249912,BIEB 102,A05,193265,Butler; Shannon Rhey,26,0,32,6
1683354249912,BIEB 102,A06,193269,Butler; Shannon Rhey,16,0,32,16
1683354251962,BIEB 150,A01,193274,Staff,0,0,32,32
1683354251962,BIEB 150,A02,193285,Staff,23,0,32,9
1683354252990,BIEB 194,A00,193286,Kurle; Carolyn M.,22,0,32,10
1683354254019,BILD 1,A01,192291,Staff,16,0,32,16
1683354254019,BILD 1,A02,192292,Staff,30,0,32,2
1683354254019,BILD 1,B01,192520,Reuther; Keefe,0,1,0,0
1683354254019,BILD 1,B02,192532,Reuther; Keefe,0,1,0,0
1683354255044,BILD 3,A01,192556,Butler; Shannon Rhey,0,0,32,32
1683354255044,BILD 3,A02,192581,Butler; Shannon Rhey,4,0,32,28
1683354255044,BILD 3,A03,192611,Butler; Shannon Rhey,23,0,32,9
1683354255044,BILD 3,A04,192612,Butler; Shannon Rhey,25,0,32,7
1683354255044,BILD 3,A05,192613,Butler; Shannon Rhey,27,0,32,5
1683354255044,BILD 3,A06,192679,Butler; Shannon Rhey,27,0,32,5
1683354255044,BILD 3,A07,192682,Butler; Shannon Rhey,22,0,32,10
1683354256074,BILD 4,A01,192836,Reuther; Keefe,0,0,24,24
1683354256074,BILD 4,A02,193044,Reuther; Keefe,4,0,24,20
1683354257098,BILD 10,A01,193142,Gustafson-Brown; Cindy,30,0,32,2
1683354257098,BILD 10,A02,193149,Gustafson-Brown; Cindy,31,0,32,1
1683354258123,BIMM 100,A01,193301,Staff,0,6,32,32
1683354258123,BIMM 100,A02,193312,Staff,0,5,32,32
1683354258123,BIMM 100,A03,193323,Staff,0,8,32,32
1683354259149,BIMM 101,A01,193329,McDonnell; Lisa Marie,0,3,24,24
1683354259149,BIMM 101,A02,193339,McDonnell; Lisa Marie,0,3,24,24
1683354259149,BIMM 101,B01,193354,McDonnell; Lisa Marie,0,3,24,24
1683354259149,BIMM 101,B02,193357,McDonnell; Lisa Marie,0,3,24,24
1683354260175,BIMM 110,A01,193377,Tat; John,0,11,32,32
1683354260175,BIMM 110,A02,193378,Tat; John,0,9,32,32
1683354261204,BIMM 120,A01,206116,Staff,0,0,32,32
1683354261204,BIMM 120,A02,206117,Staff,8,0,32,24
1683354261204,BIMM 120,A03,206121,Staff,21,0,32,11
1683354262230,BIPN 100,A01,193393,Park; Ji Young,0,14,32,32
1683354262230,BIPN 100,A02,193402,Park; Ji Young,0,13,32,32
1683354262230,BIPN 100,A03,193413,Park; Ji Young,0,14,32,32
1683354262230,BIPN 100,A04,193414,Park; Ji Young,0,13,32,32
1683354263254,BIPN 102,A01,193429,Staff,0,0,32,32
1683354263254,BIPN 102,A02,193438,Staff,22,0,32,10
1683354264279,BIPN 106,A01,193450,Reyes Gonzalez; Catalina,0,2,40,40
1683354265304,BIPN 134,A01,193465,Cooke; James Edward,1,0,32,31
1683354265304,BIPN 134,A02,193474,Cooke; James Edward,25,0,32,7
1683354265304,BIPN 134,A03,193485,Cooke; James Edward,29,0,32,3
1683354265304,BIPN 134,A04,193486,Cooke; James Edward,21,0,32,11
1683354265304,BIPN 134,A05,193491,Cooke; James Edward,31,0,32,1
1683354265304,BIPN 134,A06,193501,Cooke; James Edward,30,0,32,2
1683354265304,BIPN 134,A07,193510,Cooke; James Edward,29,0,32,3
1683354267353,BISP 194,A00,222522,Staff,14,0,32,18
1683354268377,CAT 124,A01,202407,Staff,20,0,25,5
1683354269405,CAT 125,A00,202408,Marchisotto; Jennifer Anne,4,0,20,16
1683354270430,CAT 125R,A00,202409,Smith; Lauryn Alissa,0,11,20,20
1683354270430,CAT 125R,B00,202410,Morales; Celeste Georgianna,0,11,20,20
1683354270430,CAT 125R,C00,202411,Irwin; Matthew Joseph,0,10,20,20
1683354271458,CENG 15,A01,204712,Yang; Kesong,0,1,0,0
1683354272486,CENG 114,A00,202070,Jahed Motlagh; Zeinab,5,0,20,15
1683354273511,CGS 105,A00,185477,Wesling; Megan E.,24,0,40,16
1683354274535,CGS 106,A00,185494,Staff,13,0,22,9
1683354275559,CGS 108,A00,185495,Staff,14,0,20,6
1683354276586,CGS 114,A00,185496,Staff,13,0,18,5
1683354277612,CGS 119,A00,185501,Staff,15,0,20,5
1683354278636,CGS 120,A00,185511,Staff,13,0,20,7
1683354279660,CHEM 4,A01,184675,Bussey; Thomas J,96,0,100,4
1683354280685,CHEM 6A,A01,184677,Staff,34,0,60,26
1683354281710,CHEM 6B,A01,184679,Staff,65,0,100,35
1683354282735,CHEM 6C,A01,184681,Bussey; Thomas J,1,0,50,49
1683354282735,CHEM 6C,A02,184682,Bussey; Thomas J,34,0,50,16
1683354283762,CHEM 40A,A01,184684,Albizati; Kim F.,37,0,100,63
1683354284786,CHEM 40B,A01,184686,Albizati; Kim F.,0,20,100,100
1683354285810,CHEM 41B,A01,184690,Staff,52,0,100,48
1683354286835,COGS 3,A01,184715,Boyle; Mary E. T.,0,25,40,40
1683354287862,COGS 14B,A01,185172,Staff,0,15,38,38
1683354288889,COGS 18,A01,184736,Staff,17,0,80,63
1683354289914,COGS 100,A01,184932,Staff,0,5,73,73
1683354290939,COGS 101A,A01,184935,Staff,0,39,30,30
1683354291963,COGS 101B,A01,184944,Staff,0,2,30,30
1683354292987,COGS 101C,A01,184946,Staff,0,12,30,30
1683354294010,COGS 102A,A01,184951,Johnson; Christine M.,2,0,40,38
1683354295034,COGS 107B,A01,184953,Mooshagian; Eric Frederick,0,50,40,40
1683354296066,COGS 118B,A01,184959,Gupta; Anjum,0,48,40,40
1683354297090,COGS 153,A00,184961,Staff,0,15,30,30
1683354298113,COGS 177,A00,184962,Staff,0,20,30,30
1683354299137,COGS 187A,A01,184969,Boyle; Mary E. T.,0,17,40,40
1683354300163,COMM 10,A01,185174,Staff,0,5,25,25
1683354300163,COMM 10,A02,185189,Staff,0,5,25,25
1683354300163,COMM 10,A03,269821,Staff,0,0,0,0
1683354301191,COMM 100B,A01,185475,Staff,0,0,0,2
1683354301191,COMM 100B,A02,185476,Staff,13,0,25,12
1683354302215,COMM 100C,A01,185314,Staff,1,0,25,24
1683354302215,COMM 100C,A02,185327,Staff,19,0,25,6
1683354303245,COMM 110M,A00,185349,Staff,2,0,40,38
1683354304273,COMM 113T,A00,185352,Staff,24,0,40,16
1683354305300,COMM 114I,A00,185353,Staff,33,0,40,7
1683354306323,COMM 131,A00,185354,Staff,19,0,30,11
1683354307348,CSE 8A,A50,185358,Cao; Yingjun,0,46,10,10
1683354308372,CSE 8B,A01,185362,Staff,0,46,50,50
1683354309401,CSE 11,A01,185416,Cao; Yingjun,0,92,10,10
1683354310424,CSE 20,A01,185445,Briones; Jor-el Thomas Caparas,5,0,25,20
1683354311451,CSE 21,A01,185447,Staff,10,0,50,40
1683354312478,CSE 101,A01,185451,Staff,0,13,50,50
1683354312478,CSE 101,B01,185453,Jones; Miles E,0,11,50,50
1683354314528,CSE 141,A01,185458,Eldon; John,20,0,100,80
1683354315554,CSE 141L,A01,185461,Eldon; John,12,0,100,88
1683354316640,CSE 142,A01,185463,Staff,36,0,60,24
1683354316640,CSE 142,B01,201355,Staff,0,7,60,60
1683354317665,CSE 142L,A01,185470,Staff,36,0,60,24
1683354317665,CSE 142L,B01,201417,Staff,0,6,60,60
1683354318690,CSE 190,A00,201433,Staff,32,0,49,17
1683354319713,DOC 1,A01,259136,Strom; Megan C.,7,0,15,8
1683354319713,DOC 1,A02,259137,Strom; Megan C.,14,0,15,1
1683354319713,DOC 1,A03,259138,Strom; Megan C.,14,0,15,1
1683354319713,DOC 1,A04,259139,Strom; Megan C.,14,0,15,1
1683354320742,DOC 100D,A00,259140,Pass; Natalye Joann,16,0,25,9
1683354321770,DSGN 1,A01,184749,Rill; Bryan,0,25,30,30
1683354322794,DSGN 100,A01,185168,Staff,0,2,25,25
1683354323819,ECE 5,A01,185626,Morris; Karcher William,0,10,0,0
1683354324848,ECE 101,A01,185628,Staff,17,0,70,53
1683354325877,ECE 107,A01,185635,Baghdadchi; Saharnaz,0,0,20,20
1683354325877,ECE 107,A02,185638,Baghdadchi; Saharnaz,4,0,20,16
1683354326904,ECE 148,A01,185647,Silberman; Jack,0,0,16,16
1683354327928,ECON 1,A01,185537,Crane; Meredith Helen,54,0,70,16
1683354328953,ECON 3,A01,185549,Crane; Meredith Helen,32,0,70,38
1683354329979,ECON 4,A01,203354,Anderson; John Charles,0,4,10,10
1683354331006,ECON 100A,A01,185574,Staff,0,4,40,40
1683354332033,ECON 100B,A01,185576,Staff,0,12,50,50
1683354333057,ECON 100C,A01,185589,Newhouse; Herbert S,29,0,70,41
1683354334085,ECON 105,A00,185608,Vespa; Emanuel Ignacio,19,0,35,16
1683354335113,ECON 109,A01,185610,Shishkin; Denis,10,0,35,25
1683354336139,ECON 110A,A01,185612,Staff,11,0,40,29
1683354337167,ECON 120A,A01,185615,Staff,20,0,40,20
1683354338193,ECON 120C,A01,185617,Sun; Yixiao,0,21,70,70
1683354339217,ECON 144,A00,203346,Squires; Dale E,3,0,35,32
1683354340241,ECON 171,A01,203349,Newhouse; Herbert S,0,1,35,35
1683354341266,ECON 173A,A01,185621,Toda; Alexis Akira,21,0,35,14
1683354342289,EDS 25,A01,202413,Staff,0,1,0,0
1683354342289,EDS 25,A02,202414,Staff,0,1,0,0
1683354342289,EDS 25,A03,202415,Staff,0,0,0,0
1683354342289,EDS 25,A04,202416,Staff,0,1,0,0
1683354342289,EDS 25,A05,202439,Staff,0,0,0,0
1683354342289,EDS 25,A06,202440,Staff,0,0,0,0
1683354342289,EDS 25,B01,202631,Staff,0,0,0,0
1683354342289,EDS 25,B02,202632,Staff,0,0,0,0
1683354342289,EDS 25,B03,202639,Staff,0,0,0,0
1683354342289,EDS 25,B04,202640,Staff,0,0,0,0
1683354342289,EDS 25,B05,202643,Staff,0,0,0,0
1683354342289,EDS 25,B06,202644,Staff,0,0,0,0
1683354343313,EDS 38,A01,202659,Black; Alison Michelle,24,0,25,1
1683354344338,EDS 115,A00,202652,Staff,18,0,30,12
1683354345365,EDS 125,A00,202649,Staff,14,0,30,16
1683354346390,EDS 126,A01,203332,Staff,30,0,30,0
1683354347421,EDS 139,A00,202838,Staff,16,0,25,9
1683354348447,EDS 146,A01,202655,Staff,14,0,25,11
1683354349518,ENG 15,A00,185667,Staff,0,1,0,0
1683354349518,ENG 15,B00,185672,Staff,0,0,0,0
1683354349518,ENG 15,C00,185675,Staff,0,0,0,0
1683354349518,ENG 15,D00,185682,Staff,0,0,0,0
1683354349518,ENG 15,E00,185684,Staff,0,0,0,0
1683354350562,ETHN 103,A00,185710,Staff,0,4,35,35
1683354351593,ETHN 103A,A00,199228,Man; Simeon S,2,0,9,7
1683354352621,ETHN 109,A00,185711,Staff,18,0,35,17
1683354353646,ETHN 142,A00,185726,Staff,0,4,30,30
1683354354670,ETHN 163J,A00,199229,Man; Simeon S,5,0,8,3
1683354355698,ETHN 168,A00,185727,Staff,8,0,10,2
1683354356725,ETHN 182,A00,185728,Staff,0,0,35,35
1683354357751,ETHN 183,A00,185737,Staff,8,0,18,10
1683354358779,GLBH 111,A01,209361,Burgos; Jose L.,0,0,0,0
1683354360827,HIEU 104,A00,185792,Staff,16,0,20,4
1683354361853,HIEU 115,A00,185800,Staff,1,0,20,19
1683354362877,HIEU 128,A00,185801,Staff,0,7,20,20
1683354363901,HIEU 147,A00,185802,Staff,16,0,20,4
1683354364925,HIEU 154,A00,185823,Staff,12,0,20,8
1683354365950,HILA 102,A00,185826,Staff,13,0,20,7
1683354366978,HILD 2C,A01,185778,Staff,0,12,20,20
1683354368058,HILD 7B,A01,185780,Kwak; Nancy,0,15,32,32
1683354368058,HILD 7B,A02,185781,Kwak; Nancy,0,18,32,32
1683354369084,HILD 30,A01,185791,Staff,14,0,20,6
1683354370107,HISC 119,A00,185830,Golan; Tal,0,9,20,20
1683354371135,HITO 156GS,A00,185831,Patterson; Patrick H.,0,0,0,23
1683354372164,HIUS 103,A00,185832,Man; Simeon S,0,6,20,20
1683354373187,HIUS 117,A00,185836,Kwak; Nancy,2,0,20,18
1683354374211,HIUS 125,A00,185840,Man; Simeon S,0,0,23,23
1683354375239,HIUS 149,A00,185845,Staff,0,0,20,20
1683354376268,HUM 3,A01,185882,Zavodny; Tatiana Sophia,0,7,50,50
1683354376268,HUM 3,B01,185899,Caldwell; Michael Alan,0,18,50,50
1683354377294,HUM 3GS,A00,185900,Patterson; Patrick H.,0,0,0,23
1683354378324,HUM 4,A01,185938,Zroka; Amy Liane,31,0,50,19
1683354378324,HUM 4,B01,185956,Watkins; Eric,0,3,50,50
1683354378324,HUM 4,B02,202209,Watkins; Eric,0,2,50,50
1683354378324,HUM 4,B03,202210,Watkins; Eric,0,2,50,50
1683354379351,HUM 5,A01,185958,West; Geoffrey Scott,3,0,50,47
1683354379351,HUM 5,A02,202215,West; Geoffrey Scott,0,0,50,50
1683354380375,INTL 190,A00,185959,Gagnon; Jeffrey C,0,0,0,9
1683354380375,INTL 190,B00,185960,Lettieri; Michael Joseph,0,0,0,1
1683354381400,JAPN 180,A00,254509,Staff,4,0,30,26
1683354382424,LATI 10,A01,202853,Kennemore; Amy Michelle,4,0,35,31
1683354382424,LATI 10,A02,202854,Kennemore; Amy Michelle,2,0,35,33
1683354382424,LATI 10,A03,270054,Kennemore; Amy Michelle,30,0,30,0
1683354383448,LATI 180,A00,202855,Kennemore; Amy Michelle,11,0,20,9
1683354384473,LAWS 101,A00,201767,Golan; Tal,0,7,40,40
1683354385496,LIFR 1C,A00,185961,Staff,6,0,20,14
1683354386520,LIFR 1CX,A00,185962,Staff,7,0,20,13
1683354387547,LIFR 1D,A00,185963,Staff,9,0,20,11
1683354388575,LIFR 1DX,A00,185964,Staff,9,0,20,11
1683354389602,LIGN 101,A01,186039,Staff,43,0,50,7
1683354390629,LIGN 165,A00,186040,Staff,18,0,50,32
1683354391656,LTCS 108,A00,186041,Staff,6,0,10,4
1683354392683,LTCS 119,A00,186042,Staff,16,0,20,4
1683354393710,LTCS 130,A00,186043,Wesling; Megan E.,15,0,25,10
1683354395756,LTEA 138,A00,186119,Staff,14,0,40,26
1683354396783,LTEN 124,A00,186148,Staff,6,0,25,19
1683354397808,LTEN 178,A00,186149,Staff,7,0,15,8
1683354398831,LTEN 181,A00,186150,Blanco; John D,33,0,40,7
1683354399858,LTWL 120,A00,186160,Staff,20,0,25,5
1683354400883,LTWL 165,A00,186161,Staff,22,0,25,3
1683354401908,LTWR 100,A00,186162,Staff,0,5,15,15
1683354402934,LTWR 102,A00,186163,Doller; Ben,5,0,15,10
1683354403961,MAE 8,A01,186412,Staff,0,0,0,0
1683354404989,MAE 30B,A00,186445,Bahadori; Mohammad Yousef,83,0,100,17
1683354406013,MAE 40,A00,186592,Bewley; Thomas R,10,0,50,40
1683354407038,MAE 101B,A00,186593,Bahadori; Mohammad Yousef,81,0,100,19
1683354408063,MAE 105,A00,186594,Bandaru; Prabhakar,12,0,50,38
1683354409087,MAE 107,A00,186599,Pham; Hieu Tan,0,7,120,120
1683354410116,MAE 148,A01,186660,Silberman; Jack,3,0,16,13
1683354411145,MATH 10A,A01,188095,Staff,0,5,35,35
1683354412170,MATH 10B,A01,188097,Bowers; Adam R.,0,11,30,30
1683354412170,MATH 10B,A02,188099,Bowers; Adam R.,0,11,30,30
1683354412170,MATH 10B,B01,188104,Bowers; Adam R.,0,10,30,30
1683354412170,MATH 10B,B02,188106,Bowers; Adam R.,0,10,30,30
1683354413195,MATH 10C,A01,188111,Staff,0,18,30,30
1683354413195,MATH 10C,A02,188127,Staff,0,17,30,30
1683354413195,MATH 10C,A03,188131,Staff,0,18,30,30
1683354413195,MATH 10C,B01,188218,Staff,18,0,30,12
1683354413195,MATH 10C,B02,188244,Staff,13,0,30,17
1683354413195,MATH 10C,B03,188277,Staff,16,0,30,14
1683354414221,MATH 18,A01,188344,Bach; Quang Tran,18,0,30,12
1683354414221,MATH 18,A02,188345,Bach; Quang Tran,11,0,30,19
1683354414221,MATH 18,B01,188353,Bach; Quang Tran,10,0,30,20
1683354414221,MATH 18,B02,188354,Bach; Quang Tran,20,0,30,10
1683354415243,MATH 20A,A01,188374,Staff,12,0,35,23
1683354416275,MATH 20B,A01,188382,Ohm; Ko Woon,6,0,30,24
1683354416275,MATH 20B,A02,188383,Ohm; Ko Woon,22,0,30,8
1683354416275,MATH 20B,B01,188385,Ohm; Ko Woon,7,0,30,23
1683354416275,MATH 20B,B02,188392,Ohm; Ko Woon,22,0,30,8
1683354417304,MATH 20C,A01,188394,Harel; Guershon,10,0,30,20
1683354417304,MATH 20C,A02,188395,Harel; Guershon,15,0,30,15
1683354417304,MATH 20C,B01,188404,Harel; Guershon,4,0,30,26
1683354417304,MATH 20C,B02,188405,Harel; Guershon,19,0,30,11
1683354418327,MATH 20D,A01,188414,Hammock; Frances H,0,1,30,30
1683354418327,MATH 20D,A02,188415,Hammock; Frances H,3,0,30,27
1683354418327,MATH 20D,B01,188447,Hammock; Frances H,1,0,30,29
1683354418327,MATH 20D,B02,188486,Hammock; Frances H,8,0,30,22
1683354419353,MATH 20E,A01,188649,Staff,21,0,30,9
1683354419353,MATH 20E,A02,188650,Staff,23,0,30,7
1683354419353,MATH 20E,A03,188673,Staff,0,0,30,30
1683354420439,MATH 102,A01,188675,Staff,0,35,35,35
1683354421473,MATH 103B,A01,188681,Staff,3,0,35,32
1683354421473,MATH 103B,B01,188692,Staff,5,0,35,30
1683354422501,MATH 109,A01,188695,Salehi Golsefidy; Alireza,25,0,35,10
1683354422501,MATH 109,A02,188696,Salehi Golsefidy; Alireza,25,0,35,10
1683354423528,MATH 120A,A01,188698,Eggers; John Dietrich,7,0,35,28
1683354424559,MATH 142B,A01,188736,Ioana; Adrian,0,2,30,30
1683354424559,MATH 142B,A02,188741,Ioana; Adrian,0,0,30,30
1683354424559,MATH 142B,A03,188743,Ioana; Adrian,0,1,30,30
1683354425583,MATH 168A,A01,188790,Staff,0,9,35,35
1683354426613,MATH 170A,A01,188803,Nie; Jiawang,0,2,35,35
1683354426613,MATH 170A,A02,188811,Nie; Jiawang,0,0,35,35
1683354426613,MATH 170A,A03,188814,Nie; Jiawang,1,0,35,34
1683354426613,MATH 170A,A04,188815,Nie; Jiawang,13,0,35,22
1683354427638,MATH 193B,A01,188817,Staff,0,0,35,35
1683354427638,MATH 193B,A02,188818,Staff,5,0,35,30
1683354428668,MGT 4,A01,202857,Anderson; John Charles,61,0,80,19
1683354429696,MGT 12,A00,202858,Lindenberger; Wade Douglas,42,0,90,48
1683354430723,MGT 18,A00,202859,Staff,74,0,90,16
1683354431749,MGT 18GS,A00,202860,McKay; Michael J,13,0,28,15
1683354432774,MGT 45,A00,202861,Pecore; Joseph P.,14,0,90,76
1683354433798,MGT 100,A00,202863,Yavorsky; Daniel Ryan,28,0,90,62
1683354434822,MGT 103,A00,202864,Ehrich; Kristine R,0,17,90,90
1683354435849,MGT 112,A00,202865,Ehrich; Kristine R,15,0,90,75
1683354436873,MGT 121A,A00,202868,Staff,0,20,0,0
1683354437902,MGT 131B,A00,202869,Anderson; John Charles,59,0,90,31
1683354438928,MGT 136,A00,202871,Lindenberger; Wade Douglas,84,0,90,6
1683354439954,MGT 164,A00,202873,Staff,0,68,90,91
1683354440978,MGT 164GS,A00,202874,McKay; Mary A,13,0,28,15
1683354442002,MGT 180,A00,202875,Staff,0,50,90,91
1683354443027,MMW 11R,A01,205019,Herbst; Matthew,3,0,30,27
1683354443027,MMW 11R,A02,205026,Herbst; Matthew,29,0,30,1
1683354444058,MMW 15,A01,193512,Chang; Edmond Yi-Teh,0,9,28,28
1683354444058,MMW 15,A02,193513,Chang; Edmond Yi-Teh,0,5,28,28
1683354444058,MMW 15,A03,193514,Chang; Edmond Yi-Teh,0,5,28,28
1683354444058,MMW 15,A04,193515,Chang; Edmond Yi-Teh,0,5,28,28
1683354444058,MMW 15,A05,193516,Chang; Edmond Yi-Teh,0,4,28,28
1683354444058,MMW 15,A06,193517,Chang; Edmond Yi-Teh,0,5,28,28
1683354444058,MMW 15,B01,193519,Chang; Edmond Yi-Teh,0,5,28,28
1683354444058,MMW 15,B02,193520,Chang; Edmond Yi-Teh,0,5,28,28
1683354444058,MMW 15,B03,193521,Chang; Edmond Yi-Teh,0,5,28,28
1683354444058,MMW 15,B04,193522,Chang; Edmond Yi-Teh,0,4,28,28
1683354444058,MMW 15,B05,193523,Chang; Edmond Yi-Teh,0,5,28,28
1683354444058,MMW 15,B06,193524,Chang; Edmond Yi-Teh,0,4,28,28
1683354445085,MMW 122,A01,193526,Rahimi; Babak,0,15,28,28
1683354445085,MMW 122,A02,193527,Rahimi; Babak,0,14,28,28
1683354445085,MMW 122,A03,193528,Rahimi; Babak,0,0,0,0
1683354445085,MMW 122,A04,193529,Rahimi; Babak,0,0,0,0
1683354446113,MUS 1A,A01,186663,Staff,0,20,35,35
1683354447141,MUS 4,A01,186715,Staff,0,12,35,35
1683354448167,MUS 5R,A01,186796,Dubnov; Shlomo,0,17,35,35
1683354449193,MUS 6,A01,186798,Staff,0,4,25,25
1683354450217,MUS 7,A01,186830,Staff,13,0,35,22
1683354451244,MUS 8,A01,186930,Staff,0,26,35,35
1683354452271,MUS 15,A01,186932,Staff,0,16,35,35
1683354452271,MUS 15,B01,186934,Staff,0,15,35,35
1683354453298,MUS 80,A00,186935,Staff,1,0,20,19
1683354453298,MUS 80,B00,186936,Staff,25,0,25,0
1683354454326,NANO 11,A00,204702,Lipomi; Darren John,0,0,0,0
1683354455354,NANO 15,A01,204709,Yang; Kesong,0,1,0,0
1683354456381,NANO 114,A00,202069,Jahed Motlagh; Zeinab,3,0,10,7
1683354457408,PHIL 1,A00,186955,Grush; Rick Scott,32,0,40,8
1683354458433,PHIL 10,A01,186973,Grush; Rick Scott,28,0,35,7
1683354458433,PHIL 10,A02,186974,Grush; Rick Scott,33,0,35,2
1683354459461,PHIL 13,A01,186976,Staff,7,0,35,28
1683354459461,PHIL 13,A02,186977,Staff,16,0,35,19
1683354460483,PHIL 14,A01,186979,Staff,31,0,35,4
1683354460483,PHIL 14,A02,186986,Staff,32,0,35,3
1683354461508,PHIL 28,A01,186988,Staff,16,0,30,14
1683354461508,PHIL 28,A02,186989,Staff,1,0,30,29
1683354461508,PHIL 28,A03,186990,Staff,9,0,30,21
1683354461508,PHIL 28,A04,186991,Staff,26,0,30,4
1683354462533,PHIL 120,A00,186997,Staff,23,0,40,17
1683354463561,PHIL 137,A00,187003,Staff,9,0,40,31
1683354464601,PHIL 150,A00,187015,Staff,47,0,70,23
1683354465629,PHIL 167,A00,187021,Lamey; Andy M.,35,0,40,5
1683354466654,PHIL 174,A01,202226,Staff,17,0,20,3
1683354466654,PHIL 174,A02,202235,Staff,20,0,20,0
1683354467678,PHIL 191A,A00,258918,Staff,0,0,1,1
1683354468702,PHYS 1A,A00,187028,Staff,27,0,60,33
1683354469726,PHYS 1AL,001,187036,Staff,2,0,30,28
1683354469726,PHYS 1AL,002,187049,Staff,18,0,30,12
1683354470752,PHYS 1B,A00,187058,Staff,22,0,60,38
1683354471777,PHYS 1BL,001,187064,Staff,0,0,30,30
1683354471777,PHYS 1BL,002,187070,Staff,5,0,30,25
1683354472801,PHYS 1C,A00,187082,Staff,31,0,120,89
1683354473826,PHYS 1CL,001,187088,Staff,0,9,30,30
1683354473826,PHYS 1CL,002,187089,Staff,0,2,30,30
1683354473826,PHYS 1CL,009,262693,Staff,11,0,30,19
1683354474854,PHYS 2B,A01,187097,Staff,54,0,115,61
1683354475883,PHYS 2C,A01,187099,Staff,67,0,115,48
1683354476906,PHYS 2CL,A01,187101,Staff,5,0,28,23
1683354476906,PHYS 2CL,A02,187102,Staff,15,0,28,13
1683354477931,PHYS 2D,A01,187123,Shotwell; Brian,95,0,115,20
1683354478960,PHYS 4B,A01,187133,Grinstein; Benjamin,35,0,50,15
1683354479987,POLI 10,A00,188819,Staff,0,4,50,50
1683354481014,POLI 11,A00,188827,Staff,43,0,50,7
1683354482045,POLI 13R,A00,188828,Staff,0,1,20,20
1683354483069,POLI 27,A01,188830,Elgin; Samuel Zincke,0,1,70,70
1683354484097,POLI 30,A00,188832,Desposato; Scott,31,0,50,19
1683354485122,POLI 102F,A00,188834,Staff,3,0,40,37
1683354486148,POLI 104A,A00,188852,Staff,14,0,30,16
1683354487174,POLI 104I,A00,188853,Staff,0,6,20,20
1683354488199,POLI 110B,A00,188854,Wiens; David,7,0,20,13
1683354489224,POLI 112A,A00,188855,Wiens; David,5,0,30,25
1683354490248,POLI 117R,A00,188856,Forman; Fonna,0,11,20,20
1683354491272,POLI 118,A00,188857,Ingham; Sean,8,0,20,12
1683354492301,POLI 120G,A00,188858,Staff,9,0,30,21
1683354493325,POLI 131CR,A00,188863,Hoston; Germaine,23,0,50,27
1683354494353,POLI 133,A00,188864,Nellis; Gareth Hb,44,0,50,6
1683354495381,POLI 134D,A00,188865,Desposato; Scott,27,0,30,3
1683354496417,POLI 142A,A00,188871,Gartzke; Erik,22,0,50,28
1683354497442,POLI 142K,A00,188874,Staff,38,0,50,12
1683354498467,POLI 143,A00,188940,Gartzke; Erik,16,0,30,14
1683354499494,POLI 153,A00,188943,Staff,3,0,20,17
1683354500520,POLI 160AA,A00,188944,Staff,11,0,40,29
1683354501546,POLI 170A,A00,188945,Staff,11,0,30,19
1683354503599,PSYC 1,A00,188952,Staff,37,0,90,53
1683354504626,PSYC 2,B00,188953,Staff,19,0,35,16
1683354505650,PSYC 6,A00,188970,Staff,47,0,60,13
1683354506677,PSYC 7,A00,188973,Staff,37,0,45,8
1683354507700,PSYC 60,A01,188980,Rickard; Timothy C.,43,0,60,17
1683354508725,PSYC 70,A01,189001,Steiner; Eric Tomas,23,0,45,22
1683354509754,PSYC 100,A00,189005,Lacefield; Katharine I,0,98,120,120
1683354510780,PSYC 102,A00,189008,Staff,9,0,30,21
1683354511805,PSYC 106,B00,189026,Gorman; Michael R.,34,0,60,26
1683354512829,PSYC 114,B01,189033,Winkielman; Piotr,0,32,30,30
1683354513854,PSYC 131,A00,189036,Anagnostaras; Stephan,0,43,60,60
1683354514884,PSYC 136,A00,189041,Lowe; Angela Beth,0,7,25,25
1683354515909,PSYC 137,A00,189057,Winkielman; Piotr,0,34,25,25
1683354516937,PSYC 144,A00,189107,Wixted; John T,0,7,50,50
1683354518993,PSYC 162,A00,189142,Staff,0,8,85,85
1683354520019,PSYC 172,A00,189144,Gorman; Michael R.,0,7,30,30
1683354522071,PSYC 179,A00,189146,Lacefield; Katharine I,0,84,120,120
1683354523101,PSYC 181,A00,189147,Anagnostaras; Stephan,0,44,90,90
1683354524201,PSYC 190R,A00,189148,Barner; David A.,0,22,80,80
1683354525229,PSYC 191,A00,189275,Rickard; Timothy C.,0,7,25,25
1683354526257,PSYC 193,A00,189276,Chapman; Eddie Nathaniel,0,1,0,4
1683354527285,PSYC 193L,A01,189281,Lowe; Angela Beth,12,0,20,8
1683354527285,PSYC 193L,B01,189285,Staff,28,0,35,7
1683354528314,RELI 149,A00,187137,Rahimi; Babak,7,0,40,33
1683354529342,SE 9,A01,187315,Staff,0,2,18,18
1683354530367,SE 101B,A00,187409,Staff,24,0,30,6
1683354531396,SE 110B,A00,187444,Staff,10,0,40,30
1683354532423,SE 130B,A00,187449,Staff,31,0,40,9
1683354533451,SE 150A,A00,187516,Staff,9,0,20,11
1683354534479,SE 154,A00,187528,Staff,30,0,50,20
1683354535507,SIO 3,A01,258171,Staff,35,0,40,5
1683354536532,SIO 10,A00,187144,Cook; Geoffrey W,0,3,75,75
1683354537558,SIO 45,A00,187152,Cook; Geoffrey W,1,0,100,99
1683354538587,SIO 109R,A00,194486,Staff,0,3,20,20
1683354540637,SIO 187,A01,187233,Kacev; David,12,0,40,28
1683354541669,SOCI 1,A01,258656,Thorpe; Charles Robert,28,0,30,2
1683354541669,SOCI 1,A02,258658,Thorpe; Charles Robert,30,0,30,0
1683354541669,SOCI 1,A03,258661,Thorpe; Charles Robert,25,0,25,0
1683354541669,SOCI 1,A04,258666,Thorpe; Charles Robert,22,0,25,3
1683354541669,SOCI 1,A05,258897,Thorpe; Charles Robert,23,0,25,2
1683354541669,SOCI 1,A06,258898,Thorpe; Charles Robert,25,0,25,0
1683354542693,SOCI 30,A01,258903,Pardo Guerra; Juan Pablo,15,0,30,15
1683354543718,SOCI 102,A00,258904,Staff,9,0,25,16
1683354544744,SOCI 106,A00,258905,Staff,19,0,25,6
1683354545770,SOCI 111,A00,258907,Ribas Norris; Janet Vanesa,26,0,30,4
1683354546799,SOCI 121R,A00,258908,Pardo Guerra; Juan Pablo,10,0,30,20
1683354547827,SOCI 126,A01,203330,Staff,14,0,20,6
1683354548852,SOCI 131,A00,258909,Thorpe; Charles Robert,31,0,60,29
1683354549881,SOCI 135,A00,258910,Payne; Christine Anna,0,9,30,30
1683354550907,SOCI 157,A00,258911,Staff,12,0,30,18
1683354551934,SOCI 184,A00,258912,Staff,25,0,30,5
1683354552957,SOCI 188D,A00,258913,Staff,22,0,30,8
1683354553980,SYN 2,001,187529,Staff,10,0,16,6
1683354553980,SYN 2,002,201452,Staff,0,18,16,16
1683354553980,SYN 2,003,201469,Staff,3,0,16,13
1683354555005,SYN 100,A01,187531,Staff,0,9,20,20
1683354555005,SYN 100,B01,201491,Staff,0,12,20,20
1683354556030,TDAC 1,A00,189286,Walsh; Kim C.,3,0,20,17
1683354556030,TDAC 1,B00,189287,Harting; Carla Kelso,11,0,20,9
1683354557055,TDAC 101,A00,189300,Walsh; Kim C.,16,0,20,4
1683354557055,TDAC 101,B00,189301,Harting; Carla Kelso,18,0,20,2
1683354558080,TDAC 102,A00,189304,Basso; Beatrice,14,0,20,6
1683354559103,TDAC 108,A00,189305,Staff,18,0,20,2
1683354560129,TDDE 131,A00,189310,Staff,19,0,20,1
1683354560129,TDDE 131,B00,189314,Staff,19,0,20,1
1683354560129,TDDE 131,C00,189315,Staff,48,0,50,2
1683354560129,TDDE 131,D00,189316,Staff,14,0,15,1
1683354560129,TDDE 131,E00,204841,Staff,20,0,20,0
1683354561154,TDGE 10,A00,189289,Staff,30,0,50,20
1683354561154,TDGE 10,B00,189290,Havis; Allan,1,0,50,49
1683354562189,TDGE 11,A00,189291,Fulton; Julia,0,3,50,50
1683354562189,TDGE 11,B00,189292,Staff,20,0,25,5
1683354562189,TDGE 11,C00,260270,Staff,0,0,0,0
1683354563214,TDGE 25,A00,189294,Staff,3,0,20,17
1683354564240,TDGE 124,A00,189318,Fulton; Julia,0,8,50,50
1683354565268,TDGE 125,A00,189319,Staff,13,0,25,12
1683354565268,TDGE 125,B00,189320,Staff,23,0,25,2
1683354566295,TDGE 127,A00,189322,Havis; Allan,0,0,50,50
1683354567323,TDHT 101,A00,189323,Staff,18,0,25,7
1683354567323,TDHT 101,B00,189324,Staff,25,0,25,0
1683354568349,TDHT 102,A00,189325,Staff,49,0,50,1
1683354569376,TDMV 1,A00,189295,Arcidiacono; Kristin,19,0,30,11
1683354569376,TDMV 1,B00,189296,Caligagan; Maria T.,24,0,30,6
1683354570399,TDMV 2,A00,189297,Sammartano; Tonnie,28,0,30,2
1683354570399,TDMV 2,B00,189299,Arcidiacono; Kristin,24,0,30,6
1683354571422,TDMV 3,A00,204998,Rincon; Alicia,22,0,30,8
1683354572446,TDMV 120,A00,189458,Sammartano; Tonnie,28,0,30,2
1683354573470,TDMV 138,A00,189541,Jun; Grace Shin Hae,22,0,40,18
1683354574497,TDMV 142,A00,189717,Caligagan; Tony,23,0,30,7
1683354574497,TDMV 142,B00,189718,Caligagan; Maria T.,25,0,30,5
1683354575520,TMC 2,A01,187533,Staff,25,0,25,0
1683354575520,TMC 2,A02,187534,Staff,25,0,25,0
1683354576549,USP 1,A01,187536,Kwak; Nancy,0,16,25,25
1683354577573,USP 5,A01,187538,Staff,10,0,25,15
1683354578598,USP 101,A00,199253,Staff,0,4,0,0
1683354579623,USP 124,A00,187562,Boomhower; Matthew Charles,1,0,30,29
1683354580647,USP 138,A00,187582,Staff,20,0,25,5
1683354581674,USP 152,A01,187597,Staff,4,0,25,21
1683354582702,USP 153,A00,187598,Staff,19,0,25,6
1683354583725,USP 168,A00,187607,Kwak; Nancy,2,0,5,3
1683354584747,USP 173,A00,187619,Staff,4,0,25,21
1683354585771,USP 181,A00,187638,Staff,0,3,25,25
1683354586797,VIS 103,A00,187650,Cruz; Edwin Teddy,22,0,75,53
1683354587822,VIS 110D,A00,187669,Staff,12,0,22,10
1683354588847,VIS 127C,A00,187720,Shen; Kuiyi,67,0,146,79
1683354589872,VIS 149,A00,187731,Yoldas; Pinar,0,14,22,22
1683354590901,VIS 151,A01,188091,Staff,22,0,34,12
1683354590901,VIS 151,A02,188092,Staff,11,0,34,23
1683354591925,VIS 160B,A00,188093,Stalbaum; Brett,0,0,10,10
1683354593978,WCWP 10B,A00,201720,Staff,10,0,15,5
1683354593978,WCWP 10B,B00,201722,Staff,9,0,15,6
1683354595003,WCWP 100,A00,201725,Gagnon; Jeffrey C,0,0,2,2
1683354595003,WCWP 100,B00,201727,Staff,0,4,15,15
1683354598090,ANBI 133,A00,258401,Wilder; Linnea Lorene,34,0,40,6
1683354599114,ANBI 140,A00,258395,Hrvoj Mihic; Branka,18,0,25,7
1683354600140,ANSC 120,A00,258402,Bialecki; Jon Anthony,27,0,40,13
1683354601166,ANSC 144,A00,258400,Staff,14,0,40,26
1683354603231,ANSC 166,A00,258396,Parish; Steven Martin,157,0,175,18
1683354604261,ANSC 180,A00,193533,Staff,9,0,20,11
1683354605289,ANSC 188,A00,258397,Jassal; Aftab,33,0,40,7
1683354606313,ANTH 3,A01,258316,Staff,23,0,30,7
1683354607337,ANTH 5,A00,258394,Semendeferi; Ekaterini,16,0,20,4
1683354608368,ANTH 21,A01,258331,Staff,8,0,40,32
1683354609394,ANTH 103,A00,258398,Varma; Saiba,15,0,25,10
1683354610421,AWP 10,001,202034,Staff,0,0,0,0
1683354610421,AWP 10,002,202035,Staff,0,0,0,0
1683354610421,AWP 10,003,202036,Staff,0,0,0,0
1683354610421,AWP 10,004,202037,Staff,0,0,0,0
1683354610421,AWP 10,005,202038,Staff,0,0,0,0
1683354610421,AWP 10,006,202039,Staff,0,0,0,0
1683354610421,AWP 10,007,202040,Staff,0,0,0,0
1683354610421,AWP 10,008,202041,Staff,0,0,0,0
1683354610421,AWP 10,009,202042,Staff,0,0,0,0
1683354610421,AWP 10,010,202043,Staff,0,0,0,0
1683354610421,AWP 10,011,202044,Staff,0,0,0,0
1683354610421,AWP 10,012,202045,Staff,0,0,0,0
1683354610421,AWP 10,013,202046,Staff,0,0,0,0
1683354610421,AWP 10,014,202047,Staff,0,0,0,0
1683354610421,AWP 10,015,202048,Staff,0,0,0,0
1683354610421,AWP 10,016,202049,Staff,0,0,0,0
1683354610421,AWP 10,017,202050,Staff,0,0,0,0
1683354610421,AWP 10,018,202051,Staff,0,0,0,0
1683354610421,AWP 10,019,202052,Staff,0,0,0,0
1683354610421,AWP 10,020,202053,Staff,0,0,0,0
1683354610421,AWP 10,021,202054,Staff,0,0,0,0
1683354610421,AWP 10,022,202055,Staff,0,0,0,0
1683354610421,AWP 10,023,202056,Staff,0,0,0,0
1683354610421,AWP 10,024,202057,Staff,0,0,0,0
1683354610421,AWP 10,025,202058,Staff,0,0,0,0
1683354610421,AWP 10,026,202059,Staff,0,0,0,0
1683354611444,AWP 102,001,202032,Staff,0,0,0,0
1683354611444,AWP 102,002,202033,Staff,0,0,0,0
1683354612471,BENG 100,A01,254234,Taylor Amos; Alyssa C,31,0,40,9
1683354613497,BENG 196,001,270013,Engler; Adam J.,9999,0,9999,0
1683354614522,BICD 100R,A01,202018,Smith; Laurie,0,7,32,32
1683354614522,BICD 100R,A02,202019,Smith; Laurie,0,2,32,32
1683354614522,BICD 100R,A03,202020,Smith; Laurie,0,1,32,32
1683354614522,BICD 100R,A04,202021,Smith; Laurie,9,0,32,23
1683354614522,BICD 100R,A05,202022,Smith; Laurie,12,0,32,20
1683354615548,BICD 136,A01,193242,Gustafson-Brown; Cindy,0,2,32,32
1683354615548,BICD 136,A02,193244,Gustafson-Brown; Cindy,14,0,32,18
1683354616573,BIEB 102,A01,193249,Butler; Shannon Rhey,0,2,32,32
1683354616573,BIEB 102,A02,193251,Butler; Shannon Rhey,0,0,32,32
1683354616573,BIEB 102,A03,193253,Butler; Shannon Rhey,0,1,32,32
1683354616573,BIEB 102,A04,193255,Butler; Shannon Rhey,17,0,32,15
1683354616573,BIEB 102,A05,193265,Butler; Shannon Rhey,26,0,32,6
1683354616573,BIEB 102,A06,193269,Butler; Shannon Rhey,16,0,32,16
1683354618622,BIEB 150,A01,193274,Staff,0,0,32,32
1683354618622,BIEB 150,A02,193285,Staff,23,0,32,9
1683354619646,BIEB 194,A00,193286,Kurle; Carolyn M.,22,0,32,10
1683354620675,BILD 1,A01,192291,Staff,16,0,32,16
1683354620675,BILD 1,A02,192292,Staff,30,0,32,2
1683354620675,BILD 1,B01,192520,Reuther; Keefe,0,1,0,0
1683354620675,BILD 1,B02,192532,Reuther; Keefe,0,1,0,0
1683354621702,BILD 3,A01,192556,Butler; Shannon Rhey,0,0,32,32
1683354621702,BILD 3,A02,192581,Butler; Shannon Rhey,4,0,32,28
1683354621702,BILD 3,A03,192611,Butler; Shannon Rhey,23,0,32,9
1683354621702,BILD 3,A04,192612,Butler; Shannon Rhey,25,0,32,7
1683354621702,BILD 3,A05,192613,Butler; Shannon Rhey,27,0,32,5
1683354621702,BILD 3,A06,192679,Butler; Shannon Rhey,27,0,32,5
1683354621702,BILD 3,A07,192682,Butler; Shannon Rhey,22,0,32,10
1683354622730,BILD 4,A01,192836,Reuther; Keefe,0,0,24,24
1683354622730,BILD 4,A02,193044,Reuther; Keefe,4,0,24,20
1683354623755,BILD 10,A01,193142,Gustafson-Brown; Cindy,30,0,32,2
1683354623755,BILD 10,A02,193149,Gustafson-Brown; Cindy,31,0,32,1
1683354624780,BIMM 100,A01,193301,Staff,0,6,32,32
1683354624780,BIMM 100,A02,193312,Staff,0,5,32,32
1683354624780,BIMM 100,A03,193323,Staff,0,8,32,32
1683354625806,BIMM 101,A01,193329,McDonnell; Lisa Marie,0,3,24,24
1683354625806,BIMM 101,A02,193339,McDonnell; Lisa Marie,0,3,24,24
1683354625806,BIMM 101,B01,193354,McDonnell; Lisa Marie,0,3,24,24
1683354625806,BIMM 101,B02,193357,McDonnell; Lisa Marie,0,3,24,24
1683354626830,BIMM 110,A01,193377,Tat; John,0,11,32,32
1683354626830,BIMM 110,A02,193378,Tat; John,0,9,32,32
1683354627911,BIMM 120,A01,206116,Staff,0,0,32,32
1683354627911,BIMM 120,A02,206117,Staff,8,0,32,24
1683354627911,BIMM 120,A03,206121,Staff,21,0,32,11
1683354628935,BIPN 100,A01,193393,Park; Ji Young,0,14,32,32
1683354628935,BIPN 100,A02,193402,Park; Ji Young,0,13,32,32
1683354628935,BIPN 100,A03,193413,Park; Ji Young,0,14,32,32
1683354628935,BIPN 100,A04,193414,Park; Ji Young,0,13,32,32
1683354629960,BIPN 102,A01,193429,Staff,0,0,32,32
1683354629960,BIPN 102,A02,193438,Staff,22,0,32,10
1683354630984,BIPN 106,A01,193450,Reyes Gonzalez; Catalina,0,2,40,40
1683354632008,BIPN 134,A01,193465,Cooke; James Edward,1,0,32,31
1683354632008,BIPN 134,A02,193474,Cooke; James Edward,25,0,32,7
1683354632008,BIPN 134,A03,193485,Cooke; James Edward,29,0,32,3
1683354632008,BIPN 134,A04,193486,Cooke; James Edward,21,0,32,11
1683354632008,BIPN 134,A05,193491,Cooke; James Edward,31,0,32,1
1683354632008,BIPN 134,A06,193501,Cooke; James Edward,30,0,32,2
1683354632008,BIPN 134,A07,193510,Cooke; James Edward,29,0,32,3
1683354634061,BISP 194,A00,222522,Staff,14,0,32,18
1683354635088,CAT 124,A01,202407,Staff,20,0,25,5
1683354636116,CAT 125,A00,202408,Marchisotto; Jennifer Anne,4,0,20,16
1683354637146,CAT 125R,A00,202409,Smith; Lauryn Alissa,0,11,20,20
1683354637146,CAT 125R,B00,202410,Morales; Celeste Georgianna,0,11,20,20
1683354637146,CAT 125R,C00,202411,Irwin; Matthew Joseph,0,10,20,20
1683354638173,CENG 15,A01,204712,Yang; Kesong,0,1,0,0
1683354639198,CENG 114,A00,202070,Jahed Motlagh; Zeinab,5,0,20,15
1683354640222,CGS 105,A00,185477,Wesling; Megan E.,24,0,40,16
1683354641247,CGS 106,A00,185494,Staff,13,0,22,9
1683354642271,CGS 108,A00,185495,Staff,14,0,20,6
1683354643298,CGS 114,A00,185496,Staff,13,0,18,5
1683354644319,CGS 119,A00,185501,Staff,15,0,20,5
1683354645345,CGS 120,A00,185511,Staff,13,0,20,7
1683354646369,CHEM 4,A01,184675,Bussey; Thomas J,96,0,100,4
1683354647394,CHEM 6A,A01,184677,Staff,34,0,60,26
1683354648419,CHEM 6B,A01,184679,Staff,65,0,100,35
1683354649442,CHEM 6C,A01,184681,Bussey; Thomas J,1,0,50,49
1683354649442,CHEM 6C,A02,184682,Bussey; Thomas J,34,0,50,16
1683354650470,CHEM 40A,A01,184684,Albizati; Kim F.,37,0,100,63
1683354651498,CHEM 40B,A01,184686,Albizati; Kim F.,0,20,100,100
1683354652521,CHEM 41B,A01,184690,Staff,52,0,100,48
1683354653545,COGS 3,A01,184715,Boyle; Mary E. T.,0,25,40,40
1683354654570,COGS 14B,A01,185172,Staff,0,15,38,38
1683354655597,COGS 18,A01,184736,Staff,17,0,80,63
1683354656621,COGS 100,A01,184932,Staff,0,5,73,73
1683354657647,COGS 101A,A01,184935,Staff,0,39,30,30
1683354658672,COGS 101B,A01,184944,Staff,0,2,30,30
1683354659695,COGS 101C,A01,184946,Staff,0,12,30,30
1683354660723,COGS 102A,A01,184951,Johnson; Christine M.,2,0,40,38
1683354661752,COGS 107B,A01,184953,Mooshagian; Eric Frederick,0,50,40,40
1683354662783,COGS 118B,A01,184959,Gupta; Anjum,0,48,40,40
1683354663809,COGS 153,A00,184961,Staff,0,15,30,30
1683354664836,COGS 177,A00,184962,Staff,0,20,30,30
1683354665863,COGS 187A,A01,184969,Boyle; Mary E. T.,0,17,40,40
1683354666888,COMM 10,A01,185174,Staff,0,5,25,25
1683354666888,COMM 10,A02,185189,Staff,0,5,25,25
1683354666888,COMM 10,A03,269821,Staff,0,0,0,0
1683354667915,COMM 100B,A01,185475,Staff,0,0,0,2
1683354667915,COMM 100B,A02,185476,Staff,13,0,25,12
1683354668940,COMM 100C,A01,185314,Staff,1,0,25,24
1683354668940,COMM 100C,A02,185327,Staff,19,0,25,6
1683354669966,COMM 110M,A00,185349,Staff,2,0,40,38
1683354670991,COMM 113T,A00,185352,Staff,24,0,40,16
1683354672020,COMM 114I,A00,185353,Staff,33,0,40,7
1683354673044,COMM 131,A00,185354,Staff,19,0,30,11
1683354674074,CSE 8A,A50,185358,Cao; Yingjun,0,46,10,10
1683354675102,CSE 8B,A01,185362,Staff,0,46,50,50
1683354676126,CSE 11,A01,185416,Cao; Yingjun,0,92,10,10
1683354677150,CSE 20,A01,185445,Briones; Jor-el Thomas Caparas,5,0,25,20
1683354678177,CSE 21,A01,185447,Staff,10,0,50,40
1683354679202,CSE 101,A01,185451,Staff,0,13,50,50
1683354679202,CSE 101,B01,185453,Jones; Miles E,0,11,50,50
1683354681250,CSE 141,A01,185458,Eldon; John,20,0,100,80
1683354682277,CSE 141L,A01,185461,Eldon; John,12,0,100,88
1683354683303,CSE 142,A01,185463,Staff,36,0,60,24
1683354683303,CSE 142,B01,201355,Staff,0,7,60,60
1683354684331,CSE 142L,A01,185470,Staff,36,0,60,24
1683354684331,CSE 142L,B01,201417,Staff,0,6,60,60
1683354685362,CSE 190,A00,201433,Staff,32,0,49,17
1683354686391,DOC 1,A01,259136,Strom; Megan C.,7,0,15,8
1683354686391,DOC 1,A02,259137,Strom; Megan C.,14,0,15,1
1683354686391,DOC 1,A03,259138,Strom; Megan C.,14,0,15,1
1683354686391,DOC 1,A04,259139,Strom; Megan C.,14,0,15,1
1683354687415,DOC 100D,A00,259140,Pass; Natalye Joann,16,0,25,9
1683354688439,DSGN 1,A01,184749,Rill; Bryan,0,25,30,30
1683354689466,DSGN 100,A01,185168,Staff,0,2,25,25
1683354690493,ECE 5,A01,185626,Morris; Karcher William,0,10,0,0
1683354691518,ECE 101,A01,185628,Staff,17,0,70,53
1683354692543,ECE 107,A01,185635,Baghdadchi; Saharnaz,0,0,20,20
1683354692543,ECE 107,A02,185638,Baghdadchi; Saharnaz,4,0,20,16
1683354693571,ECE 148,A01,185647,Silberman; Jack,0,0,16,16
1683354694596,ECON 1,A01,185537,Crane; Meredith Helen,54,0,70,16
1683354695625,ECON 3,A01,185549,Crane; Meredith Helen,32,0,70,38
1683354696653,ECON 4,A01,203354,Anderson; John Charles,0,4,10,10
1683354697677,ECON 100A,A01,185574,Staff,0,4,40,40
1683354698700,ECON 100B,A01,185576,Staff,0,12,50,50
1683354699727,ECON 100C,A01,185589,Newhouse; Herbert S,29,0,70,41
1683354700754,ECON 105,A00,185608,Vespa; Emanuel Ignacio,19,0,35,16
1683354701782,ECON 109,A01,185610,Shishkin; Denis,10,0,35,25
1683354702807,ECON 110A,A01,185612,Staff,11,0,40,29
1683354703831,ECON 120A,A01,185615,Staff,20,0,40,20
1683354704855,ECON 120C,A01,185617,Sun; Yixiao,0,21,70,70
1683354705878,ECON 144,A00,203346,Squires; Dale E,3,0,35,32
1683354706907,ECON 171,A01,203349,Newhouse; Herbert S,0,1,35,35
1683354707936,ECON 173A,A01,185621,Toda; Alexis Akira,21,0,35,14
1683354708962,EDS 25,A01,202413,Staff,0,1,0,0
1683354708962,EDS 25,A02,202414,Staff,0,1,0,0
1683354708962,EDS 25,A03,202415,Staff,0,0,0,0
1683354708962,EDS 25,A04,202416,Staff,0,1,0,0
1683354708962,EDS 25,A05,202439,Staff,0,0,0,0
1683354708962,EDS 25,A06,202440,Staff,0,0,0,0
1683354708962,EDS 25,B01,202631,Staff,0,0,0,0
1683354708962,EDS 25,B02,202632,Staff,0,0,0,0
1683354708962,EDS 25,B03,202639,Staff,0,0,0,0
1683354708962,EDS 25,B04,202640,Staff,0,0,0,0
1683354708962,EDS 25,B05,202643,Staff,0,0,0,0
1683354708962,EDS 25,B06,202644,Staff,0,0,0,0
1683354709988,EDS 38,A01,202659,Black; Alison Michelle,24,0,25,1
1683354711013,EDS 115,A00,202652,Staff,18,0,30,12
1683354712040,EDS 125,A00,202649,Staff,14,0,30,16
1683354713065,EDS 126,A01,203332,Staff,30,0,30,0
1683354714089,EDS 139,A00,202838,Staff,16,0,25,9
1683354715114,EDS 146,A01,202655,Staff,14,0,25,11
1683354716140,ENG 15,A00,185667,Staff,0,1,0,0
1683354716140,ENG 15,B00,185672,Staff,0,0,0,0
1683354716140,ENG 15,C00,185675,Staff,0,0,0,0
1683354716140,ENG 15,D00,185682,Staff,0,0,0,0
1683354716140,ENG 15,E00,185684,Staff,0,0,0,0
1683354717163,ETHN 103,A00,185710,Staff,0,4,35,35
1683354718192,ETHN 103A,A00,199228,Man; Simeon S,2,0,9,7
1683354719217,ETHN 109,A00,185711,Staff,18,0,35,17
1683354720241,ETHN 142,A00,185726,Staff,0,4,30,30
1683354721262,ETHN 163J,A00,199229,Man; Simeon S,5,0,8,3
1683354722320,ETHN 168,A00,185727,Staff,8,0,10,2
1683354723345,ETHN 182,A00,185728,Staff,0,0,35,35
1683354724368,ETHN 183,A00,185737,Staff,8,0,18,10
1683354725395,GLBH 111,A01,209361,Burgos; Jose L.,0,0,0,0
1683354727446,HIEU 104,A00,185792,Staff,16,0,20,4
1683354728470,HIEU 115,A00,185800,Staff,1,0,20,19
1683354729496,HIEU 128,A00,185801,Staff,0,7,20,20
1683354730521,HIEU 147,A00,185802,Staff,16,0,20,4
1683354731600,HIEU 154,A00,185823,Staff,12,0,20,8
1683354732625,HILA 102,A00,185826,Staff,13,0,20,7
1683354733650,HILD 2C,A01,185778,Staff,0,12,20,20
1683354734681,HILD 7B,A01,185780,Kwak; Nancy,0,15,32,32
1683354734681,HILD 7B,A02,185781,Kwak; Nancy,0,18,32,32
1683354735706,HILD 30,A01,185791,Staff,14,0,20,6
1683354736731,HISC 119,A00,185830,Golan; Tal,0,9,20,20
1683354737757,HITO 156GS,A00,185831,Patterson; Patrick H.,0,0,0,23
1683354738784,HIUS 103,A00,185832,Man; Simeon S,0,6,20,20
1683354739812,HIUS 117,A00,185836,Kwak; Nancy,2,0,20,18
1683354740837,HIUS 125,A00,185840,Man; Simeon S,0,0,23,23
1683354741861,HIUS 149,A00,185845,Staff,0,0,20,20
1683354742886,HUM 3,A01,185882,Zavodny; Tatiana Sophia,0,7,50,50
1683354742886,HUM 3,B01,185899,Caldwell; Michael Alan,0,18,50,50
1683354743911,HUM 3GS,A00,185900,Patterson; Patrick H.,0,0,0,23
1683354744936,HUM 4,A01,185938,Zroka; Amy Liane,31,0,50,19
1683354744936,HUM 4,B01,185956,Watkins; Eric,0,3,50,50
1683354744936,HUM 4,B02,202209,Watkins; Eric,0,2,50,50
1683354744936,HUM 4,B03,202210,Watkins; Eric,0,2,50,50
1683354745962,HUM 5,A01,185958,West; Geoffrey Scott,3,0,50,47
1683354745962,HUM 5,A02,202215,West; Geoffrey Scott,0,0,50,50
1683354746986,INTL 190,A00,185959,Gagnon; Jeffrey C,0,0,0,9
1683354746986,INTL 190,B00,185960,Lettieri; Michael Joseph,0,0,0,1
1683354748011,JAPN 180,A00,254509,Staff,4,0,30,26
1683354749036,LATI 10,A01,202853,Kennemore; Amy Michelle,4,0,35,31
1683354749036,LATI 10,A02,202854,Kennemore; Amy Michelle,2,0,35,33
1683354749036,LATI 10,A03,270054,Kennemore; Amy Michelle,30,0,30,0
1683354750059,LATI 180,A00,202855,Kennemore; Amy Michelle,11,0,20,9
1683354751087,LAWS 101,A00,201767,Golan; Tal,0,7,40,40
1683354752112,LIFR 1C,A00,185961,Staff,6,0,20,14
1683354753137,LIFR 1CX,A00,185962,Staff,7,0,20,13
1683354754162,LIFR 1D,A00,185963,Staff,9,0,20,11
1683354755187,LIFR 1DX,A00,185964,Staff,9,0,20,11
1683354756213,LIGN 101,A01,186039,Staff,43,0,50,7
1683354757239,LIGN 165,A00,186040,Staff,18,0,50,32
1683354758266,LTCS 108,A00,186041,Staff,6,0,10,4
1683354759291,LTCS 119,A00,186042,Staff,16,0,20,4
1683354760317,LTCS 130,A00,186043,Wesling; Megan E.,15,0,25,10
1683354762367,LTEA 138,A00,186119,Staff,14,0,40,26
1683354763390,LTEN 124,A00,186148,Staff,6,0,25,19
1683354764414,LTEN 178,A00,186149,Staff,7,0,15,8
1683354765439,LTEN 181,A00,186150,Blanco; John D,33,0,40,7
1683354766464,LTWL 120,A00,186160,Staff,20,0,25,5
1683354767488,LTWL 165,A00,186161,Staff,22,0,25,3
1683354768513,LTWR 100,A00,186162,Staff,0,5,15,15
1683354769539,LTWR 102,A00,186163,Doller; Ben,5,0,15,10
1683354770563,MAE 8,A01,186412,Staff,0,0,0,0
1683354771587,MAE 30B,A00,186445,Bahadori; Mohammad Yousef,83,0,100,17
1683354772612,MAE 40,A00,186592,Bewley; Thomas R,10,0,50,40
1683354773634,MAE 101B,A00,186593,Bahadori; Mohammad Yousef,81,0,100,19
1683354774662,MAE 105,A00,186594,Bandaru; Prabhakar,12,0,50,38
1683354775690,MAE 107,A00,186599,Pham; Hieu Tan,0,7,120,120
1683354776719,MAE 148,A01,186660,Silberman; Jack,3,0,16,13
1683354777747,MATH 10A,A01,188095,Staff,0,5,35,35
1683354778778,MATH 10B,A01,188097,Bowers; Adam R.,0,11,30,30
1683354778778,MATH 10B,A02,188099,Bowers; Adam R.,0,11,30,30
1683354778778,MATH 10B,B01,188104,Bowers; Adam R.,0,10,30,30
1683354778778,MATH 10B,B02,188106,Bowers; Adam R.,0,10,30,30
1683354779805,MATH 10C,A01,188111,Staff,0,18,30,30
1683354779805,MATH 10C,A02,188127,Staff,0,17,30,30
1683354779805,MATH 10C,A03,188131,Staff,0,18,30,30
1683354779805,MATH 10C,B01,188218,Staff,18,0,30,12
1683354779805,MATH 10C,B02,188244,Staff,13,0,30,17
1683354779805,MATH 10C,B03,188277,Staff,16,0,30,14
1683354780834,MATH 18,A01,188344,Bach; Quang Tran,18,0,30,12
1683354780834,MATH 18,A02,188345,Bach; Quang Tran,11,0,30,19
1683354780834,MATH 18,B01,188353,Bach; Quang Tran,10,0,30,20
1683354780834,MATH 18,B02,188354,Bach; Quang Tran,20,0,30,10
1683354781861,MATH 20A,A01,188374,Staff,12,0,35,23
1683354782893,MATH 20B,A01,188382,Ohm; Ko Woon,6,0,30,24
1683354782893,MATH 20B,A02,188383,Ohm; Ko Woon,22,0,30,8
1683354782893,MATH 20B,B01,188385,Ohm; Ko Woon,7,0,30,23
1683354782893,MATH 20B,B02,188392,Ohm; Ko Woon,22,0,30,8
1683354783923,MATH 20C,A01,188394,Harel; Guershon,10,0,30,20
1683354783923,MATH 20C,A02,188395,Harel; Guershon,15,0,30,15
1683354783923,MATH 20C,B01,188404,Harel; Guershon,4,0,30,26
1683354783923,MATH 20C,B02,188405,Harel; Guershon,19,0,30,11
1683354784953,MATH 20D,A01,188414,Hammock; Frances H,0,1,30,30
1683354784953,MATH 20D,A02,188415,Hammock; Frances H,3,0,30,27
1683354784953,MATH 20D,B01,188447,Hammock; Frances H,1,0,30,29
1683354784953,MATH 20D,B02,188486,Hammock; Frances H,8,0,30,22
1683354785980,MATH 20E,A01,188649,Staff,21,0,30,9
1683354785980,MATH 20E,A02,188650,Staff,23,0,30,7
1683354785980,MATH 20E,A03,188673,Staff,0,0,30,30
1683354787009,MATH 102,A01,188675,Staff,0,35,35,35
1683354788037,MATH 103B,A01,188681,Staff,3,0,35,32
1683354788037,MATH 103B,B01,188692,Staff,5,0,35,30
1683354789062,MATH 109,A01,188695,Salehi Golsefidy; Alireza,25,0,35,10
1683354789062,MATH 109,A02,188696,Salehi Golsefidy; Alireza,25,0,35,10
1683354790089,MATH 120A,A01,188698,Eggers; John Dietrich,7,0,35,28
1683354791114,MATH 142B,A01,188736,Ioana; Adrian,0,2,30,30
1683354791114,MATH 142B,A02,188741,Ioana; Adrian,0,0,30,30
1683354791114,MATH 142B,A03,188743,Ioana; Adrian,0,1,30,30
1683354792138,MATH 168A,A01,188790,Staff,0,9,35,35
1683354793166,MATH 170A,A01,188803,Nie; Jiawang,0,2,35,35
1683354793166,MATH 170A,A02,188811,Nie; Jiawang,0,0,35,35
1683354793166,MATH 170A,A03,188814,Nie; Jiawang,1,0,35,34
1683354793166,MATH 170A,A04,188815,Nie; Jiawang,13,0,35,22
1683354794191,MATH 193B,A01,188817,Staff,0,0,35,35
1683354794191,MATH 193B,A02,188818,Staff,5,0,35,30
1683354795217,MGT 4,A01,202857,Anderson; John Charles,61,0,80,19
1683354796244,MGT 12,A00,202858,Lindenberger; Wade Douglas,42,0,90,48
1683354797269,MGT 18,A00,202859,Staff,74,0,90,16
1683354798292,MGT 18GS,A00,202860,McKay; Michael J,13,0,28,15
1683354799319,MGT 45,A00,202861,Pecore; Joseph P.,14,0,90,76
1683354800348,MGT 100,A00,202863,Yavorsky; Daniel Ryan,28,0,90,62
1683354801372,MGT 103,A00,202864,Ehrich; Kristine R,0,17,90,90
1683354802397,MGT 112,A00,202865,Ehrich; Kristine R,15,0,90,75
1683354803422,MGT 121A,A00,202868,Staff,0,20,0,0
1683354804447,MGT 131B,A00,202869,Anderson; John Charles,59,0,90,31
1683354805471,MGT 136,A00,202871,Lindenberger; Wade Douglas,84,0,90,6
1683354806494,MGT 164,A00,202873,Staff,0,68,90,91
1683354807521,MGT 164GS,A00,202874,McKay; Mary A,13,0,28,15
1683354808548,MGT 180,A00,202875,Staff,0,50,90,91
1683354809573,MMW 11R,A01,205019,Herbst; Matthew,3,0,30,27
1683354809573,MMW 11R,A02,205026,Herbst; Matthew,29,0,30,1
1683354810599,MMW 15,A01,193512,Chang; Edmond Yi-Teh,0,9,28,28
1683354810599,MMW 15,A02,193513,Chang; Edmond Yi-Teh,0,5,28,28
1683354810599,MMW 15,A03,193514,Chang; Edmond Yi-Teh,0,5,28,28
1683354810599,MMW 15,A04,193515,Chang; Edmond Yi-Teh,0,5,28,28
1683354810599,MMW 15,A05,193516,Chang; Edmond Yi-Teh,0,4,28,28
1683354810599,MMW 15,A06,193517,Chang; Edmond Yi-Teh,0,5,28,28
1683354810599,MMW 15,B01,193519,Chang; Edmond Yi-Teh,0,5,28,28
1683354810599,MMW 15,B02,193520,Chang; Edmond Yi-Teh,0,5,28,28
1683354810599,MMW 15,B03,193521,Chang; Edmond Yi-Teh,0,5,28,28
1683354810599,MMW 15,B04,193522,Chang; Edmond Yi-Teh,0,4,28,28
1683354810599,MMW 15,B05,193523,Chang; Edmond Yi-Teh,0,5,28,28
1683354810599,MMW 15,B06,193524,Chang; Edmond Yi-Teh,0,4,28,28
1683354811623,MMW 122,A01,193526,Rahimi; Babak,0,15,28,28
1683354811623,MMW 122,A02,193527,Rahimi; Babak,0,14,28,28
1683354811623,MMW 122,A03,193528,Rahimi; Babak,0,0,0,0
1683354811623,MMW 122,A04,193529,Rahimi; Babak,0,0,0,0
1683354812647,MUS 1A,A01,186663,Staff,0,20,35,35
1683354813671,MUS 4,A01,186715,Staff,0,12,35,35
1683354814695,MUS 5R,A01,186796,Dubnov; Shlomo,0,17,35,35
1683354815719,MUS 6,A01,186798,Staff,0,4,25,25
1683354816746,MUS 7,A01,186830,Staff,13,0,35,22
1683354817773,MUS 8,A01,186930,Staff,0,26,35,35
1683354818800,MUS 15,A01,186932,Staff,0,16,35,35
1683354818800,MUS 15,B01,186934,Staff,0,15,35,35
1683354819828,MUS 80,A00,186935,Staff,1,0,20,19
1683354819828,MUS 80,B00,186936,Staff,25,0,25,0
1683354820852,NANO 11,A00,204702,Lipomi; Darren John,0,0,0,0
1683354821880,NANO 15,A01,204709,Yang; Kesong,0,1,0,0
1683354822904,NANO 114,A00,202069,Jahed Motlagh; Zeinab,3,0,10,7
1683354823931,PHIL 1,A00,186955,Grush; Rick Scott,32,0,40,8
1683354824956,PHIL 10,A01,186973,Grush; Rick Scott,28,0,35,7
1683354824956,PHIL 10,A02,186974,Grush; Rick Scott,33,0,35,2
1683354825984,PHIL 13,A01,186976,Staff,7,0,35,28
1683354825984,PHIL 13,A02,186977,Staff,16,0,35,19
1683354827009,PHIL 14,A01,186979,Staff,31,0,35,4
1683354827009,PHIL 14,A02,186986,Staff,32,0,35,3
1683354828038,PHIL 28,A01,186988,Staff,16,0,30,14
1683354828038,PHIL 28,A02,186989,Staff,1,0,30,29
1683354828038,PHIL 28,A03,186990,Staff,9,0,30,21
1683354828038,PHIL 28,A04,186991,Staff,26,0,30,4
1683354829065,PHIL 120,A00,186997,Staff,23,0,40,17
1683354830092,PHIL 137,A00,187003,Staff,9,0,40,31
1683354831118,PHIL 150,A00,187015,Staff,47,0,70,23
1683354832143,PHIL 167,A00,187021,Lamey; Andy M.,35,0,40,5
1683354833167,PHIL 174,A01,202226,Staff,17,0,20,3
1683354833167,PHIL 174,A02,202235,Staff,20,0,20,0
1683354834193,PHIL 191A,A00,258918,Staff,0,0,1,1
1683354835275,PHYS 1A,A00,187028,Staff,27,0,60,33
1683354836306,PHYS 1AL,001,187036,Staff,2,0,30,28
1683354836306,PHYS 1AL,002,187049,Staff,18,0,30,12
1683354837331,PHYS 1B,A00,187058,Staff,22,0,60,38
1683354838354,PHYS 1BL,001,187064,Staff,0,0,30,30
1683354838354,PHYS 1BL,002,187070,Staff,5,0,30,25
1683354839381,PHYS 1C,A00,187082,Staff,31,0,120,89
1683354840408,PHYS 1CL,001,187088,Staff,0,9,30,30
1683354840408,PHYS 1CL,002,187089,Staff,0,2,30,30
1683354840408,PHYS 1CL,009,262693,Staff,11,0,30,19
1683354841434,PHYS 2B,A01,187097,Staff,54,0,115,61
1683354842462,PHYS 2C,A01,187099,Staff,67,0,115,48
1683354843488,PHYS 2CL,A01,187101,Staff,5,0,28,23
1683354843488,PHYS 2CL,A02,187102,Staff,15,0,28,13
1683354844516,PHYS 2D,A01,187123,Shotwell; Brian,95,0,115,20
1683354845545,PHYS 4B,A01,187133,Grinstein; Benjamin,35,0,50,15
1683354846572,POLI 10,A00,188819,Staff,0,4,50,50
1683354847598,POLI 11,A00,188827,Staff,43,0,50,7
1683354848623,POLI 13R,A00,188828,Staff,0,1,20,20
1683354849650,POLI 27,A01,188830,Elgin; Samuel Zincke,0,1,70,70
1683354850678,POLI 30,A00,188832,Desposato; Scott,31,0,50,19
1683354851705,POLI 102F,A00,188834,Staff,3,0,40,37
1683354852727,POLI 104A,A00,188852,Staff,14,0,30,16
1683354853755,POLI 104I,A00,188853,Staff,0,6,20,20
1683354854782,POLI 110B,A00,188854,Wiens; David,7,0,20,13
1683354855806,POLI 112A,A00,188855,Wiens; David,5,0,30,25
1683354856831,POLI 117R,A00,188856,Forman; Fonna,0,11,20,20
1683354857855,POLI 118,A00,188857,Ingham; Sean,8,0,20,12
1683354858881,POLI 120G,A00,188858,Staff,9,0,30,21
1683354859911,POLI 131CR,A00,188863,Hoston; Germaine,23,0,50,27
1683354860935,POLI 133,A00,188864,Nellis; Gareth Hb,44,0,50,6
1683354861959,POLI 134D,A00,188865,Desposato; Scott,27,0,30,3
1683354862986,POLI 142A,A00,188871,Gartzke; Erik,22,0,50,28
1683354864012,POLI 142K,A00,188874,Staff,38,0,50,12
1683354865040,POLI 143,A00,188940,Gartzke; Erik,16,0,30,14
1683354866067,POLI 153,A00,188943,Staff,3,0,20,17
1683354867091,POLI 160AA,A00,188944,Staff,11,0,40,29
1683354868116,POLI 170A,A00,188945,Staff,11,0,30,19
1683354870165,PSYC 1,A00,188952,Staff,37,0,90,53
1683354871189,PSYC 2,B00,188953,Staff,19,0,35,16
1683354872213,PSYC 6,A00,188970,Staff,47,0,60,13
1683354873237,PSYC 7,A00,188973,Staff,37,0,45,8
1683354874261,PSYC 60,A01,188980,Rickard; Timothy C.,43,0,60,17
1683354875286,PSYC 70,A01,189001,Steiner; Eric Tomas,23,0,45,22
1683354876310,PSYC 100,A00,189005,Lacefield; Katharine I,0,98,120,120
1683354877336,PSYC 102,A00,189008,Staff,9,0,30,21
1683354878362,PSYC 106,B00,189026,Gorman; Michael R.,34,0,60,26
1683354879386,PSYC 114,B01,189033,Winkielman; Piotr,0,32,30,30
1683354880409,PSYC 131,A00,189036,Anagnostaras; Stephan,0,43,60,60
1683354881433,PSYC 136,A00,189041,Lowe; Angela Beth,0,7,25,25
1683354882456,PSYC 137,A00,189057,Winkielman; Piotr,0,34,25,25
1683354883481,PSYC 144,A00,189107,Wixted; John T,0,7,50,50
1683354885528,PSYC 162,A00,189142,Staff,0,8,85,85
1683354886550,PSYC 172,A00,189144,Gorman; Michael R.,0,7,30,30
1683354888601,PSYC 179,A00,189146,Lacefield; Katharine I,0,84,120,120
1683354889625,PSYC 181,A00,189147,Anagnostaras; Stephan,0,44,90,90
1683354890648,PSYC 190R,A00,189148,Barner; David A.,0,22,80,80
1683354891671,PSYC 191,A00,189275,Rickard; Timothy C.,0,7,25,25
1683354892702,PSYC 193,A00,189276,Chapman; Eddie Nathaniel,0,1,0,4
1683354893731,PSYC 193L,A01,189281,Lowe; Angela Beth,12,0,20,8
1683354893731,PSYC 193L,B01,189285,Staff,28,0,35,7
1683354894758,RELI 149,A00,187137,Rahimi; Babak,7,0,40,33
1683354895783,SE 9,A01,187315,Staff,0,2,18,18
1683354896807,SE 101B,A00,187409,Staff,24,0,30,6
1683354897831,SE 110B,A00,187444,Staff,10,0,40,30
1683354898857,SE 130B,A00,187449,Staff,31,0,40,9
1683354899881,SE 150A,A00,187516,Staff,9,0,20,11
1683354900905,SE 154,A00,187528,Staff,30,0,50,20
1683354901933,SIO 3,A01,258171,Staff,35,0,40,5
1683354902957,SIO 10,A00,187144,Cook; Geoffrey W,0,3,75,75
1683354903982,SIO 45,A00,187152,Cook; Geoffrey W,1,0,100,99
1683354905006,SIO 109R,A00,194486,Staff,0,3,20,20
1683354907061,SIO 187,A01,187233,Kacev; David,12,0,40,28
1683354908086,SOCI 1,A01,258656,Thorpe; Charles Robert,28,0,30,2
1683354908086,SOCI 1,A02,258658,Thorpe; Charles Robert,30,0,30,0
1683354908086,SOCI 1,A03,258661,Thorpe; Charles Robert,25,0,25,0
1683354908086,SOCI 1,A04,258666,Thorpe; Charles Robert,22,0,25,3
1683354908086,SOCI 1,A05,258897,Thorpe; Charles Robert,23,0,25,2
1683354908086,SOCI 1,A06,258898,Thorpe; Charles Robert,25,0,25,0
1683354909110,SOCI 30,A01,258903,Pardo Guerra; Juan Pablo,15,0,30,15
1683354910133,SOCI 102,A00,258904,Staff,9,0,25,16
1683354911160,SOCI 106,A00,258905,Staff,19,0,25,6
1683354912188,SOCI 111,A00,258907,Ribas Norris; Janet Vanesa,26,0,30,4
1683354913214,SOCI 121R,A00,258908,Pardo Guerra; Juan Pablo,10,0,30,20
1683354914243,SOCI 126,A01,203330,Staff,14,0,20,6
1683354915271,SOCI 131,A00,258909,Thorpe; Charles Robert,31,0,60,29
1683354916298,SOCI 135,A00,258910,Payne; Christine Anna,0,9,30,30
1683354917325,SOCI 157,A00,258911,Staff,12,0,30,18
1683354918349,SOCI 184,A00,258912,Staff,25,0,30,5
1683354919376,SOCI 188D,A00,258913,Staff,22,0,30,8
1683354920401,SYN 2,001,187529,Staff,10,0,16,6
1683354920401,SYN 2,002,201452,Staff,0,18,16,16
1683354920401,SYN 2,003,201469,Staff,3,0,16,13
1683354921426,SYN 100,A01,187531,Staff,0,9,20,20
1683354921426,SYN 100,B01,201491,Staff,0,12,20,20
1683354922455,TDAC 1,A00,189286,Walsh; Kim C.,3,0,20,17
1683354922455,TDAC 1,B00,189287,Harting; Carla Kelso,11,0,20,9
1683354923482,TDAC 101,A00,189300,Walsh; Kim C.,16,0,20,4
1683354923482,TDAC 101,B00,189301,Harting; Carla Kelso,18,0,20,2
1683354924506,TDAC 102,A00,189304,Basso; Beatrice,14,0,20,6
1683354925533,TDAC 108,A00,189305,Staff,18,0,20,2
1683354926560,TDDE 131,A00,189310,Staff,19,0,20,1
1683354926560,TDDE 131,B00,189314,Staff,19,0,20,1
1683354926560,TDDE 131,C00,189315,Staff,48,0,50,2
1683354926560,TDDE 131,D00,189316,Staff,14,0,15,1
1683354926560,TDDE 131,E00,204841,Staff,20,0,20,0
1683354927584,TDGE 10,A00,189289,Staff,30,0,50,20
1683354927584,TDGE 10,B00,189290,Havis; Allan,1,0,50,49
1683354928610,TDGE 11,A00,189291,Fulton; Julia,0,3,50,50
1683354928610,TDGE 11,B00,189292,Staff,20,0,25,5
1683354928610,TDGE 11,C00,260270,Staff,0,0,0,0
1683354929633,TDGE 25,A00,189294,Staff,3,0,20,17
1683354930656,TDGE 124,A00,189318,Fulton; Julia,0,8,50,50
1683354931680,TDGE 125,A00,189319,Staff,13,0,25,12
1683354931680,TDGE 125,B00,189320,Staff,23,0,25,2
1683354932703,TDGE 127,A00,189322,Havis; Allan,0,0,50,50
1683354933728,TDHT 101,A00,189323,Staff,18,0,25,7
1683354933728,TDHT 101,B00,189324,Staff,25,0,25,0
1683354934755,TDHT 102,A00,189325,Staff,49,0,50,1
1683354935782,TDMV 1,A00,189295,Arcidiacono; Kristin,19,0,30,11
1683354935782,TDMV 1,B00,189296,Caligagan; Maria T.,24,0,30,6
1683354936809,TDMV 2,A00,189297,Sammartano; Tonnie,28,0,30,2
1683354936809,TDMV 2,B00,189299,Arcidiacono; Kristin,24,0,30,6
1683354937836,TDMV 3,A00,204998,Rincon; Alicia,22,0,30,8
1683354938916,TDMV 120,A00,189458,Sammartano; Tonnie,28,0,30,2
1683354939946,TDMV 138,A00,189541,Jun; Grace Shin Hae,22,0,40,18
1683354940969,TDMV 142,A00,189717,Caligagan; Tony,23,0,30,7
1683354940969,TDMV 142,B00,189718,Caligagan; Maria T.,25,0,30,5
1683354941994,TMC 2,A01,187533,Staff,25,0,25,0
1683354941994,TMC 2,A02,187534,Staff,25,0,25,0
1683354943018,USP 1,A01,187536,Kwak; Nancy,0,16,25,25
1683354944041,USP 5,A01,187538,Staff,10,0,25,15
1683354945068,USP 101,A00,199253,Staff,0,4,0,0
1683354946095,USP 124,A00,187562,Boomhower; Matthew Charles,1,0,30,29
1683354947118,USP 138,A00,187582,Staff,20,0,25,5
1683354948146,USP 152,A01,187597,Staff,4,0,25,21
1683354949172,USP 153,A00,187598,Staff,19,0,25,6
1683354950201,USP 168,A00,187607,Kwak; Nancy,2,0,5,3
1683354951227,USP 173,A00,187619,Staff,4,0,25,21
1683354952252,USP 181,A00,187638,Staff,0,3,25,25
1683354953279,VIS 103,A00,187650,Cruz; Edwin Teddy,22,0,75,53
1683354954306,VIS 110D,A00,187669,Staff,12,0,22,10
1683354955331,VIS 127C,A00,187720,Shen; Kuiyi,67,0,146,79
1683354956355,VIS 149,A00,187731,Yoldas; Pinar,0,14,22,22
1683354957380,VIS 151,A01,188091,Staff,22,0,34,12
1683354957380,VIS 151,A02,188092,Staff,11,0,34,23
1683354958403,VIS 160B,A00,188093,Stalbaum; Brett,0,0,10,10
1683354960457,WCWP 10B,A00,201720,Staff,10,0,15,5
1683354960457,WCWP 10B,B00,201722,Staff,9,0,15,6
1683354961483,WCWP 100,A00,201725,Gagnon; Jeffrey C,0,0,2,2
1683354961483,WCWP 100,B00,201727,Staff,0,4,15,15
1683354964581,ANBI 133,A00,258401,Wilder; Linnea Lorene,34,0,40,6
1683354965607,ANBI 140,A00,258395,Hrvoj Mihic; Branka,18,0,25,7
1683354966632,ANSC 120,A00,258402,Bialecki; Jon Anthony,27,0,40,13
1683354967659,ANSC 144,A00,258400,Staff,14,0,40,26
1683354969715,ANSC 166,A00,258396,Parish; Steven Martin,157,0,175,18
1683354970739,ANSC 180,A00,193533,Staff,9,0,20,11
1683354971764,ANSC 188,A00,258397,Jassal; Aftab,33,0,40,7
1683354972789,ANTH 3,A01,258316,Staff,23,0,30,7
1683354973812,ANTH 5,A00,258394,Semendeferi; Ekaterini,16,0,20,4
1683354974840,ANTH 21,A01,258331,Staff,8,0,40,32
1683354975868,ANTH 103,A00,258398,Varma; Saiba,15,0,25,10
1683354976896,AWP 10,001,202034,Staff,0,0,0,0
1683354976896,AWP 10,002,202035,Staff,0,0,0,0
1683354976896,AWP 10,003,202036,Staff,0,0,0,0
1683354976896,AWP 10,004,202037,Staff,0,0,0,0
1683354976896,AWP 10,005,202038,Staff,0,0,0,0
1683354976896,AWP 10,006,202039,Staff,0,0,0,0
1683354976896,AWP 10,007,202040,Staff,0,0,0,0
1683354976896,AWP 10,008,202041,Staff,0,0,0,0
1683354976896,AWP 10,009,202042,Staff,0,0,0,0
1683354976896,AWP 10,010,202043,Staff,0,0,0,0
1683354976896,AWP 10,011,202044,Staff,0,0,0,0
1683354976896,AWP 10,012,202045,Staff,0,0,0,0
1683354976896,AWP 10,013,202046,Staff,0,0,0,0
1683354976896,AWP 10,014,202047,Staff,0,0,0,0
1683354976896,AWP 10,015,202048,Staff,0,0,0,0
1683354976896,AWP 10,016,202049,Staff,0,0,0,0
1683354976896,AWP 10,017,202050,Staff,0,0,0,0
1683354976896,AWP 10,018,202051,Staff,0,0,0,0
1683354976896,AWP 10,019,202052,Staff,0,0,0,0
1683354976896,AWP 10,020,202053,Staff,0,0,0,0
1683354976896,AWP 10,021,202054,Staff,0,0,0,0
1683354976896,AWP 10,022,202055,Staff,0,0,0,0
1683354976896,AWP 10,023,202056,Staff,0,0,0,0
1683354976896,AWP 10,024,202057,Staff,0,0,0,0
1683354976896,AWP 10,025,202058,Staff,0,0,0,0
1683354976896,AWP 10,026,202059,Staff,0,0,0,0
1683354977918,AWP 102,001,202032,Staff,0,0,0,0
1683354977918,AWP 102,002,202033,Staff,0,0,0,0
1683354978944,BENG 100,A01,254234,Taylor Amos; Alyssa C,31,0,40,9
1683354979969,BENG 196,001,270013,Engler; Adam J.,9999,0,9999,0
1683354980994,BICD 100R,A01,202018,Smith; Laurie,0,7,32,32
1683354980994,BICD 100R,A02,202019,Smith; Laurie,0,2,32,32
1683354980994,BICD 100R,A03,202020,Smith; Laurie,0,1,32,32
1683354980994,BICD 100R,A04,202021,Smith; Laurie,9,0,32,23
1683354980994,BICD 100R,A05,202022,Smith; Laurie,12,0,32,20
1683354982020,BICD 136,A01,193242,Gustafson-Brown; Cindy,0,2,32,32
1683354982020,BICD 136,A02,193244,Gustafson-Brown; Cindy,14,0,32,18
1683354983049,BIEB 102,A01,193249,Butler; Shannon Rhey,0,2,32,32
1683354983049,BIEB 102,A02,193251,Butler; Shannon Rhey,0,0,32,32
1683354983049,BIEB 102,A03,193253,Butler; Shannon Rhey,0,1,32,32
1683354983049,BIEB 102,A04,193255,Butler; Shannon Rhey,17,0,32,15
1683354983049,BIEB 102,A05,193265,Butler; Shannon Rhey,26,0,32,6
1683354983049,BIEB 102,A06,193269,Butler; Shannon Rhey,16,0,32,16
1683354985096,BIEB 150,A01,193274,Staff,0,0,32,32
1683354985096,BIEB 150,A02,193285,Staff,23,0,32,9
1683354986123,BIEB 194,A00,193286,Kurle; Carolyn M.,22,0,32,10
1683354987151,BILD 1,A01,192291,Staff,16,0,32,16
1683354987151,BILD 1,A02,192292,Staff,30,0,32,2
1683354987151,BILD 1,B01,192520,Reuther; Keefe,0,1,0,0
1683354987151,BILD 1,B02,192532,Reuther; Keefe,0,1,0,0
1683354988175,BILD 3,A01,192556,Butler; Shannon Rhey,0,0,32,32
1683354988175,BILD 3,A02,192581,Butler; Shannon Rhey,4,0,32,28
1683354988175,BILD 3,A03,192611,Butler; Shannon Rhey,23,0,32,9
1683354988175,BILD 3,A04,192612,Butler; Shannon Rhey,25,0,32,7
1683354988175,BILD 3,A05,192613,Butler; Shannon Rhey,27,0,32,5
1683354988175,BILD 3,A06,192679,Butler; Shannon Rhey,27,0,32,5
1683354988175,BILD 3,A07,192682,Butler; Shannon Rhey,22,0,32,10
1683354989199,BILD 4,A01,192836,Reuther; Keefe,0,0,24,24
1683354989199,BILD 4,A02,193044,Reuther; Keefe,4,0,24,20
1683354990223,BILD 10,A01,193142,Gustafson-Brown; Cindy,30,0,32,2
1683354990223,BILD 10,A02,193149,Gustafson-Brown; Cindy,31,0,32,1
1683354991249,BIMM 100,A01,193301,Staff,0,6,32,32
1683354991249,BIMM 100,A02,193312,Staff,0,5,32,32
1683354991249,BIMM 100,A03,193323,Staff,0,8,32,32
1683354992275,BIMM 101,A01,193329,McDonnell; Lisa Marie,0,3,24,24
1683354992275,BIMM 101,A02,193339,McDonnell; Lisa Marie,0,3,24,24
1683354992275,BIMM 101,B01,193354,McDonnell; Lisa Marie,0,3,24,24
1683354992275,BIMM 101,B02,193357,McDonnell; Lisa Marie,0,3,24,24
1683354993300,BIMM 110,A01,193377,Tat; John,0,11,32,32
1683354993300,BIMM 110,A02,193378,Tat; John,0,9,32,32
1683354994325,BIMM 120,A01,206116,Staff,0,0,32,32
1683354994325,BIMM 120,A02,206117,Staff,8,0,32,24
1683354994325,BIMM 120,A03,206121,Staff,21,0,32,11
1683354995350,BIPN 100,A01,193393,Park; Ji Young,0,14,32,32
1683354995350,BIPN 100,A02,193402,Park; Ji Young,0,13,32,32
1683354995350,BIPN 100,A03,193413,Park; Ji Young,0,14,32,32
1683354995350,BIPN 100,A04,193414,Park; Ji Young,0,13,32,32
1683354996377,BIPN 102,A01,193429,Staff,0,0,32,32
1683354996377,BIPN 102,A02,193438,Staff,22,0,32,10
1683354997401,BIPN 106,A01,193450,Reyes Gonzalez; Catalina,0,2,40,40
1683354998426,BIPN 134,A01,193465,Cooke; James Edward,1,0,32,31
1683354998426,BIPN 134,A02,193474,Cooke; James Edward,25,0,32,7
1683354998426,BIPN 134,A03,193485,Cooke; James Edward,29,0,32,3
1683354998426,BIPN 134,A04,193486,Cooke; James Edward,21,0,32,11
1683354998426,BIPN 134,A05,193491,Cooke; James Edward,31,0,32,1
1683354998426,BIPN 134,A06,193501,Cooke; James Edward,30,0,32,2
1683354998426,BIPN 134,A07,193510,Cooke; James Edward,29,0,32,3
1683355000477,BISP 194,A00,222522,Staff,14,0,32,18
1683355001500,CAT 124,A01,202407,Staff,20,0,25,5
1683355002527,CAT 125,A00,202408,Marchisotto; Jennifer Anne,4,0,20,16
1683355003556,CAT 125R,A00,202409,Smith; Lauryn Alissa,0,11,20,20
1683355003556,CAT 125R,B00,202410,Morales; Celeste Georgianna,0,11,20,20
1683355003556,CAT 125R,C00,202411,Irwin; Matthew Joseph,0,10,20,20
1683355004582,CENG 15,A01,204712,Yang; Kesong,0,1,0,0
1683355005606,CENG 114,A00,202070,Jahed Motlagh; Zeinab,5,0,20,15
1683355006635,CGS 105,A00,185477,Wesling; Megan E.,24,0,40,16
1683355007660,CGS 106,A00,185494,Staff,13,0,22,9
1683355008689,CGS 108,A00,185495,Staff,14,0,20,6
1683355009718,CGS 114,A00,185496,Staff,13,0,18,5
1683355010745,CGS 119,A00,185501,Staff,15,0,20,5
1683355011770,CGS 120,A00,185511,Staff,13,0,20,7
1683355012800,CHEM 4,A01,184675,Bussey; Thomas J,96,0,100,4
1683355013825,CHEM 6A,A01,184677,Staff,34,0,60,26
1683355014850,CHEM 6B,A01,184679,Staff,65,0,100,35
1683355015875,CHEM 6C,A01,184681,Bussey; Thomas J,1,0,50,49
1683355015875,CHEM 6C,A02,184682,Bussey; Thomas J,34,0,50,16
1683355016899,CHEM 40A,A01,184684,Albizati; Kim F.,37,0,100,63
1683355017924,CHEM 40B,A01,184686,Albizati; Kim F.,0,20,100,100
1683355018949,CHEM 41B,A01,184690,Staff,52,0,100,48
1683355019974,COGS 3,A01,184715,Boyle; Mary E. T.,0,25,40,40
1683355020999,COGS 14B,A01,185172,Staff,0,15,38,38
1683355022024,COGS 18,A01,184736,Staff,17,0,80,63
1683355023049,COGS 100,A01,184932,Staff,0,5,73,73
1683355024077,COGS 101A,A01,184935,Staff,0,39,30,30
1683355025101,COGS 101B,A01,184944,Staff,0,2,30,30
1683355026126,COGS 101C,A01,184946,Staff,0,12,30,30
1683355027154,COGS 102A,A01,184951,Johnson; Christine M.,2,0,40,38
1683355028183,COGS 107B,A01,184953,Mooshagian; Eric Frederick,0,50,40,40
1683355029212,COGS 118B,A01,184959,Gupta; Anjum,0,48,40,40
1683355030237,COGS 153,A00,184961,Staff,0,15,30,30
1683355031259,COGS 177,A00,184962,Staff,0,20,30,30
1683355032284,COGS 187A,A01,184969,Boyle; Mary E. T.,0,17,40,40
1683355033311,COMM 10,A01,185174,Staff,0,5,25,25
1683355033311,COMM 10,A02,185189,Staff,0,5,25,25
1683355033311,COMM 10,A03,269821,Staff,0,0,0,0
1683355034341,COMM 100B,A01,185475,Staff,0,0,0,2
1683355034341,COMM 100B,A02,185476,Staff,13,0,25,12
1683355035366,COMM 100C,A01,185314,Staff,1,0,25,24
1683355035366,COMM 100C,A02,185327,Staff,19,0,25,6
1683355036390,COMM 110M,A00,185349,Staff,2,0,40,38
1683355037416,COMM 113T,A00,185352,Staff,24,0,40,16
1683355038440,COMM 114I,A00,185353,Staff,33,0,40,7
1683355039464,COMM 131,A00,185354,Staff,19,0,30,11
1683355040489,CSE 8A,A50,185358,Cao; Yingjun,0,46,10,10
1683355041514,CSE 8B,A01,185362,Staff,0,46,50,50
1683355042593,CSE 11,A01,185416,Cao; Yingjun,0,92,10,10
1683355043617,CSE 20,A01,185445,Briones; Jor-el Thomas Caparas,5,0,25,20
1683355044642,CSE 21,A01,185447,Staff,10,0,50,40
1683355045667,CSE 101,A01,185451,Staff,0,13,50,50
1683355045667,CSE 101,B01,185453,Jones; Miles E,0,11,50,50
1683355047719,CSE 141,A01,185458,Eldon; John,20,0,100,80
1683355048744,CSE 141L,A01,185461,Eldon; John,12,0,100,88
1683355049768,CSE 142,A01,185463,Staff,36,0,60,24
1683355049768,CSE 142,B01,201355,Staff,0,7,60,60
1683355050791,CSE 142L,A01,185470,Staff,36,0,60,24
1683355050791,CSE 142L,B01,201417,Staff,0,6,60,60
1683355051816,CSE 190,A00,201433,Staff,32,0,49,17
1683355052845,DOC 1,A01,259136,Strom; Megan C.,7,0,15,8
1683355052845,DOC 1,A02,259137,Strom; Megan C.,14,0,15,1
1683355052845,DOC 1,A03,259138,Strom; Megan C.,14,0,15,1
1683355052845,DOC 1,A04,259139,Strom; Megan C.,14,0,15,1
1683355053871,DOC 100D,A00,259140,Pass; Natalye Joann,16,0,25,9
1683355054896,DSGN 1,A01,184749,Rill; Bryan,0,25,30,30
1683355055922,DSGN 100,A01,185168,Staff,0,2,25,25
1683355056946,ECE 5,A01,185626,Morris; Karcher William,0,10,0,0
1683355057974,ECE 101,A01,185628,Staff,17,0,70,53
1683355058999,ECE 107,A01,185635,Baghdadchi; Saharnaz,0,0,20,20
1683355058999,ECE 107,A02,185638,Baghdadchi; Saharnaz,4,0,20,16
1683355060024,ECE 148,A01,185647,Silberman; Jack,0,0,16,16
1683355061053,ECON 1,A01,185537,Crane; Meredith Helen,54,0,70,16
1683355062078,ECON 3,A01,185549,Crane; Meredith Helen,32,0,70,38
1683355063106,ECON 4,A01,203354,Anderson; John Charles,0,4,10,10
1683355064131,ECON 100A,A01,185574,Staff,0,4,40,40
1683355065156,ECON 100B,A01,185576,Staff,0,12,50,50
1683355066179,ECON 100C,A01,185589,Newhouse; Herbert S,29,0,70,41
1683355067206,ECON 105,A00,185608,Vespa; Emanuel Ignacio,19,0,35,16
1683355068235,ECON 109,A01,185610,Shishkin; Denis,10,0,35,25
1683355069261,ECON 110A,A01,185612,Staff,11,0,40,29
1683355070288,ECON 120A,A01,185615,Staff,20,0,40,20
1683355071312,ECON 120C,A01,185617,Sun; Yixiao,0,21,70,70
1683355072338,ECON 144,A00,203346,Squires; Dale E,3,0,35,32
1683355073367,ECON 171,A01,203349,Newhouse; Herbert S,0,1,35,35
1683355074395,ECON 173A,A01,185621,Toda; Alexis Akira,21,0,35,14
1683355075421,EDS 25,A01,202413,Staff,0,1,0,0
1683355075421,EDS 25,A02,202414,Staff,0,1,0,0
1683355075421,EDS 25,A03,202415,Staff,0,0,0,0
1683355075421,EDS 25,A04,202416,Staff,0,1,0,0
1683355075421,EDS 25,A05,202439,Staff,0,0,0,0
1683355075421,EDS 25,A06,202440,Staff,0,0,0,0
1683355075421,EDS 25,B01,202631,Staff,0,0,0,0
1683355075421,EDS 25,B02,202632,Staff,0,0,0,0
1683355075421,EDS 25,B03,202639,Staff,0,0,0,0
1683355075421,EDS 25,B04,202640,Staff,0,0,0,0
1683355075421,EDS 25,B05,202643,Staff,0,0,0,0
1683355075421,EDS 25,B06,202644,Staff,0,0,0,0
1683355076447,EDS 38,A01,202659,Black; Alison Michelle,24,0,25,1
1683355077471,EDS 115,A00,202652,Staff,18,0,30,12
1683355078497,EDS 125,A00,202649,Staff,14,0,30,16
1683355079520,EDS 126,A01,203332,Staff,30,0,30,0
1683355080545,EDS 139,A00,202838,Staff,16,0,25,9
1683355081568,EDS 146,A01,202655,Staff,14,0,25,11
1683355082598,ENG 15,A00,185667,Staff,0,1,0,0
1683355082598,ENG 15,B00,185672,Staff,0,0,0,0
1683355082598,ENG 15,C00,185675,Staff,0,0,0,0
1683355082598,ENG 15,D00,185682,Staff,0,0,0,0
1683355082598,ENG 15,E00,185684,Staff,0,0,0,0
1683355083626,ETHN 103,A00,185710,Staff,0,4,35,35
1683355084651,ETHN 103A,A00,199228,Man; Simeon S,2,0,9,7
1683355085676,ETHN 109,A00,185711,Staff,18,0,35,17
1683355086700,ETHN 142,A00,185726,Staff,0,4,30,30
1683355087725,ETHN 163J,A00,199229,Man; Simeon S,5,0,8,3
1683355088749,ETHN 168,A00,185727,Staff,8,0,10,2
1683355089773,ETHN 182,A00,185728,Staff,0,0,35,35
1683355090798,ETHN 183,A00,185737,Staff,8,0,18,10
1683355091820,GLBH 111,A01,209361,Burgos; Jose L.,0,0,0,0
1683355093874,HIEU 104,A00,185792,Staff,16,0,20,4
1683355094898,HIEU 115,A00,185800,Staff,1,0,20,19
1683355095925,HIEU 128,A00,185801,Staff,0,7,20,20
1683355096952,HIEU 147,A00,185802,Staff,16,0,20,4
1683355097981,HIEU 154,A00,185823,Staff,12,0,20,8
1683355099009,HILA 102,A00,185826,Staff,13,0,20,7
1683355100038,HILD 2C,A01,185778,Staff,0,12,20,20
1683355101069,HILD 7B,A01,185780,Kwak; Nancy,0,15,32,32
1683355101069,HILD 7B,A02,185781,Kwak; Nancy,0,18,32,32
1683355102093,HILD 30,A01,185791,Staff,14,0,20,6
1683355103118,HISC 119,A00,185830,Golan; Tal,0,9,20,20
1683355104146,HITO 156GS,A00,185831,Patterson; Patrick H.,0,0,0,23
1683355105170,HIUS 103,A00,185832,Man; Simeon S,0,6,20,20
1683355106198,HIUS 117,A00,185836,Kwak; Nancy,2,0,20,18
1683355107225,HIUS 125,A00,185840,Man; Simeon S,0,0,23,23
1683355108250,HIUS 149,A00,185845,Staff,0,0,20,20
1683355109279,HUM 3,A01,185882,Zavodny; Tatiana Sophia,0,7,50,50
1683355109279,HUM 3,B01,185899,Caldwell; Michael Alan,0,18,50,50
1683355110307,HUM 3GS,A00,185900,Patterson; Patrick H.,0,0,0,23
1683355111337,HUM 4,A01,185938,Zroka; Amy Liane,31,0,50,19
1683355111337,HUM 4,B01,185956,Watkins; Eric,0,3,50,50
1683355111337,HUM 4,B02,202209,Watkins; Eric,0,2,50,50
1683355111337,HUM 4,B03,202210,Watkins; Eric,0,2,50,50
1683355112364,HUM 5,A01,185958,West; Geoffrey Scott,3,0,50,47
1683355112364,HUM 5,A02,202215,West; Geoffrey Scott,0,0,50,50
1683355113390,INTL 190,A00,185959,Gagnon; Jeffrey C,0,0,0,9
1683355113390,INTL 190,B00,185960,Lettieri; Michael Joseph,0,0,0,1
1683355114418,JAPN 180,A00,254509,Staff,4,0,30,26
1683355115446,LATI 10,A01,202853,Kennemore; Amy Michelle,4,0,35,31
1683355115446,LATI 10,A02,202854,Kennemore; Amy Michelle,2,0,35,33
1683355115446,LATI 10,A03,270054,Kennemore; Amy Michelle,30,0,30,0
1683355116471,LATI 180,A00,202855,Kennemore; Amy Michelle,11,0,20,9
1683355117500,LAWS 101,A00,201767,Golan; Tal,0,7,40,40
1683355118524,LIFR 1C,A00,185961,Staff,6,0,20,14
1683355119551,LIFR 1CX,A00,185962,Staff,7,0,20,13
1683355120578,LIFR 1D,A00,185963,Staff,9,0,20,11
1683355121606,LIFR 1DX,A00,185964,Staff,9,0,20,11
1683355122634,LIGN 101,A01,186039,Staff,43,0,50,7
1683355123658,LIGN 165,A00,186040,Staff,18,0,50,32
1683355124684,LTCS 108,A00,186041,Staff,6,0,10,4
1683355125710,LTCS 119,A00,186042,Staff,16,0,20,4
1683355126734,LTCS 130,A00,186043,Wesling; Megan E.,15,0,25,10
1683355128781,LTEA 138,A00,186119,Staff,14,0,40,26
1683355129805,LTEN 124,A00,186148,Staff,6,0,25,19
1683355130828,LTEN 178,A00,186149,Staff,7,0,15,8
1683355131853,LTEN 181,A00,186150,Blanco; John D,33,0,40,7
1683355132880,LTWL 120,A00,186160,Staff,20,0,25,5
1683355133907,LTWL 165,A00,186161,Staff,22,0,25,3
1683355134934,LTWR 100,A00,186162,Staff,0,5,15,15
1683355135959,LTWR 102,A00,186163,Doller; Ben,5,0,15,10
1683355136984,MAE 8,A01,186412,Staff,0,0,0,0
1683355138008,MAE 30B,A00,186445,Bahadori; Mohammad Yousef,83,0,100,17
1683355139035,MAE 40,A00,186592,Bewley; Thomas R,10,0,50,40
1683355140062,MAE 101B,A00,186593,Bahadori; Mohammad Yousef,81,0,100,19
1683355141088,MAE 105,A00,186594,Bandaru; Prabhakar,12,0,50,38
1683355142115,MAE 107,A00,186599,Pham; Hieu Tan,0,7,120,120
1683355143138,MAE 148,A01,186660,Silberman; Jack,3,0,16,13
1683355144163,MATH 10A,A01,188095,Staff,0,5,35,35
1683355145191,MATH 10B,A01,188097,Bowers; Adam R.,0,11,30,30
1683355145191,MATH 10B,A02,188099,Bowers; Adam R.,0,11,30,30
1683355145191,MATH 10B,B01,188104,Bowers; Adam R.,0,10,30,30
1683355145191,MATH 10B,B02,188106,Bowers; Adam R.,0,10,30,30
1683355146283,MATH 10C,A01,188111,Staff,0,18,30,30
1683355146283,MATH 10C,A02,188127,Staff,0,17,30,30
1683355146283,MATH 10C,A03,188131,Staff,0,18,30,30
1683355146283,MATH 10C,B01,188218,Staff,18,0,30,12
1683355146283,MATH 10C,B02,188244,Staff,13,0,30,17
1683355146283,MATH 10C,B03,188277,Staff,16,0,30,14
1683355147307,MATH 18,A01,188344,Bach; Quang Tran,18,0,30,12
1683355147307,MATH 18,A02,188345,Bach; Quang Tran,11,0,30,19
1683355147307,MATH 18,B01,188353,Bach; Quang Tran,10,0,30,20
1683355147307,MATH 18,B02,188354,Bach; Quang Tran,20,0,30,10
1683355148330,MATH 20A,A01,188374,Staff,12,0,35,23
1683355149354,MATH 20B,A01,188382,Ohm; Ko Woon,6,0,30,24
1683355149354,MATH 20B,A02,188383,Ohm; Ko Woon,22,0,30,8
1683355149354,MATH 20B,B01,188385,Ohm; Ko Woon,7,0,30,23
1683355149354,MATH 20B,B02,188392,Ohm; Ko Woon,22,0,30,8
1683355150379,MATH 20C,A01,188394,Harel; Guershon,10,0,30,20
1683355150379,MATH 20C,A02,188395,Harel; Guershon,15,0,30,15
1683355150379,MATH 20C,B01,188404,Harel; Guershon,4,0,30,26
1683355150379,MATH 20C,B02,188405,Harel; Guershon,19,0,30,11
1683355151404,MATH 20D,A01,188414,Hammock; Frances H,0,1,30,30
1683355151404,MATH 20D,A02,188415,Hammock; Frances H,3,0,30,27
1683355151404,MATH 20D,B01,188447,Hammock; Frances H,1,0,30,29
1683355151404,MATH 20D,B02,188486,Hammock; Frances H,8,0,30,22
1683355152432,MATH 20E,A01,188649,Staff,21,0,30,9
1683355152432,MATH 20E,A02,188650,Staff,23,0,30,7
1683355152432,MATH 20E,A03,188673,Staff,0,0,30,30
1683355153457,MATH 102,A01,188675,Staff,0,35,35,35
1683355154482,MATH 103B,A01,188681,Staff,3,0,35,32
1683355154482,MATH 103B,B01,188692,Staff,5,0,35,30
1683355155505,MATH 109,A01,188695,Salehi Golsefidy; Alireza,25,0,35,10
1683355155505,MATH 109,A02,188696,Salehi Golsefidy; Alireza,25,0,35,10
1683355156529,MATH 120A,A01,188698,Eggers; John Dietrich,7,0,35,28
1683355157554,MATH 142B,A01,188736,Ioana; Adrian,0,2,30,30
1683355157554,MATH 142B,A02,188741,Ioana; Adrian,0,0,30,30
1683355157554,MATH 142B,A03,188743,Ioana; Adrian,0,1,30,30
1683355158578,MATH 168A,A01,188790,Staff,0,9,35,35
1683355159601,MATH 170A,A01,188803,Nie; Jiawang,0,2,35,35
1683355159601,MATH 170A,A02,188811,Nie; Jiawang,0,0,35,35
1683355159601,MATH 170A,A03,188814,Nie; Jiawang,1,0,35,34
1683355159601,MATH 170A,A04,188815,Nie; Jiawang,13,0,35,22
1683355160626,MATH 193B,A01,188817,Staff,0,0,35,35
1683355160626,MATH 193B,A02,188818,Staff,5,0,35,30
1683355161651,MGT 4,A01,202857,Anderson; John Charles,61,0,80,19
1683355162679,MGT 12,A00,202858,Lindenberger; Wade Douglas,42,0,90,48
1683355163706,MGT 18,A00,202859,Staff,74,0,90,16
1683355164734,MGT 18GS,A00,202860,McKay; Michael J,13,0,28,15
1683355165761,MGT 45,A00,202861,Pecore; Joseph P.,14,0,90,76
1683355166787,MGT 100,A00,202863,Yavorsky; Daniel Ryan,28,0,90,62
1683355167813,MGT 103,A00,202864,Ehrich; Kristine R,0,17,90,90
1683355168837,MGT 112,A00,202865,Ehrich; Kristine R,15,0,90,75
1683355169862,MGT 121A,A00,202868,Staff,0,20,0,0
1683355170890,MGT 131B,A00,202869,Anderson; John Charles,59,0,90,31
1683355171914,MGT 136,A00,202871,Lindenberger; Wade Douglas,84,0,90,6
1683355172940,MGT 164,A00,202873,Staff,0,68,90,91
1683355173966,MGT 164GS,A00,202874,McKay; Mary A,13,0,28,15
1683355174991,MGT 180,A00,202875,Staff,0,50,90,91
1683355176016,MMW 11R,A01,205019,Herbst; Matthew,3,0,30,27
1683355176016,MMW 11R,A02,205026,Herbst; Matthew,29,0,30,1
1683355177043,MMW 15,A01,193512,Chang; Edmond Yi-Teh,0,9,28,28
1683355177043,MMW 15,A02,193513,Chang; Edmond Yi-Teh,0,5,28,28
1683355177043,MMW 15,A03,193514,Chang; Edmond Yi-Teh,0,5,28,28
1683355177043,MMW 15,A04,193515,Chang; Edmond Yi-Teh,0,5,28,28
1683355177043,MMW 15,A05,193516,Chang; Edmond Yi-Teh,0,4,28,28
1683355177043,MMW 15,A06,193517,Chang; Edmond Yi-Teh,0,5,28,28
1683355177043,MMW 15,B01,193519,Chang; Edmond Yi-Teh,0,5,28,28
1683355177043,MMW 15,B02,193520,Chang; Edmond Yi-Teh,0,5,28,28
1683355177043,MMW 15,B03,193521,Chang; Edmond Yi-Teh,0,5,28,28
1683355177043,MMW 15,B04,193522,Chang; Edmond Yi-Teh,0,4,28,28
1683355177043,MMW 15,B05,193523,Chang; Edmond Yi-Teh,0,5,28,28
1683355177043,MMW 15,B06,193524,Chang; Edmond Yi-Teh,0,4,28,28
1683355178070,MMW 122,A01,193526,Rahimi; Babak,0,15,28,28
1683355178070,MMW 122,A02,193527,Rahimi; Babak,0,14,28,28
1683355178070,MMW 122,A03,193528,Rahimi; Babak,0,0,0,0
1683355178070,MMW 122,A04,193529,Rahimi; Babak,0,0,0,0
1683355179093,MUS 1A,A01,186663,Staff,0,20,35,35
1683355180119,MUS 4,A01,186715,Staff,0,12,35,35
1683355181146,MUS 5R,A01,186796,Dubnov; Shlomo,0,17,35,35
1683355182172,MUS 6,A01,186798,Staff,0,4,25,25
1683355183197,MUS 7,A01,186830,Staff,13,0,35,22
1683355184221,MUS 8,A01,186930,Staff,0,26,35,35
1683355185246,MUS 15,A01,186932,Staff,0,16,35,35
1683355185246,MUS 15,B01,186934,Staff,0,15,35,35
1683355186275,MUS 80,A00,186935,Staff,1,0,20,19
1683355186275,MUS 80,B00,186936,Staff,25,0,25,0
1683355187300,NANO 11,A00,204702,Lipomi; Darren John,0,0,0,0
1683355188323,NANO 15,A01,204709,Yang; Kesong,0,1,0,0
1683355189347,NANO 114,A00,202069,Jahed Motlagh; Zeinab,3,0,10,7
1683355190371,PHIL 1,A00,186955,Grush; Rick Scott,32,0,40,8
1683355191394,PHIL 10,A01,186973,Grush; Rick Scott,28,0,35,7
1683355191394,PHIL 10,A02,186974,Grush; Rick Scott,33,0,35,2
1683355192417,PHIL 13,A01,186976,Staff,7,0,35,28
1683355192417,PHIL 13,A02,186977,Staff,16,0,35,19
1683355193443,PHIL 14,A01,186979,Staff,31,0,35,4
1683355193443,PHIL 14,A02,186986,Staff,32,0,35,3
1683355194469,PHIL 28,A01,186988,Staff,16,0,30,14
1683355194469,PHIL 28,A02,186989,Staff,1,0,30,29
1683355194469,PHIL 28,A03,186990,Staff,9,0,30,21
1683355194469,PHIL 28,A04,186991,Staff,26,0,30,4
1683355195492,PHIL 120,A00,186997,Staff,23,0,40,17
1683355196516,PHIL 137,A00,187003,Staff,9,0,40,31
1683355197542,PHIL 150,A00,187015,Staff,47,0,70,23
1683355198566,PHIL 167,A00,187021,Lamey; Andy M.,35,0,40,5
1683355199591,PHIL 174,A01,202226,Staff,17,0,20,3
1683355199591,PHIL 174,A02,202235,Staff,20,0,20,0
1683355200617,PHIL 191A,A00,258918,Staff,0,0,1,1
1683355201640,PHYS 1A,A00,187028,Staff,27,0,60,33
1683355202685,PHYS 1AL,001,187036,Staff,2,0,30,28
1683355202685,PHYS 1AL,002,187049,Staff,18,0,30,12
1683355203709,PHYS 1B,A00,187058,Staff,22,0,60,38
1683355204734,PHYS 1BL,001,187064,Staff,0,0,30,30
1683355204734,PHYS 1BL,002,187070,Staff,5,0,30,25
1683355205762,PHYS 1C,A00,187082,Staff,31,0,120,89
1683355206788,PHYS 1CL,001,187088,Staff,0,9,30,30
1683355206788,PHYS 1CL,002,187089,Staff,0,2,30,30
1683355206788,PHYS 1CL,009,262693,Staff,11,0,30,19
1683355207815,PHYS 2B,A01,187097,Staff,54,0,115,61
1683355208841,PHYS 2C,A01,187099,Staff,67,0,115,48
1683355209869,PHYS 2CL,A01,187101,Staff,5,0,28,23
1683355209869,PHYS 2CL,A02,187102,Staff,15,0,28,13
1683355210897,PHYS 2D,A01,187123,Shotwell; Brian,95,0,115,20
1683355211922,PHYS 4B,A01,187133,Grinstein; Benjamin,35,0,50,15
1683355212945,POLI 10,A00,188819,Staff,0,4,50,50
1683355213971,POLI 11,A00,188827,Staff,43,0,50,7
1683355214998,POLI 13R,A00,188828,Staff,0,1,20,20
1683355216027,POLI 27,A01,188830,Elgin; Samuel Zincke,0,1,70,70
1683355217053,POLI 30,A00,188832,Desposato; Scott,31,0,50,19
1683355218080,POLI 102F,A00,188834,Staff,3,0,40,37
1683355219103,POLI 104A,A00,188852,Staff,14,0,30,16
1683355220127,POLI 104I,A00,188853,Staff,0,6,20,20
1683355221155,POLI 110B,A00,188854,Wiens; David,7,0,20,13
1683355222178,POLI 112A,A00,188855,Wiens; David,5,0,30,25
1683355223201,POLI 117R,A00,188856,Forman; Fonna,0,11,20,20
1683355224228,POLI 118,A00,188857,Ingham; Sean,8,0,20,12
1683355225254,POLI 120G,A00,188858,Staff,9,0,30,21
1683355226279,POLI 131CR,A00,188863,Hoston; Germaine,23,0,50,27
1683355227306,POLI 133,A00,188864,Nellis; Gareth Hb,44,0,50,6
1683355228329,POLI 134D,A00,188865,Desposato; Scott,27,0,30,3
1683355229353,POLI 142A,A00,188871,Gartzke; Erik,22,0,50,28
1683355230381,POLI 142K,A00,188874,Staff,38,0,50,12
1683355231405,POLI 143,A00,188940,Gartzke; Erik,16,0,30,14
1683355232429,POLI 153,A00,188943,Staff,3,0,20,17
1683355233453,POLI 160AA,A00,188944,Staff,11,0,40,29
1683355234476,POLI 170A,A00,188945,Staff,11,0,30,19
1683355236527,PSYC 1,A00,188952,Staff,37,0,90,53
1683355237550,PSYC 2,B00,188953,Staff,19,0,35,16
1683355238573,PSYC 6,A00,188970,Staff,47,0,60,13
1683355239600,PSYC 7,A00,188973,Staff,37,0,45,8
1683355240627,PSYC 60,A01,188980,Rickard; Timothy C.,43,0,60,17
1683355241657,PSYC 70,A01,189001,Steiner; Eric Tomas,23,0,45,22
1683355242685,PSYC 100,A00,189005,Lacefield; Katharine I,0,98,120,120
1683355243711,PSYC 102,A00,189008,Staff,9,0,30,21
1683355244740,PSYC 106,B00,189026,Gorman; Michael R.,34,0,60,26
1683355245768,PSYC 114,B01,189033,Winkielman; Piotr,0,32,30,30
1683355246792,PSYC 131,A00,189036,Anagnostaras; Stephan,0,43,60,60
1683355247816,PSYC 136,A00,189041,Lowe; Angela Beth,0,7,25,25
1683355248840,PSYC 137,A00,189057,Winkielman; Piotr,0,34,25,25
1683355249920,PSYC 144,A00,189107,Wixted; John T,0,7,50,50
1683355251969,PSYC 162,A00,189142,Staff,0,8,85,85
1683355252993,PSYC 172,A00,189144,Gorman; Michael R.,0,7,30,30
1683355255045,PSYC 179,A00,189146,Lacefield; Katharine I,0,84,120,120
1683355256069,PSYC 181,A00,189147,Anagnostaras; Stephan,0,44,90,90
1683355257095,PSYC 190R,A00,189148,Barner; David A.,0,22,80,80
1683355258121,PSYC 191,A00,189275,Rickard; Timothy C.,0,7,25,25
1683355259146,PSYC 193,A00,189276,Chapman; Eddie Nathaniel,0,1,0,4
1683355260172,PSYC 193L,A01,189281,Lowe; Angela Beth,12,0,20,8
1683355260172,PSYC 193L,B01,189285,Staff,28,0,35,7
1683355261197,RELI 149,A00,187137,Rahimi; Babak,7,0,40,33
1683355262223,SE 9,A01,187315,Staff,0,2,18,18
1683355263247,SE 101B,A00,187409,Staff,24,0,30,6
1683355264275,SE 110B,A00,187444,Staff,10,0,40,30
1683355265298,SE 130B,A00,187449,Staff,31,0,40,9
1683355266326,SE 150A,A00,187516,Staff,9,0,20,11
1683355267351,SE 154,A00,187528,Staff,30,0,50,20
1683355268381,SIO 3,A01,258171,Staff,35,0,40,5
1683355269409,SIO 10,A00,187144,Cook; Geoffrey W,0,3,75,75
1683355270437,SIO 45,A00,187152,Cook; Geoffrey W,1,0,100,99
1683355271465,SIO 109R,A00,194486,Staff,0,3,20,20
1683355273514,SIO 187,A01,187233,Kacev; David,12,0,40,28
1683355274539,SOCI 1,A01,258656,Thorpe; Charles Robert,28,0,30,2
1683355274539,SOCI 1,A02,258658,Thorpe; Charles Robert,30,0,30,0
1683355274539,SOCI 1,A03,258661,Thorpe; Charles Robert,25,0,25,0
1683355274539,SOCI 1,A04,258666,Thorpe; Charles Robert,22,0,25,3
1683355274539,SOCI 1,A05,258897,Thorpe; Charles Robert,23,0,25,2
1683355274539,SOCI 1,A06,258898,Thorpe; Charles Robert,25,0,25,0
1683355275563,SOCI 30,A01,258903,Pardo Guerra; Juan Pablo,15,0,30,15
1683355276587,SOCI 102,A00,258904,Staff,9,0,25,16
1683355277611,SOCI 106,A00,258905,Staff,19,0,25,6
1683355278636,SOCI 111,A00,258907,Ribas Norris; Janet Vanesa,26,0,30,4
1683355279663,SOCI 121R,A00,258908,Pardo Guerra; Juan Pablo,10,0,30,20
1683355280686,SOCI 126,A01,203330,Staff,14,0,20,6
1683355281711,SOCI 131,A00,258909,Thorpe; Charles Robert,31,0,60,29
1683355282734,SOCI 135,A00,258910,Payne; Christine Anna,0,9,30,30
1683355283762,SOCI 157,A00,258911,Staff,12,0,30,18
1683355284788,SOCI 184,A00,258912,Staff,25,0,30,5
1683355285812,SOCI 188D,A00,258913,Staff,22,0,30,8
1683355286836,SYN 2,001,187529,Staff,10,0,16,6
1683355286836,SYN 2,002,201452,Staff,0,18,16,16
1683355286836,SYN 2,003,201469,Staff,3,0,16,13
1683355287860,SYN 100,A01,187531,Staff,0,9,20,20
1683355287860,SYN 100,B01,201491,Staff,0,12,20,20
1683355288884,TDAC 1,A00,189286,Walsh; Kim C.,3,0,20,17
1683355288884,TDAC 1,B00,189287,Harting; Carla Kelso,11,0,20,9
1683355289908,TDAC 101,A00,189300,Walsh; Kim C.,16,0,20,4
1683355289908,TDAC 101,B00,189301,Harting; Carla Kelso,18,0,20,2
1683355290933,TDAC 102,A00,189304,Basso; Beatrice,14,0,20,6
1683355291957,TDAC 108,A00,189305,Staff,18,0,20,2
1683355292982,TDDE 131,A00,189310,Staff,19,0,20,1
1683355292982,TDDE 131,B00,189314,Staff,19,0,20,1
1683355292982,TDDE 131,C00,189315,Staff,48,0,50,2
1683355292982,TDDE 131,D00,189316,Staff,14,0,15,1
1683355292982,TDDE 131,E00,204841,Staff,20,0,20,0
1683355294006,TDGE 10,A00,189289,Staff,30,0,50,20
1683355294006,TDGE 10,B00,189290,Havis; Allan,1,0,50,49
1683355295032,TDGE 11,A00,189291,Fulton; Julia,0,3,50,50
1683355295032,TDGE 11,B00,189292,Staff,20,0,25,5
1683355295032,TDGE 11,C00,260270,Staff,0,0,0,0
1683355296061,TDGE 25,A00,189294,Staff,3,0,20,17
1683355297087,TDGE 124,A00,189318,Fulton; Julia,0,8,50,50
1683355298117,TDGE 125,A00,189319,Staff,13,0,25,12
1683355298117,TDGE 125,B00,189320,Staff,23,0,25,2
1683355299145,TDGE 127,A00,189322,Havis; Allan,0,0,50,50
1683355300168,TDHT 101,A00,189323,Staff,18,0,25,7
1683355300168,TDHT 101,B00,189324,Staff,25,0,25,0
1683355301192,TDHT 102,A00,189325,Staff,49,0,50,1
1683355302218,TDMV 1,A00,189295,Arcidiacono; Kristin,19,0,30,11
1683355302218,TDMV 1,B00,189296,Caligagan; Maria T.,24,0,30,6
1683355303242,TDMV 2,A00,189297,Sammartano; Tonnie,28,0,30,2
1683355303242,TDMV 2,B00,189299,Arcidiacono; Kristin,24,0,30,6
1683355304267,TDMV 3,A00,204998,Rincon; Alicia,22,0,30,8
1683355305291,TDMV 120,A00,189458,Sammartano; Tonnie,28,0,30,2
1683355306316,TDMV 138,A00,189541,Jun; Grace Shin Hae,22,0,40,18
1683355307341,TDMV 142,A00,189717,Caligagan; Tony,23,0,30,7
1683355307341,TDMV 142,B00,189718,Caligagan; Maria T.,25,0,30,5
1683355308366,TMC 2,A01,187533,Staff,25,0,25,0
1683355308366,TMC 2,A02,187534,Staff,25,0,25,0
1683355309394,USP 1,A01,187536,Kwak; Nancy,0,16,25,25
1683355310421,USP 5,A01,187538,Staff,10,0,25,15
1683355311446,USP 101,A00,199253,Staff,0,4,0,0
1683355312473,USP 124,A00,187562,Boomhower; Matthew Charles,1,0,30,29
1683355313498,USP 138,A00,187582,Staff,20,0,25,5
1683355314525,USP 152,A01,187597,Staff,4,0,25,21
1683355315553,USP 153,A00,187598,Staff,19,0,25,6
1683355316580,USP 168,A00,187607,Kwak; Nancy,2,0,5,3
1683355317605,USP 173,A00,187619,Staff,4,0,25,21
1683355318633,USP 181,A00,187638,Staff,0,3,25,25
1683355319658,VIS 103,A00,187650,Cruz; Edwin Teddy,22,0,75,53
1683355320690,VIS 110D,A00,187669,Staff,12,0,22,10
1683355321717,VIS 127C,A00,187720,Shen; Kuiyi,67,0,146,79
1683355322785,VIS 149,A00,187731,Yoldas; Pinar,0,14,22,22
1683355323809,VIS 151,A01,188091,Staff,22,0,34,12
1683355323809,VIS 151,A02,188092,Staff,11,0,34,23
1683355324835,VIS 160B,A00,188093,Stalbaum; Brett,0,0,10,10
1683355326884,WCWP 10B,A00,201720,Staff,10,0,15,5
1683355326884,WCWP 10B,B00,201722,Staff,9,0,15,6
1683355327908,WCWP 100,A00,201725,Gagnon; Jeffrey C,0,0,2,2
1683355327908,WCWP 100,B00,201727,Staff,0,4,15,15
1683355331002,ANBI 133,A00,258401,Wilder; Linnea Lorene,34,0,40,6
1683355332027,ANBI 140,A00,258395,Hrvoj Mihic; Branka,18,0,25,7
1683355333051,ANSC 120,A00,258402,Bialecki; Jon Anthony,27,0,40,13
1683355334076,ANSC 144,A00,258400,Staff,14,0,40,26
1683355336125,ANSC 166,A00,258396,Parish; Steven Martin,157,0,175,18
1683355337152,ANSC 180,A00,193533,Staff,9,0,20,11
1683355338178,ANSC 188,A00,258397,Jassal; Aftab,33,0,40,7
1683355339204,ANTH 3,A01,258316,Staff,23,0,30,7
1683355340230,ANTH 5,A00,258394,Semendeferi; Ekaterini,16,0,20,4
1683355341258,ANTH 21,A01,258331,Staff,8,0,40,32
1683355342285,ANTH 103,A00,258398,Varma; Saiba,15,0,25,10
1683355343318,AWP 10,001,202034,Staff,0,0,0,0
1683355343318,AWP 10,002,202035,Staff,0,0,0,0
1683355343318,AWP 10,003,202036,Staff,0,0,0,0
1683355343318,AWP 10,004,202037,Staff,0,0,0,0
1683355343318,AWP 10,005,202038,Staff,0,0,0,0
1683355343318,AWP 10,006,202039,Staff,0,0,0,0
1683355343318,AWP 10,007,202040,Staff,0,0,0,0
1683355343318,AWP 10,008,202041,Staff,0,0,0,0
1683355343318,AWP 10,009,202042,Staff,0,0,0,0
1683355343318,AWP 10,010,202043,Staff,0,0,0,0
1683355343318,AWP 10,011,202044,Staff,0,0,0,0
1683355343318,AWP 10,012,202045,Staff,0,0,0,0
1683355343318,AWP 10,013,202046,Staff,0,0,0,0
1683355343318,AWP 10,014,202047,Staff,0,0,0,0
1683355343318,AWP 10,015,202048,Staff,0,0,0,0
1683355343318,AWP 10,016,202049,Staff,0,0,0,0
1683355343318,AWP 10,017,202050,Staff,0,0,0,0
1683355343318,AWP 10,018,202051,Staff,0,0,0,0
1683355343318,AWP 10,019,202052,Staff,0,0,0,0
1683355343318,AWP 10,020,202053,Staff,0,0,0,0
1683355343318,AWP 10,021,202054,Staff,0,0,0,0
1683355343318,AWP 10,022,202055,Staff,0,0,0,0
1683355343318,AWP 10,023,202056,Staff,0,0,0,0
1683355343318,AWP 10,024,202057,Staff,0,0,0,0
1683355343318,AWP 10,025,202058,Staff,0,0,0,0
1683355343318,AWP 10,026,202059,Staff,0,0,0,0
1683355344342,AWP 102,001,202032,Staff,0,0,0,0
1683355344342,AWP 102,002,202033,Staff,0,0,0,0
1683355345366,BENG 100,A01,254234,Taylor Amos; Alyssa C,31,0,40,9
1683355346394,BENG 196,001,270013,Engler; Adam J.,9999,0,9999,0
1683355347424,BICD 100R,A01,202018,Smith; Laurie,0,7,32,32
1683355347424,BICD 100R,A02,202019,Smith; Laurie,0,2,32,32
1683355347424,BICD 100R,A03,202020,Smith; Laurie,0,1,32,32
1683355347424,BICD 100R,A04,202021,Smith; Laurie,9,0,32,23
1683355347424,BICD 100R,A05,202022,Smith; Laurie,12,0,32,20
1683355348451,BICD 136,A01,193242,Gustafson-Brown; Cindy,0,2,32,32
1683355348451,BICD 136,A02,193244,Gustafson-Brown; Cindy,14,0,32,18
1683355349477,BIEB 102,A01,193249,Butler; Shannon Rhey,0,2,32,32
1683355349477,BIEB 102,A02,193251,Butler; Shannon Rhey,0,0,32,32
1683355349477,BIEB 102,A03,193253,Butler; Shannon Rhey,0,1,32,32
1683355349477,BIEB 102,A04,193255,Butler; Shannon Rhey,17,0,32,15
1683355349477,BIEB 102,A05,193265,Butler; Shannon Rhey,26,0,32,6
1683355349477,BIEB 102,A06,193269,Butler; Shannon Rhey,16,0,32,16
1683355351526,BIEB 150,A01,193274,Staff,0,0,32,32
1683355351526,BIEB 150,A02,193285,Staff,23,0,32,9
1683355352552,BIEB 194,A00,193286,Kurle; Carolyn M.,22,0,32,10
1683355353638,BILD 1,A01,192291,Staff,16,0,32,16
1683355353638,BILD 1,A02,192292,Staff,30,0,32,2
1683355353638,BILD 1,B01,192520,Reuther; Keefe,0,1,0,0
1683355353638,BILD 1,B02,192532,Reuther; Keefe,0,1,0,0
1683355354663,BILD 3,A01,192556,Butler; Shannon Rhey,0,0,32,32
1683355354663,BILD 3,A02,192581,Butler; Shannon Rhey,4,0,32,28
1683355354663,BILD 3,A03,192611,Butler; Shannon Rhey,23,0,32,9
1683355354663,BILD 3,A04,192612,Butler; Shannon Rhey,25,0,32,7
1683355354663,BILD 3,A05,192613,Butler; Shannon Rhey,27,0,32,5
1683355354663,BILD 3,A06,192679,Butler; Shannon Rhey,27,0,32,5
1683355354663,BILD 3,A07,192682,Butler; Shannon Rhey,22,0,32,10
1683355355688,BILD 4,A01,192836,Reuther; Keefe,0,0,24,24
1683355355688,BILD 4,A02,193044,Reuther; Keefe,4,0,24,20
1683355356713,BILD 10,A01,193142,Gustafson-Brown; Cindy,30,0,32,2
1683355356713,BILD 10,A02,193149,Gustafson-Brown; Cindy,31,0,32,1
1683355357737,BIMM 100,A01,193301,Staff,0,6,32,32
1683355357737,BIMM 100,A02,193312,Staff,0,5,32,32
1683355357737,BIMM 100,A03,193323,Staff,0,8,32,32
1683355358766,BIMM 101,A01,193329,McDonnell; Lisa Marie,0,3,24,24
1683355358766,BIMM 101,A02,193339,McDonnell; Lisa Marie,0,3,24,24
1683355358766,BIMM 101,B01,193354,McDonnell; Lisa Marie,0,3,24,24
1683355358766,BIMM 101,B02,193357,McDonnell; Lisa Marie,0,3,24,24
1683355359794,BIMM 110,A01,193377,Tat; John,0,11,32,32
1683355359794,BIMM 110,A02,193378,Tat; John,0,9,32,32
1683355360820,BIMM 120,A01,206116,Staff,0,0,32,32
1683355360820,BIMM 120,A02,206117,Staff,8,0,32,24
1683355360820,BIMM 120,A03,206121,Staff,21,0,32,11
1683355361846,BIPN 100,A01,193393,Park; Ji Young,0,14,32,32
1683355361846,BIPN 100,A02,193402,Park; Ji Young,0,13,32,32
1683355361846,BIPN 100,A03,193413,Park; Ji Young,0,14,32,32
1683355361846,BIPN 100,A04,193414,Park; Ji Young,0,13,32,32
1683355362875,BIPN 102,A01,193429,Staff,0,0,32,32
1683355362875,BIPN 102,A02,193438,Staff,22,0,32,10
1683355363904,BIPN 106,A01,193450,Reyes Gonzalez; Catalina,0,2,40,40
1683355364929,BIPN 134,A01,193465,Cooke; James Edward,1,0,32,31
1683355364929,BIPN 134,A02,193474,Cooke; James Edward,25,0,32,7
1683355364929,BIPN 134,A03,193485,Cooke; James Edward,29,0,32,3
1683355364929,BIPN 134,A04,193486,Cooke; James Edward,21,0,32,11
1683355364929,BIPN 134,A05,193491,Cooke; James Edward,31,0,32,1
1683355364929,BIPN 134,A06,193501,Cooke; James Edward,30,0,32,2
1683355364929,BIPN 134,A07,193510,Cooke; James Edward,29,0,32,3
1683355366978,BISP 194,A00,222522,Staff,14,0,32,18
1683355368006,CAT 124,A01,202407,Staff,20,0,25,5
1683355369032,CAT 125,A00,202408,Marchisotto; Jennifer Anne,4,0,20,16
1683355370055,CAT 125R,A00,202409,Smith; Lauryn Alissa,0,11,20,20
1683355370055,CAT 125R,B00,202410,Morales; Celeste Georgianna,0,11,20,20
1683355370055,CAT 125R,C00,202411,Irwin; Matthew Joseph,0,10,20,20
1683355371080,CENG 15,A01,204712,Yang; Kesong,0,1,0,0
1683355372108,CENG 114,A00,202070,Jahed Motlagh; Zeinab,5,0,20,15
1683355373133,CGS 105,A00,185477,Wesling; Megan E.,24,0,40,16
1683355374158,CGS 106,A00,185494,Staff,13,0,22,9
1683355375181,CGS 108,A00,185495,Staff,14,0,20,6
1683355376204,CGS 114,A00,185496,Staff,13,0,18,5
1683355377228,CGS 119,A00,185501,Staff,15,0,20,5
1683355378253,CGS 120,A00,185511,Staff,13,0,20,7
1683355379282,CHEM 4,A01,184675,Bussey; Thomas J,96,0,100,4
1683355380306,CHEM 6A,A01,184677,Staff,34,0,60,26
1683355381331,CHEM 6B,A01,184679,Staff,65,0,100,35
1683355382361,CHEM 6C,A01,184681,Bussey; Thomas J,1,0,50,49
1683355382361,CHEM 6C,A02,184682,Bussey; Thomas J,34,0,50,16
1683355383386,CHEM 40A,A01,184684,Albizati; Kim F.,37,0,100,63
1683355384411,CHEM 40B,A01,184686,Albizati; Kim F.,0,20,100,100
1683355385436,CHEM 41B,A01,184690,Staff,52,0,100,48
1683355386468,COGS 3,A01,184715,Boyle; Mary E. T.,0,25,40,40
1683355387493,COGS 14B,A01,185172,Staff,0,15,38,38
1683355388517,COGS 18,A01,184736,Staff,17,0,80,63
1683355389541,COGS 100,A01,184932,Staff,0,5,73,73
1683355390566,COGS 101A,A01,184935,Staff,0,39,30,30
1683355391589,COGS 101B,A01,184944,Staff,0,2,30,30
1683355392614,COGS 101C,A01,184946,Staff,0,12,30,30
1683355393641,COGS 102A,A01,184951,Johnson; Christine M.,2,0,40,38
1683355394666,COGS 107B,A01,184953,Mooshagian; Eric Frederick,0,50,40,40
1683355395690,COGS 118B,A01,184959,Gupta; Anjum,0,48,40,40
1683355396716,COGS 153,A00,184961,Staff,0,15,30,30
1683355397743,COGS 177,A00,184962,Staff,0,20,30,30
1683355398768,COGS 187A,A01,184969,Boyle; Mary E. T.,0,17,40,40
1683355399797,COMM 10,A01,185174,Staff,0,5,25,25
1683355399797,COMM 10,A02,185189,Staff,0,5,25,25
1683355399797,COMM 10,A03,269821,Staff,0,0,0,0
1683355400825,COMM 100B,A01,185475,Staff,0,0,0,2
1683355400825,COMM 100B,A02,185476,Staff,13,0,25,12
1683355401850,COMM 100C,A01,185314,Staff,1,0,25,24
1683355401850,COMM 100C,A02,185327,Staff,19,0,25,6
1683355402875,COMM 110M,A00,185349,Staff,2,0,40,38
1683355403900,COMM 113T,A00,185352,Staff,24,0,40,16
1683355404925,COMM 114I,A00,185353,Staff,33,0,40,7
1683355405950,COMM 131,A00,185354,Staff,19,0,30,11
1683355406979,CSE 8A,A50,185358,Cao; Yingjun,0,46,10,10
1683355408007,CSE 8B,A01,185362,Staff,0,46,50,50
1683355409031,CSE 11,A01,185416,Cao; Yingjun,0,92,10,10
1683355410056,CSE 20,A01,185445,Briones; Jor-el Thomas Caparas,5,0,25,20
1683355411079,CSE 21,A01,185447,Staff,10,0,50,40
1683355412105,CSE 101,A01,185451,Staff,0,13,50,50
1683355412105,CSE 101,B01,185453,Jones; Miles E,0,11,50,50
1683355414158,CSE 141,A01,185458,Eldon; John,20,0,100,80
1683355415183,CSE 141L,A01,185461,Eldon; John,12,0,100,88
1683355416208,CSE 142,A01,185463,Staff,36,0,60,24
1683355416208,CSE 142,B01,201355,Staff,0,7,60,60
1683355417233,CSE 142L,A01,185470,Staff,36,0,60,24
1683355417233,CSE 142L,B01,201417,Staff,0,6,60,60
1683355418258,CSE 190,A00,201433,Staff,32,0,49,17
1683355419285,DOC 1,A01,259136,Strom; Megan C.,7,0,15,8
1683355419285,DOC 1,A02,259137,Strom; Megan C.,14,0,15,1
1683355419285,DOC 1,A03,259138,Strom; Megan C.,14,0,15,1
1683355419285,DOC 1,A04,259139,Strom; Megan C.,14,0,15,1
1683355420311,DOC 100D,A00,259140,Pass; Natalye Joann,16,0,25,9
1683355421337,DSGN 1,A01,184749,Rill; Bryan,0,25,30,30
1683355422363,DSGN 100,A01,185168,Staff,0,2,25,25
1683355423387,ECE 5,A01,185626,Morris; Karcher William,0,10,0,0
1683355424415,ECE 101,A01,185628,Staff,17,0,70,53
1683355425443,ECE 107,A01,185635,Baghdadchi; Saharnaz,0,0,20,20
1683355425443,ECE 107,A02,185638,Baghdadchi; Saharnaz,4,0,20,16
1683355426471,ECE 148,A01,185647,Silberman; Jack,0,0,16,16
1683355427497,ECON 1,A01,185537,Crane; Meredith Helen,54,0,70,16
1683355428521,ECON 3,A01,185549,Crane; Meredith Helen,32,0,70,38
1683355429550,ECON 4,A01,203354,Anderson; John Charles,0,4,10,10
1683355430580,ECON 100A,A01,185574,Staff,0,4,40,40
1683355431753,ECON 100B,A01,185576,Staff,0,12,50,50
1683355432778,ECON 100C,A01,185589,Newhouse; Herbert S,29,0,70,41
1683355433801,ECON 105,A00,185608,Vespa; Emanuel Ignacio,19,0,35,16
1683355434828,ECON 109,A01,185610,Shishkin; Denis,10,0,35,25
1683355435855,ECON 110A,A01,185612,Staff,11,0,40,29
1683355436880,ECON 120A,A01,185615,Staff,20,0,40,20
1683355437909,ECON 120C,A01,185617,Sun; Yixiao,0,21,70,70
1683355438937,ECON 144,A00,203346,Squires; Dale E,3,0,35,32
1683355439965,ECON 171,A01,203349,Newhouse; Herbert S,0,1,35,35
1683355440995,ECON 173A,A01,185621,Toda; Alexis Akira,21,0,35,14
1683355442027,EDS 25,A01,202413,Staff,0,1,0,0
1683355442027,EDS 25,A02,202414,Staff,0,1,0,0
1683355442027,EDS 25,A03,202415,Staff,0,0,0,0
1683355442027,EDS 25,A04,202416,Staff,0,1,0,0
1683355442027,EDS 25,A05,202439,Staff,0,0,0,0
1683355442027,EDS 25,A06,202440,Staff,0,0,0,0
1683355442027,EDS 25,B01,202631,Staff,0,0,0,0
1683355442027,EDS 25,B02,202632,Staff,0,0,0,0
1683355442027,EDS 25,B03,202639,Staff,0,0,0,0
1683355442027,EDS 25,B04,202640,Staff,0,0,0,0
1683355442027,EDS 25,B05,202643,Staff,0,0,0,0
1683355442027,EDS 25,B06,202644,Staff,0,0,0,0
1683355443052,EDS 38,A01,202659,Black; Alison Michelle,24,0,25,1
1683355444080,EDS 115,A00,202652,Staff,18,0,30,12
1683355445102,EDS 125,A00,202649,Staff,14,0,30,16
1683355446126,EDS 126,A01,203332,Staff,30,0,30,0
1683355447153,EDS 139,A00,202838,Staff,16,0,25,9
1683355448180,EDS 146,A01,202655,Staff,14,0,25,11
1683355449208,ENG 15,A00,185667,Staff,0,1,0,0
1683355449208,ENG 15,B00,185672,Staff,0,0,0,0
1683355449208,ENG 15,C00,185675,Staff,0,0,0,0
1683355449208,ENG 15,D00,185682,Staff,0,0,0,0
1683355449208,ENG 15,E00,185684,Staff,0,0,0,0
1683355450231,ETHN 103,A00,185710,Staff,0,4,35,35
1683355451259,ETHN 103A,A00,199228,Man; Simeon S,2,0,9,7
1683355452285,ETHN 109,A00,185711,Staff,18,0,35,17
1683355453309,ETHN 142,A00,185726,Staff,0,4,30,30
1683355454335,ETHN 163J,A00,199229,Man; Simeon S,5,0,8,3
1683355455363,ETHN 168,A00,185727,Staff,8,0,10,2
1683355456388,ETHN 182,A00,185728,Staff,0,0,35,35
1683355457469,ETHN 183,A00,185737,Staff,8,0,18,10
1683355458493,GLBH 111,A01,209361,Burgos; Jose L.,0,0,0,0
1683355460542,HIEU 104,A00,185792,Staff,16,0,20,4
1683355461566,HIEU 115,A00,185800,Staff,1,0,20,19
1683355462593,HIEU 128,A00,185801,Staff,0,7,20,20
1683355463618,HIEU 147,A00,185802,Staff,16,0,20,4
1683355464641,HIEU 154,A00,185823,Staff,12,0,20,8
1683355465666,HILA 102,A00,185826,Staff,13,0,20,7
1683355466690,HILD 2C,A01,185778,Staff,0,12,20,20
1683355467714,HILD 7B,A01,185780,Kwak; Nancy,0,15,32,32
1683355467714,HILD 7B,A02,185781,Kwak; Nancy,0,18,32,32
1683355468739,HILD 30,A01,185791,Staff,14,0,20,6
1683355469766,HISC 119,A00,185830,Golan; Tal,0,9,20,20
1683355470794,HITO 156GS,A00,185831,Patterson; Patrick H.,0,0,0,23
1683355471818,HIUS 103,A00,185832,Man; Simeon S,0,6,20,20
1683355472846,HIUS 117,A00,185836,Kwak; Nancy,2,0,20,18
1683355473870,HIUS 125,A00,185840,Man; Simeon S,0,0,23,23
1683355474897,HIUS 149,A00,185845,Staff,0,0,20,20
1683355475927,HUM 3,A01,185882,Zavodny; Tatiana Sophia,0,7,50,50
1683355475927,HUM 3,B01,185899,Caldwell; Michael Alan,0,18,50,50
1683355476954,HUM 3GS,A00,185900,Patterson; Patrick H.,0,0,0,23
1683355477983,HUM 4,A01,185938,Zroka; Amy Liane,31,0,50,19
1683355477983,HUM 4,B01,185956,Watkins; Eric,0,3,50,50
1683355477983,HUM 4,B02,202209,Watkins; Eric,0,2,50,50
1683355477983,HUM 4,B03,202210,Watkins; Eric,0,2,50,50
1683355479009,HUM 5,A01,185958,West; Geoffrey Scott,3,0,50,47
1683355479009,HUM 5,A02,202215,West; Geoffrey Scott,0,0,50,50
1683355480037,INTL 190,A00,185959,Gagnon; Jeffrey C,0,0,0,9
1683355480037,INTL 190,B00,185960,Lettieri; Michael Joseph,0,0,0,1
1683355481062,JAPN 180,A00,254509,Staff,4,0,30,26
1683355482090,LATI 10,A01,202853,Kennemore; Amy Michelle,4,0,35,31
1683355482090,LATI 10,A02,202854,Kennemore; Amy Michelle,2,0,35,33
1683355482090,LATI 10,A03,270054,Kennemore; Amy Michelle,30,0,30,0
1683355483114,LATI 180,A00,202855,Kennemore; Amy Michelle,11,0,20,9
1683355484138,LAWS 101,A00,201767,Golan; Tal,0,7,40,40
1683355485164,LIFR 1C,A00,185961,Staff,6,0,20,14
1683355486188,LIFR 1CX,A00,185962,Staff,7,0,20,13
1683355487212,LIFR 1D,A00,185963,Staff,9,0,20,11
1683355488236,LIFR 1DX,A00,185964,Staff,9,0,20,11
1683355489259,LIGN 101,A01,186039,Staff,43,0,50,7
1683355490285,LIGN 165,A00,186040,Staff,18,0,50,32
1683355491312,LTCS 108,A00,186041,Staff,6,0,10,4
1683355492335,LTCS 119,A00,186042,Staff,16,0,20,4
1683355493364,LTCS 130,A00,186043,Wesling; Megan E.,15,0,25,10
1683355495411,LTEA 138,A00,186119,Staff,14,0,40,26
1683355496439,LTEN 124,A00,186148,Staff,6,0,25,19
1683355497465,LTEN 178,A00,186149,Staff,7,0,15,8
1683355498493,LTEN 181,A00,186150,Blanco; John D,33,0,40,7
1683355499519,LTWL 120,A00,186160,Staff,20,0,25,5
1683355500545,LTWL 165,A00,186161,Staff,22,0,25,3
1683355501578,LTWR 100,A00,186162,Staff,0,5,15,15
1683355502602,LTWR 102,A00,186163,Doller; Ben,5,0,15,10
1683355503631,MAE 8,A01,186412,Staff,0,0,0,0
1683355504655,MAE 30B,A00,186445,Bahadori; Mohammad Yousef,83,0,100,17
1683355505678,MAE 40,A00,186592,Bewley; Thomas R,10,0,50,40
1683355506707,MAE 101B,A00,186593,Bahadori; Mohammad Yousef,81,0,100,19
1683355507730,MAE 105,A00,186594,Bandaru; Prabhakar,12,0,50,38
1683355508758,MAE 107,A00,186599,Pham; Hieu Tan,0,7,120,120
1683355509784,MAE 148,A01,186660,Silberman; Jack,3,0,16,13
1683355510807,MATH 10A,A01,188095,Staff,0,5,35,35
1683355511836,MATH 10B,A01,188097,Bowers; Adam R.,0,11,30,30
1683355511836,MATH 10B,A02,188099,Bowers; Adam R.,0,11,30,30
1683355511836,MATH 10B,B01,188104,Bowers; Adam R.,0,10,30,30
1683355511836,MATH 10B,B02,188106,Bowers; Adam R.,0,10,30,30
1683355512863,MATH 10C,A01,188111,Staff,0,18,30,30
1683355512863,MATH 10C,A02,188127,Staff,0,17,30,30
1683355512863,MATH 10C,A03,188131,Staff,0,18,30,30
1683355512863,MATH 10C,B01,188218,Staff,18,0,30,12
1683355512863,MATH 10C,B02,188244,Staff,13,0,30,17
1683355512863,MATH 10C,B03,188277,Staff,16,0,30,14
1683355513891,MATH 18,A01,188344,Bach; Quang Tran,18,0,30,12
1683355513891,MATH 18,A02,188345,Bach; Quang Tran,11,0,30,19
1683355513891,MATH 18,B01,188353,Bach; Quang Tran,10,0,30,20
1683355513891,MATH 18,B02,188354,Bach; Quang Tran,20,0,30,10
1683355514914,MATH 20A,A01,188374,Staff,12,0,35,23
1683355515938,MATH 20B,A01,188382,Ohm; Ko Woon,6,0,30,24
1683355515938,MATH 20B,A02,188383,Ohm; Ko Woon,22,0,30,8
1683355515938,MATH 20B,B01,188385,Ohm; Ko Woon,7,0,30,23
1683355515938,MATH 20B,B02,188392,Ohm; Ko Woon,22,0,30,8
1683355516967,MATH 20C,A01,188394,Harel; Guershon,10,0,30,20
1683355516967,MATH 20C,A02,188395,Harel; Guershon,15,0,30,15
1683355516967,MATH 20C,B01,188404,Harel; Guershon,4,0,30,26
1683355516967,MATH 20C,B02,188405,Harel; Guershon,19,0,30,11
1683355517996,MATH 20D,A01,188414,Hammock; Frances H,0,1,30,30
1683355517996,MATH 20D,A02,188415,Hammock; Frances H,3,0,30,27
1683355517996,MATH 20D,B01,188447,Hammock; Frances H,1,0,30,29
1683355517996,MATH 20D,B02,188486,Hammock; Frances H,8,0,30,22
1683355519021,MATH 20E,A01,188649,Staff,21,0,30,9
1683355519021,MATH 20E,A02,188650,Staff,23,0,30,7
1683355519021,MATH 20E,A03,188673,Staff,0,0,30,30
1683355520046,MATH 102,A01,188675,Staff,0,35,35,35
1683355521070,MATH 103B,A01,188681,Staff,3,0,35,32
1683355521070,MATH 103B,B01,188692,Staff,5,0,35,30
1683355522098,MATH 109,A01,188695,Salehi Golsefidy; Alireza,25,0,35,10
1683355522098,MATH 109,A02,188696,Salehi Golsefidy; Alireza,25,0,35,10
1683355523123,MATH 120A,A01,188698,Eggers; John Dietrich,7,0,35,28
1683355524152,MATH 142B,A01,188736,Ioana; Adrian,0,2,30,30
1683355524152,MATH 142B,A02,188741,Ioana; Adrian,0,0,30,30
1683355524152,MATH 142B,A03,188743,Ioana; Adrian,0,1,30,30
1683355525177,MATH 168A,A01,188790,Staff,0,9,35,35
1683355526201,MATH 170A,A01,188803,Nie; Jiawang,0,2,35,35
1683355526201,MATH 170A,A02,188811,Nie; Jiawang,0,0,35,35
1683355526201,MATH 170A,A03,188814,Nie; Jiawang,1,0,35,34
1683355526201,MATH 170A,A04,188815,Nie; Jiawang,13,0,35,22
1683355527229,MATH 193B,A01,188817,Staff,0,0,35,35
1683355527229,MATH 193B,A02,188818,Staff,5,0,35,30
1683355528253,MGT 4,A01,202857,Anderson; John Charles,61,0,80,19
1683355529276,MGT 12,A00,202858,Lindenberger; Wade Douglas,42,0,90,48
1683355530299,MGT 18,A00,202859,Staff,74,0,90,16
1683355531323,MGT 18GS,A00,202860,McKay; Michael J,13,0,28,15
1683355532346,MGT 45,A00,202861,Pecore; Joseph P.,14,0,90,76
1683355533369,MGT 100,A00,202863,Yavorsky; Daniel Ryan,28,0,90,62
1683355534392,MGT 103,A00,202864,Ehrich; Kristine R,0,17,90,90
1683355535415,MGT 112,A00,202865,Ehrich; Kristine R,15,0,90,75
1683355536443,MGT 121A,A00,202868,Staff,0,20,0,0
1683355537470,MGT 131B,A00,202869,Anderson; John Charles,59,0,90,31
1683355538496,MGT 136,A00,202871,Lindenberger; Wade Douglas,84,0,90,6
1683355539520,MGT 164,A00,202873,Staff,0,68,90,91
1683355540544,MGT 164GS,A00,202874,McKay; Mary A,13,0,28,15
1683355541569,MGT 180,A00,202875,Staff,0,50,90,91
1683355542596,MMW 11R,A01,205019,Herbst; Matthew,3,0,30,27
1683355542596,MMW 11R,A02,205026,Herbst; Matthew,29,0,30,1
1683355543624,MMW 15,A01,193512,Chang; Edmond Yi-Teh,0,9,28,28
1683355543624,MMW 15,A02,193513,Chang; Edmond Yi-Teh,0,5,28,28
1683355543624,MMW 15,A03,193514,Chang; Edmond Yi-Teh,0,5,28,28
1683355543624,MMW 15,A04,193515,Chang; Edmond Yi-Teh,0,5,28,28
1683355543624,MMW 15,A05,193516,Chang; Edmond Yi-Teh,0,4,28,28
1683355543624,MMW 15,A06,193517,Chang; Edmond Yi-Teh,0,5,28,28
1683355543624,MMW 15,B01,193519,Chang; Edmond Yi-Teh,0,5,28,28
1683355543624,MMW 15,B02,193520,Chang; Edmond Yi-Teh,0,5,28,28
1683355543624,MMW 15,B03,193521,Chang; Edmond Yi-Teh,0,5,28,28
1683355543624,MMW 15,B04,193522,Chang; Edmond Yi-Teh,0,4,28,28
1683355543624,MMW 15,B05,193523,Chang; Edmond Yi-Teh,0,5,28,28
1683355543624,MMW 15,B06,193524,Chang; Edmond Yi-Teh,0,4,28,28
1683355544651,MMW 122,A01,193526,Rahimi; Babak,0,15,28,28
1683355544651,MMW 122,A02,193527,Rahimi; Babak,0,14,28,28
1683355544651,MMW 122,A03,193528,Rahimi; Babak,0,0,0,0
1683355544651,MMW 122,A04,193529,Rahimi; Babak,0,0,0,0
1683355545677,MUS 1A,A01,186663,Staff,0,20,35,35
1683355546703,MUS 4,A01,186715,Staff,0,12,35,35
1683355547732,MUS 5R,A01,186796,Dubnov; Shlomo,0,17,35,35
1683355548757,MUS 6,A01,186798,Staff,0,4,25,25
1683355549782,MUS 7,A01,186830,Staff,13,0,35,22
1683355550806,MUS 8,A01,186930,Staff,0,26,35,35
1683355551830,MUS 15,A01,186932,Staff,0,16,35,35
1683355551830,MUS 15,B01,186934,Staff,0,15,35,35
1683355552857,MUS 80,A00,186935,Staff,1,0,20,19
1683355552857,MUS 80,B00,186936,Staff,25,0,25,0
1683355553899,NANO 11,A00,204702,Lipomi; Darren John,0,0,0,0
1683355554925,NANO 15,A01,204709,Yang; Kesong,0,1,0,0
1683355555950,NANO 114,A00,202069,Jahed Motlagh; Zeinab,3,0,10,7
1683355556976,PHIL 1,A00,186955,Grush; Rick Scott,32,0,40,8
1683355558004,PHIL 10,A01,186973,Grush; Rick Scott,28,0,35,7
1683355558004,PHIL 10,A02,186974,Grush; Rick Scott,33,0,35,2
1683355559028,PHIL 13,A01,186976,Staff,7,0,35,28
1683355559028,PHIL 13,A02,186977,Staff,16,0,35,19
1683355560054,PHIL 14,A01,186979,Staff,31,0,35,4
1683355560054,PHIL 14,A02,186986,Staff,32,0,35,3
1683355561184,PHIL 28,A01,186988,Staff,16,0,30,14
1683355561184,PHIL 28,A02,186989,Staff,1,0,30,29
1683355561184,PHIL 28,A03,186990,Staff,9,0,30,21
1683355561184,PHIL 28,A04,186991,Staff,26,0,30,4
1683355562209,PHIL 120,A00,186997,Staff,23,0,40,17
1683355563233,PHIL 137,A00,187003,Staff,9,0,40,31
1683355564257,PHIL 150,A00,187015,Staff,47,0,70,23
1683355565281,PHIL 167,A00,187021,Lamey; Andy M.,35,0,40,5
1683355566313,PHIL 174,A01,202226,Staff,17,0,20,3
1683355566313,PHIL 174,A02,202235,Staff,20,0,20,0
1683355567338,PHIL 191A,A00,258918,Staff,0,0,1,1
1683355568363,PHYS 1A,A00,187028,Staff,27,0,60,33
1683355569392,PHYS 1AL,001,187036,Staff,2,0,30,28
1683355569392,PHYS 1AL,002,187049,Staff,18,0,30,12
1683355570416,PHYS 1B,A00,187058,Staff,22,0,60,38
1683355571443,PHYS 1BL,001,187064,Staff,0,0,30,30
1683355571443,PHYS 1BL,002,187070,Staff,5,0,30,25
1683355572471,PHYS 1C,A00,187082,Staff,31,0,120,89
1683355573502,PHYS 1CL,001,187088,Staff,0,9,30,30
1683355573502,PHYS 1CL,002,187089,Staff,0,2,30,30
1683355573502,PHYS 1CL,009,262693,Staff,11,0,30,19
1683355574530,PHYS 2B,A01,187097,Staff,54,0,115,61
1683355575556,PHYS 2C,A01,187099,Staff,67,0,115,48
1683355576586,PHYS 2CL,A01,187101,Staff,5,0,28,23
1683355576586,PHYS 2CL,A02,187102,Staff,15,0,28,13
1683355577615,PHYS 2D,A01,187123,Shotwell; Brian,95,0,115,20
1683355578645,PHYS 4B,A01,187133,Grinstein; Benjamin,35,0,50,15
1683355579670,POLI 10,A00,188819,Staff,0,4,50,50
1683355580696,POLI 11,A00,188827,Staff,43,0,50,7
1683355581725,POLI 13R,A00,188828,Staff,0,1,20,20
1683355582750,POLI 27,A01,188830,Elgin; Samuel Zincke,0,1,70,70
1683355583776,POLI 30,A00,188832,Desposato; Scott,31,0,50,19
1683355584800,POLI 102F,A00,188834,Staff,3,0,40,37
1683355585824,POLI 104A,A00,188852,Staff,14,0,30,16
1683355586851,POLI 104I,A00,188853,Staff,0,6,20,20
1683355587878,POLI 110B,A00,188854,Wiens; David,7,0,20,13
1683355588907,POLI 112A,A00,188855,Wiens; David,5,0,30,25
1683355589931,POLI 117R,A00,188856,Forman; Fonna,0,11,20,20
1683355590954,POLI 118,A00,188857,Ingham; Sean,8,0,20,12
1683355591981,POLI 120G,A00,188858,Staff,9,0,30,21
1683355593007,POLI 131CR,A00,188863,Hoston; Germaine,23,0,50,27
1683355594032,POLI 133,A00,188864,Nellis; Gareth Hb,44,0,50,6
1683355595056,POLI 134D,A00,188865,Desposato; Scott,27,0,30,3
1683355596081,POLI 142A,A00,188871,Gartzke; Erik,22,0,50,28
1683355597108,POLI 142K,A00,188874,Staff,38,0,50,12
1683355598136,POLI 143,A00,188940,Gartzke; Erik,16,0,30,14
1683355599163,POLI 153,A00,188943,Staff,3,0,20,17
1683355600190,POLI 160AA,A00,188944,Staff,11,0,40,29
1683355601217,POLI 170A,A00,188945,Staff,11,0,30,19
1683355603267,PSYC 1,A00,188952,Staff,37,0,90,53
1683355604295,PSYC 2,B00,188953,Staff,19,0,35,16
1683355605323,PSYC 6,A00,188970,Staff,47,0,60,13
1683355606354,PSYC 7,A00,188973,Staff,37,0,45,8
1683355607378,PSYC 60,A01,188980,Rickard; Timothy C.,43,0,60,17
1683355608403,PSYC 70,A01,189001,Steiner; Eric Tomas,23,0,45,22
1683355609431,PSYC 100,A00,189005,Lacefield; Katharine I,0,98,120,120
1683355610459,PSYC 102,A00,189008,Staff,9,0,30,21
1683355611486,PSYC 106,B00,189026,Gorman; Michael R.,34,0,60,26
1683355612514,PSYC 114,B01,189033,Winkielman; Piotr,0,32,30,30
1683355613539,PSYC 131,A00,189036,Anagnostaras; Stephan,0,43,60,60
1683355614563,PSYC 136,A00,189041,Lowe; Angela Beth,0,7,25,25
1683355615588,PSYC 137,A00,189057,Winkielman; Piotr,0,34,25,25
1683355616613,PSYC 144,A00,189107,Wixted; John T,0,7,50,50
1683355618665,PSYC 162,A00,189142,Staff,0,8,85,85
1683355619691,PSYC 172,A00,189144,Gorman; Michael R.,0,7,30,30
1683355621764,PSYC 179,A00,189146,Lacefield; Katharine I,0,84,120,120
1683355622796,PSYC 181,A00,189147,Anagnostaras; Stephan,0,44,90,90
1683355623823,PSYC 190R,A00,189148,Barner; David A.,0,22,80,80
1683355624849,PSYC 191,A00,189275,Rickard; Timothy C.,0,7,25,25
1683355625874,PSYC 193,A00,189276,Chapman; Eddie Nathaniel,0,1,0,4
1683355626904,PSYC 193L,A01,189281,Lowe; Angela Beth,12,0,20,8
1683355626904,PSYC 193L,B01,189285,Staff,28,0,35,7
1683355627929,RELI 149,A00,187137,Rahimi; Babak,7,0,40,33
1683355628954,SE 9,A01,187315,Staff,0,2,18,18
1683355629978,SE 101B,A00,187409,Staff,24,0,30,6
1683355631003,SE 110B,A00,187444,Staff,10,0,40,30
1683355632031,SE 130B,A00,187449,Staff,31,0,40,9
1683355633059,SE 150A,A00,187516,Staff,9,0,20,11
1683355634087,SE 154,A00,187528,Staff,30,0,50,20
1683355635114,SIO 3,A01,258171,Staff,35,0,40,5
1683355636138,SIO 10,A00,187144,Cook; Geoffrey W,0,3,75,75
1683355637163,SIO 45,A00,187152,Cook; Geoffrey W,1,0,100,99
1683355638187,SIO 109R,A00,194486,Staff,0,3,20,20
1683355640241,SIO 187,A01,187233,Kacev; David,12,0,40,28
1683355641266,SOCI 1,A01,258656,Thorpe; Charles Robert,28,0,30,2
1683355641266,SOCI 1,A02,258658,Thorpe; Charles Robert,30,0,30,0
1683355641266,SOCI 1,A03,258661,Thorpe; Charles Robert,25,0,25,0
1683355641266,SOCI 1,A04,258666,Thorpe; Charles Robert,22,0,25,3
1683355641266,SOCI 1,A05,258897,Thorpe; Charles Robert,23,0,25,2
1683355641266,SOCI 1,A06,258898,Thorpe; Charles Robert,25,0,25,0
1683355642291,SOCI 30,A01,258903,Pardo Guerra; Juan Pablo,15,0,30,15
1683355643321,SOCI 102,A00,258904,Staff,9,0,25,16
1683355644349,SOCI 106,A00,258905,Staff,19,0,25,6
1683355645377,SOCI 111,A00,258907,Ribas Norris; Janet Vanesa,26,0,30,4
1683355646404,SOCI 121R,A00,258908,Pardo Guerra; Juan Pablo,10,0,30,20
1683355647433,SOCI 126,A01,203330,Staff,14,0,20,6
1683355648460,SOCI 131,A00,258909,Thorpe; Charles Robert,31,0,60,29
1683355649484,SOCI 135,A00,258910,Payne; Christine Anna,0,9,30,30
1683355650508,SOCI 157,A00,258911,Staff,12,0,30,18
1683355651536,SOCI 184,A00,258912,Staff,25,0,30,5
1683355652562,SOCI 188D,A00,258913,Staff,22,0,30,8
1683355653591,SYN 2,001,187529,Staff,10,0,16,6
1683355653591,SYN 2,002,201452,Staff,0,18,16,16
1683355653591,SYN 2,003,201469,Staff,3,0,16,13
1683355654618,SYN 100,A01,187531,Staff,0,9,20,20
1683355654618,SYN 100,B01,201491,Staff,0,12,20,20
1683355655643,TDAC 1,A00,189286,Walsh; Kim C.,3,0,20,17
1683355655643,TDAC 1,B00,189287,Harting; Carla Kelso,11,0,20,9
1683355656669,TDAC 101,A00,189300,Walsh; Kim C.,16,0,20,4
1683355656669,TDAC 101,B00,189301,Harting; Carla Kelso,18,0,20,2
1683355657695,TDAC 102,A00,189304,Basso; Beatrice,14,0,20,6
1683355658717,TDAC 108,A00,189305,Staff,18,0,20,2
1683355659747,TDDE 131,A00,189310,Staff,19,0,20,1
1683355659747,TDDE 131,B00,189314,Staff,19,0,20,1
1683355659747,TDDE 131,C00,189315,Staff,48,0,50,2
1683355659747,TDDE 131,D00,189316,Staff,14,0,15,1
1683355659747,TDDE 131,E00,204841,Staff,20,0,20,0
1683355660771,TDGE 10,A00,189289,Staff,30,0,50,20
1683355660771,TDGE 10,B00,189290,Havis; Allan,1,0,50,49
1683355661796,TDGE 11,A00,189291,Fulton; Julia,0,3,50,50
1683355661796,TDGE 11,B00,189292,Staff,20,0,25,5
1683355661796,TDGE 11,C00,260270,Staff,0,0,0,0
1683355662821,TDGE 25,A00,189294,Staff,3,0,20,17
1683355663846,TDGE 124,A00,189318,Fulton; Julia,0,8,50,50
1683355664928,TDGE 125,A00,189319,Staff,13,0,25,12
1683355664928,TDGE 125,B00,189320,Staff,23,0,25,2
1683355665952,TDGE 127,A00,189322,Havis; Allan,0,0,50,50
1683355666977,TDHT 101,A00,189323,Staff,18,0,25,7
1683355666977,TDHT 101,B00,189324,Staff,25,0,25,0
1683355668001,TDHT 102,A00,189325,Staff,49,0,50,1
1683355669035,TDMV 1,A00,189295,Arcidiacono; Kristin,19,0,30,11
1683355669035,TDMV 1,B00,189296,Caligagan; Maria T.,24,0,30,6
1683355670060,TDMV 2,A00,189297,Sammartano; Tonnie,28,0,30,2
1683355670060,TDMV 2,B00,189299,Arcidiacono; Kristin,24,0,30,6
1683355671084,TDMV 3,A00,204998,Rincon; Alicia,22,0,30,8
1683355672108,TDMV 120,A00,189458,Sammartano; Tonnie,28,0,30,2
1683355673135,TDMV 138,A00,189541,Jun; Grace Shin Hae,22,0,40,18
1683355674163,TDMV 142,A00,189717,Caligagan; Tony,23,0,30,7
1683355674163,TDMV 142,B00,189718,Caligagan; Maria T.,25,0,30,5
1683355675186,TMC 2,A01,187533,Staff,25,0,25,0
1683355675186,TMC 2,A02,187534,Staff,25,0,25,0
1683355676210,USP 1,A01,187536,Kwak; Nancy,0,16,25,25
1683355677237,USP 5,A01,187538,Staff,10,0,25,15
1683355678263,USP 101,A00,199253,Staff,0,4,0,0
1683355679287,USP 124,A00,187562,Boomhower; Matthew Charles,1,0,30,29
1683355680315,USP 138,A00,187582,Staff,20,0,25,5
1683355681344,USP 152,A01,187597,Staff,4,0,25,21
1683355682370,USP 153,A00,187598,Staff,19,0,25,6
1683355683395,USP 168,A00,187607,Kwak; Nancy,2,0,5,3
1683355684421,USP 173,A00,187619,Staff,4,0,25,21
1683355685444,USP 181,A00,187638,Staff,0,3,25,25
1683355686469,VIS 103,A00,187650,Cruz; Edwin Teddy,22,0,75,53
1683355687496,VIS 110D,A00,187669,Staff,12,0,22,10
1683355688521,VIS 127C,A00,187720,Shen; Kuiyi,67,0,146,79
1683355689547,VIS 149,A00,187731,Yoldas; Pinar,0,14,22,22
1683355690572,VIS 151,A01,188091,Staff,22,0,34,12
1683355690572,VIS 151,A02,188092,Staff,11,0,34,23
1683355691602,VIS 160B,A00,188093,Stalbaum; Brett,0,0,10,10
1683355693657,WCWP 10B,A00,201720,Staff,10,0,15,5
1683355693657,WCWP 10B,B00,201722,Staff,9,0,15,6
1683355694685,WCWP 100,A00,201725,Gagnon; Jeffrey C,0,0,2,2
1683355694685,WCWP 100,B00,201727,Staff,0,4,15,15
1683355697774,ANBI 133,A00,258401,Wilder; Linnea Lorene,34,0,40,6
1683355698802,ANBI 140,A00,258395,Hrvoj Mihic; Branka,18,0,25,7
1683355699833,ANSC 120,A00,258402,Bialecki; Jon Anthony,27,0,40,13
1683355700860,ANSC 144,A00,258400,Staff,14,0,40,26
1683355702909,ANSC 166,A00,258396,Parish; Steven Martin,157,0,175,18
1683355703934,ANSC 180,A00,193533,Staff,9,0,20,11
1683355704960,ANSC 188,A00,258397,Jassal; Aftab,33,0,40,7
1683355705985,ANTH 3,A01,258316,Staff,23,0,30,7
1683355707011,ANTH 5,A00,258394,Semendeferi; Ekaterini,16,0,20,4
1683355708035,ANTH 21,A01,258331,Staff,8,0,40,32
1683355709063,ANTH 103,A00,258398,Varma; Saiba,15,0,25,10
1683355710096,AWP 10,001,202034,Staff,0,0,0,0
1683355710096,AWP 10,002,202035,Staff,0,0,0,0
1683355710096,AWP 10,003,202036,Staff,0,0,0,0
1683355710096,AWP 10,004,202037,Staff,0,0,0,0
1683355710096,AWP 10,005,202038,Staff,0,0,0,0
1683355710096,AWP 10,006,202039,Staff,0,0,0,0
1683355710096,AWP 10,007,202040,Staff,0,0,0,0
1683355710096,AWP 10,008,202041,Staff,0,0,0,0
1683355710096,AWP 10,009,202042,Staff,0,0,0,0
1683355710096,AWP 10,010,202043,Staff,0,0,0,0
1683355710096,AWP 10,011,202044,Staff,0,0,0,0
1683355710096,AWP 10,012,202045,Staff,0,0,0,0
1683355710096,AWP 10,013,202046,Staff,0,0,0,0
1683355710096,AWP 10,014,202047,Staff,0,0,0,0
1683355710096,AWP 10,015,202048,Staff,0,0,0,0
1683355710096,AWP 10,016,202049,Staff,0,0,0,0
1683355710096,AWP 10,017,202050,Staff,0,0,0,0
1683355710096,AWP 10,018,202051,Staff,0,0,0,0
1683355710096,AWP 10,019,202052,Staff,0,0,0,0
1683355710096,AWP 10,020,202053,Staff,0,0,0,0
1683355710096,AWP 10,021,202054,Staff,0,0,0,0
1683355710096,AWP 10,022,202055,Staff,0,0,0,0
1683355710096,AWP 10,023,202056,Staff,0,0,0,0
1683355710096,AWP 10,024,202057,Staff,0,0,0,0
1683355710096,AWP 10,025,202058,Staff,0,0,0,0
1683355710096,AWP 10,026,202059,Staff,0,0,0,0
1683355711124,AWP 102,001,202032,Staff,0,0,0,0
1683355711124,AWP 102,002,202033,Staff,0,0,0,0
1683355712149,BENG 100,A01,254234,Taylor Amos; Alyssa C,31,0,40,9
1683355713176,BENG 196,001,270013,Engler; Adam J.,9999,0,9999,0
1683355714203,BICD 100R,A01,202018,Smith; Laurie,0,7,32,32
1683355714203,BICD 100R,A02,202019,Smith; Laurie,0,2,32,32
1683355714203,BICD 100R,A03,202020,Smith; Laurie,0,1,32,32
1683355714203,BICD 100R,A04,202021,Smith; Laurie,9,0,32,23
1683355714203,BICD 100R,A05,202022,Smith; Laurie,12,0,32,20
1683355715234,BICD 136,A01,193242,Gustafson-Brown; Cindy,0,2,32,32
1683355715234,BICD 136,A02,193244,Gustafson-Brown; Cindy,14,0,32,18
1683355716267,BIEB 102,A01,193249,Butler; Shannon Rhey,0,2,32,32
1683355716267,BIEB 102,A02,193251,Butler; Shannon Rhey,0,0,32,32
1683355716267,BIEB 102,A03,193253,Butler; Shannon Rhey,0,1,32,32
1683355716267,BIEB 102,A04,193255,Butler; Shannon Rhey,17,0,32,15
1683355716267,BIEB 102,A05,193265,Butler; Shannon Rhey,26,0,32,6
1683355716267,BIEB 102,A06,193269,Butler; Shannon Rhey,16,0,32,16
1683355718322,BIEB 150,A01,193274,Staff,0,0,32,32
1683355718322,BIEB 150,A02,193285,Staff,23,0,32,9
1683355719345,BIEB 194,A00,193286,Kurle; Carolyn M.,22,0,32,10
1683355720375,BILD 1,A01,192291,Staff,16,0,32,16
1683355720375,BILD 1,A02,192292,Staff,30,0,32,2
1683355720375,BILD 1,B01,192520,Reuther; Keefe,0,1,0,0
1683355720375,BILD 1,B02,192532,Reuther; Keefe,0,1,0,0
1683355721400,BILD 3,A01,192556,Butler; Shannon Rhey,0,0,32,32
1683355721400,BILD 3,A02,192581,Butler; Shannon Rhey,4,0,32,28
1683355721400,BILD 3,A03,192611,Butler; Shannon Rhey,23,0,32,9
1683355721400,BILD 3,A04,192612,Butler; Shannon Rhey,25,0,32,7
1683355721400,BILD 3,A05,192613,Butler; Shannon Rhey,27,0,32,5
1683355721400,BILD 3,A06,192679,Butler; Shannon Rhey,27,0,32,5
1683355721400,BILD 3,A07,192682,Butler; Shannon Rhey,22,0,32,10
1683355722424,BILD 4,A01,192836,Reuther; Keefe,0,0,24,24
1683355722424,BILD 4,A02,193044,Reuther; Keefe,4,0,24,20
1683355723448,BILD 10,A01,193142,Gustafson-Brown; Cindy,30,0,32,2
1683355723448,BILD 10,A02,193149,Gustafson-Brown; Cindy,31,0,32,1
1683355724472,BIMM 100,A01,193301,Staff,0,6,32,32
1683355724472,BIMM 100,A02,193312,Staff,0,5,32,32
1683355724472,BIMM 100,A03,193323,Staff,0,8,32,32
1683355725498,BIMM 101,A01,193329,McDonnell; Lisa Marie,0,3,24,24
1683355725498,BIMM 101,A02,193339,McDonnell; Lisa Marie,0,3,24,24
1683355725498,BIMM 101,B01,193354,McDonnell; Lisa Marie,0,3,24,24
1683355725498,BIMM 101,B02,193357,McDonnell; Lisa Marie,0,3,24,24
1683355726523,BIMM 110,A01,193377,Tat; John,0,11,32,32
1683355726523,BIMM 110,A02,193378,Tat; John,0,9,32,32
1683355727549,BIMM 120,A01,206116,Staff,0,0,32,32
1683355727549,BIMM 120,A02,206117,Staff,8,0,32,24
1683355727549,BIMM 120,A03,206121,Staff,21,0,32,11
1683355728579,BIPN 100,A01,193393,Park; Ji Young,0,14,32,32
1683355728579,BIPN 100,A02,193402,Park; Ji Young,0,13,32,32
1683355728579,BIPN 100,A03,193413,Park; Ji Young,0,14,32,32
1683355728579,BIPN 100,A04,193414,Park; Ji Young,0,13,32,32
1683355729610,BIPN 102,A01,193429,Staff,0,0,32,32
1683355729610,BIPN 102,A02,193438,Staff,22,0,32,10
1683355730640,BIPN 106,A01,193450,Reyes Gonzalez; Catalina,0,2,40,40
1683355731671,BIPN 134,A01,193465,Cooke; James Edward,1,0,32,31
1683355731671,BIPN 134,A02,193474,Cooke; James Edward,25,0,32,7
1683355731671,BIPN 134,A03,193485,Cooke; James Edward,29,0,32,3
1683355731671,BIPN 134,A04,193486,Cooke; James Edward,21,0,32,11
1683355731671,BIPN 134,A05,193491,Cooke; James Edward,31,0,32,1
1683355731671,BIPN 134,A06,193501,Cooke; James Edward,30,0,32,2
1683355731671,BIPN 134,A07,193510,Cooke; James Edward,29,0,32,3
1683355733726,BISP 194,A00,222522,Staff,14,0,32,18
1683355734752,CAT 124,A01,202407,Staff,20,0,25,5
1683355735777,CAT 125,A00,202408,Marchisotto; Jennifer Anne,4,0,20,16
1683355736802,CAT 125R,A00,202409,Smith; Lauryn Alissa,0,11,20,20
1683355736802,CAT 125R,B00,202410,Morales; Celeste Georgianna,0,11,20,20
1683355736802,CAT 125R,C00,202411,Irwin; Matthew Joseph,0,10,20,20
1683355737831,CENG 15,A01,204712,Yang; Kesong,0,1,0,0
1683355738860,CENG 114,A00,202070,Jahed Motlagh; Zeinab,5,0,20,15
1683355739887,CGS 105,A00,185477,Wesling; Megan E.,24,0,40,16
1683355740911,CGS 106,A00,185494,Staff,13,0,22,9
1683355741935,CGS 108,A00,185495,Staff,14,0,20,6
1683355742959,CGS 114,A00,185496,Staff,13,0,18,5
1683355743986,CGS 119,A00,185501,Staff,15,0,20,5
1683355745015,CGS 120,A00,185511,Staff,13,0,20,7
1683355746045,CHEM 4,A01,184675,Bussey; Thomas J,96,0,100,4
1683355747072,CHEM 6A,A01,184677,Staff,34,0,60,26
1683355748098,CHEM 6B,A01,184679,Staff,65,0,100,35
1683355749123,CHEM 6C,A01,184681,Bussey; Thomas J,1,0,50,49
1683355749123,CHEM 6C,A02,184682,Bussey; Thomas J,34,0,50,16
1683355750148,CHEM 40A,A01,184684,Albizati; Kim F.,37,0,100,63
1683355751173,CHEM 40B,A01,184686,Albizati; Kim F.,0,20,100,100
1683355752197,CHEM 41B,A01,184690,Staff,52,0,100,48
1683355753220,COGS 3,A01,184715,Boyle; Mary E. T.,0,25,40,40
1683355754245,COGS 14B,A01,185172,Staff,0,15,38,38
1683355755270,COGS 18,A01,184736,Staff,17,0,80,63
1683355756295,COGS 100,A01,184932,Staff,0,5,73,73
1683355757319,COGS 101A,A01,184935,Staff,0,39,30,30
1683355758348,COGS 101B,A01,184944,Staff,0,2,30,30
1683355759376,COGS 101C,A01,184946,Staff,0,12,30,30
1683355760402,COGS 102A,A01,184951,Johnson; Christine M.,2,0,40,38
1683355761430,COGS 107B,A01,184953,Mooshagian; Eric Frederick,0,50,40,40
1683355762457,COGS 118B,A01,184959,Gupta; Anjum,0,48,40,40
1683355763485,COGS 153,A00,184961,Staff,0,15,30,30
1683355764508,COGS 177,A00,184962,Staff,0,20,30,30
1683355765533,COGS 187A,A01,184969,Boyle; Mary E. T.,0,17,40,40
1683355766559,COMM 10,A01,185174,Staff,0,5,25,25
1683355766559,COMM 10,A02,185189,Staff,0,5,25,25
1683355766559,COMM 10,A03,269821,Staff,0,0,0,0
1683355767586,COMM 100B,A01,185475,Staff,0,0,0,2
1683355767586,COMM 100B,A02,185476,Staff,13,0,25,12
1683355768669,COMM 100C,A01,185314,Staff,1,0,25,24
1683355768669,COMM 100C,A02,185327,Staff,19,0,25,6
1683355769693,COMM 110M,A00,185349,Staff,2,0,40,38
1683355770718,COMM 113T,A00,185352,Staff,24,0,40,16
1683355771745,COMM 114I,A00,185353,Staff,33,0,40,7
1683355772769,COMM 131,A00,185354,Staff,19,0,30,11
1683355773796,CSE 8A,A50,185358,Cao; Yingjun,0,46,10,10
1683355774822,CSE 8B,A01,185362,Staff,0,46,50,50
1683355775846,CSE 11,A01,185416,Cao; Yingjun,0,92,10,10
1683355776877,CSE 20,A01,185445,Briones; Jor-el Thomas Caparas,5,0,25,20
1683355777904,CSE 21,A01,185447,Staff,10,0,50,40
1683355778934,CSE 101,A01,185451,Staff,0,13,50,50
1683355778934,CSE 101,B01,185453,Jones; Miles E,0,11,50,50
1683355780985,CSE 141,A01,185458,Eldon; John,20,0,100,80
1683355782010,CSE 141L,A01,185461,Eldon; John,12,0,100,88
1683355783034,CSE 142,A01,185463,Staff,36,0,60,24
1683355783034,CSE 142,B01,201355,Staff,0,7,60,60
1683355784061,CSE 142L,A01,185470,Staff,36,0,60,24
1683355784061,CSE 142L,B01,201417,Staff,0,6,60,60
1683355785086,CSE 190,A00,201433,Staff,32,0,49,17
1683355786111,DOC 1,A01,259136,Strom; Megan C.,7,0,15,8
1683355786111,DOC 1,A02,259137,Strom; Megan C.,14,0,15,1
1683355786111,DOC 1,A03,259138,Strom; Megan C.,14,0,15,1
1683355786111,DOC 1,A04,259139,Strom; Megan C.,14,0,15,1
1683355787135,DOC 100D,A00,259140,Pass; Natalye Joann,16,0,25,9
1683355788160,DSGN 1,A01,184749,Rill; Bryan,0,25,30,30
1683355789185,DSGN 100,A01,185168,Staff,0,2,25,25
1683355790214,ECE 5,A01,185626,Morris; Karcher William,0,10,0,0
1683355791242,ECE 101,A01,185628,Staff,17,0,70,53
1683355792271,ECE 107,A01,185635,Baghdadchi; Saharnaz,0,0,20,20
1683355792271,ECE 107,A02,185638,Baghdadchi; Saharnaz,4,0,20,16
1683355793299,ECE 148,A01,185647,Silberman; Jack,0,0,16,16
1683355794327,ECON 1,A01,185537,Crane; Meredith Helen,54,0,70,16
1683355795354,ECON 3,A01,185549,Crane; Meredith Helen,32,0,70,38
1683355796378,ECON 4,A01,203354,Anderson; John Charles,0,4,10,10
1683355797406,ECON 100A,A01,185574,Staff,0,4,40,40
1683355798434,ECON 100B,A01,185576,Staff,0,12,50,50
1683355799457,ECON 100C,A01,185589,Newhouse; Herbert S,29,0,70,41
1683355800486,ECON 105,A00,185608,Vespa; Emanuel Ignacio,19,0,35,16
1683355801514,ECON 109,A01,185610,Shishkin; Denis,10,0,35,25
1683355802539,ECON 110A,A01,185612,Staff,11,0,40,29
1683355803566,ECON 120A,A01,185615,Staff,20,0,40,20
1683355804594,ECON 120C,A01,185617,Sun; Yixiao,0,21,70,70
1683355805619,ECON 144,A00,203346,Squires; Dale E,3,0,35,32
1683355806642,ECON 171,A01,203349,Newhouse; Herbert S,0,1,35,35
1683355807666,ECON 173A,A01,185621,Toda; Alexis Akira,21,0,35,14
1683355808691,EDS 25,A01,202413,Staff,0,1,0,0
1683355808691,EDS 25,A02,202414,Staff,0,1,0,0
1683355808691,EDS 25,A03,202415,Staff,0,0,0,0
1683355808691,EDS 25,A04,202416,Staff,0,1,0,0
1683355808691,EDS 25,A05,202439,Staff,0,0,0,0
1683355808691,EDS 25,A06,202440,Staff,0,0,0,0
1683355808691,EDS 25,B01,202631,Staff,0,0,0,0
1683355808691,EDS 25,B02,202632,Staff,0,0,0,0
1683355808691,EDS 25,B03,202639,Staff,0,0,0,0
1683355808691,EDS 25,B04,202640,Staff,0,0,0,0
1683355808691,EDS 25,B05,202643,Staff,0,0,0,0
1683355808691,EDS 25,B06,202644,Staff,0,0,0,0
1683355809718,EDS 38,A01,202659,Black; Alison Michelle,24,0,25,1
1683355810742,EDS 115,A00,202652,Staff,18,0,30,12
1683355811770,EDS 125,A00,202649,Staff,14,0,30,16
1683355812800,EDS 126,A01,203332,Staff,30,0,30,0
1683355813827,EDS 139,A00,202838,Staff,16,0,25,9
1683355814852,EDS 146,A01,202655,Staff,14,0,25,11
1683355815877,ENG 15,A00,185667,Staff,0,1,0,0
1683355815877,ENG 15,B00,185672,Staff,0,0,0,0
1683355815877,ENG 15,C00,185675,Staff,0,0,0,0
1683355815877,ENG 15,D00,185682,Staff,0,0,0,0
1683355815877,ENG 15,E00,185684,Staff,0,0,0,0
1683355816907,ETHN 103,A00,185710,Staff,0,4,35,35
1683355817931,ETHN 103A,A00,199228,Man; Simeon S,2,0,9,7
1683355818958,ETHN 109,A00,185711,Staff,18,0,35,17
1683355819985,ETHN 142,A00,185726,Staff,0,4,30,30
1683355821013,ETHN 163J,A00,199229,Man; Simeon S,5,0,8,3
1683355822039,ETHN 168,A00,185727,Staff,8,0,10,2
1683355823063,ETHN 182,A00,185728,Staff,0,0,35,35
1683355824086,ETHN 183,A00,185737,Staff,8,0,18,10
1683355825111,GLBH 111,A01,209361,Burgos; Jose L.,0,0,0,0
1683355827161,HIEU 104,A00,185792,Staff,16,0,20,4
1683355828184,HIEU 115,A00,185800,Staff,1,0,20,19
1683355829207,HIEU 128,A00,185801,Staff,0,7,20,20
1683355830231,HIEU 147,A00,185802,Staff,16,0,20,4
1683355831255,HIEU 154,A00,185823,Staff,12,0,20,8
1683355832283,HILA 102,A00,185826,Staff,13,0,20,7
1683355833308,HILD 2C,A01,185778,Staff,0,12,20,20
1683355834337,HILD 7B,A01,185780,Kwak; Nancy,0,15,32,32
1683355834337,HILD 7B,A02,185781,Kwak; Nancy,0,18,32,32
1683355835364,HILD 30,A01,185791,Staff,14,0,20,6
1683355836386,HISC 119,A00,185830,Golan; Tal,0,9,20,20
1683355837410,HITO 156GS,A00,185831,Patterson; Patrick H.,0,0,0,23
1683355838438,HIUS 103,A00,185832,Man; Simeon S,0,6,20,20
1683355839463,HIUS 117,A00,185836,Kwak; Nancy,2,0,20,18
1683355840488,HIUS 125,A00,185840,Man; Simeon S,0,0,23,23
1683355841512,HIUS 149,A00,185845,Staff,0,0,20,20
1683355842539,HUM 3,A01,185882,Zavodny; Tatiana Sophia,0,7,50,50
1683355842539,HUM 3,B01,185899,Caldwell; Michael Alan,0,18,50,50
1683355843562,HUM 3GS,A00,185900,Patterson; Patrick H.,0,0,0,23
1683355844588,HUM 4,A01,185938,Zroka; Amy Liane,31,0,50,19
1683355844588,HUM 4,B01,185956,Watkins; Eric,0,3,50,50
1683355844588,HUM 4,B02,202209,Watkins; Eric,0,2,50,50
1683355844588,HUM 4,B03,202210,Watkins; Eric,0,2,50,50
1683355845616,HUM 5,A01,185958,West; Geoffrey Scott,3,0,50,47
1683355845616,HUM 5,A02,202215,West; Geoffrey Scott,0,0,50,50
1683355846641,INTL 190,A00,185959,Gagnon; Jeffrey C,0,0,0,9
1683355846641,INTL 190,B00,185960,Lettieri; Michael Joseph,0,0,0,1
1683355847664,JAPN 180,A00,254509,Staff,4,0,30,26
1683355848689,LATI 10,A01,202853,Kennemore; Amy Michelle,4,0,35,31
1683355848689,LATI 10,A02,202854,Kennemore; Amy Michelle,2,0,35,33
1683355848689,LATI 10,A03,270054,Kennemore; Amy Michelle,30,0,30,0
1683355849713,LATI 180,A00,202855,Kennemore; Amy Michelle,11,0,20,9
1683355850738,LAWS 101,A00,201767,Golan; Tal,0,7,40,40
1683355851761,LIFR 1C,A00,185961,Staff,6,0,20,14
1683355852785,LIFR 1CX,A00,185962,Staff,7,0,20,13
1683355853809,LIFR 1D,A00,185963,Staff,9,0,20,11
1683355854835,LIFR 1DX,A00,185964,Staff,9,0,20,11
1683355855859,LIGN 101,A01,186039,Staff,43,0,50,7
1683355856887,LIGN 165,A00,186040,Staff,18,0,50,32
1683355857914,LTCS 108,A00,186041,Staff,6,0,10,4
1683355858941,LTCS 119,A00,186042,Staff,16,0,20,4
1683355859964,LTCS 130,A00,186043,Wesling; Megan E.,15,0,25,10
1683355862014,LTEA 138,A00,186119,Staff,14,0,40,26
1683355863038,LTEN 124,A00,186148,Staff,6,0,25,19
1683355864063,LTEN 178,A00,186149,Staff,7,0,15,8
1683355865088,LTEN 181,A00,186150,Blanco; John D,33,0,40,7
1683355866113,LTWL 120,A00,186160,Staff,20,0,25,5
1683355867141,LTWL 165,A00,186161,Staff,22,0,25,3
1683355868169,LTWR 100,A00,186162,Staff,0,5,15,15
1683355869194,LTWR 102,A00,186163,Doller; Ben,5,0,15,10
1683355870218,MAE 8,A01,186412,Staff,0,0,0,0
1683355871243,MAE 30B,A00,186445,Bahadori; Mohammad Yousef,83,0,100,17
1683355872325,MAE 40,A00,186592,Bewley; Thomas R,10,0,50,40
1683355873351,MAE 101B,A00,186593,Bahadori; Mohammad Yousef,81,0,100,19
1683355874378,MAE 105,A00,186594,Bandaru; Prabhakar,12,0,50,38
1683355875406,MAE 107,A00,186599,Pham; Hieu Tan,0,7,120,120
1683355876430,MAE 148,A01,186660,Silberman; Jack,3,0,16,13
1683355877459,MATH 10A,A01,188095,Staff,0,5,35,35
1683355878483,MATH 10B,A01,188097,Bowers; Adam R.,0,11,30,30
1683355878483,MATH 10B,A02,188099,Bowers; Adam R.,0,11,30,30
1683355878483,MATH 10B,B01,188104,Bowers; Adam R.,0,10,30,30
1683355878483,MATH 10B,B02,188106,Bowers; Adam R.,0,10,30,30
1683355879509,MATH 10C,A01,188111,Staff,0,18,30,30
1683355879509,MATH 10C,A02,188127,Staff,0,17,30,30
1683355879509,MATH 10C,A03,188131,Staff,0,18,30,30
1683355879509,MATH 10C,B01,188218,Staff,18,0,30,12
1683355879509,MATH 10C,B02,188244,Staff,13,0,30,17
1683355879509,MATH 10C,B03,188277,Staff,16,0,30,14
1683355880534,MATH 18,A01,188344,Bach; Quang Tran,18,0,30,12
1683355880534,MATH 18,A02,188345,Bach; Quang Tran,11,0,30,19
1683355880534,MATH 18,B01,188353,Bach; Quang Tran,10,0,30,20
1683355880534,MATH 18,B02,188354,Bach; Quang Tran,20,0,30,10
1683355881559,MATH 20A,A01,188374,Staff,12,0,35,23
1683355882585,MATH 20B,A01,188382,Ohm; Ko Woon,6,0,30,24
1683355882585,MATH 20B,A02,188383,Ohm; Ko Woon,22,0,30,8
1683355882585,MATH 20B,B01,188385,Ohm; Ko Woon,7,0,30,23
1683355882585,MATH 20B,B02,188392,Ohm; Ko Woon,22,0,30,8
1683355883611,MATH 20C,A01,188394,Harel; Guershon,10,0,30,20
1683355883611,MATH 20C,A02,188395,Harel; Guershon,15,0,30,15
1683355883611,MATH 20C,B01,188404,Harel; Guershon,4,0,30,26
1683355883611,MATH 20C,B02,188405,Harel; Guershon,19,0,30,11
1683355884637,MATH 20D,A01,188414,Hammock; Frances H,0,1,30,30
1683355884637,MATH 20D,A02,188415,Hammock; Frances H,3,0,30,27
1683355884637,MATH 20D,B01,188447,Hammock; Frances H,1,0,30,29
1683355884637,MATH 20D,B02,188486,Hammock; Frances H,8,0,30,22
1683355885665,MATH 20E,A01,188649,Staff,21,0,30,9
1683355885665,MATH 20E,A02,188650,Staff,23,0,30,7
1683355885665,MATH 20E,A03,188673,Staff,0,0,30,30
1683355886689,MATH 102,A01,188675,Staff,0,35,35,35
1683355887714,MATH 103B,A01,188681,Staff,3,0,35,32
1683355887714,MATH 103B,B01,188692,Staff,5,0,35,30
1683355888743,MATH 109,A01,188695,Salehi Golsefidy; Alireza,25,0,35,10
1683355888743,MATH 109,A02,188696,Salehi Golsefidy; Alireza,25,0,35,10
1683355889772,MATH 120A,A01,188698,Eggers; John Dietrich,7,0,35,28
1683355890801,MATH 142B,A01,188736,Ioana; Adrian,0,2,30,30
1683355890801,MATH 142B,A02,188741,Ioana; Adrian,0,0,30,30
1683355890801,MATH 142B,A03,188743,Ioana; Adrian,0,1,30,30
1683355891830,MATH 168A,A01,188790,Staff,0,9,35,35
1683355892855,MATH 170A,A01,188803,Nie; Jiawang,0,2,35,35
1683355892855,MATH 170A,A02,188811,Nie; Jiawang,0,0,35,35
1683355892855,MATH 170A,A03,188814,Nie; Jiawang,1,0,35,34
1683355892855,MATH 170A,A04,188815,Nie; Jiawang,13,0,35,22
1683355893878,MATH 193B,A01,188817,Staff,0,0,35,35
1683355893878,MATH 193B,A02,188818,Staff,5,0,35,30
1683355894902,MGT 4,A01,202857,Anderson; John Charles,61,0,80,19
1683355895926,MGT 12,A00,202858,Lindenberger; Wade Douglas,42,0,90,48
1683355896950,MGT 18,A00,202859,Staff,74,0,90,16
1683355897978,MGT 18GS,A00,202860,McKay; Michael J,13,0,28,15
1683355899005,MGT 45,A00,202861,Pecore; Joseph P.,14,0,90,76
1683355900034,MGT 100,A00,202863,Yavorsky; Daniel Ryan,28,0,90,62
1683355901062,MGT 103,A00,202864,Ehrich; Kristine R,0,17,90,90
1683355902092,MGT 112,A00,202865,Ehrich; Kristine R,15,0,90,75
1683355903117,MGT 121A,A00,202868,Staff,0,20,0,0
1683355904141,MGT 131B,A00,202869,Anderson; John Charles,59,0,90,31
1683355905169,MGT 136,A00,202871,Lindenberger; Wade Douglas,84,0,90,6
1683355906193,MGT 164,A00,202873,Staff,0,68,90,91
1683355907218,MGT 164GS,A00,202874,McKay; Mary A,13,0,28,15
1683355908262,MGT 180,A00,202875,Staff,0,50,90,91
1683355909290,MMW 11R,A01,205019,Herbst; Matthew,3,0,30,27
1683355909290,MMW 11R,A02,205026,Herbst; Matthew,29,0,30,1
1683355910316,MMW 15,A01,193512,Chang; Edmond Yi-Teh,0,9,28,28
1683355910316,MMW 15,A02,193513,Chang; Edmond Yi-Teh,0,5,28,28
1683355910316,MMW 15,A03,193514,Chang; Edmond Yi-Teh,0,5,28,28
1683355910316,MMW 15,A04,193515,Chang; Edmond Yi-Teh,0,5,28,28
1683355910316,MMW 15,A05,193516,Chang; Edmond Yi-Teh,0,4,28,28
1683355910316,MMW 15,A06,193517,Chang; Edmond Yi-Teh,0,5,28,28
1683355910316,MMW 15,B01,193519,Chang; Edmond Yi-Teh,0,5,28,28
1683355910316,MMW 15,B02,193520,Chang; Edmond Yi-Teh,0,5,28,28
1683355910316,MMW 15,B03,193521,Chang; Edmond Yi-Teh,0,5,28,28
1683355910316,MMW 15,B04,193522,Chang; Edmond Yi-Teh,0,4,28,28
1683355910316,MMW 15,B05,193523,Chang; Edmond Yi-Teh,0,5,28,28
1683355910316,MMW 15,B06,193524,Chang; Edmond Yi-Teh,0,4,28,28
1683355911342,MMW 122,A01,193526,Rahimi; Babak,0,15,28,28
1683355911342,MMW 122,A02,193527,Rahimi; Babak,0,14,28,28
1683355911342,MMW 122,A03,193528,Rahimi; Babak,0,0,0,0
1683355911342,MMW 122,A04,193529,Rahimi; Babak,0,0,0,0
1683355912370,MUS 1A,A01,186663,Staff,0,20,35,35
1683355913399,MUS 4,A01,186715,Staff,0,12,35,35
1683355914428,MUS 5R,A01,186796,Dubnov; Shlomo,0,17,35,35
1683355915457,MUS 6,A01,186798,Staff,0,4,25,25
1683355916482,MUS 7,A01,186830,Staff,13,0,35,22
1683355917506,MUS 8,A01,186930,Staff,0,26,35,35
1683355918532,MUS 15,A01,186932,Staff,0,16,35,35
1683355918532,MUS 15,B01,186934,Staff,0,15,35,35
1683355919560,MUS 80,A00,186935,Staff,1,0,20,19
1683355919560,MUS 80,B00,186936,Staff,25,0,25,0
1683355920586,NANO 11,A00,204702,Lipomi; Darren John,0,0,0,0
1683355921617,NANO 15,A01,204709,Yang; Kesong,0,1,0,0
1683355922641,NANO 114,A00,202069,Jahed Motlagh; Zeinab,3,0,10,7
1683355923671,PHIL 1,A00,186955,Grush; Rick Scott,32,0,40,8
1683355924696,PHIL 10,A01,186973,Grush; Rick Scott,28,0,35,7
1683355924696,PHIL 10,A02,186974,Grush; Rick Scott,33,0,35,2
1683355925724,PHIL 13,A01,186976,Staff,7,0,35,28
1683355925724,PHIL 13,A02,186977,Staff,16,0,35,19
1683355926751,PHIL 14,A01,186979,Staff,31,0,35,4
1683355926751,PHIL 14,A02,186986,Staff,32,0,35,3
1683355927775,PHIL 28,A01,186988,Staff,16,0,30,14
1683355927775,PHIL 28,A02,186989,Staff,1,0,30,29
1683355927775,PHIL 28,A03,186990,Staff,9,0,30,21
1683355927775,PHIL 28,A04,186991,Staff,26,0,30,4
1683355928799,PHIL 120,A00,186997,Staff,23,0,40,17
1683355929825,PHIL 137,A00,187003,Staff,9,0,40,31
1683355930851,PHIL 150,A00,187015,Staff,47,0,70,23
1683355931875,PHIL 167,A00,187021,Lamey; Andy M.,35,0,40,5
1683355932901,PHIL 174,A01,202226,Staff,17,0,20,3
1683355932901,PHIL 174,A02,202235,Staff,20,0,20,0
1683355933926,PHIL 191A,A00,258918,Staff,0,0,1,1
1683355934951,PHYS 1A,A00,187028,Staff,27,0,60,33
1683355935975,PHYS 1AL,001,187036,Staff,2,0,30,28
1683355935975,PHYS 1AL,002,187049,Staff,18,0,30,12
1683355937001,PHYS 1B,A00,187058,Staff,22,0,60,38
1683355938027,PHYS 1BL,001,187064,Staff,0,0,30,30
1683355938027,PHYS 1BL,002,187070,Staff,5,0,30,25
1683355939051,PHYS 1C,A00,187082,Staff,31,0,120,89
1683355940074,PHYS 1CL,001,187088,Staff,0,9,30,30
1683355940074,PHYS 1CL,002,187089,Staff,0,2,30,30
1683355940074,PHYS 1CL,009,262693,Staff,11,0,30,19
1683355941099,PHYS 2B,A01,187097,Staff,54,0,115,61
1683355942124,PHYS 2C,A01,187099,Staff,67,0,115,48
1683355943149,PHYS 2CL,A01,187101,Staff,5,0,28,23
1683355943149,PHYS 2CL,A02,187102,Staff,15,0,28,13
1683355944173,PHYS 2D,A01,187123,Shotwell; Brian,95,0,115,20
1683355945196,PHYS 4B,A01,187133,Grinstein; Benjamin,35,0,50,15
1683355946223,POLI 10,A00,188819,Staff,0,4,50,50
1683355947250,POLI 11,A00,188827,Staff,43,0,50,7
1683355948272,POLI 13R,A00,188828,Staff,0,1,20,20
1683355949297,POLI 27,A01,188830,Elgin; Samuel Zincke,0,1,70,70
1683355950325,POLI 30,A00,188832,Desposato; Scott,31,0,50,19
1683355951353,POLI 102F,A00,188834,Staff,3,0,40,37
1683355952377,POLI 104A,A00,188852,Staff,14,0,30,16
1683355953402,POLI 104I,A00,188853,Staff,0,6,20,20
1683355954430,POLI 110B,A00,188854,Wiens; David,7,0,20,13
1683355955459,POLI 112A,A00,188855,Wiens; David,5,0,30,25
1683355956485,POLI 117R,A00,188856,Forman; Fonna,0,11,20,20
1683355957509,POLI 118,A00,188857,Ingham; Sean,8,0,20,12
1683355958534,POLI 120G,A00,188858,Staff,9,0,30,21
1683355959558,POLI 131CR,A00,188863,Hoston; Germaine,23,0,50,27
1683355960582,POLI 133,A00,188864,Nellis; Gareth Hb,44,0,50,6
1683355961609,POLI 134D,A00,188865,Desposato; Scott,27,0,30,3
1683355962637,POLI 142A,A00,188871,Gartzke; Erik,22,0,50,28
1683355963664,POLI 142K,A00,188874,Staff,38,0,50,12
1683355964688,POLI 143,A00,188940,Gartzke; Erik,16,0,30,14
1683355965711,POLI 153,A00,188943,Staff,3,0,20,17
1683355966735,POLI 160AA,A00,188944,Staff,11,0,40,29
1683355967758,POLI 170A,A00,188945,Staff,11,0,30,19
1683355969810,PSYC 1,A00,188952,Staff,37,0,90,53
1683355970834,PSYC 2,B00,188953,Staff,19,0,35,16
1683355971858,PSYC 6,A00,188970,Staff,47,0,60,13
1683355972882,PSYC 7,A00,188973,Staff,37,0,45,8
1683355973906,PSYC 60,A01,188980,Rickard; Timothy C.,43,0,60,17
1683355974937,PSYC 70,A01,189001,Steiner; Eric Tomas,23,0,45,22
1683355976021,PSYC 100,A00,189005,Lacefield; Katharine I,0,98,120,120
1683355977046,PSYC 102,A00,189008,Staff,9,0,30,21
1683355978073,PSYC 106,B00,189026,Gorman; Michael R.,34,0,60,26
1683355979098,PSYC 114,B01,189033,Winkielman; Piotr,0,32,30,30
1683355980122,PSYC 131,A00,189036,Anagnostaras; Stephan,0,43,60,60
1683355981145,PSYC 136,A00,189041,Lowe; Angela Beth,0,7,25,25
1683355982169,PSYC 137,A00,189057,Winkielman; Piotr,0,34,25,25
1683355983193,PSYC 144,A00,189107,Wixted; John T,0,7,50,50
1683355985243,PSYC 162,A00,189142,Staff,0,8,85,85
1683355986267,PSYC 172,A00,189144,Gorman; Michael R.,0,7,30,30
1683355988317,PSYC 179,A00,189146,Lacefield; Katharine I,0,84,120,120
1683355989342,PSYC 181,A00,189147,Anagnostaras; Stephan,0,44,90,90
1683355990368,PSYC 190R,A00,189148,Barner; David A.,0,22,80,80
1683355991395,PSYC 191,A00,189275,Rickard; Timothy C.,0,7,25,25
1683355992422,PSYC 193,A00,189276,Chapman; Eddie Nathaniel,0,1,0,4
1683355993446,PSYC 193L,A01,189281,Lowe; Angela Beth,12,0,20,8
1683355993446,PSYC 193L,B01,189285,Staff,28,0,35,7
1683355994470,RELI 149,A00,187137,Rahimi; Babak,7,0,40,33
1683355995496,SE 9,A01,187315,Staff,0,2,18,18
1683355996524,SE 101B,A00,187409,Staff,24,0,30,6
1683355997551,SE 110B,A00,187444,Staff,10,0,40,30
1683355998579,SE 130B,A00,187449,Staff,31,0,40,9
1683355999605,SE 150A,A00,187516,Staff,9,0,20,11
1683356000634,SE 154,A00,187528,Staff,30,0,50,20
1683356001662,SIO 3,A01,258171,Staff,35,0,40,5
1683356002686,SIO 10,A00,187144,Cook; Geoffrey W,0,3,75,75
1683356003711,SIO 45,A00,187152,Cook; Geoffrey W,1,0,100,99
1683356004739,SIO 109R,A00,194486,Staff,0,3,20,20
1683356006791,SIO 187,A01,187233,Kacev; David,12,0,40,28
1683356007816,SOCI 1,A01,258656,Thorpe; Charles Robert,28,0,30,2
1683356007816,SOCI 1,A02,258658,Thorpe; Charles Robert,30,0,30,0
1683356007816,SOCI 1,A03,258661,Thorpe; Charles Robert,25,0,25,0
1683356007816,SOCI 1,A04,258666,Thorpe; Charles Robert,22,0,25,3
1683356007816,SOCI 1,A05,258897,Thorpe; Charles Robert,23,0,25,2
1683356007816,SOCI 1,A06,258898,Thorpe; Charles Robert,25,0,25,0
1683356008841,SOCI 30,A01,258903,Pardo Guerra; Juan Pablo,15,0,30,15
1683356009867,SOCI 102,A00,258904,Staff,9,0,25,16
1683356010896,SOCI 106,A00,258905,Staff,19,0,25,6
1683356011920,SOCI 111,A00,258907,Ribas Norris; Janet Vanesa,26,0,30,4
1683356012945,SOCI 121R,A00,258908,Pardo Guerra; Juan Pablo,10,0,30,20
1683356013969,SOCI 126,A01,203330,Staff,14,0,20,6
1683356014997,SOCI 131,A00,258909,Thorpe; Charles Robert,31,0,60,29
1683356016022,SOCI 135,A00,258910,Payne; Christine Anna,0,9,30,30
1683356017047,SOCI 157,A00,258911,Staff,12,0,30,18
1683356018071,SOCI 184,A00,258912,Staff,25,0,30,5
1683356019095,SOCI 188D,A00,258913,Staff,22,0,30,8
1683356020122,SYN 2,001,187529,Staff,10,0,16,6
1683356020122,SYN 2,002,201452,Staff,0,18,16,16
1683356020122,SYN 2,003,201469,Staff,3,0,16,13
1683356021147,SYN 100,A01,187531,Staff,0,9,20,20
1683356021147,SYN 100,B01,201491,Staff,0,12,20,20
1683356022173,TDAC 1,A00,189286,Walsh; Kim C.,3,0,20,17
1683356022173,TDAC 1,B00,189287,Harting; Carla Kelso,11,0,20,9
1683356023201,TDAC 101,A00,189300,Walsh; Kim C.,16,0,20,4
1683356023201,TDAC 101,B00,189301,Harting; Carla Kelso,18,0,20,2
1683356024229,TDAC 102,A00,189304,Basso; Beatrice,14,0,20,6
1683356025256,TDAC 108,A00,189305,Staff,18,0,20,2
1683356026281,TDDE 131,A00,189310,Staff,19,0,20,1
1683356026281,TDDE 131,B00,189314,Staff,19,0,20,1
1683356026281,TDDE 131,C00,189315,Staff,48,0,50,2
1683356026281,TDDE 131,D00,189316,Staff,14,0,15,1
1683356026281,TDDE 131,E00,204841,Staff,20,0,20,0
1683356027306,TDGE 10,A00,189289,Staff,30,0,50,20
1683356027306,TDGE 10,B00,189290,Havis; Allan,1,0,50,49
1683356028330,TDGE 11,A00,189291,Fulton; Julia,0,3,50,50
1683356028330,TDGE 11,B00,189292,Staff,20,0,25,5
1683356028330,TDGE 11,C00,260270,Staff,0,0,0,0
1683356029352,TDGE 25,A00,189294,Staff,3,0,20,17
1683356030379,TDGE 124,A00,189318,Fulton; Julia,0,8,50,50
1683356031406,TDGE 125,A00,189319,Staff,13,0,25,12
1683356031406,TDGE 125,B00,189320,Staff,23,0,25,2
1683356032430,TDGE 127,A00,189322,Havis; Allan,0,0,50,50
1683356033455,TDHT 101,A00,189323,Staff,18,0,25,7
1683356033455,TDHT 101,B00,189324,Staff,25,0,25,0
1683356034482,TDHT 102,A00,189325,Staff,49,0,50,1
1683356035509,TDMV 1,A00,189295,Arcidiacono; Kristin,19,0,30,11
1683356035509,TDMV 1,B00,189296,Caligagan; Maria T.,24,0,30,6
1683356036533,TDMV 2,A00,189297,Sammartano; Tonnie,28,0,30,2
1683356036533,TDMV 2,B00,189299,Arcidiacono; Kristin,24,0,30,6
1683356037556,TDMV 3,A00,204998,Rincon; Alicia,22,0,30,8
1683356038580,TDMV 120,A00,189458,Sammartano; Tonnie,28,0,30,2
1683356039607,TDMV 138,A00,189541,Jun; Grace Shin Hae,22,0,40,18
1683356040631,TDMV 142,A00,189717,Caligagan; Tony,23,0,30,7
1683356040631,TDMV 142,B00,189718,Caligagan; Maria T.,25,0,30,5
1683356041660,TMC 2,A01,187533,Staff,25,0,25,0
1683356041660,TMC 2,A02,187534,Staff,25,0,25,0
1683356042686,USP 1,A01,187536,Kwak; Nancy,0,16,25,25
1683356043715,USP 5,A01,187538,Staff,10,0,25,15
1683356044741,USP 101,A00,199253,Staff,0,4,0,0
1683356045767,USP 124,A00,187562,Boomhower; Matthew Charles,1,0,30,29
1683356046794,USP 138,A00,187582,Staff,20,0,25,5
1683356047818,USP 152,A01,187597,Staff,4,0,25,21
1683356048847,USP 153,A00,187598,Staff,19,0,25,6
1683356049871,USP 168,A00,187607,Kwak; Nancy,2,0,5,3
1683356050897,USP 173,A00,187619,Staff,4,0,25,21
1683356051923,USP 181,A00,187638,Staff,0,3,25,25
1683356052950,VIS 103,A00,187650,Cruz; Edwin Teddy,22,0,75,53
1683356053978,VIS 110D,A00,187669,Staff,12,0,22,10
1683356055002,VIS 127C,A00,187720,Shen; Kuiyi,67,0,146,79
1683356056031,VIS 149,A00,187731,Yoldas; Pinar,0,14,22,22
1683356057056,VIS 151,A01,188091,Staff,22,0,34,12
1683356057056,VIS 151,A02,188092,Staff,11,0,34,23
1683356058083,VIS 160B,A00,188093,Stalbaum; Brett,0,0,10,10
1683356060133,WCWP 10B,A00,201720,Staff,10,0,15,5
1683356060133,WCWP 10B,B00,201722,Staff,9,0,15,6
1683356061157,WCWP 100,A00,201725,Gagnon; Jeffrey C,0,0,2,2
1683356061157,WCWP 100,B00,201727,Staff,0,4,15,15
1683356064283,ANBI 133,A00,258401,Wilder; Linnea Lorene,34,0,40,6
1683356065305,ANBI 140,A00,258395,Hrvoj Mihic; Branka,18,0,25,7
1683356066334,ANSC 120,A00,258402,Bialecki; Jon Anthony,27,0,40,13
1683356067363,ANSC 144,A00,258400,Staff,14,0,40,26
1683356069415,ANSC 166,A00,258396,Parish; Steven Martin,157,0,175,18
1683356070438,ANSC 180,A00,193533,Staff,9,0,20,11
1683356071465,ANSC 188,A00,258397,Jassal; Aftab,33,0,40,7
1683356072488,ANTH 3,A01,258316,Staff,23,0,30,7
1683356073515,ANTH 5,A00,258394,Semendeferi; Ekaterini,16,0,20,4
1683356074542,ANTH 21,A01,258331,Staff,8,0,40,32
1683356075569,ANTH 103,A00,258398,Varma; Saiba,15,0,25,10
1683356076600,AWP 10,001,202034,Staff,0,0,0,0
1683356076600,AWP 10,002,202035,Staff,0,0,0,0
1683356076600,AWP 10,003,202036,Staff,0,0,0,0
1683356076600,AWP 10,004,202037,Staff,0,0,0,0
1683356076600,AWP 10,005,202038,Staff,0,0,0,0
1683356076600,AWP 10,006,202039,Staff,0,0,0,0
1683356076600,AWP 10,007,202040,Staff,0,0,0,0
1683356076600,AWP 10,008,202041,Staff,0,0,0,0
1683356076600,AWP 10,009,202042,Staff,0,0,0,0
1683356076600,AWP 10,010,202043,Staff,0,0,0,0
1683356076600,AWP 10,011,202044,Staff,0,0,0,0
1683356076600,AWP 10,012,202045,Staff,0,0,0,0
1683356076600,AWP 10,013,202046,Staff,0,0,0,0
1683356076600,AWP 10,014,202047,Staff,0,0,0,0
1683356076600,AWP 10,015,202048,Staff,0,0,0,0
1683356076600,AWP 10,016,202049,Staff,0,0,0,0
1683356076600,AWP 10,017,202050,Staff,0,0,0,0
1683356076600,AWP 10,018,202051,Staff,0,0,0,0
1683356076600,AWP 10,019,202052,Staff,0,0,0,0
1683356076600,AWP 10,020,202053,Staff,0,0,0,0
1683356076600,AWP 10,021,202054,Staff,0,0,0,0
1683356076600,AWP 10,022,202055,Staff,0,0,0,0
1683356076600,AWP 10,023,202056,Staff,0,0,0,0
1683356076600,AWP 10,024,202057,Staff,0,0,0,0
1683356076600,AWP 10,025,202058,Staff,0,0,0,0
1683356076600,AWP 10,026,202059,Staff,0,0,0,0
1683356077624,AWP 102,001,202032,Staff,0,0,0,0
1683356077624,AWP 102,002,202033,Staff,0,0,0,0
1683356078652,BENG 100,A01,254234,Taylor Amos; Alyssa C,31,0,40,9
1683356079752,BENG 196,001,270013,Engler; Adam J.,9999,0,9999,0
1683356080781,BICD 100R,A01,202018,Smith; Laurie,0,7,32,32
1683356080781,BICD 100R,A02,202019,Smith; Laurie,0,2,32,32
1683356080781,BICD 100R,A03,202020,Smith; Laurie,0,1,32,32
1683356080781,BICD 100R,A04,202021,Smith; Laurie,9,0,32,23
1683356080781,BICD 100R,A05,202022,Smith; Laurie,12,0,32,20
1683356081808,BICD 136,A01,193242,Gustafson-Brown; Cindy,0,2,32,32
1683356081808,BICD 136,A02,193244,Gustafson-Brown; Cindy,14,0,32,18
1683356082836,BIEB 102,A01,193249,Butler; Shannon Rhey,0,2,32,32
1683356082836,BIEB 102,A02,193251,Butler; Shannon Rhey,0,0,32,32
1683356082836,BIEB 102,A03,193253,Butler; Shannon Rhey,0,1,32,32
1683356082836,BIEB 102,A04,193255,Butler; Shannon Rhey,17,0,32,15
1683356082836,BIEB 102,A05,193265,Butler; Shannon Rhey,26,0,32,6
1683356082836,BIEB 102,A06,193269,Butler; Shannon Rhey,16,0,32,16
1683356084885,BIEB 150,A01,193274,Staff,0,0,32,32
1683356084885,BIEB 150,A02,193285,Staff,23,0,32,9
1683356085909,BIEB 194,A00,193286,Kurle; Carolyn M.,22,0,32,10
1683356086934,BILD 1,A01,192291,Staff,16,0,32,16
1683356086934,BILD 1,A02,192292,Staff,30,0,32,2
1683356086934,BILD 1,B01,192520,Reuther; Keefe,0,1,0,0
1683356086934,BILD 1,B02,192532,Reuther; Keefe,0,1,0,0
1683356087963,BILD 3,A01,192556,Butler; Shannon Rhey,0,0,32,32
1683356087963,BILD 3,A02,192581,Butler; Shannon Rhey,4,0,32,28
1683356087963,BILD 3,A03,192611,Butler; Shannon Rhey,23,0,32,9
1683356087963,BILD 3,A04,192612,Butler; Shannon Rhey,25,0,32,7
1683356087963,BILD 3,A05,192613,Butler; Shannon Rhey,27,0,32,5
1683356087963,BILD 3,A06,192679,Butler; Shannon Rhey,27,0,32,5
1683356087963,BILD 3,A07,192682,Butler; Shannon Rhey,22,0,32,10
1683356088992,BILD 4,A01,192836,Reuther; Keefe,0,0,24,24
1683356088992,BILD 4,A02,193044,Reuther; Keefe,4,0,24,20
1683356090021,BILD 10,A01,193142,Gustafson-Brown; Cindy,30,0,32,2
1683356090021,BILD 10,A02,193149,Gustafson-Brown; Cindy,31,0,32,1
1683356091049,BIMM 100,A01,193301,Staff,0,6,32,32
1683356091049,BIMM 100,A02,193312,Staff,0,5,32,32
1683356091049,BIMM 100,A03,193323,Staff,0,8,32,32
1683356092074,BIMM 101,A01,193329,McDonnell; Lisa Marie,0,3,24,24
1683356092074,BIMM 101,A02,193339,McDonnell; Lisa Marie,0,3,24,24
1683356092074,BIMM 101,B01,193354,McDonnell; Lisa Marie,0,3,24,24
1683356092074,BIMM 101,B02,193357,McDonnell; Lisa Marie,0,3,24,24
1683356093099,BIMM 110,A01,193377,Tat; John,0,11,32,32
1683356093099,BIMM 110,A02,193378,Tat; John,0,9,32,32
1683356094124,BIMM 120,A01,206116,Staff,0,0,32,32
1683356094124,BIMM 120,A02,206117,Staff,8,0,32,24
1683356094124,BIMM 120,A03,206121,Staff,21,0,32,11
1683356095149,BIPN 100,A01,193393,Park; Ji Young,0,14,32,32
1683356095149,BIPN 100,A02,193402,Park; Ji Young,0,13,32,32
1683356095149,BIPN 100,A03,193413,Park; Ji Young,0,14,32,32
1683356095149,BIPN 100,A04,193414,Park; Ji Young,0,13,32,32
1683356096174,BIPN 102,A01,193429,Staff,0,0,32,32
1683356096174,BIPN 102,A02,193438,Staff,22,0,32,10
1683356097197,BIPN 106,A01,193450,Reyes Gonzalez; Catalina,0,2,40,40
1683356098221,BIPN 134,A01,193465,Cooke; James Edward,1,0,32,31
1683356098221,BIPN 134,A02,193474,Cooke; James Edward,25,0,32,7
1683356098221,BIPN 134,A03,193485,Cooke; James Edward,29,0,32,3
1683356098221,BIPN 134,A04,193486,Cooke; James Edward,21,0,32,11
1683356098221,BIPN 134,A05,193491,Cooke; James Edward,31,0,32,1
1683356098221,BIPN 134,A06,193501,Cooke; James Edward,30,0,32,2
1683356098221,BIPN 134,A07,193510,Cooke; James Edward,29,0,32,3
1683356100275,BISP 194,A00,222522,Staff,14,0,32,18
1683356101302,CAT 124,A01,202407,Staff,20,0,25,5
1683356102330,CAT 125,A00,202408,Marchisotto; Jennifer Anne,4,0,20,16
1683356103358,CAT 125R,A00,202409,Smith; Lauryn Alissa,0,11,20,20
1683356103358,CAT 125R,B00,202410,Morales; Celeste Georgianna,0,11,20,20
1683356103358,CAT 125R,C00,202411,Irwin; Matthew Joseph,0,10,20,20
1683356104381,CENG 15,A01,204712,Yang; Kesong,0,1,0,0
1683356105405,CENG 114,A00,202070,Jahed Motlagh; Zeinab,5,0,20,15
1683356106429,CGS 105,A00,185477,Wesling; Megan E.,24,0,40,16
1683356107453,CGS 106,A00,185494,Staff,13,0,22,9
1683356108477,CGS 108,A00,185495,Staff,14,0,20,6
1683356109501,CGS 114,A00,185496,Staff,13,0,18,5
1683356110529,CGS 119,A00,185501,Staff,15,0,20,5
1683356111552,CGS 120,A00,185511,Staff,13,0,20,7
1683356112578,CHEM 4,A01,184675,Bussey; Thomas J,96,0,100,4
1683356113603,CHEM 6A,A01,184677,Staff,34,0,60,26
1683356114628,CHEM 6B,A01,184679,Staff,65,0,100,35
1683356115653,CHEM 6C,A01,184681,Bussey; Thomas J,1,0,50,49
1683356115653,CHEM 6C,A02,184682,Bussey; Thomas J,34,0,50,16
1683356116678,CHEM 40A,A01,184684,Albizati; Kim F.,37,0,100,63
1683356117702,CHEM 40B,A01,184686,Albizati; Kim F.,0,20,100,100
1683356118726,CHEM 41B,A01,184690,Staff,52,0,100,48
1683356119753,COGS 3,A01,184715,Boyle; Mary E. T.,0,25,40,40
1683356120778,COGS 14B,A01,185172,Staff,0,15,38,38
1683356121803,COGS 18,A01,184736,Staff,17,0,80,63
1683356122827,COGS 100,A01,184932,Staff,0,5,73,73
1683356123851,COGS 101A,A01,184935,Staff,0,39,30,30
1683356124879,COGS 101B,A01,184944,Staff,0,2,30,30
1683356125903,COGS 101C,A01,184946,Staff,0,12,30,30
1683356126926,COGS 102A,A01,184951,Johnson; Christine M.,2,0,40,38
1683356127951,COGS 107B,A01,184953,Mooshagian; Eric Frederick,0,50,40,40
1683356128978,COGS 118B,A01,184959,Gupta; Anjum,0,48,40,40
1683356130003,COGS 153,A00,184961,Staff,0,15,30,30
1683356131027,COGS 177,A00,184962,Staff,0,20,30,30
1683356132051,COGS 187A,A01,184969,Boyle; Mary E. T.,0,17,40,40
1683356133075,COMM 10,A01,185174,Staff,0,5,25,25
1683356133075,COMM 10,A02,185189,Staff,0,5,25,25
1683356133075,COMM 10,A03,269821,Staff,0,0,0,0
1683356134098,COMM 100B,A01,185475,Staff,0,0,0,2
1683356134098,COMM 100B,A02,185476,Staff,13,0,25,12
1683356135126,COMM 100C,A01,185314,Staff,1,0,25,24
1683356135126,COMM 100C,A02,185327,Staff,19,0,25,6
1683356136151,COMM 110M,A00,185349,Staff,2,0,40,38
1683356137178,COMM 113T,A00,185352,Staff,24,0,40,16
1683356138205,COMM 114I,A00,185353,Staff,33,0,40,7
1683356139232,COMM 131,A00,185354,Staff,19,0,30,11
1683356140259,CSE 8A,A50,185358,Cao; Yingjun,0,46,10,10
1683356141282,CSE 8B,A01,185362,Staff,0,46,50,50
1683356142308,CSE 11,A01,185416,Cao; Yingjun,0,92,10,10
1683356143330,CSE 20,A01,185445,Briones; Jor-el Thomas Caparas,5,0,25,20
1683356144356,CSE 21,A01,185447,Staff,10,0,50,40
1683356145387,CSE 101,A01,185451,Staff,0,13,50,50
1683356145387,CSE 101,B01,185453,Jones; Miles E,0,11,50,50
1683356147439,CSE 141,A01,185458,Eldon; John,20,0,100,80
1683356148463,CSE 141L,A01,185461,Eldon; John,12,0,100,88
1683356149486,CSE 142,A01,185463,Staff,36,0,60,24
1683356149486,CSE 142,B01,201355,Staff,0,7,60,60
1683356150514,CSE 142L,A01,185470,Staff,36,0,60,24
1683356150514,CSE 142L,B01,201417,Staff,0,6,60,60
1683356151538,CSE 190,A00,201433,Staff,32,0,49,17
1683356152563,DOC 1,A01,259136,Strom; Megan C.,7,0,15,8
1683356152563,DOC 1,A02,259137,Strom; Megan C.,14,0,15,1
1683356152563,DOC 1,A03,259138,Strom; Megan C.,14,0,15,1
1683356152563,DOC 1,A04,259139,Strom; Megan C.,14,0,15,1
1683356153586,DOC 100D,A00,259140,Pass; Natalye Joann,16,0,25,9
1683356154615,DSGN 1,A01,184749,Rill; Bryan,0,25,30,30
1683356155638,DSGN 100,A01,185168,Staff,0,2,25,25
1683356156666,ECE 5,A01,185626,Morris; Karcher William,0,10,0,0
1683356157691,ECE 101,A01,185628,Staff,17,0,70,53
1683356158717,ECE 107,A01,185635,Baghdadchi; Saharnaz,0,0,20,20
1683356158717,ECE 107,A02,185638,Baghdadchi; Saharnaz,4,0,20,16
1683356159745,ECE 148,A01,185647,Silberman; Jack,0,0,16,16
1683356160777,ECON 1,A01,185537,Crane; Meredith Helen,54,0,70,16
1683356161812,ECON 3,A01,185549,Crane; Meredith Helen,32,0,70,38
1683356162837,ECON 4,A01,203354,Anderson; John Charles,0,4,10,10
1683356163866,ECON 100A,A01,185574,Staff,0,4,40,40
1683356164895,ECON 100B,A01,185576,Staff,0,12,50,50
1683356165923,ECON 100C,A01,185589,Newhouse; Herbert S,29,0,70,41
1683356166950,ECON 105,A00,185608,Vespa; Emanuel Ignacio,19,0,35,16
1683356167974,ECON 109,A01,185610,Shishkin; Denis,10,0,35,25
1683356168997,ECON 110A,A01,185612,Staff,11,0,40,29
1683356170021,ECON 120A,A01,185615,Staff,20,0,40,20
1683356171046,ECON 120C,A01,185617,Sun; Yixiao,0,21,70,70
1683356172071,ECON 144,A00,203346,Squires; Dale E,3,0,35,32
1683356173096,ECON 171,A01,203349,Newhouse; Herbert S,0,1,35,35
1683356174121,ECON 173A,A01,185621,Toda; Alexis Akira,21,0,35,14
1683356175147,EDS 25,A01,202413,Staff,0,1,0,0
1683356175147,EDS 25,A02,202414,Staff,0,1,0,0
1683356175147,EDS 25,A03,202415,Staff,0,0,0,0
1683356175147,EDS 25,A04,202416,Staff,0,1,0,0
1683356175147,EDS 25,A05,202439,Staff,0,0,0,0
1683356175147,EDS 25,A06,202440,Staff,0,0,0,0
1683356175147,EDS 25,B01,202631,Staff,0,0,0,0
1683356175147,EDS 25,B02,202632,Staff,0,0,0,0
1683356175147,EDS 25,B03,202639,Staff,0,0,0,0
1683356175147,EDS 25,B04,202640,Staff,0,0,0,0
1683356175147,EDS 25,B05,202643,Staff,0,0,0,0
1683356175147,EDS 25,B06,202644,Staff,0,0,0,0
1683356176169,EDS 38,A01,202659,Black; Alison Michelle,24,0,25,1
1683356177193,EDS 115,A00,202652,Staff,18,0,30,12
1683356178217,EDS 125,A00,202649,Staff,14,0,30,16
1683356179240,EDS 126,A01,203332,Staff,30,0,30,0
1683356180263,EDS 139,A00,202838,Staff,16,0,25,9
1683356181292,EDS 146,A01,202655,Staff,14,0,25,11
1683356182315,ENG 15,A00,185667,Staff,0,1,0,0
1683356182315,ENG 15,B00,185672,Staff,0,0,0,0
1683356182315,ENG 15,C00,185675,Staff,0,0,0,0
1683356182315,ENG 15,D00,185682,Staff,0,0,0,0
1683356182315,ENG 15,E00,185684,Staff,0,0,0,0
1683356183402,ETHN 103,A00,185710,Staff,0,4,35,35
1683356184425,ETHN 103A,A00,199228,Man; Simeon S,2,0,9,7
1683356185452,ETHN 109,A00,185711,Staff,18,0,35,17
1683356186479,ETHN 142,A00,185726,Staff,0,4,30,30
1683356187503,ETHN 163J,A00,199229,Man; Simeon S,5,0,8,3
1683356188530,ETHN 168,A00,185727,Staff,8,0,10,2
1683356189559,ETHN 182,A00,185728,Staff,0,0,35,35
1683356190586,ETHN 183,A00,185737,Staff,8,0,18,10
1683356191609,GLBH 111,A01,209361,Burgos; Jose L.,0,0,0,0
1683356193657,HIEU 104,A00,185792,Staff,16,0,20,4
1683356194682,HIEU 115,A00,185800,Staff,1,0,20,19
1683356195709,HIEU 128,A00,185801,Staff,0,7,20,20
1683356196734,HIEU 147,A00,185802,Staff,16,0,20,4
1683356197759,HIEU 154,A00,185823,Staff,12,0,20,8
1683356198783,HILA 102,A00,185826,Staff,13,0,20,7
1683356199807,HILD 2C,A01,185778,Staff,0,12,20,20
1683356200832,HILD 7B,A01,185780,Kwak; Nancy,0,15,32,32
1683356200832,HILD 7B,A02,185781,Kwak; Nancy,0,18,32,32
1683356201856,HILD 30,A01,185791,Staff,14,0,20,6
1683356202881,HISC 119,A00,185830,Golan; Tal,0,9,20,20
1683356203905,HITO 156GS,A00,185831,Patterson; Patrick H.,0,0,0,23
1683356204929,HIUS 103,A00,185832,Man; Simeon S,0,6,20,20
1683356205953,HIUS 117,A00,185836,Kwak; Nancy,2,0,20,18
1683356206977,HIUS 125,A00,185840,Man; Simeon S,0,0,23,23
1683356208006,HIUS 149,A00,185845,Staff,0,0,20,20
1683356209035,HUM 3,A01,185882,Zavodny; Tatiana Sophia,0,7,50,50
1683356209035,HUM 3,B01,185899,Caldwell; Michael Alan,0,18,50,50
1683356210063,HUM 3GS,A00,185900,Patterson; Patrick H.,0,0,0,23
1683356211088,HUM 4,A01,185938,Zroka; Amy Liane,31,0,50,19
1683356211088,HUM 4,B01,185956,Watkins; Eric,0,3,50,50
1683356211088,HUM 4,B02,202209,Watkins; Eric,0,2,50,50
1683356211088,HUM 4,B03,202210,Watkins; Eric,0,2,50,50
1683356212112,HUM 5,A01,185958,West; Geoffrey Scott,3,0,50,47
1683356212112,HUM 5,A02,202215,West; Geoffrey Scott,0,0,50,50
1683356213138,INTL 190,A00,185959,Gagnon; Jeffrey C,0,0,0,9
1683356213138,INTL 190,B00,185960,Lettieri; Michael Joseph,0,0,0,1
1683356214165,JAPN 180,A00,254509,Staff,4,0,30,26
1683356215193,LATI 10,A01,202853,Kennemore; Amy Michelle,4,0,35,31
1683356215193,LATI 10,A02,202854,Kennemore; Amy Michelle,2,0,35,33
1683356215193,LATI 10,A03,270054,Kennemore; Amy Michelle,30,0,30,0
1683356216219,LATI 180,A00,202855,Kennemore; Amy Michelle,11,0,20,9
1683356217244,LAWS 101,A00,201767,Golan; Tal,0,7,40,40
1683356218267,LIFR 1C,A00,185961,Staff,6,0,20,14
1683356219294,LIFR 1CX,A00,185962,Staff,7,0,20,13
1683356220321,LIFR 1D,A00,185963,Staff,9,0,20,11
1683356221346,LIFR 1DX,A00,185964,Staff,9,0,20,11
1683356222374,LIGN 101,A01,186039,Staff,43,0,50,7
1683356223399,LIGN 165,A00,186040,Staff,18,0,50,32
1683356224425,LTCS 108,A00,186041,Staff,6,0,10,4
1683356225451,LTCS 119,A00,186042,Staff,16,0,20,4
1683356226476,LTCS 130,A00,186043,Wesling; Megan E.,15,0,25,10
1683356228525,LTEA 138,A00,186119,Staff,14,0,40,26
1683356229553,LTEN 124,A00,186148,Staff,6,0,25,19
1683356230580,LTEN 178,A00,186149,Staff,7,0,15,8
1683356231604,LTEN 181,A00,186150,Blanco; John D,33,0,40,7
1683356232628,LTWL 120,A00,186160,Staff,20,0,25,5
1683356233652,LTWL 165,A00,186161,Staff,22,0,25,3
1683356234675,LTWR 100,A00,186162,Staff,0,5,15,15
1683356235702,LTWR 102,A00,186163,Doller; Ben,5,0,15,10
1683356236731,MAE 8,A01,186412,Staff,0,0,0,0
1683356237758,MAE 30B,A00,186445,Bahadori; Mohammad Yousef,83,0,100,17
1683356238787,MAE 40,A00,186592,Bewley; Thomas R,10,0,50,40
1683356239821,MAE 101B,A00,186593,Bahadori; Mohammad Yousef,81,0,100,19
1683356240847,MAE 105,A00,186594,Bandaru; Prabhakar,12,0,50,38
1683356241871,MAE 107,A00,186599,Pham; Hieu Tan,0,7,120,120
1683356242895,MAE 148,A01,186660,Silberman; Jack,3,0,16,13
1683356243920,MATH 10A,A01,188095,Staff,0,5,35,35
1683356244946,MATH 10B,A01,188097,Bowers; Adam R.,0,11,30,30
1683356244946,MATH 10B,A02,188099,Bowers; Adam R.,0,11,30,30
1683356244946,MATH 10B,B01,188104,Bowers; Adam R.,0,10,30,30
1683356244946,MATH 10B,B02,188106,Bowers; Adam R.,0,10,30,30
1683356245976,MATH 10C,A01,188111,Staff,0,18,30,30
1683356245976,MATH 10C,A02,188127,Staff,0,17,30,30
1683356245976,MATH 10C,A03,188131,Staff,0,18,30,30
1683356245976,MATH 10C,B01,188218,Staff,18,0,30,12
1683356245976,MATH 10C,B02,188244,Staff,13,0,30,17
1683356245976,MATH 10C,B03,188277,Staff,16,0,30,14
1683356247001,MATH 18,A01,188344,Bach; Quang Tran,18,0,30,12
1683356247001,MATH 18,A02,188345,Bach; Quang Tran,11,0,30,19
1683356247001,MATH 18,B01,188353,Bach; Quang Tran,10,0,30,20
1683356247001,MATH 18,B02,188354,Bach; Quang Tran,20,0,30,10
1683356248029,MATH 20A,A01,188374,Staff,12,0,35,23
1683356249058,MATH 20B,A01,188382,Ohm; Ko Woon,6,0,30,24
1683356249058,MATH 20B,A02,188383,Ohm; Ko Woon,22,0,30,8
1683356249058,MATH 20B,B01,188385,Ohm; Ko Woon,7,0,30,23
1683356249058,MATH 20B,B02,188392,Ohm; Ko Woon,22,0,30,8
1683356250087,MATH 20C,A01,188394,Harel; Guershon,10,0,30,20
1683356250087,MATH 20C,A02,188395,Harel; Guershon,15,0,30,15
1683356250087,MATH 20C,B01,188404,Harel; Guershon,4,0,30,26
1683356250087,MATH 20C,B02,188405,Harel; Guershon,19,0,30,11
1683356251113,MATH 20D,A01,188414,Hammock; Frances H,0,1,30,30
1683356251113,MATH 20D,A02,188415,Hammock; Frances H,3,0,30,27
1683356251113,MATH 20D,B01,188447,Hammock; Frances H,1,0,30,29
1683356251113,MATH 20D,B02,188486,Hammock; Frances H,8,0,30,22
1683356252141,MATH 20E,A01,188649,Staff,21,0,30,9
1683356252141,MATH 20E,A02,188650,Staff,23,0,30,7
1683356252141,MATH 20E,A03,188673,Staff,0,0,30,30
1683356253166,MATH 102,A01,188675,Staff,0,35,35,35
1683356254195,MATH 103B,A01,188681,Staff,3,0,35,32
1683356254195,MATH 103B,B01,188692,Staff,5,0,35,30
1683356255223,MATH 109,A01,188695,Salehi Golsefidy; Alireza,25,0,35,10
1683356255223,MATH 109,A02,188696,Salehi Golsefidy; Alireza,25,0,35,10
1683356256246,MATH 120A,A01,188698,Eggers; John Dietrich,7,0,35,28
1683356257274,MATH 142B,A01,188736,Ioana; Adrian,0,2,30,30
1683356257274,MATH 142B,A02,188741,Ioana; Adrian,0,0,30,30
1683356257274,MATH 142B,A03,188743,Ioana; Adrian,0,1,30,30
1683356258301,MATH 168A,A01,188790,Staff,0,9,35,35
1683356259331,MATH 170A,A01,188803,Nie; Jiawang,0,2,35,35
1683356259331,MATH 170A,A02,188811,Nie; Jiawang,0,0,35,35
1683356259331,MATH 170A,A03,188814,Nie; Jiawang,1,0,35,34
1683356259331,MATH 170A,A04,188815,Nie; Jiawang,13,0,35,22
1683356260357,MATH 193B,A01,188817,Staff,0,0,35,35
1683356260357,MATH 193B,A02,188818,Staff,5,0,35,30
1683356261385,MGT 4,A01,202857,Anderson; John Charles,61,0,80,19
1683356262409,MGT 12,A00,202858,Lindenberger; Wade Douglas,42,0,90,48
1683356263435,MGT 18,A00,202859,Staff,74,0,90,16
1683356264461,MGT 18GS,A00,202860,McKay; Michael J,13,0,28,15
1683356265484,MGT 45,A00,202861,Pecore; Joseph P.,14,0,90,76
1683356266509,MGT 100,A00,202863,Yavorsky; Daniel Ryan,28,0,90,62
1683356267533,MGT 103,A00,202864,Ehrich; Kristine R,0,17,90,90
1683356268558,MGT 112,A00,202865,Ehrich; Kristine R,15,0,90,75
1683356269582,MGT 121A,A00,202868,Staff,0,20,0,0
1683356270609,MGT 131B,A00,202869,Anderson; John Charles,59,0,90,31
1683356271634,MGT 136,A00,202871,Lindenberger; Wade Douglas,84,0,90,6
1683356272659,MGT 164,A00,202873,Staff,0,68,90,91
1683356273683,MGT 164GS,A00,202874,McKay; Mary A,13,0,28,15
1683356274708,MGT 180,A00,202875,Staff,0,50,90,91
1683356275737,MMW 11R,A01,205019,Herbst; Matthew,3,0,30,27
1683356275737,MMW 11R,A02,205026,Herbst; Matthew,29,0,30,1
1683356276766,MMW 15,A01,193512,Chang; Edmond Yi-Teh,0,9,28,28
1683356276766,MMW 15,A02,193513,Chang; Edmond Yi-Teh,0,5,28,28
1683356276766,MMW 15,A03,193514,Chang; Edmond Yi-Teh,0,5,28,28
1683356276766,MMW 15,A04,193515,Chang; Edmond Yi-Teh,0,5,28,28
1683356276766,MMW 15,A05,193516,Chang; Edmond Yi-Teh,0,4,28,28
1683356276766,MMW 15,A06,193517,Chang; Edmond Yi-Teh,0,5,28,28
1683356276766,MMW 15,B01,193519,Chang; Edmond Yi-Teh,0,5,28,28
1683356276766,MMW 15,B02,193520,Chang; Edmond Yi-Teh,0,5,28,28
1683356276766,MMW 15,B03,193521,Chang; Edmond Yi-Teh,0,5,28,28
1683356276766,MMW 15,B04,193522,Chang; Edmond Yi-Teh,0,4,28,28
1683356276766,MMW 15,B05,193523,Chang; Edmond Yi-Teh,0,5,28,28
1683356276766,MMW 15,B06,193524,Chang; Edmond Yi-Teh,0,4,28,28
1683356277790,MMW 122,A01,193526,Rahimi; Babak,0,15,28,28
1683356277790,MMW 122,A02,193527,Rahimi; Babak,0,14,28,28
1683356277790,MMW 122,A03,193528,Rahimi; Babak,0,0,0,0
1683356277790,MMW 122,A04,193529,Rahimi; Babak,0,0,0,0
1683356278814,MUS 1A,A01,186663,Staff,0,20,35,35
1683356279840,MUS 4,A01,186715,Staff,0,12,35,35
1683356280864,MUS 5R,A01,186796,Dubnov; Shlomo,0,17,35,35
1683356281893,MUS 6,A01,186798,Staff,0,4,25,25
1683356282922,MUS 7,A01,186830,Staff,13,0,35,22
1683356283949,MUS 8,A01,186930,Staff,0,26,35,35
1683356284974,MUS 15,A01,186932,Staff,0,16,35,35
1683356284974,MUS 15,B01,186934,Staff,0,15,35,35
1683356285999,MUS 80,A00,186935,Staff,1,0,20,19
1683356285999,MUS 80,B00,186936,Staff,25,0,25,0
1683356287086,NANO 11,A00,204702,Lipomi; Darren John,0,0,0,0
1683356288113,NANO 15,A01,204709,Yang; Kesong,0,1,0,0
1683356289137,NANO 114,A00,202069,Jahed Motlagh; Zeinab,3,0,10,7
1683356290166,PHIL 1,A00,186955,Grush; Rick Scott,32,0,40,8
1683356291196,PHIL 10,A01,186973,Grush; Rick Scott,28,0,35,7
1683356291196,PHIL 10,A02,186974,Grush; Rick Scott,33,0,35,2
1683356292221,PHIL 13,A01,186976,Staff,7,0,35,28
1683356292221,PHIL 13,A02,186977,Staff,16,0,35,19
1683356293247,PHIL 14,A01,186979,Staff,31,0,35,4
1683356293247,PHIL 14,A02,186986,Staff,32,0,35,3
1683356294272,PHIL 28,A01,186988,Staff,16,0,30,14
1683356294272,PHIL 28,A02,186989,Staff,1,0,30,29
1683356294272,PHIL 28,A03,186990,Staff,9,0,30,21
1683356294272,PHIL 28,A04,186991,Staff,26,0,30,4
1683356295296,PHIL 120,A00,186997,Staff,23,0,40,17
1683356296319,PHIL 137,A00,187003,Staff,9,0,40,31
1683356297343,PHIL 150,A00,187015,Staff,47,0,70,23
1683356298367,PHIL 167,A00,187021,Lamey; Andy M.,35,0,40,5
1683356299392,PHIL 174,A01,202226,Staff,17,0,20,3
1683356299392,PHIL 174,A02,202235,Staff,20,0,20,0
1683356300417,PHIL 191A,A00,258918,Staff,0,0,1,1
1683356301443,PHYS 1A,A00,187028,Staff,27,0,60,33
1683356302466,PHYS 1AL,001,187036,Staff,2,0,30,28
1683356302466,PHYS 1AL,002,187049,Staff,18,0,30,12
1683356303494,PHYS 1B,A00,187058,Staff,22,0,60,38
1683356304519,PHYS 1BL,001,187064,Staff,0,0,30,30
1683356304519,PHYS 1BL,002,187070,Staff,5,0,30,25
1683356305545,PHYS 1C,A00,187082,Staff,31,0,120,89
1683356306570,PHYS 1CL,001,187088,Staff,0,9,30,30
1683356306570,PHYS 1CL,002,187089,Staff,0,2,30,30
1683356306570,PHYS 1CL,009,262693,Staff,11,0,30,19
1683356307595,PHYS 2B,A01,187097,Staff,54,0,115,61
1683356308623,PHYS 2C,A01,187099,Staff,67,0,115,48
1683356309651,PHYS 2CL,A01,187101,Staff,5,0,28,23
1683356309651,PHYS 2CL,A02,187102,Staff,15,0,28,13
1683356310675,PHYS 2D,A01,187123,Shotwell; Brian,95,0,115,20
1683356311704,PHYS 4B,A01,187133,Grinstein; Benjamin,35,0,50,15
1683356312727,POLI 10,A00,188819,Staff,0,4,50,50
1683356313754,POLI 11,A00,188827,Staff,43,0,50,7
1683356314778,POLI 13R,A00,188828,Staff,0,1,20,20
1683356315806,POLI 27,A01,188830,Elgin; Samuel Zincke,0,1,70,70
1683356316833,POLI 30,A00,188832,Desposato; Scott,31,0,50,19
1683356317860,POLI 102F,A00,188834,Staff,3,0,40,37
1683356318888,POLI 104A,A00,188852,Staff,14,0,30,16
1683356319912,POLI 104I,A00,188853,Staff,0,6,20,20
1683356320937,POLI 110B,A00,188854,Wiens; David,7,0,20,13
1683356321963,POLI 112A,A00,188855,Wiens; David,5,0,30,25
1683356322991,POLI 117R,A00,188856,Forman; Fonna,0,11,20,20
1683356324016,POLI 118,A00,188857,Ingham; Sean,8,0,20,12
1683356325040,POLI 120G,A00,188858,Staff,9,0,30,21
1683356326068,POLI 131CR,A00,188863,Hoston; Germaine,23,0,50,27
1683356327092,POLI 133,A00,188864,Nellis; Gareth Hb,44,0,50,6
1683356328120,POLI 134D,A00,188865,Desposato; Scott,27,0,30,3
1683356329146,POLI 142A,A00,188871,Gartzke; Erik,22,0,50,28
1683356330169,POLI 142K,A00,188874,Staff,38,0,50,12
1683356331193,POLI 143,A00,188940,Gartzke; Erik,16,0,30,14
1683356332218,POLI 153,A00,188943,Staff,3,0,20,17
1683356333245,POLI 160AA,A00,188944,Staff,11,0,40,29
1683356334272,POLI 170A,A00,188945,Staff,11,0,30,19
1683356336323,PSYC 1,A00,188952,Staff,37,0,90,53
1683356337350,PSYC 2,B00,188953,Staff,19,0,35,16
1683356338373,PSYC 6,A00,188970,Staff,47,0,60,13
1683356339397,PSYC 7,A00,188973,Staff,37,0,45,8
1683356340425,PSYC 60,A01,188980,Rickard; Timothy C.,43,0,60,17
1683356341453,PSYC 70,A01,189001,Steiner; Eric Tomas,23,0,45,22
1683356342482,PSYC 100,A00,189005,Lacefield; Katharine I,0,98,120,120
1683356343517,PSYC 102,A00,189008,Staff,9,0,30,21
1683356344545,PSYC 106,B00,189026,Gorman; Michael R.,34,0,60,26
1683356345569,PSYC 114,B01,189033,Winkielman; Piotr,0,32,30,30
1683356346594,PSYC 131,A00,189036,Anagnostaras; Stephan,0,43,60,60
1683356347622,PSYC 136,A00,189041,Lowe; Angela Beth,0,7,25,25
1683356348646,PSYC 137,A00,189057,Winkielman; Piotr,0,34,25,25
1683356349679,PSYC 144,A00,189107,Wixted; John T,0,7,50,50
1683356351732,PSYC 162,A00,189142,Staff,0,8,85,85
1683356352755,PSYC 172,A00,189144,Gorman; Michael R.,0,7,30,30
1683356354803,PSYC 179,A00,189146,Lacefield; Katharine I,0,84,120,120
1683356355828,PSYC 181,A00,189147,Anagnostaras; Stephan,0,44,90,90
1683356356855,PSYC 190R,A00,189148,Barner; David A.,0,22,80,80
1683356357877,PSYC 191,A00,189275,Rickard; Timothy C.,0,7,25,25
1683356358901,PSYC 193,A00,189276,Chapman; Eddie Nathaniel,0,1,0,4
1683356359927,PSYC 193L,A01,189281,Lowe; Angela Beth,12,0,20,8
1683356359927,PSYC 193L,B01,189285,Staff,28,0,35,7
1683356360951,RELI 149,A00,187137,Rahimi; Babak,7,0,40,33
1683356361974,SE 9,A01,187315,Staff,0,2,18,18
1683356363002,SE 101B,A00,187409,Staff,24,0,30,6
1683356364030,SE 110B,A00,187444,Staff,10,0,40,30
1683356365055,SE 130B,A00,187449,Staff,31,0,40,9
1683356366080,SE 150A,A00,187516,Staff,9,0,20,11
1683356367106,SE 154,A00,187528,Staff,30,0,50,20
1683356368130,SIO 3,A01,258171,Staff,35,0,40,5
1683356369155,SIO 10,A00,187144,Cook; Geoffrey W,0,3,75,75
1683356370179,SIO 45,A00,187152,Cook; Geoffrey W,1,0,100,99
1683356371208,SIO 109R,A00,194486,Staff,0,3,20,20
1683356373255,SIO 187,A01,187233,Kacev; David,12,0,40,28
1683356374278,SOCI 1,A01,258656,Thorpe; Charles Robert,28,0,30,2
1683356374278,SOCI 1,A02,258658,Thorpe; Charles Robert,30,0,30,0
1683356374278,SOCI 1,A03,258661,Thorpe; Charles Robert,25,0,25,0
1683356374278,SOCI 1,A04,258666,Thorpe; Charles Robert,22,0,25,3
1683356374278,SOCI 1,A05,258897,Thorpe; Charles Robert,23,0,25,2
1683356374278,SOCI 1,A06,258898,Thorpe; Charles Robert,25,0,25,0
1683356375301,SOCI 30,A01,258903,Pardo Guerra; Juan Pablo,15,0,30,15
1683356376324,SOCI 102,A00,258904,Staff,9,0,25,16
1683356377349,SOCI 106,A00,258905,Staff,19,0,25,6
1683356378377,SOCI 111,A00,258907,Ribas Norris; Janet Vanesa,26,0,30,4
1683356379402,SOCI 121R,A00,258908,Pardo Guerra; Juan Pablo,10,0,30,20
1683356380425,SOCI 126,A01,203330,Staff,14,0,20,6
1683356381450,SOCI 131,A00,258909,Thorpe; Charles Robert,31,0,60,29
1683356382473,SOCI 135,A00,258910,Payne; Christine Anna,0,9,30,30
1683356383497,SOCI 157,A00,258911,Staff,12,0,30,18
1683356384520,SOCI 184,A00,258912,Staff,25,0,30,5
1683356385546,SOCI 188D,A00,258913,Staff,22,0,30,8
1683356386570,SYN 2,001,187529,Staff,10,0,16,6
1683356386570,SYN 2,002,201452,Staff,0,18,16,16
1683356386570,SYN 2,003,201469,Staff,3,0,16,13
1683356387594,SYN 100,A01,187531,Staff,0,9,20,20
1683356387594,SYN 100,B01,201491,Staff,0,12,20,20
1683356388622,TDAC 1,A00,189286,Walsh; Kim C.,3,0,20,17
1683356388622,TDAC 1,B00,189287,Harting; Carla Kelso,11,0,20,9
1683356389646,TDAC 101,A00,189300,Walsh; Kim C.,16,0,20,4
1683356389646,TDAC 101,B00,189301,Harting; Carla Kelso,18,0,20,2
1683356390729,TDAC 102,A00,189304,Basso; Beatrice,14,0,20,6
1683356391754,TDAC 108,A00,189305,Staff,18,0,20,2
1683356392779,TDDE 131,A00,189310,Staff,19,0,20,1
1683356392779,TDDE 131,B00,189314,Staff,19,0,20,1
1683356392779,TDDE 131,C00,189315,Staff,48,0,50,2
1683356392779,TDDE 131,D00,189316,Staff,14,0,15,1
1683356392779,TDDE 131,E00,204841,Staff,20,0,20,0
1683356393804,TDGE 10,A00,189289,Staff,30,0,50,20
1683356393804,TDGE 10,B00,189290,Havis; Allan,1,0,50,49
1683356394829,TDGE 11,A00,189291,Fulton; Julia,0,3,50,50
1683356394829,TDGE 11,B00,189292,Staff,20,0,25,5
1683356394829,TDGE 11,C00,260270,Staff,0,0,0,0
1683356395853,TDGE 25,A00,189294,Staff,3,0,20,17
1683356396880,TDGE 124,A00,189318,Fulton; Julia,0,8,50,50
1683356397907,TDGE 125,A00,189319,Staff,13,0,25,12
1683356397907,TDGE 125,B00,189320,Staff,23,0,25,2
1683356398932,TDGE 127,A00,189322,Havis; Allan,0,0,50,50
1683356399957,TDHT 101,A00,189323,Staff,18,0,25,7
1683356399957,TDHT 101,B00,189324,Staff,25,0,25,0
1683356400981,TDHT 102,A00,189325,Staff,49,0,50,1
1683356402005,TDMV 1,A00,189295,Arcidiacono; Kristin,19,0,30,11
1683356402005,TDMV 1,B00,189296,Caligagan; Maria T.,24,0,30,6
1683356403032,TDMV 2,A00,189297,Sammartano; Tonnie,28,0,30,2
1683356403032,TDMV 2,B00,189299,Arcidiacono; Kristin,24,0,30,6
1683356404058,TDMV 3,A00,204998,Rincon; Alicia,22,0,30,8
1683356405087,TDMV 120,A00,189458,Sammartano; Tonnie,28,0,30,2
1683356406111,TDMV 138,A00,189541,Jun; Grace Shin Hae,22,0,40,18
1683356407134,TDMV 142,A00,189717,Caligagan; Tony,23,0,30,7
1683356407134,TDMV 142,B00,189718,Caligagan; Maria T.,25,0,30,5
1683356408163,TMC 2,A01,187533,Staff,25,0,25,0
1683356408163,TMC 2,A02,187534,Staff,25,0,25,0
1683356409191,USP 1,A01,187536,Kwak; Nancy,0,16,25,25
1683356410218,USP 5,A01,187538,Staff,10,0,25,15
1683356411246,USP 101,A00,199253,Staff,0,4,0,0
1683356412274,USP 124,A00,187562,Boomhower; Matthew Charles,1,0,30,29
1683356413299,USP 138,A00,187582,Staff,20,0,25,5
1683356414328,USP 152,A01,187597,Staff,4,0,25,21
1683356415357,USP 153,A00,187598,Staff,19,0,25,6
1683356416385,USP 168,A00,187607,Kwak; Nancy,2,0,5,3
1683356417415,USP 173,A00,187619,Staff,4,0,25,21
1683356418441,USP 181,A00,187638,Staff,0,3,25,25
1683356419465,VIS 103,A00,187650,Cruz; Edwin Teddy,22,0,75,53
1683356420492,VIS 110D,A00,187669,Staff,12,0,22,10
1683356421520,VIS 127C,A00,187720,Shen; Kuiyi,67,0,146,79
1683356422548,VIS 149,A00,187731,Yoldas; Pinar,0,14,22,22
1683356423584,VIS 151,A01,188091,Staff,22,0,34,12
1683356423584,VIS 151,A02,188092,Staff,11,0,34,23
1683356424611,VIS 160B,A00,188093,Stalbaum; Brett,0,0,10,10
1683356426659,WCWP 10B,A00,201720,Staff,10,0,15,5
1683356426659,WCWP 10B,B00,201722,Staff,9,0,15,6
1683356427687,WCWP 100,A00,201725,Gagnon; Jeffrey C,0,0,2,2
1683356427687,WCWP 100,B00,201727,Staff,0,4,15,15
1683356430784,ANBI 133,A00,258401,Wilder; Linnea Lorene,34,0,40,6
1683356431806,ANBI 140,A00,258395,Hrvoj Mihic; Branka,18,0,25,7
1683356432834,ANSC 120,A00,258402,Bialecki; Jon Anthony,27,0,40,13
1683356433863,ANSC 144,A00,258400,Staff,14,0,40,26
1683356435911,ANSC 166,A00,258396,Parish; Steven Martin,157,0,175,18
1683356436935,ANSC 180,A00,193533,Staff,9,0,20,11
1683356437963,ANSC 188,A00,258397,Jassal; Aftab,33,0,40,7
1683356438987,ANTH 3,A01,258316,Staff,23,0,30,7
1683356440009,ANTH 5,A00,258394,Semendeferi; Ekaterini,16,0,20,4
1683356441041,ANTH 21,A01,258331,Staff,8,0,40,32
1683356442067,ANTH 103,A00,258398,Varma; Saiba,15,0,25,10
1683356443094,AWP 10,001,202034,Staff,0,0,0,0
1683356443094,AWP 10,002,202035,Staff,0,0,0,0
1683356443094,AWP 10,003,202036,Staff,0,0,0,0
1683356443094,AWP 10,004,202037,Staff,0,0,0,0
1683356443094,AWP 10,005,202038,Staff,0,0,0,0
1683356443094,AWP 10,006,202039,Staff,0,0,0,0
1683356443094,AWP 10,007,202040,Staff,0,0,0,0
1683356443094,AWP 10,008,202041,Staff,0,0,0,0
1683356443094,AWP 10,009,202042,Staff,0,0,0,0
1683356443094,AWP 10,010,202043,Staff,0,0,0,0
1683356443094,AWP 10,011,202044,Staff,0,0,0,0
1683356443094,AWP 10,012,202045,Staff,0,0,0,0
1683356443094,AWP 10,013,202046,Staff,0,0,0,0
1683356443094,AWP 10,014,202047,Staff,0,0,0,0
1683356443094,AWP 10,015,202048,Staff,0,0,0,0
1683356443094,AWP 10,016,202049,Staff,0,0,0,0
1683356443094,AWP 10,017,202050,Staff,0,0,0,0
1683356443094,AWP 10,018,202051,Staff,0,0,0,0
1683356443094,AWP 10,019,202052,Staff,0,0,0,0
1683356443094,AWP 10,020,202053,Staff,0,0,0,0
1683356443094,AWP 10,021,202054,Staff,0,0,0,0
1683356443094,AWP 10,022,202055,Staff,0,0,0,0
1683356443094,AWP 10,023,202056,Staff,0,0,0,0
1683356443094,AWP 10,024,202057,Staff,0,0,0,0
1683356443094,AWP 10,025,202058,Staff,0,0,0,0
1683356443094,AWP 10,026,202059,Staff,0,0,0,0
1683356444122,AWP 102,001,202032,Staff,0,0,0,0
1683356444122,AWP 102,002,202033,Staff,0,0,0,0
1683356445147,BENG 100,A01,254234,Taylor Amos; Alyssa C,31,0,40,9
1683356446171,BENG 196,001,270013,Engler; Adam J.,9999,0,9999,0
1683356447201,BICD 100R,A01,202018,Smith; Laurie,0,7,32,32
1683356447201,BICD 100R,A02,202019,Smith; Laurie,0,2,32,32
1683356447201,BICD 100R,A03,202020,Smith; Laurie,0,1,32,32
1683356447201,BICD 100R,A04,202021,Smith; Laurie,9,0,32,23
1683356447201,BICD 100R,A05,202022,Smith; Laurie,12,0,32,20
1683356448225,BICD 136,A01,193242,Gustafson-Brown; Cindy,0,2,32,32
1683356448225,BICD 136,A02,193244,Gustafson-Brown; Cindy,14,0,32,18
1683356449252,BIEB 102,A01,193249,Butler; Shannon Rhey,0,2,32,32
1683356449252,BIEB 102,A02,193251,Butler; Shannon Rhey,0,0,32,32
1683356449252,BIEB 102,A03,193253,Butler; Shannon Rhey,0,1,32,32
1683356449252,BIEB 102,A04,193255,Butler; Shannon Rhey,17,0,32,15
1683356449252,BIEB 102,A05,193265,Butler; Shannon Rhey,26,0,32,6
1683356449252,BIEB 102,A06,193269,Butler; Shannon Rhey,16,0,32,16
1683356451306,BIEB 150,A01,193274,Staff,0,0,32,32
1683356451306,BIEB 150,A02,193285,Staff,23,0,32,9
1683356452333,BIEB 194,A00,193286,Kurle; Carolyn M.,22,0,32,10
1683356453358,BILD 1,A01,192291,Staff,16,0,32,16
1683356453358,BILD 1,A02,192292,Staff,30,0,32,2
1683356453358,BILD 1,B01,192520,Reuther; Keefe,0,1,0,0
1683356453358,BILD 1,B02,192532,Reuther; Keefe,0,1,0,0
1683356454383,BILD 3,A01,192556,Butler; Shannon Rhey,0,0,32,32
1683356454383,BILD 3,A02,192581,Butler; Shannon Rhey,4,0,32,28
1683356454383,BILD 3,A03,192611,Butler; Shannon Rhey,23,0,32,9
1683356454383,BILD 3,A04,192612,Butler; Shannon Rhey,25,0,32,7
1683356454383,BILD 3,A05,192613,Butler; Shannon Rhey,27,0,32,5
1683356454383,BILD 3,A06,192679,Butler; Shannon Rhey,27,0,32,5
1683356454383,BILD 3,A07,192682,Butler; Shannon Rhey,22,0,32,10
1683356455411,BILD 4,A01,192836,Reuther; Keefe,0,0,24,24
1683356455411,BILD 4,A02,193044,Reuther; Keefe,4,0,24,20
1683356456437,BILD 10,A01,193142,Gustafson-Brown; Cindy,30,0,32,2
1683356456437,BILD 10,A02,193149,Gustafson-Brown; Cindy,31,0,32,1
1683356457461,BIMM 100,A01,193301,Staff,0,6,32,32
1683356457461,BIMM 100,A02,193312,Staff,0,5,32,32
1683356457461,BIMM 100,A03,193323,Staff,0,8,32,32
1683356458493,BIMM 101,A01,193329,McDonnell; Lisa Marie,0,3,24,24
1683356458493,BIMM 101,A02,193339,McDonnell; Lisa Marie,0,3,24,24
1683356458493,BIMM 101,B01,193354,McDonnell; Lisa Marie,0,3,24,24
1683356458493,BIMM 101,B02,193357,McDonnell; Lisa Marie,0,3,24,24
1683356459517,BIMM 110,A01,193377,Tat; John,0,11,32,32
1683356459517,BIMM 110,A02,193378,Tat; John,0,9,32,32
1683356460547,BIMM 120,A01,206116,Staff,0,0,32,32
1683356460547,BIMM 120,A02,206117,Staff,8,0,32,24
1683356460547,BIMM 120,A03,206121,Staff,21,0,32,11
1683356461571,BIPN 100,A01,193393,Park; Ji Young,0,14,32,32
1683356461571,BIPN 100,A02,193402,Park; Ji Young,0,13,32,32
1683356461571,BIPN 100,A03,193413,Park; Ji Young,0,14,32,32
1683356461571,BIPN 100,A04,193414,Park; Ji Young,0,13,32,32
1683356462597,BIPN 102,A01,193429,Staff,0,0,32,32
1683356462597,BIPN 102,A02,193438,Staff,22,0,32,10
1683356463627,BIPN 106,A01,193450,Reyes Gonzalez; Catalina,0,2,40,40
1683356464660,BIPN 134,A01,193465,Cooke; James Edward,1,0,32,31
1683356464660,BIPN 134,A02,193474,Cooke; James Edward,25,0,32,7
1683356464660,BIPN 134,A03,193485,Cooke; James Edward,29,0,32,3
1683356464660,BIPN 134,A04,193486,Cooke; James Edward,21,0,32,11
1683356464660,BIPN 134,A05,193491,Cooke; James Edward,31,0,32,1
1683356464660,BIPN 134,A06,193501,Cooke; James Edward,30,0,32,2
1683356464660,BIPN 134,A07,193510,Cooke; James Edward,29,0,32,3
1683356466711,BISP 194,A00,222522,Staff,14,0,32,18
1683356467740,CAT 124,A01,202407,Staff,20,0,25,5
1683356468765,CAT 125,A00,202408,Marchisotto; Jennifer Anne,4,0,20,16
1683356469797,CAT 125R,A00,202409,Smith; Lauryn Alissa,0,11,20,20
1683356469797,CAT 125R,B00,202410,Morales; Celeste Georgianna,0,11,20,20
1683356469797,CAT 125R,C00,202411,Irwin; Matthew Joseph,0,10,20,20
1683356470822,CENG 15,A01,204712,Yang; Kesong,0,1,0,0
1683356471852,CENG 114,A00,202070,Jahed Motlagh; Zeinab,5,0,20,15
1683356472876,CGS 105,A00,185477,Wesling; Megan E.,24,0,40,16
1683356473901,CGS 106,A00,185494,Staff,13,0,22,9
1683356474925,CGS 108,A00,185495,Staff,14,0,20,6
1683356475952,CGS 114,A00,185496,Staff,13,0,18,5
1683356476977,CGS 119,A00,185501,Staff,15,0,20,5
1683356478002,CGS 120,A00,185511,Staff,13,0,20,7
1683356479029,CHEM 4,A01,184675,Bussey; Thomas J,96,0,100,4
1683356480057,CHEM 6A,A01,184677,Staff,34,0,60,26
1683356481081,CHEM 6B,A01,184679,Staff,65,0,100,35
1683356482123,CHEM 6C,A01,184681,Bussey; Thomas J,1,0,50,49
1683356482123,CHEM 6C,A02,184682,Bussey; Thomas J,34,0,50,16
1683356483149,CHEM 40A,A01,184684,Albizati; Kim F.,37,0,100,63
1683356484175,CHEM 40B,A01,184686,Albizati; Kim F.,0,20,100,100
1683356485204,CHEM 41B,A01,184690,Staff,52,0,100,48
1683356486229,COGS 3,A01,184715,Boyle; Mary E. T.,0,25,40,40
1683356487255,COGS 14B,A01,185172,Staff,0,15,38,38
1683356488282,COGS 18,A01,184736,Staff,17,0,80,63
1683356489307,COGS 100,A01,184932,Staff,0,5,73,73
1683356490332,COGS 101A,A01,184935,Staff,0,39,30,30
1683356491356,COGS 101B,A01,184944,Staff,0,2,30,30
1683356492392,COGS 101C,A01,184946,Staff,0,12,30,30
1683356493425,COGS 102A,A01,184951,Johnson; Christine M.,2,0,40,38
1683356494506,COGS 107B,A01,184953,Mooshagian; Eric Frederick,0,50,40,40
1683356495532,COGS 118B,A01,184959,Gupta; Anjum,0,48,40,40
1683356496561,COGS 153,A00,184961,Staff,0,15,30,30
1683356497590,COGS 177,A00,184962,Staff,0,20,30,30
1683356498614,COGS 187A,A01,184969,Boyle; Mary E. T.,0,17,40,40
1683356499643,COMM 10,A01,185174,Staff,0,5,25,25
1683356499643,COMM 10,A02,185189,Staff,0,5,25,25
1683356499643,COMM 10,A03,269821,Staff,0,0,0,0
1683356500666,COMM 100B,A01,185475,Staff,0,0,0,2
1683356500666,COMM 100B,A02,185476,Staff,13,0,25,12
1683356501696,COMM 100C,A01,185314,Staff,1,0,25,24
1683356501696,COMM 100C,A02,185327,Staff,19,0,25,6
1683356502726,COMM 110M,A00,185349,Staff,2,0,40,38
1683356503751,COMM 113T,A00,185352,Staff,24,0,40,16
1683356504777,COMM 114I,A00,185353,Staff,33,0,40,7
1683356505806,COMM 131,A00,185354,Staff,19,0,30,11
1683356506833,CSE 8A,A50,185358,Cao; Yingjun,0,46,10,10
1683356507863,CSE 8B,A01,185362,Staff,0,46,50,50
1683356508892,CSE 11,A01,185416,Cao; Yingjun,0,92,10,10
1683356509919,CSE 20,A01,185445,Briones; Jor-el Thomas Caparas,5,0,25,20
1683356510950,CSE 21,A01,185447,Staff,10,0,50,40
1683356511975,CSE 101,A01,185451,Staff,0,13,50,50
1683356511975,CSE 101,B01,185453,Jones; Miles E,0,11,50,50
1683356514027,CSE 141,A01,185458,Eldon; John,20,0,100,80
1683356515058,CSE 141L,A01,185461,Eldon; John,12,0,100,88
1683356516088,CSE 142,A01,185463,Staff,36,0,60,24
1683356516088,CSE 142,B01,201355,Staff,0,7,60,60
1683356517117,CSE 142L,A01,185470,Staff,36,0,60,24
1683356517117,CSE 142L,B01,201417,Staff,0,6,60,60
1683356518141,CSE 190,A00,201433,Staff,32,0,49,17
1683356519170,DOC 1,A01,259136,Strom; Megan C.,7,0,15,8
1683356519170,DOC 1,A02,259137,Strom; Megan C.,14,0,15,1
1683356519170,DOC 1,A03,259138,Strom; Megan C.,14,0,15,1
1683356519170,DOC 1,A04,259139,Strom; Megan C.,14,0,15,1
1683356520194,DOC 100D,A00,259140,Pass; Natalye Joann,16,0,25,9
1683356521226,DSGN 1,A01,184749,Rill; Bryan,0,25,30,30
1683356522252,DSGN 100,A01,185168,Staff,0,2,25,25
1683356523277,ECE 5,A01,185626,Morris; Karcher William,0,10,0,0
1683356524302,ECE 101,A01,185628,Staff,17,0,70,53
1683356525328,ECE 107,A01,185635,Baghdadchi; Saharnaz,0,0,20,20
1683356525328,ECE 107,A02,185638,Baghdadchi; Saharnaz,4,0,20,16
1683356526354,ECE 148,A01,185647,Silberman; Jack,0,0,16,16
1683356527378,ECON 1,A01,185537,Crane; Meredith Helen,54,0,70,16
1683356528407,ECON 3,A01,185549,Crane; Meredith Helen,32,0,70,38
1683356529438,ECON 4,A01,203354,Anderson; John Charles,0,4,10,10
1683356530464,ECON 100A,A01,185574,Staff,0,4,40,40
1683356531489,ECON 100B,A01,185576,Staff,0,12,50,50
1683356532515,ECON 100C,A01,185589,Newhouse; Herbert S,29,0,70,41
1683356533541,ECON 105,A00,185608,Vespa; Emanuel Ignacio,19,0,35,16
1683356534565,ECON 109,A01,185610,Shishkin; Denis,10,0,35,25
1683356535595,ECON 110A,A01,185612,Staff,11,0,40,29
1683356536625,ECON 120A,A01,185615,Staff,20,0,40,20
1683356537649,ECON 120C,A01,185617,Sun; Yixiao,0,21,70,70
1683356538675,ECON 144,A00,203346,Squires; Dale E,3,0,35,32
1683356539702,ECON 171,A01,203349,Newhouse; Herbert S,0,1,35,35
1683356540728,ECON 173A,A01,185621,Toda; Alexis Akira,21,0,35,14
1683356541758,EDS 25,A01,202413,Staff,0,1,0,0
1683356541758,EDS 25,A02,202414,Staff,0,1,0,0
1683356541758,EDS 25,A03,202415,Staff,0,0,0,0
1683356541758,EDS 25,A04,202416,Staff,0,1,0,0
1683356541758,EDS 25,A05,202439,Staff,0,0,0,0
1683356541758,EDS 25,A06,202440,Staff,0,0,0,0
1683356541758,EDS 25,B01,202631,Staff,0,0,0,0
1683356541758,EDS 25,B02,202632,Staff,0,0,0,0
1683356541758,EDS 25,B03,202639,Staff,0,0,0,0
1683356541758,EDS 25,B04,202640,Staff,0,0,0,0
1683356541758,EDS 25,B05,202643,Staff,0,0,0,0
1683356541758,EDS 25,B06,202644,Staff,0,0,0,0
1683356542788,EDS 38,A01,202659,Black; Alison Michelle,24,0,25,1
1683356543813,EDS 115,A00,202652,Staff,18,0,30,12
1683356544842,EDS 125,A00,202649,Staff,14,0,30,16
1683356545869,EDS 126,A01,203332,Staff,30,0,30,0
1683356546894,EDS 139,A00,202838,Staff,16,0,25,9
1683356547919,EDS 146,A01,202655,Staff,14,0,25,11
1683356548945,ENG 15,A00,185667,Staff,0,1,0,0
1683356548945,ENG 15,B00,185672,Staff,0,0,0,0
1683356548945,ENG 15,C00,185675,Staff,0,0,0,0
1683356548945,ENG 15,D00,185682,Staff,0,0,0,0
1683356548945,ENG 15,E00,185684,Staff,0,0,0,0
1683356549970,ETHN 103,A00,185710,Staff,0,4,35,35
1683356550995,ETHN 103A,A00,199228,Man; Simeon S,2,0,9,7
1683356552026,ETHN 109,A00,185711,Staff,18,0,35,17
1683356553051,ETHN 142,A00,185726,Staff,0,4,30,30
1683356554079,ETHN 163J,A00,199229,Man; Simeon S,5,0,8,3
1683356555105,ETHN 168,A00,185727,Staff,8,0,10,2
1683356556131,ETHN 182,A00,185728,Staff,0,0,35,35
1683356557161,ETHN 183,A00,185737,Staff,8,0,18,10
1683356558189,GLBH 111,A01,209361,Burgos; Jose L.,0,0,0,0
1683356560242,HIEU 104,A00,185792,Staff,16,0,20,4
1683356561270,HIEU 115,A00,185800,Staff,1,0,20,19
1683356562294,HIEU 128,A00,185801,Staff,0,7,20,20
1683356563320,HIEU 147,A00,185802,Staff,16,0,20,4
1683356564349,HIEU 154,A00,185823,Staff,12,0,20,8
1683356565374,HILA 102,A00,185826,Staff,13,0,20,7
1683356566398,HILD 2C,A01,185778,Staff,0,12,20,20
1683356567422,HILD 7B,A01,185780,Kwak; Nancy,0,15,32,32
1683356567422,HILD 7B,A02,185781,Kwak; Nancy,0,18,32,32
1683356568453,HILD 30,A01,185791,Staff,14,0,20,6
1683356569477,HISC 119,A00,185830,Golan; Tal,0,9,20,20
1683356570506,HITO 156GS,A00,185831,Patterson; Patrick H.,0,0,0,23
1683356571535,HIUS 103,A00,185832,Man; Simeon S,0,6,20,20
1683356572563,HIUS 117,A00,185836,Kwak; Nancy,2,0,20,18
1683356573591,HIUS 125,A00,185840,Man; Simeon S,0,0,23,23
1683356574617,HIUS 149,A00,185845,Staff,0,0,20,20
1683356575647,HUM 3,A01,185882,Zavodny; Tatiana Sophia,0,7,50,50
1683356575647,HUM 3,B01,185899,Caldwell; Michael Alan,0,18,50,50
1683356576676,HUM 3GS,A00,185900,Patterson; Patrick H.,0,0,0,23
1683356577702,HUM 4,A01,185938,Zroka; Amy Liane,31,0,50,19
1683356577702,HUM 4,B01,185956,Watkins; Eric,0,3,50,50
1683356577702,HUM 4,B02,202209,Watkins; Eric,0,2,50,50
1683356577702,HUM 4,B03,202210,Watkins; Eric,0,2,50,50
1683356578725,HUM 5,A01,185958,West; Geoffrey Scott,3,0,50,47
1683356578725,HUM 5,A02,202215,West; Geoffrey Scott,0,0,50,50
1683356579751,INTL 190,A00,185959,Gagnon; Jeffrey C,0,0,0,9
1683356579751,INTL 190,B00,185960,Lettieri; Michael Joseph,0,0,0,1
1683356580776,JAPN 180,A00,254509,Staff,4,0,30,26
1683356581806,LATI 10,A01,202853,Kennemore; Amy Michelle,4,0,35,31
1683356581806,LATI 10,A02,202854,Kennemore; Amy Michelle,2,0,35,33
1683356581806,LATI 10,A03,270054,Kennemore; Amy Michelle,30,0,30,0
1683356582833,LATI 180,A00,202855,Kennemore; Amy Michelle,11,0,20,9
1683356583862,LAWS 101,A00,201767,Golan; Tal,0,7,40,40
1683356584891,LIFR 1C,A00,185961,Staff,6,0,20,14
1683356585915,LIFR 1CX,A00,185962,Staff,7,0,20,13
1683356586939,LIFR 1D,A00,185963,Staff,9,0,20,11
1683356587964,LIFR 1DX,A00,185964,Staff,9,0,20,11
1683356588989,LIGN 101,A01,186039,Staff,43,0,50,7
1683356590015,LIGN 165,A00,186040,Staff,18,0,50,32
1683356591044,LTCS 108,A00,186041,Staff,6,0,10,4
1683356592069,LTCS 119,A00,186042,Staff,16,0,20,4
1683356593094,LTCS 130,A00,186043,Wesling; Megan E.,15,0,25,10
1683356595149,LTEA 138,A00,186119,Staff,14,0,40,26
1683356596177,LTEN 124,A00,186148,Staff,6,0,25,19
1683356597206,LTEN 178,A00,186149,Staff,7,0,15,8
1683356598297,LTEN 181,A00,186150,Blanco; John D,33,0,40,7
1683356599322,LTWL 120,A00,186160,Staff,20,0,25,5
1683356600350,LTWL 165,A00,186161,Staff,22,0,25,3
1683356601377,LTWR 100,A00,186162,Staff,0,5,15,15
1683356602401,LTWR 102,A00,186163,Doller; Ben,5,0,15,10
1683356603427,MAE 8,A01,186412,Staff,0,0,0,0
1683356604452,MAE 30B,A00,186445,Bahadori; Mohammad Yousef,83,0,100,17
1683356605477,MAE 40,A00,186592,Bewley; Thomas R,10,0,50,40
1683356606501,MAE 101B,A00,186593,Bahadori; Mohammad Yousef,81,0,100,19
1683356607526,MAE 105,A00,186594,Bandaru; Prabhakar,12,0,50,38
1683356608554,MAE 107,A00,186599,Pham; Hieu Tan,0,7,120,120
1683356609581,MAE 148,A01,186660,Silberman; Jack,3,0,16,13
1683356610605,MATH 10A,A01,188095,Staff,0,5,35,35
1683356611632,MATH 10B,A01,188097,Bowers; Adam R.,0,11,30,30
1683356611632,MATH 10B,A02,188099,Bowers; Adam R.,0,11,30,30
1683356611632,MATH 10B,B01,188104,Bowers; Adam R.,0,10,30,30
1683356611632,MATH 10B,B02,188106,Bowers; Adam R.,0,10,30,30
1683356612663,MATH 10C,A01,188111,Staff,0,18,30,30
1683356612663,MATH 10C,A02,188127,Staff,0,17,30,30
1683356612663,MATH 10C,A03,188131,Staff,0,18,30,30
1683356612663,MATH 10C,B01,188218,Staff,18,0,30,12
1683356612663,MATH 10C,B02,188244,Staff,13,0,30,17
1683356612663,MATH 10C,B03,188277,Staff,16,0,30,14
1683356613694,MATH 18,A01,188344,Bach; Quang Tran,18,0,30,12
1683356613694,MATH 18,A02,188345,Bach; Quang Tran,11,0,30,19
1683356613694,MATH 18,B01,188353,Bach; Quang Tran,10,0,30,20
1683356613694,MATH 18,B02,188354,Bach; Quang Tran,20,0,30,10
1683356614721,MATH 20A,A01,188374,Staff,12,0,35,23
1683356615747,MATH 20B,A01,188382,Ohm; Ko Woon,6,0,30,24
1683356615747,MATH 20B,A02,188383,Ohm; Ko Woon,22,0,30,8
1683356615747,MATH 20B,B01,188385,Ohm; Ko Woon,7,0,30,23
1683356615747,MATH 20B,B02,188392,Ohm; Ko Woon,22,0,30,8
1683356616784,MATH 20C,A01,188394,Harel; Guershon,10,0,30,20
1683356616784,MATH 20C,A02,188395,Harel; Guershon,15,0,30,15
1683356616784,MATH 20C,B01,188404,Harel; Guershon,4,0,30,26
1683356616784,MATH 20C,B02,188405,Harel; Guershon,19,0,30,11
1683356617811,MATH 20D,A01,188414,Hammock; Frances H,0,1,30,30
1683356617811,MATH 20D,A02,188415,Hammock; Frances H,3,0,30,27
1683356617811,MATH 20D,B01,188447,Hammock; Frances H,1,0,30,29
1683356617811,MATH 20D,B02,188486,Hammock; Frances H,8,0,30,22
1683356618837,MATH 20E,A01,188649,Staff,21,0,30,9
1683356618837,MATH 20E,A02,188650,Staff,23,0,30,7
1683356618837,MATH 20E,A03,188673,Staff,0,0,30,30
1683356619860,MATH 102,A01,188675,Staff,0,35,35,35
1683356620890,MATH 103B,A01,188681,Staff,3,0,35,32
1683356620890,MATH 103B,B01,188692,Staff,5,0,35,30
1683356621920,MATH 109,A01,188695,Salehi Golsefidy; Alireza,25,0,35,10
1683356621920,MATH 109,A02,188696,Salehi Golsefidy; Alireza,25,0,35,10
1683356622946,MATH 120A,A01,188698,Eggers; John Dietrich,7,0,35,28
1683356623976,MATH 142B,A01,188736,Ioana; Adrian,0,2,30,30
1683356623976,MATH 142B,A02,188741,Ioana; Adrian,0,0,30,30
1683356623976,MATH 142B,A03,188743,Ioana; Adrian,0,1,30,30
1683356625001,MATH 168A,A01,188790,Staff,0,9,35,35
1683356626026,MATH 170A,A01,188803,Nie; Jiawang,0,2,35,35
1683356626026,MATH 170A,A02,188811,Nie; Jiawang,0,0,35,35
1683356626026,MATH 170A,A03,188814,Nie; Jiawang,1,0,35,34
1683356626026,MATH 170A,A04,188815,Nie; Jiawang,13,0,35,22
1683356627054,MATH 193B,A01,188817,Staff,0,0,35,35
1683356627054,MATH 193B,A02,188818,Staff,5,0,35,30
1683356628078,MGT 4,A01,202857,Anderson; John Charles,61,0,80,19
1683356629107,MGT 12,A00,202858,Lindenberger; Wade Douglas,42,0,90,48
1683356630131,MGT 18,A00,202859,Staff,74,0,90,16
1683356631160,MGT 18GS,A00,202860,McKay; Michael J,13,0,28,15
1683356632188,MGT 45,A00,202861,Pecore; Joseph P.,14,0,90,76
1683356633212,MGT 100,A00,202863,Yavorsky; Daniel Ryan,28,0,90,62
1683356634241,MGT 103,A00,202864,Ehrich; Kristine R,0,17,90,90
1683356635270,MGT 112,A00,202865,Ehrich; Kristine R,15,0,90,75
1683356636294,MGT 121A,A00,202868,Staff,0,20,0,0
1683356637319,MGT 131B,A00,202869,Anderson; John Charles,59,0,90,31
1683356638341,MGT 136,A00,202871,Lindenberger; Wade Douglas,84,0,90,6
1683356639366,MGT 164,A00,202873,Staff,0,68,90,91
1683356640392,MGT 164GS,A00,202874,McKay; Mary A,13,0,28,15
1683356641418,MGT 180,A00,202875,Staff,0,50,90,91
1683356642453,MMW 11R,A01,205019,Herbst; Matthew,3,0,30,27
1683356642453,MMW 11R,A02,205026,Herbst; Matthew,29,0,30,1
1683356643484,MMW 15,A01,193512,Chang; Edmond Yi-Teh,0,9,28,28
1683356643484,MMW 15,A02,193513,Chang; Edmond Yi-Teh,0,5,28,28
1683356643484,MMW 15,A03,193514,Chang; Edmond Yi-Teh,0,5,28,28
1683356643484,MMW 15,A04,193515,Chang; Edmond Yi-Teh,0,5,28,28
1683356643484,MMW 15,A05,193516,Chang; Edmond Yi-Teh,0,4,28,28
1683356643484,MMW 15,A06,193517,Chang; Edmond Yi-Teh,0,5,28,28
1683356643484,MMW 15,B01,193519,Chang; Edmond Yi-Teh,0,5,28,28
1683356643484,MMW 15,B02,193520,Chang; Edmond Yi-Teh,0,5,28,28
1683356643484,MMW 15,B03,193521,Chang; Edmond Yi-Teh,0,5,28,28
1683356643484,MMW 15,B04,193522,Chang; Edmond Yi-Teh,0,4,28,28
1683356643484,MMW 15,B05,193523,Chang; Edmond Yi-Teh,0,5,28,28
1683356643484,MMW 15,B06,193524,Chang; Edmond Yi-Teh,0,4,28,28
1683356644519,MMW 122,A01,193526,Rahimi; Babak,0,15,28,28
1683356644519,MMW 122,A02,193527,Rahimi; Babak,0,14,28,28
1683356644519,MMW 122,A03,193528,Rahimi; Babak,0,0,0,0
1683356644519,MMW 122,A04,193529,Rahimi; Babak,0,0,0,0
1683356645545,MUS 1A,A01,186663,Staff,0,20,35,35
1683356646574,MUS 4,A01,186715,Staff,0,12,35,35
1683356647598,MUS 5R,A01,186796,Dubnov; Shlomo,0,17,35,35
1683356648626,MUS 6,A01,186798,Staff,0,4,25,25
1683356649651,MUS 7,A01,186830,Staff,13,0,35,22
1683356650682,MUS 8,A01,186930,Staff,0,26,35,35
1683356651707,MUS 15,A01,186932,Staff,0,16,35,35
1683356651707,MUS 15,B01,186934,Staff,0,15,35,35
1683356652732,MUS 80,A00,186935,Staff,1,0,20,19
1683356652732,MUS 80,B00,186936,Staff,25,0,25,0
1683356653758,NANO 11,A00,204702,Lipomi; Darren John,0,0,0,0
1683356654788,NANO 15,A01,204709,Yang; Kesong,0,1,0,0
1683356655816,NANO 114,A00,202069,Jahed Motlagh; Zeinab,3,0,10,7
1683356656845,PHIL 1,A00,186955,Grush; Rick Scott,32,0,40,8
1683356657870,PHIL 10,A01,186973,Grush; Rick Scott,28,0,35,7
1683356657870,PHIL 10,A02,186974,Grush; Rick Scott,33,0,35,2
1683356658896,PHIL 13,A01,186976,Staff,7,0,35,28
1683356658896,PHIL 13,A02,186977,Staff,16,0,35,19
1683356659926,PHIL 14,A01,186979,Staff,31,0,35,4
1683356659926,PHIL 14,A02,186986,Staff,32,0,35,3
1683356660951,PHIL 28,A01,186988,Staff,16,0,30,14
1683356660951,PHIL 28,A02,186989,Staff,1,0,30,29
1683356660951,PHIL 28,A03,186990,Staff,9,0,30,21
1683356660951,PHIL 28,A04,186991,Staff,26,0,30,4
1683356661975,PHIL 120,A00,186997,Staff,23,0,40,17
1683356663000,PHIL 137,A00,187003,Staff,9,0,40,31
1683356664024,PHIL 150,A00,187015,Staff,47,0,70,23
1683356665055,PHIL 167,A00,187021,Lamey; Andy M.,35,0,40,5
1683356666080,PHIL 174,A01,202226,Staff,17,0,20,3
1683356666080,PHIL 174,A02,202235,Staff,20,0,20,0
1683356667110,PHIL 191A,A00,258918,Staff,0,0,1,1
1683356668133,PHYS 1A,A00,187028,Staff,27,0,60,33
1683356669159,PHYS 1AL,001,187036,Staff,2,0,30,28
1683356669159,PHYS 1AL,002,187049,Staff,18,0,30,12
1683356670187,PHYS 1B,A00,187058,Staff,22,0,60,38
1683356671214,PHYS 1BL,001,187064,Staff,0,0,30,30
1683356671214,PHYS 1BL,002,187070,Staff,5,0,30,25
1683356672241,PHYS 1C,A00,187082,Staff,31,0,120,89
1683356673270,PHYS 1CL,001,187088,Staff,0,9,30,30
1683356673270,PHYS 1CL,002,187089,Staff,0,2,30,30
1683356673270,PHYS 1CL,009,262693,Staff,11,0,30,19
1683356674294,PHYS 2B,A01,187097,Staff,54,0,115,61
1683356675323,PHYS 2C,A01,187099,Staff,67,0,115,48
1683356676351,PHYS 2CL,A01,187101,Staff,5,0,28,23
1683356676351,PHYS 2CL,A02,187102,Staff,15,0,28,13
1683356677380,PHYS 2D,A01,187123,Shotwell; Brian,95,0,115,20
1683356678405,PHYS 4B,A01,187133,Grinstein; Benjamin,35,0,50,15
1683356679430,POLI 10,A00,188819,Staff,0,4,50,50
1683356680454,POLI 11,A00,188827,Staff,43,0,50,7
1683356681478,POLI 13R,A00,188828,Staff,0,1,20,20
1683356682509,POLI 27,A01,188830,Elgin; Samuel Zincke,0,1,70,70
1683356683537,POLI 30,A00,188832,Desposato; Scott,31,0,50,19
1683356684562,POLI 102F,A00,188834,Staff,3,0,40,37
1683356685587,POLI 104A,A00,188852,Staff,14,0,30,16
1683356686611,POLI 104I,A00,188853,Staff,0,6,20,20
1683356687635,POLI 110B,A00,188854,Wiens; David,7,0,20,13
1683356688664,POLI 112A,A00,188855,Wiens; David,5,0,30,25
1683356689689,POLI 117R,A00,188856,Forman; Fonna,0,11,20,20
1683356690713,POLI 118,A00,188857,Ingham; Sean,8,0,20,12
1683356691737,POLI 120G,A00,188858,Staff,9,0,30,21
1683356692765,POLI 131CR,A00,188863,Hoston; Germaine,23,0,50,27
1683356693789,POLI 133,A00,188864,Nellis; Gareth Hb,44,0,50,6
1683356694813,POLI 134D,A00,188865,Desposato; Scott,27,0,30,3
1683356695842,POLI 142A,A00,188871,Gartzke; Erik,22,0,50,28
1683356696866,POLI 142K,A00,188874,Staff,38,0,50,12
1683356697895,POLI 143,A00,188940,Gartzke; Erik,16,0,30,14
1683356698922,POLI 153,A00,188943,Staff,3,0,20,17
1683356699949,POLI 160AA,A00,188944,Staff,11,0,40,29
1683356700979,POLI 170A,A00,188945,Staff,11,0,30,19
1683356703107,PSYC 1,A00,188952,Staff,37,0,90,53
1683356704133,PSYC 2,B00,188953,Staff,19,0,35,16
1683356705161,PSYC 6,A00,188970,Staff,47,0,60,13
1683356706185,PSYC 7,A00,188973,Staff,37,0,45,8
1683356707214,PSYC 60,A01,188980,Rickard; Timothy C.,43,0,60,17
1683356708243,PSYC 70,A01,189001,Steiner; Eric Tomas,23,0,45,22
1683356709273,PSYC 100,A00,189005,Lacefield; Katharine I,0,98,120,120
1683356710298,PSYC 102,A00,189008,Staff,9,0,30,21
1683356711325,PSYC 106,B00,189026,Gorman; Michael R.,34,0,60,26
1683356712355,PSYC 114,B01,189033,Winkielman; Piotr,0,32,30,30
1683356713381,PSYC 131,A00,189036,Anagnostaras; Stephan,0,43,60,60
1683356714410,PSYC 136,A00,189041,Lowe; Angela Beth,0,7,25,25
1683356715441,PSYC 137,A00,189057,Winkielman; Piotr,0,34,25,25
1683356716467,PSYC 144,A00,189107,Wixted; John T,0,7,50,50
1683356718515,PSYC 162,A00,189142,Staff,0,8,85,85
1683356719540,PSYC 172,A00,189144,Gorman; Michael R.,0,7,30,30
1683356721591,PSYC 179,A00,189146,Lacefield; Katharine I,0,84,120,120
1683356722616,PSYC 181,A00,189147,Anagnostaras; Stephan,0,44,90,90
1683356723645,PSYC 190R,A00,189148,Barner; David A.,0,22,80,80
1683356724674,PSYC 191,A00,189275,Rickard; Timothy C.,0,7,25,25
1683356725703,PSYC 193,A00,189276,Chapman; Eddie Nathaniel,0,1,0,4
1683356726731,PSYC 193L,A01,189281,Lowe; Angela Beth,12,0,20,8
1683356726731,PSYC 193L,B01,189285,Staff,28,0,35,7
1683356727757,RELI 149,A00,187137,Rahimi; Babak,7,0,40,33
1683356728790,SE 9,A01,187315,Staff,0,2,18,18
1683356729814,SE 101B,A00,187409,Staff,24,0,30,6
1683356730837,SE 110B,A00,187444,Staff,10,0,40,30
1683356731863,SE 130B,A00,187449,Staff,31,0,40,9
1683356732890,SE 150A,A00,187516,Staff,9,0,20,11
1683356733913,SE 154,A00,187528,Staff,30,0,50,20
1683356734937,SIO 3,A01,258171,Staff,35,0,40,5
1683356735961,SIO 10,A00,187144,Cook; Geoffrey W,0,3,75,75
1683356736989,SIO 45,A00,187152,Cook; Geoffrey W,1,0,100,99
1683356738016,SIO 109R,A00,194486,Staff,0,3,20,20
1683356740065,SIO 187,A01,187233,Kacev; David,12,0,40,28
1683356741095,SOCI 1,A01,258656,Thorpe; Charles Robert,28,0,30,2
1683356741095,SOCI 1,A02,258658,Thorpe; Charles Robert,30,0,30,0
1683356741095,SOCI 1,A03,258661,Thorpe; Charles Robert,25,0,25,0
1683356741095,SOCI 1,A04,258666,Thorpe; Charles Robert,22,0,25,3
1683356741095,SOCI 1,A05,258897,Thorpe; Charles Robert,23,0,25,2
1683356741095,SOCI 1,A06,258898,Thorpe; Charles Robert,25,0,25,0
1683356742123,SOCI 30,A01,258903,Pardo Guerra; Juan Pablo,15,0,30,15
1683356743150,SOCI 102,A00,258904,Staff,9,0,25,16
1683356744177,SOCI 106,A00,258905,Staff,19,0,25,6
1683356745202,SOCI 111,A00,258907,Ribas Norris; Janet Vanesa,26,0,30,4
1683356746228,SOCI 121R,A00,258908,Pardo Guerra; Juan Pablo,10,0,30,20
1683356747253,SOCI 126,A01,203330,Staff,14,0,20,6
1683356748277,SOCI 131,A00,258909,Thorpe; Charles Robert,31,0,60,29
1683356749302,SOCI 135,A00,258910,Payne; Christine Anna,0,9,30,30
1683356750330,SOCI 157,A00,258911,Staff,12,0,30,18
1683356751355,SOCI 184,A00,258912,Staff,25,0,30,5
1683356752382,SOCI 188D,A00,258913,Staff,22,0,30,8
1683356753407,SYN 2,001,187529,Staff,10,0,16,6
1683356753407,SYN 2,002,201452,Staff,0,18,16,16
1683356753407,SYN 2,003,201469,Staff,3,0,16,13
1683356754432,SYN 100,A01,187531,Staff,0,9,20,20
1683356754432,SYN 100,B01,201491,Staff,0,12,20,20
1683356755462,TDAC 1,A00,189286,Walsh; Kim C.,3,0,20,17
1683356755462,TDAC 1,B00,189287,Harting; Carla Kelso,11,0,20,9
1683356756491,TDAC 101,A00,189300,Walsh; Kim C.,16,0,20,4
1683356756491,TDAC 101,B00,189301,Harting; Carla Kelso,18,0,20,2
1683356757518,TDAC 102,A00,189304,Basso; Beatrice,14,0,20,6
1683356758541,TDAC 108,A00,189305,Staff,18,0,20,2
1683356759567,TDDE 131,A00,189310,Staff,19,0,20,1
1683356759567,TDDE 131,B00,189314,Staff,19,0,20,1
1683356759567,TDDE 131,C00,189315,Staff,48,0,50,2
1683356759567,TDDE 131,D00,189316,Staff,14,0,15,1
1683356759567,TDDE 131,E00,204841,Staff,20,0,20,0
1683356760593,TDGE 10,A00,189289,Staff,30,0,50,20
1683356760593,TDGE 10,B00,189290,Havis; Allan,1,0,50,49
1683356761624,TDGE 11,A00,189291,Fulton; Julia,0,3,50,50
1683356761624,TDGE 11,B00,189292,Staff,20,0,25,5
1683356761624,TDGE 11,C00,260270,Staff,0,0,0,0
1683356762649,TDGE 25,A00,189294,Staff,3,0,20,17
1683356763678,TDGE 124,A00,189318,Fulton; Julia,0,8,50,50
1683356764700,TDGE 125,A00,189319,Staff,13,0,25,12
1683356764700,TDGE 125,B00,189320,Staff,23,0,25,2
1683356765724,TDGE 127,A00,189322,Havis; Allan,0,0,50,50
1683356766750,TDHT 101,A00,189323,Staff,18,0,25,7
1683356766750,TDHT 101,B00,189324,Staff,25,0,25,0
1683356767777,TDHT 102,A00,189325,Staff,49,0,50,1
1683356768807,TDMV 1,A00,189295,Arcidiacono; Kristin,19,0,30,11
1683356768807,TDMV 1,B00,189296,Caligagan; Maria T.,24,0,30,6
1683356769832,TDMV 2,A00,189297,Sammartano; Tonnie,28,0,30,2
1683356769832,TDMV 2,B00,189299,Arcidiacono; Kristin,24,0,30,6
1683356770857,TDMV 3,A00,204998,Rincon; Alicia,22,0,30,8
1683356771885,TDMV 120,A00,189458,Sammartano; Tonnie,28,0,30,2
1683356772912,TDMV 138,A00,189541,Jun; Grace Shin Hae,22,0,40,18
1683356773936,TDMV 142,A00,189717,Caligagan; Tony,23,0,30,7
1683356773936,TDMV 142,B00,189718,Caligagan; Maria T.,25,0,30,5
1683356774964,TMC 2,A01,187533,Staff,25,0,25,0
1683356774964,TMC 2,A02,187534,Staff,25,0,25,0
1683356775993,USP 1,A01,187536,Kwak; Nancy,0,16,25,25
1683356777026,USP 5,A01,187538,Staff,10,0,25,15
1683356778050,USP 101,A00,199253,Staff,0,4,0,0
1683356779075,USP 124,A00,187562,Boomhower; Matthew Charles,1,0,30,29
1683356780101,USP 138,A00,187582,Staff,20,0,25,5
1683356781125,USP 152,A01,187597,Staff,4,0,25,21
1683356782150,USP 153,A00,187598,Staff,19,0,25,6
1683356783178,USP 168,A00,187607,Kwak; Nancy,2,0,5,3
1683356784205,USP 173,A00,187619,Staff,4,0,25,21
1683356785233,USP 181,A00,187638,Staff,0,3,25,25
1683356786260,VIS 103,A00,187650,Cruz; Edwin Teddy,22,0,75,53
1683356787287,VIS 110D,A00,187669,Staff,12,0,22,10
1683356788311,VIS 127C,A00,187720,Shen; Kuiyi,67,0,146,79
1683356789337,VIS 149,A00,187731,Yoldas; Pinar,0,14,22,22
1683356790366,VIS 151,A01,188091,Staff,22,0,34,12
1683356790366,VIS 151,A02,188092,Staff,11,0,34,23
1683356791390,VIS 160B,A00,188093,Stalbaum; Brett,0,0,10,10
1683356793447,WCWP 10B,A00,201720,Staff,10,0,15,5
1683356793447,WCWP 10B,B00,201722,Staff,9,0,15,6
1683356794476,WCWP 100,A00,201725,Gagnon; Jeffrey C,0,0,2,2
1683356794476,WCWP 100,B00,201727,Staff,0,4,15,15
1683356797574,ANBI 133,A00,258401,Wilder; Linnea Lorene,34,0,40,6
1683356798599,ANBI 140,A00,258395,Hrvoj Mihic; Branka,18,0,25,7
1683356799623,ANSC 120,A00,258402,Bialecki; Jon Anthony,27,0,40,13
1683356800651,ANSC 144,A00,258400,Staff,14,0,40,26
1683356802705,ANSC 166,A00,258396,Parish; Steven Martin,157,0,175,18
1683356803731,ANSC 180,A00,193533,Staff,9,0,20,11
1683356804759,ANSC 188,A00,258397,Jassal; Aftab,33,0,40,7
1683356805837,ANTH 3,A01,258316,Staff,23,0,30,7
1683356806867,ANTH 5,A00,258394,Semendeferi; Ekaterini,16,0,20,4
1683356807893,ANTH 21,A01,258331,Staff,8,0,40,32
1683356808921,ANTH 103,A00,258398,Varma; Saiba,15,0,25,10
1683356809956,AWP 10,001,202034,Staff,0,0,0,0
1683356809956,AWP 10,002,202035,Staff,0,0,0,0
1683356809956,AWP 10,003,202036,Staff,0,0,0,0
1683356809956,AWP 10,004,202037,Staff,0,0,0,0
1683356809956,AWP 10,005,202038,Staff,0,0,0,0
1683356809956,AWP 10,006,202039,Staff,0,0,0,0
1683356809956,AWP 10,007,202040,Staff,0,0,0,0
1683356809956,AWP 10,008,202041,Staff,0,0,0,0
1683356809956,AWP 10,009,202042,Staff,0,0,0,0
1683356809956,AWP 10,010,202043,Staff,0,0,0,0
1683356809956,AWP 10,011,202044,Staff,0,0,0,0
1683356809956,AWP 10,012,202045,Staff,0,0,0,0
1683356809956,AWP 10,013,202046,Staff,0,0,0,0
1683356809956,AWP 10,014,202047,Staff,0,0,0,0
1683356809956,AWP 10,015,202048,Staff,0,0,0,0
1683356809956,AWP 10,016,202049,Staff,0,0,0,0
1683356809956,AWP 10,017,202050,Staff,0,0,0,0
1683356809956,AWP 10,018,202051,Staff,0,0,0,0
1683356809956,AWP 10,019,202052,Staff,0,0,0,0
1683356809956,AWP 10,020,202053,Staff,0,0,0,0
1683356809956,AWP 10,021,202054,Staff,0,0,0,0
1683356809956,AWP 10,022,202055,Staff,0,0,0,0
1683356809956,AWP 10,023,202056,Staff,0,0,0,0
1683356809956,AWP 10,024,202057,Staff,0,0,0,0
1683356809956,AWP 10,025,202058,Staff,0,0,0,0
1683356809956,AWP 10,026,202059,Staff,0,0,0,0
1683356810985,AWP 102,001,202032,Staff,0,0,0,0
1683356810985,AWP 102,002,202033,Staff,0,0,0,0
1683356812016,BENG 100,A01,254234,Taylor Amos; Alyssa C,31,0,40,9
1683356813043,BENG 196,001,270013,Engler; Adam J.,9999,0,9999,0
1683356814069,BICD 100R,A01,202018,Smith; Laurie,0,7,32,32
1683356814069,BICD 100R,A02,202019,Smith; Laurie,0,2,32,32
1683356814069,BICD 100R,A03,202020,Smith; Laurie,0,1,32,32
1683356814069,BICD 100R,A04,202021,Smith; Laurie,9,0,32,23
1683356814069,BICD 100R,A05,202022,Smith; Laurie,12,0,32,20
1683356815094,BICD 136,A01,193242,Gustafson-Brown; Cindy,0,2,32,32
1683356815094,BICD 136,A02,193244,Gustafson-Brown; Cindy,14,0,32,18
1683356816120,BIEB 102,A01,193249,Butler; Shannon Rhey,0,2,32,32
1683356816120,BIEB 102,A02,193251,Butler; Shannon Rhey,0,0,32,32
1683356816120,BIEB 102,A03,193253,Butler; Shannon Rhey,0,1,32,32
1683356816120,BIEB 102,A04,193255,Butler; Shannon Rhey,17,0,32,15
1683356816120,BIEB 102,A05,193265,Butler; Shannon Rhey,26,0,32,6
1683356816120,BIEB 102,A06,193269,Butler; Shannon Rhey,16,0,32,16
1683356818175,BIEB 150,A01,193274,Staff,0,0,32,32
1683356818175,BIEB 150,A02,193285,Staff,23,0,32,9
1683356819200,BIEB 194,A00,193286,Kurle; Carolyn M.,22,0,32,10
1683356820229,BILD 1,A01,192291,Staff,16,0,32,16
1683356820229,BILD 1,A02,192292,Staff,30,0,32,2
1683356820229,BILD 1,B01,192520,Reuther; Keefe,0,1,0,0
1683356820229,BILD 1,B02,192532,Reuther; Keefe,0,1,0,0
1683356821253,BILD 3,A01,192556,Butler; Shannon Rhey,0,0,32,32
1683356821253,BILD 3,A02,192581,Butler; Shannon Rhey,4,0,32,28
1683356821253,BILD 3,A03,192611,Butler; Shannon Rhey,23,0,32,9
1683356821253,BILD 3,A04,192612,Butler; Shannon Rhey,25,0,32,7
1683356821253,BILD 3,A05,192613,Butler; Shannon Rhey,27,0,32,5
1683356821253,BILD 3,A06,192679,Butler; Shannon Rhey,27,0,32,5
1683356821253,BILD 3,A07,192682,Butler; Shannon Rhey,22,0,32,10
1683356822279,BILD 4,A01,192836,Reuther; Keefe,0,0,24,24
1683356822279,BILD 4,A02,193044,Reuther; Keefe,4,0,24,20
1683356823305,BILD 10,A01,193142,Gustafson-Brown; Cindy,30,0,32,2
1683356823305,BILD 10,A02,193149,Gustafson-Brown; Cindy,31,0,32,1
1683356824334,BIMM 100,A01,193301,Staff,0,6,32,32
1683356824334,BIMM 100,A02,193312,Staff,0,5,32,32
1683356824334,BIMM 100,A03,193323,Staff,0,8,32,32
1683356825364,BIMM 101,A01,193329,McDonnell; Lisa Marie,0,3,24,24
1683356825364,BIMM 101,A02,193339,McDonnell; Lisa Marie,0,3,24,24
1683356825364,BIMM 101,B01,193354,McDonnell; Lisa Marie,0,3,24,24
1683356825364,BIMM 101,B02,193357,McDonnell; Lisa Marie,0,3,24,24
1683356826390,BIMM 110,A01,193377,Tat; John,0,11,32,32
1683356826390,BIMM 110,A02,193378,Tat; John,0,9,32,32
1683356827413,BIMM 120,A01,206116,Staff,0,0,32,32
1683356827413,BIMM 120,A02,206117,Staff,8,0,32,24
1683356827413,BIMM 120,A03,206121,Staff,21,0,32,11
1683356828442,BIPN 100,A01,193393,Park; Ji Young,0,14,32,32
1683356828442,BIPN 100,A02,193402,Park; Ji Young,0,13,32,32
1683356828442,BIPN 100,A03,193413,Park; Ji Young,0,14,32,32
1683356828442,BIPN 100,A04,193414,Park; Ji Young,0,13,32,32
1683356829467,BIPN 102,A01,193429,Staff,0,0,32,32
1683356829467,BIPN 102,A02,193438,Staff,22,0,32,10
1683356830492,BIPN 106,A01,193450,Reyes Gonzalez; Catalina,0,2,40,40
1683356831517,BIPN 134,A01,193465,Cooke; James Edward,1,0,32,31
1683356831517,BIPN 134,A02,193474,Cooke; James Edward,25,0,32,7
1683356831517,BIPN 134,A03,193485,Cooke; James Edward,29,0,32,3
1683356831517,BIPN 134,A04,193486,Cooke; James Edward,21,0,32,11
1683356831517,BIPN 134,A05,193491,Cooke; James Edward,31,0,32,1
1683356831517,BIPN 134,A06,193501,Cooke; James Edward,30,0,32,2
1683356831517,BIPN 134,A07,193510,Cooke; James Edward,29,0,32,3
1683356833566,BISP 194,A00,222522,Staff,14,0,32,18
1683356834590,CAT 124,A01,202407,Staff,20,0,25,5
1683356835615,CAT 125,A00,202408,Marchisotto; Jennifer Anne,4,0,20,16
1683356836645,CAT 125R,A00,202409,Smith; Lauryn Alissa,0,11,20,20
1683356836645,CAT 125R,B00,202410,Morales; Celeste Georgianna,0,11,20,20
1683356836645,CAT 125R,C00,202411,Irwin; Matthew Joseph,0,10,20,20
1683356837670,CENG 15,A01,204712,Yang; Kesong,0,1,0,0
1683356838695,CENG 114,A00,202070,Jahed Motlagh; Zeinab,5,0,20,15
1683356839721,CGS 105,A00,185477,Wesling; Megan E.,24,0,40,16
1683356840750,CGS 106,A00,185494,Staff,13,0,22,9
1683356841775,CGS 108,A00,185495,Staff,14,0,20,6
1683356842801,CGS 114,A00,185496,Staff,13,0,18,5
1683356843825,CGS 119,A00,185501,Staff,15,0,20,5
1683356844850,CGS 120,A00,185511,Staff,13,0,20,7
1683356845878,CHEM 4,A01,184675,Bussey; Thomas J,96,0,100,4
1683356846903,CHEM 6A,A01,184677,Staff,34,0,60,26
1683356847932,CHEM 6B,A01,184679,Staff,65,0,100,35
1683356848962,CHEM 6C,A01,184681,Bussey; Thomas J,1,0,50,49
1683356848962,CHEM 6C,A02,184682,Bussey; Thomas J,34,0,50,16
1683356849991,CHEM 40A,A01,184684,Albizati; Kim F.,37,0,100,63
1683356851020,CHEM 40B,A01,184686,Albizati; Kim F.,0,20,100,100
1683356852044,CHEM 41B,A01,184690,Staff,52,0,100,48
1683356853072,COGS 3,A01,184715,Boyle; Mary E. T.,0,25,40,40
1683356854094,COGS 14B,A01,185172,Staff,0,15,38,38
1683356855121,COGS 18,A01,184736,Staff,17,0,80,63
1683356856148,COGS 100,A01,184932,Staff,0,5,73,73
1683356857177,COGS 101A,A01,184935,Staff,0,39,30,30
1683356858202,COGS 101B,A01,184944,Staff,0,2,30,30
1683356859226,COGS 101C,A01,184946,Staff,0,12,30,30
1683356860250,COGS 102A,A01,184951,Johnson; Christine M.,2,0,40,38
1683356861280,COGS 107B,A01,184953,Mooshagian; Eric Frederick,0,50,40,40
1683356862305,COGS 118B,A01,184959,Gupta; Anjum,0,48,40,40
1683356863334,COGS 153,A00,184961,Staff,0,15,30,30
1683356864359,COGS 177,A00,184962,Staff,0,20,30,30
1683356865390,COGS 187A,A01,184969,Boyle; Mary E. T.,0,17,40,40
1683356866419,COMM 10,A01,185174,Staff,0,5,25,25
1683356866419,COMM 10,A02,185189,Staff,0,5,25,25
1683356866419,COMM 10,A03,269821,Staff,0,0,0,0
1683356867445,COMM 100B,A01,185475,Staff,0,0,0,2
1683356867445,COMM 100B,A02,185476,Staff,13,0,25,12
1683356868473,COMM 100C,A01,185314,Staff,1,0,25,24
1683356868473,COMM 100C,A02,185327,Staff,19,0,25,6
1683356869498,COMM 110M,A00,185349,Staff,2,0,40,38
1683356870526,COMM 113T,A00,185352,Staff,24,0,40,16
1683356871553,COMM 114I,A00,185353,Staff,33,0,40,7
1683356872581,COMM 131,A00,185354,Staff,19,0,30,11
1683356873610,CSE 8A,A50,185358,Cao; Yingjun,0,46,10,10
1683356874634,CSE 8B,A01,185362,Staff,0,46,50,50
1683356875662,CSE 11,A01,185416,Cao; Yingjun,0,92,10,10
1683356876691,CSE 20,A01,185445,Briones; Jor-el Thomas Caparas,5,0,25,20
1683356877715,CSE 21,A01,185447,Staff,10,0,50,40
1683356878740,CSE 101,A01,185451,Staff,0,13,50,50
1683356878740,CSE 101,B01,185453,Jones; Miles E,0,11,50,50
1683356880797,CSE 141,A01,185458,Eldon; John,20,0,100,80
1683356881827,CSE 141L,A01,185461,Eldon; John,12,0,100,88
1683356882858,CSE 142,A01,185463,Staff,36,0,60,24
1683356882858,CSE 142,B01,201355,Staff,0,7,60,60
1683356883889,CSE 142L,A01,185470,Staff,36,0,60,24
1683356883889,CSE 142L,B01,201417,Staff,0,6,60,60
1683356884914,CSE 190,A00,201433,Staff,32,0,49,17
1683356885943,DOC 1,A01,259136,Strom; Megan C.,7,0,15,8
1683356885943,DOC 1,A02,259137,Strom; Megan C.,14,0,15,1
1683356885943,DOC 1,A03,259138,Strom; Megan C.,14,0,15,1
1683356885943,DOC 1,A04,259139,Strom; Megan C.,14,0,15,1
1683356886968,DOC 100D,A00,259140,Pass; Natalye Joann,16,0,25,9
1683356887992,DSGN 1,A01,184749,Rill; Bryan,0,25,30,30
1683356889019,DSGN 100,A01,185168,Staff,0,2,25,25
1683356890048,ECE 5,A01,185626,Morris; Karcher William,0,10,0,0
1683356891077,ECE 101,A01,185628,Staff,17,0,70,53
1683356892102,ECE 107,A01,185635,Baghdadchi; Saharnaz,0,0,20,20
1683356892102,ECE 107,A02,185638,Baghdadchi; Saharnaz,4,0,20,16
1683356893131,ECE 148,A01,185647,Silberman; Jack,0,0,16,16
1683356894158,ECON 1,A01,185537,Crane; Meredith Helen,54,0,70,16
1683356895184,ECON 3,A01,185549,Crane; Meredith Helen,32,0,70,38
1683356896214,ECON 4,A01,203354,Anderson; John Charles,0,4,10,10
1683356897243,ECON 100A,A01,185574,Staff,0,4,40,40
1683356898268,ECON 100B,A01,185576,Staff,0,12,50,50
1683356899297,ECON 100C,A01,185589,Newhouse; Herbert S,29,0,70,41
1683356900325,ECON 105,A00,185608,Vespa; Emanuel Ignacio,19,0,35,16
1683356901353,ECON 109,A01,185610,Shishkin; Denis,10,0,35,25
1683356902376,ECON 110A,A01,185612,Staff,11,0,40,29
1683356903404,ECON 120A,A01,185615,Staff,20,0,40,20
1683356904432,ECON 120C,A01,185617,Sun; Yixiao,0,21,70,70
1683356905459,ECON 144,A00,203346,Squires; Dale E,3,0,35,32
1683356906523,ECON 171,A01,203349,Newhouse; Herbert S,0,1,35,35
1683356907548,ECON 173A,A01,185621,Toda; Alexis Akira,21,0,35,14
1683356908579,EDS 25,A01,202413,Staff,0,1,0,0
1683356908579,EDS 25,A02,202414,Staff,0,1,0,0
1683356908579,EDS 25,A03,202415,Staff,0,0,0,0
1683356908579,EDS 25,A04,202416,Staff,0,1,0,0
1683356908579,EDS 25,A05,202439,Staff,0,0,0,0
1683356908579,EDS 25,A06,202440,Staff,0,0,0,0
1683356908579,EDS 25,B01,202631,Staff,0,0,0,0
1683356908579,EDS 25,B02,202632,Staff,0,0,0,0
1683356908579,EDS 25,B03,202639,Staff,0,0,0,0
1683356908579,EDS 25,B04,202640,Staff,0,0,0,0
1683356908579,EDS 25,B05,202643,Staff,0,0,0,0
1683356908579,EDS 25,B06,202644,Staff,0,0,0,0
1683356909661,EDS 38,A01,202659,Black; Alison Michelle,24,0,25,1
1683356910690,EDS 115,A00,202652,Staff,18,0,30,12
1683356911715,EDS 125,A00,202649,Staff,14,0,30,16
1683356912743,EDS 126,A01,203332,Staff,30,0,30,0
1683356913767,EDS 139,A00,202838,Staff,16,0,25,9
1683356914792,EDS 146,A01,202655,Staff,14,0,25,11
1683356915818,ENG 15,A00,185667,Staff,0,1,0,0
1683356915818,ENG 15,B00,185672,Staff,0,0,0,0
1683356915818,ENG 15,C00,185675,Staff,0,0,0,0
1683356915818,ENG 15,D00,185682,Staff,0,0,0,0
1683356915818,ENG 15,E00,185684,Staff,0,0,0,0
1683356916843,ETHN 103,A00,185710,Staff,0,4,35,35
1683356917872,ETHN 103A,A00,199228,Man; Simeon S,2,0,9,7
1683356918896,ETHN 109,A00,185711,Staff,18,0,35,17
1683356919925,ETHN 142,A00,185726,Staff,0,4,30,30
1683356920949,ETHN 163J,A00,199229,Man; Simeon S,5,0,8,3
1683356921978,ETHN 168,A00,185727,Staff,8,0,10,2
1683356923005,ETHN 182,A00,185728,Staff,0,0,35,35
1683356924034,ETHN 183,A00,185737,Staff,8,0,18,10
1683356925062,GLBH 111,A01,209361,Burgos; Jose L.,0,0,0,0
1683356927111,HIEU 104,A00,185792,Staff,16,0,20,4
1683356928136,HIEU 115,A00,185800,Staff,1,0,20,19
1683356929163,HIEU 128,A00,185801,Staff,0,7,20,20
1683356930187,HIEU 147,A00,185802,Staff,16,0,20,4
1683356931212,HIEU 154,A00,185823,Staff,12,0,20,8
1683356932237,HILA 102,A00,185826,Staff,13,0,20,7
1683356933262,HILD 2C,A01,185778,Staff,0,12,20,20
1683356934287,HILD 7B,A01,185780,Kwak; Nancy,0,15,32,32
1683356934287,HILD 7B,A02,185781,Kwak; Nancy,0,18,32,32
1683356935312,HILD 30,A01,185791,Staff,14,0,20,6
1683356936337,HISC 119,A00,185830,Golan; Tal,0,9,20,20
1683356937363,HITO 156GS,A00,185831,Patterson; Patrick H.,0,0,0,23
1683356938388,HIUS 103,A00,185832,Man; Simeon S,0,6,20,20
1683356939412,HIUS 117,A00,185836,Kwak; Nancy,2,0,20,18
1683356940435,HIUS 125,A00,185840,Man; Simeon S,0,0,23,23
1683356941462,HIUS 149,A00,185845,Staff,0,0,20,20
1683356942487,HUM 3,A01,185882,Zavodny; Tatiana Sophia,0,7,50,50
1683356942487,HUM 3,B01,185899,Caldwell; Michael Alan,0,18,50,50
1683356943512,HUM 3GS,A00,185900,Patterson; Patrick H.,0,0,0,23
1683356944538,HUM 4,A01,185938,Zroka; Amy Liane,31,0,50,19
1683356944538,HUM 4,B01,185956,Watkins; Eric,0,3,50,50
1683356944538,HUM 4,B02,202209,Watkins; Eric,0,2,50,50
1683356944538,HUM 4,B03,202210,Watkins; Eric,0,2,50,50
1683356945563,HUM 5,A01,185958,West; Geoffrey Scott,3,0,50,47
1683356945563,HUM 5,A02,202215,West; Geoffrey Scott,0,0,50,50
1683356946594,INTL 190,A00,185959,Gagnon; Jeffrey C,0,0,0,9
1683356946594,INTL 190,B00,185960,Lettieri; Michael Joseph,0,0,0,1
1683356947617,JAPN 180,A00,254509,Staff,4,0,30,26
1683356948647,LATI 10,A01,202853,Kennemore; Amy Michelle,4,0,35,31
1683356948647,LATI 10,A02,202854,Kennemore; Amy Michelle,2,0,35,33
1683356948647,LATI 10,A03,270054,Kennemore; Amy Michelle,30,0,30,0
1683356949675,LATI 180,A00,202855,Kennemore; Amy Michelle,11,0,20,9
1683356950699,LAWS 101,A00,201767,Golan; Tal,0,7,40,40
1683356951725,LIFR 1C,A00,185961,Staff,6,0,20,14
1683356952750,LIFR 1CX,A00,185962,Staff,7,0,20,13
1683356953775,LIFR 1D,A00,185963,Staff,9,0,20,11
1683356954800,LIFR 1DX,A00,185964,Staff,9,0,20,11
1683356955825,LIGN 101,A01,186039,Staff,43,0,50,7
1683356956854,LIGN 165,A00,186040,Staff,18,0,50,32
1683356957878,LTCS 108,A00,186041,Staff,6,0,10,4
1683356958903,LTCS 119,A00,186042,Staff,16,0,20,4
1683356959930,LTCS 130,A00,186043,Wesling; Megan E.,15,0,25,10
1683356961983,LTEA 138,A00,186119,Staff,14,0,40,26
1683356963007,LTEN 124,A00,186148,Staff,6,0,25,19
1683356964031,LTEN 178,A00,186149,Staff,7,0,15,8
1683356965056,LTEN 181,A00,186150,Blanco; John D,33,0,40,7
1683356966081,LTWL 120,A00,186160,Staff,20,0,25,5
1683356967109,LTWL 165,A00,186161,Staff,22,0,25,3
1683356968133,LTWR 100,A00,186162,Staff,0,5,15,15
1683356969162,LTWR 102,A00,186163,Doller; Ben,5,0,15,10
1683356970190,MAE 8,A01,186412,Staff,0,0,0,0
1683356971215,MAE 30B,A00,186445,Bahadori; Mohammad Yousef,83,0,100,17
1683356972245,MAE 40,A00,186592,Bewley; Thomas R,10,0,50,40
1683356973268,MAE 101B,A00,186593,Bahadori; Mohammad Yousef,81,0,100,19
1683356974291,MAE 105,A00,186594,Bandaru; Prabhakar,12,0,50,38
1683356975318,MAE 107,A00,186599,Pham; Hieu Tan,0,7,120,120
1683356976342,MAE 148,A01,186660,Silberman; Jack,3,0,16,13
1683356977367,MATH 10A,A01,188095,Staff,0,5,35,35
1683356978397,MATH 10B,A01,188097,Bowers; Adam R.,0,11,30,30
1683356978397,MATH 10B,A02,188099,Bowers; Adam R.,0,11,30,30
1683356978397,MATH 10B,B01,188104,Bowers; Adam R.,0,10,30,30
1683356978397,MATH 10B,B02,188106,Bowers; Adam R.,0,10,30,30
1683356979428,MATH 10C,A01,188111,Staff,0,18,30,30
1683356979428,MATH 10C,A02,188127,Staff,0,17,30,30
1683356979428,MATH 10C,A03,188131,Staff,0,18,30,30
1683356979428,MATH 10C,B01,188218,Staff,18,0,30,12
1683356979428,MATH 10C,B02,188244,Staff,13,0,30,17
1683356979428,MATH 10C,B03,188277,Staff,16,0,30,14
1683356980459,MATH 18,A01,188344,Bach; Quang Tran,18,0,30,12
1683356980459,MATH 18,A02,188345,Bach; Quang Tran,11,0,30,19
1683356980459,MATH 18,B01,188353,Bach; Quang Tran,10,0,30,20
1683356980459,MATH 18,B02,188354,Bach; Quang Tran,20,0,30,10
1683356981486,MATH 20A,A01,188374,Staff,12,0,35,23
1683356982515,MATH 20B,A01,188382,Ohm; Ko Woon,6,0,30,24
1683356982515,MATH 20B,A02,188383,Ohm; Ko Woon,22,0,30,8
1683356982515,MATH 20B,B01,188385,Ohm; Ko Woon,7,0,30,23
1683356982515,MATH 20B,B02,188392,Ohm; Ko Woon,22,0,30,8
1683356983541,MATH 20C,A01,188394,Harel; Guershon,10,0,30,20
1683356983541,MATH 20C,A02,188395,Harel; Guershon,15,0,30,15
1683356983541,MATH 20C,B01,188404,Harel; Guershon,4,0,30,26
1683356983541,MATH 20C,B02,188405,Harel; Guershon,19,0,30,11
1683356984567,MATH 20D,A01,188414,Hammock; Frances H,0,1,30,30
1683356984567,MATH 20D,A02,188415,Hammock; Frances H,3,0,30,27
1683356984567,MATH 20D,B01,188447,Hammock; Frances H,1,0,30,29
1683356984567,MATH 20D,B02,188486,Hammock; Frances H,8,0,30,22
1683356985593,MATH 20E,A01,188649,Staff,21,0,30,9
1683356985593,MATH 20E,A02,188650,Staff,23,0,30,7
1683356985593,MATH 20E,A03,188673,Staff,0,0,30,30
1683356986618,MATH 102,A01,188675,Staff,0,35,35,35
1683356987646,MATH 103B,A01,188681,Staff,3,0,35,32
1683356987646,MATH 103B,B01,188692,Staff,5,0,35,30
1683356988671,MATH 109,A01,188695,Salehi Golsefidy; Alireza,25,0,35,10
1683356988671,MATH 109,A02,188696,Salehi Golsefidy; Alireza,25,0,35,10
1683356989698,MATH 120A,A01,188698,Eggers; John Dietrich,7,0,35,28
1683356990729,MATH 142B,A01,188736,Ioana; Adrian,0,2,30,30
1683356990729,MATH 142B,A02,188741,Ioana; Adrian,0,0,30,30
1683356990729,MATH 142B,A03,188743,Ioana; Adrian,0,1,30,30
1683356991757,MATH 168A,A01,188790,Staff,0,9,35,35
1683356992783,MATH 170A,A01,188803,Nie; Jiawang,0,2,35,35
1683356992783,MATH 170A,A02,188811,Nie; Jiawang,0,0,35,35
1683356992783,MATH 170A,A03,188814,Nie; Jiawang,1,0,35,34
1683356992783,MATH 170A,A04,188815,Nie; Jiawang,13,0,35,22
1683356993813,MATH 193B,A01,188817,Staff,0,0,35,35
1683356993813,MATH 193B,A02,188818,Staff,5,0,35,30
1683356994842,MGT 4,A01,202857,Anderson; John Charles,61,0,80,19
1683356995866,MGT 12,A00,202858,Lindenberger; Wade Douglas,42,0,90,48
1683356996894,MGT 18,A00,202859,Staff,74,0,90,16
1683356997922,MGT 18GS,A00,202860,McKay; Michael J,13,0,28,15
1683356998945,MGT 45,A00,202861,Pecore; Joseph P.,14,0,90,76
1683356999970,MGT 100,A00,202863,Yavorsky; Daniel Ryan,28,0,90,62
1683357000994,MGT 103,A00,202864,Ehrich; Kristine R,0,17,90,90
1683357002020,MGT 112,A00,202865,Ehrich; Kristine R,15,0,90,75
1683357003049,MGT 121A,A00,202868,Staff,0,20,0,0
1683357004078,MGT 131B,A00,202869,Anderson; John Charles,59,0,90,31
1683357005107,MGT 136,A00,202871,Lindenberger; Wade Douglas,84,0,90,6
1683357006134,MGT 164,A00,202873,Staff,0,68,90,91
1683357007158,MGT 164GS,A00,202874,McKay; Mary A,13,0,28,15
1683357008183,MGT 180,A00,202875,Staff,0,50,90,91
1683357009210,MMW 11R,A01,205019,Herbst; Matthew,3,0,30,27
1683357009210,MMW 11R,A02,205026,Herbst; Matthew,29,0,30,1
1683357010239,MMW 15,A01,193512,Chang; Edmond Yi-Teh,0,9,28,28
1683357010239,MMW 15,A02,193513,Chang; Edmond Yi-Teh,0,5,28,28
1683357010239,MMW 15,A03,193514,Chang; Edmond Yi-Teh,0,5,28,28
1683357010239,MMW 15,A04,193515,Chang; Edmond Yi-Teh,0,5,28,28
1683357010239,MMW 15,A05,193516,Chang; Edmond Yi-Teh,0,4,28,28
1683357010239,MMW 15,A06,193517,Chang; Edmond Yi-Teh,0,5,28,28
1683357010239,MMW 15,B01,193519,Chang; Edmond Yi-Teh,0,5,28,28
1683357010239,MMW 15,B02,193520,Chang; Edmond Yi-Teh,0,5,28,28
1683357010239,MMW 15,B03,193521,Chang; Edmond Yi-Teh,0,5,28,28
1683357010239,MMW 15,B04,193522,Chang; Edmond Yi-Teh,0,4,28,28
1683357010239,MMW 15,B05,193523,Chang; Edmond Yi-Teh,0,5,28,28
1683357010239,MMW 15,B06,193524,Chang; Edmond Yi-Teh,0,4,28,28
1683357011265,MMW 122,A01,193526,Rahimi; Babak,0,15,28,28
1683357011265,MMW 122,A02,193527,Rahimi; Babak,0,14,28,28
1683357011265,MMW 122,A03,193528,Rahimi; Babak,0,0,0,0
1683357011265,MMW 122,A04,193529,Rahimi; Babak,0,0,0,0
1683357012290,MUS 1A,A01,186663,Staff,0,20,35,35
1683357013371,MUS 4,A01,186715,Staff,0,12,35,35
1683357014400,MUS 5R,A01,186796,Dubnov; Shlomo,0,17,35,35
1683357015424,MUS 6,A01,186798,Staff,0,4,25,25
1683357016448,MUS 7,A01,186830,Staff,13,0,35,22
1683357017479,MUS 8,A01,186930,Staff,0,26,35,35
1683357018504,MUS 15,A01,186932,Staff,0,16,35,35
1683357018504,MUS 15,B01,186934,Staff,0,15,35,35
1683357019531,MUS 80,A00,186935,Staff,1,0,20,19
1683357019531,MUS 80,B00,186936,Staff,25,0,25,0
1683357020556,NANO 11,A00,204702,Lipomi; Darren John,0,0,0,0
1683357021580,NANO 15,A01,204709,Yang; Kesong,0,1,0,0
1683357022605,NANO 114,A00,202069,Jahed Motlagh; Zeinab,3,0,10,7
1683357023629,PHIL 1,A00,186955,Grush; Rick Scott,32,0,40,8
1683357024655,PHIL 10,A01,186973,Grush; Rick Scott,28,0,35,7
1683357024655,PHIL 10,A02,186974,Grush; Rick Scott,33,0,35,2
1683357025684,PHIL 13,A01,186976,Staff,7,0,35,28
1683357025684,PHIL 13,A02,186977,Staff,16,0,35,19
1683357026709,PHIL 14,A01,186979,Staff,31,0,35,4
1683357026709,PHIL 14,A02,186986,Staff,32,0,35,3
1683357027734,PHIL 28,A01,186988,Staff,16,0,30,14
1683357027734,PHIL 28,A02,186989,Staff,1,0,30,29
1683357027734,PHIL 28,A03,186990,Staff,9,0,30,21
1683357027734,PHIL 28,A04,186991,Staff,26,0,30,4
1683357028760,PHIL 120,A00,186997,Staff,23,0,40,17
1683357029784,PHIL 137,A00,187003,Staff,9,0,40,31
1683357030809,PHIL 150,A00,187015,Staff,47,0,70,23
1683357031834,PHIL 167,A00,187021,Lamey; Andy M.,35,0,40,5
1683357032859,PHIL 174,A01,202226,Staff,17,0,20,3
1683357032859,PHIL 174,A02,202235,Staff,20,0,20,0
1683357033884,PHIL 191A,A00,258918,Staff,0,0,1,1
1683357034908,PHYS 1A,A00,187028,Staff,27,0,60,33
1683357035931,PHYS 1AL,001,187036,Staff,2,0,30,28
1683357035931,PHYS 1AL,002,187049,Staff,18,0,30,12
1683357036955,PHYS 1B,A00,187058,Staff,22,0,60,38
1683357037984,PHYS 1BL,001,187064,Staff,0,0,30,30
1683357037984,PHYS 1BL,002,187070,Staff,5,0,30,25
1683357039009,PHYS 1C,A00,187082,Staff,31,0,120,89
1683357040033,PHYS 1CL,001,187088,Staff,0,9,30,30
1683357040033,PHYS 1CL,002,187089,Staff,0,2,30,30
1683357040033,PHYS 1CL,009,262693,Staff,11,0,30,19
1683357041062,PHYS 2B,A01,187097,Staff,54,0,115,61
1683357042087,PHYS 2C,A01,187099,Staff,67,0,115,48
1683357043113,PHYS 2CL,A01,187101,Staff,5,0,28,23
1683357043113,PHYS 2CL,A02,187102,Staff,15,0,28,13
1683357044137,PHYS 2D,A01,187123,Shotwell; Brian,95,0,115,20
1683357045161,PHYS 4B,A01,187133,Grinstein; Benjamin,35,0,50,15
1683357046186,POLI 10,A00,188819,Staff,0,4,50,50
1683357047210,POLI 11,A00,188827,Staff,43,0,50,7
1683357048235,POLI 13R,A00,188828,Staff,0,1,20,20
1683357049264,POLI 27,A01,188830,Elgin; Samuel Zincke,0,1,70,70
1683357050288,POLI 30,A00,188832,Desposato; Scott,31,0,50,19
1683357051314,POLI 102F,A00,188834,Staff,3,0,40,37
1683357052341,POLI 104A,A00,188852,Staff,14,0,30,16
1683357053365,POLI 104I,A00,188853,Staff,0,6,20,20
1683357054391,POLI 110B,A00,188854,Wiens; David,7,0,20,13
1683357055416,POLI 112A,A00,188855,Wiens; David,5,0,30,25
1683357056440,POLI 117R,A00,188856,Forman; Fonna,0,11,20,20
1683357057463,POLI 118,A00,188857,Ingham; Sean,8,0,20,12
1683357058491,POLI 120G,A00,188858,Staff,9,0,30,21
1683357059515,POLI 131CR,A00,188863,Hoston; Germaine,23,0,50,27
1683357060545,POLI 133,A00,188864,Nellis; Gareth Hb,44,0,50,6
1683357061570,POLI 134D,A00,188865,Desposato; Scott,27,0,30,3
1683357062596,POLI 142A,A00,188871,Gartzke; Erik,22,0,50,28
1683357063621,POLI 142K,A00,188874,Staff,38,0,50,12
1683357064653,POLI 143,A00,188940,Gartzke; Erik,16,0,30,14
1683357065689,POLI 153,A00,188943,Staff,3,0,20,17
1683357066714,POLI 160AA,A00,188944,Staff,11,0,40,29
1683357067739,POLI 170A,A00,188945,Staff,11,0,30,19
1683357069798,PSYC 1,A00,188952,Staff,37,0,90,53
1683357070826,PSYC 2,B00,188953,Staff,19,0,35,16
1683357071851,PSYC 6,A00,188970,Staff,47,0,60,13
1683357072880,PSYC 7,A00,188973,Staff,37,0,45,8
1683357073905,PSYC 60,A01,188980,Rickard; Timothy C.,43,0,60,17
1683357074934,PSYC 70,A01,189001,Steiner; Eric Tomas,23,0,45,22
1683357075960,PSYC 100,A00,189005,Lacefield; Katharine I,0,98,120,120
1683357076989,PSYC 102,A00,189008,Staff,9,0,30,21
1683357078018,PSYC 106,B00,189026,Gorman; Michael R.,34,0,60,26
1683357079044,PSYC 114,B01,189033,Winkielman; Piotr,0,32,30,30
1683357080067,PSYC 131,A00,189036,Anagnostaras; Stephan,0,43,60,60
1683357081096,PSYC 136,A00,189041,Lowe; Angela Beth,0,7,25,25
1683357082121,PSYC 137,A00,189057,Winkielman; Piotr,0,34,25,25
1683357083149,PSYC 144,A00,189107,Wixted; John T,0,7,50,50
1683357085198,PSYC 162,A00,189142,Staff,0,8,85,85
1683357086224,PSYC 172,A00,189144,Gorman; Michael R.,0,7,30,30
1683357088274,PSYC 179,A00,189146,Lacefield; Katharine I,0,84,120,120
1683357089299,PSYC 181,A00,189147,Anagnostaras; Stephan,0,44,90,90
1683357090330,PSYC 190R,A00,189148,Barner; David A.,0,22,80,80
1683357091358,PSYC 191,A00,189275,Rickard; Timothy C.,0,7,25,25
1683357092384,PSYC 193,A00,189276,Chapman; Eddie Nathaniel,0,1,0,4
1683357093418,PSYC 193L,A01,189281,Lowe; Angela Beth,12,0,20,8
1683357093418,PSYC 193L,B01,189285,Staff,28,0,35,7
1683357094442,RELI 149,A00,187137,Rahimi; Babak,7,0,40,33
1683357095468,SE 9,A01,187315,Staff,0,2,18,18
1683357096497,SE 101B,A00,187409,Staff,24,0,30,6
1683357097528,SE 110B,A00,187444,Staff,10,0,40,30
1683357098555,SE 130B,A00,187449,Staff,31,0,40,9
1683357099585,SE 150A,A00,187516,Staff,9,0,20,11
1683357100614,SE 154,A00,187528,Staff,30,0,50,20
1683357101638,SIO 3,A01,258171,Staff,35,0,40,5
1683357102663,SIO 10,A00,187144,Cook; Geoffrey W,0,3,75,75
1683357103693,SIO 45,A00,187152,Cook; Geoffrey W,1,0,100,99
1683357104718,SIO 109R,A00,194486,Staff,0,3,20,20
1683357106775,SIO 187,A01,187233,Kacev; David,12,0,40,28
1683357107808,SOCI 1,A01,258656,Thorpe; Charles Robert,28,0,30,2
1683357107808,SOCI 1,A02,258658,Thorpe; Charles Robert,30,0,30,0
1683357107808,SOCI 1,A03,258661,Thorpe; Charles Robert,25,0,25,0
1683357107808,SOCI 1,A04,258666,Thorpe; Charles Robert,22,0,25,3
1683357107808,SOCI 1,A05,258897,Thorpe; Charles Robert,23,0,25,2
1683357107808,SOCI 1,A06,258898,Thorpe; Charles Robert,25,0,25,0
1683357108833,SOCI 30,A01,258903,Pardo Guerra; Juan Pablo,15,0,30,15
1683357109861,SOCI 102,A00,258904,Staff,9,0,25,16
1683357110890,SOCI 106,A00,258905,Staff,19,0,25,6
1683357111919,SOCI 111,A00,258907,Ribas Norris; Janet Vanesa,26,0,30,4
1683357112944,SOCI 121R,A00,258908,Pardo Guerra; Juan Pablo,10,0,30,20
1683357113969,SOCI 126,A01,203330,Staff,14,0,20,6
1683357114996,SOCI 131,A00,258909,Thorpe; Charles Robert,31,0,60,29
1683357116022,SOCI 135,A00,258910,Payne; Christine Anna,0,9,30,30
1683357117104,SOCI 157,A00,258911,Staff,12,0,30,18
1683357118130,SOCI 184,A00,258912,Staff,25,0,30,5
1683357119160,SOCI 188D,A00,258913,Staff,22,0,30,8
1683357120186,SYN 2,001,187529,Staff,10,0,16,6
1683357120186,SYN 2,002,201452,Staff,0,18,16,16
1683357120186,SYN 2,003,201469,Staff,3,0,16,13
1683357121210,SYN 100,A01,187531,Staff,0,9,20,20
1683357121210,SYN 100,B01,201491,Staff,0,12,20,20
1683357122235,TDAC 1,A00,189286,Walsh; Kim C.,3,0,20,17
1683357122235,TDAC 1,B00,189287,Harting; Carla Kelso,11,0,20,9
1683357123261,TDAC 101,A00,189300,Walsh; Kim C.,16,0,20,4
1683357123261,TDAC 101,B00,189301,Harting; Carla Kelso,18,0,20,2
1683357124285,TDAC 102,A00,189304,Basso; Beatrice,14,0,20,6
1683357125312,TDAC 108,A00,189305,Staff,18,0,20,2
1683357126344,TDDE 131,A00,189310,Staff,19,0,20,1
1683357126344,TDDE 131,B00,189314,Staff,19,0,20,1
1683357126344,TDDE 131,C00,189315,Staff,48,0,50,2
1683357126344,TDDE 131,D00,189316,Staff,14,0,15,1
1683357126344,TDDE 131,E00,204841,Staff,20,0,20,0
1683357127369,TDGE 10,A00,189289,Staff,30,0,50,20
1683357127369,TDGE 10,B00,189290,Havis; Allan,1,0,50,49
1683357128402,TDGE 11,A00,189291,Fulton; Julia,0,3,50,50
1683357128402,TDGE 11,B00,189292,Staff,20,0,25,5
1683357128402,TDGE 11,C00,260270,Staff,0,0,0,0
1683357129432,TDGE 25,A00,189294,Staff,3,0,20,17
1683357130464,TDGE 124,A00,189318,Fulton; Julia,0,8,50,50
1683357131493,TDGE 125,A00,189319,Staff,13,0,25,12
1683357131493,TDGE 125,B00,189320,Staff,23,0,25,2
1683357132523,TDGE 127,A00,189322,Havis; Allan,0,0,50,50
1683357133547,TDHT 101,A00,189323,Staff,18,0,25,7
1683357133547,TDHT 101,B00,189324,Staff,25,0,25,0
1683357134578,TDHT 102,A00,189325,Staff,49,0,50,1
1683357135606,TDMV 1,A00,189295,Arcidiacono; Kristin,19,0,30,11
1683357135606,TDMV 1,B00,189296,Caligagan; Maria T.,24,0,30,6
1683357136638,TDMV 2,A00,189297,Sammartano; Tonnie,28,0,30,2
1683357136638,TDMV 2,B00,189299,Arcidiacono; Kristin,24,0,30,6
1683357137666,TDMV 3,A00,204998,Rincon; Alicia,22,0,30,8
1683357138691,TDMV 120,A00,189458,Sammartano; Tonnie,28,0,30,2
1683357139719,TDMV 138,A00,189541,Jun; Grace Shin Hae,22,0,40,18
1683357140744,TDMV 142,A00,189717,Caligagan; Tony,23,0,30,7
1683357140744,TDMV 142,B00,189718,Caligagan; Maria T.,25,0,30,5
1683357141769,TMC 2,A01,187533,Staff,25,0,25,0
1683357141769,TMC 2,A02,187534,Staff,25,0,25,0
1683357142805,USP 1,A01,187536,Kwak; Nancy,0,16,25,25
1683357143834,USP 5,A01,187538,Staff,10,0,25,15
1683357144860,USP 101,A00,199253,Staff,0,4,0,0
1683357145886,USP 124,A00,187562,Boomhower; Matthew Charles,1,0,30,29
1683357146911,USP 138,A00,187582,Staff,20,0,25,5
1683357147942,USP 152,A01,187597,Staff,4,0,25,21
1683357148973,USP 153,A00,187598,Staff,19,0,25,6
1683357150002,USP 168,A00,187607,Kwak; Nancy,2,0,5,3
1683357151025,USP 173,A00,187619,Staff,4,0,25,21
1683357152050,USP 181,A00,187638,Staff,0,3,25,25
1683357153080,VIS 103,A00,187650,Cruz; Edwin Teddy,22,0,75,53
1683357154106,VIS 110D,A00,187669,Staff,12,0,22,10
1683357155136,VIS 127C,A00,187720,Shen; Kuiyi,67,0,146,79
1683357156166,VIS 149,A00,187731,Yoldas; Pinar,0,14,22,22
1683357157191,VIS 151,A01,188091,Staff,22,0,34,12
1683357157191,VIS 151,A02,188092,Staff,11,0,34,23
1683357158217,VIS 160B,A00,188093,Stalbaum; Brett,0,0,10,10
1683357160270,WCWP 10B,A00,201720,Staff,10,0,15,5
1683357160270,WCWP 10B,B00,201722,Staff,9,0,15,6
1683357161295,WCWP 100,A00,201725,Gagnon; Jeffrey C,0,0,2,2
1683357161295,WCWP 100,B00,201727,Staff,0,4,15,15
1683357164393,ANBI 133,A00,258401,Wilder; Linnea Lorene,34,0,40,6
1683357165419,ANBI 140,A00,258395,Hrvoj Mihic; Branka,18,0,25,7
1683357166445,ANSC 120,A00,258402,Bialecki; Jon Anthony,27,0,40,13
1683357167470,ANSC 144,A00,258400,Staff,14,0,40,26
1683357169526,ANSC 166,A00,258396,Parish; Steven Martin,157,0,175,18
1683357170552,ANSC 180,A00,193533,Staff,9,0,20,11
1683357171576,ANSC 188,A00,258397,Jassal; Aftab,33,0,40,7
1683357172602,ANTH 3,A01,258316,Staff,23,0,30,7
1683357173628,ANTH 5,A00,258394,Semendeferi; Ekaterini,16,0,20,4
1683357174655,ANTH 21,A01,258331,Staff,8,0,40,32
1683357175679,ANTH 103,A00,258398,Varma; Saiba,15,0,25,10
1683357176715,AWP 10,001,202034,Staff,0,0,0,0
1683357176715,AWP 10,002,202035,Staff,0,0,0,0
1683357176715,AWP 10,003,202036,Staff,0,0,0,0
1683357176715,AWP 10,004,202037,Staff,0,0,0,0
1683357176715,AWP 10,005,202038,Staff,0,0,0,0
1683357176715,AWP 10,006,202039,Staff,0,0,0,0
1683357176715,AWP 10,007,202040,Staff,0,0,0,0
1683357176715,AWP 10,008,202041,Staff,0,0,0,0
1683357176715,AWP 10,009,202042,Staff,0,0,0,0
1683357176715,AWP 10,010,202043,Staff,0,0,0,0
1683357176715,AWP 10,011,202044,Staff,0,0,0,0
1683357176715,AWP 10,012,202045,Staff,0,0,0,0
1683357176715,AWP 10,013,202046,Staff,0,0,0,0
1683357176715,AWP 10,014,202047,Staff,0,0,0,0
1683357176715,AWP 10,015,202048,Staff,0,0,0,0
1683357176715,AWP 10,016,202049,Staff,0,0,0,0
1683357176715,AWP 10,017,202050,Staff,0,0,0,0
1683357176715,AWP 10,018,202051,Staff,0,0,0,0
1683357176715,AWP 10,019,202052,Staff,0,0,0,0
1683357176715,AWP 10,020,202053,Staff,0,0,0,0
1683357176715,AWP 10,021,202054,Staff,0,0,0,0
1683357176715,AWP 10,022,202055,Staff,0,0,0,0
1683357176715,AWP 10,023,202056,Staff,0,0,0,0
1683357176715,AWP 10,024,202057,Staff,0,0,0,0
1683357176715,AWP 10,025,202058,Staff,0,0,0,0
1683357176715,AWP 10,026,202059,Staff,0,0,0,0
1683357177746,AWP 102,001,202032,Staff,0,0,0,0
1683357177746,AWP 102,002,202033,Staff,0,0,0,0
1683357178778,BENG 100,A01,254234,Taylor Amos; Alyssa C,31,0,40,9
1683357179808,BENG 196,001,270013,Engler; Adam J.,9999,0,9999,0
1683357180835,BICD 100R,A01,202018,Smith; Laurie,0,7,32,32
1683357180835,BICD 100R,A02,202019,Smith; Laurie,0,2,32,32
1683357180835,BICD 100R,A03,202020,Smith; Laurie,0,1,32,32
1683357180835,BICD 100R,A04,202021,Smith; Laurie,9,0,32,23
1683357180835,BICD 100R,A05,202022,Smith; Laurie,12,0,32,20
1683357181862,BICD 136,A01,193242,Gustafson-Brown; Cindy,0,2,32,32
1683357181862,BICD 136,A02,193244,Gustafson-Brown; Cindy,14,0,32,18
1683357182894,BIEB 102,A01,193249,Butler; Shannon Rhey,0,2,32,32
1683357182894,BIEB 102,A02,193251,Butler; Shannon Rhey,0,0,32,32
1683357182894,BIEB 102,A03,193253,Butler; Shannon Rhey,0,1,32,32
1683357182894,BIEB 102,A04,193255,Butler; Shannon Rhey,17,0,32,15
1683357182894,BIEB 102,A05,193265,Butler; Shannon Rhey,26,0,32,6
1683357182894,BIEB 102,A06,193269,Butler; Shannon Rhey,16,0,32,16
1683357184957,BIEB 150,A01,193274,Staff,0,0,32,32
1683357184957,BIEB 150,A02,193285,Staff,23,0,32,9
1683357185987,BIEB 194,A00,193286,Kurle; Carolyn M.,22,0,32,10
1683357187013,BILD 1,A01,192291,Staff,16,0,32,16
1683357187013,BILD 1,A02,192292,Staff,30,0,32,2
1683357187013,BILD 1,B01,192520,Reuther; Keefe,0,1,0,0
1683357187013,BILD 1,B02,192532,Reuther; Keefe,0,1,0,0
1683357188041,BILD 3,A01,192556,Butler; Shannon Rhey,0,0,32,32
1683357188041,BILD 3,A02,192581,Butler; Shannon Rhey,4,0,32,28
1683357188041,BILD 3,A03,192611,Butler; Shannon Rhey,23,0,32,9
1683357188041,BILD 3,A04,192612,Butler; Shannon Rhey,25,0,32,7
1683357188041,BILD 3,A05,192613,Butler; Shannon Rhey,27,0,32,5
1683357188041,BILD 3,A06,192679,Butler; Shannon Rhey,27,0,32,5
1683357188041,BILD 3,A07,192682,Butler; Shannon Rhey,22,0,32,10
1683357189074,BILD 4,A01,192836,Reuther; Keefe,0,0,24,24
1683357189074,BILD 4,A02,193044,Reuther; Keefe,4,0,24,20
1683357190106,BILD 10,A01,193142,Gustafson-Brown; Cindy,30,0,32,2
1683357190106,BILD 10,A02,193149,Gustafson-Brown; Cindy,31,0,32,1
1683357191148,BIMM 100,A01,193301,Staff,0,6,32,32
1683357191148,BIMM 100,A02,193312,Staff,0,5,32,32
1683357191148,BIMM 100,A03,193323,Staff,0,8,32,32
1683357192189,BIMM 101,A01,193329,McDonnell; Lisa Marie,0,3,24,24
1683357192189,BIMM 101,A02,193339,McDonnell; Lisa Marie,0,3,24,24
1683357192189,BIMM 101,B01,193354,McDonnell; Lisa Marie,0,3,24,24
1683357192189,BIMM 101,B02,193357,McDonnell; Lisa Marie,0,3,24,24
1683357193214,BIMM 110,A01,193377,Tat; John,0,11,32,32
1683357193214,BIMM 110,A02,193378,Tat; John,0,9,32,32
1683357194246,BIMM 120,A01,206116,Staff,0,0,32,32
1683357194246,BIMM 120,A02,206117,Staff,8,0,32,24
1683357194246,BIMM 120,A03,206121,Staff,21,0,32,11
1683357195277,BIPN 100,A01,193393,Park; Ji Young,0,14,32,32
1683357195277,BIPN 100,A02,193402,Park; Ji Young,0,13,32,32
1683357195277,BIPN 100,A03,193413,Park; Ji Young,0,14,32,32
1683357195277,BIPN 100,A04,193414,Park; Ji Young,0,13,32,32
1683357196309,BIPN 102,A01,193429,Staff,0,0,32,32
1683357196309,BIPN 102,A02,193438,Staff,22,0,32,10
1683357197335,BIPN 106,A01,193450,Reyes Gonzalez; Catalina,0,2,40,40
1683357198361,BIPN 134,A01,193465,Cooke; James Edward,1,0,32,31
1683357198361,BIPN 134,A02,193474,Cooke; James Edward,25,0,32,7
1683357198361,BIPN 134,A03,193485,Cooke; James Edward,29,0,32,3
1683357198361,BIPN 134,A04,193486,Cooke; James Edward,21,0,32,11
1683357198361,BIPN 134,A05,193491,Cooke; James Edward,31,0,32,1
1683357198361,BIPN 134,A06,193501,Cooke; James Edward,30,0,32,2
1683357198361,BIPN 134,A07,193510,Cooke; James Edward,29,0,32,3
1683357200413,BISP 194,A00,222522,Staff,14,0,32,18
1683357201441,CAT 124,A01,202407,Staff,19,0,25,6
1683357202466,CAT 125,A00,202408,Marchisotto; Jennifer Anne,4,0,20,16
1683357203500,CAT 125R,A00,202409,Smith; Lauryn Alissa,0,11,20,20
1683357203500,CAT 125R,B00,202410,Morales; Celeste Georgianna,0,11,20,20
1683357203500,CAT 125R,C00,202411,Irwin; Matthew Joseph,0,10,20,20
1683357204525,CENG 15,A01,204712,Yang; Kesong,0,1,0,0
1683357205552,CENG 114,A00,202070,Jahed Motlagh; Zeinab,5,0,20,15
1683357206580,CGS 105,A00,185477,Wesling; Megan E.,24,0,40,16
1683357207609,CGS 106,A00,185494,Staff,13,0,22,9
1683357208637,CGS 108,A00,185495,Staff,14,0,20,6
1683357209668,CGS 114,A00,185496,Staff,13,0,18,5
1683357210697,CGS 119,A00,185501,Staff,15,0,20,5
1683357211722,CGS 120,A00,185511,Staff,13,0,20,7
1683357212750,CHEM 4,A01,184675,Bussey; Thomas J,96,0,100,4
1683357213776,CHEM 6A,A01,184677,Staff,34,0,60,26
1683357214807,CHEM 6B,A01,184679,Staff,65,0,100,35
1683357215840,CHEM 6C,A01,184681,Bussey; Thomas J,1,0,50,49
1683357215840,CHEM 6C,A02,184682,Bussey; Thomas J,34,0,50,16
1683357216866,CHEM 40A,A01,184684,Albizati; Kim F.,37,0,100,63
1683357217892,CHEM 40B,A01,184686,Albizati; Kim F.,0,20,100,100
1683357218917,CHEM 41B,A01,184690,Staff,52,0,100,48
1683357219944,COGS 3,A01,184715,Boyle; Mary E. T.,0,25,40,40
1683357221025,COGS 14B,A01,185172,Staff,0,15,38,38
1683357222050,COGS 18,A01,184736,Staff,17,0,80,63
1683357223076,COGS 100,A01,184932,Staff,0,5,73,73
1683357224131,COGS 101A,A01,184935,Staff,0,39,30,30
1683357225162,COGS 101B,A01,184944,Staff,0,2,30,30
1683357226192,COGS 101C,A01,184946,Staff,0,12,30,30
1683357227219,COGS 102A,A01,184951,Johnson; Christine M.,2,0,40,38
1683357228257,COGS 107B,A01,184953,Mooshagian; Eric Frederick,0,50,40,40
1683357229283,COGS 118B,A01,184959,Gupta; Anjum,0,48,40,40
1683357230312,COGS 153,A00,184961,Staff,0,15,30,30
1683357231338,COGS 177,A00,184962,Staff,0,20,30,30
1683357232371,COGS 187A,A01,184969,Boyle; Mary E. T.,0,17,40,40
1683357233405,COMM 10,A01,185174,Staff,0,5,25,25
1683357233405,COMM 10,A02,185189,Staff,0,5,25,25
1683357233405,COMM 10,A03,269821,Staff,0,0,0,0
1683357234431,COMM 100B,A01,185475,Staff,0,0,0,2
1683357234431,COMM 100B,A02,185476,Staff,13,0,25,12
1683357235456,COMM 100C,A01,185314,Staff,1,0,25,24
1683357235456,COMM 100C,A02,185327,Staff,19,0,25,6
1683357236530,COMM 110M,A00,185349,Staff,2,0,40,38
1683357237555,COMM 113T,A00,185352,Staff,24,0,40,16
1683357238585,COMM 114I,A00,185353,Staff,33,0,40,7
1683357239609,COMM 131,A00,185354,Staff,19,0,30,11
1683357240633,CSE 8A,A50,185358,Cao; Yingjun,0,46,10,10
1683357241657,CSE 8B,A01,185362,Staff,0,46,50,50
1683357242682,CSE 11,A01,185416,Cao; Yingjun,0,92,10,10
1683357243706,CSE 20,A01,185445,Briones; Jor-el Thomas Caparas,5,0,25,20
1683357244736,CSE 21,A01,185447,Staff,10,0,50,40
1683357245760,CSE 101,A01,185451,Staff,0,13,50,50
1683357245760,CSE 101,B01,185453,Jones; Miles E,0,11,50,50
1683357247824,CSE 141,A01,185458,Eldon; John,20,0,100,80
1683357248847,CSE 141L,A01,185461,Eldon; John,12,0,100,88
1683357249880,CSE 142,A01,185463,Staff,36,0,60,24
1683357249880,CSE 142,B01,201355,Staff,0,7,60,60
1683357250906,CSE 142L,A01,185470,Staff,36,0,60,24
1683357250906,CSE 142L,B01,201417,Staff,0,6,60,60
1683357251932,CSE 190,A00,201433,Staff,32,0,49,17
1683357252956,DOC 1,A01,259136,Strom; Megan C.,7,0,15,8
1683357252956,DOC 1,A02,259137,Strom; Megan C.,14,0,15,1
1683357252956,DOC 1,A03,259138,Strom; Megan C.,14,0,15,1
1683357252956,DOC 1,A04,259139,Strom; Megan C.,14,0,15,1
1683357253990,DOC 100D,A00,259140,Pass; Natalye Joann,16,0,25,9
1683357255016,DSGN 1,A01,184749,Rill; Bryan,0,25,30,30
1683357256041,DSGN 100,A01,185168,Staff,0,2,25,25
1683357257072,ECE 5,A01,185626,Morris; Karcher William,0,10,0,0
1683357258102,ECE 101,A01,185628,Staff,17,0,70,53
1683357259128,ECE 107,A01,185635,Baghdadchi; Saharnaz,0,0,20,20
1683357259128,ECE 107,A02,185638,Baghdadchi; Saharnaz,4,0,20,16
1683357260155,ECE 148,A01,185647,Silberman; Jack,0,0,16,16
1683357261187,ECON 1,A01,185537,Crane; Meredith Helen,54,0,70,16
1683357262212,ECON 3,A01,185549,Crane; Meredith Helen,32,0,70,38
1683357263247,ECON 4,A01,203354,Anderson; John Charles,0,4,10,10
1683357264271,ECON 100A,A01,185574,Staff,0,4,40,40
1683357265301,ECON 100B,A01,185576,Staff,0,12,50,50
1683357266327,ECON 100C,A01,185589,Newhouse; Herbert S,29,0,70,41
1683357267352,ECON 105,A00,185608,Vespa; Emanuel Ignacio,19,0,35,16
1683357268383,ECON 109,A01,185610,Shishkin; Denis,10,0,35,25
1683357269410,ECON 110A,A01,185612,Staff,11,0,40,29
1683357270448,ECON 120A,A01,185615,Staff,20,0,40,20
1683357271474,ECON 120C,A01,185617,Sun; Yixiao,0,21,70,70
1683357272506,ECON 144,A00,203346,Squires; Dale E,3,0,35,32
1683357273531,ECON 171,A01,203349,Newhouse; Herbert S,0,1,35,35
1683357274557,ECON 173A,A01,185621,Toda; Alexis Akira,21,0,35,14
1683357275593,EDS 25,A01,202413,Staff,0,1,0,0
1683357275593,EDS 25,A02,202414,Staff,0,1,0,0
1683357275593,EDS 25,A03,202415,Staff,0,0,0,0
1683357275593,EDS 25,A04,202416,Staff,0,1,0,0
1683357275593,EDS 25,A05,202439,Staff,0,0,0,0
1683357275593,EDS 25,A06,202440,Staff,0,0,0,0
1683357275593,EDS 25,B01,202631,Staff,0,0,0,0
1683357275593,EDS 25,B02,202632,Staff,0,0,0,0
1683357275593,EDS 25,B03,202639,Staff,0,0,0,0
1683357275593,EDS 25,B04,202640,Staff,0,0,0,0
1683357275593,EDS 25,B05,202643,Staff,0,0,0,0
1683357275593,EDS 25,B06,202644,Staff,0,0,0,0
1683357276621,EDS 38,A01,202659,Black; Alison Michelle,24,0,25,1
1683357277657,EDS 115,A00,202652,Staff,18,0,30,12
1683357278685,EDS 125,A00,202649,Staff,14,0,30,16
1683357279710,EDS 126,A01,203332,Staff,30,0,30,0
1683357280737,EDS 139,A00,202838,Staff,16,0,25,9
1683357281762,EDS 146,A01,202655,Staff,14,0,25,11
1683357282788,ENG 15,A00,185667,Staff,0,1,0,0
1683357282788,ENG 15,B00,185672,Staff,0,0,0,0
1683357282788,ENG 15,C00,185675,Staff,0,0,0,0
1683357282788,ENG 15,D00,185682,Staff,0,0,0,0
1683357282788,ENG 15,E00,185684,Staff,0,0,0,0
1683357283825,ETHN 103,A00,185710,Staff,0,4,35,35
1683357284850,ETHN 103A,A00,199228,Man; Simeon S,2,0,9,7
1683357285878,ETHN 109,A00,185711,Staff,18,0,35,17
1683357286912,ETHN 142,A00,185726,Staff,0,4,30,30
1683357287945,ETHN 163J,A00,199229,Man; Simeon S,5,0,8,3
1683357288971,ETHN 168,A00,185727,Staff,8,0,10,2
1683357289997,ETHN 182,A00,185728,Staff,0,0,35,35
1683357291028,ETHN 183,A00,185737,Staff,8,0,18,10
1683357292056,GLBH 111,A01,209361,Burgos; Jose L.,0,0,0,0
1683357294113,HIEU 104,A00,185792,Staff,16,0,20,4
1683357295138,HIEU 115,A00,185800,Staff,1,0,20,19
1683357296166,HIEU 128,A00,185801,Staff,0,7,20,20
1683357297192,HIEU 147,A00,185802,Staff,16,0,20,4
1683357298216,HIEU 154,A00,185823,Staff,12,0,20,8
1683357299243,HILA 102,A00,185826,Staff,13,0,20,7
1683357300268,HILD 2C,A01,185778,Staff,0,12,20,20
1683357301308,HILD 7B,A01,185780,Kwak; Nancy,0,15,32,32
1683357301308,HILD 7B,A02,185781,Kwak; Nancy,0,18,32,32
1683357302334,HILD 30,A01,185791,Staff,14,0,20,6
1683357303361,HISC 119,A00,185830,Golan; Tal,0,9,20,20
1683357304398,HITO 156GS,A00,185831,Patterson; Patrick H.,0,0,0,23
1683357305429,HIUS 103,A00,185832,Man; Simeon S,1,6,20,19
1683357306453,HIUS 117,A00,185836,Kwak; Nancy,2,0,20,18
1683357307482,HIUS 125,A00,185840,Man; Simeon S,0,0,23,23
1683357308509,HIUS 149,A00,185845,Staff,0,0,20,20
1683357309534,HUM 3,A01,185882,Zavodny; Tatiana Sophia,0,7,50,50
1683357309534,HUM 3,B01,185899,Caldwell; Michael Alan,0,18,50,50
1683357310560,HUM 3GS,A00,185900,Patterson; Patrick H.,0,0,0,23
1683357311590,HUM 4,A01,185938,Zroka; Amy Liane,31,0,50,19
1683357311590,HUM 4,B01,185956,Watkins; Eric,0,3,50,50
1683357311590,HUM 4,B02,202209,Watkins; Eric,0,2,50,50
1683357311590,HUM 4,B03,202210,Watkins; Eric,0,2,50,50
1683357312616,HUM 5,A01,185958,West; Geoffrey Scott,3,0,50,47
1683357312616,HUM 5,A02,202215,West; Geoffrey Scott,0,0,50,50
1683357313642,INTL 190,A00,185959,Gagnon; Jeffrey C,0,0,0,9
1683357313642,INTL 190,B00,185960,Lettieri; Michael Joseph,0,0,0,1
1683357314666,JAPN 180,A00,254509,Staff,4,0,30,26
1683357315700,LATI 10,A01,202853,Kennemore; Amy Michelle,4,0,35,31
1683357315700,LATI 10,A02,202854,Kennemore; Amy Michelle,2,0,35,33
1683357315700,LATI 10,A03,270054,Kennemore; Amy Michelle,30,0,30,0
1683357316727,LATI 180,A00,202855,Kennemore; Amy Michelle,11,0,20,9
1683357317751,LAWS 101,A00,201767,Golan; Tal,0,7,40,40
1683357318780,LIFR 1C,A00,185961,Staff,6,0,20,14
1683357319805,LIFR 1CX,A00,185962,Staff,7,0,20,13
1683357320831,LIFR 1D,A00,185963,Staff,9,0,20,11
1683357321859,LIFR 1DX,A00,185964,Staff,9,0,20,11
1683357322893,LIGN 101,A01,186039,Staff,43,0,50,7
1683357323923,LIGN 165,A00,186040,Staff,18,0,50,32
1683357325002,LTCS 108,A00,186041,Staff,6,0,10,4
1683357326049,LTCS 119,A00,186042,Staff,16,0,20,4
1683357327085,LTCS 130,A00,186043,Wesling; Megan E.,15,0,25,10
1683357329140,LTEA 138,A00,186119,Staff,14,0,40,26
1683357330168,LTEN 124,A00,186148,Staff,6,0,25,19
1683357331198,LTEN 178,A00,186149,Staff,7,0,15,8
1683357332223,LTEN 181,A00,186150,Blanco; John D,33,0,40,7
1683357333254,LTWL 120,A00,186160,Staff,20,0,25,5
1683357334281,LTWL 165,A00,186161,Staff,22,0,25,3
1683357335305,LTWR 100,A00,186162,Staff,0,5,15,15
1683357336334,LTWR 102,A00,186163,Doller; Ben,5,0,15,10
1683357337360,MAE 8,A01,186412,Staff,0,0,0,0
1683357338386,MAE 30B,A00,186445,Bahadori; Mohammad Yousef,83,0,100,17
1683357339418,MAE 40,A00,186592,Bewley; Thomas R,10,0,50,40
1683357340442,MAE 101B,A00,186593,Bahadori; Mohammad Yousef,81,0,100,19
1683357341468,MAE 105,A00,186594,Bandaru; Prabhakar,12,0,50,38
1683357342495,MAE 107,A00,186599,Pham; Hieu Tan,0,7,120,120
1683357343520,MAE 148,A01,186660,Silberman; Jack,3,0,16,13
1683357344545,MATH 10A,A01,188095,Staff,0,5,35,35
1683357345571,MATH 10B,A01,188097,Bowers; Adam R.,0,11,30,30
1683357345571,MATH 10B,A02,188099,Bowers; Adam R.,0,11,30,30
1683357345571,MATH 10B,B01,188104,Bowers; Adam R.,0,10,30,30
1683357345571,MATH 10B,B02,188106,Bowers; Adam R.,0,10,30,30
1683357346597,MATH 10C,A01,188111,Staff,0,18,30,30
1683357346597,MATH 10C,A02,188127,Staff,0,17,30,30
1683357346597,MATH 10C,A03,188131,Staff,0,18,30,30
1683357346597,MATH 10C,B01,188218,Staff,18,0,30,12
1683357346597,MATH 10C,B02,188244,Staff,13,0,30,17
1683357346597,MATH 10C,B03,188277,Staff,16,0,30,14
1683357347628,MATH 18,A01,188344,Bach; Quang Tran,18,0,30,12
1683357347628,MATH 18,A02,188345,Bach; Quang Tran,11,0,30,19
1683357347628,MATH 18,B01,188353,Bach; Quang Tran,10,0,30,20
1683357347628,MATH 18,B02,188354,Bach; Quang Tran,20,0,30,10
1683357348654,MATH 20A,A01,188374,Staff,12,0,35,23
1683357349683,MATH 20B,A01,188382,Ohm; Ko Woon,6,0,30,24
1683357349683,MATH 20B,A02,188383,Ohm; Ko Woon,22,0,30,8
1683357349683,MATH 20B,B01,188385,Ohm; Ko Woon,7,0,30,23
1683357349683,MATH 20B,B02,188392,Ohm; Ko Woon,22,0,30,8
1683357350730,MATH 20C,A01,188394,Harel; Guershon,10,0,30,20
1683357350730,MATH 20C,A02,188395,Harel; Guershon,15,0,30,15
1683357350730,MATH 20C,B01,188404,Harel; Guershon,4,0,30,26
1683357350730,MATH 20C,B02,188405,Harel; Guershon,19,0,30,11
1683357351768,MATH 20D,A01,188414,Hammock; Frances H,0,1,30,30
1683357351768,MATH 20D,A02,188415,Hammock; Frances H,3,0,30,27
1683357351768,MATH 20D,B01,188447,Hammock; Frances H,1,0,30,29
1683357351768,MATH 20D,B02,188486,Hammock; Frances H,8,0,30,22
1683357352793,MATH 20E,A01,188649,Staff,21,0,30,9
1683357352793,MATH 20E,A02,188650,Staff,23,0,30,7
1683357352793,MATH 20E,A03,188673,Staff,0,0,30,30
1683357353820,MATH 102,A01,188675,Staff,0,35,35,35
1683357354846,MATH 103B,A01,188681,Staff,3,0,35,32
1683357354846,MATH 103B,B01,188692,Staff,5,0,35,30
1683357355871,MATH 109,A01,188695,Salehi Golsefidy; Alireza,25,0,35,10
1683357355871,MATH 109,A02,188696,Salehi Golsefidy; Alireza,25,0,35,10
1683357356903,MATH 120A,A01,188698,Eggers; John Dietrich,7,0,35,28
1683357357937,MATH 142B,A01,188736,Ioana; Adrian,0,2,30,30
1683357357937,MATH 142B,A02,188741,Ioana; Adrian,0,0,30,30
1683357357937,MATH 142B,A03,188743,Ioana; Adrian,0,1,30,30
1683357358962,MATH 168A,A01,188790,Staff,0,9,35,35
1683357359989,MATH 170A,A01,188803,Nie; Jiawang,0,2,35,35
1683357359989,MATH 170A,A02,188811,Nie; Jiawang,0,0,35,35
1683357359989,MATH 170A,A03,188814,Nie; Jiawang,1,0,35,34
1683357359989,MATH 170A,A04,188815,Nie; Jiawang,13,0,35,22
1683357361015,MATH 193B,A01,188817,Staff,0,0,35,35
1683357361015,MATH 193B,A02,188818,Staff,5,0,35,30
1683357362052,MGT 4,A01,202857,Anderson; John Charles,61,0,80,19
1683357363089,MGT 12,A00,202858,Lindenberger; Wade Douglas,42,0,90,48
1683357364122,MGT 18,A00,202859,Staff,74,0,90,16
1683357365152,MGT 18GS,A00,202860,McKay; Michael J,13,0,28,15
1683357366181,MGT 45,A00,202861,Pecore; Joseph P.,14,0,90,76
1683357367208,MGT 100,A00,202863,Yavorsky; Daniel Ryan,28,0,90,62
1683357368235,MGT 103,A00,202864,Ehrich; Kristine R,0,17,90,90
1683357369259,MGT 112,A00,202865,Ehrich; Kristine R,15,0,90,75
1683357370285,MGT 121A,A00,202868,Staff,0,20,0,0
1683357371311,MGT 131B,A00,202869,Anderson; John Charles,59,0,90,31
1683357372341,MGT 136,A00,202871,Lindenberger; Wade Douglas,84,0,90,6
1683357373373,MGT 164,A00,202873,Staff,0,68,90,91
1683357374404,MGT 164GS,A00,202874,McKay; Mary A,13,0,28,15
1683357375436,MGT 180,A00,202875,Staff,0,50,90,91
1683357376466,MMW 11R,A01,205019,Herbst; Matthew,3,0,30,27
1683357376466,MMW 11R,A02,205026,Herbst; Matthew,29,0,30,1
1683357377494,MMW 15,A01,193512,Chang; Edmond Yi-Teh,0,9,28,28
1683357377494,MMW 15,A02,193513,Chang; Edmond Yi-Teh,0,5,28,28
1683357377494,MMW 15,A03,193514,Chang; Edmond Yi-Teh,0,5,28,28
1683357377494,MMW 15,A04,193515,Chang; Edmond Yi-Teh,0,5,28,28
1683357377494,MMW 15,A05,193516,Chang; Edmond Yi-Teh,0,4,28,28
1683357377494,MMW 15,A06,193517,Chang; Edmond Yi-Teh,0,5,28,28
1683357377494,MMW 15,B01,193519,Chang; Edmond Yi-Teh,0,5,28,28
1683357377494,MMW 15,B02,193520,Chang; Edmond Yi-Teh,0,5,28,28
1683357377494,MMW 15,B03,193521,Chang; Edmond Yi-Teh,0,5,28,28
1683357377494,MMW 15,B04,193522,Chang; Edmond Yi-Teh,0,4,28,28
1683357377494,MMW 15,B05,193523,Chang; Edmond Yi-Teh,0,5,28,28
1683357377494,MMW 15,B06,193524,Chang; Edmond Yi-Teh,0,4,28,28
1683357378528,MMW 122,A01,193526,Rahimi; Babak,0,15,28,28
1683357378528,MMW 122,A02,193527,Rahimi; Babak,0,14,28,28
1683357378528,MMW 122,A03,193528,Rahimi; Babak,0,0,0,0
1683357378528,MMW 122,A04,193529,Rahimi; Babak,0,0,0,0
1683357379553,MUS 1A,A01,186663,Staff,0,20,35,35
1683357380584,MUS 4,A01,186715,Staff,0,12,35,35
1683357381615,MUS 5R,A01,186796,Dubnov; Shlomo,0,17,35,35
1683357382641,MUS 6,A01,186798,Staff,0,4,25,25
1683357383673,MUS 7,A01,186830,Staff,13,0,35,22
1683357384698,MUS 8,A01,186930,Staff,0,26,35,35
1683357385725,MUS 15,A01,186932,Staff,0,16,35,35
1683357385725,MUS 15,B01,186934,Staff,0,15,35,35
1683357386751,MUS 80,A00,186935,Staff,1,0,20,19
1683357386751,MUS 80,B00,186936,Staff,25,0,25,0
1683357387783,NANO 11,A00,204702,Lipomi; Darren John,0,0,0,0
1683357388812,NANO 15,A01,204709,Yang; Kesong,0,1,0,0
1683357389842,NANO 114,A00,202069,Jahed Motlagh; Zeinab,3,0,10,7
1683357390870,PHIL 1,A00,186955,Grush; Rick Scott,32,0,40,8
1683357391897,PHIL 10,A01,186973,Grush; Rick Scott,28,0,35,7
1683357391897,PHIL 10,A02,186974,Grush; Rick Scott,33,0,35,2
1683357392927,PHIL 13,A01,186976,Staff,7,0,35,28
1683357392927,PHIL 13,A02,186977,Staff,16,0,35,19
1683357393953,PHIL 14,A01,186979,Staff,31,0,35,4
1683357393953,PHIL 14,A02,186986,Staff,32,0,35,3
1683357394985,PHIL 28,A01,186988,Staff,16,0,30,14
1683357394985,PHIL 28,A02,186989,Staff,1,0,30,29
1683357394985,PHIL 28,A03,186990,Staff,9,0,30,21
1683357394985,PHIL 28,A04,186991,Staff,26,0,30,4
1683357396010,PHIL 120,A00,186997,Staff,23,0,40,17
1683357397036,PHIL 137,A00,187003,Staff,9,0,40,31
1683357398066,PHIL 150,A00,187015,Staff,47,0,70,23
1683357399097,PHIL 167,A00,187021,Lamey; Andy M.,35,0,40,5
1683357400124,PHIL 174,A01,202226,Staff,17,0,20,3
1683357400124,PHIL 174,A02,202235,Staff,20,0,20,0
1683357401150,PHIL 191A,A00,258918,Staff,0,0,1,1
1683357402178,PHYS 1A,A00,187028,Staff,27,0,60,33
1683357403202,PHYS 1AL,001,187036,Staff,2,0,30,28
1683357403202,PHYS 1AL,002,187049,Staff,18,0,30,12
1683357404236,PHYS 1B,A00,187058,Staff,22,0,60,38
1683357405263,PHYS 1BL,001,187064,Staff,0,0,30,30
1683357405263,PHYS 1BL,002,187070,Staff,5,0,30,25
1683357406291,PHYS 1C,A00,187082,Staff,31,0,120,89
1683357407320,PHYS 1CL,001,187088,Staff,0,9,30,30
1683357407320,PHYS 1CL,002,187089,Staff,0,2,30,30
1683357407320,PHYS 1CL,009,262693,Staff,11,0,30,19
1683357408353,PHYS 2B,A01,187097,Staff,54,0,115,61
1683357409377,PHYS 2C,A01,187099,Staff,67,0,115,48
1683357410417,PHYS 2CL,A01,187101,Staff,5,0,28,23
1683357410417,PHYS 2CL,A02,187102,Staff,15,0,28,13
1683357411449,PHYS 2D,A01,187123,Shotwell; Brian,95,0,115,20
1683357412476,PHYS 4B,A01,187133,Grinstein; Benjamin,35,0,50,15
1683357413500,POLI 10,A00,188819,Staff,0,4,50,50
1683357414530,POLI 11,A00,188827,Staff,43,0,50,7
1683357415559,POLI 13R,A00,188828,Staff,0,1,20,20
1683357416584,POLI 27,A01,188830,Elgin; Samuel Zincke,0,1,70,70
1683357417614,POLI 30,A00,188832,Desposato; Scott,31,0,50,19
1683357418639,POLI 102F,A00,188834,Staff,3,0,40,37
1683357419665,POLI 104A,A00,188852,Staff,14,0,30,16
1683357420693,POLI 104I,A00,188853,Staff,0,6,20,20
1683357421725,POLI 110B,A00,188854,Wiens; David,7,0,20,13
1683357422756,POLI 112A,A00,188855,Wiens; David,5,0,30,25
1683357423781,POLI 117R,A00,188856,Forman; Fonna,0,11,20,20
1683357424820,POLI 118,A00,188857,Ingham; Sean,8,0,20,12
1683357425844,POLI 120G,A00,188858,Staff,9,0,30,21
1683357426908,POLI 131CR,A00,188863,Hoston; Germaine,23,0,50,27
1683357427938,POLI 133,A00,188864,Nellis; Gareth Hb,44,0,50,6
1683357429023,POLI 134D,A00,188865,Desposato; Scott,27,0,30,3
1683357430054,POLI 142A,A00,188871,Gartzke; Erik,22,0,50,28
1683357431085,POLI 142K,A00,188874,Staff,38,0,50,12
1683357432112,POLI 143,A00,188940,Gartzke; Erik,16,0,30,14
1683357433143,POLI 153,A00,188943,Staff,3,0,20,17
1683357434168,POLI 160AA,A00,188944,Staff,11,0,40,29
1683357435194,POLI 170A,A00,188945,Staff,11,0,30,19
1683357437250,PSYC 1,A00,188952,Staff,37,0,90,53
1683357438278,PSYC 2,B00,188953,Staff,19,0,35,16
1683357439306,PSYC 6,A00,188970,Staff,47,0,60,13
1683357440332,PSYC 7,A00,188973,Staff,37,0,45,8
1683357441457,PSYC 60,A01,188980,Rickard; Timothy C.,43,0,60,17
1683357442485,PSYC 70,A01,189001,Steiner; Eric Tomas,23,0,45,22
1683357443517,PSYC 100,A00,189005,Lacefield; Katharine I,0,98,120,120
1683357444549,PSYC 102,A00,189008,Staff,9,0,30,21
1683357445584,PSYC 106,B00,189026,Gorman; Michael R.,34,0,60,26
1683357446615,PSYC 114,B01,189033,Winkielman; Piotr,0,32,30,30
1683357447642,PSYC 131,A00,189036,Anagnostaras; Stephan,0,43,60,60
1683357448672,PSYC 136,A00,189041,Lowe; Angela Beth,0,7,25,25
1683357449701,PSYC 137,A00,189057,Winkielman; Piotr,0,34,25,25
1683357450728,PSYC 144,A00,189107,Wixted; John T,0,7,50,50
1683357452784,PSYC 162,A00,189142,Staff,0,8,85,85
1683357453810,PSYC 172,A00,189144,Gorman; Michael R.,0,7,30,30
1683357455864,PSYC 179,A00,189146,Lacefield; Katharine I,0,84,120,120
1683357456898,PSYC 181,A00,189147,Anagnostaras; Stephan,0,44,90,90
1683357457923,PSYC 190R,A00,189148,Barner; David A.,0,22,80,80
1683357458949,PSYC 191,A00,189275,Rickard; Timothy C.,0,7,25,25
1683357459975,PSYC 193,A00,189276,Chapman; Eddie Nathaniel,0,1,0,4
1683357461001,PSYC 193L,A01,189281,Lowe; Angela Beth,12,0,20,8
1683357461001,PSYC 193L,B01,189285,Staff,28,0,35,7
1683357462031,RELI 149,A00,187137,Rahimi; Babak,7,0,40,33
1683357463059,SE 9,A01,187315,Staff,0,2,18,18
1683357464090,SE 101B,A00,187409,Staff,24,0,30,6
1683357465124,SE 110B,A00,187444,Staff,10,0,40,30
1683357466158,SE 130B,A00,187449,Staff,31,0,40,9
1683357467185,SE 150A,A00,187516,Staff,9,0,20,11
1683357468211,SE 154,A00,187528,Staff,30,0,50,20
1683357469238,SIO 3,A01,258171,Staff,35,0,40,5
1683357470270,SIO 10,A00,187144,Cook; Geoffrey W,0,3,75,75
1683357471295,SIO 45,A00,187152,Cook; Geoffrey W,1,0,100,99
1683357472326,SIO 109R,A00,194486,Staff,0,3,20,20
1683357474379,SIO 187,A01,187233,Kacev; David,12,0,40,28
1683357475412,SOCI 1,A01,258656,Thorpe; Charles Robert,28,0,30,2
1683357475412,SOCI 1,A02,258658,Thorpe; Charles Robert,30,0,30,0
1683357475412,SOCI 1,A03,258661,Thorpe; Charles Robert,25,0,25,0
1683357475412,SOCI 1,A04,258666,Thorpe; Charles Robert,22,0,25,3
1683357475412,SOCI 1,A05,258897,Thorpe; Charles Robert,23,0,25,2
1683357475412,SOCI 1,A06,258898,Thorpe; Charles Robert,25,0,25,0
1683357476440,SOCI 30,A01,258903,Pardo Guerra; Juan Pablo,15,0,30,15
1683357477468,SOCI 102,A00,258904,Staff,9,0,25,16
1683357478495,SOCI 106,A00,258905,Staff,19,0,25,6
1683357479519,SOCI 111,A00,258907,Ribas Norris; Janet Vanesa,26,0,30,4
1683357480545,SOCI 121R,A00,258908,Pardo Guerra; Juan Pablo,10,0,30,20
1683357481579,SOCI 126,A01,203330,Staff,14,0,20,6
1683357482610,SOCI 131,A00,258909,Thorpe; Charles Robert,31,0,60,29
1683357483637,SOCI 135,A00,258910,Payne; Christine Anna,0,9,30,30
1683357484662,SOCI 157,A00,258911,Staff,12,0,30,18
1683357485687,SOCI 184,A00,258912,Staff,25,0,30,5
1683357486712,SOCI 188D,A00,258913,Staff,22,0,30,8
1683357487743,SYN 2,001,187529,Staff,10,0,16,6
1683357487743,SYN 2,002,201452,Staff,0,18,16,16
1683357487743,SYN 2,003,201469,Staff,3,0,16,13
1683357488769,SYN 100,A01,187531,Staff,0,9,20,20
1683357488769,SYN 100,B01,201491,Staff,0,12,20,20
1683357489795,TDAC 1,A00,189286,Walsh; Kim C.,3,0,20,17
1683357489795,TDAC 1,B00,189287,Harting; Carla Kelso,11,0,20,9
1683357490826,TDAC 101,A00,189300,Walsh; Kim C.,16,0,20,4
1683357490826,TDAC 101,B00,189301,Harting; Carla Kelso,18,0,20,2
1683357491857,TDAC 102,A00,189304,Basso; Beatrice,14,0,20,6
1683357492882,TDAC 108,A00,189305,Staff,18,0,20,2
1683357493909,TDDE 131,A00,189310,Staff,19,0,20,1
1683357493909,TDDE 131,B00,189314,Staff,19,0,20,1
1683357493909,TDDE 131,C00,189315,Staff,48,0,50,2
1683357493909,TDDE 131,D00,189316,Staff,14,0,15,1
1683357493909,TDDE 131,E00,204841,Staff,20,0,20,0
1683357494936,TDGE 10,A00,189289,Staff,30,0,50,20
1683357494936,TDGE 10,B00,189290,Havis; Allan,1,0,50,49
1683357495968,TDGE 11,A00,189291,Fulton; Julia,0,3,50,50
1683357495968,TDGE 11,B00,189292,Staff,20,0,25,5
1683357495968,TDGE 11,C00,260270,Staff,0,0,0,0
1683357496993,TDGE 25,A00,189294,Staff,3,0,20,17
1683357498018,TDGE 124,A00,189318,Fulton; Julia,0,8,50,50
1683357499051,TDGE 125,A00,189319,Staff,13,0,25,12
1683357499051,TDGE 125,B00,189320,Staff,23,0,25,2
1683357500080,TDGE 127,A00,189322,Havis; Allan,0,0,50,50
1683357501111,TDHT 101,A00,189323,Staff,18,0,25,7
1683357501111,TDHT 101,B00,189324,Staff,25,0,25,0
1683357502135,TDHT 102,A00,189325,Staff,49,0,50,1
1683357503162,TDMV 1,A00,189295,Arcidiacono; Kristin,19,0,30,11
1683357503162,TDMV 1,B00,189296,Caligagan; Maria T.,24,0,30,6
1683357504189,TDMV 2,A00,189297,Sammartano; Tonnie,28,0,30,2
1683357504189,TDMV 2,B00,189299,Arcidiacono; Kristin,24,0,30,6
1683357505216,TDMV 3,A00,204998,Rincon; Alicia,22,0,30,8
1683357506254,TDMV 120,A00,189458,Sammartano; Tonnie,28,0,30,2
1683357507279,TDMV 138,A00,189541,Jun; Grace Shin Hae,22,0,40,18
1683357508334,TDMV 142,A00,189717,Caligagan; Tony,23,0,30,7
1683357508334,TDMV 142,B00,189718,Caligagan; Maria T.,25,0,30,5
1683357509370,TMC 2,A01,187533,Staff,25,0,25,0
1683357509370,TMC 2,A02,187534,Staff,25,0,25,0
1683357510400,USP 1,A01,187536,Kwak; Nancy,0,16,25,25
1683357511436,USP 5,A01,187538,Staff,10,0,25,15
1683357512464,USP 101,A00,199253,Staff,0,4,0,0
1683357513488,USP 124,A00,187562,Boomhower; Matthew Charles,1,0,30,29
1683357514519,USP 138,A00,187582,Staff,20,0,25,5
1683357515546,USP 152,A01,187597,Staff,4,0,25,21
1683357516578,USP 153,A00,187598,Staff,19,0,25,6
1683357517618,USP 168,A00,187607,Kwak; Nancy,2,0,5,3
1683357518649,USP 173,A00,187619,Staff,4,0,25,21
1683357519679,USP 181,A00,187638,Staff,0,3,25,25
1683357520708,VIS 103,A00,187650,Cruz; Edwin Teddy,22,0,75,53
1683357521737,VIS 110D,A00,187669,Staff,12,0,22,10
1683357522763,VIS 127C,A00,187720,Shen; Kuiyi,67,0,146,79
1683357523792,VIS 149,A00,187731,Yoldas; Pinar,0,14,22,22
1683357524819,VIS 151,A01,188091,Staff,22,0,34,12
1683357524819,VIS 151,A02,188092,Staff,11,0,34,23
1683357525844,VIS 160B,A00,188093,Stalbaum; Brett,0,0,10,10
1683357527899,WCWP 10B,A00,201720,Staff,10,0,15,5
1683357527899,WCWP 10B,B00,201722,Staff,9,0,15,6
1683357528936,WCWP 100,A00,201725,Gagnon; Jeffrey C,0,0,2,2
1683357528936,WCWP 100,B00,201727,Staff,0,4,15,15
1683357532157,ANBI 133,A00,258401,Wilder; Linnea Lorene,34,0,40,6
1683357533243,ANBI 140,A00,258395,Hrvoj Mihic; Branka,18,0,25,7
1683357534269,ANSC 120,A00,258402,Bialecki; Jon Anthony,27,0,40,13
1683357535295,ANSC 144,A00,258400,Staff,14,0,40,26
1683357537352,ANSC 166,A00,258396,Parish; Steven Martin,157,0,175,18
1683357538382,ANSC 180,A00,193533,Staff,9,0,20,11
1683357539417,ANSC 188,A00,258397,Jassal; Aftab,33,0,40,7
1683357540450,ANTH 3,A01,258316,Staff,23,0,30,7
1683357541486,ANTH 5,A00,258394,Semendeferi; Ekaterini,16,0,20,4
1683357542516,ANTH 21,A01,258331,Staff,8,0,40,32
1683357543541,ANTH 103,A00,258398,Varma; Saiba,15,0,25,10
1683357544572,AWP 10,001,202034,Staff,0,0,0,0
1683357544572,AWP 10,002,202035,Staff,0,0,0,0
1683357544572,AWP 10,003,202036,Staff,0,0,0,0
1683357544572,AWP 10,004,202037,Staff,0,0,0,0
1683357544572,AWP 10,005,202038,Staff,0,0,0,0
1683357544572,AWP 10,006,202039,Staff,0,0,0,0
1683357544572,AWP 10,007,202040,Staff,0,0,0,0
1683357544572,AWP 10,008,202041,Staff,0,0,0,0
1683357544572,AWP 10,009,202042,Staff,0,0,0,0
1683357544572,AWP 10,010,202043,Staff,0,0,0,0
1683357544572,AWP 10,011,202044,Staff,0,0,0,0
1683357544572,AWP 10,012,202045,Staff,0,0,0,0
1683357544572,AWP 10,013,202046,Staff,0,0,0,0
1683357544572,AWP 10,014,202047,Staff,0,0,0,0
1683357544572,AWP 10,015,202048,Staff,0,0,0,0
1683357544572,AWP 10,016,202049,Staff,0,0,0,0
1683357544572,AWP 10,017,202050,Staff,0,0,0,0
1683357544572,AWP 10,018,202051,Staff,0,0,0,0
1683357544572,AWP 10,019,202052,Staff,0,0,0,0
1683357544572,AWP 10,020,202053,Staff,0,0,0,0
1683357544572,AWP 10,021,202054,Staff,0,0,0,0
1683357544572,AWP 10,022,202055,Staff,0,0,0,0
1683357544572,AWP 10,023,202056,Staff,0,0,0,0
1683357544572,AWP 10,024,202057,Staff,0,0,0,0
1683357544572,AWP 10,025,202058,Staff,0,0,0,0
1683357544572,AWP 10,026,202059,Staff,0,0,0,0
1683357545598,AWP 102,001,202032,Staff,0,0,0,0
1683357545598,AWP 102,002,202033,Staff,0,0,0,0
1683357546625,BENG 100,A01,254234,Taylor Amos; Alyssa C,31,0,40,9
1683357547652,BENG 196,001,270013,Engler; Adam J.,9999,0,9999,0
1683357548687,BICD 100R,A01,202018,Smith; Laurie,0,7,32,32
1683357548687,BICD 100R,A02,202019,Smith; Laurie,0,2,32,32
1683357548687,BICD 100R,A03,202020,Smith; Laurie,0,1,32,32
1683357548687,BICD 100R,A04,202021,Smith; Laurie,9,0,32,23
1683357548687,BICD 100R,A05,202022,Smith; Laurie,12,0,32,20
1683357549712,BICD 136,A01,193242,Gustafson-Brown; Cindy,0,2,32,32
1683357549712,BICD 136,A02,193244,Gustafson-Brown; Cindy,14,0,32,18
1683357550745,BIEB 102,A01,193249,Butler; Shannon Rhey,0,2,32,32
1683357550745,BIEB 102,A02,193251,Butler; Shannon Rhey,0,0,32,32
1683357550745,BIEB 102,A03,193253,Butler; Shannon Rhey,0,1,32,32
1683357550745,BIEB 102,A04,193255,Butler; Shannon Rhey,17,0,32,15
1683357550745,BIEB 102,A05,193265,Butler; Shannon Rhey,26,0,32,6
1683357550745,BIEB 102,A06,193269,Butler; Shannon Rhey,16,0,32,16
1683357552800,BIEB 150,A01,193274,Staff,0,0,32,32
1683357552800,BIEB 150,A02,193285,Staff,23,0,32,9
1683357553828,BIEB 194,A00,193286,Kurle; Carolyn M.,22,0,32,10
1683357554876,BILD 1,A01,192291,Staff,16,0,32,16
1683357554876,BILD 1,A02,192292,Staff,30,0,32,2
1683357554876,BILD 1,B01,192520,Reuther; Keefe,0,1,0,0
1683357554876,BILD 1,B02,192532,Reuther; Keefe,0,1,0,0
1683357555903,BILD 3,A01,192556,Butler; Shannon Rhey,0,0,32,32
1683357555903,BILD 3,A02,192581,Butler; Shannon Rhey,4,0,32,28
1683357555903,BILD 3,A03,192611,Butler; Shannon Rhey,23,0,32,9
1683357555903,BILD 3,A04,192612,Butler; Shannon Rhey,25,0,32,7
1683357555903,BILD 3,A05,192613,Butler; Shannon Rhey,27,0,32,5
1683357555903,BILD 3,A06,192679,Butler; Shannon Rhey,27,0,32,5
1683357555903,BILD 3,A07,192682,Butler; Shannon Rhey,22,0,32,10
1683357556944,BILD 4,A01,192836,Reuther; Keefe,0,0,24,24
1683357556944,BILD 4,A02,193044,Reuther; Keefe,4,0,24,20
1683357557968,BILD 10,A01,193142,Gustafson-Brown; Cindy,30,0,32,2
1683357557968,BILD 10,A02,193149,Gustafson-Brown; Cindy,31,0,32,1
1683357558994,BIMM 100,A01,193301,Staff,0,6,32,32
1683357558994,BIMM 100,A02,193312,Staff,0,5,32,32
1683357558994,BIMM 100,A03,193323,Staff,0,8,32,32
1683357560029,BIMM 101,A01,193329,McDonnell; Lisa Marie,0,3,24,24
1683357560029,BIMM 101,A02,193339,McDonnell; Lisa Marie,0,3,24,24
1683357560029,BIMM 101,B01,193354,McDonnell; Lisa Marie,0,3,24,24
1683357560029,BIMM 101,B02,193357,McDonnell; Lisa Marie,0,3,24,24
1683357561060,BIMM 110,A01,193377,Tat; John,0,11,32,32
1683357561060,BIMM 110,A02,193378,Tat; John,0,9,32,32
1683357562086,BIMM 120,A01,206116,Staff,0,0,32,32
1683357562086,BIMM 120,A02,206117,Staff,8,0,32,24
1683357562086,BIMM 120,A03,206121,Staff,21,0,32,11
1683357563112,BIPN 100,A01,193393,Park; Ji Young,0,14,32,32
1683357563112,BIPN 100,A02,193402,Park; Ji Young,0,13,32,32
1683357563112,BIPN 100,A03,193413,Park; Ji Young,0,14,32,32
1683357563112,BIPN 100,A04,193414,Park; Ji Young,0,13,32,32
1683357564139,BIPN 102,A01,193429,Staff,0,0,32,32
1683357564139,BIPN 102,A02,193438,Staff,22,0,32,10
1683357565178,BIPN 106,A01,193450,Reyes Gonzalez; Catalina,0,2,40,40
1683357566219,BIPN 134,A01,193465,Cooke; James Edward,1,0,32,31
1683357566219,BIPN 134,A02,193474,Cooke; James Edward,25,0,32,7
1683357566219,BIPN 134,A03,193485,Cooke; James Edward,29,0,32,3
1683357566219,BIPN 134,A04,193486,Cooke; James Edward,21,0,32,11
1683357566219,BIPN 134,A05,193491,Cooke; James Edward,31,0,32,1
1683357566219,BIPN 134,A06,193501,Cooke; James Edward,30,0,32,2
1683357566219,BIPN 134,A07,193510,Cooke; James Edward,29,0,32,3
1683357568279,BISP 194,A00,222522,Staff,14,0,32,18
1683357569306,CAT 124,A01,202407,Staff,19,0,25,6
1683357570335,CAT 125,A00,202408,Marchisotto; Jennifer Anne,4,0,20,16
1683357571366,CAT 125R,A00,202409,Smith; Lauryn Alissa,0,11,20,20
1683357571366,CAT 125R,B00,202410,Morales; Celeste Georgianna,0,11,20,20
1683357571366,CAT 125R,C00,202411,Irwin; Matthew Joseph,0,10,20,20
1683357572396,CENG 15,A01,204712,Yang; Kesong,0,1,0,0
1683357573423,CENG 114,A00,202070,Jahed Motlagh; Zeinab,5,0,20,15
1683357574449,CGS 105,A00,185477,Wesling; Megan E.,24,0,40,16
1683357575486,CGS 106,A00,185494,Staff,13,0,22,9
1683357576514,CGS 108,A00,185495,Staff,14,0,20,6
1683357577540,CGS 114,A00,185496,Staff,13,0,18,5
1683357578576,CGS 119,A00,185501,Staff,15,0,20,5
1683357579601,CGS 120,A00,185511,Staff,13,0,20,7
1683357580630,CHEM 4,A01,184675,Bussey; Thomas J,96,0,100,4
1683357581656,CHEM 6A,A01,184677,Staff,34,0,60,26
1683357582681,CHEM 6B,A01,184679,Staff,65,0,100,35
1683357583716,CHEM 6C,A01,184681,Bussey; Thomas J,1,0,50,49
1683357583716,CHEM 6C,A02,184682,Bussey; Thomas J,34,0,50,16
1683357584742,CHEM 40A,A01,184684,Albizati; Kim F.,37,0,100,63
1683357585768,CHEM 40B,A01,184686,Albizati; Kim F.,0,20,100,100
1683357586795,CHEM 41B,A01,184690,Staff,52,0,100,48
1683357587819,COGS 3,A01,184715,Boyle; Mary E. T.,0,25,40,40
1683357588847,COGS 14B,A01,185172,Staff,0,15,38,38
1683357589880,COGS 18,A01,184736,Staff,17,0,80,63
1683357590916,COGS 100,A01,184932,Staff,0,5,73,73
1683357591951,COGS 101A,A01,184935,Staff,0,39,30,30
1683357592977,COGS 101B,A01,184944,Staff,0,2,30,30
1683357594002,COGS 101C,A01,184946,Staff,0,12,30,30
1683357595027,COGS 102A,A01,184951,Johnson; Christine M.,2,0,40,38
1683357596052,COGS 107B,A01,184953,Mooshagian; Eric Frederick,0,50,40,40
1683357597091,COGS 118B,A01,184959,Gupta; Anjum,0,48,40,40
1683357598116,COGS 153,A00,184961,Staff,0,15,30,30
1683357599140,COGS 177,A00,184962,Staff,0,20,30,30
1683357600171,COGS 187A,A01,184969,Boyle; Mary E. T.,0,17,40,40
1683357601211,COMM 10,A01,185174,Staff,0,5,25,25
1683357601211,COMM 10,A02,185189,Staff,0,5,25,25
1683357601211,COMM 10,A03,269821,Staff,0,0,0,0
1683357602237,COMM 100B,A01,185475,Staff,0,0,0,2
1683357602237,COMM 100B,A02,185476,Staff,13,0,25,12
1683357603268,COMM 100C,A01,185314,Staff,1,0,25,24
1683357603268,COMM 100C,A02,185327,Staff,19,0,25,6
1683357604299,COMM 110M,A00,185349,Staff,2,0,40,38
1683357605329,COMM 113T,A00,185352,Staff,24,0,40,16
1683357606353,COMM 114I,A00,185353,Staff,33,0,40,7
1683357607381,COMM 131,A00,185354,Staff,19,0,30,11
1683357608412,CSE 8A,A50,185358,Cao; Yingjun,0,46,10,10
1683357609447,CSE 8B,A01,185362,Staff,0,46,50,50
1683357610473,CSE 11,A01,185416,Cao; Yingjun,0,92,10,10
1683357611499,CSE 20,A01,185445,Briones; Jor-el Thomas Caparas,5,0,25,20
1683357612523,CSE 21,A01,185447,Staff,10,0,50,40
1683357613554,CSE 101,A01,185451,Staff,0,13,50,50
1683357613554,CSE 101,B01,185453,Jones; Miles E,0,11,50,50
1683357615602,CSE 141,A01,185458,Eldon; John,20,0,100,80
1683357616627,CSE 141L,A01,185461,Eldon; John,12,0,100,88
1683357617659,CSE 142,A01,185463,Staff,36,0,60,24
1683357617659,CSE 142,B01,201355,Staff,0,7,60,60
1683357618683,CSE 142L,A01,185470,Staff,36,0,60,24
1683357618683,CSE 142L,B01,201417,Staff,0,6,60,60
1683357619707,CSE 190,A00,201433,Staff,32,0,49,17
1683357620738,DOC 1,A01,259136,Strom; Megan C.,7,0,15,8
1683357620738,DOC 1,A02,259137,Strom; Megan C.,14,0,15,1
1683357620738,DOC 1,A03,259138,Strom; Megan C.,14,0,15,1
1683357620738,DOC 1,A04,259139,Strom; Megan C.,14,0,15,1
1683357621763,DOC 100D,A00,259140,Pass; Natalye Joann,16,0,25,9
1683357622791,DSGN 1,A01,184749,Rill; Bryan,0,25,30,30
1683357623820,DSGN 100,A01,185168,Staff,0,2,25,25
1683357624848,ECE 5,A01,185626,Morris; Karcher William,0,10,0,0
1683357625878,ECE 101,A01,185628,Staff,17,0,70,53
1683357626903,ECE 107,A01,185635,Baghdadchi; Saharnaz,0,0,20,20
1683357626903,ECE 107,A02,185638,Baghdadchi; Saharnaz,4,0,20,16
1683357627936,ECE 148,A01,185647,Silberman; Jack,0,0,16,16
1683357628968,ECON 1,A01,185537,Crane; Meredith Helen,54,0,70,16
1683357629999,ECON 3,A01,185549,Crane; Meredith Helen,32,0,70,38
1683357631028,ECON 4,A01,203354,Anderson; John Charles,0,4,10,10
1683357632052,ECON 100A,A01,185574,Staff,0,4,40,40
1683357633077,ECON 100B,A01,185576,Staff,0,12,50,50
1683357634111,ECON 100C,A01,185589,Newhouse; Herbert S,29,0,70,41
1683357635136,ECON 105,A00,185608,Vespa; Emanuel Ignacio,19,0,35,16
1683357636164,ECON 109,A01,185610,Shishkin; Denis,10,0,35,25
1683357637242,ECON 110A,A01,185612,Staff,11,0,40,29
1683357638267,ECON 120A,A01,185615,Staff,20,0,40,20
1683357639292,ECON 120C,A01,185617,Sun; Yixiao,0,21,70,70
1683357640327,ECON 144,A00,203346,Squires; Dale E,3,0,35,32
1683357641355,ECON 171,A01,203349,Newhouse; Herbert S,0,1,35,35
1683357642381,ECON 173A,A01,185621,Toda; Alexis Akira,21,0,35,14
1683357643421,EDS 25,A01,202413,Staff,0,1,0,0
1683357643421,EDS 25,A02,202414,Staff,0,1,0,0
1683357643421,EDS 25,A03,202415,Staff,0,0,0,0
1683357643421,EDS 25,A04,202416,Staff,0,1,0,0
1683357643421,EDS 25,A05,202439,Staff,0,0,0,0
1683357643421,EDS 25,A06,202440,Staff,0,0,0,0
1683357643421,EDS 25,B01,202631,Staff,0,0,0,0
1683357643421,EDS 25,B02,202632,Staff,0,0,0,0
1683357643421,EDS 25,B03,202639,Staff,0,0,0,0
1683357643421,EDS 25,B04,202640,Staff,0,0,0,0
1683357643421,EDS 25,B05,202643,Staff,0,0,0,0
1683357643421,EDS 25,B06,202644,Staff,0,0,0,0
1683357644452,EDS 38,A01,202659,Black; Alison Michelle,24,0,25,1
1683357645477,EDS 115,A00,202652,Staff,18,0,30,12
1683357646505,EDS 125,A00,202649,Staff,14,0,30,16
1683357647533,EDS 126,A01,203332,Staff,30,0,30,0
1683357648562,EDS 139,A00,202838,Staff,16,0,25,9
1683357649587,EDS 146,A01,202655,Staff,14,0,25,11
1683357650617,ENG 15,A00,185667,Staff,0,1,0,0
1683357650617,ENG 15,B00,185672,Staff,0,0,0,0
1683357650617,ENG 15,C00,185675,Staff,0,0,0,0
1683357650617,ENG 15,D00,185682,Staff,0,0,0,0
1683357650617,ENG 15,E00,185684,Staff,0,0,0,0
1683357651643,ETHN 103,A00,185710,Staff,0,4,35,35
1683357652674,ETHN 103A,A00,199228,Man; Simeon S,2,0,9,7
1683357653699,ETHN 109,A00,185711,Staff,18,0,35,17
1683357654729,ETHN 142,A00,185726,Staff,0,4,30,30
1683357655759,ETHN 163J,A00,199229,Man; Simeon S,5,0,8,3
1683357656787,ETHN 168,A00,185727,Staff,8,0,10,2
1683357657812,ETHN 182,A00,185728,Staff,0,0,35,35
1683357658838,ETHN 183,A00,185737,Staff,8,0,18,10
1683357659862,GLBH 111,A01,209361,Burgos; Jose L.,0,0,0,0
1683357661911,HIEU 104,A00,185792,Staff,16,0,20,4
1683357662937,HIEU 115,A00,185800,Staff,1,0,20,19
1683357663963,HIEU 128,A00,185801,Staff,0,7,20,20
1683357664995,HIEU 147,A00,185802,Staff,16,0,20,4
1683357666019,HIEU 154,A00,185823,Staff,12,0,20,8
1683357667048,HILA 102,A00,185826,Staff,13,0,20,7
1683357668077,HILD 2C,A01,185778,Staff,0,12,20,20
1683357669107,HILD 7B,A01,185780,Kwak; Nancy,0,15,32,32
1683357669107,HILD 7B,A02,185781,Kwak; Nancy,0,18,32,32
1683357670139,HILD 30,A01,185791,Staff,14,0,20,6
1683357671165,HISC 119,A00,185830,Golan; Tal,0,9,20,20
1683357672189,HITO 156GS,A00,185831,Patterson; Patrick H.,0,0,0,23
1683357673212,HIUS 103,A00,185832,Man; Simeon S,1,6,20,19
1683357674237,HIUS 117,A00,185836,Kwak; Nancy,2,0,20,18
1683357675265,HIUS 125,A00,185840,Man; Simeon S,0,0,23,23
1683357676294,HIUS 149,A00,185845,Staff,0,0,20,20
1683357677328,HUM 3,A01,185882,Zavodny; Tatiana Sophia,0,7,50,50
1683357677328,HUM 3,B01,185899,Caldwell; Michael Alan,0,18,50,50
1683357678358,HUM 3GS,A00,185900,Patterson; Patrick H.,0,0,0,23
1683357679384,HUM 4,A01,185938,Zroka; Amy Liane,31,0,50,19
1683357679384,HUM 4,B01,185956,Watkins; Eric,0,3,50,50
1683357679384,HUM 4,B02,202209,Watkins; Eric,0,2,50,50
1683357679384,HUM 4,B03,202210,Watkins; Eric,0,2,50,50
1683357680411,HUM 5,A01,185958,West; Geoffrey Scott,3,0,50,47
1683357680411,HUM 5,A02,202215,West; Geoffrey Scott,0,0,50,50
1683357681436,INTL 190,A00,185959,Gagnon; Jeffrey C,0,0,0,9
1683357681436,INTL 190,B00,185960,Lettieri; Michael Joseph,0,0,0,1
1683357682462,JAPN 180,A00,254509,Staff,4,0,30,26
1683357683495,LATI 10,A01,202853,Kennemore; Amy Michelle,4,0,35,31
1683357683495,LATI 10,A02,202854,Kennemore; Amy Michelle,2,0,35,33
1683357683495,LATI 10,A03,270054,Kennemore; Amy Michelle,30,0,30,0
1683357684520,LATI 180,A00,202855,Kennemore; Amy Michelle,11,0,20,9
1683357685554,LAWS 101,A00,201767,Golan; Tal,0,7,40,40
1683357686580,LIFR 1C,A00,185961,Staff,6,0,20,14
1683357687609,LIFR 1CX,A00,185962,Staff,7,0,20,13
1683357688636,LIFR 1D,A00,185963,Staff,9,0,20,11
1683357689659,LIFR 1DX,A00,185964,Staff,9,0,20,11
1683357690684,LIGN 101,A01,186039,Staff,43,0,50,7
1683357691709,LIGN 165,A00,186040,Staff,18,0,50,32
1683357692737,LTCS 108,A00,186041,Staff,6,0,10,4
1683357693761,LTCS 119,A00,186042,Staff,16,0,20,4
1683357694786,LTCS 130,A00,186043,Wesling; Megan E.,15,0,25,10
1683357696841,LTEA 138,A00,186119,Staff,14,0,40,26
1683357697865,LTEN 124,A00,186148,Staff,6,0,25,19
1683357698889,LTEN 178,A00,186149,Staff,7,0,15,8
1683357699918,LTEN 181,A00,186150,Blanco; John D,33,0,40,7
1683357700943,LTWL 120,A00,186160,Staff,20,0,25,5
1683357701968,LTWL 165,A00,186161,Staff,22,0,25,3
1683357702997,LTWR 100,A00,186162,Staff,0,5,15,15
1683357704023,LTWR 102,A00,186163,Doller; Ben,5,0,15,10
1683357705054,MAE 8,A01,186412,Staff,0,0,0,0
1683357706078,MAE 30B,A00,186445,Bahadori; Mohammad Yousef,83,0,100,17
1683357707103,MAE 40,A00,186592,Bewley; Thomas R,10,0,50,40
1683357708126,MAE 101B,A00,186593,Bahadori; Mohammad Yousef,81,0,100,19
1683357709151,MAE 105,A00,186594,Bandaru; Prabhakar,12,0,50,38
1683357710181,MAE 107,A00,186599,Pham; Hieu Tan,0,7,120,120
1683357711209,MAE 148,A01,186660,Silberman; Jack,3,0,16,13
1683357712238,MATH 10A,A01,188095,Staff,0,5,35,35
1683357713266,MATH 10B,A01,188097,Bowers; Adam R.,0,11,30,30
1683357713266,MATH 10B,A02,188099,Bowers; Adam R.,0,11,30,30
1683357713266,MATH 10B,B01,188104,Bowers; Adam R.,0,10,30,30
1683357713266,MATH 10B,B02,188106,Bowers; Adam R.,0,10,30,30
1683357714299,MATH 10C,A01,188111,Staff,0,18,30,30
1683357714299,MATH 10C,A02,188127,Staff,0,17,30,30
1683357714299,MATH 10C,A03,188131,Staff,0,18,30,30
1683357714299,MATH 10C,B01,188218,Staff,18,0,30,12
1683357714299,MATH 10C,B02,188244,Staff,13,0,30,17
1683357714299,MATH 10C,B03,188277,Staff,16,0,30,14
1683357715332,MATH 18,A01,188344,Bach; Quang Tran,18,0,30,12
1683357715332,MATH 18,A02,188345,Bach; Quang Tran,11,0,30,19
1683357715332,MATH 18,B01,188353,Bach; Quang Tran,10,0,30,20
1683357715332,MATH 18,B02,188354,Bach; Quang Tran,20,0,30,10
1683357716359,MATH 20A,A01,188374,Staff,12,0,35,23
1683357717386,MATH 20B,A01,188382,Ohm; Ko Woon,6,0,30,24
1683357717386,MATH 20B,A02,188383,Ohm; Ko Woon,22,0,30,8
1683357717386,MATH 20B,B01,188385,Ohm; Ko Woon,7,0,30,23
1683357717386,MATH 20B,B02,188392,Ohm; Ko Woon,22,0,30,8
1683357718417,MATH 20C,A01,188394,Harel; Guershon,10,0,30,20
1683357718417,MATH 20C,A02,188395,Harel; Guershon,15,0,30,15
1683357718417,MATH 20C,B01,188404,Harel; Guershon,4,0,30,26
1683357718417,MATH 20C,B02,188405,Harel; Guershon,19,0,30,11
1683357719444,MATH 20D,A01,188414,Hammock; Frances H,0,1,30,30
1683357719444,MATH 20D,A02,188415,Hammock; Frances H,3,0,30,27
1683357719444,MATH 20D,B01,188447,Hammock; Frances H,1,0,30,29
1683357719444,MATH 20D,B02,188486,Hammock; Frances H,8,0,30,22
1683357720470,MATH 20E,A01,188649,Staff,21,0,30,9
1683357720470,MATH 20E,A02,188650,Staff,23,0,30,7
1683357720470,MATH 20E,A03,188673,Staff,0,0,30,30
1683357721494,MATH 102,A01,188675,Staff,0,35,35,35
1683357722524,MATH 103B,A01,188681,Staff,3,0,35,32
1683357722524,MATH 103B,B01,188692,Staff,5,0,35,30
1683357723553,MATH 109,A01,188695,Salehi Golsefidy; Alireza,25,0,35,10
1683357723553,MATH 109,A02,188696,Salehi Golsefidy; Alireza,25,0,35,10
1683357724579,MATH 120A,A01,188698,Eggers; John Dietrich,7,0,35,28
1683357725607,MATH 142B,A01,188736,Ioana; Adrian,0,2,30,30
1683357725607,MATH 142B,A02,188741,Ioana; Adrian,0,0,30,30
1683357725607,MATH 142B,A03,188743,Ioana; Adrian,0,1,30,30
1683357726632,MATH 168A,A01,188790,Staff,0,9,35,35
1683357727658,MATH 170A,A01,188803,Nie; Jiawang,0,2,35,35
1683357727658,MATH 170A,A02,188811,Nie; Jiawang,0,0,35,35
1683357727658,MATH 170A,A03,188814,Nie; Jiawang,1,0,35,34
1683357727658,MATH 170A,A04,188815,Nie; Jiawang,13,0,35,22
1683357728683,MATH 193B,A01,188817,Staff,0,0,35,35
1683357728683,MATH 193B,A02,188818,Staff,5,0,35,30
1683357729717,MGT 4,A01,202857,Anderson; John Charles,61,0,80,19
1683357730741,MGT 12,A00,202858,Lindenberger; Wade Douglas,42,0,90,48
1683357731770,MGT 18,A00,202859,Staff,74,0,90,16
1683357732796,MGT 18GS,A00,202860,McKay; Michael J,13,0,28,15
1683357733822,MGT 45,A00,202861,Pecore; Joseph P.,14,0,90,76
1683357734849,MGT 100,A00,202863,Yavorsky; Daniel Ryan,28,0,90,62
1683357735881,MGT 103,A00,202864,Ehrich; Kristine R,0,17,90,90
1683357736910,MGT 112,A00,202865,Ehrich; Kristine R,15,0,90,75
1683357737940,MGT 121A,A00,202868,Staff,0,20,0,0
1683357738965,MGT 131B,A00,202869,Anderson; John Charles,59,0,90,31
1683357739995,MGT 136,A00,202871,Lindenberger; Wade Douglas,84,0,90,6
1683357741081,MGT 164,A00,202873,Staff,0,68,90,91
1683357742106,MGT 164GS,A00,202874,McKay; Mary A,13,0,28,15
1683357743136,MGT 180,A00,202875,Staff,0,50,90,91
1683357744161,MMW 11R,A01,205019,Herbst; Matthew,3,0,30,27
1683357744161,MMW 11R,A02,205026,Herbst; Matthew,29,0,30,1
1683357745192,MMW 15,A01,193512,Chang; Edmond Yi-Teh,0,9,28,28
1683357745192,MMW 15,A02,193513,Chang; Edmond Yi-Teh,0,5,28,28
1683357745192,MMW 15,A03,193514,Chang; Edmond Yi-Teh,0,5,28,28
1683357745192,MMW 15,A04,193515,Chang; Edmond Yi-Teh,0,5,28,28
1683357745192,MMW 15,A05,193516,Chang; Edmond Yi-Teh,0,4,28,28
1683357745192,MMW 15,A06,193517,Chang; Edmond Yi-Teh,0,5,28,28
1683357745192,MMW 15,B01,193519,Chang; Edmond Yi-Teh,0,5,28,28
1683357745192,MMW 15,B02,193520,Chang; Edmond Yi-Teh,0,5,28,28
1683357745192,MMW 15,B03,193521,Chang; Edmond Yi-Teh,0,5,28,28
1683357745192,MMW 15,B04,193522,Chang; Edmond Yi-Teh,0,4,28,28
1683357745192,MMW 15,B05,193523,Chang; Edmond Yi-Teh,0,5,28,28
1683357745192,MMW 15,B06,193524,Chang; Edmond Yi-Teh,0,4,28,28
1683357746219,MMW 122,A01,193526,Rahimi; Babak,0,15,28,28
1683357746219,MMW 122,A02,193527,Rahimi; Babak,0,14,28,28
1683357746219,MMW 122,A03,193528,Rahimi; Babak,0,0,0,0
1683357746219,MMW 122,A04,193529,Rahimi; Babak,0,0,0,0
1683357747247,MUS 1A,A01,186663,Staff,0,20,35,35
1683357748274,MUS 4,A01,186715,Staff,0,12,35,35
1683357749296,MUS 5R,A01,186796,Dubnov; Shlomo,0,17,35,35
1683357750326,MUS 6,A01,186798,Staff,0,4,25,25
1683357751351,MUS 7,A01,186830,Staff,13,0,35,22
1683357752383,MUS 8,A01,186930,Staff,0,26,35,35
1683357753413,MUS 15,A01,186932,Staff,0,16,35,35
1683357753413,MUS 15,B01,186934,Staff,0,15,35,35
1683357754443,MUS 80,A00,186935,Staff,1,0,20,19
1683357754443,MUS 80,B00,186936,Staff,25,0,25,0
1683357755469,NANO 11,A00,204702,Lipomi; Darren John,0,0,0,0
1683357756496,NANO 15,A01,204709,Yang; Kesong,0,1,0,0
1683357757519,NANO 114,A00,202069,Jahed Motlagh; Zeinab,3,0,10,7
1683357758544,PHIL 1,A00,186955,Grush; Rick Scott,32,0,40,8
1683357759571,PHIL 10,A01,186973,Grush; Rick Scott,28,0,35,7
1683357759571,PHIL 10,A02,186974,Grush; Rick Scott,33,0,35,2
1683357760597,PHIL 13,A01,186976,Staff,7,0,35,28
1683357760597,PHIL 13,A02,186977,Staff,16,0,35,19
1683357761623,PHIL 14,A01,186979,Staff,31,0,35,4
1683357761623,PHIL 14,A02,186986,Staff,32,0,35,3
1683357762648,PHIL 28,A01,186988,Staff,16,0,30,14
1683357762648,PHIL 28,A02,186989,Staff,1,0,30,29
1683357762648,PHIL 28,A03,186990,Staff,9,0,30,21
1683357762648,PHIL 28,A04,186991,Staff,26,0,30,4
1683357763677,PHIL 120,A00,186997,Staff,23,0,40,17
1683357764704,PHIL 137,A00,187003,Staff,9,0,40,31
1683357765732,PHIL 150,A00,187015,Staff,47,0,70,23
1683357766757,PHIL 167,A00,187021,Lamey; Andy M.,35,0,40,5
1683357767791,PHIL 174,A01,202226,Staff,17,0,20,3
1683357767791,PHIL 174,A02,202235,Staff,20,0,20,0
1683357768816,PHIL 191A,A00,258918,Staff,0,0,1,1
1683357769842,PHYS 1A,A00,187028,Staff,27,0,60,33
1683357770872,PHYS 1AL,001,187036,Staff,2,0,30,28
1683357770872,PHYS 1AL,002,187049,Staff,18,0,30,12
1683357771898,PHYS 1B,A00,187058,Staff,22,0,60,38
1683357772937,PHYS 1BL,001,187064,Staff,0,0,30,30
1683357772937,PHYS 1BL,002,187070,Staff,5,0,30,25
1683357773966,PHYS 1C,A00,187082,Staff,31,0,120,89
1683357774995,PHYS 1CL,001,187088,Staff,0,9,30,30
1683357774995,PHYS 1CL,002,187089,Staff,0,2,30,30
1683357774995,PHYS 1CL,009,262693,Staff,11,0,30,19
1683357776027,PHYS 2B,A01,187097,Staff,54,0,115,61
1683357777055,PHYS 2C,A01,187099,Staff,67,0,115,48
1683357778085,PHYS 2CL,A01,187101,Staff,5,0,28,23
1683357778085,PHYS 2CL,A02,187102,Staff,15,0,28,13
1683357779117,PHYS 2D,A01,187123,Shotwell; Brian,95,0,115,20
1683357780141,PHYS 4B,A01,187133,Grinstein; Benjamin,35,0,50,15
1683357781178,POLI 10,A00,188819,Staff,0,4,50,50
1683357782203,POLI 11,A00,188827,Staff,43,0,50,7
1683357783231,POLI 13R,A00,188828,Staff,0,1,20,20
1683357784265,POLI 27,A01,188830,Elgin; Samuel Zincke,0,1,70,70
1683357785290,POLI 30,A00,188832,Desposato; Scott,31,0,50,19
1683357786318,POLI 102F,A00,188834,Staff,3,0,40,37
1683357787349,POLI 104A,A00,188852,Staff,14,0,30,16
1683357788378,POLI 104I,A00,188853,Staff,0,6,20,20
1683357789407,POLI 110B,A00,188854,Wiens; David,7,0,20,13
1683357790433,POLI 112A,A00,188855,Wiens; David,5,0,30,25
1683357791458,POLI 117R,A00,188856,Forman; Fonna,0,11,20,20
1683357792486,POLI 118,A00,188857,Ingham; Sean,8,0,20,12
1683357793513,POLI 120G,A00,188858,Staff,9,0,30,21
1683357794540,POLI 131CR,A00,188863,Hoston; Germaine,23,0,50,27
1683357795566,POLI 133,A00,188864,Nellis; Gareth Hb,44,0,50,6
1683357796593,POLI 134D,A00,188865,Desposato; Scott,27,0,30,3
1683357797618,POLI 142A,A00,188871,Gartzke; Erik,22,0,50,28
1683357798647,POLI 142K,A00,188874,Staff,38,0,50,12
1683357799676,POLI 143,A00,188940,Gartzke; Erik,16,0,30,14
1683357800706,POLI 153,A00,188943,Staff,3,0,20,17
1683357801734,POLI 160AA,A00,188944,Staff,11,0,40,29
1683357802762,POLI 170A,A00,188945,Staff,11,0,30,19
1683357804820,PSYC 1,A00,188952,Staff,37,0,90,53
1683357805845,PSYC 2,B00,188953,Staff,19,0,35,16
1683357806873,PSYC 6,A00,188970,Staff,47,0,60,13
1683357807898,PSYC 7,A00,188973,Staff,37,0,45,8
1683357808929,PSYC 60,A01,188980,Rickard; Timothy C.,43,0,60,17
1683357809958,PSYC 70,A01,189001,Steiner; Eric Tomas,23,0,45,22
1683357810986,PSYC 100,A00,189005,Lacefield; Katharine I,0,98,120,120
1683357812012,PSYC 102,A00,189008,Staff,9,0,30,21
1683357813039,PSYC 106,B00,189026,Gorman; Michael R.,34,0,60,26
1683357814066,PSYC 114,B01,189033,Winkielman; Piotr,0,32,30,30
1683357815091,PSYC 131,A00,189036,Anagnostaras; Stephan,0,43,60,60
1683357816116,PSYC 136,A00,189041,Lowe; Angela Beth,0,7,25,25
1683357817147,PSYC 137,A00,189057,Winkielman; Piotr,0,34,25,25
1683357818176,PSYC 144,A00,189107,Wixted; John T,0,7,50,50
1683357820227,PSYC 162,A00,189142,Staff,0,8,85,85
1683357821256,PSYC 172,A00,189144,Gorman; Michael R.,0,7,30,30
1683357823318,PSYC 179,A00,189146,Lacefield; Katharine I,0,84,120,120
1683357824349,PSYC 181,A00,189147,Anagnostaras; Stephan,0,44,90,90
1683357825375,PSYC 190R,A00,189148,Barner; David A.,0,22,80,80
1683357826400,PSYC 191,A00,189275,Rickard; Timothy C.,0,7,25,25
1683357827425,PSYC 193,A00,189276,Chapman; Eddie Nathaniel,0,1,0,4
1683357828456,PSYC 193L,A01,189281,Lowe; Angela Beth,12,0,20,8
1683357828456,PSYC 193L,B01,189285,Staff,28,0,35,7
1683357829484,RELI 149,A00,187137,Rahimi; Babak,7,0,40,33
1683357830514,SE 9,A01,187315,Staff,0,2,18,18
1683357831541,SE 101B,A00,187409,Staff,24,0,30,6
1683357832568,SE 110B,A00,187444,Staff,10,0,40,30
1683357833597,SE 130B,A00,187449,Staff,31,0,40,9
1683357834622,SE 150A,A00,187516,Staff,9,0,20,11
1683357835650,SE 154,A00,187528,Staff,30,0,50,20
1683357836674,SIO 3,A01,258171,Staff,35,0,40,5
1683357837701,SIO 10,A00,187144,Cook; Geoffrey W,0,3,75,75
1683357838729,SIO 45,A00,187152,Cook; Geoffrey W,1,0,100,99
1683357839755,SIO 109R,A00,194486,Staff,0,3,20,20
1683357841810,SIO 187,A01,187233,Kacev; David,12,0,40,28
1683357842836,SOCI 1,A01,258656,Thorpe; Charles Robert,28,0,30,2
1683357842836,SOCI 1,A02,258658,Thorpe; Charles Robert,30,0,30,0
1683357842836,SOCI 1,A03,258661,Thorpe; Charles Robert,25,0,25,0
1683357842836,SOCI 1,A04,258666,Thorpe; Charles Robert,22,0,25,3
1683357842836,SOCI 1,A05,258897,Thorpe; Charles Robert,23,0,25,2
1683357842836,SOCI 1,A06,258898,Thorpe; Charles Robert,25,0,25,0
1683357843862,SOCI 30,A01,258903,Pardo Guerra; Juan Pablo,15,0,30,15
1683357844944,SOCI 102,A00,258904,Staff,9,0,25,16
1683357845968,SOCI 106,A00,258905,Staff,19,0,25,6
1683357846993,SOCI 111,A00,258907,Ribas Norris; Janet Vanesa,26,0,30,4
1683357848018,SOCI 121R,A00,258908,Pardo Guerra; Juan Pablo,10,0,30,20
1683357849043,SOCI 126,A01,203330,Staff,14,0,20,6
1683357850068,SOCI 131,A00,258909,Thorpe; Charles Robert,31,0,60,29
1683357851094,SOCI 135,A00,258910,Payne; Christine Anna,0,9,30,30
1683357852118,SOCI 157,A00,258911,Staff,12,0,30,18
1683357853145,SOCI 184,A00,258912,Staff,25,0,30,5
1683357854173,SOCI 188D,A00,258913,Staff,22,0,30,8
1683357855201,SYN 2,001,187529,Staff,10,0,16,6
1683357855201,SYN 2,002,201452,Staff,0,18,16,16
1683357855201,SYN 2,003,201469,Staff,3,0,16,13
1683357856228,SYN 100,A01,187531,Staff,0,9,20,20
1683357856228,SYN 100,B01,201491,Staff,0,12,20,20
1683357857253,TDAC 1,A00,189286,Walsh; Kim C.,3,0,20,17
1683357857253,TDAC 1,B00,189287,Harting; Carla Kelso,11,0,20,9
1683357858282,TDAC 101,A00,189300,Walsh; Kim C.,16,0,20,4
1683357858282,TDAC 101,B00,189301,Harting; Carla Kelso,18,0,20,2
1683357859308,TDAC 102,A00,189304,Basso; Beatrice,14,0,20,6
1683357860336,TDAC 108,A00,189305,Staff,18,0,20,2
1683357861364,TDDE 131,A00,189310,Staff,19,0,20,1
1683357861364,TDDE 131,B00,189314,Staff,19,0,20,1
1683357861364,TDDE 131,C00,189315,Staff,48,0,50,2
1683357861364,TDDE 131,D00,189316,Staff,14,0,15,1
1683357861364,TDDE 131,E00,204841,Staff,20,0,20,0
1683357862388,TDGE 10,A00,189289,Staff,30,0,50,20
1683357862388,TDGE 10,B00,189290,Havis; Allan,1,0,50,49
1683357863413,TDGE 11,A00,189291,Fulton; Julia,0,3,50,50
1683357863413,TDGE 11,B00,189292,Staff,20,0,25,5
1683357863413,TDGE 11,C00,260270,Staff,0,0,0,0
1683357864442,TDGE 25,A00,189294,Staff,3,0,20,17
1683357865467,TDGE 124,A00,189318,Fulton; Julia,0,8,50,50
1683357866491,TDGE 125,A00,189319,Staff,13,0,25,12
1683357866491,TDGE 125,B00,189320,Staff,23,0,25,2
1683357867522,TDGE 127,A00,189322,Havis; Allan,0,0,50,50
1683357868551,TDHT 101,A00,189323,Staff,18,0,25,7
1683357868551,TDHT 101,B00,189324,Staff,25,0,25,0
1683357869576,TDHT 102,A00,189325,Staff,49,0,50,1
1683357870606,TDMV 1,A00,189295,Arcidiacono; Kristin,19,0,30,11
1683357870606,TDMV 1,B00,189296,Caligagan; Maria T.,24,0,30,6
1683357871630,TDMV 2,A00,189297,Sammartano; Tonnie,28,0,30,2
1683357871630,TDMV 2,B00,189299,Arcidiacono; Kristin,24,0,30,6
1683357872653,TDMV 3,A00,204998,Rincon; Alicia,22,0,30,8
1683357873681,TDMV 120,A00,189458,Sammartano; Tonnie,28,0,30,2
1683357874709,TDMV 138,A00,189541,Jun; Grace Shin Hae,22,0,40,18
1683357875736,TDMV 142,A00,189717,Caligagan; Tony,23,0,30,7
1683357875736,TDMV 142,B00,189718,Caligagan; Maria T.,25,0,30,5
1683357876760,TMC 2,A01,187533,Staff,25,0,25,0
1683357876760,TMC 2,A02,187534,Staff,25,0,25,0
1683357877785,USP 1,A01,187536,Kwak; Nancy,0,16,25,25
1683357878810,USP 5,A01,187538,Staff,10,0,25,15
1683357879837,USP 101,A00,199253,Staff,0,4,0,0
1683357880862,USP 124,A00,187562,Boomhower; Matthew Charles,1,0,30,29
1683357881891,USP 138,A00,187582,Staff,20,0,25,5
1683357882917,USP 152,A01,187597,Staff,4,0,25,21
1683357883943,USP 153,A00,187598,Staff,19,0,25,6
1683357884970,USP 168,A00,187607,Kwak; Nancy,2,0,5,3
1683357885995,USP 173,A00,187619,Staff,4,0,25,21
1683357887021,USP 181,A00,187638,Staff,0,3,25,25
1683357888050,VIS 103,A00,187650,Cruz; Edwin Teddy,22,0,75,53
1683357889078,VIS 110D,A00,187669,Staff,12,0,22,10
1683357890103,VIS 127C,A00,187720,Shen; Kuiyi,67,0,146,79
1683357891128,VIS 149,A00,187731,Yoldas; Pinar,0,14,22,22
1683357892153,VIS 151,A01,188091,Staff,22,0,34,12
1683357892153,VIS 151,A02,188092,Staff,11,0,34,23
1683357893176,VIS 160B,A00,188093,Stalbaum; Brett,0,0,10,10
1683357895227,WCWP 10B,A00,201720,Staff,10,0,15,5
1683357895227,WCWP 10B,B00,201722,Staff,9,0,15,6
1683357896255,WCWP 100,A00,201725,Gagnon; Jeffrey C,0,0,2,2
1683357896255,WCWP 100,B00,201727,Staff,0,4,15,15
1683357899397,ANBI 133,A00,258401,Wilder; Linnea Lorene,34,0,40,6
1683357900423,ANBI 140,A00,258395,Hrvoj Mihic; Branka,18,0,25,7
1683357901448,ANSC 120,A00,258402,Bialecki; Jon Anthony,27,0,40,13
1683357902474,ANSC 144,A00,258400,Staff,14,0,40,26
1683357904526,ANSC 166,A00,258396,Parish; Steven Martin,157,0,175,18
1683357905552,ANSC 180,A00,193533,Staff,9,0,20,11
1683357906579,ANSC 188,A00,258397,Jassal; Aftab,33,0,40,7
1683357907604,ANTH 3,A01,258316,Staff,23,0,30,7
1683357908632,ANTH 5,A00,258394,Semendeferi; Ekaterini,16,0,20,4
1683357909659,ANTH 21,A01,258331,Staff,8,0,40,32
1683357910688,ANTH 103,A00,258398,Varma; Saiba,15,0,25,10
1683357911713,AWP 10,001,202034,Staff,0,0,0,0
1683357911713,AWP 10,002,202035,Staff,0,0,0,0
1683357911713,AWP 10,003,202036,Staff,0,0,0,0
1683357911713,AWP 10,004,202037,Staff,0,0,0,0
1683357911713,AWP 10,005,202038,Staff,0,0,0,0
1683357911713,AWP 10,006,202039,Staff,0,0,0,0
1683357911713,AWP 10,007,202040,Staff,0,0,0,0
1683357911713,AWP 10,008,202041,Staff,0,0,0,0
1683357911713,AWP 10,009,202042,Staff,0,0,0,0
1683357911713,AWP 10,010,202043,Staff,0,0,0,0
1683357911713,AWP 10,011,202044,Staff,0,0,0,0
1683357911713,AWP 10,012,202045,Staff,0,0,0,0
1683357911713,AWP 10,013,202046,Staff,0,0,0,0
1683357911713,AWP 10,014,202047,Staff,0,0,0,0
1683357911713,AWP 10,015,202048,Staff,0,0,0,0
1683357911713,AWP 10,016,202049,Staff,0,0,0,0
1683357911713,AWP 10,017,202050,Staff,0,0,0,0
1683357911713,AWP 10,018,202051,Staff,0,0,0,0
1683357911713,AWP 10,019,202052,Staff,0,0,0,0
1683357911713,AWP 10,020,202053,Staff,0,0,0,0
1683357911713,AWP 10,021,202054,Staff,0,0,0,0
1683357911713,AWP 10,022,202055,Staff,0,0,0,0
1683357911713,AWP 10,023,202056,Staff,0,0,0,0
1683357911713,AWP 10,024,202057,Staff,0,0,0,0
1683357911713,AWP 10,025,202058,Staff,0,0,0,0
1683357911713,AWP 10,026,202059,Staff,0,0,0,0
1683357912737,AWP 102,001,202032,Staff,0,0,0,0
1683357912737,AWP 102,002,202033,Staff,0,0,0,0
1683357913760,BENG 100,A01,254234,Taylor Amos; Alyssa C,31,0,40,9
1683357914794,BENG 196,001,270013,Engler; Adam J.,9999,0,9999,0
1683357915824,BICD 100R,A01,202018,Smith; Laurie,0,7,32,32
1683357915824,BICD 100R,A02,202019,Smith; Laurie,0,2,32,32
1683357915824,BICD 100R,A03,202020,Smith; Laurie,0,1,32,32
1683357915824,BICD 100R,A04,202021,Smith; Laurie,9,0,32,23
1683357915824,BICD 100R,A05,202022,Smith; Laurie,12,0,32,20
1683357916854,BICD 136,A01,193242,Gustafson-Brown; Cindy,0,2,32,32
1683357916854,BICD 136,A02,193244,Gustafson-Brown; Cindy,14,0,32,18
1683357917886,BIEB 102,A01,193249,Butler; Shannon Rhey,0,2,32,32
1683357917886,BIEB 102,A02,193251,Butler; Shannon Rhey,0,0,32,32
1683357917886,BIEB 102,A03,193253,Butler; Shannon Rhey,0,1,32,32
1683357917886,BIEB 102,A04,193255,Butler; Shannon Rhey,17,0,32,15
1683357917886,BIEB 102,A05,193265,Butler; Shannon Rhey,26,0,32,6
1683357917886,BIEB 102,A06,193269,Butler; Shannon Rhey,16,0,32,16
1683357919935,BIEB 150,A01,193274,Staff,0,0,32,32
1683357919935,BIEB 150,A02,193285,Staff,23,0,32,9
1683357920960,BIEB 194,A00,193286,Kurle; Carolyn M.,22,0,32,10
1683357921989,BILD 1,A01,192291,Staff,16,0,32,16
1683357921989,BILD 1,A02,192292,Staff,30,0,32,2
1683357921989,BILD 1,B01,192520,Reuther; Keefe,0,1,0,0
1683357921989,BILD 1,B02,192532,Reuther; Keefe,0,1,0,0
1683357923021,BILD 3,A01,192556,Butler; Shannon Rhey,0,0,32,32
1683357923021,BILD 3,A02,192581,Butler; Shannon Rhey,4,0,32,28
1683357923021,BILD 3,A03,192611,Butler; Shannon Rhey,23,0,32,9
1683357923021,BILD 3,A04,192612,Butler; Shannon Rhey,25,0,32,7
1683357923021,BILD 3,A05,192613,Butler; Shannon Rhey,27,0,32,5
1683357923021,BILD 3,A06,192679,Butler; Shannon Rhey,27,0,32,5
1683357923021,BILD 3,A07,192682,Butler; Shannon Rhey,22,0,32,10
1683357924047,BILD 4,A01,192836,Reuther; Keefe,0,0,24,24
1683357924047,BILD 4,A02,193044,Reuther; Keefe,4,0,24,20
1683357925069,BILD 10,A01,193142,Gustafson-Brown; Cindy,30,0,32,2
1683357925069,BILD 10,A02,193149,Gustafson-Brown; Cindy,31,0,32,1
1683357926095,BIMM 100,A01,193301,Staff,0,6,32,32
1683357926095,BIMM 100,A02,193312,Staff,0,5,32,32
1683357926095,BIMM 100,A03,193323,Staff,0,8,32,32
1683357927120,BIMM 101,A01,193329,McDonnell; Lisa Marie,0,3,24,24
1683357927120,BIMM 101,A02,193339,McDonnell; Lisa Marie,0,3,24,24
1683357927120,BIMM 101,B01,193354,McDonnell; Lisa Marie,0,3,24,24
1683357927120,BIMM 101,B02,193357,McDonnell; Lisa Marie,0,3,24,24
1683357928148,BIMM 110,A01,193377,Tat; John,0,11,32,32
1683357928148,BIMM 110,A02,193378,Tat; John,0,9,32,32
1683357929180,BIMM 120,A01,206116,Staff,0,0,32,32
1683357929180,BIMM 120,A02,206117,Staff,8,0,32,24
1683357929180,BIMM 120,A03,206121,Staff,21,0,32,11
1683357930209,BIPN 100,A01,193393,Park; Ji Young,0,14,32,32
1683357930209,BIPN 100,A02,193402,Park; Ji Young,0,13,32,32
1683357930209,BIPN 100,A03,193413,Park; Ji Young,0,14,32,32
1683357930209,BIPN 100,A04,193414,Park; Ji Young,0,13,32,32
1683357931238,BIPN 102,A01,193429,Staff,0,0,32,32
1683357931238,BIPN 102,A02,193438,Staff,22,0,32,10
1683357932266,BIPN 106,A01,193450,Reyes Gonzalez; Catalina,0,2,40,40
1683357933295,BIPN 134,A01,193465,Cooke; James Edward,1,0,32,31
1683357933295,BIPN 134,A02,193474,Cooke; James Edward,25,0,32,7
1683357933295,BIPN 134,A03,193485,Cooke; James Edward,29,0,32,3
1683357933295,BIPN 134,A04,193486,Cooke; James Edward,21,0,32,11
1683357933295,BIPN 134,A05,193491,Cooke; James Edward,31,0,32,1
1683357933295,BIPN 134,A06,193501,Cooke; James Edward,30,0,32,2
1683357933295,BIPN 134,A07,193510,Cooke; James Edward,29,0,32,3
1683357935346,BISP 194,A00,222522,Staff,14,0,32,18
1683357936370,CAT 124,A01,202407,Staff,19,0,25,6
1683357937394,CAT 125,A00,202408,Marchisotto; Jennifer Anne,4,0,20,16
1683357938420,CAT 125R,A00,202409,Smith; Lauryn Alissa,0,11,20,20
1683357938420,CAT 125R,B00,202410,Morales; Celeste Georgianna,0,11,20,20
1683357938420,CAT 125R,C00,202411,Irwin; Matthew Joseph,0,10,20,20
1683357939532,CENG 15,A01,204712,Yang; Kesong,0,1,0,0
1683357940561,CENG 114,A00,202070,Jahed Motlagh; Zeinab,5,0,20,15
1683357941589,CGS 105,A00,185477,Wesling; Megan E.,24,0,40,16
1683357942613,CGS 106,A00,185494,Staff,13,0,22,9
1683357943641,CGS 108,A00,185495,Staff,14,0,20,6
1683357944665,CGS 114,A00,185496,Staff,13,0,18,5
1683357945689,CGS 119,A00,185501,Staff,15,0,20,5
1683357946713,CGS 120,A00,185511,Staff,13,0,20,7
1683357947738,CHEM 4,A01,184675,Bussey; Thomas J,96,0,100,4
1683357948817,CHEM 6A,A01,184677,Staff,34,0,60,26
1683357949842,CHEM 6B,A01,184679,Staff,65,0,100,35
1683357950867,CHEM 6C,A01,184681,Bussey; Thomas J,1,0,50,49
1683357950867,CHEM 6C,A02,184682,Bussey; Thomas J,34,0,50,16
1683357951892,CHEM 40A,A01,184684,Albizati; Kim F.,37,0,100,63
1683357952917,CHEM 40B,A01,184686,Albizati; Kim F.,0,20,100,100
1683357953941,CHEM 41B,A01,184690,Staff,52,0,100,48
1683357954970,COGS 3,A01,184715,Boyle; Mary E. T.,0,25,40,40
1683357955994,COGS 14B,A01,185172,Staff,0,15,38,38
1683357957020,COGS 18,A01,184736,Staff,17,0,80,63
1683357958049,COGS 100,A01,184932,Staff,0,5,73,73
1683357959076,COGS 101A,A01,184935,Staff,0,39,30,30
1683357960100,COGS 101B,A01,184944,Staff,0,2,30,30
1683357961129,COGS 101C,A01,184946,Staff,0,12,30,30
1683357962155,COGS 102A,A01,184951,Johnson; Christine M.,2,0,40,38
1683357963180,COGS 107B,A01,184953,Mooshagian; Eric Frederick,0,50,40,40
1683357964211,COGS 118B,A01,184959,Gupta; Anjum,0,48,40,40
1683357965236,COGS 153,A00,184961,Staff,0,15,30,30
1683357966265,COGS 177,A00,184962,Staff,0,20,30,30
1683357967291,COGS 187A,A01,184969,Boyle; Mary E. T.,0,17,40,40
1683357968318,COMM 10,A01,185174,Staff,0,5,25,25
1683357968318,COMM 10,A02,185189,Staff,0,5,25,25
1683357968318,COMM 10,A03,269821,Staff,0,0,0,0
1683357969343,COMM 100B,A01,185475,Staff,0,0,0,2
1683357969343,COMM 100B,A02,185476,Staff,13,0,25,12
1683357970368,COMM 100C,A01,185314,Staff,1,0,25,24
1683357970368,COMM 100C,A02,185327,Staff,19,0,25,6
1683357971394,COMM 110M,A00,185349,Staff,2,0,40,38
1683357972422,COMM 113T,A00,185352,Staff,24,0,40,16
1683357973446,COMM 114I,A00,185353,Staff,33,0,40,7
1683357974468,COMM 131,A00,185354,Staff,19,0,30,11
1683357975494,CSE 8A,A50,185358,Cao; Yingjun,0,46,10,10
1683357976519,CSE 8B,A01,185362,Staff,0,46,50,50
1683357977548,CSE 11,A01,185416,Cao; Yingjun,0,92,10,10
1683357978574,CSE 20,A01,185445,Briones; Jor-el Thomas Caparas,5,0,25,20
1683357979602,CSE 21,A01,185447,Staff,10,0,50,40
1683357980629,CSE 101,A01,185451,Staff,0,13,50,50
1683357980629,CSE 101,B01,185453,Jones; Miles E,0,11,50,50
1683357982682,CSE 141,A01,185458,Eldon; John,20,0,100,80
1683357983710,CSE 141L,A01,185461,Eldon; John,12,0,100,88
1683357984736,CSE 142,A01,185463,Staff,36,0,60,24
1683357984736,CSE 142,B01,201355,Staff,0,7,60,60
1683357985761,CSE 142L,A01,185470,Staff,36,0,60,24
1683357985761,CSE 142L,B01,201417,Staff,0,6,60,60
1683357986784,CSE 190,A00,201433,Staff,32,0,49,17
1683357987809,DOC 1,A01,259136,Strom; Megan C.,7,0,15,8
1683357987809,DOC 1,A02,259137,Strom; Megan C.,14,0,15,1
1683357987809,DOC 1,A03,259138,Strom; Megan C.,14,0,15,1
1683357987809,DOC 1,A04,259139,Strom; Megan C.,14,0,15,1
1683357988834,DOC 100D,A00,259140,Pass; Natalye Joann,16,0,25,9
1683357989858,DSGN 1,A01,184749,Rill; Bryan,0,25,30,30
1683357990883,DSGN 100,A01,185168,Staff,0,2,25,25
1683357991908,ECE 5,A01,185626,Morris; Karcher William,0,10,0,0
1683357992937,ECE 101,A01,185628,Staff,17,0,70,53
1683357993966,ECE 107,A01,185635,Baghdadchi; Saharnaz,0,0,20,20
1683357993966,ECE 107,A02,185638,Baghdadchi; Saharnaz,4,0,20,16
1683357994995,ECE 148,A01,185647,Silberman; Jack,0,0,16,16
1683357996021,ECON 1,A01,185537,Crane; Meredith Helen,54,0,70,16
1683357997046,ECON 3,A01,185549,Crane; Meredith Helen,32,0,70,38
1683357998071,ECON 4,A01,203354,Anderson; John Charles,0,4,10,10
1683357999100,ECON 100A,A01,185574,Staff,0,4,40,40
1683358000127,ECON 100B,A01,185576,Staff,0,12,50,50
1683358001151,ECON 100C,A01,185589,Newhouse; Herbert S,29,0,70,41
1683358002175,ECON 105,A00,185608,Vespa; Emanuel Ignacio,19,0,35,16
1683358003205,ECON 109,A01,185610,Shishkin; Denis,10,0,35,25
1683358004230,ECON 110A,A01,185612,Staff,11,0,40,29
1683358005256,ECON 120A,A01,185615,Staff,20,0,40,20
1683358006286,ECON 120C,A01,185617,Sun; Yixiao,0,21,70,70
1683358007315,ECON 144,A00,203346,Squires; Dale E,3,0,35,32
1683358008340,ECON 171,A01,203349,Newhouse; Herbert S,0,1,35,35
1683358009366,ECON 173A,A01,185621,Toda; Alexis Akira,21,0,35,14
1683358010391,EDS 25,A01,202413,Staff,0,1,0,0
1683358010391,EDS 25,A02,202414,Staff,0,1,0,0
1683358010391,EDS 25,A03,202415,Staff,0,0,0,0
1683358010391,EDS 25,A04,202416,Staff,0,1,0,0
1683358010391,EDS 25,A05,202439,Staff,0,0,0,0
1683358010391,EDS 25,A06,202440,Staff,0,0,0,0
1683358010391,EDS 25,B01,202631,Staff,0,0,0,0
1683358010391,EDS 25,B02,202632,Staff,0,0,0,0
1683358010391,EDS 25,B03,202639,Staff,0,0,0,0
1683358010391,EDS 25,B04,202640,Staff,0,0,0,0
1683358010391,EDS 25,B05,202643,Staff,0,0,0,0
1683358010391,EDS 25,B06,202644,Staff,0,0,0,0
1683358011415,EDS 38,A01,202659,Black; Alison Michelle,24,0,25,1
1683358012442,EDS 115,A00,202652,Staff,18,0,30,12
1683358013468,EDS 125,A00,202649,Staff,14,0,30,16
1683358014492,EDS 126,A01,203332,Staff,30,0,30,0
1683358015516,EDS 139,A00,202838,Staff,16,0,25,9
1683358016542,EDS 146,A01,202655,Staff,14,0,25,11
1683358017568,ENG 15,A00,185667,Staff,0,1,0,0
1683358017568,ENG 15,B00,185672,Staff,0,0,0,0
1683358017568,ENG 15,C00,185675,Staff,0,0,0,0
1683358017568,ENG 15,D00,185682,Staff,0,0,0,0
1683358017568,ENG 15,E00,185684,Staff,0,0,0,0
1683358018591,ETHN 103,A00,185710,Staff,0,4,35,35
1683358019614,ETHN 103A,A00,199228,Man; Simeon S,2,0,9,7
1683358020639,ETHN 109,A00,185711,Staff,18,0,35,17
1683358021666,ETHN 142,A00,185726,Staff,0,4,30,30
1683358022691,ETHN 163J,A00,199229,Man; Simeon S,5,0,8,3
1683358023716,ETHN 168,A00,185727,Staff,8,0,10,2
1683358024745,ETHN 182,A00,185728,Staff,0,0,35,35
1683358025771,ETHN 183,A00,185737,Staff,8,0,18,10
1683358026798,GLBH 111,A01,209361,Burgos; Jose L.,0,0,0,0
1683358028848,HIEU 104,A00,185792,Staff,16,0,20,4
1683358029873,HIEU 115,A00,185800,Staff,1,0,20,19
1683358030897,HIEU 128,A00,185801,Staff,0,7,20,20
1683358031923,HIEU 147,A00,185802,Staff,16,0,20,4
1683358032948,HIEU 154,A00,185823,Staff,12,0,20,8
1683358033976,HILA 102,A00,185826,Staff,13,0,20,7
1683358035003,HILD 2C,A01,185778,Staff,0,12,20,20
1683358036031,HILD 7B,A01,185780,Kwak; Nancy,0,15,32,32
1683358036031,HILD 7B,A02,185781,Kwak; Nancy,0,18,32,32
1683358037056,HILD 30,A01,185791,Staff,14,0,20,6
1683358038082,HISC 119,A00,185830,Golan; Tal,0,9,20,20
1683358039106,HITO 156GS,A00,185831,Patterson; Patrick H.,0,0,0,23
1683358040130,HIUS 103,A00,185832,Man; Simeon S,1,6,20,19
1683358041156,HIUS 117,A00,185836,Kwak; Nancy,2,0,20,18
1683358042180,HIUS 125,A00,185840,Man; Simeon S,0,0,23,23
1683358043208,HIUS 149,A00,185845,Staff,0,0,20,20
1683358044238,HUM 3,A01,185882,Zavodny; Tatiana Sophia,0,7,50,50
1683358044238,HUM 3,B01,185899,Caldwell; Michael Alan,0,18,50,50
1683358045262,HUM 3GS,A00,185900,Patterson; Patrick H.,0,0,0,23
1683358046294,HUM 4,A01,185938,Zroka; Amy Liane,31,0,50,19
1683358046294,HUM 4,B01,185956,Watkins; Eric,0,3,50,50
1683358046294,HUM 4,B02,202209,Watkins; Eric,0,2,50,50
1683358046294,HUM 4,B03,202210,Watkins; Eric,0,2,50,50
1683358047324,HUM 5,A01,185958,West; Geoffrey Scott,3,0,50,47
1683358047324,HUM 5,A02,202215,West; Geoffrey Scott,0,0,50,50
1683358048348,INTL 190,A00,185959,Gagnon; Jeffrey C,0,0,0,9
1683358048348,INTL 190,B00,185960,Lettieri; Michael Joseph,0,0,0,1
1683358049372,JAPN 180,A00,254509,Staff,4,0,30,26
1683358050398,LATI 10,A01,202853,Kennemore; Amy Michelle,4,0,35,31
1683358050398,LATI 10,A02,202854,Kennemore; Amy Michelle,2,0,35,33
1683358050398,LATI 10,A03,270054,Kennemore; Amy Michelle,30,0,30,0
1683358051422,LATI 180,A00,202855,Kennemore; Amy Michelle,11,0,20,9
1683358052508,LAWS 101,A00,201767,Golan; Tal,0,7,40,40
1683358053532,LIFR 1C,A00,185961,Staff,6,0,20,14
1683358054558,LIFR 1CX,A00,185962,Staff,7,0,20,13
1683358055584,LIFR 1D,A00,185963,Staff,9,0,20,11
1683358056612,LIFR 1DX,A00,185964,Staff,9,0,20,11
1683358057634,LIGN 101,A01,186039,Staff,43,0,50,7
1683358058659,LIGN 165,A00,186040,Staff,18,0,50,32
1683358059687,LTCS 108,A00,186041,Staff,6,0,10,4
1683358060711,LTCS 119,A00,186042,Staff,16,0,20,4
1683358061735,LTCS 130,A00,186043,Wesling; Megan E.,15,0,25,10
1683358063794,LTEA 138,A00,186119,Staff,14,0,40,26
1683358064819,LTEN 124,A00,186148,Staff,6,0,25,19
1683358065848,LTEN 178,A00,186149,Staff,7,0,15,8
1683358066872,LTEN 181,A00,186150,Blanco; John D,33,0,40,7
1683358067900,LTWL 120,A00,186160,Staff,20,0,25,5
1683358068930,LTWL 165,A00,186161,Staff,22,0,25,3
1683358069954,LTWR 100,A00,186162,Staff,0,5,15,15
1683358070982,LTWR 102,A00,186163,Doller; Ben,5,0,15,10
1683358072008,MAE 8,A01,186412,Staff,0,0,0,0
1683358073032,MAE 30B,A00,186445,Bahadori; Mohammad Yousef,83,0,100,17
1683358074060,MAE 40,A00,186592,Bewley; Thomas R,10,0,50,40
1683358075086,MAE 101B,A00,186593,Bahadori; Mohammad Yousef,81,0,100,19
1683358076111,MAE 105,A00,186594,Bandaru; Prabhakar,12,0,50,38
1683358077135,MAE 107,A00,186599,Pham; Hieu Tan,0,7,120,120
1683358078159,MAE 148,A01,186660,Silberman; Jack,3,0,16,13
1683358079185,MATH 10A,A01,188095,Staff,0,5,35,35
1683358080215,MATH 10B,A01,188097,Bowers; Adam R.,0,11,30,30
1683358080215,MATH 10B,A02,188099,Bowers; Adam R.,0,11,30,30
1683358080215,MATH 10B,B01,188104,Bowers; Adam R.,0,10,30,30
1683358080215,MATH 10B,B02,188106,Bowers; Adam R.,0,10,30,30
1683358081247,MATH 10C,A01,188111,Staff,0,18,30,30
1683358081247,MATH 10C,A02,188127,Staff,0,17,30,30
1683358081247,MATH 10C,A03,188131,Staff,0,18,30,30
1683358081247,MATH 10C,B01,188218,Staff,18,0,30,12
1683358081247,MATH 10C,B02,188244,Staff,13,0,30,17
1683358081247,MATH 10C,B03,188277,Staff,16,0,30,14
1683358082278,MATH 18,A01,188344,Bach; Quang Tran,18,0,30,12
1683358082278,MATH 18,A02,188345,Bach; Quang Tran,11,0,30,19
1683358082278,MATH 18,B01,188353,Bach; Quang Tran,10,0,30,20
1683358082278,MATH 18,B02,188354,Bach; Quang Tran,20,0,30,10
1683358083303,MATH 20A,A01,188374,Staff,12,0,35,23
1683358084335,MATH 20B,A01,188382,Ohm; Ko Woon,6,0,30,24
1683358084335,MATH 20B,A02,188383,Ohm; Ko Woon,22,0,30,8
1683358084335,MATH 20B,B01,188385,Ohm; Ko Woon,7,0,30,23
1683358084335,MATH 20B,B02,188392,Ohm; Ko Woon,22,0,30,8
1683358085360,MATH 20C,A01,188394,Harel; Guershon,10,0,30,20
1683358085360,MATH 20C,A02,188395,Harel; Guershon,15,0,30,15
1683358085360,MATH 20C,B01,188404,Harel; Guershon,4,0,30,26
1683358085360,MATH 20C,B02,188405,Harel; Guershon,19,0,30,11
1683358086387,MATH 20D,A01,188414,Hammock; Frances H,0,1,30,30
1683358086387,MATH 20D,A02,188415,Hammock; Frances H,3,0,30,27
1683358086387,MATH 20D,B01,188447,Hammock; Frances H,1,0,30,29
1683358086387,MATH 20D,B02,188486,Hammock; Frances H,8,0,30,22
1683358087411,MATH 20E,A01,188649,Staff,21,0,30,9
1683358087411,MATH 20E,A02,188650,Staff,23,0,30,7
1683358087411,MATH 20E,A03,188673,Staff,0,0,30,30
1683358088438,MATH 102,A01,188675,Staff,0,35,35,35
1683358089463,MATH 103B,A01,188681,Staff,3,0,35,32
1683358089463,MATH 103B,B01,188692,Staff,5,0,35,30
1683358090490,MATH 109,A01,188695,Salehi Golsefidy; Alireza,25,0,35,10
1683358090490,MATH 109,A02,188696,Salehi Golsefidy; Alireza,25,0,35,10
1683358091516,MATH 120A,A01,188698,Eggers; John Dietrich,7,0,35,28
1683358092543,MATH 142B,A01,188736,Ioana; Adrian,0,2,30,30
1683358092543,MATH 142B,A02,188741,Ioana; Adrian,0,0,30,30
1683358092543,MATH 142B,A03,188743,Ioana; Adrian,0,1,30,30
1683358093571,MATH 168A,A01,188790,Staff,0,9,35,35
1683358094603,MATH 170A,A01,188803,Nie; Jiawang,0,2,35,35
1683358094603,MATH 170A,A02,188811,Nie; Jiawang,0,0,35,35
1683358094603,MATH 170A,A03,188814,Nie; Jiawang,1,0,35,34
1683358094603,MATH 170A,A04,188815,Nie; Jiawang,13,0,35,22
1683358095631,MATH 193B,A01,188817,Staff,0,0,35,35
1683358095631,MATH 193B,A02,188818,Staff,5,0,35,30
1683358096656,MGT 4,A01,202857,Anderson; John Charles,61,0,80,19
1683358097682,MGT 12,A00,202858,Lindenberger; Wade Douglas,42,0,90,48
1683358098707,MGT 18,A00,202859,Staff,74,0,90,16
1683358099732,MGT 18GS,A00,202860,McKay; Michael J,13,0,28,15
1683358100758,MGT 45,A00,202861,Pecore; Joseph P.,14,0,90,76
1683358101785,MGT 100,A00,202863,Yavorsky; Daniel Ryan,28,0,90,62
1683358102814,MGT 103,A00,202864,Ehrich; Kristine R,0,17,90,90
1683358103842,MGT 112,A00,202865,Ehrich; Kristine R,15,0,90,75
1683358104868,MGT 121A,A00,202868,Staff,0,20,0,0
1683358105893,MGT 131B,A00,202869,Anderson; John Charles,59,0,90,31
1683358106921,MGT 136,A00,202871,Lindenberger; Wade Douglas,84,0,90,6
1683358107945,MGT 164,A00,202873,Staff,0,68,90,91
1683358108969,MGT 164GS,A00,202874,McKay; Mary A,13,0,28,15
1683358109991,MGT 180,A00,202875,Staff,0,50,90,91
1683358111015,MMW 11R,A01,205019,Herbst; Matthew,3,0,30,27
1683358111015,MMW 11R,A02,205026,Herbst; Matthew,29,0,30,1
1683358112046,MMW 15,A01,193512,Chang; Edmond Yi-Teh,0,9,28,28
1683358112046,MMW 15,A02,193513,Chang; Edmond Yi-Teh,0,5,28,28
1683358112046,MMW 15,A03,193514,Chang; Edmond Yi-Teh,0,5,28,28
1683358112046,MMW 15,A04,193515,Chang; Edmond Yi-Teh,0,5,28,28
1683358112046,MMW 15,A05,193516,Chang; Edmond Yi-Teh,0,4,28,28
1683358112046,MMW 15,A06,193517,Chang; Edmond Yi-Teh,0,5,28,28
1683358112046,MMW 15,B01,193519,Chang; Edmond Yi-Teh,0,5,28,28
1683358112046,MMW 15,B02,193520,Chang; Edmond Yi-Teh,0,5,28,28
1683358112046,MMW 15,B03,193521,Chang; Edmond Yi-Teh,0,5,28,28
1683358112046,MMW 15,B04,193522,Chang; Edmond Yi-Teh,0,4,28,28
1683358112046,MMW 15,B05,193523,Chang; Edmond Yi-Teh,0,5,28,28
1683358112046,MMW 15,B06,193524,Chang; Edmond Yi-Teh,0,4,28,28
1683358113075,MMW 122,A01,193526,Rahimi; Babak,0,15,28,28
1683358113075,MMW 122,A02,193527,Rahimi; Babak,0,14,28,28
1683358113075,MMW 122,A03,193528,Rahimi; Babak,0,0,0,0
1683358113075,MMW 122,A04,193529,Rahimi; Babak,0,0,0,0
1683358114100,MUS 1A,A01,186663,Staff,0,20,35,35
1683358115125,MUS 4,A01,186715,Staff,0,12,35,35
1683358116150,MUS 5R,A01,186796,Dubnov; Shlomo,0,17,35,35
1683358117174,MUS 6,A01,186798,Staff,0,4,25,25
1683358118199,MUS 7,A01,186830,Staff,13,0,35,22
1683358119225,MUS 8,A01,186930,Staff,0,26,35,35
1683358120248,MUS 15,A01,186932,Staff,0,16,35,35
1683358120248,MUS 15,B01,186934,Staff,0,15,35,35
1683358121276,MUS 80,A00,186935,Staff,0,0,20,20
1683358121276,MUS 80,B00,186936,Staff,25,0,25,0
1683358122301,NANO 11,A00,204702,Lipomi; Darren John,0,0,0,0
1683358123324,NANO 15,A01,204709,Yang; Kesong,0,1,0,0
1683358124353,NANO 114,A00,202069,Jahed Motlagh; Zeinab,3,0,10,7
1683358125378,PHIL 1,A00,186955,Grush; Rick Scott,32,0,40,8
1683358126403,PHIL 10,A01,186973,Grush; Rick Scott,28,0,35,7
1683358126403,PHIL 10,A02,186974,Grush; Rick Scott,33,0,35,2
1683358127428,PHIL 13,A01,186976,Staff,7,0,35,28
1683358127428,PHIL 13,A02,186977,Staff,16,0,35,19
1683358128453,PHIL 14,A01,186979,Staff,31,0,35,4
1683358128453,PHIL 14,A02,186986,Staff,32,0,35,3
1683358129483,PHIL 28,A01,186988,Staff,16,0,30,14
1683358129483,PHIL 28,A02,186989,Staff,1,0,30,29
1683358129483,PHIL 28,A03,186990,Staff,9,0,30,21
1683358129483,PHIL 28,A04,186991,Staff,26,0,30,4
1683358130512,PHIL 120,A00,186997,Staff,23,0,40,17
1683358131539,PHIL 137,A00,187003,Staff,9,0,40,31
1683358132564,PHIL 150,A00,187015,Staff,47,0,70,23
1683358133589,PHIL 167,A00,187021,Lamey; Andy M.,35,0,40,5
1683358134618,PHIL 174,A01,202226,Staff,17,0,20,3
1683358134618,PHIL 174,A02,202235,Staff,20,0,20,0
1683358135649,PHIL 191A,A00,258918,Staff,0,0,1,1
1683358136677,PHYS 1A,A00,187028,Staff,27,0,60,33
1683358137702,PHYS 1AL,001,187036,Staff,2,0,30,28
1683358137702,PHYS 1AL,002,187049,Staff,18,0,30,12
1683358138727,PHYS 1B,A00,187058,Staff,22,0,60,38
1683358139752,PHYS 1BL,001,187064,Staff,0,0,30,30
1683358139752,PHYS 1BL,002,187070,Staff,5,0,30,25
1683358140777,PHYS 1C,A00,187082,Staff,31,0,120,89
1683358141802,PHYS 1CL,001,187088,Staff,0,9,30,30
1683358141802,PHYS 1CL,002,187089,Staff,0,2,30,30
1683358141802,PHYS 1CL,009,262693,Staff,11,0,30,19
1683358142827,PHYS 2B,A01,187097,Staff,54,0,115,61
1683358143851,PHYS 2C,A01,187099,Staff,67,0,115,48
1683358144880,PHYS 2CL,A01,187101,Staff,5,0,28,23
1683358144880,PHYS 2CL,A02,187102,Staff,15,0,28,13
1683358145905,PHYS 2D,A01,187123,Shotwell; Brian,95,0,115,20
1683358146933,PHYS 4B,A01,187133,Grinstein; Benjamin,35,0,50,15
1683358147959,POLI 10,A00,188819,Staff,0,4,50,50
1683358148984,POLI 11,A00,188827,Staff,43,0,50,7
1683358150011,POLI 13R,A00,188828,Staff,0,1,20,20
1683358151041,POLI 27,A01,188830,Elgin; Samuel Zincke,0,1,70,70
1683358152069,POLI 30,A00,188832,Desposato; Scott,31,0,50,19
1683358153096,POLI 102F,A00,188834,Staff,3,0,40,37
1683358154121,POLI 104A,A00,188852,Staff,14,0,30,16
1683358155146,POLI 104I,A00,188853,Staff,0,6,20,20
1683358156224,POLI 110B,A00,188854,Wiens; David,7,0,20,13
1683358157248,POLI 112A,A00,188855,Wiens; David,5,0,30,25
1683358158276,POLI 117R,A00,188856,Forman; Fonna,0,11,20,20
1683358159300,POLI 118,A00,188857,Ingham; Sean,8,0,20,12
1683358160324,POLI 120G,A00,188858,Staff,9,0,30,21
1683358161350,POLI 131CR,A00,188863,Hoston; Germaine,23,0,50,27
1683358162375,POLI 133,A00,188864,Nellis; Gareth Hb,44,0,50,6
1683358163406,POLI 134D,A00,188865,Desposato; Scott,27,0,30,3
1683358164431,POLI 142A,A00,188871,Gartzke; Erik,22,0,50,28
1683358165458,POLI 142K,A00,188874,Staff,38,0,50,12
1683358166486,POLI 143,A00,188940,Gartzke; Erik,16,0,30,14
1683358167511,POLI 153,A00,188943,Staff,3,0,20,17
1683358168536,POLI 160AA,A00,188944,Staff,11,0,40,29
1683358169561,POLI 170A,A00,188945,Staff,11,0,30,19
1683358171612,PSYC 1,A00,188952,Staff,37,0,90,53
1683358172637,PSYC 2,B00,188953,Staff,19,0,35,16
1683358173664,PSYC 6,A00,188970,Staff,47,0,60,13
1683358174690,PSYC 7,A00,188973,Staff,37,0,45,8
1683358175718,PSYC 60,A01,188980,Rickard; Timothy C.,43,0,60,17
1683358176747,PSYC 70,A01,189001,Steiner; Eric Tomas,23,0,45,22
1683358177776,PSYC 100,A00,189005,Lacefield; Katharine I,0,98,120,120
1683358178800,PSYC 102,A00,189008,Staff,9,0,30,21
1683358179825,PSYC 106,B00,189026,Gorman; Michael R.,34,0,60,26
1683358180850,PSYC 114,B01,189033,Winkielman; Piotr,0,32,30,30
1683358181875,PSYC 131,A00,189036,Anagnostaras; Stephan,0,43,60,60
1683358182900,PSYC 136,A00,189041,Lowe; Angela Beth,0,7,25,25
1683358183930,PSYC 137,A00,189057,Winkielman; Piotr,0,34,25,25
1683358184955,PSYC 144,A00,189107,Wixted; John T,0,7,50,50
1683358187006,PSYC 162,A00,189142,Staff,0,8,85,85
1683358188032,PSYC 172,A00,189144,Gorman; Michael R.,0,7,30,30
1683358190085,PSYC 179,A00,189146,Lacefield; Katharine I,0,84,120,120
1683358191110,PSYC 181,A00,189147,Anagnostaras; Stephan,0,44,90,90
1683358192135,PSYC 190R,A00,189148,Barner; David A.,0,22,80,80
1683358193159,PSYC 191,A00,189275,Rickard; Timothy C.,0,7,25,25
1683358194185,PSYC 193,A00,189276,Chapman; Eddie Nathaniel,0,1,0,4
1683358195211,PSYC 193L,A01,189281,Lowe; Angela Beth,12,0,20,8
1683358195211,PSYC 193L,B01,189285,Staff,28,0,35,7
1683358196236,RELI 149,A00,187137,Rahimi; Babak,7,0,40,33
1683358197261,SE 9,A01,187315,Staff,0,2,18,18
1683358198289,SE 101B,A00,187409,Staff,24,0,30,6
1683358199316,SE 110B,A00,187444,Staff,10,0,40,30
1683358200345,SE 130B,A00,187449,Staff,31,0,40,9
1683358201370,SE 150A,A00,187516,Staff,9,0,20,11
1683358202400,SE 154,A00,187528,Staff,30,0,50,20
1683358203423,SIO 3,A01,258171,Staff,35,0,40,5
1683358204452,SIO 10,A00,187144,Cook; Geoffrey W,0,3,75,75
1683358205482,SIO 45,A00,187152,Cook; Geoffrey W,1,0,100,99
1683358206506,SIO 109R,A00,194486,Staff,0,3,20,20
1683358208562,SIO 187,A01,187233,Kacev; David,12,0,40,28
1683358209591,SOCI 1,A01,258656,Thorpe; Charles Robert,28,0,30,2
1683358209591,SOCI 1,A02,258658,Thorpe; Charles Robert,30,0,30,0
1683358209591,SOCI 1,A03,258661,Thorpe; Charles Robert,25,0,25,0
1683358209591,SOCI 1,A04,258666,Thorpe; Charles Robert,22,0,25,3
1683358209591,SOCI 1,A05,258897,Thorpe; Charles Robert,23,0,25,2
1683358209591,SOCI 1,A06,258898,Thorpe; Charles Robert,25,0,25,0
1683358210618,SOCI 30,A01,258903,Pardo Guerra; Juan Pablo,15,0,30,15
1683358211643,SOCI 102,A00,258904,Staff,9,0,25,16
1683358212671,SOCI 106,A00,258905,Staff,19,0,25,6
1683358213698,SOCI 111,A00,258907,Ribas Norris; Janet Vanesa,26,0,30,4
1683358214726,SOCI 121R,A00,258908,Pardo Guerra; Juan Pablo,10,0,30,20
1683358215752,SOCI 126,A01,203330,Staff,14,0,20,6
1683358216782,SOCI 131,A00,258909,Thorpe; Charles Robert,31,0,60,29
1683358217806,SOCI 135,A00,258910,Payne; Christine Anna,0,9,30,30
1683358218830,SOCI 157,A00,258911,Staff,12,0,30,18
1683358219854,SOCI 184,A00,258912,Staff,25,0,30,5
1683358220880,SOCI 188D,A00,258913,Staff,22,0,30,8
1683358221907,SYN 2,001,187529,Staff,10,0,16,6
1683358221907,SYN 2,002,201452,Staff,0,18,16,16
1683358221907,SYN 2,003,201469,Staff,3,0,16,13
1683358222933,SYN 100,A01,187531,Staff,0,9,20,20
1683358222933,SYN 100,B01,201491,Staff,0,12,20,20
1683358223958,TDAC 1,A00,189286,Walsh; Kim C.,3,0,20,17
1683358223958,TDAC 1,B00,189287,Harting; Carla Kelso,11,0,20,9
1683358224986,TDAC 101,A00,189300,Walsh; Kim C.,16,0,20,4
1683358224986,TDAC 101,B00,189301,Harting; Carla Kelso,18,0,20,2
1683358226014,TDAC 102,A00,189304,Basso; Beatrice,14,0,20,6
1683358227040,TDAC 108,A00,189305,Staff,18,0,20,2
1683358228070,TDDE 131,A00,189310,Staff,19,0,20,1
1683358228070,TDDE 131,B00,189314,Staff,19,0,20,1
1683358228070,TDDE 131,C00,189315,Staff,48,0,50,2
1683358228070,TDDE 131,D00,189316,Staff,14,0,15,1
1683358228070,TDDE 131,E00,204841,Staff,20,0,20,0
1683358229095,TDGE 10,A00,189289,Staff,30,0,50,20
1683358229095,TDGE 10,B00,189290,Havis; Allan,1,0,50,49
1683358230120,TDGE 11,A00,189291,Fulton; Julia,0,3,50,50
1683358230120,TDGE 11,B00,189292,Staff,20,0,25,5
1683358230120,TDGE 11,C00,260270,Staff,0,0,0,0
1683358231144,TDGE 25,A00,189294,Staff,3,0,20,17
1683358232167,TDGE 124,A00,189318,Fulton; Julia,0,8,50,50
1683358233192,TDGE 125,A00,189319,Staff,13,0,25,12
1683358233192,TDGE 125,B00,189320,Staff,23,0,25,2
1683358234216,TDGE 127,A00,189322,Havis; Allan,0,0,50,50
1683358235241,TDHT 101,A00,189323,Staff,18,0,25,7
1683358235241,TDHT 101,B00,189324,Staff,25,0,25,0
1683358236264,TDHT 102,A00,189325,Staff,49,0,50,1
1683358237288,TDMV 1,A00,189295,Arcidiacono; Kristin,19,0,30,11
1683358237288,TDMV 1,B00,189296,Caligagan; Maria T.,24,0,30,6
1683358238316,TDMV 2,A00,189297,Sammartano; Tonnie,28,0,30,2
1683358238316,TDMV 2,B00,189299,Arcidiacono; Kristin,24,0,30,6
1683358239344,TDMV 3,A00,204998,Rincon; Alicia,22,0,30,8
1683358240371,TDMV 120,A00,189458,Sammartano; Tonnie,28,0,30,2
1683358241394,TDMV 138,A00,189541,Jun; Grace Shin Hae,22,0,40,18
1683358242421,TDMV 142,A00,189717,Caligagan; Tony,23,0,30,7
1683358242421,TDMV 142,B00,189718,Caligagan; Maria T.,25,0,30,5
1683358243447,TMC 2,A01,187533,Staff,25,0,25,0
1683358243447,TMC 2,A02,187534,Staff,25,0,25,0
1683358244471,USP 1,A01,187536,Kwak; Nancy,0,16,25,25
1683358245495,USP 5,A01,187538,Staff,10,0,25,15
1683358246519,USP 101,A00,199253,Staff,0,4,0,0
1683358247547,USP 124,A00,187562,Boomhower; Matthew Charles,1,0,30,29
1683358248574,USP 138,A00,187582,Staff,20,0,25,5
1683358249601,USP 152,A01,187597,Staff,4,0,25,21
1683358250630,USP 153,A00,187598,Staff,19,0,25,6
1683358251655,USP 168,A00,187607,Kwak; Nancy,2,0,5,3
1683358252681,USP 173,A00,187619,Staff,4,0,25,21
1683358253704,USP 181,A00,187638,Staff,0,3,25,25
1683358254728,VIS 103,A00,187650,Cruz; Edwin Teddy,22,0,75,53
1683358255752,VIS 110D,A00,187669,Staff,12,0,22,10
1683358256777,VIS 127C,A00,187720,Shen; Kuiyi,67,0,146,79
1683358257802,VIS 149,A00,187731,Yoldas; Pinar,0,14,22,22
1683358258827,VIS 151,A01,188091,Staff,22,0,34,12
1683358258827,VIS 151,A02,188092,Staff,11,0,34,23
1683358259906,VIS 160B,A00,188093,Stalbaum; Brett,0,0,10,10
1683358261961,WCWP 10B,A00,201720,Staff,10,0,15,5
1683358261961,WCWP 10B,B00,201722,Staff,9,0,15,6
1683358262989,WCWP 100,A00,201725,Gagnon; Jeffrey C,0,0,2,2
1683358262989,WCWP 100,B00,201727,Staff,0,4,15,15
1683358266137,ANBI 133,A00,258401,Wilder; Linnea Lorene,34,0,40,6
1683358267172,ANBI 140,A00,258395,Hrvoj Mihic; Branka,18,0,25,7
1683358268199,ANSC 120,A00,258402,Bialecki; Jon Anthony,27,0,40,13
1683358269227,ANSC 144,A00,258400,Staff,14,0,40,26
1683358271278,ANSC 166,A00,258396,Parish; Steven Martin,157,0,175,18
1683358272306,ANSC 180,A00,193533,Staff,9,0,20,11
1683358273330,ANSC 188,A00,258397,Jassal; Aftab,33,0,40,7
1683358274355,ANTH 3,A01,258316,Staff,23,0,30,7
1683358275378,ANTH 5,A00,258394,Semendeferi; Ekaterini,16,0,20,4
1683358276409,ANTH 21,A01,258331,Staff,8,0,40,32
1683358277436,ANTH 103,A00,258398,Varma; Saiba,15,0,25,10
1683358278463,AWP 10,001,202034,Staff,0,0,0,0
1683358278463,AWP 10,002,202035,Staff,0,0,0,0
1683358278463,AWP 10,003,202036,Staff,0,0,0,0
1683358278463,AWP 10,004,202037,Staff,0,0,0,0
1683358278463,AWP 10,005,202038,Staff,0,0,0,0
1683358278463,AWP 10,006,202039,Staff,0,0,0,0
1683358278463,AWP 10,007,202040,Staff,0,0,0,0
1683358278463,AWP 10,008,202041,Staff,0,0,0,0
1683358278463,AWP 10,009,202042,Staff,0,0,0,0
1683358278463,AWP 10,010,202043,Staff,0,0,0,0
1683358278463,AWP 10,011,202044,Staff,0,0,0,0
1683358278463,AWP 10,012,202045,Staff,0,0,0,0
1683358278463,AWP 10,013,202046,Staff,0,0,0,0
1683358278463,AWP 10,014,202047,Staff,0,0,0,0
1683358278463,AWP 10,015,202048,Staff,0,0,0,0
1683358278463,AWP 10,016,202049,Staff,0,0,0,0
1683358278463,AWP 10,017,202050,Staff,0,0,0,0
1683358278463,AWP 10,018,202051,Staff,0,0,0,0
1683358278463,AWP 10,019,202052,Staff,0,0,0,0
1683358278463,AWP 10,020,202053,Staff,0,0,0,0
1683358278463,AWP 10,021,202054,Staff,0,0,0,0
1683358278463,AWP 10,022,202055,Staff,0,0,0,0
1683358278463,AWP 10,023,202056,Staff,0,0,0,0
1683358278463,AWP 10,024,202057,Staff,0,0,0,0
1683358278463,AWP 10,025,202058,Staff,0,0,0,0
1683358278463,AWP 10,026,202059,Staff,0,0,0,0
1683358279494,AWP 102,001,202032,Staff,0,0,0,0
1683358279494,AWP 102,002,202033,Staff,0,0,0,0
1683358280519,BENG 100,A01,254234,Taylor Amos; Alyssa C,31,0,40,9
1683358281543,BENG 196,001,270013,Engler; Adam J.,9999,0,9999,0
1683358282574,BICD 100R,A01,202018,Smith; Laurie,0,7,32,32
1683358282574,BICD 100R,A02,202019,Smith; Laurie,0,2,32,32
1683358282574,BICD 100R,A03,202020,Smith; Laurie,0,1,32,32
1683358282574,BICD 100R,A04,202021,Smith; Laurie,9,0,32,23
1683358282574,BICD 100R,A05,202022,Smith; Laurie,12,0,32,20
1683358283601,BICD 136,A01,193242,Gustafson-Brown; Cindy,0,2,32,32
1683358283601,BICD 136,A02,193244,Gustafson-Brown; Cindy,14,0,32,18
1683358284627,BIEB 102,A01,193249,Butler; Shannon Rhey,0,2,32,32
1683358284627,BIEB 102,A02,193251,Butler; Shannon Rhey,0,0,32,32
1683358284627,BIEB 102,A03,193253,Butler; Shannon Rhey,0,1,32,32
1683358284627,BIEB 102,A04,193255,Butler; Shannon Rhey,17,0,32,15
1683358284627,BIEB 102,A05,193265,Butler; Shannon Rhey,26,0,32,6
1683358284627,BIEB 102,A06,193269,Butler; Shannon Rhey,16,0,32,16
1683358286675,BIEB 150,A01,193274,Staff,0,0,32,32
1683358286675,BIEB 150,A02,193285,Staff,23,0,32,9
1683358287700,BIEB 194,A00,193286,Kurle; Carolyn M.,22,0,32,10
1683358288733,BILD 1,A01,192291,Staff,16,0,32,16
1683358288733,BILD 1,A02,192292,Staff,30,0,32,2
1683358288733,BILD 1,B01,192520,Reuther; Keefe,0,1,0,0
1683358288733,BILD 1,B02,192532,Reuther; Keefe,0,1,0,0
1683358289765,BILD 3,A01,192556,Butler; Shannon Rhey,0,0,32,32
1683358289765,BILD 3,A02,192581,Butler; Shannon Rhey,4,0,32,28
1683358289765,BILD 3,A03,192611,Butler; Shannon Rhey,23,0,32,9
1683358289765,BILD 3,A04,192612,Butler; Shannon Rhey,25,0,32,7
1683358289765,BILD 3,A05,192613,Butler; Shannon Rhey,27,0,32,5
1683358289765,BILD 3,A06,192679,Butler; Shannon Rhey,27,0,32,5
1683358289765,BILD 3,A07,192682,Butler; Shannon Rhey,22,0,32,10
1683358290790,BILD 4,A01,192836,Reuther; Keefe,0,0,24,24
1683358290790,BILD 4,A02,193044,Reuther; Keefe,4,0,24,20
1683358291817,BILD 10,A01,193142,Gustafson-Brown; Cindy,30,0,32,2
1683358291817,BILD 10,A02,193149,Gustafson-Brown; Cindy,31,0,32,1
1683358292841,BIMM 100,A01,193301,Staff,0,6,32,32
1683358292841,BIMM 100,A02,193312,Staff,0,5,32,32
1683358292841,BIMM 100,A03,193323,Staff,0,8,32,32
1683358293867,BIMM 101,A01,193329,McDonnell; Lisa Marie,0,3,24,24
1683358293867,BIMM 101,A02,193339,McDonnell; Lisa Marie,0,3,24,24
1683358293867,BIMM 101,B01,193354,McDonnell; Lisa Marie,0,3,24,24
1683358293867,BIMM 101,B02,193357,McDonnell; Lisa Marie,0,3,24,24
1683358294892,BIMM 110,A01,193377,Tat; John,0,11,32,32
1683358294892,BIMM 110,A02,193378,Tat; John,0,9,32,32
1683358295917,BIMM 120,A01,206116,Staff,0,0,32,32
1683358295917,BIMM 120,A02,206117,Staff,8,0,32,24
1683358295917,BIMM 120,A03,206121,Staff,21,0,32,11
1683358296946,BIPN 100,A01,193393,Park; Ji Young,0,14,32,32
1683358296946,BIPN 100,A02,193402,Park; Ji Young,0,13,32,32
1683358296946,BIPN 100,A03,193413,Park; Ji Young,0,14,32,32
1683358296946,BIPN 100,A04,193414,Park; Ji Young,0,13,32,32
1683358297974,BIPN 102,A01,193429,Staff,0,0,32,32
1683358297974,BIPN 102,A02,193438,Staff,22,0,32,10
1683358299003,BIPN 106,A01,193450,Reyes Gonzalez; Catalina,0,2,40,40
1683358300032,BIPN 134,A01,193465,Cooke; James Edward,1,0,32,31
1683358300032,BIPN 134,A02,193474,Cooke; James Edward,25,0,32,7
1683358300032,BIPN 134,A03,193485,Cooke; James Edward,29,0,32,3
1683358300032,BIPN 134,A04,193486,Cooke; James Edward,21,0,32,11
1683358300032,BIPN 134,A05,193491,Cooke; James Edward,31,0,32,1
1683358300032,BIPN 134,A06,193501,Cooke; James Edward,30,0,32,2
1683358300032,BIPN 134,A07,193510,Cooke; James Edward,29,0,32,3
1683358302082,BISP 194,A00,222522,Staff,14,0,32,18
1683358303106,CAT 124,A01,202407,Staff,19,0,25,6
1683358304134,CAT 125,A00,202408,Marchisotto; Jennifer Anne,4,0,20,16
1683358305163,CAT 125R,A00,202409,Smith; Lauryn Alissa,0,11,20,20
1683358305163,CAT 125R,B00,202410,Morales; Celeste Georgianna,0,11,20,20
1683358305163,CAT 125R,C00,202411,Irwin; Matthew Joseph,0,10,20,20
1683358306190,CENG 15,A01,204712,Yang; Kesong,0,1,0,0
1683358307217,CENG 114,A00,202070,Jahed Motlagh; Zeinab,5,0,20,15
1683358308242,CGS 105,A00,185477,Wesling; Megan E.,24,0,40,16
1683358309266,CGS 106,A00,185494,Staff,13,0,22,9
1683358310291,CGS 108,A00,185495,Staff,14,0,20,6
1683358311316,CGS 114,A00,185496,Staff,13,0,18,5
1683358312342,CGS 119,A00,185501,Staff,15,0,20,5
1683358313371,CGS 120,A00,185511,Staff,13,0,20,7
1683358314397,CHEM 4,A01,184675,Bussey; Thomas J,96,0,100,4
1683358315422,CHEM 6A,A01,184677,Staff,34,0,60,26
1683358316450,CHEM 6B,A01,184679,Staff,65,0,100,35
1683358317479,CHEM 6C,A01,184681,Bussey; Thomas J,1,0,50,49
1683358317479,CHEM 6C,A02,184682,Bussey; Thomas J,34,0,50,16
1683358318510,CHEM 40A,A01,184684,Albizati; Kim F.,37,0,100,63
1683358319534,CHEM 40B,A01,184686,Albizati; Kim F.,0,20,100,100
1683358320561,CHEM 41B,A01,184690,Staff,52,0,100,48
1683358321587,COGS 3,A01,184715,Boyle; Mary E. T.,0,25,40,40
1683358322614,COGS 14B,A01,185172,Staff,0,15,38,38
1683358323639,COGS 18,A01,184736,Staff,17,0,80,63
1683358324664,COGS 100,A01,184932,Staff,0,5,73,73
1683358325697,COGS 101A,A01,184935,Staff,0,39,30,30
1683358326722,COGS 101B,A01,184944,Staff,0,2,30,30
1683358327747,COGS 101C,A01,184946,Staff,0,12,30,30
1683358328780,COGS 102A,A01,184951,Johnson; Christine M.,2,0,40,38
1683358329809,COGS 107B,A01,184953,Mooshagian; Eric Frederick,0,50,40,40
1683358330838,COGS 118B,A01,184959,Gupta; Anjum,0,48,40,40
1683358331863,COGS 153,A00,184961,Staff,0,15,30,30
1683358332892,COGS 177,A00,184962,Staff,0,20,30,30
1683358333920,COGS 187A,A01,184969,Boyle; Mary E. T.,0,17,40,40
1683358334947,COMM 10,A01,185174,Staff,0,5,25,25
1683358334947,COMM 10,A02,185189,Staff,0,5,25,25
1683358334947,COMM 10,A03,269821,Staff,0,0,0,0
1683358335972,COMM 100B,A01,185475,Staff,0,0,0,2
1683358335972,COMM 100B,A02,185476,Staff,13,0,25,12
1683358337000,COMM 100C,A01,185314,Staff,1,0,25,24
1683358337000,COMM 100C,A02,185327,Staff,19,0,25,6
1683358338028,COMM 110M,A00,185349,Staff,2,0,40,38
1683358339057,COMM 113T,A00,185352,Staff,24,0,40,16
1683358340084,COMM 114I,A00,185353,Staff,33,0,40,7
1683358341109,COMM 131,A00,185354,Staff,19,0,30,11
1683358342135,CSE 8A,A50,185358,Cao; Yingjun,0,46,10,10
1683358343161,CSE 8B,A01,185362,Staff,0,46,50,50
1683358344186,CSE 11,A01,185416,Cao; Yingjun,0,92,10,10
1683358345210,CSE 20,A01,185445,Briones; Jor-el Thomas Caparas,5,0,25,20
1683358346238,CSE 21,A01,185447,Staff,10,0,50,40
1683358347263,CSE 101,A01,185451,Staff,0,13,50,50
1683358347263,CSE 101,B01,185453,Jones; Miles E,0,11,50,50
1683358349316,CSE 141,A01,185458,Eldon; John,20,0,100,80
1683358350341,CSE 141L,A01,185461,Eldon; John,12,0,100,88
1683358351366,CSE 142,A01,185463,Staff,36,0,60,24
1683358351366,CSE 142,B01,201355,Staff,0,7,60,60
1683358352395,CSE 142L,A01,185470,Staff,36,0,60,24
1683358352395,CSE 142L,B01,201417,Staff,0,6,60,60
1683358353419,CSE 190,A00,201433,Staff,32,0,49,17
1683358354448,DOC 1,A01,259136,Strom; Megan C.,7,0,15,8
1683358354448,DOC 1,A02,259137,Strom; Megan C.,14,0,15,1
1683358354448,DOC 1,A03,259138,Strom; Megan C.,14,0,15,1
1683358354448,DOC 1,A04,259139,Strom; Megan C.,14,0,15,1
1683358355478,DOC 100D,A00,259140,Pass; Natalye Joann,16,0,25,9
1683358356507,DSGN 1,A01,184749,Rill; Bryan,0,25,30,30
1683358357533,DSGN 100,A01,185168,Staff,0,2,25,25
1683358358559,ECE 5,A01,185626,Morris; Karcher William,0,10,0,0
1683358359586,ECE 101,A01,185628,Staff,17,0,70,53
1683358360611,ECE 107,A01,185635,Baghdadchi; Saharnaz,0,0,20,20
1683358360611,ECE 107,A02,185638,Baghdadchi; Saharnaz,4,0,20,16
1683358361638,ECE 148,A01,185647,Silberman; Jack,0,0,16,16
1683358362664,ECON 1,A01,185537,Crane; Meredith Helen,54,0,70,16
1683358363747,ECON 3,A01,185549,Crane; Meredith Helen,32,0,70,38
1683358364771,ECON 4,A01,203354,Anderson; John Charles,0,4,10,10
1683358365796,ECON 100A,A01,185574,Staff,0,4,40,40
1683358366825,ECON 100B,A01,185576,Staff,0,12,50,50
1683358367852,ECON 100C,A01,185589,Newhouse; Herbert S,29,0,70,41
1683358368880,ECON 105,A00,185608,Vespa; Emanuel Ignacio,19,0,35,16
1683358369905,ECON 109,A01,185610,Shishkin; Denis,10,0,35,25
1683358370931,ECON 110A,A01,185612,Staff,11,0,40,29
1683358371956,ECON 120A,A01,185615,Staff,20,0,40,20
1683358372982,ECON 120C,A01,185617,Sun; Yixiao,0,21,70,70
1683358374009,ECON 144,A00,203346,Squires; Dale E,3,0,35,32
1683358375038,ECON 171,A01,203349,Newhouse; Herbert S,0,1,35,35
1683358376068,ECON 173A,A01,185621,Toda; Alexis Akira,21,0,35,14
1683358377101,EDS 25,A01,202413,Staff,0,1,0,0
1683358377101,EDS 25,A02,202414,Staff,0,1,0,0
1683358377101,EDS 25,A03,202415,Staff,0,0,0,0
1683358377101,EDS 25,A04,202416,Staff,0,1,0,0
1683358377101,EDS 25,A05,202439,Staff,0,0,0,0
1683358377101,EDS 25,A06,202440,Staff,0,0,0,0
1683358377101,EDS 25,B01,202631,Staff,0,0,0,0
1683358377101,EDS 25,B02,202632,Staff,0,0,0,0
1683358377101,EDS 25,B03,202639,Staff,0,0,0,0
1683358377101,EDS 25,B04,202640,Staff,0,0,0,0
1683358377101,EDS 25,B05,202643,Staff,0,0,0,0
1683358377101,EDS 25,B06,202644,Staff,0,0,0,0
1683358378129,EDS 38,A01,202659,Black; Alison Michelle,24,0,25,1
1683358379158,EDS 115,A00,202652,Staff,18,0,30,12
1683358380182,EDS 125,A00,202649,Staff,14,0,30,16
1683358381209,EDS 126,A01,203332,Staff,30,0,30,0
1683358382234,EDS 139,A00,202838,Staff,16,0,25,9
1683358383272,EDS 146,A01,202655,Staff,14,0,25,11
1683358384304,ENG 15,A00,185667,Staff,0,1,0,0
1683358384304,ENG 15,B00,185672,Staff,0,0,0,0
1683358384304,ENG 15,C00,185675,Staff,0,0,0,0
1683358384304,ENG 15,D00,185682,Staff,0,0,0,0
1683358384304,ENG 15,E00,185684,Staff,0,0,0,0
1683358385329,ETHN 103,A00,185710,Staff,0,4,35,35
1683358386359,ETHN 103A,A00,199228,Man; Simeon S,2,0,9,7
1683358387386,ETHN 109,A00,185711,Staff,18,0,35,17
1683358388415,ETHN 142,A00,185726,Staff,0,4,30,30
1683358389444,ETHN 163J,A00,199229,Man; Simeon S,5,0,8,3
1683358390472,ETHN 168,A00,185727,Staff,8,0,10,2
1683358391499,ETHN 182,A00,185728,Staff,0,0,35,35
1683358392525,ETHN 183,A00,185737,Staff,8,0,18,10
1683358393551,GLBH 111,A01,209361,Burgos; Jose L.,0,0,0,0
1683358395602,HIEU 104,A00,185792,Staff,16,0,20,4
1683358396629,HIEU 115,A00,185800,Staff,1,0,20,19
1683358397654,HIEU 128,A00,185801,Staff,0,7,20,20
1683358398682,HIEU 147,A00,185802,Staff,16,0,20,4
1683358399707,HIEU 154,A00,185823,Staff,12,0,20,8
1683358400732,HILA 102,A00,185826,Staff,13,0,20,7
1683358401759,HILD 2C,A01,185778,Staff,0,12,20,20
1683358402785,HILD 7B,A01,185780,Kwak; Nancy,0,15,32,32
1683358402785,HILD 7B,A02,185781,Kwak; Nancy,0,18,32,32
1683358403814,HILD 30,A01,185791,Staff,14,0,20,6
1683358404844,HISC 119,A00,185830,Golan; Tal,0,9,20,20
1683358405876,HITO 156GS,A00,185831,Patterson; Patrick H.,0,0,0,23
1683358406905,HIUS 103,A00,185832,Man; Simeon S,1,6,20,19
1683358407934,HIUS 117,A00,185836,Kwak; Nancy,2,0,20,18
1683358408960,HIUS 125,A00,185840,Man; Simeon S,0,0,23,23
1683358409988,HIUS 149,A00,185845,Staff,0,0,20,20
1683358411027,HUM 3,A01,185882,Zavodny; Tatiana Sophia,0,7,50,50
1683358411027,HUM 3,B01,185899,Caldwell; Michael Alan,0,18,50,50
1683358412056,HUM 3GS,A00,185900,Patterson; Patrick H.,0,0,0,23
1683358413095,HUM 4,A01,185938,Zroka; Amy Liane,31,0,50,19
1683358413095,HUM 4,B01,185956,Watkins; Eric,0,3,50,50
1683358413095,HUM 4,B02,202209,Watkins; Eric,0,2,50,50
1683358413095,HUM 4,B03,202210,Watkins; Eric,0,2,50,50
1683358414121,HUM 5,A01,185958,West; Geoffrey Scott,3,0,50,47
1683358414121,HUM 5,A02,202215,West; Geoffrey Scott,0,0,50,50
1683358415147,INTL 190,A00,185959,Gagnon; Jeffrey C,0,0,0,9
1683358415147,INTL 190,B00,185960,Lettieri; Michael Joseph,0,0,0,1
1683358416174,JAPN 180,A00,254509,Staff,4,0,30,26
1683358417208,LATI 10,A01,202853,Kennemore; Amy Michelle,4,0,35,31
1683358417208,LATI 10,A02,202854,Kennemore; Amy Michelle,2,0,35,33
1683358417208,LATI 10,A03,270054,Kennemore; Amy Michelle,30,0,30,0
1683358418236,LATI 180,A00,202855,Kennemore; Amy Michelle,11,0,20,9
1683358419265,LAWS 101,A00,201767,Golan; Tal,0,7,40,40
1683358420293,LIFR 1C,A00,185961,Staff,6,0,20,14
1683358421319,LIFR 1CX,A00,185962,Staff,7,0,20,13
1683358422344,LIFR 1D,A00,185963,Staff,9,0,20,11
1683358423371,LIFR 1DX,A00,185964,Staff,9,0,20,11
1683358424395,LIGN 101,A01,186039,Staff,43,0,50,7
1683358425419,LIGN 165,A00,186040,Staff,18,0,50,32
1683358426441,LTCS 108,A00,186041,Staff,6,0,10,4
1683358427467,LTCS 119,A00,186042,Staff,16,0,20,4
1683358428492,LTCS 130,A00,186043,Wesling; Megan E.,15,0,25,10
1683358430542,LTEA 138,A00,186119,Staff,14,0,40,26
1683358431567,LTEN 124,A00,186148,Staff,6,0,25,19
1683358432593,LTEN 178,A00,186149,Staff,7,0,15,8
1683358433622,LTEN 181,A00,186150,Blanco; John D,33,0,40,7
1683358434649,LTWL 120,A00,186160,Staff,20,0,25,5
1683358435675,LTWL 165,A00,186161,Staff,22,0,25,3
1683358436702,LTWR 100,A00,186162,Staff,0,5,15,15
1683358437727,LTWR 102,A00,186163,Doller; Ben,5,0,15,10
1683358438753,MAE 8,A01,186412,Staff,0,0,0,0
1683358439784,MAE 30B,A00,186445,Bahadori; Mohammad Yousef,83,0,100,17
1683358440810,MAE 40,A00,186592,Bewley; Thomas R,10,0,50,40
1683358441839,MAE 101B,A00,186593,Bahadori; Mohammad Yousef,81,0,100,19
1683358442869,MAE 105,A00,186594,Bandaru; Prabhakar,12,0,50,38
1683358443901,MAE 107,A00,186599,Pham; Hieu Tan,0,7,120,120
1683358444926,MAE 148,A01,186660,Silberman; Jack,3,0,16,13
1683358445953,MATH 10A,A01,188095,Staff,0,5,35,35
1683358446980,MATH 10B,A01,188097,Bowers; Adam R.,0,11,30,30
1683358446980,MATH 10B,A02,188099,Bowers; Adam R.,0,11,30,30
1683358446980,MATH 10B,B01,188104,Bowers; Adam R.,0,10,30,30
1683358446980,MATH 10B,B02,188106,Bowers; Adam R.,0,10,30,30
1683358448008,MATH 10C,A01,188111,Staff,0,18,30,30
1683358448008,MATH 10C,A02,188127,Staff,0,17,30,30
1683358448008,MATH 10C,A03,188131,Staff,0,18,30,30
1683358448008,MATH 10C,B01,188218,Staff,18,0,30,12
1683358448008,MATH 10C,B02,188244,Staff,13,0,30,17
1683358448008,MATH 10C,B03,188277,Staff,16,0,30,14
1683358449039,MATH 18,A01,188344,Bach; Quang Tran,18,0,30,12
1683358449039,MATH 18,A02,188345,Bach; Quang Tran,11,0,30,19
1683358449039,MATH 18,B01,188353,Bach; Quang Tran,10,0,30,20
1683358449039,MATH 18,B02,188354,Bach; Quang Tran,20,0,30,10
1683358450070,MATH 20A,A01,188374,Staff,12,0,35,23
1683358451097,MATH 20B,A01,188382,Ohm; Ko Woon,6,0,30,24
1683358451097,MATH 20B,A02,188383,Ohm; Ko Woon,22,0,30,8
1683358451097,MATH 20B,B01,188385,Ohm; Ko Woon,7,0,30,23
1683358451097,MATH 20B,B02,188392,Ohm; Ko Woon,22,0,30,8
1683358452127,MATH 20C,A01,188394,Harel; Guershon,10,0,30,20
1683358452127,MATH 20C,A02,188395,Harel; Guershon,15,0,30,15
1683358452127,MATH 20C,B01,188404,Harel; Guershon,4,0,30,26
1683358452127,MATH 20C,B02,188405,Harel; Guershon,19,0,30,11
1683358453161,MATH 20D,A01,188414,Hammock; Frances H,0,1,30,30
1683358453161,MATH 20D,A02,188415,Hammock; Frances H,3,0,30,27
1683358453161,MATH 20D,B01,188447,Hammock; Frances H,1,0,30,29
1683358453161,MATH 20D,B02,188486,Hammock; Frances H,8,0,30,22
1683358454190,MATH 20E,A01,188649,Staff,21,0,30,9
1683358454190,MATH 20E,A02,188650,Staff,23,0,30,7
1683358454190,MATH 20E,A03,188673,Staff,0,0,30,30
1683358455215,MATH 102,A01,188675,Staff,0,35,35,35
1683358456239,MATH 103B,A01,188681,Staff,3,0,35,32
1683358456239,MATH 103B,B01,188692,Staff,5,0,35,30
1683358457265,MATH 109,A01,188695,Salehi Golsefidy; Alireza,25,0,35,10
1683358457265,MATH 109,A02,188696,Salehi Golsefidy; Alireza,25,0,35,10
1683358458296,MATH 120A,A01,188698,Eggers; John Dietrich,7,0,35,28
1683358459327,MATH 142B,A01,188736,Ioana; Adrian,0,2,30,30
1683358459327,MATH 142B,A02,188741,Ioana; Adrian,0,0,30,30
1683358459327,MATH 142B,A03,188743,Ioana; Adrian,0,1,30,30
1683358460356,MATH 168A,A01,188790,Staff,0,9,35,35
1683358461388,MATH 170A,A01,188803,Nie; Jiawang,0,2,35,35
1683358461388,MATH 170A,A02,188811,Nie; Jiawang,0,0,35,35
1683358461388,MATH 170A,A03,188814,Nie; Jiawang,1,0,35,34
1683358461388,MATH 170A,A04,188815,Nie; Jiawang,13,0,35,22
1683358462411,MATH 193B,A01,188817,Staff,0,0,35,35
1683358462411,MATH 193B,A02,188818,Staff,5,0,35,30
1683358463444,MGT 4,A01,202857,Anderson; John Charles,61,0,80,19
1683358464474,MGT 12,A00,202858,Lindenberger; Wade Douglas,42,0,90,48
1683358465500,MGT 18,A00,202859,Staff,74,0,90,16
1683358466527,MGT 18GS,A00,202860,McKay; Michael J,13,0,28,15
1683358467606,MGT 45,A00,202861,Pecore; Joseph P.,14,0,90,76
1683358468633,MGT 100,A00,202863,Yavorsky; Daniel Ryan,28,0,90,62
1683358469657,MGT 103,A00,202864,Ehrich; Kristine R,0,17,90,90
1683358470685,MGT 112,A00,202865,Ehrich; Kristine R,15,0,90,75
1683358471710,MGT 121A,A00,202868,Staff,0,20,0,0
1683358472736,MGT 131B,A00,202869,Anderson; John Charles,59,0,90,31
1683358473766,MGT 136,A00,202871,Lindenberger; Wade Douglas,84,0,90,6
1683358474791,MGT 164,A00,202873,Staff,0,68,90,91
1683358475818,MGT 164GS,A00,202874,McKay; Mary A,13,0,28,15
1683358476843,MGT 180,A00,202875,Staff,0,50,90,91
1683358477869,MMW 11R,A01,205019,Herbst; Matthew,3,0,30,27
1683358477869,MMW 11R,A02,205026,Herbst; Matthew,29,0,30,1
1683358478896,MMW 15,A01,193512,Chang; Edmond Yi-Teh,0,9,28,28
1683358478896,MMW 15,A02,193513,Chang; Edmond Yi-Teh,0,5,28,28
1683358478896,MMW 15,A03,193514,Chang; Edmond Yi-Teh,0,5,28,28
1683358478896,MMW 15,A04,193515,Chang; Edmond Yi-Teh,0,5,28,28
1683358478896,MMW 15,A05,193516,Chang; Edmond Yi-Teh,0,4,28,28
1683358478896,MMW 15,A06,193517,Chang; Edmond Yi-Teh,0,5,28,28
1683358478896,MMW 15,B01,193519,Chang; Edmond Yi-Teh,0,5,28,28
1683358478896,MMW 15,B02,193520,Chang; Edmond Yi-Teh,0,5,28,28
1683358478896,MMW 15,B03,193521,Chang; Edmond Yi-Teh,0,5,28,28
1683358478896,MMW 15,B04,193522,Chang; Edmond Yi-Teh,0,4,28,28
1683358478896,MMW 15,B05,193523,Chang; Edmond Yi-Teh,0,5,28,28
1683358478896,MMW 15,B06,193524,Chang; Edmond Yi-Teh,0,4,28,28
1683358479927,MMW 122,A01,193526,Rahimi; Babak,0,15,28,28
1683358479927,MMW 122,A02,193527,Rahimi; Babak,0,14,28,28
1683358479927,MMW 122,A03,193528,Rahimi; Babak,0,0,0,0
1683358479927,MMW 122,A04,193529,Rahimi; Babak,0,0,0,0
1683358480953,MUS 1A,A01,186663,Staff,0,20,35,35
1683358481981,MUS 4,A01,186715,Staff,0,12,35,35
1683358483008,MUS 5R,A01,186796,Dubnov; Shlomo,0,17,35,35
1683358484032,MUS 6,A01,186798,Staff,0,4,25,25
1683358485058,MUS 7,A01,186830,Staff,13,0,35,22
1683358486084,MUS 8,A01,186930,Staff,0,26,35,35
1683358487113,MUS 15,A01,186932,Staff,0,16,35,35
1683358487113,MUS 15,B01,186934,Staff,0,15,35,35
1683358488138,MUS 80,A00,186935,Staff,0,0,20,20
1683358488138,MUS 80,B00,186936,Staff,25,0,25,0
1683358489164,NANO 11,A00,204702,Lipomi; Darren John,0,0,0,0
1683358490197,NANO 15,A01,204709,Yang; Kesong,0,1,0,0
1683358491225,NANO 114,A00,202069,Jahed Motlagh; Zeinab,3,0,10,7
1683358492250,PHIL 1,A00,186955,Grush; Rick Scott,32,0,40,8
1683358493276,PHIL 10,A01,186973,Grush; Rick Scott,28,0,35,7
1683358493276,PHIL 10,A02,186974,Grush; Rick Scott,33,0,35,2
1683358494302,PHIL 13,A01,186976,Staff,7,0,35,28
1683358494302,PHIL 13,A02,186977,Staff,16,0,35,19
1683358495326,PHIL 14,A01,186979,Staff,31,0,35,4
1683358495326,PHIL 14,A02,186986,Staff,32,0,35,3
1683358496352,PHIL 28,A01,186988,Staff,16,0,30,14
1683358496352,PHIL 28,A02,186989,Staff,1,0,30,29
1683358496352,PHIL 28,A03,186990,Staff,9,0,30,21
1683358496352,PHIL 28,A04,186991,Staff,26,0,30,4
1683358497376,PHIL 120,A00,186997,Staff,23,0,40,17
1683358498400,PHIL 137,A00,187003,Staff,9,0,40,31
1683358499426,PHIL 150,A00,187015,Staff,47,0,70,23
1683358500456,PHIL 167,A00,187021,Lamey; Andy M.,35,0,40,5
1683358501482,PHIL 174,A01,202226,Staff,17,0,20,3
1683358501482,PHIL 174,A02,202235,Staff,20,0,20,0
1683358502506,PHIL 191A,A00,258918,Staff,0,0,1,1
1683358503535,PHYS 1A,A00,187028,Staff,27,0,60,33
1683358504562,PHYS 1AL,001,187036,Staff,2,0,30,28
1683358504562,PHYS 1AL,002,187049,Staff,18,0,30,12
1683358505589,PHYS 1B,A00,187058,Staff,22,0,60,38
1683358506617,PHYS 1BL,001,187064,Staff,0,0,30,30
1683358506617,PHYS 1BL,002,187070,Staff,5,0,30,25
1683358507645,PHYS 1C,A00,187082,Staff,31,0,120,89
1683358508675,PHYS 1CL,001,187088,Staff,0,9,30,30
1683358508675,PHYS 1CL,002,187089,Staff,0,2,30,30
1683358508675,PHYS 1CL,009,262693,Staff,11,0,30,19
1683358509700,PHYS 2B,A01,187097,Staff,54,0,115,61
1683358510726,PHYS 2C,A01,187099,Staff,67,0,115,48
1683358511751,PHYS 2CL,A01,187101,Staff,5,0,28,23
1683358511751,PHYS 2CL,A02,187102,Staff,15,0,28,13
1683358512776,PHYS 2D,A01,187123,Shotwell; Brian,95,0,115,20
1683358513806,PHYS 4B,A01,187133,Grinstein; Benjamin,35,0,50,15
1683358514835,POLI 10,A00,188819,Staff,0,4,50,50
1683358515859,POLI 11,A00,188827,Staff,43,0,50,7
1683358516886,POLI 13R,A00,188828,Staff,0,1,20,20
1683358517913,POLI 27,A01,188830,Elgin; Samuel Zincke,0,1,70,70
1683358518942,POLI 30,A00,188832,Desposato; Scott,31,0,50,19
1683358519970,POLI 102F,A00,188834,Staff,3,0,40,37
1683358520995,POLI 104A,A00,188852,Staff,14,0,30,16
1683358522020,POLI 104I,A00,188853,Staff,0,6,20,20
1683358523045,POLI 110B,A00,188854,Wiens; David,7,0,20,13
1683358524069,POLI 112A,A00,188855,Wiens; David,5,0,30,25
1683358525094,POLI 117R,A00,188856,Forman; Fonna,0,11,20,20
1683358526122,POLI 118,A00,188857,Ingham; Sean,8,0,20,12
1683358527150,POLI 120G,A00,188858,Staff,9,0,30,21
1683358528174,POLI 131CR,A00,188863,Hoston; Germaine,23,0,50,27
1683358529204,POLI 133,A00,188864,Nellis; Gareth Hb,44,0,50,6
1683358530230,POLI 134D,A00,188865,Desposato; Scott,27,0,30,3
1683358531255,POLI 142A,A00,188871,Gartzke; Erik,22,0,50,28
1683358532278,POLI 142K,A00,188874,Staff,38,0,50,12
1683358533307,POLI 143,A00,188940,Gartzke; Erik,16,0,30,14
1683358534335,POLI 153,A00,188943,Staff,3,0,20,17
1683358535362,POLI 160AA,A00,188944,Staff,11,0,40,29
1683358536388,POLI 170A,A00,188945,Staff,11,0,30,19
1683358538437,PSYC 1,A00,188952,Staff,37,0,90,53
1683358539462,PSYC 2,B00,188953,Staff,19,0,35,16
1683358540485,PSYC 6,A00,188970,Staff,47,0,60,13
1683358541510,PSYC 7,A00,188973,Staff,37,0,45,8
1683358542543,PSYC 60,A01,188980,Rickard; Timothy C.,43,0,60,17
1683358543572,PSYC 70,A01,189001,Steiner; Eric Tomas,23,0,45,22
1683358544596,PSYC 100,A00,189005,Lacefield; Katharine I,0,98,120,120
1683358545621,PSYC 102,A00,189008,Staff,9,0,30,21
1683358546645,PSYC 106,B00,189026,Gorman; Michael R.,34,0,60,26
1683358547671,PSYC 114,B01,189033,Winkielman; Piotr,0,32,30,30
1683358548695,PSYC 131,A00,189036,Anagnostaras; Stephan,0,43,60,60
1683358549718,PSYC 136,A00,189041,Lowe; Angela Beth,0,7,25,25
1683358550742,PSYC 137,A00,189057,Winkielman; Piotr,0,34,25,25
1683358551766,PSYC 144,A00,189107,Wixted; John T,0,7,50,50
1683358553819,PSYC 162,A00,189142,Staff,0,8,85,85
1683358554844,PSYC 172,A00,189144,Gorman; Michael R.,0,7,30,30
1683358556899,PSYC 179,A00,189146,Lacefield; Katharine I,0,84,120,120
1683358557923,PSYC 181,A00,189147,Anagnostaras; Stephan,0,44,90,90
1683358558949,PSYC 190R,A00,189148,Barner; David A.,0,22,80,80
1683358559975,PSYC 191,A00,189275,Rickard; Timothy C.,0,7,25,25
1683358561005,PSYC 193,A00,189276,Chapman; Eddie Nathaniel,0,1,0,4
1683358562036,PSYC 193L,A01,189281,Lowe; Angela Beth,12,0,20,8
1683358562036,PSYC 193L,B01,189285,Staff,28,0,35,7
1683358563062,RELI 149,A00,187137,Rahimi; Babak,7,0,40,33
1683358564091,SE 9,A01,187315,Staff,0,2,18,18
1683358565119,SE 101B,A00,187409,Staff,24,0,30,6
1683358566148,SE 110B,A00,187444,Staff,10,0,40,30
1683358567173,SE 130B,A00,187449,Staff,31,0,40,9
1683358568198,SE 150A,A00,187516,Staff,9,0,20,11
1683358569222,SE 154,A00,187528,Staff,30,0,50,20
1683358570250,SIO 3,A01,258171,Staff,35,0,40,5
1683358571334,SIO 10,A00,187144,Cook; Geoffrey W,0,3,75,75
1683358572363,SIO 45,A00,187152,Cook; Geoffrey W,1,0,100,99
1683358573388,SIO 109R,A00,194486,Staff,0,3,20,20
1683358575437,SIO 187,A01,187233,Kacev; David,12,0,40,28
1683358576469,SOCI 1,A01,258656,Thorpe; Charles Robert,28,0,30,2
1683358576469,SOCI 1,A02,258658,Thorpe; Charles Robert,30,0,30,0
1683358576469,SOCI 1,A03,258661,Thorpe; Charles Robert,25,0,25,0
1683358576469,SOCI 1,A04,258666,Thorpe; Charles Robert,22,0,25,3
1683358576469,SOCI 1,A05,258897,Thorpe; Charles Robert,23,0,25,2
1683358576469,SOCI 1,A06,258898,Thorpe; Charles Robert,25,0,25,0
1683358577499,SOCI 30,A01,258903,Pardo Guerra; Juan Pablo,15,0,30,15
1683358578527,SOCI 102,A00,258904,Staff,9,0,25,16
1683358579555,SOCI 106,A00,258905,Staff,19,0,25,6
1683358580584,SOCI 111,A00,258907,Ribas Norris; Janet Vanesa,26,0,30,4
1683358581610,SOCI 121R,A00,258908,Pardo Guerra; Juan Pablo,10,0,30,20
1683358582640,SOCI 126,A01,203330,Staff,14,0,20,6
1683358583665,SOCI 131,A00,258909,Thorpe; Charles Robert,31,0,60,29
1683358584692,SOCI 135,A00,258910,Payne; Christine Anna,0,9,30,30
1683358585717,SOCI 157,A00,258911,Staff,12,0,30,18
1683358586740,SOCI 184,A00,258912,Staff,25,0,30,5
1683358587764,SOCI 188D,A00,258913,Staff,22,0,30,8
1683358588794,SYN 2,001,187529,Staff,10,0,16,6
1683358588794,SYN 2,002,201452,Staff,0,18,16,16
1683358588794,SYN 2,003,201469,Staff,3,0,16,13
1683358589818,SYN 100,A01,187531,Staff,0,9,20,20
1683358589818,SYN 100,B01,201491,Staff,0,12,20,20
1683358590843,TDAC 1,A00,189286,Walsh; Kim C.,3,0,20,17
1683358590843,TDAC 1,B00,189287,Harting; Carla Kelso,11,0,20,9
1683358591867,TDAC 101,A00,189300,Walsh; Kim C.,16,0,20,4
1683358591867,TDAC 101,B00,189301,Harting; Carla Kelso,18,0,20,2
1683358592896,TDAC 102,A00,189304,Basso; Beatrice,14,0,20,6
1683358593923,TDAC 108,A00,189305,Staff,18,0,20,2
1683358594988,TDDE 131,A00,189310,Staff,19,0,20,1
1683358594988,TDDE 131,B00,189314,Staff,19,0,20,1
1683358594988,TDDE 131,C00,189315,Staff,48,0,50,2
1683358594988,TDDE 131,D00,189316,Staff,14,0,15,1
1683358594988,TDDE 131,E00,204841,Staff,20,0,20,0
1683358596017,TDGE 10,A00,189289,Staff,30,0,50,20
1683358596017,TDGE 10,B00,189290,Havis; Allan,1,0,50,49
1683358597044,TDGE 11,A00,189291,Fulton; Julia,0,3,50,50
1683358597044,TDGE 11,B00,189292,Staff,20,0,25,5
1683358597044,TDGE 11,C00,260270,Staff,0,0,0,0
1683358598068,TDGE 25,A00,189294,Staff,3,0,20,17
1683358599093,TDGE 124,A00,189318,Fulton; Julia,0,8,50,50
1683358600121,TDGE 125,A00,189319,Staff,13,0,25,12
1683358600121,TDGE 125,B00,189320,Staff,23,0,25,2
1683358601147,TDGE 127,A00,189322,Havis; Allan,0,0,50,50
1683358602172,TDHT 101,A00,189323,Staff,18,0,25,7
1683358602172,TDHT 101,B00,189324,Staff,25,0,25,0
1683358603198,TDHT 102,A00,189325,Staff,49,0,50,1
1683358604227,TDMV 1,A00,189295,Arcidiacono; Kristin,19,0,30,11
1683358604227,TDMV 1,B00,189296,Caligagan; Maria T.,24,0,30,6
1683358605255,TDMV 2,A00,189297,Sammartano; Tonnie,28,0,30,2
1683358605255,TDMV 2,B00,189299,Arcidiacono; Kristin,24,0,30,6
1683358606282,TDMV 3,A00,204998,Rincon; Alicia,22,0,30,8
1683358607311,TDMV 120,A00,189458,Sammartano; Tonnie,28,0,30,2
1683358608337,TDMV 138,A00,189541,Jun; Grace Shin Hae,22,0,40,18
1683358609367,TDMV 142,A00,189717,Caligagan; Tony,23,0,30,7
1683358609367,TDMV 142,B00,189718,Caligagan; Maria T.,25,0,30,5
1683358610392,TMC 2,A01,187533,Staff,25,0,25,0
1683358610392,TMC 2,A02,187534,Staff,25,0,25,0
1683358611418,USP 1,A01,187536,Kwak; Nancy,0,16,25,25
1683358612443,USP 5,A01,187538,Staff,10,0,25,15
1683358613471,USP 101,A00,199253,Staff,0,4,0,0
1683358614500,USP 124,A00,187562,Boomhower; Matthew Charles,1,0,30,29
1683358615542,USP 138,A00,187582,Staff,20,0,25,5
1683358616566,USP 152,A01,187597,Staff,4,0,25,21
1683358617590,USP 153,A00,187598,Staff,19,0,25,6
1683358618617,USP 168,A00,187607,Kwak; Nancy,2,0,5,3
1683358619642,USP 173,A00,187619,Staff,4,0,25,21
1683358620669,USP 181,A00,187638,Staff,0,3,25,25
1683358621700,VIS 103,A00,187650,Cruz; Edwin Teddy,22,0,75,53
1683358622727,VIS 110D,A00,187669,Staff,12,0,22,10
1683358623754,VIS 127C,A00,187720,Shen; Kuiyi,67,0,146,79
1683358624779,VIS 149,A00,187731,Yoldas; Pinar,0,14,22,22
1683358625809,VIS 151,A01,188091,Staff,22,0,34,12
1683358625809,VIS 151,A02,188092,Staff,11,0,34,23
1683358626840,VIS 160B,A00,188093,Stalbaum; Brett,0,0,10,10
1683358628891,WCWP 10B,A00,201720,Staff,10,0,15,5
1683358628891,WCWP 10B,B00,201722,Staff,9,0,15,6
1683358629920,WCWP 100,A00,201725,Gagnon; Jeffrey C,0,0,2,2
1683358629920,WCWP 100,B00,201727,Staff,0,4,15,15
1683358633138,ANBI 133,A00,258401,Wilder; Linnea Lorene,34,0,40,6
1683358634164,ANBI 140,A00,258395,Hrvoj Mihic; Branka,18,0,25,7
1683358635190,ANSC 120,A00,258402,Bialecki; Jon Anthony,27,0,40,13
1683358636217,ANSC 144,A00,258400,Staff,14,0,40,26
1683358638271,ANSC 166,A00,258396,Parish; Steven Martin,157,0,175,18
1683358639299,ANSC 180,A00,193533,Staff,9,0,20,11
1683358640323,ANSC 188,A00,258397,Jassal; Aftab,33,0,40,7
1683358641351,ANTH 3,A01,258316,Staff,23,0,30,7
1683358642379,ANTH 5,A00,258394,Semendeferi; Ekaterini,16,0,20,4
1683358643407,ANTH 21,A01,258331,Staff,8,0,40,32
1683358644433,ANTH 103,A00,258398,Varma; Saiba,15,0,25,10
1683358645470,AWP 10,001,202034,Staff,0,0,0,0
1683358645470,AWP 10,002,202035,Staff,0,0,0,0
1683358645470,AWP 10,003,202036,Staff,0,0,0,0
1683358645470,AWP 10,004,202037,Staff,0,0,0,0
1683358645470,AWP 10,005,202038,Staff,0,0,0,0
1683358645470,AWP 10,006,202039,Staff,0,0,0,0
1683358645470,AWP 10,007,202040,Staff,0,0,0,0
1683358645470,AWP 10,008,202041,Staff,0,0,0,0
1683358645470,AWP 10,009,202042,Staff,0,0,0,0
1683358645470,AWP 10,010,202043,Staff,0,0,0,0
1683358645470,AWP 10,011,202044,Staff,0,0,0,0
1683358645470,AWP 10,012,202045,Staff,0,0,0,0
1683358645470,AWP 10,013,202046,Staff,0,0,0,0
1683358645470,AWP 10,014,202047,Staff,0,0,0,0
1683358645470,AWP 10,015,202048,Staff,0,0,0,0
1683358645470,AWP 10,016,202049,Staff,0,0,0,0
1683358645470,AWP 10,017,202050,Staff,0,0,0,0
1683358645470,AWP 10,018,202051,Staff,0,0,0,0
1683358645470,AWP 10,019,202052,Staff,0,0,0,0
1683358645470,AWP 10,020,202053,Staff,0,0,0,0
1683358645470,AWP 10,021,202054,Staff,0,0,0,0
1683358645470,AWP 10,022,202055,Staff,0,0,0,0
1683358645470,AWP 10,023,202056,Staff,0,0,0,0
1683358645470,AWP 10,024,202057,Staff,0,0,0,0
1683358645470,AWP 10,025,202058,Staff,0,0,0,0
1683358645470,AWP 10,026,202059,Staff,0,0,0,0
1683358646494,AWP 102,001,202032,Staff,0,0,0,0
1683358646494,AWP 102,002,202033,Staff,0,0,0,0
1683358647526,BENG 100,A01,254234,Taylor Amos; Alyssa C,31,0,40,9
1683358648552,BENG 196,001,270013,Engler; Adam J.,9999,0,9999,0
1683358649580,BICD 100R,A01,202018,Smith; Laurie,0,7,32,32
1683358649580,BICD 100R,A02,202019,Smith; Laurie,0,2,32,32
1683358649580,BICD 100R,A03,202020,Smith; Laurie,0,1,32,32
1683358649580,BICD 100R,A04,202021,Smith; Laurie,9,0,32,23
1683358649580,BICD 100R,A05,202022,Smith; Laurie,12,0,32,20
1683358650608,BICD 136,A01,193242,Gustafson-Brown; Cindy,0,2,32,32
1683358650608,BICD 136,A02,193244,Gustafson-Brown; Cindy,14,0,32,18
1683358651637,BIEB 102,A01,193249,Butler; Shannon Rhey,0,2,32,32
1683358651637,BIEB 102,A02,193251,Butler; Shannon Rhey,0,0,32,32
1683358651637,BIEB 102,A03,193253,Butler; Shannon Rhey,0,1,32,32
1683358651637,BIEB 102,A04,193255,Butler; Shannon Rhey,17,0,32,15
1683358651637,BIEB 102,A05,193265,Butler; Shannon Rhey,26,0,32,6
1683358651637,BIEB 102,A06,193269,Butler; Shannon Rhey,16,0,32,16
1683358653687,BIEB 150,A01,193274,Staff,0,0,32,32
1683358653687,BIEB 150,A02,193285,Staff,23,0,32,9
1683358654718,BIEB 194,A00,193286,Kurle; Carolyn M.,22,0,32,10
1683358655752,BILD 1,A01,192291,Staff,16,0,32,16
1683358655752,BILD 1,A02,192292,Staff,30,0,32,2
1683358655752,BILD 1,B01,192520,Reuther; Keefe,0,1,0,0
1683358655752,BILD 1,B02,192532,Reuther; Keefe,0,1,0,0
1683358656777,BILD 3,A01,192556,Butler; Shannon Rhey,0,0,32,32
1683358656777,BILD 3,A02,192581,Butler; Shannon Rhey,4,0,32,28
1683358656777,BILD 3,A03,192611,Butler; Shannon Rhey,23,0,32,9
1683358656777,BILD 3,A04,192612,Butler; Shannon Rhey,25,0,32,7
1683358656777,BILD 3,A05,192613,Butler; Shannon Rhey,27,0,32,5
1683358656777,BILD 3,A06,192679,Butler; Shannon Rhey,27,0,32,5
1683358656777,BILD 3,A07,192682,Butler; Shannon Rhey,22,0,32,10
1683358657808,BILD 4,A01,192836,Reuther; Keefe,0,0,24,24
1683358657808,BILD 4,A02,193044,Reuther; Keefe,4,0,24,20
1683358658834,BILD 10,A01,193142,Gustafson-Brown; Cindy,30,0,32,2
1683358658834,BILD 10,A02,193149,Gustafson-Brown; Cindy,31,0,32,1
1683358659859,BIMM 100,A01,193301,Staff,0,6,32,32
1683358659859,BIMM 100,A02,193312,Staff,0,5,32,32
1683358659859,BIMM 100,A03,193323,Staff,0,8,32,32
1683358660886,BIMM 101,A01,193329,McDonnell; Lisa Marie,0,3,24,24
1683358660886,BIMM 101,A02,193339,McDonnell; Lisa Marie,0,3,24,24
1683358660886,BIMM 101,B01,193354,McDonnell; Lisa Marie,0,3,24,24
1683358660886,BIMM 101,B02,193357,McDonnell; Lisa Marie,0,3,24,24
1683358661926,BIMM 110,A01,193377,Tat; John,0,11,32,32
1683358661926,BIMM 110,A02,193378,Tat; John,0,9,32,32
1683358662953,BIMM 120,A01,206116,Staff,0,0,32,32
1683358662953,BIMM 120,A02,206117,Staff,8,0,32,24
1683358662953,BIMM 120,A03,206121,Staff,21,0,32,11
1683358663985,BIPN 100,A01,193393,Park; Ji Young,0,14,32,32
1683358663985,BIPN 100,A02,193402,Park; Ji Young,0,13,32,32
1683358663985,BIPN 100,A03,193413,Park; Ji Young,0,14,32,32
1683358663985,BIPN 100,A04,193414,Park; Ji Young,0,13,32,32
1683358665010,BIPN 102,A01,193429,Staff,0,0,32,32
1683358665010,BIPN 102,A02,193438,Staff,22,0,32,10
1683358666040,BIPN 106,A01,193450,Reyes Gonzalez; Catalina,0,2,40,40
1683358667073,BIPN 134,A01,193465,Cooke; James Edward,1,0,32,31
1683358667073,BIPN 134,A02,193474,Cooke; James Edward,25,0,32,7
1683358667073,BIPN 134,A03,193485,Cooke; James Edward,29,0,32,3
1683358667073,BIPN 134,A04,193486,Cooke; James Edward,21,0,32,11
1683358667073,BIPN 134,A05,193491,Cooke; James Edward,31,0,32,1
1683358667073,BIPN 134,A06,193501,Cooke; James Edward,30,0,32,2
1683358667073,BIPN 134,A07,193510,Cooke; James Edward,29,0,32,3
1683358669127,BISP 194,A00,222522,Staff,14,0,32,18
1683358670155,CAT 124,A01,202407,Staff,19,0,25,6
1683358671185,CAT 125,A00,202408,Marchisotto; Jennifer Anne,4,0,20,16
1683358672213,CAT 125R,A00,202409,Smith; Lauryn Alissa,0,11,20,20
1683358672213,CAT 125R,B00,202410,Morales; Celeste Georgianna,0,11,20,20
1683358672213,CAT 125R,C00,202411,Irwin; Matthew Joseph,0,10,20,20
1683358673243,CENG 15,A01,204712,Yang; Kesong,0,1,0,0
1683358674270,CENG 114,A00,202070,Jahed Motlagh; Zeinab,5,0,20,15
1683358675356,CGS 105,A00,185477,Wesling; Megan E.,24,0,40,16
1683358676382,CGS 106,A00,185494,Staff,13,0,22,9
1683358677408,CGS 108,A00,185495,Staff,14,0,20,6
1683358678433,CGS 114,A00,185496,Staff,13,0,18,5
1683358679458,CGS 119,A00,185501,Staff,15,0,20,5
1683358680481,CGS 120,A00,185511,Staff,13,0,20,7
1683358681521,CHEM 4,A01,184675,Bussey; Thomas J,96,0,100,4
1683358682546,CHEM 6A,A01,184677,Staff,34,0,60,26
1683358683571,CHEM 6B,A01,184679,Staff,65,0,100,35
1683358684595,CHEM 6C,A01,184681,Bussey; Thomas J,1,0,50,49
1683358684595,CHEM 6C,A02,184682,Bussey; Thomas J,34,0,50,16
1683358685627,CHEM 40A,A01,184684,Albizati; Kim F.,37,0,100,63
1683358686652,CHEM 40B,A01,184686,Albizati; Kim F.,0,20,100,100
1683358687677,CHEM 41B,A01,184690,Staff,52,0,100,48
1683358688708,COGS 3,A01,184715,Boyle; Mary E. T.,0,25,40,40
1683358689738,COGS 14B,A01,185172,Staff,0,15,38,38
1683358690763,COGS 18,A01,184736,Staff,17,0,80,63
1683358691791,COGS 100,A01,184932,Staff,0,5,73,73
1683358692816,COGS 101A,A01,184935,Staff,0,39,30,30
1683358693841,COGS 101B,A01,184944,Staff,0,2,30,30
1683358694869,COGS 101C,A01,184946,Staff,0,12,30,30
1683358695895,COGS 102A,A01,184951,Johnson; Christine M.,2,0,40,38
1683358696920,COGS 107B,A01,184953,Mooshagian; Eric Frederick,0,50,40,40
1683358697944,COGS 118B,A01,184959,Gupta; Anjum,0,48,40,40
1683358698970,COGS 153,A00,184961,Staff,0,15,30,30
1683358699998,COGS 177,A00,184962,Staff,0,20,30,30
1683358701023,COGS 187A,A01,184969,Boyle; Mary E. T.,0,17,40,40
1683358702055,COMM 10,A01,185174,Staff,0,5,25,25
1683358702055,COMM 10,A02,185189,Staff,0,5,25,25
1683358702055,COMM 10,A03,269821,Staff,0,0,0,0
1683358703082,COMM 100B,A01,185475,Staff,0,0,0,2
1683358703082,COMM 100B,A02,185476,Staff,13,0,25,12
1683358704107,COMM 100C,A01,185314,Staff,1,0,25,24
1683358704107,COMM 100C,A02,185327,Staff,19,0,25,6
1683358705132,COMM 110M,A00,185349,Staff,2,0,40,38
1683358706159,COMM 113T,A00,185352,Staff,24,0,40,16
1683358707186,COMM 114I,A00,185353,Staff,33,0,40,7
1683358708212,COMM 131,A00,185354,Staff,19,0,30,11
1683358709239,CSE 8A,A50,185358,Cao; Yingjun,0,46,10,10
1683358710267,CSE 8B,A01,185362,Staff,0,46,50,50
1683358711296,CSE 11,A01,185416,Cao; Yingjun,0,92,10,10
1683358712322,CSE 20,A01,185445,Briones; Jor-el Thomas Caparas,5,0,25,20
1683358713347,CSE 21,A01,185447,Staff,10,0,50,40
1683358714380,CSE 101,A01,185451,Staff,0,13,50,50
1683358714380,CSE 101,B01,185453,Jones; Miles E,0,11,50,50
1683358716435,CSE 141,A01,185458,Eldon; John,20,0,100,80
1683358717460,CSE 141L,A01,185461,Eldon; John,12,0,100,88
1683358718490,CSE 142,A01,185463,Staff,36,0,60,24
1683358718490,CSE 142,B01,201355,Staff,0,7,60,60
1683358719521,CSE 142L,A01,185470,Staff,36,0,60,24
1683358719521,CSE 142L,B01,201417,Staff,0,6,60,60
1683358720548,CSE 190,A00,201433,Staff,32,0,49,17
1683358721583,DOC 1,A01,259136,Strom; Megan C.,7,0,15,8
1683358721583,DOC 1,A02,259137,Strom; Megan C.,14,0,15,1
1683358721583,DOC 1,A03,259138,Strom; Megan C.,14,0,15,1
1683358721583,DOC 1,A04,259139,Strom; Megan C.,14,0,15,1
1683358722608,DOC 100D,A00,259140,Pass; Natalye Joann,16,0,25,9
1683358723633,DSGN 1,A01,184749,Rill; Bryan,0,25,30,30
1683358724658,DSGN 100,A01,185168,Staff,0,2,25,25
1683358725684,ECE 5,A01,185626,Morris; Karcher William,0,10,0,0
1683358726707,ECE 101,A01,185628,Staff,17,0,70,53
1683358727733,ECE 107,A01,185635,Baghdadchi; Saharnaz,0,0,20,20
1683358727733,ECE 107,A02,185638,Baghdadchi; Saharnaz,4,0,20,16
1683358728762,ECE 148,A01,185647,Silberman; Jack,0,0,16,16
1683358729791,ECON 1,A01,185537,Crane; Meredith Helen,54,0,70,16
1683358730821,ECON 3,A01,185549,Crane; Meredith Helen,32,0,70,38
1683358731851,ECON 4,A01,203354,Anderson; John Charles,0,4,10,10
1683358732880,ECON 100A,A01,185574,Staff,0,4,40,40
1683358733907,ECON 100B,A01,185576,Staff,0,12,50,50
1683358734936,ECON 100C,A01,185589,Newhouse; Herbert S,29,0,70,41
1683358735962,ECON 105,A00,185608,Vespa; Emanuel Ignacio,19,0,35,16
1683358736991,ECON 109,A01,185610,Shishkin; Denis,10,0,35,25
1683358738015,ECON 110A,A01,185612,Staff,11,0,40,29
1683358739039,ECON 120A,A01,185615,Staff,20,0,40,20
1683358740065,ECON 120C,A01,185617,Sun; Yixiao,0,21,70,70
1683358741123,ECON 144,A00,203346,Squires; Dale E,3,0,35,32
1683358742149,ECON 171,A01,203349,Newhouse; Herbert S,0,1,35,35
1683358743174,ECON 173A,A01,185621,Toda; Alexis Akira,21,0,35,14
1683358744210,EDS 25,A01,202413,Staff,0,1,0,0
1683358744210,EDS 25,A02,202414,Staff,0,1,0,0
1683358744210,EDS 25,A03,202415,Staff,0,0,0,0
1683358744210,EDS 25,A04,202416,Staff,0,1,0,0
1683358744210,EDS 25,A05,202439,Staff,0,0,0,0
1683358744210,EDS 25,A06,202440,Staff,0,0,0,0
1683358744210,EDS 25,B01,202631,Staff,0,0,0,0
1683358744210,EDS 25,B02,202632,Staff,0,0,0,0
1683358744210,EDS 25,B03,202639,Staff,0,0,0,0
1683358744210,EDS 25,B04,202640,Staff,0,0,0,0
1683358744210,EDS 25,B05,202643,Staff,0,0,0,0
1683358744210,EDS 25,B06,202644,Staff,0,0,0,0
1683358745239,EDS 38,A01,202659,Black; Alison Michelle,24,0,25,1
1683358746265,EDS 115,A00,202652,Staff,18,0,30,12
1683358747292,EDS 125,A00,202649,Staff,14,0,30,16
1683358748322,EDS 126,A01,203332,Staff,30,0,30,0
1683358749346,EDS 139,A00,202838,Staff,16,0,25,9
1683358750375,EDS 146,A01,202655,Staff,14,0,25,11
1683358751401,ENG 15,A00,185667,Staff,0,1,0,0
1683358751401,ENG 15,B00,185672,Staff,0,0,0,0
1683358751401,ENG 15,C00,185675,Staff,0,0,0,0
1683358751401,ENG 15,D00,185682,Staff,0,0,0,0
1683358751401,ENG 15,E00,185684,Staff,0,0,0,0
1683358752427,ETHN 103,A00,185710,Staff,0,4,35,35
1683358753452,ETHN 103A,A00,199228,Man; Simeon S,2,0,9,7
1683358754481,ETHN 109,A00,185711,Staff,18,0,35,17
1683358755506,ETHN 142,A00,185726,Staff,0,4,30,30
1683358756534,ETHN 163J,A00,199229,Man; Simeon S,5,0,8,3
1683358757559,ETHN 168,A00,185727,Staff,8,0,10,2
1683358758587,ETHN 182,A00,185728,Staff,0,0,35,35
1683358759611,ETHN 183,A00,185737,Staff,8,0,18,10
1683358760641,GLBH 111,A01,209361,Burgos; Jose L.,0,0,0,0
1683358762693,HIEU 104,A00,185792,Staff,16,0,20,4
1683358763718,HIEU 115,A00,185800,Staff,1,0,20,19
1683358764747,HIEU 128,A00,185801,Staff,0,7,20,20
1683358765772,HIEU 147,A00,185802,Staff,16,0,20,4
1683358766797,HIEU 154,A00,185823,Staff,12,0,20,8
1683358767825,HILA 102,A00,185826,Staff,13,0,20,7
1683358768851,HILD 2C,A01,185778,Staff,0,12,20,20
1683358769876,HILD 7B,A01,185780,Kwak; Nancy,0,15,32,32
1683358769876,HILD 7B,A02,185781,Kwak; Nancy,0,18,32,32
1683358770906,HILD 30,A01,185791,Staff,14,0,20,6
1683358771937,HISC 119,A00,185830,Golan; Tal,0,9,20,20
1683358772962,HITO 156GS,A00,185831,Patterson; Patrick H.,0,0,0,23
1683358773986,HIUS 103,A00,185832,Man; Simeon S,1,6,20,19
1683358775014,HIUS 117,A00,185836,Kwak; Nancy,2,0,20,18
1683358776039,HIUS 125,A00,185840,Man; Simeon S,0,0,23,23
1683358777065,HIUS 149,A00,185845,Staff,0,0,20,20
1683358778091,HUM 3,A01,185882,Zavodny; Tatiana Sophia,0,7,50,50
1683358778091,HUM 3,B01,185899,Caldwell; Michael Alan,0,18,50,50
1683358779190,HUM 3GS,A00,185900,Patterson; Patrick H.,0,0,0,23
1683358780221,HUM 4,A01,185938,Zroka; Amy Liane,31,0,50,19
1683358780221,HUM 4,B01,185956,Watkins; Eric,0,3,50,50
1683358780221,HUM 4,B02,202209,Watkins; Eric,0,2,50,50
1683358780221,HUM 4,B03,202210,Watkins; Eric,0,2,50,50
1683358781248,HUM 5,A01,185958,West; Geoffrey Scott,3,0,50,47
1683358781248,HUM 5,A02,202215,West; Geoffrey Scott,0,0,50,50
1683358782273,INTL 190,A00,185959,Gagnon; Jeffrey C,0,0,0,9
1683358782273,INTL 190,B00,185960,Lettieri; Michael Joseph,0,0,0,1
1683358783302,JAPN 180,A00,254509,Staff,4,0,30,26
1683358784328,LATI 10,A01,202853,Kennemore; Amy Michelle,4,0,35,31
1683358784328,LATI 10,A02,202854,Kennemore; Amy Michelle,2,0,35,33
1683358784328,LATI 10,A03,270054,Kennemore; Amy Michelle,30,0,30,0
1683358785357,LATI 180,A00,202855,Kennemore; Amy Michelle,11,0,20,9
1683358786384,LAWS 101,A00,201767,Golan; Tal,0,7,40,40
1683358787414,LIFR 1C,A00,185961,Staff,6,0,20,14
1683358788440,LIFR 1CX,A00,185962,Staff,7,0,20,13
1683358789465,LIFR 1D,A00,185963,Staff,9,0,20,11
1683358790496,LIFR 1DX,A00,185964,Staff,9,0,20,11
1683358791525,LIGN 101,A01,186039,Staff,43,0,50,7
1683358792553,LIGN 165,A00,186040,Staff,18,0,50,32
1683358793577,LTCS 108,A00,186041,Staff,6,0,10,4
1683358794605,LTCS 119,A00,186042,Staff,16,0,20,4
1683358795635,LTCS 130,A00,186043,Wesling; Megan E.,15,0,25,10
1683358797686,LTEA 138,A00,186119,Staff,14,0,40,26
1683358798715,LTEN 124,A00,186148,Staff,6,0,25,19
1683358799743,LTEN 178,A00,186149,Staff,7,0,15,8
1683358800768,LTEN 181,A00,186150,Blanco; John D,33,0,40,7
1683358801801,LTWL 120,A00,186160,Staff,20,0,25,5
1683358802832,LTWL 165,A00,186161,Staff,22,0,25,3
1683358803856,LTWR 100,A00,186162,Staff,0,5,15,15
1683358804888,LTWR 102,A00,186163,Doller; Ben,5,0,15,10
1683358805914,MAE 8,A01,186412,Staff,0,0,0,0
1683358806939,MAE 30B,A00,186445,Bahadori; Mohammad Yousef,83,0,100,17
1683358807967,MAE 40,A00,186592,Bewley; Thomas R,10,0,50,40
1683358808993,MAE 101B,A00,186593,Bahadori; Mohammad Yousef,81,0,100,19
1683358810020,MAE 105,A00,186594,Bandaru; Prabhakar,12,0,50,38
1683358811045,MAE 107,A00,186599,Pham; Hieu Tan,0,7,120,120
1683358812071,MAE 148,A01,186660,Silberman; Jack,3,0,16,13
1683358813099,MATH 10A,A01,188095,Staff,0,5,35,35
1683358814127,MATH 10B,A01,188097,Bowers; Adam R.,0,11,30,30
1683358814127,MATH 10B,A02,188099,Bowers; Adam R.,0,11,30,30
1683358814127,MATH 10B,B01,188104,Bowers; Adam R.,0,10,30,30
1683358814127,MATH 10B,B02,188106,Bowers; Adam R.,0,10,30,30
1683358815160,MATH 10C,A01,188111,Staff,0,18,30,30
1683358815160,MATH 10C,A02,188127,Staff,0,17,30,30
1683358815160,MATH 10C,A03,188131,Staff,0,18,30,30
1683358815160,MATH 10C,B01,188218,Staff,18,0,30,12
1683358815160,MATH 10C,B02,188244,Staff,13,0,30,17
1683358815160,MATH 10C,B03,188277,Staff,16,0,30,14
1683358816191,MATH 18,A01,188344,Bach; Quang Tran,18,0,30,12
1683358816191,MATH 18,A02,188345,Bach; Quang Tran,11,0,30,19
1683358816191,MATH 18,B01,188353,Bach; Quang Tran,10,0,30,20
1683358816191,MATH 18,B02,188354,Bach; Quang Tran,20,0,30,10
1683358817216,MATH 20A,A01,188374,Staff,12,0,35,23
1683358818242,MATH 20B,A01,188382,Ohm; Ko Woon,6,0,30,24
1683358818242,MATH 20B,A02,188383,Ohm; Ko Woon,22,0,30,8
1683358818242,MATH 20B,B01,188385,Ohm; Ko Woon,7,0,30,23
1683358818242,MATH 20B,B02,188392,Ohm; Ko Woon,22,0,30,8
1683358819272,MATH 20C,A01,188394,Harel; Guershon,10,0,30,20
1683358819272,MATH 20C,A02,188395,Harel; Guershon,15,0,30,15
1683358819272,MATH 20C,B01,188404,Harel; Guershon,4,0,30,26
1683358819272,MATH 20C,B02,188405,Harel; Guershon,19,0,30,11
1683358820305,MATH 20D,A01,188414,Hammock; Frances H,0,1,30,30
1683358820305,MATH 20D,A02,188415,Hammock; Frances H,3,0,30,27
1683358820305,MATH 20D,B01,188447,Hammock; Frances H,1,0,30,29
1683358820305,MATH 20D,B02,188486,Hammock; Frances H,8,0,30,22
1683358821330,MATH 20E,A01,188649,Staff,21,0,30,9
1683358821330,MATH 20E,A02,188650,Staff,23,0,30,7
1683358821330,MATH 20E,A03,188673,Staff,0,0,30,30
1683358822361,MATH 102,A01,188675,Staff,0,35,35,35
1683358823390,MATH 103B,A01,188681,Staff,3,0,35,32
1683358823390,MATH 103B,B01,188692,Staff,5,0,35,30
1683358824419,MATH 109,A01,188695,Salehi Golsefidy; Alireza,25,0,35,10
1683358824419,MATH 109,A02,188696,Salehi Golsefidy; Alireza,25,0,35,10
1683358825449,MATH 120A,A01,188698,Eggers; John Dietrich,7,0,35,28
1683358826474,MATH 142B,A01,188736,Ioana; Adrian,0,2,30,30
1683358826474,MATH 142B,A02,188741,Ioana; Adrian,0,0,30,30
1683358826474,MATH 142B,A03,188743,Ioana; Adrian,0,1,30,30
1683358827500,MATH 168A,A01,188790,Staff,0,9,35,35
1683358828531,MATH 170A,A01,188803,Nie; Jiawang,0,2,35,35
1683358828531,MATH 170A,A02,188811,Nie; Jiawang,0,0,35,35
1683358828531,MATH 170A,A03,188814,Nie; Jiawang,1,0,35,34
1683358828531,MATH 170A,A04,188815,Nie; Jiawang,13,0,35,22
1683358829557,MATH 193B,A01,188817,Staff,0,0,35,35
1683358829557,MATH 193B,A02,188818,Staff,5,0,35,30
1683358830581,MGT 4,A01,202857,Anderson; John Charles,61,0,80,19
1683358831606,MGT 12,A00,202858,Lindenberger; Wade Douglas,42,0,90,48
1683358832630,MGT 18,A00,202859,Staff,74,0,90,16
1683358833653,MGT 18GS,A00,202860,McKay; Michael J,13,0,28,15
1683358834680,MGT 45,A00,202861,Pecore; Joseph P.,14,0,90,76
1683358835705,MGT 100,A00,202863,Yavorsky; Daniel Ryan,28,0,90,62
1683358836735,MGT 103,A00,202864,Ehrich; Kristine R,0,17,90,90
1683358837760,MGT 112,A00,202865,Ehrich; Kristine R,15,0,90,75
1683358838795,MGT 121A,A00,202868,Staff,0,20,0,0
1683358839821,MGT 131B,A00,202869,Anderson; John Charles,59,0,90,31
1683358840846,MGT 136,A00,202871,Lindenberger; Wade Douglas,84,0,90,6
1683358841871,MGT 164,A00,202873,Staff,0,68,90,91
1683358842895,MGT 164GS,A00,202874,McKay; Mary A,13,0,28,15
1683358843924,MGT 180,A00,202875,Staff,0,50,90,91
1683358844954,MMW 11R,A01,205019,Herbst; Matthew,3,0,30,27
1683358844954,MMW 11R,A02,205026,Herbst; Matthew,29,0,30,1
1683358845981,MMW 15,A01,193512,Chang; Edmond Yi-Teh,0,9,28,28
1683358845981,MMW 15,A02,193513,Chang; Edmond Yi-Teh,0,5,28,28
1683358845981,MMW 15,A03,193514,Chang; Edmond Yi-Teh,0,5,28,28
1683358845981,MMW 15,A04,193515,Chang; Edmond Yi-Teh,0,5,28,28
1683358845981,MMW 15,A05,193516,Chang; Edmond Yi-Teh,0,4,28,28
1683358845981,MMW 15,A06,193517,Chang; Edmond Yi-Teh,0,5,28,28
1683358845981,MMW 15,B01,193519,Chang; Edmond Yi-Teh,0,5,28,28
1683358845981,MMW 15,B02,193520,Chang; Edmond Yi-Teh,0,5,28,28
1683358845981,MMW 15,B03,193521,Chang; Edmond Yi-Teh,0,5,28,28
1683358845981,MMW 15,B04,193522,Chang; Edmond Yi-Teh,0,4,28,28
1683358845981,MMW 15,B05,193523,Chang; Edmond Yi-Teh,0,5,28,28
1683358845981,MMW 15,B06,193524,Chang; Edmond Yi-Teh,0,4,28,28
1683358847010,MMW 122,A01,193526,Rahimi; Babak,0,15,28,28
1683358847010,MMW 122,A02,193527,Rahimi; Babak,0,14,28,28
1683358847010,MMW 122,A03,193528,Rahimi; Babak,0,0,0,0
1683358847010,MMW 122,A04,193529,Rahimi; Babak,0,0,0,0
1683358848034,MUS 1A,A01,186663,Staff,0,20,35,35
1683358849059,MUS 4,A01,186715,Staff,0,12,35,35
1683358850084,MUS 5R,A01,186796,Dubnov; Shlomo,0,17,35,35
1683358851109,MUS 6,A01,186798,Staff,0,4,25,25
1683358852134,MUS 7,A01,186830,Staff,13,0,35,22
1683358853159,MUS 8,A01,186930,Staff,0,26,35,35
1683358854188,MUS 15,A01,186932,Staff,0,16,35,35
1683358854188,MUS 15,B01,186934,Staff,0,15,35,35
1683358855212,MUS 80,A00,186935,Staff,0,0,20,20
1683358855212,MUS 80,B00,186936,Staff,25,0,25,0
1683358856239,NANO 11,A00,204702,Lipomi; Darren John,0,0,0,0
1683358857264,NANO 15,A01,204709,Yang; Kesong,0,1,0,0
1683358858294,NANO 114,A00,202069,Jahed Motlagh; Zeinab,3,0,10,7
1683358859324,PHIL 1,A00,186955,Grush; Rick Scott,32,0,40,8
1683358860354,PHIL 10,A01,186973,Grush; Rick Scott,28,0,35,7
1683358860354,PHIL 10,A02,186974,Grush; Rick Scott,33,0,35,2
1683358861379,PHIL 13,A01,186976,Staff,7,0,35,28
1683358861379,PHIL 13,A02,186977,Staff,16,0,35,19
1683358862402,PHIL 14,A01,186979,Staff,31,0,35,4
1683358862402,PHIL 14,A02,186986,Staff,32,0,35,3
1683358863428,PHIL 28,A01,186988,Staff,16,0,30,14
1683358863428,PHIL 28,A02,186989,Staff,1,0,30,29
1683358863428,PHIL 28,A03,186990,Staff,9,0,30,21
1683358863428,PHIL 28,A04,186991,Staff,26,0,30,4
1683358864458,PHIL 120,A00,186997,Staff,23,0,40,17
1683358865484,PHIL 137,A00,187003,Staff,9,0,40,31
1683358866512,PHIL 150,A00,187015,Staff,47,0,70,23
1683358867537,PHIL 167,A00,187021,Lamey; Andy M.,35,0,40,5
1683358868563,PHIL 174,A01,202226,Staff,17,0,20,3
1683358868563,PHIL 174,A02,202235,Staff,20,0,20,0
1683358869589,PHIL 191A,A00,258918,Staff,0,0,1,1
1683358870620,PHYS 1A,A00,187028,Staff,27,0,60,33
1683358871645,PHYS 1AL,001,187036,Staff,2,0,30,28
1683358871645,PHYS 1AL,002,187049,Staff,18,0,30,12
1683358872668,PHYS 1B,A00,187058,Staff,22,0,60,38
1683358873694,PHYS 1BL,001,187064,Staff,0,0,30,30
1683358873694,PHYS 1BL,002,187070,Staff,5,0,30,25
1683358874720,PHYS 1C,A00,187082,Staff,31,0,120,89
1683358875747,PHYS 1CL,001,187088,Staff,0,9,30,30
1683358875747,PHYS 1CL,002,187089,Staff,0,2,30,30
1683358875747,PHYS 1CL,009,262693,Staff,11,0,30,19
1683358876772,PHYS 2B,A01,187097,Staff,54,0,115,61
1683358877798,PHYS 2C,A01,187099,Staff,67,0,115,48
1683358878829,PHYS 2CL,A01,187101,Staff,5,0,28,23
1683358878829,PHYS 2CL,A02,187102,Staff,15,0,28,13
1683358879854,PHYS 2D,A01,187123,Shotwell; Brian,95,0,115,20
1683358880886,PHYS 4B,A01,187133,Grinstein; Benjamin,35,0,50,15
1683358881913,POLI 10,A00,188819,Staff,0,4,50,50
1683358882995,POLI 11,A00,188827,Staff,43,0,50,7
1683358884021,POLI 13R,A00,188828,Staff,0,1,20,20
1683358885050,POLI 27,A01,188830,Elgin; Samuel Zincke,0,1,70,70
1683358886076,POLI 30,A00,188832,Desposato; Scott,31,0,50,19
1683358887103,POLI 102F,A00,188834,Staff,3,0,40,37
1683358888129,POLI 104A,A00,188852,Staff,14,0,30,16
1683358889156,POLI 104I,A00,188853,Staff,0,6,20,20
1683358890182,POLI 110B,A00,188854,Wiens; David,7,0,20,13
1683358891206,POLI 112A,A00,188855,Wiens; David,5,0,30,25
1683358892234,POLI 117R,A00,188856,Forman; Fonna,0,11,20,20
1683358893258,POLI 118,A00,188857,Ingham; Sean,8,0,20,12
1683358894283,POLI 120G,A00,188858,Staff,9,0,30,21
1683358895311,POLI 131CR,A00,188863,Hoston; Germaine,23,0,50,27
1683358896336,POLI 133,A00,188864,Nellis; Gareth Hb,44,0,50,6
1683358897363,POLI 134D,A00,188865,Desposato; Scott,27,0,30,3
1683358898388,POLI 142A,A00,188871,Gartzke; Erik,22,0,50,28
1683358899416,POLI 142K,A00,188874,Staff,38,0,50,12
1683358900440,POLI 143,A00,188940,Gartzke; Erik,16,0,30,14
1683358901466,POLI 153,A00,188943,Staff,3,0,20,17
1683358902490,POLI 160AA,A00,188944,Staff,11,0,40,29
1683358903517,POLI 170A,A00,188945,Staff,11,0,30,19
1683358905569,PSYC 1,A00,188952,Staff,37,0,90,53
1683358906595,PSYC 2,B00,188953,Staff,19,0,35,16
1683358907621,PSYC 6,A00,188970,Staff,47,0,60,13
1683358908649,PSYC 7,A00,188973,Staff,37,0,45,8
1683358909680,PSYC 60,A01,188980,Rickard; Timothy C.,43,0,60,17
1683358910706,PSYC 70,A01,189001,Steiner; Eric Tomas,23,0,45,22
1683358911735,PSYC 100,A00,189005,Lacefield; Katharine I,0,98,120,120
1683358912762,PSYC 102,A00,189008,Staff,9,0,30,21
1683358913790,PSYC 106,B00,189026,Gorman; Michael R.,34,0,60,26
1683358914814,PSYC 114,B01,189033,Winkielman; Piotr,0,32,30,30
1683358915843,PSYC 131,A00,189036,Anagnostaras; Stephan,0,43,60,60
1683358916872,PSYC 136,A00,189041,Lowe; Angela Beth,0,7,25,25
1683358917898,PSYC 137,A00,189057,Winkielman; Piotr,0,34,25,25
1683358918926,PSYC 144,A00,189107,Wixted; John T,0,7,50,50
1683358920978,PSYC 162,A00,189142,Staff,0,8,85,85
1683358922003,PSYC 172,A00,189144,Gorman; Michael R.,0,7,30,30
1683358924054,PSYC 179,A00,189146,Lacefield; Katharine I,0,84,120,120
1683358925079,PSYC 181,A00,189147,Anagnostaras; Stephan,0,44,90,90
1683358926109,PSYC 190R,A00,189148,Barner; David A.,0,22,80,80
1683358927142,PSYC 191,A00,189275,Rickard; Timothy C.,0,7,25,25
1683358928167,PSYC 193,A00,189276,Chapman; Eddie Nathaniel,0,1,0,4
1683358929193,PSYC 193L,A01,189281,Lowe; Angela Beth,12,0,20,8
1683358929193,PSYC 193L,B01,189285,Staff,28,0,35,7
1683358930219,RELI 149,A00,187137,Rahimi; Babak,7,0,40,33
1683358931250,SE 9,A01,187315,Staff,0,2,18,18
1683358932279,SE 101B,A00,187409,Staff,24,0,30,6
1683358933305,SE 110B,A00,187444,Staff,10,0,40,30
1683358934334,SE 130B,A00,187449,Staff,31,0,40,9
1683358935358,SE 150A,A00,187516,Staff,9,0,20,11
1683358936387,SE 154,A00,187528,Staff,30,0,50,20
1683358937416,SIO 3,A01,258171,Staff,35,0,40,5
1683358938445,SIO 10,A00,187144,Cook; Geoffrey W,0,3,75,75
1683358939474,SIO 45,A00,187152,Cook; Geoffrey W,1,0,100,99
1683358940501,SIO 109R,A00,194486,Staff,0,3,20,20
1683358942552,SIO 187,A01,187233,Kacev; David,12,0,40,28
1683358943585,SOCI 1,A01,258656,Thorpe; Charles Robert,28,0,30,2
1683358943585,SOCI 1,A02,258658,Thorpe; Charles Robert,30,0,30,0
1683358943585,SOCI 1,A03,258661,Thorpe; Charles Robert,25,0,25,0
1683358943585,SOCI 1,A04,258666,Thorpe; Charles Robert,22,0,25,3
1683358943585,SOCI 1,A05,258897,Thorpe; Charles Robert,23,0,25,2
1683358943585,SOCI 1,A06,258898,Thorpe; Charles Robert,25,0,25,0
1683358944616,SOCI 30,A01,258903,Pardo Guerra; Juan Pablo,15,0,30,15
1683358945641,SOCI 102,A00,258904,Staff,9,0,25,16
1683358946668,SOCI 106,A00,258905,Staff,19,0,25,6
1683358947695,SOCI 111,A00,258907,Ribas Norris; Janet Vanesa,26,0,30,4
1683358948724,SOCI 121R,A00,258908,Pardo Guerra; Juan Pablo,10,0,30,20
1683358949750,SOCI 126,A01,203330,Staff,14,0,20,6
1683358950775,SOCI 131,A00,258909,Thorpe; Charles Robert,31,0,60,29
1683358951800,SOCI 135,A00,258910,Payne; Christine Anna,0,9,30,30
1683358952827,SOCI 157,A00,258911,Staff,12,0,30,18
1683358953853,SOCI 184,A00,258912,Staff,25,0,30,5
1683358954882,SOCI 188D,A00,258913,Staff,22,0,30,8
1683358955908,SYN 2,001,187529,Staff,10,0,16,6
1683358955908,SYN 2,002,201452,Staff,0,18,16,16
1683358955908,SYN 2,003,201469,Staff,3,0,16,13
1683358956933,SYN 100,A01,187531,Staff,0,9,20,20
1683358956933,SYN 100,B01,201491,Staff,0,12,20,20
1683358957958,TDAC 1,A00,189286,Walsh; Kim C.,3,0,20,17
1683358957958,TDAC 1,B00,189287,Harting; Carla Kelso,11,0,20,9
1683358958982,TDAC 101,A00,189300,Walsh; Kim C.,16,0,20,4
1683358958982,TDAC 101,B00,189301,Harting; Carla Kelso,18,0,20,2
1683358960012,TDAC 102,A00,189304,Basso; Beatrice,14,0,20,6
1683358961036,TDAC 108,A00,189305,Staff,18,0,20,2
1683358962064,TDDE 131,A00,189310,Staff,19,0,20,1
1683358962064,TDDE 131,B00,189314,Staff,19,0,20,1
1683358962064,TDDE 131,C00,189315,Staff,48,0,50,2
1683358962064,TDDE 131,D00,189316,Staff,14,0,15,1
1683358962064,TDDE 131,E00,204841,Staff,20,0,20,0
1683358963094,TDGE 10,A00,189289,Staff,30,0,50,20
1683358963094,TDGE 10,B00,189290,Havis; Allan,1,0,50,49
1683358964122,TDGE 11,A00,189291,Fulton; Julia,0,3,50,50
1683358964122,TDGE 11,B00,189292,Staff,20,0,25,5
1683358964122,TDGE 11,C00,260270,Staff,0,0,0,0
1683358965150,TDGE 25,A00,189294,Staff,3,0,20,17
1683358966175,TDGE 124,A00,189318,Fulton; Julia,0,8,50,50
1683358967205,TDGE 125,A00,189319,Staff,13,0,25,12
1683358967205,TDGE 125,B00,189320,Staff,23,0,25,2
1683358968230,TDGE 127,A00,189322,Havis; Allan,0,0,50,50
1683358969254,TDHT 101,A00,189323,Staff,18,0,25,7
1683358969254,TDHT 101,B00,189324,Staff,25,0,25,0
1683358970282,TDHT 102,A00,189325,Staff,49,0,50,1
1683358971312,TDMV 1,A00,189295,Arcidiacono; Kristin,19,0,30,11
1683358971312,TDMV 1,B00,189296,Caligagan; Maria T.,24,0,30,6
1683358972338,TDMV 2,A00,189297,Sammartano; Tonnie,28,0,30,2
1683358972338,TDMV 2,B00,189299,Arcidiacono; Kristin,24,0,30,6
1683358973366,TDMV 3,A00,204998,Rincon; Alicia,22,0,30,8
1683358974391,TDMV 120,A00,189458,Sammartano; Tonnie,28,0,30,2
1683358975417,TDMV 138,A00,189541,Jun; Grace Shin Hae,22,0,40,18
1683358976442,TDMV 142,A00,189717,Caligagan; Tony,23,0,30,7
1683358976442,TDMV 142,B00,189718,Caligagan; Maria T.,25,0,30,5
1683358977469,TMC 2,A01,187533,Staff,25,0,25,0
1683358977469,TMC 2,A02,187534,Staff,25,0,25,0
1683358978497,USP 1,A01,187536,Kwak; Nancy,0,16,25,25
1683358979523,USP 5,A01,187538,Staff,10,0,25,15
1683358980551,USP 101,A00,199253,Staff,0,4,0,0
1683358981582,USP 124,A00,187562,Boomhower; Matthew Charles,1,0,30,29
1683358982612,USP 138,A00,187582,Staff,20,0,25,5
1683358983636,USP 152,A01,187597,Staff,4,0,25,21
1683358984665,USP 153,A00,187598,Staff,19,0,25,6
1683358985691,USP 168,A00,187607,Kwak; Nancy,2,0,5,3
1683358986774,USP 173,A00,187619,Staff,4,0,25,21
1683358987802,USP 181,A00,187638,Staff,0,3,25,25
1683358988827,VIS 103,A00,187650,Cruz; Edwin Teddy,22,0,75,53
1683358989860,VIS 110D,A00,187669,Staff,12,0,22,10
1683358990886,VIS 127C,A00,187720,Shen; Kuiyi,67,0,146,79
1683358991911,VIS 149,A00,187731,Yoldas; Pinar,0,14,22,22
1683358992942,VIS 151,A01,188091,Staff,22,0,34,12
1683358992942,VIS 151,A02,188092,Staff,11,0,34,23
1683358993966,VIS 160B,A00,188093,Stalbaum; Brett,0,0,10,10
1683358996019,WCWP 10B,A00,201720,Staff,10,0,15,5
1683358996019,WCWP 10B,B00,201722,Staff,9,0,15,6
1683358997050,WCWP 100,A00,201725,Gagnon; Jeffrey C,0,0,2,2
1683358997050,WCWP 100,B00,201727,Staff,0,4,15,15
1683359000208,ANBI 133,A00,258401,Wilder; Linnea Lorene,34,0,40,6
1683359001237,ANBI 140,A00,258395,Hrvoj Mihic; Branka,18,0,25,7
1683359002261,ANSC 120,A00,258402,Bialecki; Jon Anthony,27,0,40,13
1683359003288,ANSC 144,A00,258400,Staff,14,0,40,26
1683359005345,ANSC 166,A00,258396,Parish; Steven Martin,157,0,175,18
1683359006377,ANSC 180,A00,193533,Staff,9,0,20,11
1683359007402,ANSC 188,A00,258397,Jassal; Aftab,33,0,40,7
1683359008429,ANTH 3,A01,258316,Staff,23,0,30,7
1683359009455,ANTH 5,A00,258394,Semendeferi; Ekaterini,16,0,20,4
1683359010484,ANTH 21,A01,258331,Staff,8,0,40,32
1683359011513,ANTH 103,A00,258398,Varma; Saiba,15,0,25,10
1683359012543,AWP 10,001,202034,Staff,0,0,0,0
1683359012543,AWP 10,002,202035,Staff,0,0,0,0
1683359012543,AWP 10,003,202036,Staff,0,0,0,0
1683359012543,AWP 10,004,202037,Staff,0,0,0,0
1683359012543,AWP 10,005,202038,Staff,0,0,0,0
1683359012543,AWP 10,006,202039,Staff,0,0,0,0
1683359012543,AWP 10,007,202040,Staff,0,0,0,0
1683359012543,AWP 10,008,202041,Staff,0,0,0,0
1683359012543,AWP 10,009,202042,Staff,0,0,0,0
1683359012543,AWP 10,010,202043,Staff,0,0,0,0
1683359012543,AWP 10,011,202044,Staff,0,0,0,0
1683359012543,AWP 10,012,202045,Staff,0,0,0,0
1683359012543,AWP 10,013,202046,Staff,0,0,0,0
1683359012543,AWP 10,014,202047,Staff,0,0,0,0
1683359012543,AWP 10,015,202048,Staff,0,0,0,0
1683359012543,AWP 10,016,202049,Staff,0,0,0,0
1683359012543,AWP 10,017,202050,Staff,0,0,0,0
1683359012543,AWP 10,018,202051,Staff,0,0,0,0
1683359012543,AWP 10,019,202052,Staff,0,0,0,0
1683359012543,AWP 10,020,202053,Staff,0,0,0,0
1683359012543,AWP 10,021,202054,Staff,0,0,0,0
1683359012543,AWP 10,022,202055,Staff,0,0,0,0
1683359012543,AWP 10,023,202056,Staff,0,0,0,0
1683359012543,AWP 10,024,202057,Staff,0,0,0,0
1683359012543,AWP 10,025,202058,Staff,0,0,0,0
1683359012543,AWP 10,026,202059,Staff,0,0,0,0
1683359013572,AWP 102,001,202032,Staff,0,0,0,0
1683359013572,AWP 102,002,202033,Staff,0,0,0,0
1683359014616,BENG 100,A01,254234,Taylor Amos; Alyssa C,31,0,40,9
1683359015641,BENG 196,001,270013,Engler; Adam J.,9999,0,9999,0
1683359016669,BICD 100R,A01,202018,Smith; Laurie,0,7,32,32
1683359016669,BICD 100R,A02,202019,Smith; Laurie,0,2,32,32
1683359016669,BICD 100R,A03,202020,Smith; Laurie,0,1,32,32
1683359016669,BICD 100R,A04,202021,Smith; Laurie,9,0,32,23
1683359016669,BICD 100R,A05,202022,Smith; Laurie,12,0,32,20
1683359017705,BICD 136,A01,193242,Gustafson-Brown; Cindy,0,2,32,32
1683359017705,BICD 136,A02,193244,Gustafson-Brown; Cindy,14,0,32,18
1683359018734,BIEB 102,A01,193249,Butler; Shannon Rhey,0,2,32,32
1683359018734,BIEB 102,A02,193251,Butler; Shannon Rhey,0,0,32,32
1683359018734,BIEB 102,A03,193253,Butler; Shannon Rhey,0,1,32,32
1683359018734,BIEB 102,A04,193255,Butler; Shannon Rhey,17,0,32,15
1683359018734,BIEB 102,A05,193265,Butler; Shannon Rhey,26,0,32,6
1683359018734,BIEB 102,A06,193269,Butler; Shannon Rhey,16,0,32,16
1683359020788,BIEB 150,A01,193274,Staff,0,0,32,32
1683359020788,BIEB 150,A02,193285,Staff,23,0,32,9
1683359021814,BIEB 194,A00,193286,Kurle; Carolyn M.,22,0,32,10
1683359022848,BILD 1,A01,192291,Staff,16,0,32,16
1683359022848,BILD 1,A02,192292,Staff,30,0,32,2
1683359022848,BILD 1,B01,192520,Reuther; Keefe,0,1,0,0
1683359022848,BILD 1,B02,192532,Reuther; Keefe,0,1,0,0
1683359023880,BILD 3,A01,192556,Butler; Shannon Rhey,0,0,32,32
1683359023880,BILD 3,A02,192581,Butler; Shannon Rhey,4,0,32,28
1683359023880,BILD 3,A03,192611,Butler; Shannon Rhey,23,0,32,9
1683359023880,BILD 3,A04,192612,Butler; Shannon Rhey,25,0,32,7
1683359023880,BILD 3,A05,192613,Butler; Shannon Rhey,27,0,32,5
1683359023880,BILD 3,A06,192679,Butler; Shannon Rhey,27,0,32,5
1683359023880,BILD 3,A07,192682,Butler; Shannon Rhey,22,0,32,10
1683359024906,BILD 4,A01,192836,Reuther; Keefe,0,0,24,24
1683359024906,BILD 4,A02,193044,Reuther; Keefe,4,0,24,20
1683359025937,BILD 10,A01,193142,Gustafson-Brown; Cindy,30,0,32,2
1683359025937,BILD 10,A02,193149,Gustafson-Brown; Cindy,31,0,32,1
1683359026966,BIMM 100,A01,193301,Staff,0,6,32,32
1683359026966,BIMM 100,A02,193312,Staff,0,5,32,32
1683359026966,BIMM 100,A03,193323,Staff,0,8,32,32
1683359027992,BIMM 101,A01,193329,McDonnell; Lisa Marie,0,3,24,24
1683359027992,BIMM 101,A02,193339,McDonnell; Lisa Marie,0,3,24,24
1683359027992,BIMM 101,B01,193354,McDonnell; Lisa Marie,0,3,24,24
1683359027992,BIMM 101,B02,193357,McDonnell; Lisa Marie,0,3,24,24
1683359029016,BIMM 110,A01,193377,Tat; John,0,11,32,32
1683359029016,BIMM 110,A02,193378,Tat; John,0,9,32,32
1683359030042,BIMM 120,A01,206116,Staff,0,0,32,32
1683359030042,BIMM 120,A02,206117,Staff,8,0,32,24
1683359030042,BIMM 120,A03,206121,Staff,21,0,32,11
1683359031074,BIPN 100,A01,193393,Park; Ji Young,0,14,32,32
1683359031074,BIPN 100,A02,193402,Park; Ji Young,0,13,32,32
1683359031074,BIPN 100,A03,193413,Park; Ji Young,0,14,32,32
1683359031074,BIPN 100,A04,193414,Park; Ji Young,0,13,32,32
1683359032099,BIPN 102,A01,193429,Staff,0,0,32,32
1683359032099,BIPN 102,A02,193438,Staff,22,0,32,10
1683359033128,BIPN 106,A01,193450,Reyes Gonzalez; Catalina,0,2,40,40
1683359034154,BIPN 134,A01,193465,Cooke; James Edward,1,0,32,31
1683359034154,BIPN 134,A02,193474,Cooke; James Edward,25,0,32,7
1683359034154,BIPN 134,A03,193485,Cooke; James Edward,29,0,32,3
1683359034154,BIPN 134,A04,193486,Cooke; James Edward,21,0,32,11
1683359034154,BIPN 134,A05,193491,Cooke; James Edward,31,0,32,1
1683359034154,BIPN 134,A06,193501,Cooke; James Edward,30,0,32,2
1683359034154,BIPN 134,A07,193510,Cooke; James Edward,29,0,32,3
1683359036209,BISP 194,A00,222522,Staff,14,0,32,18
1683359037235,CAT 124,A01,202407,Staff,19,0,25,6
1683359038259,CAT 125,A00,202408,Marchisotto; Jennifer Anne,4,0,20,16
1683359039288,CAT 125R,A00,202409,Smith; Lauryn Alissa,0,11,20,20
1683359039288,CAT 125R,B00,202410,Morales; Celeste Georgianna,0,11,20,20
1683359039288,CAT 125R,C00,202411,Irwin; Matthew Joseph,0,10,20,20
1683359040315,CENG 15,A01,204712,Yang; Kesong,0,1,0,0
1683359041342,CENG 114,A00,202070,Jahed Motlagh; Zeinab,5,0,20,15
1683359042381,CGS 105,A00,185477,Wesling; Megan E.,24,0,40,16
1683359043406,CGS 106,A00,185494,Staff,13,0,22,9
1683359044434,CGS 108,A00,185495,Staff,14,0,20,6
1683359045462,CGS 114,A00,185496,Staff,13,0,18,5
1683359046488,CGS 119,A00,185501,Staff,15,0,20,5
1683359047513,CGS 120,A00,185511,Staff,13,0,20,7
1683359048549,CHEM 4,A01,184675,Bussey; Thomas J,96,0,100,4
1683359049578,CHEM 6A,A01,184677,Staff,34,0,60,26
1683359050603,CHEM 6B,A01,184679,Staff,65,0,100,35
1683359051633,CHEM 6C,A01,184681,Bussey; Thomas J,1,0,50,49
1683359051633,CHEM 6C,A02,184682,Bussey; Thomas J,34,0,50,16
1683359052663,CHEM 40A,A01,184684,Albizati; Kim F.,37,0,100,63
1683359053693,CHEM 40B,A01,184686,Albizati; Kim F.,0,20,100,100
1683359054717,CHEM 41B,A01,184690,Staff,52,0,100,48
1683359055743,COGS 3,A01,184715,Boyle; Mary E. T.,0,25,40,40
1683359056775,COGS 14B,A01,185172,Staff,0,15,38,38
1683359057804,COGS 18,A01,184736,Staff,17,0,80,63
1683359058830,COGS 100,A01,184932,Staff,0,5,73,73
1683359059864,COGS 101A,A01,184935,Staff,0,39,30,30
1683359060892,COGS 101B,A01,184944,Staff,0,2,30,30
1683359061917,COGS 101C,A01,184946,Staff,0,12,30,30
1683359062943,COGS 102A,A01,184951,Johnson; Christine M.,2,0,40,38
1683359064001,COGS 107B,A01,184953,Mooshagian; Eric Frederick,0,50,40,40
1683359065026,COGS 118B,A01,184959,Gupta; Anjum,0,48,40,40
1683359066054,COGS 153,A00,184961,Staff,0,15,30,30
1683359067079,COGS 177,A00,184962,Staff,0,20,30,30
1683359068108,COGS 187A,A01,184969,Boyle; Mary E. T.,0,17,40,40
1683359069134,COMM 10,A01,185174,Staff,0,5,25,25
1683359069134,COMM 10,A02,185189,Staff,0,5,25,25
1683359069134,COMM 10,A03,269821,Staff,0,0,0,0
1683359070161,COMM 100B,A01,185475,Staff,0,0,0,2
1683359070161,COMM 100B,A02,185476,Staff,13,0,25,12
1683359071192,COMM 100C,A01,185314,Staff,1,0,25,24
1683359071192,COMM 100C,A02,185327,Staff,19,0,25,6
1683359072216,COMM 110M,A00,185349,Staff,2,0,40,38
1683359073241,COMM 113T,A00,185352,Staff,24,0,40,16
1683359074265,COMM 114I,A00,185353,Staff,33,0,40,7
1683359075293,COMM 131,A00,185354,Staff,19,0,30,11
1683359076320,CSE 8A,A50,185358,Cao; Yingjun,0,46,10,10
1683359077344,CSE 8B,A01,185362,Staff,0,46,50,50
1683359078368,CSE 11,A01,185416,Cao; Yingjun,0,92,10,10
1683359079392,CSE 20,A01,185445,Briones; Jor-el Thomas Caparas,5,0,25,20
1683359080417,CSE 21,A01,185447,Staff,10,0,50,40
1683359081448,CSE 101,A01,185451,Staff,0,13,50,50
1683359081448,CSE 101,B01,185453,Jones; Miles E,0,11,50,50
1683359083502,CSE 141,A01,185458,Eldon; John,20,0,100,80
1683359084527,CSE 141L,A01,185461,Eldon; John,12,0,100,88
1683359085555,CSE 142,A01,185463,Staff,36,0,60,24
1683359085555,CSE 142,B01,201355,Staff,0,7,60,60
1683359086585,CSE 142L,A01,185470,Staff,36,0,60,24
1683359086585,CSE 142L,B01,201417,Staff,0,6,60,60
1683359087608,CSE 190,A00,201433,Staff,32,0,49,17
1683359088643,DOC 1,A01,259136,Strom; Megan C.,7,0,15,8
1683359088643,DOC 1,A02,259137,Strom; Megan C.,14,0,15,1
1683359088643,DOC 1,A03,259138,Strom; Megan C.,14,0,15,1
1683359088643,DOC 1,A04,259139,Strom; Megan C.,14,0,15,1
1683359089670,DOC 100D,A00,259140,Pass; Natalye Joann,16,0,25,9
1683359090766,DSGN 1,A01,184749,Rill; Bryan,0,25,30,30
1683359091792,DSGN 100,A01,185168,Staff,0,2,25,25
1683359092820,ECE 5,A01,185626,Morris; Karcher William,0,10,0,0
1683359093848,ECE 101,A01,185628,Staff,17,0,70,53
1683359094875,ECE 107,A01,185635,Baghdadchi; Saharnaz,0,0,20,20
1683359094875,ECE 107,A02,185638,Baghdadchi; Saharnaz,4,0,20,16
1683359095905,ECE 148,A01,185647,Silberman; Jack,0,0,16,16
1683359096930,ECON 1,A01,185537,Crane; Meredith Helen,54,0,70,16
1683359097953,ECON 3,A01,185549,Crane; Meredith Helen,32,0,70,38
1683359098980,ECON 4,A01,203354,Anderson; John Charles,0,4,10,10
1683359100006,ECON 100A,A01,185574,Staff,0,4,40,40
1683359101031,ECON 100B,A01,185576,Staff,0,12,50,50
1683359102058,ECON 100C,A01,185589,Newhouse; Herbert S,29,0,70,41
1683359103083,ECON 105,A00,185608,Vespa; Emanuel Ignacio,19,0,35,16
1683359104114,ECON 109,A01,185610,Shishkin; Denis,10,0,35,25
1683359105138,ECON 110A,A01,185612,Staff,11,0,40,29
1683359106164,ECON 120A,A01,185615,Staff,20,0,40,20
1683359107189,ECON 120C,A01,185617,Sun; Yixiao,0,21,70,70
1683359108215,ECON 144,A00,203346,Squires; Dale E,3,0,35,32
1683359109245,ECON 171,A01,203349,Newhouse; Herbert S,0,1,35,35
1683359110271,ECON 173A,A01,185621,Toda; Alexis Akira,21,0,35,14
1683359111300,EDS 25,A01,202413,Staff,0,1,0,0
1683359111300,EDS 25,A02,202414,Staff,0,1,0,0
1683359111300,EDS 25,A03,202415,Staff,0,0,0,0
1683359111300,EDS 25,A04,202416,Staff,0,1,0,0
1683359111300,EDS 25,A05,202439,Staff,0,0,0,0
1683359111300,EDS 25,A06,202440,Staff,0,0,0,0
1683359111300,EDS 25,B01,202631,Staff,0,0,0,0
1683359111300,EDS 25,B02,202632,Staff,0,0,0,0
1683359111300,EDS 25,B03,202639,Staff,0,0,0,0
1683359111300,EDS 25,B04,202640,Staff,0,0,0,0
1683359111300,EDS 25,B05,202643,Staff,0,0,0,0
1683359111300,EDS 25,B06,202644,Staff,0,0,0,0
1683359112335,EDS 38,A01,202659,Black; Alison Michelle,24,0,25,1
1683359113362,EDS 115,A00,202652,Staff,18,0,30,12
1683359114388,EDS 125,A00,202649,Staff,14,0,30,16
1683359115416,EDS 126,A01,203332,Staff,30,0,30,0
1683359116440,EDS 139,A00,202838,Staff,16,0,25,9
1683359117464,EDS 146,A01,202655,Staff,14,0,25,11
1683359118496,ENG 15,A00,185667,Staff,0,1,0,0
1683359118496,ENG 15,B00,185672,Staff,0,0,0,0
1683359118496,ENG 15,C00,185675,Staff,0,0,0,0
1683359118496,ENG 15,D00,185682,Staff,0,0,0,0
1683359118496,ENG 15,E00,185684,Staff,0,0,0,0
1683359119524,ETHN 103,A00,185710,Staff,0,4,35,35
1683359120550,ETHN 103A,A00,199228,Man; Simeon S,2,0,9,7
1683359121586,ETHN 109,A00,185711,Staff,18,0,35,17
1683359122612,ETHN 142,A00,185726,Staff,0,4,30,30
1683359123641,ETHN 163J,A00,199229,Man; Simeon S,5,0,8,3
1683359124668,ETHN 168,A00,185727,Staff,8,0,10,2
1683359125694,ETHN 182,A00,185728,Staff,0,0,35,35
1683359126719,ETHN 183,A00,185737,Staff,8,0,18,10
1683359127746,GLBH 111,A01,209361,Burgos; Jose L.,0,0,0,0
1683359129797,HIEU 104,A00,185792,Staff,16,0,20,4
1683359130826,HIEU 115,A00,185800,Staff,1,0,20,19
1683359131854,HIEU 128,A00,185801,Staff,0,7,20,20
1683359132876,HIEU 147,A00,185802,Staff,16,0,20,4
1683359133903,HIEU 154,A00,185823,Staff,12,0,20,8
1683359134927,HILA 102,A00,185826,Staff,13,0,20,7
1683359135957,HILD 2C,A01,185778,Staff,0,12,20,20
1683359136982,HILD 7B,A01,185780,Kwak; Nancy,0,15,32,32
1683359136982,HILD 7B,A02,185781,Kwak; Nancy,0,18,32,32
1683359138013,HILD 30,A01,185791,Staff,14,0,20,6
1683359139039,HISC 119,A00,185830,Golan; Tal,0,9,20,20
1683359140069,HITO 156GS,A00,185831,Patterson; Patrick H.,0,0,0,23
1683359141094,HIUS 103,A00,185832,Man; Simeon S,1,6,20,19
1683359142120,HIUS 117,A00,185836,Kwak; Nancy,2,0,20,18
1683359143147,HIUS 125,A00,185840,Man; Simeon S,0,0,23,23
1683359144175,HIUS 149,A00,185845,Staff,0,0,20,20
1683359145201,HUM 3,A01,185882,Zavodny; Tatiana Sophia,0,7,50,50
1683359145201,HUM 3,B01,185899,Caldwell; Michael Alan,0,18,50,50
1683359146228,HUM 3GS,A00,185900,Patterson; Patrick H.,0,0,0,23
1683359147260,HUM 4,A01,185938,Zroka; Amy Liane,31,0,50,19
1683359147260,HUM 4,B01,185956,Watkins; Eric,0,3,50,50
1683359147260,HUM 4,B02,202209,Watkins; Eric,0,2,50,50
1683359147260,HUM 4,B03,202210,Watkins; Eric,0,2,50,50
1683359148286,HUM 5,A01,185958,West; Geoffrey Scott,3,0,50,47
1683359148286,HUM 5,A02,202215,West; Geoffrey Scott,0,0,50,50
1683359149312,INTL 190,A00,185959,Gagnon; Jeffrey C,0,0,0,9
1683359149312,INTL 190,B00,185960,Lettieri; Michael Joseph,0,0,0,1
1683359150347,JAPN 180,A00,254509,Staff,4,0,30,26
1683359151375,LATI 10,A01,202853,Kennemore; Amy Michelle,4,0,35,31
1683359151375,LATI 10,A02,202854,Kennemore; Amy Michelle,2,0,35,33
1683359151375,LATI 10,A03,270054,Kennemore; Amy Michelle,30,0,30,0
1683359152400,LATI 180,A00,202855,Kennemore; Amy Michelle,11,0,20,9
1683359153425,LAWS 101,A00,201767,Golan; Tal,0,7,40,40
1683359154454,LIFR 1C,A00,185961,Staff,6,0,20,14
1683359155480,LIFR 1CX,A00,185962,Staff,7,0,20,13
1683359156504,LIFR 1D,A00,185963,Staff,9,0,20,11
1683359157529,LIFR 1DX,A00,185964,Staff,9,0,20,11
1683359158554,LIGN 101,A01,186039,Staff,43,0,50,7
1683359159579,LIGN 165,A00,186040,Staff,18,0,50,32
1683359160611,LTCS 108,A00,186041,Staff,6,0,10,4
1683359161650,LTCS 119,A00,186042,Staff,16,0,20,4
1683359162687,LTCS 130,A00,186043,Wesling; Megan E.,15,0,25,10
1683359164745,LTEA 138,A00,186119,Staff,14,0,40,26
1683359165771,LTEN 124,A00,186148,Staff,6,0,25,19
1683359166796,LTEN 178,A00,186149,Staff,7,0,15,8
1683359167823,LTEN 181,A00,186150,Blanco; John D,33,0,40,7
1683359168848,LTWL 120,A00,186160,Staff,20,0,25,5
1683359169873,LTWL 165,A00,186161,Staff,22,0,25,3
1683359170898,LTWR 100,A00,186162,Staff,0,5,15,15
1683359171924,LTWR 102,A00,186163,Doller; Ben,5,0,15,10
1683359172956,MAE 8,A01,186412,Staff,0,0,0,0
1683359173986,MAE 30B,A00,186445,Bahadori; Mohammad Yousef,83,0,100,17
1683359175011,MAE 40,A00,186592,Bewley; Thomas R,10,0,50,40
1683359176036,MAE 101B,A00,186593,Bahadori; Mohammad Yousef,81,0,100,19
1683359177072,MAE 105,A00,186594,Bandaru; Prabhakar,12,0,50,38
1683359178098,MAE 107,A00,186599,Pham; Hieu Tan,0,7,120,120
1683359179124,MAE 148,A01,186660,Silberman; Jack,3,0,16,13
1683359180156,MATH 10A,A01,188095,Staff,0,5,35,35
1683359181181,MATH 10B,A01,188097,Bowers; Adam R.,0,11,30,30
1683359181181,MATH 10B,A02,188099,Bowers; Adam R.,0,11,30,30
1683359181181,MATH 10B,B01,188104,Bowers; Adam R.,0,10,30,30
1683359181181,MATH 10B,B02,188106,Bowers; Adam R.,0,10,30,30
1683359182208,MATH 10C,A01,188111,Staff,0,18,30,30
1683359182208,MATH 10C,A02,188127,Staff,0,17,30,30
1683359182208,MATH 10C,A03,188131,Staff,0,18,30,30
1683359182208,MATH 10C,B01,188218,Staff,18,0,30,12
1683359182208,MATH 10C,B02,188244,Staff,13,0,30,17
1683359182208,MATH 10C,B03,188277,Staff,16,0,30,14
1683359183242,MATH 18,A01,188344,Bach; Quang Tran,18,0,30,12
1683359183242,MATH 18,A02,188345,Bach; Quang Tran,11,0,30,19
1683359183242,MATH 18,B01,188353,Bach; Quang Tran,10,0,30,20
1683359183242,MATH 18,B02,188354,Bach; Quang Tran,20,0,30,10
1683359184267,MATH 20A,A01,188374,Staff,12,0,35,23
1683359185294,MATH 20B,A01,188382,Ohm; Ko Woon,6,0,30,24
1683359185294,MATH 20B,A02,188383,Ohm; Ko Woon,22,0,30,8
1683359185294,MATH 20B,B01,188385,Ohm; Ko Woon,7,0,30,23
1683359185294,MATH 20B,B02,188392,Ohm; Ko Woon,22,0,30,8
1683359186325,MATH 20C,A01,188394,Harel; Guershon,10,0,30,20
1683359186325,MATH 20C,A02,188395,Harel; Guershon,15,0,30,15
1683359186325,MATH 20C,B01,188404,Harel; Guershon,4,0,30,26
1683359186325,MATH 20C,B02,188405,Harel; Guershon,19,0,30,11
1683359187353,MATH 20D,A01,188414,Hammock; Frances H,0,1,30,30
1683359187353,MATH 20D,A02,188415,Hammock; Frances H,3,0,30,27
1683359187353,MATH 20D,B01,188447,Hammock; Frances H,1,0,30,29
1683359187353,MATH 20D,B02,188486,Hammock; Frances H,8,0,30,22
1683359188380,MATH 20E,A01,188649,Staff,21,0,30,9
1683359188380,MATH 20E,A02,188650,Staff,23,0,30,7
1683359188380,MATH 20E,A03,188673,Staff,0,0,30,30
1683359189405,MATH 102,A01,188675,Staff,0,35,35,35
1683359190435,MATH 103B,A01,188681,Staff,3,0,35,32
1683359190435,MATH 103B,B01,188692,Staff,5,0,35,30
1683359191461,MATH 109,A01,188695,Salehi Golsefidy; Alireza,25,0,35,10
1683359191461,MATH 109,A02,188696,Salehi Golsefidy; Alireza,25,0,35,10
1683359192486,MATH 120A,A01,188698,Eggers; John Dietrich,7,0,35,28
1683359193511,MATH 142B,A01,188736,Ioana; Adrian,0,2,30,30
1683359193511,MATH 142B,A02,188741,Ioana; Adrian,0,0,30,30
1683359193511,MATH 142B,A03,188743,Ioana; Adrian,0,1,30,30
1683359194592,MATH 168A,A01,188790,Staff,0,9,35,35
1683359195624,MATH 170A,A01,188803,Nie; Jiawang,0,2,35,35
1683359195624,MATH 170A,A02,188811,Nie; Jiawang,0,0,35,35
1683359195624,MATH 170A,A03,188814,Nie; Jiawang,1,0,35,34
1683359195624,MATH 170A,A04,188815,Nie; Jiawang,13,0,35,22
1683359196653,MATH 193B,A01,188817,Staff,0,0,35,35
1683359196653,MATH 193B,A02,188818,Staff,5,0,35,30
1683359197679,MGT 4,A01,202857,Anderson; John Charles,61,0,80,19
1683359198705,MGT 12,A00,202858,Lindenberger; Wade Douglas,42,0,90,48
1683359199733,MGT 18,A00,202859,Staff,74,0,90,16
1683359200759,MGT 18GS,A00,202860,McKay; Michael J,13,0,28,15
1683359201790,MGT 45,A00,202861,Pecore; Joseph P.,14,0,90,76
1683359202815,MGT 100,A00,202863,Yavorsky; Daniel Ryan,28,0,90,62
1683359203845,MGT 103,A00,202864,Ehrich; Kristine R,0,17,90,90
1683359204870,MGT 112,A00,202865,Ehrich; Kristine R,15,0,90,75
1683359205913,MGT 121A,A00,202868,Staff,0,20,0,0
1683359206939,MGT 131B,A00,202869,Anderson; John Charles,59,0,90,31
1683359207969,MGT 136,A00,202871,Lindenberger; Wade Douglas,84,0,90,6
1683359208996,MGT 164,A00,202873,Staff,0,68,90,91
1683359210024,MGT 164GS,A00,202874,McKay; Mary A,13,0,28,15
1683359211049,MGT 180,A00,202875,Staff,0,50,90,91
1683359212078,MMW 11R,A01,205019,Herbst; Matthew,3,0,30,27
1683359212078,MMW 11R,A02,205026,Herbst; Matthew,29,0,30,1
1683359213111,MMW 15,A01,193512,Chang; Edmond Yi-Teh,0,9,28,28
1683359213111,MMW 15,A02,193513,Chang; Edmond Yi-Teh,0,5,28,28
1683359213111,MMW 15,A03,193514,Chang; Edmond Yi-Teh,0,5,28,28
1683359213111,MMW 15,A04,193515,Chang; Edmond Yi-Teh,0,5,28,28
1683359213111,MMW 15,A05,193516,Chang; Edmond Yi-Teh,0,4,28,28
1683359213111,MMW 15,A06,193517,Chang; Edmond Yi-Teh,0,5,28,28
1683359213111,MMW 15,B01,193519,Chang; Edmond Yi-Teh,0,5,28,28
1683359213111,MMW 15,B02,193520,Chang; Edmond Yi-Teh,0,5,28,28
1683359213111,MMW 15,B03,193521,Chang; Edmond Yi-Teh,0,5,28,28
1683359213111,MMW 15,B04,193522,Chang; Edmond Yi-Teh,0,4,28,28
1683359213111,MMW 15,B05,193523,Chang; Edmond Yi-Teh,0,5,28,28
1683359213111,MMW 15,B06,193524,Chang; Edmond Yi-Teh,0,4,28,28
1683359214136,MMW 122,A01,193526,Rahimi; Babak,0,15,28,28
1683359214136,MMW 122,A02,193527,Rahimi; Babak,0,14,28,28
1683359214136,MMW 122,A03,193528,Rahimi; Babak,0,0,0,0
1683359214136,MMW 122,A04,193529,Rahimi; Babak,0,0,0,0
1683359215165,MUS 1A,A01,186663,Staff,0,20,35,35
1683359216192,MUS 4,A01,186715,Staff,0,12,35,35
1683359217217,MUS 5R,A01,186796,Dubnov; Shlomo,0,17,35,35
1683359218241,MUS 6,A01,186798,Staff,0,4,25,25
1683359219270,MUS 7,A01,186830,Staff,13,0,35,22
1683359220295,MUS 8,A01,186930,Staff,0,26,35,35
1683359221320,MUS 15,A01,186932,Staff,0,16,35,35
1683359221320,MUS 15,B01,186934,Staff,0,15,35,35
1683359222351,MUS 80,A00,186935,Staff,0,0,20,20
1683359222351,MUS 80,B00,186936,Staff,25,0,25,0
1683359223390,NANO 11,A00,204702,Lipomi; Darren John,0,0,0,0
1683359224418,NANO 15,A01,204709,Yang; Kesong,0,1,0,0
1683359225448,NANO 114,A00,202069,Jahed Motlagh; Zeinab,3,0,10,7
1683359226474,PHIL 1,A00,186955,Grush; Rick Scott,32,0,40,8
1683359227505,PHIL 10,A01,186973,Grush; Rick Scott,28,0,35,7
1683359227505,PHIL 10,A02,186974,Grush; Rick Scott,33,0,35,2
1683359228529,PHIL 13,A01,186976,Staff,7,0,35,28
1683359228529,PHIL 13,A02,186977,Staff,16,0,35,19
1683359229559,PHIL 14,A01,186979,Staff,31,0,35,4
1683359229559,PHIL 14,A02,186986,Staff,32,0,35,3
1683359230585,PHIL 28,A01,186988,Staff,16,0,30,14
1683359230585,PHIL 28,A02,186989,Staff,1,0,30,29
1683359230585,PHIL 28,A03,186990,Staff,9,0,30,21
1683359230585,PHIL 28,A04,186991,Staff,26,0,30,4
1683359231639,PHIL 120,A00,186997,Staff,23,0,40,17
1683359232666,PHIL 137,A00,187003,Staff,9,0,40,31
1683359233697,PHIL 150,A00,187015,Staff,47,0,70,23
1683359234723,PHIL 167,A00,187021,Lamey; Andy M.,35,0,40,5
1683359235750,PHIL 174,A01,202226,Staff,17,0,20,3
1683359235750,PHIL 174,A02,202235,Staff,20,0,20,0
1683359236780,PHIL 191A,A00,258918,Staff,0,0,1,1
1683359237808,PHYS 1A,A00,187028,Staff,27,0,60,33
1683359238834,PHYS 1AL,001,187036,Staff,2,0,30,28
1683359238834,PHYS 1AL,002,187049,Staff,18,0,30,12
1683359239863,PHYS 1B,A00,187058,Staff,22,0,60,38
1683359240891,PHYS 1BL,001,187064,Staff,0,0,30,30
1683359240891,PHYS 1BL,002,187070,Staff,5,0,30,25
1683359241917,PHYS 1C,A00,187082,Staff,31,0,120,89
1683359242949,PHYS 1CL,001,187088,Staff,0,9,30,30
1683359242949,PHYS 1CL,002,187089,Staff,0,2,30,30
1683359242949,PHYS 1CL,009,262693,Staff,11,0,30,19
1683359243974,PHYS 2B,A01,187097,Staff,54,0,115,61
1683359245015,PHYS 2C,A01,187099,Staff,67,0,115,48
1683359246052,PHYS 2CL,A01,187101,Staff,5,0,28,23
1683359246052,PHYS 2CL,A02,187102,Staff,15,0,28,13
1683359247079,PHYS 2D,A01,187123,Shotwell; Brian,95,0,115,20
1683359248104,PHYS 4B,A01,187133,Grinstein; Benjamin,35,0,50,15
1683359249135,POLI 10,A00,188819,Staff,0,4,50,50
1683359250161,POLI 11,A00,188827,Staff,43,0,50,7
1683359251190,POLI 13R,A00,188828,Staff,0,1,20,20
1683359252222,POLI 27,A01,188830,Elgin; Samuel Zincke,0,1,70,70
1683359253249,POLI 30,A00,188832,Desposato; Scott,31,0,50,19
1683359254278,POLI 102F,A00,188834,Staff,3,0,40,37
1683359255302,POLI 104A,A00,188852,Staff,14,0,30,16
1683359256334,POLI 104I,A00,188853,Staff,0,6,20,20
1683359257359,POLI 110B,A00,188854,Wiens; David,7,0,20,13
1683359258384,POLI 112A,A00,188855,Wiens; David,5,0,30,25
1683359259412,POLI 117R,A00,188856,Forman; Fonna,0,11,20,20
1683359260437,POLI 118,A00,188857,Ingham; Sean,8,0,20,12
1683359261462,POLI 120G,A00,188858,Staff,9,0,30,21
1683359262493,POLI 131CR,A00,188863,Hoston; Germaine,23,0,50,27
1683359263521,POLI 133,A00,188864,Nellis; Gareth Hb,44,0,50,6
1683359264551,POLI 134D,A00,188865,Desposato; Scott,27,0,30,3
1683359265579,POLI 142A,A00,188871,Gartzke; Erik,22,0,50,28
1683359266605,POLI 142K,A00,188874,Staff,38,0,50,12
1683359267638,POLI 143,A00,188940,Gartzke; Erik,16,0,30,14
1683359268666,POLI 153,A00,188943,Staff,3,0,20,17
1683359269694,POLI 160AA,A00,188944,Staff,11,0,40,29
1683359270723,POLI 170A,A00,188945,Staff,11,0,30,19
1683359272773,PSYC 1,A00,188952,Staff,37,0,90,53
1683359273804,PSYC 2,B00,188953,Staff,19,0,35,16
1683359274830,PSYC 6,A00,188970,Staff,47,0,60,13
1683359275859,PSYC 7,A00,188973,Staff,37,0,45,8
1683359276886,PSYC 60,A01,188980,Rickard; Timothy C.,43,0,60,17
1683359277912,PSYC 70,A01,189001,Steiner; Eric Tomas,23,0,45,22
1683359278939,PSYC 100,A00,189005,Lacefield; Katharine I,0,98,120,120
1683359279964,PSYC 102,A00,189008,Staff,9,0,30,21
1683359280990,PSYC 106,B00,189026,Gorman; Michael R.,34,0,60,26
1683359282016,PSYC 114,B01,189033,Winkielman; Piotr,0,32,30,30
1683359283042,PSYC 131,A00,189036,Anagnostaras; Stephan,0,43,60,60
1683359284073,PSYC 136,A00,189041,Lowe; Angela Beth,0,7,25,25
1683359285097,PSYC 137,A00,189057,Winkielman; Piotr,0,34,25,25
1683359286127,PSYC 144,A00,189107,Wixted; John T,0,7,50,50
1683359288184,PSYC 162,A00,189142,Staff,0,8,85,85
1683359289209,PSYC 172,A00,189144,Gorman; Michael R.,0,7,30,30
1683359291258,PSYC 179,A00,189146,Lacefield; Katharine I,0,84,120,120
1683359292288,PSYC 181,A00,189147,Anagnostaras; Stephan,0,44,90,90
1683359293315,PSYC 190R,A00,189148,Barner; David A.,0,22,80,80
1683359294344,PSYC 191,A00,189275,Rickard; Timothy C.,0,7,25,25
1683359295371,PSYC 193,A00,189276,Chapman; Eddie Nathaniel,0,1,0,4
1683359296402,PSYC 193L,A01,189281,Lowe; Angela Beth,12,0,20,8
1683359296402,PSYC 193L,B01,189285,Staff,28,0,35,7
1683359297429,RELI 149,A00,187137,Rahimi; Babak,7,0,40,33
1683359298515,SE 9,A01,187315,Staff,0,2,18,18
1683359299544,SE 101B,A00,187409,Staff,24,0,30,6
1683359300571,SE 110B,A00,187444,Staff,10,0,40,30
1683359301600,SE 130B,A00,187449,Staff,31,0,40,9
1683359302630,SE 150A,A00,187516,Staff,9,0,20,11
1683359303657,SE 154,A00,187528,Staff,30,0,50,20
1683359304684,SIO 3,A01,258171,Staff,35,0,40,5
1683359305709,SIO 10,A00,187144,Cook; Geoffrey W,0,3,75,75
1683359306737,SIO 45,A00,187152,Cook; Geoffrey W,1,0,100,99
1683359307761,SIO 109R,A00,194486,Staff,0,3,20,20
1683359309817,SIO 187,A01,187233,Kacev; David,12,0,40,28
1683359310848,SOCI 1,A01,258656,Thorpe; Charles Robert,28,0,30,2
1683359310848,SOCI 1,A02,258658,Thorpe; Charles Robert,30,0,30,0
1683359310848,SOCI 1,A03,258661,Thorpe; Charles Robert,25,0,25,0
1683359310848,SOCI 1,A04,258666,Thorpe; Charles Robert,22,0,25,3
1683359310848,SOCI 1,A05,258897,Thorpe; Charles Robert,23,0,25,2
1683359310848,SOCI 1,A06,258898,Thorpe; Charles Robert,25,0,25,0
1683359311875,SOCI 30,A01,258903,Pardo Guerra; Juan Pablo,15,0,30,15
1683359312904,SOCI 102,A00,258904,Staff,9,0,25,16
1683359313933,SOCI 106,A00,258905,Staff,19,0,25,6
1683359314958,SOCI 111,A00,258907,Ribas Norris; Janet Vanesa,26,0,30,4
1683359315985,SOCI 121R,A00,258908,Pardo Guerra; Juan Pablo,10,0,30,20
1683359317010,SOCI 126,A01,203330,Staff,14,0,20,6
1683359318039,SOCI 131,A00,258909,Thorpe; Charles Robert,31,0,60,29
1683359319068,SOCI 135,A00,258910,Payne; Christine Anna,0,9,30,30
1683359320095,SOCI 157,A00,258911,Staff,12,0,30,18
1683359321124,SOCI 184,A00,258912,Staff,25,0,30,5
1683359322147,SOCI 188D,A00,258913,Staff,22,0,30,8
1683359323177,SYN 2,001,187529,Staff,10,0,16,6
1683359323177,SYN 2,002,201452,Staff,0,18,16,16
1683359323177,SYN 2,003,201469,Staff,3,0,16,13
1683359324205,SYN 100,A01,187531,Staff,0,9,20,20
1683359324205,SYN 100,B01,201491,Staff,0,12,20,20
1683359325238,TDAC 1,A00,189286,Walsh; Kim C.,3,0,20,17
1683359325238,TDAC 1,B00,189287,Harting; Carla Kelso,11,0,20,9
1683359326263,TDAC 101,A00,189300,Walsh; Kim C.,16,0,20,4
1683359326263,TDAC 101,B00,189301,Harting; Carla Kelso,18,0,20,2
1683359327294,TDAC 102,A00,189304,Basso; Beatrice,14,0,20,6
1683359328321,TDAC 108,A00,189305,Staff,18,0,20,2
1683359329352,TDDE 131,A00,189310,Staff,19,0,20,1
1683359329352,TDDE 131,B00,189314,Staff,19,0,20,1
1683359329352,TDDE 131,C00,189315,Staff,48,0,50,2
1683359329352,TDDE 131,D00,189316,Staff,14,0,15,1
1683359329352,TDDE 131,E00,204841,Staff,20,0,20,0
1683359330378,TDGE 10,A00,189289,Staff,30,0,50,20
1683359330378,TDGE 10,B00,189290,Havis; Allan,1,0,50,49
1683359331411,TDGE 11,A00,189291,Fulton; Julia,0,3,50,50
1683359331411,TDGE 11,B00,189292,Staff,20,0,25,5
1683359331411,TDGE 11,C00,260270,Staff,0,0,0,0
1683359332440,TDGE 25,A00,189294,Staff,3,0,20,17
1683359333466,TDGE 124,A00,189318,Fulton; Julia,0,8,50,50
1683359334494,TDGE 125,A00,189319,Staff,13,0,25,12
1683359334494,TDGE 125,B00,189320,Staff,23,0,25,2
1683359335518,TDGE 127,A00,189322,Havis; Allan,0,0,50,50
1683359336544,TDHT 101,A00,189323,Staff,18,0,25,7
1683359336544,TDHT 101,B00,189324,Staff,25,0,25,0
1683359337572,TDHT 102,A00,189325,Staff,49,0,50,1
1683359338600,TDMV 1,A00,189295,Arcidiacono; Kristin,19,0,30,11
1683359338600,TDMV 1,B00,189296,Caligagan; Maria T.,24,0,30,6
1683359339624,TDMV 2,A00,189297,Sammartano; Tonnie,28,0,30,2
1683359339624,TDMV 2,B00,189299,Arcidiacono; Kristin,24,0,30,6
1683359340655,TDMV 3,A00,204998,Rincon; Alicia,22,0,30,8
1683359341679,TDMV 120,A00,189458,Sammartano; Tonnie,28,0,30,2
1683359342705,TDMV 138,A00,189541,Jun; Grace Shin Hae,22,0,40,18
1683359343736,TDMV 142,A00,189717,Caligagan; Tony,23,0,30,7
1683359343736,TDMV 142,B00,189718,Caligagan; Maria T.,25,0,30,5
1683359344763,TMC 2,A01,187533,Staff,25,0,25,0
1683359344763,TMC 2,A02,187534,Staff,25,0,25,0
1683359345794,USP 1,A01,187536,Kwak; Nancy,0,16,25,25
1683359346821,USP 5,A01,187538,Staff,10,0,25,15
1683359347846,USP 101,A00,199253,Staff,0,4,0,0
1683359348870,USP 124,A00,187562,Boomhower; Matthew Charles,1,0,30,29
1683359349895,USP 138,A00,187582,Staff,20,0,25,5
1683359350924,USP 152,A01,187597,Staff,4,0,25,21
1683359351948,USP 153,A00,187598,Staff,19,0,25,6
1683359352974,USP 168,A00,187607,Kwak; Nancy,2,0,5,3
1683359354000,USP 173,A00,187619,Staff,4,0,25,21
1683359355026,USP 181,A00,187638,Staff,0,3,25,25
1683359356057,VIS 103,A00,187650,Cruz; Edwin Teddy,22,0,75,53
1683359357083,VIS 110D,A00,187669,Staff,12,0,22,10
1683359358113,VIS 127C,A00,187720,Shen; Kuiyi,67,0,146,79
1683359359137,VIS 149,A00,187731,Yoldas; Pinar,0,14,22,22
1683359360166,VIS 151,A01,188091,Staff,22,0,34,12
1683359360166,VIS 151,A02,188092,Staff,11,0,34,23
1683359361191,VIS 160B,A00,188093,Stalbaum; Brett,0,0,10,10
1683359363245,WCWP 10B,A00,201720,Staff,10,0,15,5
1683359363245,WCWP 10B,B00,201722,Staff,9,0,15,6
1683359364278,WCWP 100,A00,201725,Gagnon; Jeffrey C,0,0,2,2
1683359364278,WCWP 100,B00,201727,Staff,0,4,15,15
1683359367417,ANBI 133,A00,258401,Wilder; Linnea Lorene,34,0,40,6
1683359368446,ANBI 140,A00,258395,Hrvoj Mihic; Branka,18,0,25,7
1683359369474,ANSC 120,A00,258402,Bialecki; Jon Anthony,27,0,40,13
1683359370499,ANSC 144,A00,258400,Staff,14,0,40,26
1683359372550,ANSC 166,A00,258396,Parish; Steven Martin,157,0,175,18
1683359373574,ANSC 180,A00,193533,Staff,9,0,20,11
1683359374600,ANSC 188,A00,258397,Jassal; Aftab,33,0,40,7
1683359375623,ANTH 3,A01,258316,Staff,23,0,30,7
1683359376649,ANTH 5,A00,258394,Semendeferi; Ekaterini,16,0,20,4
1683359377675,ANTH 21,A01,258331,Staff,8,0,40,32
1683359378700,ANTH 103,A00,258398,Varma; Saiba,15,0,25,10
1683359379740,AWP 10,001,202034,Staff,0,0,0,0
1683359379740,AWP 10,002,202035,Staff,0,0,0,0
1683359379740,AWP 10,003,202036,Staff,0,0,0,0
1683359379740,AWP 10,004,202037,Staff,0,0,0,0
1683359379740,AWP 10,005,202038,Staff,0,0,0,0
1683359379740,AWP 10,006,202039,Staff,0,0,0,0
1683359379740,AWP 10,007,202040,Staff,0,0,0,0
1683359379740,AWP 10,008,202041,Staff,0,0,0,0
1683359379740,AWP 10,009,202042,Staff,0,0,0,0
1683359379740,AWP 10,010,202043,Staff,0,0,0,0
1683359379740,AWP 10,011,202044,Staff,0,0,0,0
1683359379740,AWP 10,012,202045,Staff,0,0,0,0
1683359379740,AWP 10,013,202046,Staff,0,0,0,0
1683359379740,AWP 10,014,202047,Staff,0,0,0,0
1683359379740,AWP 10,015,202048,Staff,0,0,0,0
1683359379740,AWP 10,016,202049,Staff,0,0,0,0
1683359379740,AWP 10,017,202050,Staff,0,0,0,0
1683359379740,AWP 10,018,202051,Staff,0,0,0,0
1683359379740,AWP 10,019,202052,Staff,0,0,0,0
1683359379740,AWP 10,020,202053,Staff,0,0,0,0
1683359379740,AWP 10,021,202054,Staff,0,0,0,0
1683359379740,AWP 10,022,202055,Staff,0,0,0,0
1683359379740,AWP 10,023,202056,Staff,0,0,0,0
1683359379740,AWP 10,024,202057,Staff,0,0,0,0
1683359379740,AWP 10,025,202058,Staff,0,0,0,0
1683359379740,AWP 10,026,202059,Staff,0,0,0,0
1683359380765,AWP 102,001,202032,Staff,0,0,0,0
1683359380765,AWP 102,002,202033,Staff,0,0,0,0
1683359381795,BENG 100,A01,254234,Taylor Amos; Alyssa C,31,0,40,9
1683359382819,BENG 196,001,270013,Engler; Adam J.,9999,0,9999,0
1683359383846,BICD 100R,A01,202018,Smith; Laurie,0,7,32,32
1683359383846,BICD 100R,A02,202019,Smith; Laurie,0,2,32,32
1683359383846,BICD 100R,A03,202020,Smith; Laurie,0,1,32,32
1683359383846,BICD 100R,A04,202021,Smith; Laurie,9,0,32,23
1683359383846,BICD 100R,A05,202022,Smith; Laurie,12,0,32,20
1683359384882,BICD 136,A01,193242,Gustafson-Brown; Cindy,0,2,32,32
1683359384882,BICD 136,A02,193244,Gustafson-Brown; Cindy,14,0,32,18
1683359385916,BIEB 102,A01,193249,Butler; Shannon Rhey,0,2,32,32
1683359385916,BIEB 102,A02,193251,Butler; Shannon Rhey,0,0,32,32
1683359385916,BIEB 102,A03,193253,Butler; Shannon Rhey,0,1,32,32
1683359385916,BIEB 102,A04,193255,Butler; Shannon Rhey,17,0,32,15
1683359385916,BIEB 102,A05,193265,Butler; Shannon Rhey,26,0,32,6
1683359385916,BIEB 102,A06,193269,Butler; Shannon Rhey,16,0,32,16
1683359387970,BIEB 150,A01,193274,Staff,0,0,32,32
1683359387970,BIEB 150,A02,193285,Staff,23,0,32,9
1683359388998,BIEB 194,A00,193286,Kurle; Carolyn M.,22,0,32,10
1683359390029,BILD 1,A01,192291,Staff,16,0,32,16
1683359390029,BILD 1,A02,192292,Staff,30,0,32,2
1683359390029,BILD 1,B01,192520,Reuther; Keefe,0,1,0,0
1683359390029,BILD 1,B02,192532,Reuther; Keefe,0,1,0,0
1683359391073,BILD 3,A01,192556,Butler; Shannon Rhey,0,0,32,32
1683359391073,BILD 3,A02,192581,Butler; Shannon Rhey,4,0,32,28
1683359391073,BILD 3,A03,192611,Butler; Shannon Rhey,23,0,32,9
1683359391073,BILD 3,A04,192612,Butler; Shannon Rhey,25,0,32,7
1683359391073,BILD 3,A05,192613,Butler; Shannon Rhey,27,0,32,5
1683359391073,BILD 3,A06,192679,Butler; Shannon Rhey,27,0,32,5
1683359391073,BILD 3,A07,192682,Butler; Shannon Rhey,22,0,32,10
1683359392097,BILD 4,A01,192836,Reuther; Keefe,0,0,24,24
1683359392097,BILD 4,A02,193044,Reuther; Keefe,4,0,24,20
1683359393123,BILD 10,A01,193142,Gustafson-Brown; Cindy,30,0,32,2
1683359393123,BILD 10,A02,193149,Gustafson-Brown; Cindy,31,0,32,1
1683359394154,BIMM 100,A01,193301,Staff,0,6,32,32
1683359394154,BIMM 100,A02,193312,Staff,0,5,32,32
1683359394154,BIMM 100,A03,193323,Staff,0,8,32,32
1683359395184,BIMM 101,A01,193329,McDonnell; Lisa Marie,0,3,24,24
1683359395184,BIMM 101,A02,193339,McDonnell; Lisa Marie,0,3,24,24
1683359395184,BIMM 101,B01,193354,McDonnell; Lisa Marie,0,3,24,24
1683359395184,BIMM 101,B02,193357,McDonnell; Lisa Marie,0,3,24,24
1683359396209,BIMM 110,A01,193377,Tat; John,0,11,32,32
1683359396209,BIMM 110,A02,193378,Tat; John,0,9,32,32
1683359397238,BIMM 120,A01,206116,Staff,0,0,32,32
1683359397238,BIMM 120,A02,206117,Staff,8,0,32,24
1683359397238,BIMM 120,A03,206121,Staff,21,0,32,11
1683359398272,BIPN 100,A01,193393,Park; Ji Young,0,14,32,32
1683359398272,BIPN 100,A02,193402,Park; Ji Young,0,13,32,32
1683359398272,BIPN 100,A03,193413,Park; Ji Young,0,14,32,32
1683359398272,BIPN 100,A04,193414,Park; Ji Young,0,13,32,32
1683359399298,BIPN 102,A01,193429,Staff,0,0,32,32
1683359399298,BIPN 102,A02,193438,Staff,22,0,32,10
1683359400322,BIPN 106,A01,193450,Reyes Gonzalez; Catalina,0,2,40,40
1683359401355,BIPN 134,A01,193465,Cooke; James Edward,1,0,32,31
1683359401355,BIPN 134,A02,193474,Cooke; James Edward,25,0,32,7
1683359401355,BIPN 134,A03,193485,Cooke; James Edward,29,0,32,3
1683359401355,BIPN 134,A04,193486,Cooke; James Edward,21,0,32,11
1683359401355,BIPN 134,A05,193491,Cooke; James Edward,31,0,32,1
1683359401355,BIPN 134,A06,193501,Cooke; James Edward,30,0,32,2
1683359401355,BIPN 134,A07,193510,Cooke; James Edward,29,0,32,3
1683359403501,BISP 194,A00,222522,Staff,14,0,32,18
1683359404526,CAT 124,A01,202407,Staff,19,0,25,6
1683359405553,CAT 125,A00,202408,Marchisotto; Jennifer Anne,4,0,20,16
1683359406591,CAT 125R,A00,202409,Smith; Lauryn Alissa,0,11,20,20
1683359406591,CAT 125R,B00,202410,Morales; Celeste Georgianna,0,11,20,20
1683359406591,CAT 125R,C00,202411,Irwin; Matthew Joseph,0,10,20,20
1683359407618,CENG 15,A01,204712,Yang; Kesong,0,1,0,0
1683359408643,CENG 114,A00,202070,Jahed Motlagh; Zeinab,5,0,20,15
1683359409675,CGS 105,A00,185477,Wesling; Megan E.,24,0,40,16
1683359410706,CGS 106,A00,185494,Staff,13,0,22,9
1683359411730,CGS 108,A00,185495,Staff,14,0,20,6
1683359412754,CGS 114,A00,185496,Staff,13,0,18,5
1683359413779,CGS 119,A00,185501,Staff,15,0,20,5
1683359414804,CGS 120,A00,185511,Staff,13,0,20,7
1683359415830,CHEM 4,A01,184675,Bussey; Thomas J,96,0,100,4
1683359416856,CHEM 6A,A01,184677,Staff,34,0,60,26
1683359417887,CHEM 6B,A01,184679,Staff,65,0,100,35
1683359418911,CHEM 6C,A01,184681,Bussey; Thomas J,1,0,50,49
1683359418911,CHEM 6C,A02,184682,Bussey; Thomas J,34,0,50,16
1683359419936,CHEM 40A,A01,184684,Albizati; Kim F.,37,0,100,63
1683359420966,CHEM 40B,A01,184686,Albizati; Kim F.,0,20,100,100
1683359421991,CHEM 41B,A01,184690,Staff,52,0,100,48
1683359423021,COGS 3,A01,184715,Boyle; Mary E. T.,0,25,40,40
1683359424051,COGS 14B,A01,185172,Staff,0,15,38,38
1683359425077,COGS 18,A01,184736,Staff,17,0,80,63
1683359426118,COGS 100,A01,184932,Staff,0,5,73,73
1683359427142,COGS 101A,A01,184935,Staff,0,39,30,30
1683359428165,COGS 101B,A01,184944,Staff,0,2,30,30
1683359429194,COGS 101C,A01,184946,Staff,0,12,30,30
1683359430230,COGS 102A,A01,184951,Johnson; Christine M.,2,0,40,38
1683359431256,COGS 107B,A01,184953,Mooshagian; Eric Frederick,0,50,40,40
1683359432287,COGS 118B,A01,184959,Gupta; Anjum,0,48,40,40
1683359433318,COGS 153,A00,184961,Staff,0,15,30,30
1683359434343,COGS 177,A00,184962,Staff,0,20,30,30
1683359435372,COGS 187A,A01,184969,Boyle; Mary E. T.,0,17,40,40
1683359436398,COMM 10,A01,185174,Staff,0,5,25,25
1683359436398,COMM 10,A02,185189,Staff,0,5,25,25
1683359436398,COMM 10,A03,269821,Staff,0,0,0,0
1683359437424,COMM 100B,A01,185475,Staff,0,0,0,2
1683359437424,COMM 100B,A02,185476,Staff,13,0,25,12
1683359438449,COMM 100C,A01,185314,Staff,1,0,25,24
1683359438449,COMM 100C,A02,185327,Staff,19,0,25,6
1683359439474,COMM 110M,A00,185349,Staff,2,0,40,38
1683359440498,COMM 113T,A00,185352,Staff,24,0,40,16
1683359441522,COMM 114I,A00,185353,Staff,33,0,40,7
1683359442549,COMM 131,A00,185354,Staff,19,0,30,11
1683359443574,CSE 8A,A50,185358,Cao; Yingjun,0,46,10,10
1683359444601,CSE 8B,A01,185362,Staff,0,46,50,50
1683359445625,CSE 11,A01,185416,Cao; Yingjun,0,92,10,10
1683359446652,CSE 20,A01,185445,Briones; Jor-el Thomas Caparas,5,0,25,20
1683359447684,CSE 21,A01,185447,Staff,10,0,50,40
1683359448716,CSE 101,A01,185451,Staff,0,13,50,50
1683359448716,CSE 101,B01,185453,Jones; Miles E,0,11,50,50
1683359450767,CSE 141,A01,185458,Eldon; John,20,0,100,80
1683359451798,CSE 141L,A01,185461,Eldon; John,12,0,100,88
1683359452823,CSE 142,A01,185463,Staff,36,0,60,24
1683359452823,CSE 142,B01,201355,Staff,0,7,60,60
1683359453850,CSE 142L,A01,185470,Staff,36,0,60,24
1683359453850,CSE 142L,B01,201417,Staff,0,6,60,60
1683359454875,CSE 190,A00,201433,Staff,32,0,49,17
1683359455908,DOC 1,A01,259136,Strom; Megan C.,7,0,15,8
1683359455908,DOC 1,A02,259137,Strom; Megan C.,14,0,15,1
1683359455908,DOC 1,A03,259138,Strom; Megan C.,14,0,15,1
1683359455908,DOC 1,A04,259139,Strom; Megan C.,14,0,15,1
1683359456933,DOC 100D,A00,259140,Pass; Natalye Joann,16,0,25,9
1683359457962,DSGN 1,A01,184749,Rill; Bryan,0,25,30,30
1683359458986,DSGN 100,A01,185168,Staff,0,2,25,25
1683359460026,ECE 5,A01,185626,Morris; Karcher William,0,10,0,0
1683359461054,ECE 101,A01,185628,Staff,17,0,70,53
1683359462079,ECE 107,A01,185635,Baghdadchi; Saharnaz,0,0,20,20
1683359462079,ECE 107,A02,185638,Baghdadchi; Saharnaz,4,0,20,16
1683359463111,ECE 148,A01,185647,Silberman; Jack,0,0,16,16
1683359464135,ECON 1,A01,185537,Crane; Meredith Helen,54,0,70,16
1683359465165,ECON 3,A01,185549,Crane; Meredith Helen,32,0,70,38
1683359466198,ECON 4,A01,203354,Anderson; John Charles,0,4,10,10
1683359467223,ECON 100A,A01,185574,Staff,0,4,40,40
1683359468254,ECON 100B,A01,185576,Staff,0,12,50,50
1683359469280,ECON 100C,A01,185589,Newhouse; Herbert S,29,0,70,41
1683359470304,ECON 105,A00,185608,Vespa; Emanuel Ignacio,19,0,35,16
1683359471334,ECON 109,A01,185610,Shishkin; Denis,10,0,35,25
1683359472359,ECON 110A,A01,185612,Staff,11,0,40,29
1683359473384,ECON 120A,A01,185615,Staff,20,0,40,20
1683359474419,ECON 120C,A01,185617,Sun; Yixiao,0,21,70,70
1683359475450,ECON 144,A00,203346,Squires; Dale E,3,0,35,32
1683359476475,ECON 171,A01,203349,Newhouse; Herbert S,0,1,35,35
1683359477506,ECON 173A,A01,185621,Toda; Alexis Akira,21,0,35,14
1683359478542,EDS 25,A01,202413,Staff,0,1,0,0
1683359478542,EDS 25,A02,202414,Staff,0,1,0,0
1683359478542,EDS 25,A03,202415,Staff,0,0,0,0
1683359478542,EDS 25,A04,202416,Staff,0,1,0,0
1683359478542,EDS 25,A05,202439,Staff,0,0,0,0
1683359478542,EDS 25,A06,202440,Staff,0,0,0,0
1683359478542,EDS 25,B01,202631,Staff,0,0,0,0
1683359478542,EDS 25,B02,202632,Staff,0,0,0,0
1683359478542,EDS 25,B03,202639,Staff,0,0,0,0
1683359478542,EDS 25,B04,202640,Staff,0,0,0,0
1683359478542,EDS 25,B05,202643,Staff,0,0,0,0
1683359478542,EDS 25,B06,202644,Staff,0,0,0,0
1683359479572,EDS 38,A01,202659,Black; Alison Michelle,24,0,25,1
1683359480598,EDS 115,A00,202652,Staff,18,0,30,12
1683359481627,EDS 125,A00,202649,Staff,14,0,30,16
1683359482654,EDS 126,A01,203332,Staff,30,0,30,0
1683359483679,EDS 139,A00,202838,Staff,16,0,25,9
1683359484706,EDS 146,A01,202655,Staff,14,0,25,11
1683359485731,ENG 15,A00,185667,Staff,0,1,0,0
1683359485731,ENG 15,B00,185672,Staff,0,0,0,0
1683359485731,ENG 15,C00,185675,Staff,0,0,0,0
1683359485731,ENG 15,D00,185682,Staff,0,0,0,0
1683359485731,ENG 15,E00,185684,Staff,0,0,0,0
1683359486765,ETHN 103,A00,185710,Staff,0,4,35,35
1683359487791,ETHN 103A,A00,199228,Man; Simeon S,2,0,9,7
1683359488817,ETHN 109,A00,185711,Staff,18,0,35,17
1683359489845,ETHN 142,A00,185726,Staff,0,4,30,30
1683359490870,ETHN 163J,A00,199229,Man; Simeon S,5,0,8,3
1683359491894,ETHN 168,A00,185727,Staff,8,0,10,2
1683359492919,ETHN 182,A00,185728,Staff,0,0,35,35
1683359493946,ETHN 183,A00,185737,Staff,8,0,18,10
1683359494974,GLBH 111,A01,209361,Burgos; Jose L.,0,0,0,0
1683359497030,HIEU 104,A00,185792,Staff,16,0,20,4
1683359498061,HIEU 115,A00,185800,Staff,1,0,20,19
1683359499090,HIEU 128,A00,185801,Staff,0,7,20,20
1683359500118,HIEU 147,A00,185802,Staff,16,0,20,4
1683359501144,HIEU 154,A00,185823,Staff,12,0,20,8
1683359502171,HILA 102,A00,185826,Staff,13,0,20,7
1683359503196,HILD 2C,A01,185778,Staff,0,12,20,20
1683359504222,HILD 7B,A01,185780,Kwak; Nancy,0,15,32,32
1683359504222,HILD 7B,A02,185781,Kwak; Nancy,0,18,32,32
1683359505252,HILD 30,A01,185791,Staff,14,0,20,6
1683359506334,HISC 119,A00,185830,Golan; Tal,0,9,20,20
1683359507363,HITO 156GS,A00,185831,Patterson; Patrick H.,0,0,0,23
1683359508392,HIUS 103,A00,185832,Man; Simeon S,1,6,20,19
1683359509423,HIUS 117,A00,185836,Kwak; Nancy,2,0,20,18
1683359510448,HIUS 125,A00,185840,Man; Simeon S,0,0,23,23
1683359511474,HIUS 149,A00,185845,Staff,0,0,20,20
1683359512502,HUM 3,A01,185882,Zavodny; Tatiana Sophia,0,7,50,50
1683359512502,HUM 3,B01,185899,Caldwell; Michael Alan,0,18,50,50
1683359513528,HUM 3GS,A00,185900,Patterson; Patrick H.,0,0,0,23
1683359514564,HUM 4,A01,185938,Zroka; Amy Liane,31,0,50,19
1683359514564,HUM 4,B01,185956,Watkins; Eric,0,3,50,50
1683359514564,HUM 4,B02,202209,Watkins; Eric,0,2,50,50
1683359514564,HUM 4,B03,202210,Watkins; Eric,0,2,50,50
1683359515591,HUM 5,A01,185958,West; Geoffrey Scott,3,0,50,47
1683359515591,HUM 5,A02,202215,West; Geoffrey Scott,0,0,50,50
1683359516624,INTL 190,A00,185959,Gagnon; Jeffrey C,0,0,0,9
1683359516624,INTL 190,B00,185960,Lettieri; Michael Joseph,0,0,0,1
1683359517650,JAPN 180,A00,254509,Staff,4,0,30,26
1683359518684,LATI 10,A01,202853,Kennemore; Amy Michelle,4,0,35,31
1683359518684,LATI 10,A02,202854,Kennemore; Amy Michelle,2,0,35,33
1683359518684,LATI 10,A03,270054,Kennemore; Amy Michelle,30,0,30,0
1683359519712,LATI 180,A00,202855,Kennemore; Amy Michelle,11,0,20,9
1683359520737,LAWS 101,A00,201767,Golan; Tal,0,7,40,40
1683359521766,LIFR 1C,A00,185961,Staff,6,0,20,14
1683359522791,LIFR 1CX,A00,185962,Staff,7,0,20,13
1683359523820,LIFR 1D,A00,185963,Staff,9,0,20,11
1683359524849,LIFR 1DX,A00,185964,Staff,9,0,20,11
1683359525875,LIGN 101,A01,186039,Staff,43,0,50,7
1683359526902,LIGN 165,A00,186040,Staff,18,0,50,32
1683359527928,LTCS 108,A00,186041,Staff,6,0,10,4
1683359528954,LTCS 119,A00,186042,Staff,16,0,20,4
1683359529979,LTCS 130,A00,186043,Wesling; Megan E.,15,0,25,10
1683359532036,LTEA 138,A00,186119,Staff,14,0,40,26
1683359533068,LTEN 124,A00,186148,Staff,6,0,25,19
1683359534091,LTEN 178,A00,186149,Staff,7,0,15,8
1683359535117,LTEN 181,A00,186150,Blanco; John D,33,0,40,7
1683359536143,LTWL 120,A00,186160,Staff,20,0,25,5
1683359537168,LTWL 165,A00,186161,Staff,22,0,25,3
1683359538194,LTWR 100,A00,186162,Staff,0,5,15,15
1683359539218,LTWR 102,A00,186163,Doller; Ben,5,0,15,10
1683359540245,MAE 8,A01,186412,Staff,0,0,0,0
1683359541272,MAE 30B,A00,186445,Bahadori; Mohammad Yousef,83,0,100,17
1683359542297,MAE 40,A00,186592,Bewley; Thomas R,10,0,50,40
1683359543325,MAE 101B,A00,186593,Bahadori; Mohammad Yousef,81,0,100,19
1683359544360,MAE 105,A00,186594,Bandaru; Prabhakar,12,0,50,38
1683359545385,MAE 107,A00,186599,Pham; Hieu Tan,0,7,120,120
1683359546416,MAE 148,A01,186660,Silberman; Jack,3,0,16,13
1683359547450,MATH 10A,A01,188095,Staff,0,5,35,35
1683359548478,MATH 10B,A01,188097,Bowers; Adam R.,0,11,30,30
1683359548478,MATH 10B,A02,188099,Bowers; Adam R.,0,11,30,30
1683359548478,MATH 10B,B01,188104,Bowers; Adam R.,0,10,30,30
1683359548478,MATH 10B,B02,188106,Bowers; Adam R.,0,10,30,30
1683359549507,MATH 10C,A01,188111,Staff,0,18,30,30
1683359549507,MATH 10C,A02,188127,Staff,0,17,30,30
1683359549507,MATH 10C,A03,188131,Staff,0,18,30,30
1683359549507,MATH 10C,B01,188218,Staff,18,0,30,12
1683359549507,MATH 10C,B02,188244,Staff,13,0,30,17
1683359549507,MATH 10C,B03,188277,Staff,16,0,30,14
1683359561847,MATH 18,A01,188344,Bach; Quang Tran,18,0,30,12
1683359561847,MATH 18,A02,188345,Bach; Quang Tran,11,0,30,19
1683359561847,MATH 18,B01,188353,Bach; Quang Tran,10,0,30,20
1683359561847,MATH 18,B02,188354,Bach; Quang Tran,20,0,30,10
1683359562878,MATH 20A,A01,188374,Staff,12,0,35,23
1683359563904,MATH 20B,A01,188382,Ohm; Ko Woon,6,0,30,24
1683359563904,MATH 20B,A02,188383,Ohm; Ko Woon,22,0,30,8
1683359563904,MATH 20B,B01,188385,Ohm; Ko Woon,7,0,30,23
1683359563904,MATH 20B,B02,188392,Ohm; Ko Woon,22,0,30,8
1683359564937,MATH 20C,A01,188394,Harel; Guershon,10,0,30,20
1683359564937,MATH 20C,A02,188395,Harel; Guershon,15,0,30,15
1683359564937,MATH 20C,B01,188404,Harel; Guershon,4,0,30,26
1683359564937,MATH 20C,B02,188405,Harel; Guershon,19,0,30,11
1683359565970,MATH 20D,A01,188414,Hammock; Frances H,0,1,30,30
1683359565970,MATH 20D,A02,188415,Hammock; Frances H,3,0,30,27
1683359565970,MATH 20D,B01,188447,Hammock; Frances H,1,0,30,29
1683359565970,MATH 20D,B02,188486,Hammock; Frances H,8,0,30,22
1683359567001,MATH 20E,A01,188649,Staff,21,0,30,9
1683359567001,MATH 20E,A02,188650,Staff,23,0,30,7
1683359567001,MATH 20E,A03,188673,Staff,0,0,30,30
1683359568026,MATH 102,A01,188675,Staff,0,35,35,35
1683359569057,MATH 103B,A01,188681,Staff,3,0,35,32
1683359569057,MATH 103B,B01,188692,Staff,5,0,35,30
1683359570084,MATH 109,A01,188695,Salehi Golsefidy; Alireza,25,0,35,10
1683359570084,MATH 109,A02,188696,Salehi Golsefidy; Alireza,25,0,35,10
1683359571117,MATH 120A,A01,188698,Eggers; John Dietrich,7,0,35,28
1683359572143,MATH 142B,A01,188736,Ioana; Adrian,0,2,30,30
1683359572143,MATH 142B,A02,188741,Ioana; Adrian,0,0,30,30
1683359572143,MATH 142B,A03,188743,Ioana; Adrian,0,1,30,30
1683359573167,MATH 168A,A01,188790,Staff,0,9,35,35
1683359574194,MATH 170A,A01,188803,Nie; Jiawang,0,2,35,35
1683359574194,MATH 170A,A02,188811,Nie; Jiawang,0,0,35,35
1683359574194,MATH 170A,A03,188814,Nie; Jiawang,1,0,35,34
1683359574194,MATH 170A,A04,188815,Nie; Jiawang,13,0,35,22
1683359575218,MATH 193B,A01,188817,Staff,0,0,35,35
1683359575218,MATH 193B,A02,188818,Staff,5,0,35,30
1683359576248,MGT 4,A01,202857,Anderson; John Charles,61,0,80,19
1683359577284,MGT 12,A00,202858,Lindenberger; Wade Douglas,42,0,90,48
1683359578307,MGT 18,A00,202859,Staff,74,0,90,16
1683359579336,MGT 18GS,A00,202860,McKay; Michael J,13,0,28,15
1683359580363,MGT 45,A00,202861,Pecore; Joseph P.,14,0,90,76
1683359581393,MGT 100,A00,202863,Yavorsky; Daniel Ryan,28,0,90,62
1683359582422,MGT 103,A00,202864,Ehrich; Kristine R,0,17,90,90
1683359583447,MGT 112,A00,202865,Ehrich; Kristine R,15,0,90,75
1683359584478,MGT 121A,A00,202868,Staff,0,20,0,0
1683359585507,MGT 131B,A00,202869,Anderson; John Charles,59,0,90,31
1683359586533,MGT 136,A00,202871,Lindenberger; Wade Douglas,84,0,90,6
1683359587559,MGT 164,A00,202873,Staff,0,68,90,91
1683359588587,MGT 164GS,A00,202874,McKay; Mary A,13,0,28,15
1683359589612,MGT 180,A00,202875,Staff,0,50,90,91
1683359590642,MMW 11R,A01,205019,Herbst; Matthew,3,0,30,27
1683359590642,MMW 11R,A02,205026,Herbst; Matthew,29,0,30,1
1683359591676,MMW 15,A01,193512,Chang; Edmond Yi-Teh,0,9,28,28
1683359591676,MMW 15,A02,193513,Chang; Edmond Yi-Teh,0,5,28,28
1683359591676,MMW 15,A03,193514,Chang; Edmond Yi-Teh,0,5,28,28
1683359591676,MMW 15,A04,193515,Chang; Edmond Yi-Teh,0,5,28,28
1683359591676,MMW 15,A05,193516,Chang; Edmond Yi-Teh,0,4,28,28
1683359591676,MMW 15,A06,193517,Chang; Edmond Yi-Teh,0,5,28,28
1683359591676,MMW 15,B01,193519,Chang; Edmond Yi-Teh,0,5,28,28
1683359591676,MMW 15,B02,193520,Chang; Edmond Yi-Teh,0,5,28,28
1683359591676,MMW 15,B03,193521,Chang; Edmond Yi-Teh,0,5,28,28
1683359591676,MMW 15,B04,193522,Chang; Edmond Yi-Teh,0,4,28,28
1683359591676,MMW 15,B05,193523,Chang; Edmond Yi-Teh,0,5,28,28
1683359591676,MMW 15,B06,193524,Chang; Edmond Yi-Teh,0,4,28,28
1683359592701,MMW 122,A01,193526,Rahimi; Babak,0,15,28,28
1683359592701,MMW 122,A02,193527,Rahimi; Babak,0,14,28,28
1683359592701,MMW 122,A03,193528,Rahimi; Babak,0,0,0,0
1683359592701,MMW 122,A04,193529,Rahimi; Babak,0,0,0,0
1683359593727,MUS 1A,A01,186663,Staff,0,20,35,35
1683359594755,MUS 4,A01,186715,Staff,0,12,35,35
1683359595780,MUS 5R,A01,186796,Dubnov; Shlomo,0,17,35,35
1683359596805,MUS 6,A01,186798,Staff,0,4,25,25
1683359597830,MUS 7,A01,186830,Staff,13,0,35,22
1683359598860,MUS 8,A01,186930,Staff,0,26,35,35
1683359599886,MUS 15,A01,186932,Staff,0,16,35,35
1683359599886,MUS 15,B01,186934,Staff,0,15,35,35
1683359600911,MUS 80,A00,186935,Staff,0,0,20,20
1683359600911,MUS 80,B00,186936,Staff,25,0,25,0
1683359601945,NANO 11,A00,204702,Lipomi; Darren John,0,0,0,0
1683359602976,NANO 15,A01,204709,Yang; Kesong,0,1,0,0
1683359604007,NANO 114,A00,202069,Jahed Motlagh; Zeinab,3,0,10,7
1683359605035,PHIL 1,A00,186955,Grush; Rick Scott,32,0,40,8
1683359606061,PHIL 10,A01,186973,Grush; Rick Scott,28,0,35,7
1683359606061,PHIL 10,A02,186974,Grush; Rick Scott,33,0,35,2
1683359607087,PHIL 13,A01,186976,Staff,7,0,35,28
1683359607087,PHIL 13,A02,186977,Staff,16,0,35,19
1683359608117,PHIL 14,A01,186979,Staff,31,0,35,4
1683359608117,PHIL 14,A02,186986,Staff,32,0,35,3
1683359609143,PHIL 28,A01,186988,Staff,16,0,30,14
1683359609143,PHIL 28,A02,186989,Staff,1,0,30,29
1683359609143,PHIL 28,A03,186990,Staff,9,0,30,21
1683359609143,PHIL 28,A04,186991,Staff,26,0,30,4
1683359610170,PHIL 120,A00,186997,Staff,23,0,40,17
1683359611197,PHIL 137,A00,187003,Staff,9,0,40,31
1683359612224,PHIL 150,A00,187015,Staff,47,0,70,23
1683359613265,PHIL 167,A00,187021,Lamey; Andy M.,35,0,40,5
1683359614291,PHIL 174,A01,202226,Staff,17,0,20,3
1683359614291,PHIL 174,A02,202235,Staff,20,0,20,0
1683359615320,PHIL 191A,A00,258918,Staff,0,0,1,1
1683359616347,PHYS 1A,A00,187028,Staff,27,0,60,33
1683359617370,PHYS 1AL,001,187036,Staff,2,0,30,28
1683359617370,PHYS 1AL,002,187049,Staff,18,0,30,12
1683359618397,PHYS 1B,A00,187058,Staff,22,0,60,38
1683359619427,PHYS 1BL,001,187064,Staff,0,0,30,30
1683359619427,PHYS 1BL,002,187070,Staff,5,0,30,25
1683359620458,PHYS 1C,A00,187082,Staff,31,0,120,89
1683359621559,PHYS 1CL,001,187088,Staff,0,9,30,30
1683359621559,PHYS 1CL,002,187089,Staff,0,2,30,30
1683359621559,PHYS 1CL,009,262693,Staff,11,0,30,19
1683359622585,PHYS 2B,A01,187097,Staff,54,0,115,61
1683359623610,PHYS 2C,A01,187099,Staff,67,0,115,48
1683359624639,PHYS 2CL,A01,187101,Staff,5,0,28,23
1683359624639,PHYS 2CL,A02,187102,Staff,15,0,28,13
1683359625672,PHYS 2D,A01,187123,Shotwell; Brian,95,0,115,20
1683359626701,PHYS 4B,A01,187133,Grinstein; Benjamin,35,0,50,15
1683359627731,POLI 10,A00,188819,Staff,0,4,50,50
1683359628759,POLI 11,A00,188827,Staff,43,0,50,7
1683359629784,POLI 13R,A00,188828,Staff,0,1,20,20
1683359630811,POLI 27,A01,188830,Elgin; Samuel Zincke,0,1,70,70
1683359631836,POLI 30,A00,188832,Desposato; Scott,31,0,50,19
1683359632866,POLI 102F,A00,188834,Staff,3,0,40,37
1683359633891,POLI 104A,A00,188852,Staff,14,0,30,16
1683359634915,POLI 104I,A00,188853,Staff,0,6,20,20
1683359635939,POLI 110B,A00,188854,Wiens; David,7,0,20,13
1683359636963,POLI 112A,A00,188855,Wiens; David,5,0,30,25
1683359637991,POLI 117R,A00,188856,Forman; Fonna,0,11,20,20
1683359639021,POLI 118,A00,188857,Ingham; Sean,8,0,20,12
1683359640051,POLI 120G,A00,188858,Staff,9,0,30,21
1683359641084,POLI 131CR,A00,188863,Hoston; Germaine,23,0,50,27
1683359642110,POLI 133,A00,188864,Nellis; Gareth Hb,44,0,50,6
1683359643137,POLI 134D,A00,188865,Desposato; Scott,27,0,30,3
1683359644164,POLI 142A,A00,188871,Gartzke; Erik,22,0,50,28
1683359645189,POLI 142K,A00,188874,Staff,38,0,50,12
1683359646215,POLI 143,A00,188940,Gartzke; Erik,16,0,30,14
1683359647239,POLI 153,A00,188943,Staff,3,0,20,17
1683359648267,POLI 160AA,A00,188944,Staff,11,0,40,29
1683359649291,POLI 170A,A00,188945,Staff,11,0,30,19
1683359651350,PSYC 1,A00,188952,Staff,37,0,90,53
1683359652374,PSYC 2,B00,188953,Staff,19,0,35,16
1683359653402,PSYC 6,A00,188970,Staff,47,0,60,13
1683359654428,PSYC 7,A00,188973,Staff,37,0,45,8
1683359655454,PSYC 60,A01,188980,Rickard; Timothy C.,43,0,60,17
1683359656481,PSYC 70,A01,189001,Steiner; Eric Tomas,23,0,45,22
1683359657507,PSYC 100,A00,189005,Lacefield; Katharine I,0,98,120,120
1683359658531,PSYC 102,A00,189008,Staff,9,0,30,21
1683359659556,PSYC 106,B00,189026,Gorman; Michael R.,34,0,60,26
1683359660585,PSYC 114,B01,189033,Winkielman; Piotr,0,32,30,30
1683359661612,PSYC 131,A00,189036,Anagnostaras; Stephan,0,43,60,60
1683359662645,PSYC 136,A00,189041,Lowe; Angela Beth,0,7,25,25
1683359663670,PSYC 137,A00,189057,Winkielman; Piotr,0,34,25,25
1683359664699,PSYC 144,A00,189107,Wixted; John T,0,7,50,50
1683359666748,PSYC 162,A00,189142,Staff,0,8,85,85
1683359667778,PSYC 172,A00,189144,Gorman; Michael R.,0,7,30,30
1683359669828,PSYC 179,A00,189146,Lacefield; Katharine I,0,84,120,120
1683359670854,PSYC 181,A00,189147,Anagnostaras; Stephan,0,44,90,90
1683359671880,PSYC 190R,A00,189148,Barner; David A.,0,22,80,80
1683359672904,PSYC 191,A00,189275,Rickard; Timothy C.,0,7,25,25
1683359673930,PSYC 193,A00,189276,Chapman; Eddie Nathaniel,0,1,0,4
1683359674957,PSYC 193L,A01,189281,Lowe; Angela Beth,12,0,20,8
1683359674957,PSYC 193L,B01,189285,Staff,28,0,35,7
1683359675991,RELI 149,A00,187137,Rahimi; Babak,7,0,40,33
1683359677022,SE 9,A01,187315,Staff,0,2,18,18
1683359678054,SE 101B,A00,187409,Staff,24,0,30,6
1683359679083,SE 110B,A00,187444,Staff,10,0,40,30
1683359680106,SE 130B,A00,187449,Staff,31,0,40,9
1683359681131,SE 150A,A00,187516,Staff,9,0,20,11
1683359682155,SE 154,A00,187528,Staff,30,0,50,20
1683359683179,SIO 3,A01,258171,Staff,35,0,40,5
1683359684204,SIO 10,A00,187144,Cook; Geoffrey W,0,3,75,75
1683359685229,SIO 45,A00,187152,Cook; Geoffrey W,1,0,100,99
1683359686252,SIO 109R,A00,194486,Staff,0,3,20,20
1683359688302,SIO 187,A01,187233,Kacev; David,12,0,40,28
1683359689333,SOCI 1,A01,258656,Thorpe; Charles Robert,28,0,30,2
1683359689333,SOCI 1,A02,258658,Thorpe; Charles Robert,30,0,30,0
1683359689333,SOCI 1,A03,258661,Thorpe; Charles Robert,25,0,25,0
1683359689333,SOCI 1,A04,258666,Thorpe; Charles Robert,22,0,25,3
1683359689333,SOCI 1,A05,258897,Thorpe; Charles Robert,23,0,25,2
1683359689333,SOCI 1,A06,258898,Thorpe; Charles Robert,25,0,25,0
1683359690359,SOCI 30,A01,258903,Pardo Guerra; Juan Pablo,15,0,30,15
1683359691385,SOCI 102,A00,258904,Staff,9,0,25,16
1683359692411,SOCI 106,A00,258905,Staff,19,0,25,6
1683359693437,SOCI 111,A00,258907,Ribas Norris; Janet Vanesa,26,0,30,4
1683359694462,SOCI 121R,A00,258908,Pardo Guerra; Juan Pablo,10,0,30,20
1683359695489,SOCI 126,A01,203330,Staff,14,0,20,6
1683359696513,SOCI 131,A00,258909,Thorpe; Charles Robert,31,0,60,29
1683359697537,SOCI 135,A00,258910,Payne; Christine Anna,0,9,30,30
1683359698563,SOCI 157,A00,258911,Staff,12,0,30,18
1683359699591,SOCI 184,A00,258912,Staff,25,0,30,5
1683359700618,SOCI 188D,A00,258913,Staff,22,0,30,8
1683359701648,SYN 2,001,187529,Staff,10,0,16,6
1683359701648,SYN 2,002,201452,Staff,0,18,16,16
1683359701648,SYN 2,003,201469,Staff,3,0,16,13
1683359702672,SYN 100,A01,187531,Staff,0,9,20,20
1683359702672,SYN 100,B01,201491,Staff,0,12,20,20
1683359703697,TDAC 1,A00,189286,Walsh; Kim C.,3,0,20,17
1683359703697,TDAC 1,B00,189287,Harting; Carla Kelso,11,0,20,9
1683359704723,TDAC 101,A00,189300,Walsh; Kim C.,16,0,20,4
1683359704723,TDAC 101,B00,189301,Harting; Carla Kelso,18,0,20,2
1683359705750,TDAC 102,A00,189304,Basso; Beatrice,14,0,20,6
1683359706774,TDAC 108,A00,189305,Staff,18,0,20,2
1683359707810,TDDE 131,A00,189310,Staff,19,0,20,1
1683359707810,TDDE 131,B00,189314,Staff,19,0,20,1
1683359707810,TDDE 131,C00,189315,Staff,48,0,50,2
1683359707810,TDDE 131,D00,189316,Staff,14,0,15,1
1683359707810,TDDE 131,E00,204841,Staff,20,0,20,0
1683359708840,TDGE 10,A00,189289,Staff,30,0,50,20
1683359708840,TDGE 10,B00,189290,Havis; Allan,1,0,50,49
1683359709868,TDGE 11,A00,189291,Fulton; Julia,0,3,50,50
1683359709868,TDGE 11,B00,189292,Staff,20,0,25,5
1683359709868,TDGE 11,C00,260270,Staff,0,0,0,0
1683359710895,TDGE 25,A00,189294,Staff,3,0,20,17
1683359711918,TDGE 124,A00,189318,Fulton; Julia,0,8,50,50
1683359712942,TDGE 125,A00,189319,Staff,13,0,25,12
1683359712942,TDGE 125,B00,189320,Staff,23,0,25,2
1683359713970,TDGE 127,A00,189322,Havis; Allan,0,0,50,50
1683359714998,TDHT 101,A00,189323,Staff,18,0,25,7
1683359714998,TDHT 101,B00,189324,Staff,25,0,25,0
1683359716028,TDHT 102,A00,189325,Staff,49,0,50,1
1683359717058,TDMV 1,A00,189295,Arcidiacono; Kristin,19,0,30,11
1683359717058,TDMV 1,B00,189296,Caligagan; Maria T.,24,0,30,6
1683359718083,TDMV 2,A00,189297,Sammartano; Tonnie,28,0,30,2
1683359718083,TDMV 2,B00,189299,Arcidiacono; Kristin,24,0,30,6
1683359719111,TDMV 3,A00,204998,Rincon; Alicia,22,0,30,8
1683359720136,TDMV 120,A00,189458,Sammartano; Tonnie,28,0,30,2
1683359721162,TDMV 138,A00,189541,Jun; Grace Shin Hae,22,0,40,18
1683359722192,TDMV 142,A00,189717,Caligagan; Tony,23,0,30,7
1683359722192,TDMV 142,B00,189718,Caligagan; Maria T.,25,0,30,5
1683359723221,TMC 2,A01,187533,Staff,25,0,25,0
1683359723221,TMC 2,A02,187534,Staff,25,0,25,0
1683359724251,USP 1,A01,187536,Kwak; Nancy,0,16,25,25
1683359725334,USP 5,A01,187538,Staff,10,0,25,15
1683359726365,USP 101,A00,199253,Staff,0,4,0,0
1683359727389,USP 124,A00,187562,Boomhower; Matthew Charles,1,0,30,29
1683359728418,USP 138,A00,187582,Staff,20,0,25,5
1683359729450,USP 152,A01,187597,Staff,4,0,25,21
1683359730476,USP 153,A00,187598,Staff,19,0,25,6
1683359731503,USP 168,A00,187607,Kwak; Nancy,2,0,5,3
1683359732531,USP 173,A00,187619,Staff,4,0,25,21
1683359733555,USP 181,A00,187638,Staff,0,3,25,25
1683359734583,VIS 103,A00,187650,Cruz; Edwin Teddy,22,0,75,53
1683359735609,VIS 110D,A00,187669,Staff,12,0,22,10
1683359736634,VIS 127C,A00,187720,Shen; Kuiyi,67,0,146,79
1683359737664,VIS 149,A00,187731,Yoldas; Pinar,0,14,22,22
1683359738688,VIS 151,A01,188091,Staff,22,0,34,12
1683359738688,VIS 151,A02,188092,Staff,11,0,34,23
1683359739712,VIS 160B,A00,188093,Stalbaum; Brett,0,0,10,10
1683359741765,WCWP 10B,A00,201720,Staff,10,0,15,5
1683359741765,WCWP 10B,B00,201722,Staff,9,0,15,6
1683359742794,WCWP 100,A00,201725,Gagnon; Jeffrey C,0,0,2,2
1683359742794,WCWP 100,B00,201727,Staff,0,4,15,15
1683359745990,ANBI 133,A00,258401,Wilder; Linnea Lorene,34,0,40,6
1683359747016,ANBI 140,A00,258395,Hrvoj Mihic; Branka,18,0,25,7
1683359748045,ANSC 120,A00,258402,Bialecki; Jon Anthony,27,0,40,13
1683359749071,ANSC 144,A00,258400,Staff,14,0,40,26
1683359751122,ANSC 166,A00,258396,Parish; Steven Martin,157,0,175,18
1683359752153,ANSC 180,A00,193533,Staff,9,0,20,11
1683359753180,ANSC 188,A00,258397,Jassal; Aftab,33,0,40,7
1683359754203,ANTH 3,A01,258316,Staff,23,0,30,7
1683359755227,ANTH 5,A00,258394,Semendeferi; Ekaterini,16,0,20,4
1683359756253,ANTH 21,A01,258331,Staff,8,0,40,32
1683359757281,ANTH 103,A00,258398,Varma; Saiba,15,0,25,10
1683359758317,AWP 10,001,202034,Staff,0,0,0,0
1683359758317,AWP 10,002,202035,Staff,0,0,0,0
1683359758317,AWP 10,003,202036,Staff,0,0,0,0
1683359758317,AWP 10,004,202037,Staff,0,0,0,0
1683359758317,AWP 10,005,202038,Staff,0,0,0,0
1683359758317,AWP 10,006,202039,Staff,0,0,0,0
1683359758317,AWP 10,007,202040,Staff,0,0,0,0
1683359758317,AWP 10,008,202041,Staff,0,0,0,0
1683359758317,AWP 10,009,202042,Staff,0,0,0,0
1683359758317,AWP 10,010,202043,Staff,0,0,0,0
1683359758317,AWP 10,011,202044,Staff,0,0,0,0
1683359758317,AWP 10,012,202045,Staff,0,0,0,0
1683359758317,AWP 10,013,202046,Staff,0,0,0,0
1683359758317,AWP 10,014,202047,Staff,0,0,0,0
1683359758317,AWP 10,015,202048,Staff,0,0,0,0
1683359758317,AWP 10,016,202049,Staff,0,0,0,0
1683359758317,AWP 10,017,202050,Staff,0,0,0,0
1683359758317,AWP 10,018,202051,Staff,0,0,0,0
1683359758317,AWP 10,019,202052,Staff,0,0,0,0
1683359758317,AWP 10,020,202053,Staff,0,0,0,0
1683359758317,AWP 10,021,202054,Staff,0,0,0,0
1683359758317,AWP 10,022,202055,Staff,0,0,0,0
1683359758317,AWP 10,023,202056,Staff,0,0,0,0
1683359758317,AWP 10,024,202057,Staff,0,0,0,0
1683359758317,AWP 10,025,202058,Staff,0,0,0,0
1683359758317,AWP 10,026,202059,Staff,0,0,0,0
1683359759342,AWP 102,001,202032,Staff,0,0,0,0
1683359759342,AWP 102,002,202033,Staff,0,0,0,0
1683359760369,BENG 100,A01,254234,Taylor Amos; Alyssa C,31,0,40,9
1683359761396,BENG 196,001,270013,Engler; Adam J.,9999,0,9999,0
1683359762423,BICD 100R,A01,202018,Smith; Laurie,0,7,32,32
1683359762423,BICD 100R,A02,202019,Smith; Laurie,0,2,32,32
1683359762423,BICD 100R,A03,202020,Smith; Laurie,0,1,32,32
1683359762423,BICD 100R,A04,202021,Smith; Laurie,9,0,32,23
1683359762423,BICD 100R,A05,202022,Smith; Laurie,12,0,32,20
1683359763448,BICD 136,A01,193242,Gustafson-Brown; Cindy,0,2,32,32
1683359763448,BICD 136,A02,193244,Gustafson-Brown; Cindy,14,0,32,18
1683359764486,BIEB 102,A01,193249,Butler; Shannon Rhey,0,2,32,32
1683359764486,BIEB 102,A02,193251,Butler; Shannon Rhey,0,0,32,32
1683359764486,BIEB 102,A03,193253,Butler; Shannon Rhey,0,1,32,32
1683359764486,BIEB 102,A04,193255,Butler; Shannon Rhey,17,0,32,15
1683359764486,BIEB 102,A05,193265,Butler; Shannon Rhey,26,0,32,6
1683359764486,BIEB 102,A06,193269,Butler; Shannon Rhey,16,0,32,16
1683359766543,BIEB 150,A01,193274,Staff,0,0,32,32
1683359766543,BIEB 150,A02,193285,Staff,23,0,32,9
1683359767575,BIEB 194,A00,193286,Kurle; Carolyn M.,22,0,32,10
1683359768610,BILD 1,A01,192291,Staff,16,0,32,16
1683359768610,BILD 1,A02,192292,Staff,30,0,32,2
1683359768610,BILD 1,B01,192520,Reuther; Keefe,0,1,0,0
1683359768610,BILD 1,B02,192532,Reuther; Keefe,0,1,0,0
1683359769638,BILD 3,A01,192556,Butler; Shannon Rhey,0,0,32,32
1683359769638,BILD 3,A02,192581,Butler; Shannon Rhey,4,0,32,28
1683359769638,BILD 3,A03,192611,Butler; Shannon Rhey,23,0,32,9
1683359769638,BILD 3,A04,192612,Butler; Shannon Rhey,25,0,32,7
1683359769638,BILD 3,A05,192613,Butler; Shannon Rhey,27,0,32,5
1683359769638,BILD 3,A06,192679,Butler; Shannon Rhey,27,0,32,5
1683359769638,BILD 3,A07,192682,Butler; Shannon Rhey,22,0,32,10
1683359770665,BILD 4,A01,192836,Reuther; Keefe,0,0,24,24
1683359770665,BILD 4,A02,193044,Reuther; Keefe,4,0,24,20
1683359771690,BILD 10,A01,193142,Gustafson-Brown; Cindy,30,0,32,2
1683359771690,BILD 10,A02,193149,Gustafson-Brown; Cindy,31,0,32,1
1683359772717,BIMM 100,A01,193301,Staff,0,6,32,32
1683359772717,BIMM 100,A02,193312,Staff,0,5,32,32
1683359772717,BIMM 100,A03,193323,Staff,0,8,32,32
1683359773749,BIMM 101,A01,193329,McDonnell; Lisa Marie,0,3,24,24
1683359773749,BIMM 101,A02,193339,McDonnell; Lisa Marie,0,3,24,24
1683359773749,BIMM 101,B01,193354,McDonnell; Lisa Marie,0,3,24,24
1683359773749,BIMM 101,B02,193357,McDonnell; Lisa Marie,0,3,24,24
1683359774775,BIMM 110,A01,193377,Tat; John,0,11,32,32
1683359774775,BIMM 110,A02,193378,Tat; John,0,9,32,32
1683359775810,BIMM 120,A01,206116,Staff,0,0,32,32
1683359775810,BIMM 120,A02,206117,Staff,8,0,32,24
1683359775810,BIMM 120,A03,206121,Staff,21,0,32,11
1683359776841,BIPN 100,A01,193393,Park; Ji Young,0,14,32,32
1683359776841,BIPN 100,A02,193402,Park; Ji Young,0,13,32,32
1683359776841,BIPN 100,A03,193413,Park; Ji Young,0,14,32,32
1683359776841,BIPN 100,A04,193414,Park; Ji Young,0,13,32,32
1683359777866,BIPN 102,A01,193429,Staff,0,0,32,32
1683359777866,BIPN 102,A02,193438,Staff,22,0,32,10
1683359778897,BIPN 106,A01,193450,Reyes Gonzalez; Catalina,0,2,40,40
1683359779928,BIPN 134,A01,193465,Cooke; James Edward,1,0,32,31
1683359779928,BIPN 134,A02,193474,Cooke; James Edward,25,0,32,7
1683359779928,BIPN 134,A03,193485,Cooke; James Edward,29,0,32,3
1683359779928,BIPN 134,A04,193486,Cooke; James Edward,21,0,32,11
1683359779928,BIPN 134,A05,193491,Cooke; James Edward,31,0,32,1
1683359779928,BIPN 134,A06,193501,Cooke; James Edward,30,0,32,2
1683359779928,BIPN 134,A07,193510,Cooke; James Edward,29,0,32,3
1683359781989,BISP 194,A00,222522,Staff,14,0,32,18
1683359783014,CAT 124,A01,202407,Staff,19,0,25,6
1683359784039,CAT 125,A00,202408,Marchisotto; Jennifer Anne,4,0,20,16
1683359785071,CAT 125R,A00,202409,Smith; Lauryn Alissa,0,11,20,20
1683359785071,CAT 125R,B00,202410,Morales; Celeste Georgianna,0,11,20,20
1683359785071,CAT 125R,C00,202411,Irwin; Matthew Joseph,0,10,20,20
1683359786097,CENG 15,A01,204712,Yang; Kesong,0,1,0,0
1683359787128,CENG 114,A00,202070,Jahed Motlagh; Zeinab,5,0,20,15
1683359788158,CGS 105,A00,185477,Wesling; Megan E.,24,0,40,16
1683359789182,CGS 106,A00,185494,Staff,13,0,22,9
1683359790210,CGS 108,A00,185495,Staff,14,0,20,6
1683359791237,CGS 114,A00,185496,Staff,13,0,18,5
1683359792265,CGS 119,A00,185501,Staff,15,0,20,5
1683359793293,CGS 120,A00,185511,Staff,13,0,20,7
1683359794326,CHEM 4,A01,184675,Bussey; Thomas J,96,0,100,4
1683359795352,CHEM 6A,A01,184677,Staff,34,0,60,26
1683359796376,CHEM 6B,A01,184679,Staff,65,0,100,35
1683359797401,CHEM 6C,A01,184681,Bussey; Thomas J,1,0,50,49
1683359797401,CHEM 6C,A02,184682,Bussey; Thomas J,34,0,50,16
1683359798425,CHEM 40A,A01,184684,Albizati; Kim F.,37,0,100,63
1683359799450,CHEM 40B,A01,184686,Albizati; Kim F.,0,20,100,100
1683359800479,CHEM 41B,A01,184690,Staff,52,0,100,48
1683359801505,COGS 3,A01,184715,Boyle; Mary E. T.,0,25,40,40
1683359802531,COGS 14B,A01,185172,Staff,0,15,38,38
1683359803554,COGS 18,A01,184736,Staff,17,0,80,63
1683359804579,COGS 100,A01,184932,Staff,0,5,73,73
1683359805606,COGS 101A,A01,184935,Staff,0,39,30,30
1683359806634,COGS 101B,A01,184944,Staff,0,2,30,30
1683359807661,COGS 101C,A01,184946,Staff,0,12,30,30
1683359808692,COGS 102A,A01,184951,Johnson; Christine M.,2,0,40,38
1683359809717,COGS 107B,A01,184953,Mooshagian; Eric Frederick,0,50,40,40
1683359810746,COGS 118B,A01,184959,Gupta; Anjum,0,48,40,40
1683359811773,COGS 153,A00,184961,Staff,0,15,30,30
1683359812798,COGS 177,A00,184962,Staff,0,20,30,30
1683359813826,COGS 187A,A01,184969,Boyle; Mary E. T.,0,17,40,40
1683359814856,COMM 10,A01,185174,Staff,0,5,25,25
1683359814856,COMM 10,A02,185189,Staff,0,5,25,25
1683359814856,COMM 10,A03,269821,Staff,0,0,0,0
1683359815880,COMM 100B,A01,185475,Staff,0,0,0,2
1683359815880,COMM 100B,A02,185476,Staff,13,0,25,12
1683359816906,COMM 100C,A01,185314,Staff,1,0,25,24
1683359816906,COMM 100C,A02,185327,Staff,19,0,25,6
1683359817934,COMM 110M,A00,185349,Staff,2,0,40,38
1683359818964,COMM 113T,A00,185352,Staff,24,0,40,16
1683359819988,COMM 114I,A00,185353,Staff,33,0,40,7
1683359821013,COMM 131,A00,185354,Staff,19,0,30,11
1683359822039,CSE 8A,A50,185358,Cao; Yingjun,0,46,10,10
1683359823066,CSE 8B,A01,185362,Staff,0,46,50,50
1683359824092,CSE 11,A01,185416,Cao; Yingjun,0,92,10,10
1683359825125,CSE 20,A01,185445,Briones; Jor-el Thomas Caparas,5,0,25,20
1683359826155,CSE 21,A01,185447,Staff,10,0,50,40
1683359827187,CSE 101,A01,185451,Staff,0,13,50,50
1683359827187,CSE 101,B01,185453,Jones; Miles E,0,11,50,50
1683359829295,CSE 141,A01,185458,Eldon; John,20,0,100,80
1683359830321,CSE 141L,A01,185461,Eldon; John,12,0,100,88
1683359831350,CSE 142,A01,185463,Staff,36,0,60,24
1683359831350,CSE 142,B01,201355,Staff,0,7,60,60
1683359832374,CSE 142L,A01,185470,Staff,36,0,60,24
1683359832374,CSE 142L,B01,201417,Staff,0,6,60,60
1683359833402,CSE 190,A00,201433,Staff,32,0,49,17
1683359834437,DOC 1,A01,259136,Strom; Megan C.,7,0,15,8
1683359834437,DOC 1,A02,259137,Strom; Megan C.,14,0,15,1
1683359834437,DOC 1,A03,259138,Strom; Megan C.,14,0,15,1
1683359834437,DOC 1,A04,259139,Strom; Megan C.,14,0,15,1
1683359835462,DOC 100D,A00,259140,Pass; Natalye Joann,16,0,25,9
1683359836489,DSGN 1,A01,184749,Rill; Bryan,0,25,30,30
1683359837523,DSGN 100,A01,185168,Staff,0,2,25,25
1683359838548,ECE 5,A01,185626,Morris; Karcher William,0,10,0,0
1683359839574,ECE 101,A01,185628,Staff,17,0,70,53
1683359840603,ECE 107,A01,185635,Baghdadchi; Saharnaz,0,0,20,20
1683359840603,ECE 107,A02,185638,Baghdadchi; Saharnaz,4,0,20,16
1683359841634,ECE 148,A01,185647,Silberman; Jack,0,0,16,16
1683359842664,ECON 1,A01,185537,Crane; Meredith Helen,54,0,70,16
1683359843688,ECON 3,A01,185549,Crane; Meredith Helen,32,0,70,38
1683359844718,ECON 4,A01,203354,Anderson; John Charles,0,4,10,10
1683359845743,ECON 100A,A01,185574,Staff,0,4,40,40
1683359846769,ECON 100B,A01,185576,Staff,0,12,50,50
1683359847795,ECON 100C,A01,185589,Newhouse; Herbert S,29,0,70,41
1683359848822,ECON 105,A00,185608,Vespa; Emanuel Ignacio,19,0,35,16
1683359849849,ECON 109,A01,185610,Shishkin; Denis,10,0,35,25
1683359850874,ECON 110A,A01,185612,Staff,11,0,40,29
1683359851899,ECON 120A,A01,185615,Staff,20,0,40,20
1683359852924,ECON 120C,A01,185617,Sun; Yixiao,0,21,70,70
1683359853949,ECON 144,A00,203346,Squires; Dale E,3,0,35,32
1683359854974,ECON 171,A01,203349,Newhouse; Herbert S,0,1,35,35
1683359856001,ECON 173A,A01,185621,Toda; Alexis Akira,21,0,35,14
1683359857031,EDS 25,A01,202413,Staff,0,1,0,0
1683359857031,EDS 25,A02,202414,Staff,0,1,0,0
1683359857031,EDS 25,A03,202415,Staff,0,0,0,0
1683359857031,EDS 25,A04,202416,Staff,0,1,0,0
1683359857031,EDS 25,A05,202439,Staff,0,0,0,0
1683359857031,EDS 25,A06,202440,Staff,0,0,0,0
1683359857031,EDS 25,B01,202631,Staff,0,0,0,0
1683359857031,EDS 25,B02,202632,Staff,0,0,0,0
1683359857031,EDS 25,B03,202639,Staff,0,0,0,0
1683359857031,EDS 25,B04,202640,Staff,0,0,0,0
1683359857031,EDS 25,B05,202643,Staff,0,0,0,0
1683359857031,EDS 25,B06,202644,Staff,0,0,0,0
1683359858061,EDS 38,A01,202659,Black; Alison Michelle,24,0,25,1
1683359859086,EDS 115,A00,202652,Staff,18,0,30,12
1683359860111,EDS 125,A00,202649,Staff,14,0,30,16
1683359861137,EDS 126,A01,203332,Staff,30,0,30,0
1683359862166,EDS 139,A00,202838,Staff,16,0,25,9
1683359863190,EDS 146,A01,202655,Staff,14,0,25,11
1683359864219,ENG 15,A00,185667,Staff,0,1,0,0
1683359864219,ENG 15,B00,185672,Staff,0,0,0,0
1683359864219,ENG 15,C00,185675,Staff,0,0,0,0
1683359864219,ENG 15,D00,185682,Staff,0,0,0,0
1683359864219,ENG 15,E00,185684,Staff,0,0,0,0
1683359865249,ETHN 103,A00,185710,Staff,0,4,35,35
1683359866273,ETHN 103A,A00,199228,Man; Simeon S,2,0,9,7
1683359867298,ETHN 109,A00,185711,Staff,18,0,35,17
1683359868324,ETHN 142,A00,185726,Staff,0,4,30,30
1683359869348,ETHN 163J,A00,199229,Man; Simeon S,5,0,8,3
1683359870373,ETHN 168,A00,185727,Staff,8,0,10,2
1683359871401,ETHN 182,A00,185728,Staff,0,0,35,35
1683359872427,ETHN 183,A00,185737,Staff,8,0,18,10
1683359873452,GLBH 111,A01,209361,Burgos; Jose L.,0,0,0,0
1683359875510,HIEU 104,A00,185792,Staff,16,0,20,4
1683359876533,HIEU 115,A00,185800,Staff,1,0,20,19
1683359877557,HIEU 128,A00,185801,Staff,0,7,20,20
1683359878580,HIEU 147,A00,185802,Staff,16,0,20,4
1683359879605,HIEU 154,A00,185823,Staff,12,0,20,8
1683359880633,HILA 102,A00,185826,Staff,13,0,20,7
1683359881661,HILD 2C,A01,185778,Staff,0,12,20,20
1683359882688,HILD 7B,A01,185780,Kwak; Nancy,0,15,32,32
1683359882688,HILD 7B,A02,185781,Kwak; Nancy,0,18,32,32
1683359883714,HILD 30,A01,185791,Staff,14,0,20,6
1683359884744,HISC 119,A00,185830,Golan; Tal,0,9,20,20
1683359885769,HITO 156GS,A00,185831,Patterson; Patrick H.,0,0,0,23
1683359886798,HIUS 103,A00,185832,Man; Simeon S,1,6,20,19
1683359887823,HIUS 117,A00,185836,Kwak; Nancy,2,0,20,18
1683359888848,HIUS 125,A00,185840,Man; Simeon S,0,0,23,23
1683359889879,HIUS 149,A00,185845,Staff,0,0,20,20
1683359890905,HUM 3,A01,185882,Zavodny; Tatiana Sophia,0,7,50,50
1683359890905,HUM 3,B01,185899,Caldwell; Michael Alan,0,18,50,50
1683359891930,HUM 3GS,A00,185900,Patterson; Patrick H.,0,0,0,23
1683359892958,HUM 4,A01,185938,Zroka; Amy Liane,31,0,50,19
1683359892958,HUM 4,B01,185956,Watkins; Eric,0,3,50,50
1683359892958,HUM 4,B02,202209,Watkins; Eric,0,2,50,50
1683359892958,HUM 4,B03,202210,Watkins; Eric,0,2,50,50
1683359893988,HUM 5,A01,185958,West; Geoffrey Scott,3,0,50,47
1683359893988,HUM 5,A02,202215,West; Geoffrey Scott,0,0,50,50
1683359895016,INTL 190,A00,185959,Gagnon; Jeffrey C,0,0,0,9
1683359895016,INTL 190,B00,185960,Lettieri; Michael Joseph,0,0,0,1
1683359896043,JAPN 180,A00,254509,Staff,4,0,30,26
1683359897068,LATI 10,A01,202853,Kennemore; Amy Michelle,4,0,35,31
1683359897068,LATI 10,A02,202854,Kennemore; Amy Michelle,2,0,35,33
1683359897068,LATI 10,A03,270054,Kennemore; Amy Michelle,30,0,30,0
1683359898092,LATI 180,A00,202855,Kennemore; Amy Michelle,11,0,20,9
1683359899122,LAWS 101,A00,201767,Golan; Tal,0,7,40,40
1683359900150,LIFR 1C,A00,185961,Staff,6,0,20,14
1683359901178,LIFR 1CX,A00,185962,Staff,7,0,20,13
1683359902206,LIFR 1D,A00,185963,Staff,9,0,20,11
1683359903235,LIFR 1DX,A00,185964,Staff,9,0,20,11
1683359904261,LIGN 101,A01,186039,Staff,43,0,50,7
1683359905286,LIGN 165,A00,186040,Staff,18,0,50,32
1683359906311,LTCS 108,A00,186041,Staff,6,0,10,4
1683359907336,LTCS 119,A00,186042,Staff,16,0,20,4
1683359908360,LTCS 130,A00,186043,Wesling; Megan E.,15,0,25,10
1683359910409,LTEA 138,A00,186119,Staff,14,0,40,26
1683359911432,LTEN 124,A00,186148,Staff,6,0,25,19
1683359912456,LTEN 178,A00,186149,Staff,7,0,15,8
1683359913482,LTEN 181,A00,186150,Blanco; John D,33,0,40,7
1683359914508,LTWL 120,A00,186160,Staff,20,0,25,5
1683359915538,LTWL 165,A00,186161,Staff,22,0,25,3
1683359916569,LTWR 100,A00,186162,Staff,0,5,15,15
1683359917596,LTWR 102,A00,186163,Doller; Ben,5,0,15,10
1683359918622,MAE 8,A01,186412,Staff,0,0,0,0
1683359919647,MAE 30B,A00,186445,Bahadori; Mohammad Yousef,83,0,100,17
1683359920671,MAE 40,A00,186592,Bewley; Thomas R,10,0,50,40
1683359921697,MAE 101B,A00,186593,Bahadori; Mohammad Yousef,81,0,100,19
1683359922723,MAE 105,A00,186594,Bandaru; Prabhakar,12,0,50,38
1683359923754,MAE 107,A00,186599,Pham; Hieu Tan,0,7,120,120
1683359924784,MAE 148,A01,186660,Silberman; Jack,3,0,16,13
1683359925819,MATH 10A,A01,188095,Staff,0,5,35,35
1683359926846,MATH 10B,A01,188097,Bowers; Adam R.,0,11,30,30
1683359926846,MATH 10B,A02,188099,Bowers; Adam R.,0,11,30,30
1683359926846,MATH 10B,B01,188104,Bowers; Adam R.,0,10,30,30
1683359926846,MATH 10B,B02,188106,Bowers; Adam R.,0,10,30,30
1683359927874,MATH 10C,A01,188111,Staff,0,18,30,30
1683359927874,MATH 10C,A02,188127,Staff,0,17,30,30
1683359927874,MATH 10C,A03,188131,Staff,0,18,30,30
1683359927874,MATH 10C,B01,188218,Staff,18,0,30,12
1683359927874,MATH 10C,B02,188244,Staff,13,0,30,17
1683359927874,MATH 10C,B03,188277,Staff,16,0,30,14
1683359928900,MATH 18,A01,188344,Bach; Quang Tran,18,0,30,12
1683359928900,MATH 18,A02,188345,Bach; Quang Tran,11,0,30,19
1683359928900,MATH 18,B01,188353,Bach; Quang Tran,10,0,30,20
1683359928900,MATH 18,B02,188354,Bach; Quang Tran,20,0,30,10
1683359929926,MATH 20A,A01,188374,Staff,12,0,35,23
1683359930952,MATH 20B,A01,188382,Ohm; Ko Woon,6,0,30,24
1683359930952,MATH 20B,A02,188383,Ohm; Ko Woon,22,0,30,8
1683359930952,MATH 20B,B01,188385,Ohm; Ko Woon,7,0,30,23
1683359930952,MATH 20B,B02,188392,Ohm; Ko Woon,22,0,30,8
1683359931976,MATH 20C,A01,188394,Harel; Guershon,10,0,30,20
1683359931976,MATH 20C,A02,188395,Harel; Guershon,15,0,30,15
1683359931976,MATH 20C,B01,188404,Harel; Guershon,4,0,30,26
1683359931976,MATH 20C,B02,188405,Harel; Guershon,19,0,30,11
1683359933065,MATH 20D,A01,188414,Hammock; Frances H,0,1,30,30
1683359933065,MATH 20D,A02,188415,Hammock; Frances H,3,0,30,27
1683359933065,MATH 20D,B01,188447,Hammock; Frances H,1,0,30,29
1683359933065,MATH 20D,B02,188486,Hammock; Frances H,8,0,30,22
1683359934092,MATH 20E,A01,188649,Staff,21,0,30,9
1683359934092,MATH 20E,A02,188650,Staff,23,0,30,7
1683359934092,MATH 20E,A03,188673,Staff,0,0,30,30
1683359935120,MATH 102,A01,188675,Staff,0,35,35,35
1683359936151,MATH 103B,A01,188681,Staff,3,0,35,32
1683359936151,MATH 103B,B01,188692,Staff,5,0,35,30
1683359937181,MATH 109,A01,188695,Salehi Golsefidy; Alireza,25,0,35,10
1683359937181,MATH 109,A02,188696,Salehi Golsefidy; Alireza,25,0,35,10
1683359938206,MATH 120A,A01,188698,Eggers; John Dietrich,7,0,35,28
1683359939231,MATH 142B,A01,188736,Ioana; Adrian,0,2,30,30
1683359939231,MATH 142B,A02,188741,Ioana; Adrian,0,0,30,30
1683359939231,MATH 142B,A03,188743,Ioana; Adrian,0,1,30,30
1683359940255,MATH 168A,A01,188790,Staff,0,9,35,35
1683359941280,MATH 170A,A01,188803,Nie; Jiawang,0,2,35,35
1683359941280,MATH 170A,A02,188811,Nie; Jiawang,0,0,35,35
1683359941280,MATH 170A,A03,188814,Nie; Jiawang,1,0,35,34
1683359941280,MATH 170A,A04,188815,Nie; Jiawang,13,0,35,22
1683359942305,MATH 193B,A01,188817,Staff,0,0,35,35
1683359942305,MATH 193B,A02,188818,Staff,5,0,35,30
1683359943330,MGT 4,A01,202857,Anderson; John Charles,61,0,80,19
1683359944356,MGT 12,A00,202858,Lindenberger; Wade Douglas,42,0,90,48
1683359945382,MGT 18,A00,202859,Staff,74,0,90,16
1683359946408,MGT 18GS,A00,202860,McKay; Michael J,13,0,28,15
1683359947438,MGT 45,A00,202861,Pecore; Joseph P.,14,0,90,76
1683359948463,MGT 100,A00,202863,Yavorsky; Daniel Ryan,28,0,90,62
1683359949489,MGT 103,A00,202864,Ehrich; Kristine R,0,17,90,90
1683359950514,MGT 112,A00,202865,Ehrich; Kristine R,15,0,90,75
1683359951544,MGT 121A,A00,202868,Staff,0,20,0,0
1683359952576,MGT 131B,A00,202869,Anderson; John Charles,59,0,90,31
1683359953600,MGT 136,A00,202871,Lindenberger; Wade Douglas,84,0,90,6
1683359954624,MGT 164,A00,202873,Staff,0,68,90,91
1683359955648,MGT 164GS,A00,202874,McKay; Mary A,13,0,28,15
1683359956673,MGT 180,A00,202875,Staff,0,50,90,91
1683359957702,MMW 11R,A01,205019,Herbst; Matthew,3,0,30,27
1683359957702,MMW 11R,A02,205026,Herbst; Matthew,29,0,30,1
1683359958729,MMW 15,A01,193512,Chang; Edmond Yi-Teh,0,9,28,28
1683359958729,MMW 15,A02,193513,Chang; Edmond Yi-Teh,0,5,28,28
1683359958729,MMW 15,A03,193514,Chang; Edmond Yi-Teh,0,5,28,28
1683359958729,MMW 15,A04,193515,Chang; Edmond Yi-Teh,0,5,28,28
1683359958729,MMW 15,A05,193516,Chang; Edmond Yi-Teh,0,4,28,28
1683359958729,MMW 15,A06,193517,Chang; Edmond Yi-Teh,0,5,28,28
1683359958729,MMW 15,B01,193519,Chang; Edmond Yi-Teh,0,5,28,28
1683359958729,MMW 15,B02,193520,Chang; Edmond Yi-Teh,0,5,28,28
1683359958729,MMW 15,B03,193521,Chang; Edmond Yi-Teh,0,5,28,28
1683359958729,MMW 15,B04,193522,Chang; Edmond Yi-Teh,0,4,28,28
1683359958729,MMW 15,B05,193523,Chang; Edmond Yi-Teh,0,5,28,28
1683359958729,MMW 15,B06,193524,Chang; Edmond Yi-Teh,0,4,28,28
1683359959754,MMW 122,A01,193526,Rahimi; Babak,0,15,28,28
1683359959754,MMW 122,A02,193527,Rahimi; Babak,0,14,28,28
1683359959754,MMW 122,A03,193528,Rahimi; Babak,0,0,0,0
1683359959754,MMW 122,A04,193529,Rahimi; Babak,0,0,0,0
1683359960779,MUS 1A,A01,186663,Staff,0,20,35,35
1683359961810,MUS 4,A01,186715,Staff,0,12,35,35
1683359962840,MUS 5R,A01,186796,Dubnov; Shlomo,0,17,35,35
1683359963866,MUS 6,A01,186798,Staff,0,4,25,25
1683359964901,MUS 7,A01,186830,Staff,13,0,35,22
1683359965963,MUS 8,A01,186930,Staff,0,26,35,35
1683359966994,MUS 15,A01,186932,Staff,0,16,35,35
1683359966994,MUS 15,B01,186934,Staff,0,15,35,35
1683359968018,MUS 80,A00,186935,Staff,0,0,20,20
1683359968018,MUS 80,B00,186936,Staff,25,0,25,0
1683359969048,NANO 11,A00,204702,Lipomi; Darren John,0,0,0,0
1683359970075,NANO 15,A01,204709,Yang; Kesong,0,1,0,0
1683359971100,NANO 114,A00,202069,Jahed Motlagh; Zeinab,3,0,10,7
1683359972130,PHIL 1,A00,186955,Grush; Rick Scott,32,0,40,8
1683359973158,PHIL 10,A01,186973,Grush; Rick Scott,28,0,35,7
1683359973158,PHIL 10,A02,186974,Grush; Rick Scott,33,0,35,2
1683359974183,PHIL 13,A01,186976,Staff,7,0,35,28
1683359974183,PHIL 13,A02,186977,Staff,16,0,35,19
1683359975210,PHIL 14,A01,186979,Staff,31,0,35,4
1683359975210,PHIL 14,A02,186986,Staff,32,0,35,3
1683359976235,PHIL 28,A01,186988,Staff,16,0,30,14
1683359976235,PHIL 28,A02,186989,Staff,1,0,30,29
1683359976235,PHIL 28,A03,186990,Staff,9,0,30,21
1683359976235,PHIL 28,A04,186991,Staff,26,0,30,4
1683359977260,PHIL 120,A00,186997,Staff,23,0,40,17
1683359978285,PHIL 137,A00,187003,Staff,9,0,40,31
1683359979310,PHIL 150,A00,187015,Staff,47,0,70,23
1683359980335,PHIL 167,A00,187021,Lamey; Andy M.,35,0,40,5
1683359981363,PHIL 174,A01,202226,Staff,17,0,20,3
1683359981363,PHIL 174,A02,202235,Staff,20,0,20,0
1683359982386,PHIL 191A,A00,258918,Staff,0,0,1,1
1683359983413,PHYS 1A,A00,187028,Staff,27,0,60,33
1683359984443,PHYS 1AL,001,187036,Staff,2,0,30,28
1683359984443,PHYS 1AL,002,187049,Staff,18,0,30,12
1683359985471,PHYS 1B,A00,187058,Staff,22,0,60,38
1683359986497,PHYS 1BL,001,187064,Staff,0,0,30,30
1683359986497,PHYS 1BL,002,187070,Staff,5,0,30,25
1683359987527,PHYS 1C,A00,187082,Staff,31,0,120,89
1683359988559,PHYS 1CL,001,187088,Staff,0,9,30,30
1683359988559,PHYS 1CL,002,187089,Staff,0,2,30,30
1683359988559,PHYS 1CL,009,262693,Staff,11,0,30,19
1683359989586,PHYS 2B,A01,187097,Staff,54,0,115,61
1683359990611,PHYS 2C,A01,187099,Staff,67,0,115,48
1683359991637,PHYS 2CL,A01,187101,Staff,5,0,28,23
1683359991637,PHYS 2CL,A02,187102,Staff,15,0,28,13
1683359992662,PHYS 2D,A01,187123,Shotwell; Brian,95,0,115,20
1683359993712,PHYS 4B,A01,187133,Grinstein; Benjamin,35,0,50,15
1683359994739,POLI 10,A00,188819,Staff,0,4,50,50
1683359995766,POLI 11,A00,188827,Staff,43,0,50,7
1683359996793,POLI 13R,A00,188828,Staff,0,1,20,20
1683359997819,POLI 27,A01,188830,Elgin; Samuel Zincke,0,1,70,70
1683359998845,POLI 30,A00,188832,Desposato; Scott,31,0,50,19
1683359999875,POLI 102F,A00,188834,Staff,3,0,40,37
1683360000904,POLI 104A,A00,188852,Staff,14,0,30,16
1683360001932,POLI 104I,A00,188853,Staff,0,6,20,20
1683360002963,POLI 110B,A00,188854,Wiens; David,7,0,20,13
1683360003992,POLI 112A,A00,188855,Wiens; David,5,0,30,25
1683360005018,POLI 117R,A00,188856,Forman; Fonna,0,11,20,20
1683360006043,POLI 118,A00,188857,Ingham; Sean,8,0,20,12
1683360007067,POLI 120G,A00,188858,Staff,9,0,30,21
1683360008092,POLI 131CR,A00,188863,Hoston; Germaine,23,0,50,27
1683360009117,POLI 133,A00,188864,Nellis; Gareth Hb,44,0,50,6
1683360010146,POLI 134D,A00,188865,Desposato; Scott,27,0,30,3
1683360011170,POLI 142A,A00,188871,Gartzke; Erik,22,0,50,28
1683360012199,POLI 142K,A00,188874,Staff,38,0,50,12
1683360013224,POLI 143,A00,188940,Gartzke; Erik,16,0,30,14
1683360014252,POLI 153,A00,188943,Staff,3,0,20,17
1683360015282,POLI 160AA,A00,188944,Staff,11,0,40,29
1683360016306,POLI 170A,A00,188945,Staff,11,0,30,19
1683360018362,PSYC 1,A00,188952,Staff,37,0,90,53
1683360019395,PSYC 2,B00,188953,Staff,19,0,35,16
1683360020420,PSYC 6,A00,188970,Staff,47,0,60,13
1683360021447,PSYC 7,A00,188973,Staff,37,0,45,8
1683360022472,PSYC 60,A01,188980,Rickard; Timothy C.,43,0,60,17
1683360023497,PSYC 70,A01,189001,Steiner; Eric Tomas,23,0,45,22
1683360024527,PSYC 100,A00,189005,Lacefield; Katharine I,0,98,120,120
1683360025555,PSYC 102,A00,189008,Staff,9,0,30,21
1683360026582,PSYC 106,B00,189026,Gorman; Michael R.,34,0,60,26
1683360027606,PSYC 114,B01,189033,Winkielman; Piotr,0,32,30,30
1683360028630,PSYC 131,A00,189036,Anagnostaras; Stephan,0,43,60,60
1683360029655,PSYC 136,A00,189041,Lowe; Angela Beth,0,7,25,25
1683360030679,PSYC 137,A00,189057,Winkielman; Piotr,0,34,25,25
1683360031707,PSYC 144,A00,189107,Wixted; John T,0,7,50,50
1683360033756,PSYC 162,A00,189142,Staff,0,8,85,85
1683360034784,PSYC 172,A00,189144,Gorman; Michael R.,0,7,30,30
1683360037097,PSYC 179,A00,189146,Lacefield; Katharine I,0,84,120,120
1683360038122,PSYC 181,A00,189147,Anagnostaras; Stephan,0,44,90,90
1683360039147,PSYC 190R,A00,189148,Barner; David A.,0,22,80,80
1683360040171,PSYC 191,A00,189275,Rickard; Timothy C.,0,7,25,25
1683360041198,PSYC 193,A00,189276,Chapman; Eddie Nathaniel,0,1,0,4
1683360042226,PSYC 193L,A01,189281,Lowe; Angela Beth,12,0,20,8
1683360042226,PSYC 193L,B01,189285,Staff,28,0,35,7
1683360043254,RELI 149,A00,187137,Rahimi; Babak,7,0,40,33
1683360044280,SE 9,A01,187315,Staff,0,2,18,18
1683360045307,SE 101B,A00,187409,Staff,24,0,30,6
1683360046333,SE 110B,A00,187444,Staff,10,0,40,30
1683360047368,SE 130B,A00,187449,Staff,31,0,40,9
1683360048392,SE 150A,A00,187516,Staff,9,0,20,11
1683360049427,SE 154,A00,187528,Staff,30,0,50,20
1683360050452,SIO 3,A01,258171,Staff,35,0,40,5
1683360051480,SIO 10,A00,187144,Cook; Geoffrey W,0,3,75,75
1683360052506,SIO 45,A00,187152,Cook; Geoffrey W,1,0,100,99
1683360053535,SIO 109R,A00,194486,Staff,0,3,20,20
1683360055589,SIO 187,A01,187233,Kacev; David,12,0,40,28
1683360056615,SOCI 1,A01,258656,Thorpe; Charles Robert,28,0,30,2
1683360056615,SOCI 1,A02,258658,Thorpe; Charles Robert,30,0,30,0
1683360056615,SOCI 1,A03,258661,Thorpe; Charles Robert,25,0,25,0
1683360056615,SOCI 1,A04,258666,Thorpe; Charles Robert,22,0,25,3
1683360056615,SOCI 1,A05,258897,Thorpe; Charles Robert,23,0,25,2
1683360056615,SOCI 1,A06,258898,Thorpe; Charles Robert,25,0,25,0
1683360057644,SOCI 30,A01,258903,Pardo Guerra; Juan Pablo,15,0,30,15
1683360058673,SOCI 102,A00,258904,Staff,9,0,25,16
1683360059697,SOCI 106,A00,258905,Staff,19,0,25,6
1683360060723,SOCI 111,A00,258907,Ribas Norris; Janet Vanesa,26,0,30,4
1683360061755,SOCI 121R,A00,258908,Pardo Guerra; Juan Pablo,10,0,30,20
1683360062780,SOCI 126,A01,203330,Staff,14,0,20,6
1683360063805,SOCI 131,A00,258909,Thorpe; Charles Robert,31,0,60,29
1683360064829,SOCI 135,A00,258910,Payne; Christine Anna,0,9,30,30
1683360065853,SOCI 157,A00,258911,Staff,12,0,30,18
1683360066879,SOCI 184,A00,258912,Staff,25,0,30,5
1683360067903,SOCI 188D,A00,258913,Staff,22,0,30,8
1683360068931,SYN 2,001,187529,Staff,10,0,16,6
1683360068931,SYN 2,002,201452,Staff,0,18,16,16
1683360068931,SYN 2,003,201469,Staff,3,0,16,13
1683360069958,SYN 100,A01,187531,Staff,0,9,20,20
1683360069958,SYN 100,B01,201491,Staff,0,12,20,20
1683360070987,TDAC 1,A00,189286,Walsh; Kim C.,3,0,20,17
1683360070987,TDAC 1,B00,189287,Harting; Carla Kelso,11,0,20,9
1683360072018,TDAC 101,A00,189300,Walsh; Kim C.,16,0,20,4
1683360072018,TDAC 101,B00,189301,Harting; Carla Kelso,18,0,20,2
1683360073045,TDAC 102,A00,189304,Basso; Beatrice,14,0,20,6
1683360074070,TDAC 108,A00,189305,Staff,18,0,20,2
1683360075097,TDDE 131,A00,189310,Staff,19,0,20,1
1683360075097,TDDE 131,B00,189314,Staff,19,0,20,1
1683360075097,TDDE 131,C00,189315,Staff,48,0,50,2
1683360075097,TDDE 131,D00,189316,Staff,14,0,15,1
1683360075097,TDDE 131,E00,204841,Staff,20,0,20,0
1683360076122,TDGE 10,A00,189289,Staff,30,0,50,20
1683360076122,TDGE 10,B00,189290,Havis; Allan,1,0,50,49
1683360077149,TDGE 11,A00,189291,Fulton; Julia,0,3,50,50
1683360077149,TDGE 11,B00,189292,Staff,20,0,25,5
1683360077149,TDGE 11,C00,260270,Staff,0,0,0,0
1683360078172,TDGE 25,A00,189294,Staff,3,0,20,17
1683360079197,TDGE 124,A00,189318,Fulton; Julia,0,8,50,50
1683360080224,TDGE 125,A00,189319,Staff,13,0,25,12
1683360080224,TDGE 125,B00,189320,Staff,23,0,25,2
1683360081246,TDGE 127,A00,189322,Havis; Allan,0,0,50,50
1683360082273,TDHT 101,A00,189323,Staff,18,0,25,7
1683360082273,TDHT 101,B00,189324,Staff,25,0,25,0
1683360083300,TDHT 102,A00,189325,Staff,49,0,50,1
1683360084329,TDMV 1,A00,189295,Arcidiacono; Kristin,19,0,30,11
1683360084329,TDMV 1,B00,189296,Caligagan; Maria T.,24,0,30,6
1683360085380,TDMV 2,A00,189297,Sammartano; Tonnie,28,0,30,2
1683360085380,TDMV 2,B00,189299,Arcidiacono; Kristin,24,0,30,6
1683360086405,TDMV 3,A00,204998,Rincon; Alicia,22,0,30,8
1683360087429,TDMV 120,A00,189458,Sammartano; Tonnie,28,0,30,2
1683360088455,TDMV 138,A00,189541,Jun; Grace Shin Hae,22,0,40,18
1683360089480,TDMV 142,A00,189717,Caligagan; Tony,23,0,30,7
1683360089480,TDMV 142,B00,189718,Caligagan; Maria T.,25,0,30,5
1683360090505,TMC 2,A01,187533,Staff,25,0,25,0
1683360090505,TMC 2,A02,187534,Staff,25,0,25,0
1683360091532,USP 1,A01,187536,Kwak; Nancy,0,16,25,25
1683360092556,USP 5,A01,187538,Staff,10,0,25,15
1683360093583,USP 101,A00,199253,Staff,0,4,0,0
1683360094612,USP 124,A00,187562,Boomhower; Matthew Charles,1,0,30,29
1683360095637,USP 138,A00,187582,Staff,20,0,25,5
1683360096669,USP 152,A01,187597,Staff,4,0,25,21
1683360097693,USP 153,A00,187598,Staff,19,0,25,6
1683360098718,USP 168,A00,187607,Kwak; Nancy,2,0,5,3
1683360099742,USP 173,A00,187619,Staff,4,0,25,21
1683360100764,USP 181,A00,187638,Staff,0,3,25,25
1683360101787,VIS 103,A00,187650,Cruz; Edwin Teddy,22,0,75,53
1683360102812,VIS 110D,A00,187669,Staff,12,0,22,10
1683360103837,VIS 127C,A00,187720,Shen; Kuiyi,67,0,146,79
1683360104865,VIS 149,A00,187731,Yoldas; Pinar,0,14,22,22
1683360105887,VIS 151,A01,188091,Staff,22,0,34,12
1683360105887,VIS 151,A02,188092,Staff,11,0,34,23
1683360106910,VIS 160B,A00,188093,Stalbaum; Brett,0,0,10,10
1683360108965,WCWP 10B,A00,201720,Staff,10,0,15,5
1683360108965,WCWP 10B,B00,201722,Staff,9,0,15,6
1683360109990,WCWP 100,A00,201725,Gagnon; Jeffrey C,0,0,2,2
1683360109990,WCWP 100,B00,201727,Staff,0,4,15,15
1683360113100,ANBI 133,A00,258401,Wilder; Linnea Lorene,34,0,40,6
1683360114124,ANBI 140,A00,258395,Hrvoj Mihic; Branka,18,0,25,7
1683360115153,ANSC 120,A00,258402,Bialecki; Jon Anthony,27,0,40,13
1683360116180,ANSC 144,A00,258400,Staff,14,0,40,26
1683360118233,ANSC 166,A00,258396,Parish; Steven Martin,157,0,175,18
1683360119262,ANSC 180,A00,193533,Staff,9,0,20,11
1683360120287,ANSC 188,A00,258397,Jassal; Aftab,33,0,40,7
1683360121312,ANTH 3,A01,258316,Staff,23,0,30,7
1683360122338,ANTH 5,A00,258394,Semendeferi; Ekaterini,16,0,20,4
1683360123363,ANTH 21,A01,258331,Staff,8,0,40,32
1683360124391,ANTH 103,A00,258398,Varma; Saiba,15,0,25,10
1683360125419,AWP 10,001,202034,Staff,0,0,0,0
1683360125419,AWP 10,002,202035,Staff,0,0,0,0
1683360125419,AWP 10,003,202036,Staff,0,0,0,0
1683360125419,AWP 10,004,202037,Staff,0,0,0,0
1683360125419,AWP 10,005,202038,Staff,0,0,0,0
1683360125419,AWP 10,006,202039,Staff,0,0,0,0
1683360125419,AWP 10,007,202040,Staff,0,0,0,0
1683360125419,AWP 10,008,202041,Staff,0,0,0,0
1683360125419,AWP 10,009,202042,Staff,0,0,0,0
1683360125419,AWP 10,010,202043,Staff,0,0,0,0
1683360125419,AWP 10,011,202044,Staff,0,0,0,0
1683360125419,AWP 10,012,202045,Staff,0,0,0,0
1683360125419,AWP 10,013,202046,Staff,0,0,0,0
1683360125419,AWP 10,014,202047,Staff,0,0,0,0
1683360125419,AWP 10,015,202048,Staff,0,0,0,0
1683360125419,AWP 10,016,202049,Staff,0,0,0,0
1683360125419,AWP 10,017,202050,Staff,0,0,0,0
1683360125419,AWP 10,018,202051,Staff,0,0,0,0
1683360125419,AWP 10,019,202052,Staff,0,0,0,0
1683360125419,AWP 10,020,202053,Staff,0,0,0,0
1683360125419,AWP 10,021,202054,Staff,0,0,0,0
1683360125419,AWP 10,022,202055,Staff,0,0,0,0
1683360125419,AWP 10,023,202056,Staff,0,0,0,0
1683360125419,AWP 10,024,202057,Staff,0,0,0,0
1683360125419,AWP 10,025,202058,Staff,0,0,0,0
1683360125419,AWP 10,026,202059,Staff,0,0,0,0
1683360126443,AWP 102,001,202032,Staff,0,0,0,0
1683360126443,AWP 102,002,202033,Staff,0,0,0,0
1683360127471,BENG 100,A01,254234,Taylor Amos; Alyssa C,31,0,40,9
1683360128495,BENG 196,001,270013,Engler; Adam J.,9999,0,9999,0
1683360129520,BICD 100R,A01,202018,Smith; Laurie,0,7,32,32
1683360129520,BICD 100R,A02,202019,Smith; Laurie,0,2,32,32
1683360129520,BICD 100R,A03,202020,Smith; Laurie,0,1,32,32
1683360129520,BICD 100R,A04,202021,Smith; Laurie,9,0,32,23
1683360129520,BICD 100R,A05,202022,Smith; Laurie,12,0,32,20
1683360130553,BICD 136,A01,193242,Gustafson-Brown; Cindy,0,2,32,32
1683360130553,BICD 136,A02,193244,Gustafson-Brown; Cindy,14,0,32,18
1683360131582,BIEB 102,A01,193249,Butler; Shannon Rhey,0,2,32,32
1683360131582,BIEB 102,A02,193251,Butler; Shannon Rhey,0,0,32,32
1683360131582,BIEB 102,A03,193253,Butler; Shannon Rhey,0,1,32,32
1683360131582,BIEB 102,A04,193255,Butler; Shannon Rhey,17,0,32,15
1683360131582,BIEB 102,A05,193265,Butler; Shannon Rhey,26,0,32,6
1683360131582,BIEB 102,A06,193269,Butler; Shannon Rhey,16,0,32,16
1683360133634,BIEB 150,A01,193274,Staff,0,0,32,32
1683360133634,BIEB 150,A02,193285,Staff,23,0,32,9
1683360134658,BIEB 194,A00,193286,Kurle; Carolyn M.,22,0,32,10
1683360135683,BILD 1,A01,192291,Staff,16,0,32,16
1683360135683,BILD 1,A02,192292,Staff,30,0,32,2
1683360135683,BILD 1,B01,192520,Reuther; Keefe,0,1,0,0
1683360135683,BILD 1,B02,192532,Reuther; Keefe,0,1,0,0
1683360136732,BILD 3,A01,192556,Butler; Shannon Rhey,0,0,32,32
1683360136732,BILD 3,A02,192581,Butler; Shannon Rhey,4,0,32,28
1683360136732,BILD 3,A03,192611,Butler; Shannon Rhey,23,0,32,9
1683360136732,BILD 3,A04,192612,Butler; Shannon Rhey,25,0,32,7
1683360136732,BILD 3,A05,192613,Butler; Shannon Rhey,27,0,32,5
1683360136732,BILD 3,A06,192679,Butler; Shannon Rhey,27,0,32,5
1683360136732,BILD 3,A07,192682,Butler; Shannon Rhey,22,0,32,10
1683360137765,BILD 4,A01,192836,Reuther; Keefe,0,0,24,24
1683360137765,BILD 4,A02,193044,Reuther; Keefe,4,0,24,20
1683360138790,BILD 10,A01,193142,Gustafson-Brown; Cindy,30,0,32,2
1683360138790,BILD 10,A02,193149,Gustafson-Brown; Cindy,31,0,32,1
1683360139818,BIMM 100,A01,193301,Staff,1,6,32,31
1683360139818,BIMM 100,A02,193312,Staff,0,5,32,32
1683360139818,BIMM 100,A03,193323,Staff,0,8,32,32
1683360140916,BIMM 101,A01,193329,McDonnell; Lisa Marie,0,3,24,24
1683360140916,BIMM 101,A02,193339,McDonnell; Lisa Marie,0,3,24,24
1683360140916,BIMM 101,B01,193354,McDonnell; Lisa Marie,0,3,24,24
1683360140916,BIMM 101,B02,193357,McDonnell; Lisa Marie,0,3,24,24
1683360141946,BIMM 110,A01,193377,Tat; John,0,11,32,32
1683360141946,BIMM 110,A02,193378,Tat; John,0,9,32,32
1683360142978,BIMM 120,A01,206116,Staff,0,0,32,32
1683360142978,BIMM 120,A02,206117,Staff,8,0,32,24
1683360142978,BIMM 120,A03,206121,Staff,21,0,32,11
1683360144004,BIPN 100,A01,193393,Park; Ji Young,0,14,32,32
1683360144004,BIPN 100,A02,193402,Park; Ji Young,0,13,32,32
1683360144004,BIPN 100,A03,193413,Park; Ji Young,0,14,32,32
1683360144004,BIPN 100,A04,193414,Park; Ji Young,0,13,32,32
1683360145035,BIPN 102,A01,193429,Staff,0,0,32,32
1683360145035,BIPN 102,A02,193438,Staff,22,0,32,10
1683360146063,BIPN 106,A01,193450,Reyes Gonzalez; Catalina,0,2,40,40
1683360147095,BIPN 134,A01,193465,Cooke; James Edward,1,0,32,31
1683360147095,BIPN 134,A02,193474,Cooke; James Edward,25,0,32,7
1683360147095,BIPN 134,A03,193485,Cooke; James Edward,29,0,32,3
1683360147095,BIPN 134,A04,193486,Cooke; James Edward,21,0,32,11
1683360147095,BIPN 134,A05,193491,Cooke; James Edward,31,0,32,1
1683360147095,BIPN 134,A06,193501,Cooke; James Edward,30,0,32,2
1683360147095,BIPN 134,A07,193510,Cooke; James Edward,29,0,32,3
1683360149149,BISP 194,A00,222522,Staff,14,0,32,18
1683360150176,CAT 124,A01,202407,Staff,19,0,25,6
1683360151205,CAT 125,A00,202408,Marchisotto; Jennifer Anne,4,0,20,16
1683360152231,CAT 125R,A00,202409,Smith; Lauryn Alissa,0,11,20,20
1683360152231,CAT 125R,B00,202410,Morales; Celeste Georgianna,0,11,20,20
1683360152231,CAT 125R,C00,202411,Irwin; Matthew Joseph,0,10,20,20
1683360153262,CENG 15,A01,204712,Yang; Kesong,0,1,0,0
1683360154286,CENG 114,A00,202070,Jahed Motlagh; Zeinab,5,0,20,15
1683360155315,CGS 105,A00,185477,Wesling; Megan E.,24,0,40,16
1683360156339,CGS 106,A00,185494,Staff,13,0,22,9
1683360157364,CGS 108,A00,185495,Staff,14,0,20,6
1683360158394,CGS 114,A00,185496,Staff,13,0,18,5
1683360159419,CGS 119,A00,185501,Staff,15,0,20,5
1683360160444,CGS 120,A00,185511,Staff,13,0,20,7
1683360161474,CHEM 4,A01,184675,Bussey; Thomas J,96,0,100,4
1683360162506,CHEM 6A,A01,184677,Staff,34,0,60,26
1683360163531,CHEM 6B,A01,184679,Staff,65,0,100,35
1683360164565,CHEM 6C,A01,184681,Bussey; Thomas J,1,0,50,49
1683360164565,CHEM 6C,A02,184682,Bussey; Thomas J,34,0,50,16
1683360165591,CHEM 40A,A01,184684,Albizati; Kim F.,37,0,100,63
1683360166619,CHEM 40B,A01,184686,Albizati; Kim F.,0,20,100,100
1683360167647,CHEM 41B,A01,184690,Staff,52,0,100,48
1683360168672,COGS 3,A01,184715,Boyle; Mary E. T.,0,25,40,40
1683360169702,COGS 14B,A01,185172,Staff,0,15,38,38
1683360170729,COGS 18,A01,184736,Staff,16,0,80,64
1683360171753,COGS 100,A01,184932,Staff,0,5,73,73
1683360172778,COGS 101A,A01,184935,Staff,0,39,30,30
1683360173803,COGS 101B,A01,184944,Staff,0,2,30,30
1683360174826,COGS 101C,A01,184946,Staff,0,12,30,30
1683360175854,COGS 102A,A01,184951,Johnson; Christine M.,2,0,40,38
1683360176879,COGS 107B,A01,184953,Mooshagian; Eric Frederick,0,50,40,40
1683360177905,COGS 118B,A01,184959,Gupta; Anjum,0,48,40,40
1683360178930,COGS 153,A00,184961,Staff,0,15,30,30
1683360179954,COGS 177,A00,184962,Staff,0,20,30,30
1683360180981,COGS 187A,A01,184969,Boyle; Mary E. T.,0,17,40,40
1683360182030,COMM 10,A01,185174,Staff,0,5,25,25
1683360182030,COMM 10,A02,185189,Staff,0,5,25,25
1683360182030,COMM 10,A03,269821,Staff,0,0,0,0
1683360183056,COMM 100B,A01,185475,Staff,0,0,0,2
1683360183056,COMM 100B,A02,185476,Staff,13,0,25,12
1683360184085,COMM 100C,A01,185314,Staff,1,0,25,24
1683360184085,COMM 100C,A02,185327,Staff,19,0,25,6
1683360185112,COMM 110M,A00,185349,Staff,2,0,40,38
1683360186138,COMM 113T,A00,185352,Staff,24,0,40,16
1683360187168,COMM 114I,A00,185353,Staff,33,0,40,7
1683360188191,COMM 131,A00,185354,Staff,19,0,30,11
1683360189221,CSE 8A,A50,185358,Cao; Yingjun,0,46,10,10
1683360190249,CSE 8B,A01,185362,Staff,0,46,50,50
1683360191277,CSE 11,A01,185416,Cao; Yingjun,0,92,10,10
1683360192302,CSE 20,A01,185445,Briones; Jor-el Thomas Caparas,5,0,25,20
1683360193330,CSE 21,A01,185447,Staff,10,0,50,40
1683360194356,CSE 101,A01,185451,Staff,0,13,50,50
1683360194356,CSE 101,B01,185453,Jones; Miles E,0,11,50,50
1683360196413,CSE 141,A01,185458,Eldon; John,20,0,100,80
1683360197441,CSE 141L,A01,185461,Eldon; John,12,0,100,88
1683360198470,CSE 142,A01,185463,Staff,36,0,60,24
1683360198470,CSE 142,B01,201355,Staff,0,7,60,60
1683360199495,CSE 142L,A01,185470,Staff,36,0,60,24
1683360199495,CSE 142L,B01,201417,Staff,0,6,60,60
1683360200523,CSE 190,A00,201433,Staff,32,0,49,17
1683360201551,DOC 1,A01,259136,Strom; Megan C.,7,0,15,8
1683360201551,DOC 1,A02,259137,Strom; Megan C.,14,0,15,1
1683360201551,DOC 1,A03,259138,Strom; Megan C.,14,0,15,1
1683360201551,DOC 1,A04,259139,Strom; Megan C.,14,0,15,1
1683360202578,DOC 100D,A00,259140,Pass; Natalye Joann,16,0,25,9
1683360203604,DSGN 1,A01,184749,Rill; Bryan,0,25,30,30
1683360204631,DSGN 100,A01,185168,Staff,0,2,25,25
1683360205658,ECE 5,A01,185626,Morris; Karcher William,0,10,0,0
1683360206683,ECE 101,A01,185628,Staff,17,0,70,53
1683360207708,ECE 107,A01,185635,Baghdadchi; Saharnaz,0,0,20,20
1683360207708,ECE 107,A02,185638,Baghdadchi; Saharnaz,4,0,20,16
1683360208733,ECE 148,A01,185647,Silberman; Jack,0,0,16,16
1683360209759,ECON 1,A01,185537,Crane; Meredith Helen,54,0,70,16
1683360210786,ECON 3,A01,185549,Crane; Meredith Helen,32,0,70,38
1683360211814,ECON 4,A01,203354,Anderson; John Charles,0,4,10,10
1683360212836,ECON 100A,A01,185574,Staff,0,4,40,40
1683360213859,ECON 100B,A01,185576,Staff,0,12,50,50
1683360214884,ECON 100C,A01,185589,Newhouse; Herbert S,29,0,70,41
1683360215908,ECON 105,A00,185608,Vespa; Emanuel Ignacio,19,0,35,16
1683360216933,ECON 109,A01,185610,Shishkin; Denis,10,0,35,25
1683360217957,ECON 110A,A01,185612,Staff,11,0,40,29
1683360218981,ECON 120A,A01,185615,Staff,20,0,40,20
1683360220007,ECON 120C,A01,185617,Sun; Yixiao,0,21,70,70
1683360221037,ECON 144,A00,203346,Squires; Dale E,3,0,35,32
1683360222063,ECON 171,A01,203349,Newhouse; Herbert S,0,1,35,35
1683360223086,ECON 173A,A01,185621,Toda; Alexis Akira,21,0,35,14
1683360224114,EDS 25,A01,202413,Staff,0,1,0,0
1683360224114,EDS 25,A02,202414,Staff,0,1,0,0
1683360224114,EDS 25,A03,202415,Staff,0,0,0,0
1683360224114,EDS 25,A04,202416,Staff,0,1,0,0
1683360224114,EDS 25,A05,202439,Staff,0,0,0,0
1683360224114,EDS 25,A06,202440,Staff,0,0,0,0
1683360224114,EDS 25,B01,202631,Staff,0,0,0,0
1683360224114,EDS 25,B02,202632,Staff,0,0,0,0
1683360224114,EDS 25,B03,202639,Staff,0,0,0,0
1683360224114,EDS 25,B04,202640,Staff,0,0,0,0
1683360224114,EDS 25,B05,202643,Staff,0,0,0,0
1683360224114,EDS 25,B06,202644,Staff,0,0,0,0
1683360225139,EDS 38,A01,202659,Black; Alison Michelle,24,0,25,1
1683360226166,EDS 115,A00,202652,Staff,18,0,30,12
1683360227191,EDS 125,A00,202649,Staff,14,0,30,16
1683360228219,EDS 126,A01,203332,Staff,30,0,30,0
1683360229245,EDS 139,A00,202838,Staff,16,0,25,9
1683360230270,EDS 146,A01,202655,Staff,14,0,25,11
1683360231294,ENG 15,A00,185667,Staff,0,1,0,0
1683360231294,ENG 15,B00,185672,Staff,0,0,0,0
1683360231294,ENG 15,C00,185675,Staff,0,0,0,0
1683360231294,ENG 15,D00,185682,Staff,0,0,0,0
1683360231294,ENG 15,E00,185684,Staff,0,0,0,0
1683360232321,ETHN 103,A00,185710,Staff,0,4,35,35
1683360233346,ETHN 103A,A00,199228,Man; Simeon S,2,0,9,7
1683360234370,ETHN 109,A00,185711,Staff,18,0,35,17
1683360235393,ETHN 142,A00,185726,Staff,0,4,30,30
1683360236418,ETHN 163J,A00,199229,Man; Simeon S,5,0,8,3
1683360237442,ETHN 168,A00,185727,Staff,8,0,10,2
1683360238466,ETHN 182,A00,185728,Staff,0,0,35,35
1683360239490,ETHN 183,A00,185737,Staff,8,0,18,10
1683360240514,GLBH 111,A01,209361,Burgos; Jose L.,0,0,0,0
1683360242565,HIEU 104,A00,185792,Staff,16,0,20,4
1683360243590,HIEU 115,A00,185800,Staff,1,0,20,19
1683360244674,HIEU 128,A00,185801,Staff,0,7,20,20
1683360245701,HIEU 147,A00,185802,Staff,16,0,20,4
1683360246726,HIEU 154,A00,185823,Staff,12,0,20,8
1683360247751,HILA 102,A00,185826,Staff,13,0,20,7
1683360248776,HILD 2C,A01,185778,Staff,0,12,20,20
1683360249800,HILD 7B,A01,185780,Kwak; Nancy,0,15,32,32
1683360249800,HILD 7B,A02,185781,Kwak; Nancy,0,18,32,32
1683360250834,HILD 30,A01,185791,Staff,14,0,20,6
1683360251859,HISC 119,A00,185830,Golan; Tal,0,9,20,20
1683360252890,HITO 156GS,A00,185831,Patterson; Patrick H.,0,0,0,23
1683360253914,HIUS 103,A00,185832,Man; Simeon S,1,6,20,19
1683360254943,HIUS 117,A00,185836,Kwak; Nancy,2,0,20,18
1683360255968,HIUS 125,A00,185840,Man; Simeon S,0,0,23,23
1683360256992,HIUS 149,A00,185845,Staff,0,0,20,20
1683360258018,HUM 3,A01,185882,Zavodny; Tatiana Sophia,0,7,50,50
1683360258018,HUM 3,B01,185899,Caldwell; Michael Alan,0,18,50,50
1683360259049,HUM 3GS,A00,185900,Patterson; Patrick H.,0,0,0,23
1683360260075,HUM 4,A01,185938,Zroka; Amy Liane,31,0,50,19
1683360260075,HUM 4,B01,185956,Watkins; Eric,0,3,50,50
1683360260075,HUM 4,B02,202209,Watkins; Eric,0,2,50,50
1683360260075,HUM 4,B03,202210,Watkins; Eric,0,2,50,50
1683360261106,HUM 5,A01,185958,West; Geoffrey Scott,3,0,50,47
1683360261106,HUM 5,A02,202215,West; Geoffrey Scott,0,0,50,50
1683360262131,INTL 190,A00,185959,Gagnon; Jeffrey C,0,0,0,9
1683360262131,INTL 190,B00,185960,Lettieri; Michael Joseph,0,0,0,1
1683360263154,JAPN 180,A00,254509,Staff,4,0,30,26
1683360264180,LATI 10,A01,202853,Kennemore; Amy Michelle,4,0,35,31
1683360264180,LATI 10,A02,202854,Kennemore; Amy Michelle,2,0,35,33
1683360264180,LATI 10,A03,270054,Kennemore; Amy Michelle,30,0,30,0
1683360265204,LATI 180,A00,202855,Kennemore; Amy Michelle,11,0,20,9
1683360266232,LAWS 101,A00,201767,Golan; Tal,0,7,40,40
1683360267259,LIFR 1C,A00,185961,Staff,6,0,20,14
1683360268286,LIFR 1CX,A00,185962,Staff,7,0,20,13
1683360269312,LIFR 1D,A00,185963,Staff,9,0,20,11
1683360270336,LIFR 1DX,A00,185964,Staff,9,0,20,11
1683360271361,LIGN 101,A01,186039,Staff,43,0,50,7
1683360272386,LIGN 165,A00,186040,Staff,18,0,50,32
1683360273412,LTCS 108,A00,186041,Staff,6,0,10,4
1683360274438,LTCS 119,A00,186042,Staff,16,0,20,4
1683360275462,LTCS 130,A00,186043,Wesling; Megan E.,15,0,25,10
1683360277513,LTEA 138,A00,186119,Staff,14,0,40,26
1683360278540,LTEN 124,A00,186148,Staff,6,0,25,19
1683360279568,LTEN 178,A00,186149,Staff,7,0,15,8
1683360280596,LTEN 181,A00,186150,Blanco; John D,33,0,40,7
1683360281621,LTWL 120,A00,186160,Staff,20,0,25,5
1683360282646,LTWL 165,A00,186161,Staff,22,0,25,3
1683360283668,LTWR 100,A00,186162,Staff,0,5,15,15
1683360284697,LTWR 102,A00,186163,Doller; Ben,5,0,15,10
1683360285726,MAE 8,A01,186412,Staff,0,0,0,0
1683360286751,MAE 30B,A00,186445,Bahadori; Mohammad Yousef,83,0,100,17
1683360287778,MAE 40,A00,186592,Bewley; Thomas R,10,0,50,40
1683360288804,MAE 101B,A00,186593,Bahadori; Mohammad Yousef,81,0,100,19
1683360289828,MAE 105,A00,186594,Bandaru; Prabhakar,12,0,50,38
1683360290857,MAE 107,A00,186599,Pham; Hieu Tan,0,7,120,120
1683360291884,MAE 148,A01,186660,Silberman; Jack,3,0,16,13
1683360292914,MATH 10A,A01,188095,Staff,0,5,35,35
1683360293942,MATH 10B,A01,188097,Bowers; Adam R.,0,11,30,30
1683360293942,MATH 10B,A02,188099,Bowers; Adam R.,0,11,30,30
1683360293942,MATH 10B,B01,188104,Bowers; Adam R.,0,10,30,30
1683360293942,MATH 10B,B02,188106,Bowers; Adam R.,0,10,30,30
1683360294969,MATH 10C,A01,188111,Staff,0,18,30,30
1683360294969,MATH 10C,A02,188127,Staff,0,17,30,30
1683360294969,MATH 10C,A03,188131,Staff,0,18,30,30
1683360294969,MATH 10C,B01,188218,Staff,18,0,30,12
1683360294969,MATH 10C,B02,188244,Staff,13,0,30,17
1683360294969,MATH 10C,B03,188277,Staff,16,0,30,14
1683360296002,MATH 18,A01,188344,Bach; Quang Tran,18,0,30,12
1683360296002,MATH 18,A02,188345,Bach; Quang Tran,11,0,30,19
1683360296002,MATH 18,B01,188353,Bach; Quang Tran,10,0,30,20
1683360296002,MATH 18,B02,188354,Bach; Quang Tran,20,0,30,10
1683360297026,MATH 20A,A01,188374,Staff,12,0,35,23
1683360298051,MATH 20B,A01,188382,Ohm; Ko Woon,6,0,30,24
1683360298051,MATH 20B,A02,188383,Ohm; Ko Woon,22,0,30,8
1683360298051,MATH 20B,B01,188385,Ohm; Ko Woon,7,0,30,23
1683360298051,MATH 20B,B02,188392,Ohm; Ko Woon,22,0,30,8
1683360299075,MATH 20C,A01,188394,Harel; Guershon,10,0,30,20
1683360299075,MATH 20C,A02,188395,Harel; Guershon,15,0,30,15
1683360299075,MATH 20C,B01,188404,Harel; Guershon,4,0,30,26
1683360299075,MATH 20C,B02,188405,Harel; Guershon,19,0,30,11
1683360300102,MATH 20D,A01,188414,Hammock; Frances H,0,1,30,30
1683360300102,MATH 20D,A02,188415,Hammock; Frances H,3,0,30,27
1683360300102,MATH 20D,B01,188447,Hammock; Frances H,1,0,30,29
1683360300102,MATH 20D,B02,188486,Hammock; Frances H,8,0,30,22
1683360301127,MATH 20E,A01,188649,Staff,21,0,30,9
1683360301127,MATH 20E,A02,188650,Staff,23,0,30,7
1683360301127,MATH 20E,A03,188673,Staff,0,0,30,30
1683360302162,MATH 102,A01,188675,Staff,0,35,35,35
1683360303193,MATH 103B,A01,188681,Staff,3,0,35,32
1683360303193,MATH 103B,B01,188692,Staff,5,0,35,30
1683360304223,MATH 109,A01,188695,Salehi Golsefidy; Alireza,25,0,35,10
1683360304223,MATH 109,A02,188696,Salehi Golsefidy; Alireza,25,0,35,10
1683360305253,MATH 120A,A01,188698,Eggers; John Dietrich,7,0,35,28
1683360306282,MATH 142B,A01,188736,Ioana; Adrian,0,2,30,30
1683360306282,MATH 142B,A02,188741,Ioana; Adrian,0,0,30,30
1683360306282,MATH 142B,A03,188743,Ioana; Adrian,0,1,30,30
1683360307311,MATH 168A,A01,188790,Staff,0,9,35,35
1683360308335,MATH 170A,A01,188803,Nie; Jiawang,0,2,35,35
1683360308335,MATH 170A,A02,188811,Nie; Jiawang,0,0,35,35
1683360308335,MATH 170A,A03,188814,Nie; Jiawang,1,0,35,34
1683360308335,MATH 170A,A04,188815,Nie; Jiawang,13,0,35,22
1683360309361,MATH 193B,A01,188817,Staff,0,0,35,35
1683360309361,MATH 193B,A02,188818,Staff,5,0,35,30
1683360310383,MGT 4,A01,202857,Anderson; John Charles,61,0,80,19
1683360311408,MGT 12,A00,202858,Lindenberger; Wade Douglas,42,0,90,48
1683360312435,MGT 18,A00,202859,Staff,74,0,90,16
1683360313466,MGT 18GS,A00,202860,McKay; Michael J,13,0,28,15
1683360314494,MGT 45,A00,202861,Pecore; Joseph P.,14,0,90,76
1683360315519,MGT 100,A00,202863,Yavorsky; Daniel Ryan,28,0,90,62
1683360316545,MGT 103,A00,202864,Ehrich; Kristine R,0,17,90,90
1683360317570,MGT 112,A00,202865,Ehrich; Kristine R,15,0,90,75
1683360318600,MGT 121A,A00,202868,Staff,0,20,0,0
1683360319625,MGT 131B,A00,202869,Anderson; John Charles,59,0,90,31
1683360320651,MGT 136,A00,202871,Lindenberger; Wade Douglas,84,0,90,6
1683360321679,MGT 164,A00,202873,Staff,0,68,90,91
1683360322703,MGT 164GS,A00,202874,McKay; Mary A,13,0,28,15
1683360323742,MGT 180,A00,202875,Staff,0,50,90,91
1683360324767,MMW 11R,A01,205019,Herbst; Matthew,3,0,30,27
1683360324767,MMW 11R,A02,205026,Herbst; Matthew,29,0,30,1
1683360325795,MMW 15,A01,193512,Chang; Edmond Yi-Teh,0,9,28,28
1683360325795,MMW 15,A02,193513,Chang; Edmond Yi-Teh,0,5,28,28
1683360325795,MMW 15,A03,193514,Chang; Edmond Yi-Teh,0,5,28,28
1683360325795,MMW 15,A04,193515,Chang; Edmond Yi-Teh,0,5,28,28
1683360325795,MMW 15,A05,193516,Chang; Edmond Yi-Teh,0,4,28,28
1683360325795,MMW 15,A06,193517,Chang; Edmond Yi-Teh,0,5,28,28
1683360325795,MMW 15,B01,193519,Chang; Edmond Yi-Teh,0,5,28,28
1683360325795,MMW 15,B02,193520,Chang; Edmond Yi-Teh,0,5,28,28
1683360325795,MMW 15,B03,193521,Chang; Edmond Yi-Teh,0,5,28,28
1683360325795,MMW 15,B04,193522,Chang; Edmond Yi-Teh,0,4,28,28
1683360325795,MMW 15,B05,193523,Chang; Edmond Yi-Teh,0,5,28,28
1683360325795,MMW 15,B06,193524,Chang; Edmond Yi-Teh,0,4,28,28
1683360326825,MMW 122,A01,193526,Rahimi; Babak,0,15,28,28
1683360326825,MMW 122,A02,193527,Rahimi; Babak,0,14,28,28
1683360326825,MMW 122,A03,193528,Rahimi; Babak,0,0,0,0
1683360326825,MMW 122,A04,193529,Rahimi; Babak,0,0,0,0
1683360327854,MUS 1A,A01,186663,Staff,0,20,35,35
1683360328882,MUS 4,A01,186715,Staff,0,12,35,35
1683360329908,MUS 5R,A01,186796,Dubnov; Shlomo,0,17,35,35
1683360330934,MUS 6,A01,186798,Staff,0,4,25,25
1683360331962,MUS 7,A01,186830,Staff,13,0,35,22
1683360332991,MUS 8,A01,186930,Staff,0,26,35,35
1683360334020,MUS 15,A01,186932,Staff,0,16,35,35
1683360334020,MUS 15,B01,186934,Staff,0,15,35,35
1683360335049,MUS 80,A00,186935,Staff,0,0,20,20
1683360335049,MUS 80,B00,186936,Staff,25,0,25,0
1683360336075,NANO 11,A00,204702,Lipomi; Darren John,0,0,0,0
1683360337101,NANO 15,A01,204709,Yang; Kesong,0,1,0,0
1683360338128,NANO 114,A00,202069,Jahed Motlagh; Zeinab,3,0,10,7
1683360339158,PHIL 1,A00,186955,Grush; Rick Scott,32,0,40,8
1683360340183,PHIL 10,A01,186973,Grush; Rick Scott,28,0,35,7
1683360340183,PHIL 10,A02,186974,Grush; Rick Scott,33,0,35,2
1683360341210,PHIL 13,A01,186976,Staff,7,0,35,28
1683360341210,PHIL 13,A02,186977,Staff,16,0,35,19
1683360342237,PHIL 14,A01,186979,Staff,31,0,35,4
1683360342237,PHIL 14,A02,186986,Staff,32,0,35,3
1683360343265,PHIL 28,A01,186988,Staff,16,0,30,14
1683360343265,PHIL 28,A02,186989,Staff,1,0,30,29
1683360343265,PHIL 28,A03,186990,Staff,9,0,30,21
1683360343265,PHIL 28,A04,186991,Staff,26,0,30,4
1683360344291,PHIL 120,A00,186997,Staff,23,0,40,17
1683360345317,PHIL 137,A00,187003,Staff,9,0,40,31
1683360346342,PHIL 150,A00,187015,Staff,47,0,70,23
1683360347372,PHIL 167,A00,187021,Lamey; Andy M.,35,0,40,5
1683360348470,PHIL 174,A01,202226,Staff,17,0,20,3
1683360348470,PHIL 174,A02,202235,Staff,20,0,20,0
1683360349497,PHIL 191A,A00,258918,Staff,0,0,1,1
1683360350523,PHYS 1A,A00,187028,Staff,27,0,60,33
1683360351547,PHYS 1AL,001,187036,Staff,2,0,30,28
1683360351547,PHYS 1AL,002,187049,Staff,18,0,30,12
1683360352571,PHYS 1B,A00,187058,Staff,22,0,60,38
1683360353598,PHYS 1BL,001,187064,Staff,0,0,30,30
1683360353598,PHYS 1BL,002,187070,Staff,5,0,30,25
1683360354623,PHYS 1C,A00,187082,Staff,31,0,120,89
1683360355649,PHYS 1CL,001,187088,Staff,0,9,30,30
1683360355649,PHYS 1CL,002,187089,Staff,0,2,30,30
1683360355649,PHYS 1CL,009,262693,Staff,11,0,30,19
1683360356674,PHYS 2B,A01,187097,Staff,54,0,115,61
1683360357699,PHYS 2C,A01,187099,Staff,67,0,115,48
1683360358745,PHYS 2CL,A01,187101,Staff,5,0,28,23
1683360358745,PHYS 2CL,A02,187102,Staff,15,0,28,13
1683360359777,PHYS 2D,A01,187123,Shotwell; Brian,95,0,115,20
1683360360805,PHYS 4B,A01,187133,Grinstein; Benjamin,35,0,50,15
1683360361833,POLI 10,A00,188819,Staff,0,4,50,50
1683360362860,POLI 11,A00,188827,Staff,43,0,50,7
1683360363889,POLI 13R,A00,188828,Staff,0,1,20,20
1683360364913,POLI 27,A01,188830,Elgin; Samuel Zincke,0,1,70,70
1683360365942,POLI 30,A00,188832,Desposato; Scott,31,0,50,19
1683360366968,POLI 102F,A00,188834,Staff,3,0,40,37
1683360367992,POLI 104A,A00,188852,Staff,14,0,30,16
1683360369021,POLI 104I,A00,188853,Staff,0,6,20,20
1683360370050,POLI 110B,A00,188854,Wiens; David,7,0,20,13
1683360371081,POLI 112A,A00,188855,Wiens; David,5,0,30,25
1683360372112,POLI 117R,A00,188856,Forman; Fonna,0,11,20,20
1683360373142,POLI 118,A00,188857,Ingham; Sean,8,0,20,12
1683360374170,POLI 120G,A00,188858,Staff,9,0,30,21
1683360375197,POLI 131CR,A00,188863,Hoston; Germaine,23,0,50,27
1683360376224,POLI 133,A00,188864,Nellis; Gareth Hb,44,0,50,6
1683360377250,POLI 134D,A00,188865,Desposato; Scott,27,0,30,3
1683360378277,POLI 142A,A00,188871,Gartzke; Erik,22,0,50,28
1683360379303,POLI 142K,A00,188874,Staff,38,0,50,12
1683360380329,POLI 143,A00,188940,Gartzke; Erik,16,0,30,14
1683360381356,POLI 153,A00,188943,Staff,3,0,20,17
1683360382381,POLI 160AA,A00,188944,Staff,11,0,40,29
1683360383410,POLI 170A,A00,188945,Staff,11,0,30,19
1683360385469,PSYC 1,A00,188952,Staff,37,0,90,53
1683360386500,PSYC 2,B00,188953,Staff,19,0,35,16
1683360387529,PSYC 6,A00,188970,Staff,47,0,60,13
1683360388555,PSYC 7,A00,188973,Staff,37,0,45,8
1683360389582,PSYC 60,A01,188980,Rickard; Timothy C.,43,0,60,17
1683360390607,PSYC 70,A01,189001,Steiner; Eric Tomas,23,0,45,22
1683360391633,PSYC 100,A00,189005,Lacefield; Katharine I,0,98,120,120
1683360392659,PSYC 102,A00,189008,Staff,9,0,30,21
1683360393688,PSYC 106,B00,189026,Gorman; Michael R.,34,0,60,26
1683360394743,PSYC 114,B01,189033,Winkielman; Piotr,0,32,30,30
1683360395769,PSYC 131,A00,189036,Anagnostaras; Stephan,0,43,60,60
1683360396798,PSYC 136,A00,189041,Lowe; Angela Beth,0,7,25,25
1683360397826,PSYC 137,A00,189057,Winkielman; Piotr,0,34,25,25
1683360398851,PSYC 144,A00,189107,Wixted; John T,0,7,50,50
1683360400903,PSYC 162,A00,189142,Staff,0,8,85,85
1683360401929,PSYC 172,A00,189144,Gorman; Michael R.,0,7,30,30
1683360403979,PSYC 179,A00,189146,Lacefield; Katharine I,0,84,120,120
1683360405004,PSYC 181,A00,189147,Anagnostaras; Stephan,0,44,90,90
1683360406030,PSYC 190R,A00,189148,Barner; David A.,0,22,80,80
1683360407057,PSYC 191,A00,189275,Rickard; Timothy C.,0,7,25,25
1683360408081,PSYC 193,A00,189276,Chapman; Eddie Nathaniel,0,1,0,4
1683360409106,PSYC 193L,A01,189281,Lowe; Angela Beth,12,0,20,8
1683360409106,PSYC 193L,B01,189285,Staff,28,0,35,7
1683360410138,RELI 149,A00,187137,Rahimi; Babak,7,0,40,33
1683360411164,SE 9,A01,187315,Staff,0,2,18,18
1683360412190,SE 101B,A00,187409,Staff,24,0,30,6
1683360413220,SE 110B,A00,187444,Staff,10,0,40,30
1683360414245,SE 130B,A00,187449,Staff,31,0,40,9
1683360415269,SE 150A,A00,187516,Staff,9,0,20,11
1683360416293,SE 154,A00,187528,Staff,30,0,50,20
1683360417318,SIO 3,A01,258171,Staff,35,0,40,5
1683360418341,SIO 10,A00,187144,Cook; Geoffrey W,0,3,75,75
1683360419365,SIO 45,A00,187152,Cook; Geoffrey W,1,0,100,99
1683360420394,SIO 109R,A00,194486,Staff,0,3,20,20
1683360422451,SIO 187,A01,187233,Kacev; David,12,0,40,28
1683360423483,SOCI 1,A01,258656,Thorpe; Charles Robert,28,0,30,2
1683360423483,SOCI 1,A02,258658,Thorpe; Charles Robert,30,0,30,0
1683360423483,SOCI 1,A03,258661,Thorpe; Charles Robert,25,0,25,0
1683360423483,SOCI 1,A04,258666,Thorpe; Charles Robert,22,0,25,3
1683360423483,SOCI 1,A05,258897,Thorpe; Charles Robert,23,0,25,2
1683360423483,SOCI 1,A06,258898,Thorpe; Charles Robert,25,0,25,0
1683360424509,SOCI 30,A01,258903,Pardo Guerra; Juan Pablo,15,0,30,15
1683360425534,SOCI 102,A00,258904,Staff,9,0,25,16
1683360426558,SOCI 106,A00,258905,Staff,19,0,25,6
1683360427587,SOCI 111,A00,258907,Ribas Norris; Janet Vanesa,26,0,30,4
1683360428616,SOCI 121R,A00,258908,Pardo Guerra; Juan Pablo,10,0,30,20
1683360429645,SOCI 126,A01,203330,Staff,14,0,20,6
1683360430670,SOCI 131,A00,258909,Thorpe; Charles Robert,31,0,60,29
1683360431696,SOCI 135,A00,258910,Payne; Christine Anna,0,9,30,30
1683360432738,SOCI 157,A00,258911,Staff,12,0,30,18
1683360433766,SOCI 184,A00,258912,Staff,25,0,30,5
1683360434792,SOCI 188D,A00,258913,Staff,22,0,30,8
1683360435816,SYN 2,001,187529,Staff,10,0,16,6
1683360435816,SYN 2,002,201452,Staff,0,18,16,16
1683360435816,SYN 2,003,201469,Staff,3,0,16,13
1683360436841,SYN 100,A01,187531,Staff,0,9,20,20
1683360436841,SYN 100,B01,201491,Staff,0,12,20,20
1683360437867,TDAC 1,A00,189286,Walsh; Kim C.,3,0,20,17
1683360437867,TDAC 1,B00,189287,Harting; Carla Kelso,11,0,20,9
1683360438894,TDAC 101,A00,189300,Walsh; Kim C.,16,0,20,4
1683360438894,TDAC 101,B00,189301,Harting; Carla Kelso,18,0,20,2
1683360439921,TDAC 102,A00,189304,Basso; Beatrice,14,0,20,6
1683360440958,TDAC 108,A00,189305,Staff,18,0,20,2
1683360441986,TDDE 131,A00,189310,Staff,19,0,20,1
1683360441986,TDDE 131,B00,189314,Staff,19,0,20,1
1683360441986,TDDE 131,C00,189315,Staff,48,0,50,2
1683360441986,TDDE 131,D00,189316,Staff,14,0,15,1
1683360441986,TDDE 131,E00,204841,Staff,20,0,20,0
1683360443016,TDGE 10,A00,189289,Staff,30,0,50,20
1683360443016,TDGE 10,B00,189290,Havis; Allan,1,0,50,49
1683360444047,TDGE 11,A00,189291,Fulton; Julia,0,3,50,50
1683360444047,TDGE 11,B00,189292,Staff,20,0,25,5
1683360444047,TDGE 11,C00,260270,Staff,0,0,0,0
1683360445073,TDGE 25,A00,189294,Staff,3,0,20,17
1683360446101,TDGE 124,A00,189318,Fulton; Julia,0,8,50,50
1683360447129,TDGE 125,A00,189319,Staff,13,0,25,12
1683360447129,TDGE 125,B00,189320,Staff,23,0,25,2
1683360448152,TDGE 127,A00,189322,Havis; Allan,0,0,50,50
1683360449181,TDHT 101,A00,189323,Staff,18,0,25,7
1683360449181,TDHT 101,B00,189324,Staff,25,0,25,0
1683360450210,TDHT 102,A00,189325,Staff,49,0,50,1
1683360451234,TDMV 1,A00,189295,Arcidiacono; Kristin,19,0,30,11
1683360451234,TDMV 1,B00,189296,Caligagan; Maria T.,24,0,30,6
1683360452319,TDMV 2,A00,189297,Sammartano; Tonnie,28,0,30,2
1683360452319,TDMV 2,B00,189299,Arcidiacono; Kristin,24,0,30,6
1683360453349,TDMV 3,A00,204998,Rincon; Alicia,22,0,30,8
1683360454377,TDMV 120,A00,189458,Sammartano; Tonnie,28,0,30,2
1683360455408,TDMV 138,A00,189541,Jun; Grace Shin Hae,22,0,40,18
1683360456438,TDMV 142,A00,189717,Caligagan; Tony,23,0,30,7
1683360456438,TDMV 142,B00,189718,Caligagan; Maria T.,25,0,30,5
1683360457463,TMC 2,A01,187533,Staff,25,0,25,0
1683360457463,TMC 2,A02,187534,Staff,25,0,25,0
1683360458489,USP 1,A01,187536,Kwak; Nancy,0,16,25,25
1683360459514,USP 5,A01,187538,Staff,10,0,25,15
1683360460542,USP 101,A00,199253,Staff,0,4,0,0
1683360461565,USP 124,A00,187562,Boomhower; Matthew Charles,1,0,30,29
1683360462593,USP 138,A00,187582,Staff,20,0,25,5
1683360463622,USP 152,A01,187597,Staff,4,0,25,21
1683360464649,USP 153,A00,187598,Staff,19,0,25,6
1683360465674,USP 168,A00,187607,Kwak; Nancy,2,0,5,3
1683360466698,USP 173,A00,187619,Staff,4,0,25,21
1683360467723,USP 181,A00,187638,Staff,0,3,25,25
1683360468752,VIS 103,A00,187650,Cruz; Edwin Teddy,22,0,75,53
1683360469776,VIS 110D,A00,187669,Staff,12,0,22,10
1683360470802,VIS 127C,A00,187720,Shen; Kuiyi,67,0,146,79
1683360471826,VIS 149,A00,187731,Yoldas; Pinar,0,14,22,22
1683360472850,VIS 151,A01,188091,Staff,22,0,34,12
1683360472850,VIS 151,A02,188092,Staff,11,0,34,23
1683360473875,VIS 160B,A00,188093,Stalbaum; Brett,0,0,10,10
1683360475925,WCWP 10B,A00,201720,Staff,10,0,15,5
1683360475925,WCWP 10B,B00,201722,Staff,9,0,15,6
1683360476951,WCWP 100,A00,201725,Gagnon; Jeffrey C,0,0,2,2
1683360476951,WCWP 100,B00,201727,Staff,0,4,15,15
1683360480080,ANBI 133,A00,258401,Wilder; Linnea Lorene,34,0,40,6
1683360481107,ANBI 140,A00,258395,Hrvoj Mihic; Branka,18,0,25,7
1683360482133,ANSC 120,A00,258402,Bialecki; Jon Anthony,27,0,40,13
1683360483158,ANSC 144,A00,258400,Staff,14,0,40,26
1683360485216,ANSC 166,A00,258396,Parish; Steven Martin,157,0,175,18
1683360486241,ANSC 180,A00,193533,Staff,9,0,20,11
1683360487267,ANSC 188,A00,258397,Jassal; Aftab,33,0,40,7
1683360488292,ANTH 3,A01,258316,Staff,23,0,30,7
1683360489318,ANTH 5,A00,258394,Semendeferi; Ekaterini,16,0,20,4
1683360490347,ANTH 21,A01,258331,Staff,8,0,40,32
1683360491373,ANTH 103,A00,258398,Varma; Saiba,15,0,25,10
1683360492403,AWP 10,001,202034,Staff,0,0,0,0
1683360492403,AWP 10,002,202035,Staff,0,0,0,0
1683360492403,AWP 10,003,202036,Staff,0,0,0,0
1683360492403,AWP 10,004,202037,Staff,0,0,0,0
1683360492403,AWP 10,005,202038,Staff,0,0,0,0
1683360492403,AWP 10,006,202039,Staff,0,0,0,0
1683360492403,AWP 10,007,202040,Staff,0,0,0,0
1683360492403,AWP 10,008,202041,Staff,0,0,0,0
1683360492403,AWP 10,009,202042,Staff,0,0,0,0
1683360492403,AWP 10,010,202043,Staff,0,0,0,0
1683360492403,AWP 10,011,202044,Staff,0,0,0,0
1683360492403,AWP 10,012,202045,Staff,0,0,0,0
1683360492403,AWP 10,013,202046,Staff,0,0,0,0
1683360492403,AWP 10,014,202047,Staff,0,0,0,0
1683360492403,AWP 10,015,202048,Staff,0,0,0,0
1683360492403,AWP 10,016,202049,Staff,0,0,0,0
1683360492403,AWP 10,017,202050,Staff,0,0,0,0
1683360492403,AWP 10,018,202051,Staff,0,0,0,0
1683360492403,AWP 10,019,202052,Staff,0,0,0,0
1683360492403,AWP 10,020,202053,Staff,0,0,0,0
1683360492403,AWP 10,021,202054,Staff,0,0,0,0
1683360492403,AWP 10,022,202055,Staff,0,0,0,0
1683360492403,AWP 10,023,202056,Staff,0,0,0,0
1683360492403,AWP 10,024,202057,Staff,0,0,0,0
1683360492403,AWP 10,025,202058,Staff,0,0,0,0
1683360492403,AWP 10,026,202059,Staff,0,0,0,0
1683360493430,AWP 102,001,202032,Staff,0,0,0,0
1683360493430,AWP 102,002,202033,Staff,0,0,0,0
1683360494456,BENG 100,A01,254234,Taylor Amos; Alyssa C,31,0,40,9
1683360495481,BENG 196,001,270013,Engler; Adam J.,9999,0,9999,0
1683360496514,BICD 100R,A01,202018,Smith; Laurie,0,7,32,32
1683360496514,BICD 100R,A02,202019,Smith; Laurie,0,2,32,32
1683360496514,BICD 100R,A03,202020,Smith; Laurie,0,1,32,32
1683360496514,BICD 100R,A04,202021,Smith; Laurie,9,0,32,23
1683360496514,BICD 100R,A05,202022,Smith; Laurie,12,0,32,20
1683360497541,BICD 136,A01,193242,Gustafson-Brown; Cindy,0,2,32,32
1683360497541,BICD 136,A02,193244,Gustafson-Brown; Cindy,14,0,32,18
1683360498569,BIEB 102,A01,193249,Butler; Shannon Rhey,0,2,32,32
1683360498569,BIEB 102,A02,193251,Butler; Shannon Rhey,0,0,32,32
1683360498569,BIEB 102,A03,193253,Butler; Shannon Rhey,0,1,32,32
1683360498569,BIEB 102,A04,193255,Butler; Shannon Rhey,17,0,32,15
1683360498569,BIEB 102,A05,193265,Butler; Shannon Rhey,26,0,32,6
1683360498569,BIEB 102,A06,193269,Butler; Shannon Rhey,16,0,32,16
1683360500620,BIEB 150,A01,193274,Staff,0,0,32,32
1683360500620,BIEB 150,A02,193285,Staff,23,0,32,9
1683360501646,BIEB 194,A00,193286,Kurle; Carolyn M.,22,0,32,10
1683360502674,BILD 1,A01,192291,Staff,16,0,32,16
1683360502674,BILD 1,A02,192292,Staff,30,0,32,2
1683360502674,BILD 1,B01,192520,Reuther; Keefe,0,1,0,0
1683360502674,BILD 1,B02,192532,Reuther; Keefe,0,1,0,0
1683360503699,BILD 3,A01,192556,Butler; Shannon Rhey,0,0,32,32
1683360503699,BILD 3,A02,192581,Butler; Shannon Rhey,4,0,32,28
1683360503699,BILD 3,A03,192611,Butler; Shannon Rhey,23,0,32,9
1683360503699,BILD 3,A04,192612,Butler; Shannon Rhey,25,0,32,7
1683360503699,BILD 3,A05,192613,Butler; Shannon Rhey,27,0,32,5
1683360503699,BILD 3,A06,192679,Butler; Shannon Rhey,27,0,32,5
1683360503699,BILD 3,A07,192682,Butler; Shannon Rhey,22,0,32,10
1683360504731,BILD 4,A01,192836,Reuther; Keefe,0,0,24,24
1683360504731,BILD 4,A02,193044,Reuther; Keefe,4,0,24,20
1683360505756,BILD 10,A01,193142,Gustafson-Brown; Cindy,30,0,32,2
1683360505756,BILD 10,A02,193149,Gustafson-Brown; Cindy,31,0,32,1
1683360506786,BIMM 100,A01,193301,Staff,1,6,32,31
1683360506786,BIMM 100,A02,193312,Staff,0,5,32,32
1683360506786,BIMM 100,A03,193323,Staff,0,8,32,32
1683360507817,BIMM 101,A01,193329,McDonnell; Lisa Marie,0,3,24,24
1683360507817,BIMM 101,A02,193339,McDonnell; Lisa Marie,0,3,24,24
1683360507817,BIMM 101,B01,193354,McDonnell; Lisa Marie,0,3,24,24
1683360507817,BIMM 101,B02,193357,McDonnell; Lisa Marie,0,3,24,24
1683360508847,BIMM 110,A01,193377,Tat; John,0,11,32,32
1683360508847,BIMM 110,A02,193378,Tat; John,0,9,32,32
1683360509872,BIMM 120,A01,206116,Staff,0,0,32,32
1683360509872,BIMM 120,A02,206117,Staff,8,0,32,24
1683360509872,BIMM 120,A03,206121,Staff,21,0,32,11
1683360510899,BIPN 100,A01,193393,Park; Ji Young,0,14,32,32
1683360510899,BIPN 100,A02,193402,Park; Ji Young,0,13,32,32
1683360510899,BIPN 100,A03,193413,Park; Ji Young,0,14,32,32
1683360510899,BIPN 100,A04,193414,Park; Ji Young,0,13,32,32
1683360511923,BIPN 102,A01,193429,Staff,0,0,32,32
1683360511923,BIPN 102,A02,193438,Staff,22,0,32,10
1683360512954,BIPN 106,A01,193450,Reyes Gonzalez; Catalina,0,2,40,40
1683360513984,BIPN 134,A01,193465,Cooke; James Edward,1,0,32,31
1683360513984,BIPN 134,A02,193474,Cooke; James Edward,25,0,32,7
1683360513984,BIPN 134,A03,193485,Cooke; James Edward,29,0,32,3
1683360513984,BIPN 134,A04,193486,Cooke; James Edward,21,0,32,11
1683360513984,BIPN 134,A05,193491,Cooke; James Edward,31,0,32,1
1683360513984,BIPN 134,A06,193501,Cooke; James Edward,30,0,32,2
1683360513984,BIPN 134,A07,193510,Cooke; James Edward,29,0,32,3
1683360516036,BISP 194,A00,222522,Staff,14,0,32,18
1683360517059,CAT 124,A01,202407,Staff,19,0,25,6
1683360518083,CAT 125,A00,202408,Marchisotto; Jennifer Anne,4,0,20,16
1683360519109,CAT 125R,A00,202409,Smith; Lauryn Alissa,0,11,20,20
1683360519109,CAT 125R,B00,202410,Morales; Celeste Georgianna,0,11,20,20
1683360519109,CAT 125R,C00,202411,Irwin; Matthew Joseph,0,10,20,20
1683360520139,CENG 15,A01,204712,Yang; Kesong,0,1,0,0
1683360521170,CENG 114,A00,202070,Jahed Motlagh; Zeinab,5,0,20,15
1683360522195,CGS 105,A00,185477,Wesling; Megan E.,24,0,40,16
1683360523221,CGS 106,A00,185494,Staff,13,0,22,9
1683360524249,CGS 108,A00,185495,Staff,14,0,20,6
1683360525276,CGS 114,A00,185496,Staff,13,0,18,5
1683360526301,CGS 119,A00,185501,Staff,15,0,20,5
1683360527327,CGS 120,A00,185511,Staff,13,0,20,7
1683360528360,CHEM 4,A01,184675,Bussey; Thomas J,96,0,100,4
1683360529383,CHEM 6A,A01,184677,Staff,34,0,60,26
1683360530411,CHEM 6B,A01,184679,Staff,65,0,100,35
1683360531442,CHEM 6C,A01,184681,Bussey; Thomas J,1,0,50,49
1683360531442,CHEM 6C,A02,184682,Bussey; Thomas J,34,0,50,16
1683360532468,CHEM 40A,A01,184684,Albizati; Kim F.,37,0,100,63
1683360533496,CHEM 40B,A01,184686,Albizati; Kim F.,0,20,100,100
1683360534522,CHEM 41B,A01,184690,Staff,52,0,100,48
1683360535547,COGS 3,A01,184715,Boyle; Mary E. T.,0,25,40,40
1683360536574,COGS 14B,A01,185172,Staff,0,15,38,38
1683360537598,COGS 18,A01,184736,Staff,16,0,80,64
1683360538623,COGS 100,A01,184932,Staff,0,5,73,73
1683360539662,COGS 101A,A01,184935,Staff,0,39,30,30
1683360540690,COGS 101B,A01,184944,Staff,0,2,30,30
1683360541717,COGS 101C,A01,184946,Staff,0,12,30,30
1683360542744,COGS 102A,A01,184951,Johnson; Christine M.,2,0,40,38
1683360543770,COGS 107B,A01,184953,Mooshagian; Eric Frederick,0,50,40,40
1683360544795,COGS 118B,A01,184959,Gupta; Anjum,0,48,40,40
1683360545822,COGS 153,A00,184961,Staff,0,15,30,30
1683360546847,COGS 177,A00,184962,Staff,0,20,30,30
1683360547872,COGS 187A,A01,184969,Boyle; Mary E. T.,0,17,40,40
1683360548898,COMM 10,A01,185174,Staff,0,5,25,25
1683360548898,COMM 10,A02,185189,Staff,0,5,25,25
1683360548898,COMM 10,A03,269821,Staff,0,0,0,0
1683360549922,COMM 100B,A01,185475,Staff,0,0,0,2
1683360549922,COMM 100B,A02,185476,Staff,13,0,25,12
1683360550946,COMM 100C,A01,185314,Staff,1,0,25,24
1683360550946,COMM 100C,A02,185327,Staff,19,0,25,6
1683360551974,COMM 110M,A00,185349,Staff,2,0,40,38
1683360553008,COMM 113T,A00,185352,Staff,24,0,40,16
1683360554037,COMM 114I,A00,185353,Staff,33,0,40,7
1683360555063,COMM 131,A00,185354,Staff,19,0,30,11
1683360556145,CSE 8A,A50,185358,Cao; Yingjun,0,46,10,10
1683360557173,CSE 8B,A01,185362,Staff,0,46,50,50
1683360558202,CSE 11,A01,185416,Cao; Yingjun,0,92,10,10
1683360559230,CSE 20,A01,185445,Briones; Jor-el Thomas Caparas,5,0,25,20
1683360560258,CSE 21,A01,185447,Staff,10,0,50,40
1683360561290,CSE 101,A01,185451,Staff,0,13,50,50
1683360561290,CSE 101,B01,185453,Jones; Miles E,0,11,50,50
1683360563343,CSE 141,A01,185458,Eldon; John,20,0,100,80
1683360564367,CSE 141L,A01,185461,Eldon; John,12,0,100,88
1683360565392,CSE 142,A01,185463,Staff,36,0,60,24
1683360565392,CSE 142,B01,201355,Staff,0,7,60,60
1683360566416,CSE 142L,A01,185470,Staff,36,0,60,24
1683360566416,CSE 142L,B01,201417,Staff,0,6,60,60
1683360567440,CSE 190,A00,201433,Staff,32,0,49,17
1683360568466,DOC 1,A01,259136,Strom; Megan C.,7,0,15,8
1683360568466,DOC 1,A02,259137,Strom; Megan C.,14,0,15,1
1683360568466,DOC 1,A03,259138,Strom; Megan C.,14,0,15,1
1683360568466,DOC 1,A04,259139,Strom; Megan C.,14,0,15,1
1683360569492,DOC 100D,A00,259140,Pass; Natalye Joann,16,0,25,9
1683360570519,DSGN 1,A01,184749,Rill; Bryan,0,26,30,30
1683360571543,DSGN 100,A01,185168,Staff,0,2,25,25
1683360572573,ECE 5,A01,185626,Morris; Karcher William,0,10,0,0
1683360573598,ECE 101,A01,185628,Staff,17,0,70,53
1683360574624,ECE 107,A01,185635,Baghdadchi; Saharnaz,0,0,20,20
1683360574624,ECE 107,A02,185638,Baghdadchi; Saharnaz,4,0,20,16
1683360575649,ECE 148,A01,185647,Silberman; Jack,0,0,16,16
1683360576680,ECON 1,A01,185537,Crane; Meredith Helen,54,0,70,16
1683360577709,ECON 3,A01,185549,Crane; Meredith Helen,32,0,70,38
1683360578737,ECON 4,A01,203354,Anderson; John Charles,0,4,10,10
1683360579762,ECON 100A,A01,185574,Staff,0,4,40,40
1683360580787,ECON 100B,A01,185576,Staff,0,12,50,50
1683360581812,ECON 100C,A01,185589,Newhouse; Herbert S,29,0,70,41
1683360582837,ECON 105,A00,185608,Vespa; Emanuel Ignacio,19,0,35,16
1683360583867,ECON 109,A01,185610,Shishkin; Denis,10,0,35,25
1683360584892,ECON 110A,A01,185612,Staff,11,0,40,29
1683360585916,ECON 120A,A01,185615,Staff,20,0,40,20
1683360586945,ECON 120C,A01,185617,Sun; Yixiao,0,21,70,70
1683360587972,ECON 144,A00,203346,Squires; Dale E,3,0,35,32
1683360588997,ECON 171,A01,203349,Newhouse; Herbert S,0,1,35,35
1683360590021,ECON 173A,A01,185621,Toda; Alexis Akira,21,0,35,14
1683360591048,EDS 25,A01,202413,Staff,0,1,0,0
1683360591048,EDS 25,A02,202414,Staff,0,1,0,0
1683360591048,EDS 25,A03,202415,Staff,0,0,0,0
1683360591048,EDS 25,A04,202416,Staff,0,1,0,0
1683360591048,EDS 25,A05,202439,Staff,0,0,0,0
1683360591048,EDS 25,A06,202440,Staff,0,0,0,0
1683360591048,EDS 25,B01,202631,Staff,0,0,0,0
1683360591048,EDS 25,B02,202632,Staff,0,0,0,0
1683360591048,EDS 25,B03,202639,Staff,0,0,0,0
1683360591048,EDS 25,B04,202640,Staff,0,0,0,0
1683360591048,EDS 25,B05,202643,Staff,0,0,0,0
1683360591048,EDS 25,B06,202644,Staff,0,0,0,0
1683360592072,EDS 38,A01,202659,Black; Alison Michelle,24,0,25,1
1683360593099,EDS 115,A00,202652,Staff,18,0,30,12
1683360594123,EDS 125,A00,202649,Staff,14,0,30,16
1683360595148,EDS 126,A01,203332,Staff,30,0,30,0
1683360596176,EDS 139,A00,202838,Staff,16,0,25,9
1683360597202,EDS 146,A01,202655,Staff,14,0,25,11
1683360598225,ENG 15,A00,185667,Staff,0,1,0,0
1683360598225,ENG 15,B00,185672,Staff,0,0,0,0
1683360598225,ENG 15,C00,185675,Staff,0,0,0,0
1683360598225,ENG 15,D00,185682,Staff,0,0,0,0
1683360598225,ENG 15,E00,185684,Staff,0,0,0,0
1683360599252,ETHN 103,A00,185710,Staff,0,4,35,35
1683360600278,ETHN 103A,A00,199228,Man; Simeon S,2,0,9,7
1683360601305,ETHN 109,A00,185711,Staff,18,0,35,17
1683360602328,ETHN 142,A00,185726,Staff,0,4,30,30
1683360603353,ETHN 163J,A00,199229,Man; Simeon S,5,0,8,3
1683360604378,ETHN 168,A00,185727,Staff,8,0,10,2
1683360605407,ETHN 182,A00,185728,Staff,0,0,35,35
1683360606434,ETHN 183,A00,185737,Staff,8,0,18,10
1683360607465,GLBH 111,A01,209361,Burgos; Jose L.,0,0,0,0
1683360609516,HIEU 104,A00,185792,Staff,16,0,20,4
1683360610544,HIEU 115,A00,185800,Staff,1,0,20,19
1683360611571,HIEU 128,A00,185801,Staff,0,7,20,20
1683360612599,HIEU 147,A00,185802,Staff,16,0,20,4
1683360613626,HIEU 154,A00,185823,Staff,12,0,20,8
1683360614655,HILA 102,A00,185826,Staff,13,0,20,7
1683360615682,HILD 2C,A01,185778,Staff,0,12,20,20
1683360616710,HILD 7B,A01,185780,Kwak; Nancy,0,15,32,32
1683360616710,HILD 7B,A02,185781,Kwak; Nancy,0,18,32,32
1683360617738,HILD 30,A01,185791,Staff,14,0,20,6
1683360618768,HISC 119,A00,185830,Golan; Tal,0,9,20,20
1683360619793,HITO 156GS,A00,185831,Patterson; Patrick H.,0,0,0,23
1683360620818,HIUS 103,A00,185832,Man; Simeon S,1,6,20,19
1683360621845,HIUS 117,A00,185836,Kwak; Nancy,2,0,20,18
1683360622868,HIUS 125,A00,185840,Man; Simeon S,0,0,23,23
1683360623895,HIUS 149,A00,185845,Staff,0,0,20,20
1683360624927,HUM 3,A01,185882,Zavodny; Tatiana Sophia,0,7,50,50
1683360624927,HUM 3,B01,185899,Caldwell; Michael Alan,0,18,50,50
1683360625953,HUM 3GS,A00,185900,Patterson; Patrick H.,0,0,0,23
1683360626979,HUM 4,A01,185938,Zroka; Amy Liane,31,0,50,19
1683360626979,HUM 4,B01,185956,Watkins; Eric,0,3,50,50
1683360626979,HUM 4,B02,202209,Watkins; Eric,0,2,50,50
1683360626979,HUM 4,B03,202210,Watkins; Eric,0,2,50,50
1683360628005,HUM 5,A01,185958,West; Geoffrey Scott,3,0,50,47
1683360628005,HUM 5,A02,202215,West; Geoffrey Scott,0,0,50,50
1683360629035,INTL 190,A00,185959,Gagnon; Jeffrey C,0,0,0,9
1683360629035,INTL 190,B00,185960,Lettieri; Michael Joseph,0,0,0,1
1683360630066,JAPN 180,A00,254509,Staff,4,0,30,26
1683360631096,LATI 10,A01,202853,Kennemore; Amy Michelle,4,0,35,31
1683360631096,LATI 10,A02,202854,Kennemore; Amy Michelle,2,0,35,33
1683360631096,LATI 10,A03,270054,Kennemore; Amy Michelle,30,0,30,0
1683360632120,LATI 180,A00,202855,Kennemore; Amy Michelle,11,0,20,9
1683360633144,LAWS 101,A00,201767,Golan; Tal,0,7,40,40
1683360634175,LIFR 1C,A00,185961,Staff,6,0,20,14
1683360635201,LIFR 1CX,A00,185962,Staff,7,0,20,13
1683360636229,LIFR 1D,A00,185963,Staff,9,0,20,11
1683360637253,LIFR 1DX,A00,185964,Staff,9,0,20,11
1683360638278,LIGN 101,A01,186039,Staff,43,0,50,7
1683360639306,LIGN 165,A00,186040,Staff,18,0,50,32
1683360640334,LTCS 108,A00,186041,Staff,6,0,10,4
1683360641357,LTCS 119,A00,186042,Staff,16,0,20,4
1683360642381,LTCS 130,A00,186043,Wesling; Megan E.,15,0,25,10
1683360644435,LTEA 138,A00,186119,Staff,14,0,40,26
1683360645461,LTEN 124,A00,186148,Staff,6,0,25,19
1683360646487,LTEN 178,A00,186149,Staff,7,0,15,8
1683360647517,LTEN 181,A00,186150,Blanco; John D,33,0,40,7
1683360648545,LTWL 120,A00,186160,Staff,20,0,25,5
1683360649574,LTWL 165,A00,186161,Staff,22,0,25,3
1683360650601,LTWR 100,A00,186162,Staff,0,5,15,15
1683360651630,LTWR 102,A00,186163,Doller; Ben,5,0,15,10
1683360652659,MAE 8,A01,186412,Staff,0,0,0,0
1683360653683,MAE 30B,A00,186445,Bahadori; Mohammad Yousef,83,0,100,17
1683360654712,MAE 40,A00,186592,Bewley; Thomas R,10,0,50,40
1683360655737,MAE 101B,A00,186593,Bahadori; Mohammad Yousef,81,0,100,19
1683360656766,MAE 105,A00,186594,Bandaru; Prabhakar,12,0,50,38
1683360657794,MAE 107,A00,186599,Pham; Hieu Tan,0,7,120,120
1683360658819,MAE 148,A01,186660,Silberman; Jack,3,0,16,13
1683360659904,MATH 10A,A01,188095,Staff,0,5,35,35
1683360660930,MATH 10B,A01,188097,Bowers; Adam R.,0,11,30,30
1683360660930,MATH 10B,A02,188099,Bowers; Adam R.,0,11,30,30
1683360660930,MATH 10B,B01,188104,Bowers; Adam R.,0,10,30,30
1683360660930,MATH 10B,B02,188106,Bowers; Adam R.,0,10,30,30
1683360661963,MATH 10C,A01,188111,Staff,0,18,30,30
1683360661963,MATH 10C,A02,188127,Staff,0,17,30,30
1683360661963,MATH 10C,A03,188131,Staff,0,18,30,30
1683360661963,MATH 10C,B01,188218,Staff,18,0,30,12
1683360661963,MATH 10C,B02,188244,Staff,13,0,30,17
1683360661963,MATH 10C,B03,188277,Staff,16,0,30,14
1683360662994,MATH 18,A01,188344,Bach; Quang Tran,18,0,30,12
1683360662994,MATH 18,A02,188345,Bach; Quang Tran,11,0,30,19
1683360662994,MATH 18,B01,188353,Bach; Quang Tran,10,0,30,20
1683360662994,MATH 18,B02,188354,Bach; Quang Tran,20,0,30,10
1683360664020,MATH 20A,A01,188374,Staff,12,0,35,23
1683360665054,MATH 20B,A01,188382,Ohm; Ko Woon,6,0,30,24
1683360665054,MATH 20B,A02,188383,Ohm; Ko Woon,22,0,30,8
1683360665054,MATH 20B,B01,188385,Ohm; Ko Woon,7,0,30,23
1683360665054,MATH 20B,B02,188392,Ohm; Ko Woon,22,0,30,8
1683360666081,MATH 20C,A01,188394,Harel; Guershon,10,0,30,20
1683360666081,MATH 20C,A02,188395,Harel; Guershon,15,0,30,15
1683360666081,MATH 20C,B01,188404,Harel; Guershon,4,0,30,26
1683360666081,MATH 20C,B02,188405,Harel; Guershon,19,0,30,11
1683360667108,MATH 20D,A01,188414,Hammock; Frances H,0,1,30,30
1683360667108,MATH 20D,A02,188415,Hammock; Frances H,3,0,30,27
1683360667108,MATH 20D,B01,188447,Hammock; Frances H,1,0,30,29
1683360667108,MATH 20D,B02,188486,Hammock; Frances H,8,0,30,22
1683360668137,MATH 20E,A01,188649,Staff,21,0,30,9
1683360668137,MATH 20E,A02,188650,Staff,23,0,30,7
1683360668137,MATH 20E,A03,188673,Staff,0,0,30,30
1683360669161,MATH 102,A01,188675,Staff,0,35,35,35
1683360670192,MATH 103B,A01,188681,Staff,3,0,35,32
1683360670192,MATH 103B,B01,188692,Staff,5,0,35,30
1683360671216,MATH 109,A01,188695,Salehi Golsefidy; Alireza,25,0,35,10
1683360671216,MATH 109,A02,188696,Salehi Golsefidy; Alireza,25,0,35,10
1683360672241,MATH 120A,A01,188698,Eggers; John Dietrich,7,0,35,28
1683360673267,MATH 142B,A01,188736,Ioana; Adrian,0,2,30,30
1683360673267,MATH 142B,A02,188741,Ioana; Adrian,0,0,30,30
1683360673267,MATH 142B,A03,188743,Ioana; Adrian,0,1,30,30
1683360674292,MATH 168A,A01,188790,Staff,0,9,35,35
1683360675319,MATH 170A,A01,188803,Nie; Jiawang,0,2,35,35
1683360675319,MATH 170A,A02,188811,Nie; Jiawang,0,0,35,35
1683360675319,MATH 170A,A03,188814,Nie; Jiawang,1,0,35,34
1683360675319,MATH 170A,A04,188815,Nie; Jiawang,13,0,35,22
1683360676346,MATH 193B,A01,188817,Staff,0,0,35,35
1683360676346,MATH 193B,A02,188818,Staff,5,0,35,30
1683360677371,MGT 4,A01,202857,Anderson; John Charles,61,0,80,19
1683360678396,MGT 12,A00,202858,Lindenberger; Wade Douglas,42,0,90,48
1683360679420,MGT 18,A00,202859,Staff,74,0,90,16
1683360680446,MGT 18GS,A00,202860,McKay; Michael J,13,0,28,15
1683360681471,MGT 45,A00,202861,Pecore; Joseph P.,13,0,90,77
1683360682500,MGT 100,A00,202863,Yavorsky; Daniel Ryan,28,0,90,62
1683360683525,MGT 103,A00,202864,Ehrich; Kristine R,0,17,90,90
1683360684555,MGT 112,A00,202865,Ehrich; Kristine R,15,0,90,75
1683360685584,MGT 121A,A00,202868,Staff,0,20,0,0
1683360686612,MGT 131B,A00,202869,Anderson; John Charles,59,0,90,31
1683360687654,MGT 136,A00,202871,Lindenberger; Wade Douglas,84,0,90,6
1683360688680,MGT 164,A00,202873,Staff,0,68,90,91
1683360689705,MGT 164GS,A00,202874,McKay; Mary A,13,0,28,15
1683360690732,MGT 180,A00,202875,Staff,0,50,90,91
1683360691761,MMW 11R,A01,205019,Herbst; Matthew,3,0,30,27
1683360691761,MMW 11R,A02,205026,Herbst; Matthew,29,0,30,1
1683360692793,MMW 15,A01,193512,Chang; Edmond Yi-Teh,0,9,28,28
1683360692793,MMW 15,A02,193513,Chang; Edmond Yi-Teh,0,5,28,28
1683360692793,MMW 15,A03,193514,Chang; Edmond Yi-Teh,0,5,28,28
1683360692793,MMW 15,A04,193515,Chang; Edmond Yi-Teh,0,5,28,28
1683360692793,MMW 15,A05,193516,Chang; Edmond Yi-Teh,0,4,28,28
1683360692793,MMW 15,A06,193517,Chang; Edmond Yi-Teh,0,5,28,28
1683360692793,MMW 15,B01,193519,Chang; Edmond Yi-Teh,0,5,28,28
1683360692793,MMW 15,B02,193520,Chang; Edmond Yi-Teh,0,5,28,28
1683360692793,MMW 15,B03,193521,Chang; Edmond Yi-Teh,0,5,28,28
1683360692793,MMW 15,B04,193522,Chang; Edmond Yi-Teh,0,4,28,28
1683360692793,MMW 15,B05,193523,Chang; Edmond Yi-Teh,0,5,28,28
1683360692793,MMW 15,B06,193524,Chang; Edmond Yi-Teh,0,4,28,28
1683360693823,MMW 122,A01,193526,Rahimi; Babak,0,15,28,28
1683360693823,MMW 122,A02,193527,Rahimi; Babak,0,14,28,28
1683360693823,MMW 122,A03,193528,Rahimi; Babak,0,0,0,0
1683360693823,MMW 122,A04,193529,Rahimi; Babak,0,0,0,0
1683360694852,MUS 1A,A01,186663,Staff,0,20,35,35
1683360695879,MUS 4,A01,186715,Staff,0,12,35,35
1683360696906,MUS 5R,A01,186796,Dubnov; Shlomo,0,17,35,35
1683360697931,MUS 6,A01,186798,Staff,0,4,25,25
1683360698956,MUS 7,A01,186830,Staff,13,0,35,22
1683360699986,MUS 8,A01,186930,Staff,0,26,35,35
1683360701014,MUS 15,A01,186932,Staff,0,16,35,35
1683360701014,MUS 15,B01,186934,Staff,0,15,35,35
1683360702038,MUS 80,A00,186935,Staff,0,0,20,20
1683360702038,MUS 80,B00,186936,Staff,25,0,25,0
1683360703066,NANO 11,A00,204702,Lipomi; Darren John,0,0,0,0
1683360704091,NANO 15,A01,204709,Yang; Kesong,0,1,0,0
1683360705117,NANO 114,A00,202069,Jahed Motlagh; Zeinab,3,0,10,7
1683360706146,PHIL 1,A00,186955,Grush; Rick Scott,32,0,40,8
1683360707200,PHIL 10,A01,186973,Grush; Rick Scott,28,0,35,7
1683360707200,PHIL 10,A02,186974,Grush; Rick Scott,33,0,35,2
1683360708229,PHIL 13,A01,186976,Staff,7,0,35,28
1683360708229,PHIL 13,A02,186977,Staff,16,0,35,19
1683360709256,PHIL 14,A01,186979,Staff,31,0,35,4
1683360709256,PHIL 14,A02,186986,Staff,32,0,35,3
1683360710286,PHIL 28,A01,186988,Staff,16,0,30,14
1683360710286,PHIL 28,A02,186989,Staff,1,0,30,29
1683360710286,PHIL 28,A03,186990,Staff,9,0,30,21
1683360710286,PHIL 28,A04,186991,Staff,26,0,30,4
1683360711316,PHIL 120,A00,186997,Staff,23,0,40,17
1683360712345,PHIL 137,A00,187003,Staff,9,0,40,31
1683360713372,PHIL 150,A00,187015,Staff,47,0,70,23
1683360714403,PHIL 167,A00,187021,Lamey; Andy M.,35,0,40,5
1683360715436,PHIL 174,A01,202226,Staff,17,0,20,3
1683360715436,PHIL 174,A02,202235,Staff,20,0,20,0
1683360716463,PHIL 191A,A00,258918,Staff,0,0,1,1
1683360717491,PHYS 1A,A00,187028,Staff,27,0,60,33
1683360718521,PHYS 1AL,001,187036,Staff,2,0,30,28
1683360718521,PHYS 1AL,002,187049,Staff,18,0,30,12
1683360719551,PHYS 1B,A00,187058,Staff,22,0,60,38
1683360720576,PHYS 1BL,001,187064,Staff,0,0,30,30
1683360720576,PHYS 1BL,002,187070,Staff,5,0,30,25
1683360721602,PHYS 1C,A00,187082,Staff,31,0,120,89
1683360722633,PHYS 1CL,001,187088,Staff,0,9,30,30
1683360722633,PHYS 1CL,002,187089,Staff,0,2,30,30
1683360722633,PHYS 1CL,009,262693,Staff,11,0,30,19
1683360723662,PHYS 2B,A01,187097,Staff,54,0,115,61
1683360724687,PHYS 2C,A01,187099,Staff,67,0,115,48
1683360725714,PHYS 2CL,A01,187101,Staff,5,0,28,23
1683360725714,PHYS 2CL,A02,187102,Staff,15,0,28,13
1683360726742,PHYS 2D,A01,187123,Shotwell; Brian,95,0,115,20
1683360727768,PHYS 4B,A01,187133,Grinstein; Benjamin,35,0,50,15
1683360728794,POLI 10,A00,188819,Staff,0,4,50,50
1683360729819,POLI 11,A00,188827,Staff,43,0,50,7
1683360730848,POLI 13R,A00,188828,Staff,0,1,20,20
1683360731879,POLI 27,A01,188830,Elgin; Samuel Zincke,0,1,70,70
1683360732911,POLI 30,A00,188832,Desposato; Scott,31,0,50,19
1683360733939,POLI 102F,A00,188834,Staff,3,0,40,37
1683360734963,POLI 104A,A00,188852,Staff,14,0,30,16
1683360735988,POLI 104I,A00,188853,Staff,0,6,20,20
1683360737021,POLI 110B,A00,188854,Wiens; David,7,0,20,13
1683360738054,POLI 112A,A00,188855,Wiens; David,5,0,30,25
1683360739077,POLI 117R,A00,188856,Forman; Fonna,0,11,20,20
1683360740103,POLI 118,A00,188857,Ingham; Sean,8,0,20,12
1683360741131,POLI 120G,A00,188858,Staff,9,0,30,21
1683360742154,POLI 131CR,A00,188863,Hoston; Germaine,23,0,50,27
1683360743180,POLI 133,A00,188864,Nellis; Gareth Hb,44,0,50,6
1683360744206,POLI 134D,A00,188865,Desposato; Scott,27,0,30,3
1683360745231,POLI 142A,A00,188871,Gartzke; Erik,22,0,50,28
1683360746261,POLI 142K,A00,188874,Staff,38,0,50,12
1683360747289,POLI 143,A00,188940,Gartzke; Erik,16,0,30,14
1683360748311,POLI 153,A00,188943,Staff,3,0,20,17
1683360749336,POLI 160AA,A00,188944,Staff,11,0,40,29
1683360750362,POLI 170A,A00,188945,Staff,11,0,30,19
1683360752416,PSYC 1,A00,188952,Staff,37,0,90,53
1683360753440,PSYC 2,B00,188953,Staff,19,0,35,16
1683360754464,PSYC 6,A00,188970,Staff,47,0,60,13
1683360755492,PSYC 7,A00,188973,Staff,37,0,45,8
1683360756518,PSYC 60,A01,188980,Rickard; Timothy C.,43,0,60,17
1683360757547,PSYC 70,A01,189001,Steiner; Eric Tomas,23,0,45,22
1683360758577,PSYC 100,A00,189005,Lacefield; Katharine I,0,98,120,120
1683360759606,PSYC 102,A00,189008,Staff,9,0,30,21
1683360760632,PSYC 106,B00,189026,Gorman; Michael R.,34,0,60,26
1683360761659,PSYC 114,B01,189033,Winkielman; Piotr,0,32,30,30
1683360762688,PSYC 131,A00,189036,Anagnostaras; Stephan,0,43,60,60
1683360763786,PSYC 136,A00,189041,Lowe; Angela Beth,0,7,25,25
1683360764815,PSYC 137,A00,189057,Winkielman; Piotr,0,34,25,25
1683360765844,PSYC 144,A00,189107,Wixted; John T,0,7,50,50
1683360767907,PSYC 162,A00,189142,Staff,0,8,85,85
1683360768936,PSYC 172,A00,189144,Gorman; Michael R.,0,7,30,30
1683360770988,PSYC 179,A00,189146,Lacefield; Katharine I,0,84,120,120
1683360772018,PSYC 181,A00,189147,Anagnostaras; Stephan,0,44,90,90
1683360773049,PSYC 190R,A00,189148,Barner; David A.,0,22,80,80
1683360774079,PSYC 191,A00,189275,Rickard; Timothy C.,0,7,25,25
1683360775111,PSYC 193,A00,189276,Chapman; Eddie Nathaniel,0,1,0,4
1683360776138,PSYC 193L,A01,189281,Lowe; Angela Beth,12,0,20,8
1683360776138,PSYC 193L,B01,189285,Staff,28,0,35,7
1683360777164,RELI 149,A00,187137,Rahimi; Babak,7,0,40,33
1683360778193,SE 9,A01,187315,Staff,0,2,18,18
1683360779222,SE 101B,A00,187409,Staff,24,0,30,6
1683360780253,SE 110B,A00,187444,Staff,10,0,40,30
1683360781286,SE 130B,A00,187449,Staff,31,0,40,9
1683360782322,SE 150A,A00,187516,Staff,9,0,20,11
1683360783347,SE 154,A00,187528,Staff,30,0,50,20
1683360784378,SIO 3,A01,258171,Staff,35,0,40,5
1683360785408,SIO 10,A00,187144,Cook; Geoffrey W,0,3,75,75
1683360786439,SIO 45,A00,187152,Cook; Geoffrey W,1,0,100,99
1683360787464,SIO 109R,A00,194486,Staff,0,3,20,20
1683360789518,SIO 187,A01,187233,Kacev; David,12,0,40,28
1683360790551,SOCI 1,A01,258656,Thorpe; Charles Robert,28,0,30,2
1683360790551,SOCI 1,A02,258658,Thorpe; Charles Robert,30,0,30,0
1683360790551,SOCI 1,A03,258661,Thorpe; Charles Robert,25,0,25,0
1683360790551,SOCI 1,A04,258666,Thorpe; Charles Robert,22,0,25,3
1683360790551,SOCI 1,A05,258897,Thorpe; Charles Robert,23,0,25,2
1683360790551,SOCI 1,A06,258898,Thorpe; Charles Robert,25,0,25,0
1683360791581,SOCI 30,A01,258903,Pardo Guerra; Juan Pablo,15,0,30,15
1683360792610,SOCI 102,A00,258904,Staff,9,0,25,16
1683360793635,SOCI 106,A00,258905,Staff,19,0,25,6
1683360794660,SOCI 111,A00,258907,Ribas Norris; Janet Vanesa,26,0,30,4
1683360795687,SOCI 121R,A00,258908,Pardo Guerra; Juan Pablo,10,0,30,20
1683360796713,SOCI 126,A01,203330,Staff,14,0,20,6
1683360797738,SOCI 131,A00,258909,Thorpe; Charles Robert,31,0,60,29
1683360798763,SOCI 135,A00,258910,Payne; Christine Anna,0,9,30,30
1683360799789,SOCI 157,A00,258911,Staff,12,0,30,18
1683360800817,SOCI 184,A00,258912,Staff,25,0,30,5
1683360801846,SOCI 188D,A00,258913,Staff,22,0,30,8
1683360802872,SYN 2,001,187529,Staff,10,0,16,6
1683360802872,SYN 2,002,201452,Staff,0,18,16,16
1683360802872,SYN 2,003,201469,Staff,3,0,16,13
1683360803902,SYN 100,A01,187531,Staff,0,9,20,20
1683360803902,SYN 100,B01,201491,Staff,0,12,20,20
1683360804933,TDAC 1,A00,189286,Walsh; Kim C.,3,0,20,17
1683360804933,TDAC 1,B00,189287,Harting; Carla Kelso,11,0,20,9
1683360805960,TDAC 101,A00,189300,Walsh; Kim C.,16,0,20,4
1683360805960,TDAC 101,B00,189301,Harting; Carla Kelso,18,0,20,2
1683360806987,TDAC 102,A00,189304,Basso; Beatrice,14,0,20,6
1683360808012,TDAC 108,A00,189305,Staff,18,0,20,2
1683360809044,TDDE 131,A00,189310,Staff,19,0,20,1
1683360809044,TDDE 131,B00,189314,Staff,19,0,20,1
1683360809044,TDDE 131,C00,189315,Staff,48,0,50,2
1683360809044,TDDE 131,D00,189316,Staff,14,0,15,1
1683360809044,TDDE 131,E00,204841,Staff,20,0,20,0
1683360810069,TDGE 10,A00,189289,Staff,30,0,50,20
1683360810069,TDGE 10,B00,189290,Havis; Allan,1,0,50,49
1683360811096,TDGE 11,A00,189291,Fulton; Julia,0,3,50,50
1683360811096,TDGE 11,B00,189292,Staff,20,0,25,5
1683360811096,TDGE 11,C00,260270,Staff,0,0,0,0
1683360812123,TDGE 25,A00,189294,Staff,3,0,20,17
1683360813149,TDGE 124,A00,189318,Fulton; Julia,0,8,50,50
1683360814177,TDGE 125,A00,189319,Staff,13,0,25,12
1683360814177,TDGE 125,B00,189320,Staff,23,0,25,2
1683360815205,TDGE 127,A00,189322,Havis; Allan,0,0,50,50
1683360816230,TDHT 101,A00,189323,Staff,18,0,25,7
1683360816230,TDHT 101,B00,189324,Staff,25,0,25,0
1683360817256,TDHT 102,A00,189325,Staff,49,0,50,1
1683360818286,TDMV 1,A00,189295,Arcidiacono; Kristin,19,0,30,11
1683360818286,TDMV 1,B00,189296,Caligagan; Maria T.,24,0,30,6
1683360819318,TDMV 2,A00,189297,Sammartano; Tonnie,28,0,30,2
1683360819318,TDMV 2,B00,189299,Arcidiacono; Kristin,24,0,30,6
1683360820343,TDMV 3,A00,204998,Rincon; Alicia,22,0,30,8
1683360821372,TDMV 120,A00,189458,Sammartano; Tonnie,28,0,30,2
1683360822402,TDMV 138,A00,189541,Jun; Grace Shin Hae,22,0,40,18
1683360823430,TDMV 142,A00,189717,Caligagan; Tony,23,0,30,7
1683360823430,TDMV 142,B00,189718,Caligagan; Maria T.,25,0,30,5
1683360824461,TMC 2,A01,187533,Staff,25,0,25,0
1683360824461,TMC 2,A02,187534,Staff,25,0,25,0
1683360825491,USP 1,A01,187536,Kwak; Nancy,0,16,25,25
1683360826518,USP 5,A01,187538,Staff,10,0,25,15
1683360827544,USP 101,A00,199253,Staff,0,4,0,0
1683360828574,USP 124,A00,187562,Boomhower; Matthew Charles,1,0,30,29
1683360829604,USP 138,A00,187582,Staff,20,0,25,5
1683360830630,USP 152,A01,187597,Staff,4,0,25,21
1683360831659,USP 153,A00,187598,Staff,19,0,25,6
1683360832688,USP 168,A00,187607,Kwak; Nancy,2,0,5,3
1683360833716,USP 173,A00,187619,Staff,4,0,25,21
1683360834741,USP 181,A00,187638,Staff,0,3,25,25
1683360835766,VIS 103,A00,187650,Cruz; Edwin Teddy,22,0,75,53
1683360836791,VIS 110D,A00,187669,Staff,12,0,22,10
1683360837817,VIS 127C,A00,187720,Shen; Kuiyi,67,0,146,79
1683360838843,VIS 149,A00,187731,Yoldas; Pinar,0,14,22,22
1683360839868,VIS 151,A01,188091,Staff,22,0,34,12
1683360839868,VIS 151,A02,188092,Staff,11,0,34,23
1683360840893,VIS 160B,A00,188093,Stalbaum; Brett,0,0,10,10
1683360842950,WCWP 10B,A00,201720,Staff,10,0,15,5
1683360842950,WCWP 10B,B00,201722,Staff,9,0,15,6
1683360843976,WCWP 100,A00,201725,Gagnon; Jeffrey C,0,0,2,2
1683360843976,WCWP 100,B00,201727,Staff,0,4,15,15
1683360847128,ANBI 133,A00,258401,Wilder; Linnea Lorene,34,0,40,6
1683360848154,ANBI 140,A00,258395,Hrvoj Mihic; Branka,18,0,25,7
1683360849180,ANSC 120,A00,258402,Bialecki; Jon Anthony,27,0,40,13
1683360850205,ANSC 144,A00,258400,Staff,14,0,40,26
1683360852258,ANSC 166,A00,258396,Parish; Steven Martin,157,0,175,18
1683360853287,ANSC 180,A00,193533,Staff,9,0,20,11
1683360854320,ANSC 188,A00,258397,Jassal; Aftab,33,0,40,7
1683360855345,ANTH 3,A01,258316,Staff,23,0,30,7
1683360856370,ANTH 5,A00,258394,Semendeferi; Ekaterini,16,0,20,4
1683360857395,ANTH 21,A01,258331,Staff,8,0,40,32
1683360858419,ANTH 103,A00,258398,Varma; Saiba,15,0,25,10
1683360859447,AWP 10,001,202034,Staff,0,0,0,0
1683360859447,AWP 10,002,202035,Staff,0,0,0,0
1683360859447,AWP 10,003,202036,Staff,0,0,0,0
1683360859447,AWP 10,004,202037,Staff,0,0,0,0
1683360859447,AWP 10,005,202038,Staff,0,0,0,0
1683360859447,AWP 10,006,202039,Staff,0,0,0,0
1683360859447,AWP 10,007,202040,Staff,0,0,0,0
1683360859447,AWP 10,008,202041,Staff,0,0,0,0
1683360859447,AWP 10,009,202042,Staff,0,0,0,0
1683360859447,AWP 10,010,202043,Staff,0,0,0,0
1683360859447,AWP 10,011,202044,Staff,0,0,0,0
1683360859447,AWP 10,012,202045,Staff,0,0,0,0
1683360859447,AWP 10,013,202046,Staff,0,0,0,0
1683360859447,AWP 10,014,202047,Staff,0,0,0,0
1683360859447,AWP 10,015,202048,Staff,0,0,0,0
1683360859447,AWP 10,016,202049,Staff,0,0,0,0
1683360859447,AWP 10,017,202050,Staff,0,0,0,0
1683360859447,AWP 10,018,202051,Staff,0,0,0,0
1683360859447,AWP 10,019,202052,Staff,0,0,0,0
1683360859447,AWP 10,020,202053,Staff,0,0,0,0
1683360859447,AWP 10,021,202054,Staff,0,0,0,0
1683360859447,AWP 10,022,202055,Staff,0,0,0,0
1683360859447,AWP 10,023,202056,Staff,0,0,0,0
1683360859447,AWP 10,024,202057,Staff,0,0,0,0
1683360859447,AWP 10,025,202058,Staff,0,0,0,0
1683360859447,AWP 10,026,202059,Staff,0,0,0,0
1683360860471,AWP 102,001,202032,Staff,0,0,0,0
1683360860471,AWP 102,002,202033,Staff,0,0,0,0
1683360861496,BENG 100,A01,254234,Taylor Amos; Alyssa C,31,0,40,9
1683360862521,BENG 196,001,270013,Engler; Adam J.,9999,0,9999,0
1683360863555,BICD 100R,A01,202018,Smith; Laurie,0,7,32,32
1683360863555,BICD 100R,A02,202019,Smith; Laurie,0,2,32,32
1683360863555,BICD 100R,A03,202020,Smith; Laurie,0,1,32,32
1683360863555,BICD 100R,A04,202021,Smith; Laurie,9,0,32,23
1683360863555,BICD 100R,A05,202022,Smith; Laurie,12,0,32,20
1683360864583,BICD 136,A01,193242,Gustafson-Brown; Cindy,0,2,32,32
1683360864583,BICD 136,A02,193244,Gustafson-Brown; Cindy,14,0,32,18
1683360865608,BIEB 102,A01,193249,Butler; Shannon Rhey,0,2,32,32
1683360865608,BIEB 102,A02,193251,Butler; Shannon Rhey,0,0,32,32
1683360865608,BIEB 102,A03,193253,Butler; Shannon Rhey,0,1,32,32
1683360865608,BIEB 102,A04,193255,Butler; Shannon Rhey,17,0,32,15
1683360865608,BIEB 102,A05,193265,Butler; Shannon Rhey,26,0,32,6
1683360865608,BIEB 102,A06,193269,Butler; Shannon Rhey,16,0,32,16
1683360867731,BIEB 150,A01,193274,Staff,0,0,32,32
1683360867731,BIEB 150,A02,193285,Staff,23,0,32,9
1683360868758,BIEB 194,A00,193286,Kurle; Carolyn M.,22,0,32,10
1683360869784,BILD 1,A01,192291,Staff,16,0,32,16
1683360869784,BILD 1,A02,192292,Staff,30,0,32,2
1683360869784,BILD 1,B01,192520,Reuther; Keefe,0,1,0,0
1683360869784,BILD 1,B02,192532,Reuther; Keefe,0,1,0,0
1683360870817,BILD 3,A01,192556,Butler; Shannon Rhey,0,0,32,32
1683360870817,BILD 3,A02,192581,Butler; Shannon Rhey,4,0,32,28
1683360870817,BILD 3,A03,192611,Butler; Shannon Rhey,23,0,32,9
1683360870817,BILD 3,A04,192612,Butler; Shannon Rhey,25,0,32,7
1683360870817,BILD 3,A05,192613,Butler; Shannon Rhey,27,0,32,5
1683360870817,BILD 3,A06,192679,Butler; Shannon Rhey,27,0,32,5
1683360870817,BILD 3,A07,192682,Butler; Shannon Rhey,22,0,32,10
1683360871848,BILD 4,A01,192836,Reuther; Keefe,0,0,24,24
1683360871848,BILD 4,A02,193044,Reuther; Keefe,4,0,24,20
1683360872875,BILD 10,A01,193142,Gustafson-Brown; Cindy,30,0,32,2
1683360872875,BILD 10,A02,193149,Gustafson-Brown; Cindy,31,0,32,1
1683360873907,BIMM 100,A01,193301,Staff,1,6,32,31
1683360873907,BIMM 100,A02,193312,Staff,0,5,32,32
1683360873907,BIMM 100,A03,193323,Staff,0,8,32,32
1683360874942,BIMM 101,A01,193329,McDonnell; Lisa Marie,0,3,24,24
1683360874942,BIMM 101,A02,193339,McDonnell; Lisa Marie,0,3,24,24
1683360874942,BIMM 101,B01,193354,McDonnell; Lisa Marie,0,3,24,24
1683360874942,BIMM 101,B02,193357,McDonnell; Lisa Marie,0,3,24,24
1683360875977,BIMM 110,A01,193377,Tat; John,0,11,32,32
1683360875977,BIMM 110,A02,193378,Tat; John,0,9,32,32
1683360877003,BIMM 120,A01,206116,Staff,0,0,32,32
1683360877003,BIMM 120,A02,206117,Staff,8,0,32,24
1683360877003,BIMM 120,A03,206121,Staff,21,0,32,11
1683360878030,BIPN 100,A01,193393,Park; Ji Young,0,14,32,32
1683360878030,BIPN 100,A02,193402,Park; Ji Young,0,13,32,32
1683360878030,BIPN 100,A03,193413,Park; Ji Young,0,14,32,32
1683360878030,BIPN 100,A04,193414,Park; Ji Young,0,13,32,32
1683360879054,BIPN 102,A01,193429,Staff,0,0,32,32
1683360879054,BIPN 102,A02,193438,Staff,22,0,32,10
1683360880087,BIPN 106,A01,193450,Reyes Gonzalez; Catalina,0,2,40,40
1683360881116,BIPN 134,A01,193465,Cooke; James Edward,1,0,32,31
1683360881116,BIPN 134,A02,193474,Cooke; James Edward,25,0,32,7
1683360881116,BIPN 134,A03,193485,Cooke; James Edward,29,0,32,3
1683360881116,BIPN 134,A04,193486,Cooke; James Edward,21,0,32,11
1683360881116,BIPN 134,A05,193491,Cooke; James Edward,31,0,32,1
1683360881116,BIPN 134,A06,193501,Cooke; James Edward,30,0,32,2
1683360881116,BIPN 134,A07,193510,Cooke; James Edward,29,0,32,3
1683360883174,BISP 194,A00,222522,Staff,14,0,32,18
1683360884202,CAT 124,A01,202407,Staff,19,0,25,6
1683360885231,CAT 125,A00,202408,Marchisotto; Jennifer Anne,4,0,20,16
1683360886255,CAT 125R,A00,202409,Smith; Lauryn Alissa,0,11,20,20
1683360886255,CAT 125R,B00,202410,Morales; Celeste Georgianna,0,11,20,20
1683360886255,CAT 125R,C00,202411,Irwin; Matthew Joseph,0,10,20,20
1683360887280,CENG 15,A01,204712,Yang; Kesong,0,1,0,0
1683360888310,CENG 114,A00,202070,Jahed Motlagh; Zeinab,5,0,20,15
1683360889336,CGS 105,A00,185477,Wesling; Megan E.,24,0,40,16
1683360890362,CGS 106,A00,185494,Staff,13,0,22,9
1683360891389,CGS 108,A00,185495,Staff,14,0,20,6
1683360892414,CGS 114,A00,185496,Staff,13,0,18,5
1683360893437,CGS 119,A00,185501,Staff,15,0,20,5
1683360894462,CGS 120,A00,185511,Staff,13,0,20,7
1683360895490,CHEM 4,A01,184675,Bussey; Thomas J,96,0,100,4
1683360896513,CHEM 6A,A01,184677,Staff,34,0,60,26
1683360897542,CHEM 6B,A01,184679,Staff,65,0,100,35
1683360898569,CHEM 6C,A01,184681,Bussey; Thomas J,1,0,50,49
1683360898569,CHEM 6C,A02,184682,Bussey; Thomas J,34,0,50,16
1683360899598,CHEM 40A,A01,184684,Albizati; Kim F.,37,0,100,63
1683360900623,CHEM 40B,A01,184686,Albizati; Kim F.,0,20,100,100
1683360901652,CHEM 41B,A01,184690,Staff,52,0,100,48
1683360902678,COGS 3,A01,184715,Boyle; Mary E. T.,0,25,40,40
1683360903703,COGS 14B,A01,185172,Staff,0,15,38,38
1683360904731,COGS 18,A01,184736,Staff,16,0,80,64
1683360905754,COGS 100,A01,184932,Staff,0,5,73,73
1683360906779,COGS 101A,A01,184935,Staff,0,39,30,30
1683360907803,COGS 101B,A01,184944,Staff,0,2,30,30
1683360908831,COGS 101C,A01,184946,Staff,0,12,30,30
1683360909857,COGS 102A,A01,184951,Johnson; Christine M.,2,0,40,38
1683360910881,COGS 107B,A01,184953,Mooshagian; Eric Frederick,0,50,40,40
1683360911906,COGS 118B,A01,184959,Gupta; Anjum,0,48,40,40
1683360912932,COGS 153,A00,184961,Staff,0,15,30,30
1683360913960,COGS 177,A00,184962,Staff,0,20,30,30
1683360914985,COGS 187A,A01,184969,Boyle; Mary E. T.,0,17,40,40
1683360916016,COMM 10,A01,185174,Staff,0,5,25,25
1683360916016,COMM 10,A02,185189,Staff,0,5,25,25
1683360916016,COMM 10,A03,269821,Staff,0,0,0,0
1683360917040,COMM 100B,A01,185475,Staff,0,0,0,2
1683360917040,COMM 100B,A02,185476,Staff,13,0,25,12
1683360918070,COMM 100C,A01,185314,Staff,1,0,25,24
1683360918070,COMM 100C,A02,185327,Staff,19,0,25,6
1683360919100,COMM 110M,A00,185349,Staff,2,0,40,38
1683360920125,COMM 113T,A00,185352,Staff,24,0,40,16
1683360921150,COMM 114I,A00,185353,Staff,33,0,40,7
1683360922175,COMM 131,A00,185354,Staff,19,0,30,11
1683360923200,CSE 8A,A50,185358,Cao; Yingjun,0,46,10,10
1683360924225,CSE 8B,A01,185362,Staff,0,46,50,50
1683360925250,CSE 11,A01,185416,Cao; Yingjun,0,92,10,10
1683360926278,CSE 20,A01,185445,Briones; Jor-el Thomas Caparas,5,0,25,20
1683360927303,CSE 21,A01,185447,Staff,10,0,50,40
1683360928326,CSE 101,A01,185451,Staff,0,13,50,50
1683360928326,CSE 101,B01,185453,Jones; Miles E,0,11,50,50
1683360930381,CSE 141,A01,185458,Eldon; John,20,0,100,80
1683360931409,CSE 141L,A01,185461,Eldon; John,12,0,100,88
1683360932438,CSE 142,A01,185463,Staff,36,0,60,24
1683360932438,CSE 142,B01,201355,Staff,0,7,60,60
1683360933466,CSE 142L,A01,185470,Staff,36,0,60,24
1683360933466,CSE 142L,B01,201417,Staff,0,6,60,60
1683360934496,CSE 190,A00,201433,Staff,32,0,49,17
1683360935522,DOC 1,A01,259136,Strom; Megan C.,7,0,15,8
1683360935522,DOC 1,A02,259137,Strom; Megan C.,14,0,15,1
1683360935522,DOC 1,A03,259138,Strom; Megan C.,14,0,15,1
1683360935522,DOC 1,A04,259139,Strom; Megan C.,14,0,15,1
1683360936551,DOC 100D,A00,259140,Pass; Natalye Joann,16,0,25,9
1683360937582,DSGN 1,A01,184749,Rill; Bryan,0,26,30,30
1683360938610,DSGN 100,A01,185168,Staff,0,2,25,25
1683360939634,ECE 5,A01,185626,Morris; Karcher William,0,10,0,0
1683360940660,ECE 101,A01,185628,Staff,17,0,70,53
1683360941686,ECE 107,A01,185635,Baghdadchi; Saharnaz,0,0,20,20
1683360941686,ECE 107,A02,185638,Baghdadchi; Saharnaz,4,0,20,16
1683360942712,ECE 148,A01,185647,Silberman; Jack,0,0,16,16
1683360943741,ECON 1,A01,185537,Crane; Meredith Helen,54,0,70,16
1683360944768,ECON 3,A01,185549,Crane; Meredith Helen,32,0,70,38
1683360945791,ECON 4,A01,203354,Anderson; John Charles,0,4,10,10
1683360946815,ECON 100A,A01,185574,Staff,0,4,40,40
1683360947842,ECON 100B,A01,185576,Staff,0,12,50,50
1683360948867,ECON 100C,A01,185589,Newhouse; Herbert S,29,0,70,41
1683360949894,ECON 105,A00,185608,Vespa; Emanuel Ignacio,19,0,35,16
1683360950919,ECON 109,A01,185610,Shishkin; Denis,10,0,35,25
1683360951944,ECON 110A,A01,185612,Staff,11,0,40,29
1683360952972,ECON 120A,A01,185615,Staff,20,0,40,20
1683360954001,ECON 120C,A01,185617,Sun; Yixiao,0,21,70,70
1683360955026,ECON 144,A00,203346,Squires; Dale E,3,0,35,32
1683360956049,ECON 171,A01,203349,Newhouse; Herbert S,0,1,35,35
1683360957078,ECON 173A,A01,185621,Toda; Alexis Akira,21,0,35,14
1683360958102,EDS 25,A01,202413,Staff,0,1,0,0
1683360958102,EDS 25,A02,202414,Staff,0,1,0,0
1683360958102,EDS 25,A03,202415,Staff,0,0,0,0
1683360958102,EDS 25,A04,202416,Staff,0,1,0,0
1683360958102,EDS 25,A05,202439,Staff,0,0,0,0
1683360958102,EDS 25,A06,202440,Staff,0,0,0,0
1683360958102,EDS 25,B01,202631,Staff,0,0,0,0
1683360958102,EDS 25,B02,202632,Staff,0,0,0,0
1683360958102,EDS 25,B03,202639,Staff,0,0,0,0
1683360958102,EDS 25,B04,202640,Staff,0,0,0,0
1683360958102,EDS 25,B05,202643,Staff,0,0,0,0
1683360958102,EDS 25,B06,202644,Staff,0,0,0,0
1683360959129,EDS 38,A01,202659,Black; Alison Michelle,24,0,25,1
1683360960153,EDS 115,A00,202652,Staff,18,0,30,12
1683360961178,EDS 125,A00,202649,Staff,14,0,30,16
1683360962202,EDS 126,A01,203332,Staff,30,0,30,0
1683360963229,EDS 139,A00,202838,Staff,16,0,25,9
1683360964255,EDS 146,A01,202655,Staff,14,0,25,11
1683360965278,ENG 15,A00,185667,Staff,0,1,0,0
1683360965278,ENG 15,B00,185672,Staff,0,0,0,0
1683360965278,ENG 15,C00,185675,Staff,0,0,0,0
1683360965278,ENG 15,D00,185682,Staff,0,0,0,0
1683360965278,ENG 15,E00,185684,Staff,0,0,0,0
1683360966303,ETHN 103,A00,185710,Staff,0,4,35,35
1683360967335,ETHN 103A,A00,199228,Man; Simeon S,2,0,9,7
1683360968363,ETHN 109,A00,185711,Staff,18,0,35,17
1683360969391,ETHN 142,A00,185726,Staff,0,4,30,30
1683360970416,ETHN 163J,A00,199229,Man; Simeon S,5,0,8,3
1683360971518,ETHN 168,A00,185727,Staff,8,0,10,2
1683360972546,ETHN 182,A00,185728,Staff,0,0,35,35
1683360973574,ETHN 183,A00,185737,Staff,8,0,18,10
1683360974600,GLBH 111,A01,209361,Burgos; Jose L.,0,0,0,0
1683360976660,HIEU 104,A00,185792,Staff,16,0,20,4
1683360977688,HIEU 115,A00,185800,Staff,1,0,20,19
1683360978717,HIEU 128,A00,185801,Staff,0,7,20,20
1683360979746,HIEU 147,A00,185802,Staff,16,0,20,4
1683360980772,HIEU 154,A00,185823,Staff,12,0,20,8
1683360981800,HILA 102,A00,185826,Staff,13,0,20,7
1683360982826,HILD 2C,A01,185778,Staff,0,12,20,20
1683360983853,HILD 7B,A01,185780,Kwak; Nancy,0,15,32,32
1683360983853,HILD 7B,A02,185781,Kwak; Nancy,0,18,32,32
1683360984877,HILD 30,A01,185791,Staff,14,0,20,6
1683360985977,HISC 119,A00,185830,Golan; Tal,0,9,20,20
1683360987004,HITO 156GS,A00,185831,Patterson; Patrick H.,0,0,0,23
1683360988034,HIUS 103,A00,185832,Man; Simeon S,1,6,20,19
1683360989060,HIUS 117,A00,185836,Kwak; Nancy,2,0,20,18
1683360990090,HIUS 125,A00,185840,Man; Simeon S,0,0,23,23
1683360991114,HIUS 149,A00,185845,Staff,0,0,20,20
1683360992140,HUM 3,A01,185882,Zavodny; Tatiana Sophia,0,7,50,50
1683360992140,HUM 3,B01,185899,Caldwell; Michael Alan,0,18,50,50
1683360993164,HUM 3GS,A00,185900,Patterson; Patrick H.,0,0,0,23
1683360994190,HUM 4,A01,185938,Zroka; Amy Liane,31,0,50,19
1683360994190,HUM 4,B01,185956,Watkins; Eric,0,3,50,50
1683360994190,HUM 4,B02,202209,Watkins; Eric,0,2,50,50
1683360994190,HUM 4,B03,202210,Watkins; Eric,0,2,50,50
1683360995213,HUM 5,A01,185958,West; Geoffrey Scott,3,0,50,47
1683360995213,HUM 5,A02,202215,West; Geoffrey Scott,0,0,50,50
1683360996239,INTL 190,A00,185959,Gagnon; Jeffrey C,0,0,0,9
1683360996239,INTL 190,B00,185960,Lettieri; Michael Joseph,0,0,0,1
1683360997267,JAPN 180,A00,254509,Staff,4,0,30,26
1683360998300,LATI 10,A01,202853,Kennemore; Amy Michelle,4,0,35,31
1683360998300,LATI 10,A02,202854,Kennemore; Amy Michelle,2,0,35,33
1683360998300,LATI 10,A03,270054,Kennemore; Amy Michelle,30,0,30,0
1683360999325,LATI 180,A00,202855,Kennemore; Amy Michelle,11,0,20,9
1683361000351,LAWS 101,A00,201767,Golan; Tal,0,7,40,40
1683361001376,LIFR 1C,A00,185961,Staff,6,0,20,14
1683361002401,LIFR 1CX,A00,185962,Staff,7,0,20,13
1683361003429,LIFR 1D,A00,185963,Staff,9,0,20,11
1683361004456,LIFR 1DX,A00,185964,Staff,9,0,20,11
1683361005481,LIGN 101,A01,186039,Staff,43,0,50,7
1683361006507,LIGN 165,A00,186040,Staff,18,0,50,32
1683361007531,LTCS 108,A00,186041,Staff,6,0,10,4
1683361008559,LTCS 119,A00,186042,Staff,16,0,20,4
1683361009589,LTCS 130,A00,186043,Wesling; Megan E.,15,0,25,10
1683361011646,LTEA 138,A00,186119,Staff,14,0,40,26
1683361012674,LTEN 124,A00,186148,Staff,6,0,25,19
1683361013704,LTEN 178,A00,186149,Staff,7,0,15,8
1683361014732,LTEN 181,A00,186150,Blanco; John D,33,0,40,7
1683361015761,LTWL 120,A00,186160,Staff,20,0,25,5
1683361016791,LTWL 165,A00,186161,Staff,22,0,25,3
1683361017818,LTWR 100,A00,186162,Staff,0,5,15,15
1683361018848,LTWR 102,A00,186163,Doller; Ben,5,0,15,10
1683361019882,MAE 8,A01,186412,Staff,0,0,0,0
1683361020908,MAE 30B,A00,186445,Bahadori; Mohammad Yousef,83,0,100,17
1683361021934,MAE 40,A00,186592,Bewley; Thomas R,10,0,50,40
1683361022963,MAE 101B,A00,186593,Bahadori; Mohammad Yousef,81,0,100,19
1683361023993,MAE 105,A00,186594,Bandaru; Prabhakar,12,0,50,38
1683361025024,MAE 107,A00,186599,Pham; Hieu Tan,0,7,120,120
1683361026048,MAE 148,A01,186660,Silberman; Jack,3,0,16,13
1683361027074,MATH 10A,A01,188095,Staff,0,5,35,35
1683361028100,MATH 10B,A01,188097,Bowers; Adam R.,0,11,30,30
1683361028100,MATH 10B,A02,188099,Bowers; Adam R.,0,11,30,30
1683361028100,MATH 10B,B01,188104,Bowers; Adam R.,0,10,30,30
1683361028100,MATH 10B,B02,188106,Bowers; Adam R.,0,10,30,30
1683361029137,MATH 10C,A01,188111,Staff,0,18,30,30
1683361029137,MATH 10C,A02,188127,Staff,0,17,30,30
1683361029137,MATH 10C,A03,188131,Staff,0,18,30,30
1683361029137,MATH 10C,B01,188218,Staff,18,0,30,12
1683361029137,MATH 10C,B02,188244,Staff,13,0,30,17
1683361029137,MATH 10C,B03,188277,Staff,16,0,30,14
1683361030163,MATH 18,A01,188344,Bach; Quang Tran,18,0,30,12
1683361030163,MATH 18,A02,188345,Bach; Quang Tran,11,0,30,19
1683361030163,MATH 18,B01,188353,Bach; Quang Tran,10,0,30,20
1683361030163,MATH 18,B02,188354,Bach; Quang Tran,20,0,30,10
1683361031193,MATH 20A,A01,188374,Staff,12,0,35,23
1683361032219,MATH 20B,A01,188382,Ohm; Ko Woon,6,0,30,24
1683361032219,MATH 20B,A02,188383,Ohm; Ko Woon,22,0,30,8
1683361032219,MATH 20B,B01,188385,Ohm; Ko Woon,7,0,30,23
1683361032219,MATH 20B,B02,188392,Ohm; Ko Woon,22,0,30,8
1683361033244,MATH 20C,A01,188394,Harel; Guershon,10,0,30,20
1683361033244,MATH 20C,A02,188395,Harel; Guershon,15,0,30,15
1683361033244,MATH 20C,B01,188404,Harel; Guershon,4,0,30,26
1683361033244,MATH 20C,B02,188405,Harel; Guershon,19,0,30,11
1683361034275,MATH 20D,A01,188414,Hammock; Frances H,0,1,30,30
1683361034275,MATH 20D,A02,188415,Hammock; Frances H,3,0,30,27
1683361034275,MATH 20D,B01,188447,Hammock; Frances H,1,0,30,29
1683361034275,MATH 20D,B02,188486,Hammock; Frances H,8,0,30,22
1683361035301,MATH 20E,A01,188649,Staff,21,0,30,9
1683361035301,MATH 20E,A02,188650,Staff,23,0,30,7
1683361035301,MATH 20E,A03,188673,Staff,0,0,30,30
1683361036329,MATH 102,A01,188675,Staff,0,35,35,35
1683361037355,MATH 103B,A01,188681,Staff,3,0,35,32
1683361037355,MATH 103B,B01,188692,Staff,5,0,35,30
1683361038381,MATH 109,A01,188695,Salehi Golsefidy; Alireza,25,0,35,10
1683361038381,MATH 109,A02,188696,Salehi Golsefidy; Alireza,25,0,35,10
1683361039406,MATH 120A,A01,188698,Eggers; John Dietrich,7,0,35,28
1683361040438,MATH 142B,A01,188736,Ioana; Adrian,0,2,30,30
1683361040438,MATH 142B,A02,188741,Ioana; Adrian,0,0,30,30
1683361040438,MATH 142B,A03,188743,Ioana; Adrian,0,1,30,30
1683361041464,MATH 168A,A01,188790,Staff,0,9,35,35
1683361042491,MATH 170A,A01,188803,Nie; Jiawang,0,2,35,35
1683361042491,MATH 170A,A02,188811,Nie; Jiawang,0,0,35,35
1683361042491,MATH 170A,A03,188814,Nie; Jiawang,1,0,35,34
1683361042491,MATH 170A,A04,188815,Nie; Jiawang,13,0,35,22
1683361043515,MATH 193B,A01,188817,Staff,0,0,35,35
1683361043515,MATH 193B,A02,188818,Staff,5,0,35,30
1683361044540,MGT 4,A01,202857,Anderson; John Charles,61,0,80,19
1683361045570,MGT 12,A00,202858,Lindenberger; Wade Douglas,42,0,90,48
1683361046596,MGT 18,A00,202859,Staff,74,0,90,16
1683361047626,MGT 18GS,A00,202860,McKay; Michael J,13,0,28,15
1683361048651,MGT 45,A00,202861,Pecore; Joseph P.,15,0,90,75
1683361049676,MGT 100,A00,202863,Yavorsky; Daniel Ryan,28,0,90,62
1683361050701,MGT 103,A00,202864,Ehrich; Kristine R,0,17,90,90
1683361051731,MGT 112,A00,202865,Ehrich; Kristine R,15,0,90,75
1683361052758,MGT 121A,A00,202868,Staff,0,20,0,0
1683361053783,MGT 131B,A00,202869,Anderson; John Charles,59,0,90,31
1683361054809,MGT 136,A00,202871,Lindenberger; Wade Douglas,84,0,90,6
1683361055835,MGT 164,A00,202873,Staff,0,68,90,91
1683361056865,MGT 164GS,A00,202874,McKay; Mary A,13,0,28,15
1683361057890,MGT 180,A00,202875,Staff,0,50,90,91
1683361058920,MMW 11R,A01,205019,Herbst; Matthew,3,0,30,27
1683361058920,MMW 11R,A02,205026,Herbst; Matthew,29,0,30,1
1683361059952,MMW 15,A01,193512,Chang; Edmond Yi-Teh,0,9,28,28
1683361059952,MMW 15,A02,193513,Chang; Edmond Yi-Teh,0,5,28,28
1683361059952,MMW 15,A03,193514,Chang; Edmond Yi-Teh,0,5,28,28
1683361059952,MMW 15,A04,193515,Chang; Edmond Yi-Teh,0,5,28,28
1683361059952,MMW 15,A05,193516,Chang; Edmond Yi-Teh,0,4,28,28
1683361059952,MMW 15,A06,193517,Chang; Edmond Yi-Teh,0,5,28,28
1683361059952,MMW 15,B01,193519,Chang; Edmond Yi-Teh,0,5,28,28
1683361059952,MMW 15,B02,193520,Chang; Edmond Yi-Teh,0,5,28,28
1683361059952,MMW 15,B03,193521,Chang; Edmond Yi-Teh,0,5,28,28
1683361059952,MMW 15,B04,193522,Chang; Edmond Yi-Teh,0,4,28,28
1683361059952,MMW 15,B05,193523,Chang; Edmond Yi-Teh,0,5,28,28
1683361059952,MMW 15,B06,193524,Chang; Edmond Yi-Teh,0,4,28,28
1683361060979,MMW 122,A01,193526,Rahimi; Babak,0,15,28,28
1683361060979,MMW 122,A02,193527,Rahimi; Babak,0,14,28,28
1683361060979,MMW 122,A03,193528,Rahimi; Babak,0,0,0,0
1683361060979,MMW 122,A04,193529,Rahimi; Babak,0,0,0,0
1683361062005,MUS 1A,A01,186663,Staff,0,20,35,35
1683361063030,MUS 4,A01,186715,Staff,0,12,35,35
1683361064056,MUS 5R,A01,186796,Dubnov; Shlomo,0,17,35,35
1683361065080,MUS 6,A01,186798,Staff,0,4,25,25
1683361066105,MUS 7,A01,186830,Staff,13,0,35,22
1683361067130,MUS 8,A01,186930,Staff,0,26,35,35
1683361068156,MUS 15,A01,186932,Staff,0,16,35,35
1683361068156,MUS 15,B01,186934,Staff,0,15,35,35
1683361069181,MUS 80,A00,186935,Staff,0,0,20,20
1683361069181,MUS 80,B00,186936,Staff,25,0,25,0
1683361070206,NANO 11,A00,204702,Lipomi; Darren John,0,0,0,0
1683361071232,NANO 15,A01,204709,Yang; Kesong,0,1,0,0
1683361072258,NANO 114,A00,202069,Jahed Motlagh; Zeinab,3,0,10,7
1683361073283,PHIL 1,A00,186955,Grush; Rick Scott,32,0,40,8
1683361074308,PHIL 10,A01,186973,Grush; Rick Scott,28,0,35,7
1683361074308,PHIL 10,A02,186974,Grush; Rick Scott,33,0,35,2
1683361075388,PHIL 13,A01,186976,Staff,7,0,35,28
1683361075388,PHIL 13,A02,186977,Staff,16,0,35,19
1683361076416,PHIL 14,A01,186979,Staff,31,0,35,4
1683361076416,PHIL 14,A02,186986,Staff,32,0,35,3
1683361077443,PHIL 28,A01,186988,Staff,16,0,30,14
1683361077443,PHIL 28,A02,186989,Staff,1,0,30,29
1683361077443,PHIL 28,A03,186990,Staff,9,0,30,21
1683361077443,PHIL 28,A04,186991,Staff,26,0,30,4
1683361078469,PHIL 120,A00,186997,Staff,23,0,40,17
1683361079498,PHIL 137,A00,187003,Staff,9,0,40,31
1683361080530,PHIL 150,A00,187015,Staff,47,0,70,23
1683361081555,PHIL 167,A00,187021,Lamey; Andy M.,35,0,40,5
1683361082581,PHIL 174,A01,202226,Staff,17,0,20,3
1683361082581,PHIL 174,A02,202235,Staff,20,0,20,0
1683361083605,PHIL 191A,A00,258918,Staff,0,0,1,1
1683361084631,PHYS 1A,A00,187028,Staff,27,0,60,33
1683361085656,PHYS 1AL,001,187036,Staff,2,0,30,28
1683361085656,PHYS 1AL,002,187049,Staff,18,0,30,12
1683361086684,PHYS 1B,A00,187058,Staff,22,0,60,38
1683361087711,PHYS 1BL,001,187064,Staff,0,0,30,30
1683361087711,PHYS 1BL,002,187070,Staff,5,0,30,25
1683361088737,PHYS 1C,A00,187082,Staff,31,0,120,89
1683361089764,PHYS 1CL,001,187088,Staff,0,9,30,30
1683361089764,PHYS 1CL,002,187089,Staff,0,2,30,30
1683361089764,PHYS 1CL,009,262693,Staff,11,0,30,19
1683361090790,PHYS 2B,A01,187097,Staff,54,0,115,61
1683361091816,PHYS 2C,A01,187099,Staff,67,0,115,48
1683361092843,PHYS 2CL,A01,187101,Staff,5,0,28,23
1683361092843,PHYS 2CL,A02,187102,Staff,15,0,28,13
1683361093867,PHYS 2D,A01,187123,Shotwell; Brian,95,0,115,20
1683361094892,PHYS 4B,A01,187133,Grinstein; Benjamin,35,0,50,15
1683361095920,POLI 10,A00,188819,Staff,0,4,50,50
1683361096946,POLI 11,A00,188827,Staff,43,0,50,7
1683361097970,POLI 13R,A00,188828,Staff,0,1,20,20
1683361098995,POLI 27,A01,188830,Elgin; Samuel Zincke,0,1,70,70
1683361100025,POLI 30,A00,188832,Desposato; Scott,31,0,50,19
1683361101053,POLI 102F,A00,188834,Staff,3,0,40,37
1683361102085,POLI 104A,A00,188852,Staff,14,0,30,16
1683361103113,POLI 104I,A00,188853,Staff,0,6,20,20
1683361104138,POLI 110B,A00,188854,Wiens; David,7,0,20,13
1683361105166,POLI 112A,A00,188855,Wiens; David,5,0,30,25
1683361106191,POLI 117R,A00,188856,Forman; Fonna,0,11,20,20
1683361107217,POLI 118,A00,188857,Ingham; Sean,8,0,20,12
1683361108240,POLI 120G,A00,188858,Staff,9,0,30,21
1683361109269,POLI 131CR,A00,188863,Hoston; Germaine,23,0,50,27
1683361110295,POLI 133,A00,188864,Nellis; Gareth Hb,44,0,50,6
1683361111320,POLI 134D,A00,188865,Desposato; Scott,27,0,30,3
1683361112346,POLI 142A,A00,188871,Gartzke; Erik,22,0,50,28
1683361113375,POLI 142K,A00,188874,Staff,38,0,50,12
1683361114400,POLI 143,A00,188940,Gartzke; Erik,16,0,30,14
1683361115429,POLI 153,A00,188943,Staff,3,0,20,17
1683361116458,POLI 160AA,A00,188944,Staff,11,0,40,29
1683361117483,POLI 170A,A00,188945,Staff,11,0,30,19
1683361119535,PSYC 1,A00,188952,Staff,37,0,90,53
1683361120559,PSYC 2,B00,188953,Staff,19,0,35,16
1683361121584,PSYC 6,A00,188970,Staff,47,0,60,13
1683361122613,PSYC 7,A00,188973,Staff,37,0,45,8
1683361123644,PSYC 60,A01,188980,Rickard; Timothy C.,43,0,60,17
1683361124675,PSYC 70,A01,189001,Steiner; Eric Tomas,23,0,45,22
1683361125705,PSYC 100,A00,189005,Lacefield; Katharine I,0,98,120,120
1683361126730,PSYC 102,A00,189008,Staff,9,0,30,21
1683361127757,PSYC 106,B00,189026,Gorman; Michael R.,34,0,60,26
1683361128784,PSYC 114,B01,189033,Winkielman; Piotr,0,32,30,30
1683361129813,PSYC 131,A00,189036,Anagnostaras; Stephan,0,43,60,60
1683361130840,PSYC 136,A00,189041,Lowe; Angela Beth,0,7,25,25
1683361131870,PSYC 137,A00,189057,Winkielman; Piotr,0,34,25,25
1683361132896,PSYC 144,A00,189107,Wixted; John T,0,7,50,50
1683361134952,PSYC 162,A00,189142,Staff,0,8,85,85
1683361135979,PSYC 172,A00,189144,Gorman; Michael R.,0,7,30,30
1683361138028,PSYC 179,A00,189146,Lacefield; Katharine I,0,84,120,120
1683361139053,PSYC 181,A00,189147,Anagnostaras; Stephan,0,44,90,90
1683361140082,PSYC 190R,A00,189148,Barner; David A.,0,22,80,80
1683361141139,PSYC 191,A00,189275,Rickard; Timothy C.,0,7,25,25
1683361142187,PSYC 193,A00,189276,Chapman; Eddie Nathaniel,0,1,0,4
1683361143213,PSYC 193L,A01,189281,Lowe; Angela Beth,12,0,20,8
1683361143213,PSYC 193L,B01,189285,Staff,28,0,35,7
1683361144242,RELI 149,A00,187137,Rahimi; Babak,7,0,40,33
1683361145270,SE 9,A01,187315,Staff,0,2,18,18
1683361146295,SE 101B,A00,187409,Staff,24,0,30,6
1683361147320,SE 110B,A00,187444,Staff,10,0,40,30
1683361148350,SE 130B,A00,187449,Staff,31,0,40,9
1683361149377,SE 150A,A00,187516,Staff,9,0,20,11
1683361150402,SE 154,A00,187528,Staff,30,0,50,20
1683361151432,SIO 3,A01,258171,Staff,35,0,40,5
1683361152459,SIO 10,A00,187144,Cook; Geoffrey W,0,3,75,75
1683361153485,SIO 45,A00,187152,Cook; Geoffrey W,1,0,100,99
1683361154512,SIO 109R,A00,194486,Staff,0,3,20,20
1683361156567,SIO 187,A01,187233,Kacev; David,12,0,40,28
1683361157600,SOCI 1,A01,258656,Thorpe; Charles Robert,28,0,30,2
1683361157600,SOCI 1,A02,258658,Thorpe; Charles Robert,30,0,30,0
1683361157600,SOCI 1,A03,258661,Thorpe; Charles Robert,25,0,25,0
1683361157600,SOCI 1,A04,258666,Thorpe; Charles Robert,22,0,25,3
1683361157600,SOCI 1,A05,258897,Thorpe; Charles Robert,23,0,25,2
1683361157600,SOCI 1,A06,258898,Thorpe; Charles Robert,25,0,25,0
1683361158625,SOCI 30,A01,258903,Pardo Guerra; Juan Pablo,15,0,30,15
1683361159650,SOCI 102,A00,258904,Staff,9,0,25,16
1683361160676,SOCI 106,A00,258905,Staff,19,0,25,6
1683361161700,SOCI 111,A00,258907,Ribas Norris; Janet Vanesa,26,0,30,4
1683361162728,SOCI 121R,A00,258908,Pardo Guerra; Juan Pablo,10,0,30,20
1683361163758,SOCI 126,A01,203330,Staff,14,0,20,6
1683361164785,SOCI 131,A00,258909,Thorpe; Charles Robert,31,0,60,29
1683361165810,SOCI 135,A00,258910,Payne; Christine Anna,0,9,30,30
1683361166835,SOCI 157,A00,258911,Staff,12,0,30,18
1683361167859,SOCI 184,A00,258912,Staff,25,0,30,5
1683361168882,SOCI 188D,A00,258913,Staff,22,0,30,8
1683361169910,SYN 2,001,187529,Staff,10,0,16,6
1683361169910,SYN 2,002,201452,Staff,0,18,16,16
1683361169910,SYN 2,003,201469,Staff,3,0,16,13
1683361170935,SYN 100,A01,187531,Staff,0,9,20,20
1683361170935,SYN 100,B01,201491,Staff,0,12,20,20
1683361171965,TDAC 1,A00,189286,Walsh; Kim C.,3,0,20,17
1683361171965,TDAC 1,B00,189287,Harting; Carla Kelso,11,0,20,9
1683361172996,TDAC 101,A00,189300,Walsh; Kim C.,16,0,20,4
1683361172996,TDAC 101,B00,189301,Harting; Carla Kelso,18,0,20,2
1683361174026,TDAC 102,A00,189304,Basso; Beatrice,14,0,20,6
1683361175054,TDAC 108,A00,189305,Staff,18,0,20,2
1683361176080,TDDE 131,A00,189310,Staff,19,0,20,1
1683361176080,TDDE 131,B00,189314,Staff,19,0,20,1
1683361176080,TDDE 131,C00,189315,Staff,48,0,50,2
1683361176080,TDDE 131,D00,189316,Staff,14,0,15,1
1683361176080,TDDE 131,E00,204841,Staff,20,0,20,0
1683361177104,TDGE 10,A00,189289,Staff,30,0,50,20
1683361177104,TDGE 10,B00,189290,Havis; Allan,1,0,50,49
1683361178134,TDGE 11,A00,189291,Fulton; Julia,0,3,50,50
1683361178134,TDGE 11,B00,189292,Staff,20,0,25,5
1683361178134,TDGE 11,C00,260270,Staff,0,0,0,0
1683361179217,TDGE 25,A00,189294,Staff,3,0,20,17
1683361180245,TDGE 124,A00,189318,Fulton; Julia,0,8,50,50
1683361181269,TDGE 125,A00,189319,Staff,13,0,25,12
1683361181269,TDGE 125,B00,189320,Staff,23,0,25,2
1683361182294,TDGE 127,A00,189322,Havis; Allan,0,0,50,50
1683361183318,TDHT 101,A00,189323,Staff,18,0,25,7
1683361183318,TDHT 101,B00,189324,Staff,25,0,25,0
1683361184347,TDHT 102,A00,189325,Staff,49,0,50,1
1683361185372,TDMV 1,A00,189295,Arcidiacono; Kristin,19,0,30,11
1683361185372,TDMV 1,B00,189296,Caligagan; Maria T.,24,0,30,6
1683361186396,TDMV 2,A00,189297,Sammartano; Tonnie,28,0,30,2
1683361186396,TDMV 2,B00,189299,Arcidiacono; Kristin,24,0,30,6
1683361187422,TDMV 3,A00,204998,Rincon; Alicia,22,0,30,8
1683361188447,TDMV 120,A00,189458,Sammartano; Tonnie,28,0,30,2
1683361189472,TDMV 138,A00,189541,Jun; Grace Shin Hae,22,0,40,18
1683361190496,TDMV 142,A00,189717,Caligagan; Tony,24,0,30,6
1683361190496,TDMV 142,B00,189718,Caligagan; Maria T.,25,0,30,5
1683361191526,TMC 2,A01,187533,Staff,25,0,25,0
1683361191526,TMC 2,A02,187534,Staff,25,0,25,0
1683361192552,USP 1,A01,187536,Kwak; Nancy,0,16,25,25
1683361193583,USP 5,A01,187538,Staff,10,0,25,15
1683361194611,USP 101,A00,199253,Staff,0,4,0,0
1683361195644,USP 124,A00,187562,Boomhower; Matthew Charles,1,0,30,29
1683361196674,USP 138,A00,187582,Staff,20,0,25,5
1683361197699,USP 152,A01,187597,Staff,4,0,25,21
1683361198726,USP 153,A00,187598,Staff,19,0,25,6
1683361199750,USP 168,A00,187607,Kwak; Nancy,2,0,5,3
1683361200778,USP 173,A00,187619,Staff,4,0,25,21
1683361201803,USP 181,A00,187638,Staff,0,3,25,25
1683361202831,VIS 103,A00,187650,Cruz; Edwin Teddy,22,0,75,53
1683361203859,VIS 110D,A00,187669,Staff,12,0,22,10
1683361204888,VIS 127C,A00,187720,Shen; Kuiyi,67,0,146,79
1683361205912,VIS 149,A00,187731,Yoldas; Pinar,0,14,22,22
1683361206939,VIS 151,A01,188091,Staff,22,0,34,12
1683361206939,VIS 151,A02,188092,Staff,11,0,34,23
1683361207962,VIS 160B,A00,188093,Stalbaum; Brett,0,0,10,10
1683361210013,WCWP 10B,A00,201720,Staff,10,0,15,5
1683361210013,WCWP 10B,B00,201722,Staff,9,0,15,6
1683361211042,WCWP 100,A00,201725,Gagnon; Jeffrey C,0,0,2,2
1683361211042,WCWP 100,B00,201727,Staff,0,4,15,15
1683361214189,ANBI 133,A00,258401,Wilder; Linnea Lorene,34,0,40,6
1683361215218,ANBI 140,A00,258395,Hrvoj Mihic; Branka,18,0,25,7
1683361216242,ANSC 120,A00,258402,Bialecki; Jon Anthony,27,0,40,13
1683361217269,ANSC 144,A00,258400,Staff,14,0,40,26
1683361219323,ANSC 166,A00,258396,Parish; Steven Martin,157,0,175,18
1683361220348,ANSC 180,A00,193533,Staff,9,0,20,11
1683361221373,ANSC 188,A00,258397,Jassal; Aftab,33,0,40,7
1683361222397,ANTH 3,A01,258316,Staff,23,0,30,7
1683361223423,ANTH 5,A00,258394,Semendeferi; Ekaterini,16,0,20,4
1683361224447,ANTH 21,A01,258331,Staff,8,0,40,32
1683361225477,ANTH 103,A00,258398,Varma; Saiba,15,0,25,10
1683361226506,AWP 10,001,202034,Staff,0,0,0,0
1683361226506,AWP 10,002,202035,Staff,0,0,0,0
1683361226506,AWP 10,003,202036,Staff,0,0,0,0
1683361226506,AWP 10,004,202037,Staff,0,0,0,0
1683361226506,AWP 10,005,202038,Staff,0,0,0,0
1683361226506,AWP 10,006,202039,Staff,0,0,0,0
1683361226506,AWP 10,007,202040,Staff,0,0,0,0
1683361226506,AWP 10,008,202041,Staff,0,0,0,0
1683361226506,AWP 10,009,202042,Staff,0,0,0,0
1683361226506,AWP 10,010,202043,Staff,0,0,0,0
1683361226506,AWP 10,011,202044,Staff,0,0,0,0
1683361226506,AWP 10,012,202045,Staff,0,0,0,0
1683361226506,AWP 10,013,202046,Staff,0,0,0,0
1683361226506,AWP 10,014,202047,Staff,0,0,0,0
1683361226506,AWP 10,015,202048,Staff,0,0,0,0
1683361226506,AWP 10,016,202049,Staff,0,0,0,0
1683361226506,AWP 10,017,202050,Staff,0,0,0,0
1683361226506,AWP 10,018,202051,Staff,0,0,0,0
1683361226506,AWP 10,019,202052,Staff,0,0,0,0
1683361226506,AWP 10,020,202053,Staff,0,0,0,0
1683361226506,AWP 10,021,202054,Staff,0,0,0,0
1683361226506,AWP 10,022,202055,Staff,0,0,0,0
1683361226506,AWP 10,023,202056,Staff,0,0,0,0
1683361226506,AWP 10,024,202057,Staff,0,0,0,0
1683361226506,AWP 10,025,202058,Staff,0,0,0,0
1683361226506,AWP 10,026,202059,Staff,0,0,0,0
1683361227531,AWP 102,001,202032,Staff,0,0,0,0
1683361227531,AWP 102,002,202033,Staff,0,0,0,0
1683361228557,BENG 100,A01,254234,Taylor Amos; Alyssa C,31,0,40,9
1683361229580,BENG 196,001,270013,Engler; Adam J.,9999,0,9999,0
1683361230606,BICD 100R,A01,202018,Smith; Laurie,0,7,32,32
1683361230606,BICD 100R,A02,202019,Smith; Laurie,0,2,32,32
1683361230606,BICD 100R,A03,202020,Smith; Laurie,0,1,32,32
1683361230606,BICD 100R,A04,202021,Smith; Laurie,9,0,32,23
1683361230606,BICD 100R,A05,202022,Smith; Laurie,12,0,32,20
1683361231632,BICD 136,A01,193242,Gustafson-Brown; Cindy,0,2,32,32
1683361231632,BICD 136,A02,193244,Gustafson-Brown; Cindy,14,0,32,18
1683361232663,BIEB 102,A01,193249,Butler; Shannon Rhey,0,2,32,32
1683361232663,BIEB 102,A02,193251,Butler; Shannon Rhey,0,0,32,32
1683361232663,BIEB 102,A03,193253,Butler; Shannon Rhey,0,1,32,32
1683361232663,BIEB 102,A04,193255,Butler; Shannon Rhey,17,0,32,15
1683361232663,BIEB 102,A05,193265,Butler; Shannon Rhey,26,0,32,6
1683361232663,BIEB 102,A06,193269,Butler; Shannon Rhey,16,0,32,16
1683361234719,BIEB 150,A01,193274,Staff,0,0,32,32
1683361234719,BIEB 150,A02,193285,Staff,23,0,32,9
1683361235745,BIEB 194,A00,193286,Kurle; Carolyn M.,22,0,32,10
1683361236777,BILD 1,A01,192291,Staff,16,0,32,16
1683361236777,BILD 1,A02,192292,Staff,30,0,32,2
1683361236777,BILD 1,B01,192520,Reuther; Keefe,0,1,0,0
1683361236777,BILD 1,B02,192532,Reuther; Keefe,0,1,0,0
1683361237806,BILD 3,A01,192556,Butler; Shannon Rhey,0,0,32,32
1683361237806,BILD 3,A02,192581,Butler; Shannon Rhey,4,0,32,28
1683361237806,BILD 3,A03,192611,Butler; Shannon Rhey,23,0,32,9
1683361237806,BILD 3,A04,192612,Butler; Shannon Rhey,25,0,32,7
1683361237806,BILD 3,A05,192613,Butler; Shannon Rhey,27,0,32,5
1683361237806,BILD 3,A06,192679,Butler; Shannon Rhey,27,0,32,5
1683361237806,BILD 3,A07,192682,Butler; Shannon Rhey,22,0,32,10
1683361238832,BILD 4,A01,192836,Reuther; Keefe,0,0,24,24
1683361238832,BILD 4,A02,193044,Reuther; Keefe,4,0,24,20
1683361239857,BILD 10,A01,193142,Gustafson-Brown; Cindy,30,0,32,2
1683361239857,BILD 10,A02,193149,Gustafson-Brown; Cindy,31,0,32,1
1683361240888,BIMM 100,A01,193301,Staff,1,6,32,31
1683361240888,BIMM 100,A02,193312,Staff,0,5,32,32
1683361240888,BIMM 100,A03,193323,Staff,0,8,32,32
1683361241915,BIMM 101,A01,193329,McDonnell; Lisa Marie,0,3,24,24
1683361241915,BIMM 101,A02,193339,McDonnell; Lisa Marie,0,3,24,24
1683361241915,BIMM 101,B01,193354,McDonnell; Lisa Marie,0,3,24,24
1683361241915,BIMM 101,B02,193357,McDonnell; Lisa Marie,0,3,24,24
1683361242944,BIMM 110,A01,193377,Tat; John,0,11,32,32
1683361242944,BIMM 110,A02,193378,Tat; John,0,9,32,32
1683361243971,BIMM 120,A01,206116,Staff,0,0,32,32
1683361243971,BIMM 120,A02,206117,Staff,8,0,32,24
1683361243971,BIMM 120,A03,206121,Staff,21,0,32,11
1683361244996,BIPN 100,A01,193393,Park; Ji Young,0,14,32,32
1683361244996,BIPN 100,A02,193402,Park; Ji Young,0,13,32,32
1683361244996,BIPN 100,A03,193413,Park; Ji Young,0,14,32,32
1683361244996,BIPN 100,A04,193414,Park; Ji Young,0,13,32,32
1683361246026,BIPN 102,A01,193429,Staff,0,0,32,32
1683361246026,BIPN 102,A02,193438,Staff,22,0,32,10
1683361247051,BIPN 106,A01,193450,Reyes Gonzalez; Catalina,0,2,40,40
1683361248077,BIPN 134,A01,193465,Cooke; James Edward,1,0,32,31
1683361248077,BIPN 134,A02,193474,Cooke; James Edward,25,0,32,7
1683361248077,BIPN 134,A03,193485,Cooke; James Edward,29,0,32,3
1683361248077,BIPN 134,A04,193486,Cooke; James Edward,21,0,32,11
1683361248077,BIPN 134,A05,193491,Cooke; James Edward,31,0,32,1
1683361248077,BIPN 134,A06,193501,Cooke; James Edward,30,0,32,2
1683361248077,BIPN 134,A07,193510,Cooke; James Edward,29,0,32,3
1683361250136,BISP 194,A00,222522,Staff,14,0,32,18
1683361251161,CAT 124,A01,202407,Staff,19,0,25,6
1683361252186,CAT 125,A00,202408,Marchisotto; Jennifer Anne,4,0,20,16
1683361253212,CAT 125R,A00,202409,Smith; Lauryn Alissa,0,11,20,20
1683361253212,CAT 125R,B00,202410,Morales; Celeste Georgianna,0,11,20,20
1683361253212,CAT 125R,C00,202411,Irwin; Matthew Joseph,0,10,20,20
1683361254238,CENG 15,A01,204712,Yang; Kesong,0,1,0,0
1683361255266,CENG 114,A00,202070,Jahed Motlagh; Zeinab,5,0,20,15
1683361256296,CGS 105,A00,185477,Wesling; Megan E.,24,0,40,16
1683361257324,CGS 106,A00,185494,Staff,13,0,22,9
1683361258351,CGS 108,A00,185495,Staff,14,0,20,6
1683361259378,CGS 114,A00,185496,Staff,13,0,18,5
1683361260406,CGS 119,A00,185501,Staff,15,0,20,5
1683361261434,CGS 120,A00,185511,Staff,13,0,20,7
1683361262465,CHEM 4,A01,184675,Bussey; Thomas J,96,0,100,4
1683361263493,CHEM 6A,A01,184677,Staff,34,0,60,26
1683361264517,CHEM 6B,A01,184679,Staff,65,0,100,35
1683361265542,CHEM 6C,A01,184681,Bussey; Thomas J,1,0,50,49
1683361265542,CHEM 6C,A02,184682,Bussey; Thomas J,34,0,50,16
1683361266567,CHEM 40A,A01,184684,Albizati; Kim F.,37,0,100,63
1683361267592,CHEM 40B,A01,184686,Albizati; Kim F.,0,20,100,100
1683361268623,CHEM 41B,A01,184690,Staff,52,0,100,48
1683361269652,COGS 3,A01,184715,Boyle; Mary E. T.,0,25,40,40
1683361270678,COGS 14B,A01,185172,Staff,0,15,38,38
1683361271702,COGS 18,A01,184736,Staff,16,0,80,64
1683361272727,COGS 100,A01,184932,Staff,0,5,73,73
1683361273757,COGS 101A,A01,184935,Staff,0,39,30,30
1683361274782,COGS 101B,A01,184944,Staff,0,2,30,30
1683361275805,COGS 101C,A01,184946,Staff,0,12,30,30
1683361276831,COGS 102A,A01,184951,Johnson; Christine M.,2,0,40,38
1683361277858,COGS 107B,A01,184953,Mooshagian; Eric Frederick,0,50,40,40
1683361278882,COGS 118B,A01,184959,Gupta; Anjum,0,48,40,40
1683361279907,COGS 153,A00,184961,Staff,0,15,30,30
1683361280932,COGS 177,A00,184962,Staff,0,20,30,30
1683361281960,COGS 187A,A01,184969,Boyle; Mary E. T.,0,17,40,40
1683361283043,COMM 10,A01,185174,Staff,0,5,25,25
1683361283043,COMM 10,A02,185189,Staff,0,5,25,25
1683361283043,COMM 10,A03,269821,Staff,0,0,0,0
1683361284068,COMM 100B,A01,185475,Staff,0,0,0,2
1683361284068,COMM 100B,A02,185476,Staff,13,0,25,12
1683361285090,COMM 100C,A01,185314,Staff,1,0,25,24
1683361285090,COMM 100C,A02,185327,Staff,19,0,25,6
1683361286118,COMM 110M,A00,185349,Staff,2,0,40,38
1683361287145,COMM 113T,A00,185352,Staff,24,0,40,16
1683361288171,COMM 114I,A00,185353,Staff,33,0,40,7
1683361289198,COMM 131,A00,185354,Staff,19,0,30,11
1683361290222,CSE 8A,A50,185358,Cao; Yingjun,0,46,10,10
1683361291244,CSE 8B,A01,185362,Staff,0,46,50,50
1683361292269,CSE 11,A01,185416,Cao; Yingjun,0,92,10,10
1683361293296,CSE 20,A01,185445,Briones; Jor-el Thomas Caparas,5,0,25,20
1683361294324,CSE 21,A01,185447,Staff,10,0,50,40
1683361295349,CSE 101,A01,185451,Staff,0,13,50,50
1683361295349,CSE 101,B01,185453,Jones; Miles E,0,11,50,50
1683361297402,CSE 141,A01,185458,Eldon; John,20,0,100,80
1683361298427,CSE 141L,A01,185461,Eldon; John,12,0,100,88
1683361299452,CSE 142,A01,185463,Staff,36,0,60,24
1683361299452,CSE 142,B01,201355,Staff,0,7,60,60
1683361300480,CSE 142L,A01,185470,Staff,36,0,60,24
1683361300480,CSE 142L,B01,201417,Staff,0,6,60,60
1683361301507,CSE 190,A00,201433,Staff,32,0,49,17
1683361302538,DOC 1,A01,259136,Strom; Megan C.,7,0,15,8
1683361302538,DOC 1,A02,259137,Strom; Megan C.,14,0,15,1
1683361302538,DOC 1,A03,259138,Strom; Megan C.,14,0,15,1
1683361302538,DOC 1,A04,259139,Strom; Megan C.,14,0,15,1
1683361303562,DOC 100D,A00,259140,Pass; Natalye Joann,16,0,25,9
1683361304594,DSGN 1,A01,184749,Rill; Bryan,0,25,30,30
1683361305622,DSGN 100,A01,185168,Staff,0,2,25,25
1683361306653,ECE 5,A01,185626,Morris; Karcher William,0,10,0,0
1683361307681,ECE 101,A01,185628,Staff,17,0,70,53
1683361308712,ECE 107,A01,185635,Baghdadchi; Saharnaz,0,0,20,20
1683361308712,ECE 107,A02,185638,Baghdadchi; Saharnaz,4,0,20,16
1683361309742,ECE 148,A01,185647,Silberman; Jack,0,0,16,16
1683361310769,ECON 1,A01,185537,Crane; Meredith Helen,54,0,70,16
1683361311797,ECON 3,A01,185549,Crane; Meredith Helen,32,0,70,38
1683361312826,ECON 4,A01,203354,Anderson; John Charles,0,4,10,10
1683361313854,ECON 100A,A01,185574,Staff,0,4,40,40
1683361314885,ECON 100B,A01,185576,Staff,0,12,50,50
1683361315911,ECON 100C,A01,185589,Newhouse; Herbert S,29,0,70,41
1683361316940,ECON 105,A00,185608,Vespa; Emanuel Ignacio,19,0,35,16
1683361317970,ECON 109,A01,185610,Shishkin; Denis,10,0,35,25
1683361318997,ECON 110A,A01,185612,Staff,11,0,40,29
1683361320023,ECON 120A,A01,185615,Staff,20,0,40,20
1683361321048,ECON 120C,A01,185617,Sun; Yixiao,0,21,70,70
1683361322073,ECON 144,A00,203346,Squires; Dale E,3,0,35,32
1683361323102,ECON 171,A01,203349,Newhouse; Herbert S,0,1,35,35
1683361324131,ECON 173A,A01,185621,Toda; Alexis Akira,21,0,35,14
1683361325158,EDS 25,A01,202413,Staff,0,1,0,0
1683361325158,EDS 25,A02,202414,Staff,0,1,0,0
1683361325158,EDS 25,A03,202415,Staff,0,0,0,0
1683361325158,EDS 25,A04,202416,Staff,0,1,0,0
1683361325158,EDS 25,A05,202439,Staff,0,0,0,0
1683361325158,EDS 25,A06,202440,Staff,0,0,0,0
1683361325158,EDS 25,B01,202631,Staff,0,0,0,0
1683361325158,EDS 25,B02,202632,Staff,0,0,0,0
1683361325158,EDS 25,B03,202639,Staff,0,0,0,0
1683361325158,EDS 25,B04,202640,Staff,0,0,0,0
1683361325158,EDS 25,B05,202643,Staff,0,0,0,0
1683361325158,EDS 25,B06,202644,Staff,0,0,0,0
1683361326184,EDS 38,A01,202659,Black; Alison Michelle,24,0,25,1
1683361327207,EDS 115,A00,202652,Staff,18,0,30,12
1683361328235,EDS 125,A00,202649,Staff,14,0,30,16
1683361329262,EDS 126,A01,203332,Staff,30,0,30,0
1683361330286,EDS 139,A00,202838,Staff,16,0,25,9
1683361331310,EDS 146,A01,202655,Staff,14,0,25,11
1683361332337,ENG 15,A00,185667,Staff,0,1,0,0
1683361332337,ENG 15,B00,185672,Staff,0,0,0,0
1683361332337,ENG 15,C00,185675,Staff,0,0,0,0
1683361332337,ENG 15,D00,185682,Staff,0,0,0,0
1683361332337,ENG 15,E00,185684,Staff,0,0,0,0
1683361333362,ETHN 103,A00,185710,Staff,0,4,35,35
1683361334388,ETHN 103A,A00,199228,Man; Simeon S,2,0,9,7
1683361335413,ETHN 109,A00,185711,Staff,18,0,35,17
1683361336439,ETHN 142,A00,185726,Staff,0,4,30,30
1683361337468,ETHN 163J,A00,199229,Man; Simeon S,5,0,8,3
1683361338496,ETHN 168,A00,185727,Staff,8,0,10,2
1683361339522,ETHN 182,A00,185728,Staff,0,0,35,35
1683361340549,ETHN 183,A00,185737,Staff,8,0,18,10
1683361341579,GLBH 111,A01,209361,Burgos; Jose L.,0,0,0,0
1683361343631,HIEU 104,A00,185792,Staff,16,0,20,4
1683361344657,HIEU 115,A00,185800,Staff,1,0,20,19
1683361345686,HIEU 128,A00,185801,Staff,0,7,20,20
1683361346712,HIEU 147,A00,185802,Staff,16,0,20,4
1683361347736,HIEU 154,A00,185823,Staff,12,0,20,8
1683361348761,HILA 102,A00,185826,Staff,13,0,20,7
1683361349786,HILD 2C,A01,185778,Staff,0,12,20,20
1683361350813,HILD 7B,A01,185780,Kwak; Nancy,0,15,32,32
1683361350813,HILD 7B,A02,185781,Kwak; Nancy,0,18,32,32
1683361351840,HILD 30,A01,185791,Staff,14,0,20,6
1683361352869,HISC 119,A00,185830,Golan; Tal,0,9,20,20
1683361353898,HITO 156GS,A00,185831,Patterson; Patrick H.,0,0,0,23
1683361354925,HIUS 103,A00,185832,Man; Simeon S,1,6,20,19
1683361355951,HIUS 117,A00,185836,Kwak; Nancy,2,0,20,18
1683361356976,HIUS 125,A00,185840,Man; Simeon S,0,0,23,23
1683361358005,HIUS 149,A00,185845,Staff,0,0,20,20
1683361359033,HUM 3,A01,185882,Zavodny; Tatiana Sophia,0,7,50,50
1683361359033,HUM 3,B01,185899,Caldwell; Michael Alan,0,18,50,50
1683361360060,HUM 3GS,A00,185900,Patterson; Patrick H.,0,0,0,23
1683361361088,HUM 4,A01,185938,Zroka; Amy Liane,31,0,50,19
1683361361088,HUM 4,B01,185956,Watkins; Eric,0,3,50,50
1683361361088,HUM 4,B02,202209,Watkins; Eric,0,2,50,50
1683361361088,HUM 4,B03,202210,Watkins; Eric,0,2,50,50
1683361362117,HUM 5,A01,185958,West; Geoffrey Scott,3,0,50,47
1683361362117,HUM 5,A02,202215,West; Geoffrey Scott,0,0,50,50
1683361363146,INTL 190,A00,185959,Gagnon; Jeffrey C,0,0,0,9
1683361363146,INTL 190,B00,185960,Lettieri; Michael Joseph,0,0,0,1
1683361364215,JAPN 180,A00,254509,Staff,4,0,30,26
1683361365246,LATI 10,A01,202853,Kennemore; Amy Michelle,4,0,35,31
1683361365246,LATI 10,A02,202854,Kennemore; Amy Michelle,2,0,35,33
1683361365246,LATI 10,A03,270054,Kennemore; Amy Michelle,30,0,30,0
1683361366273,LATI 180,A00,202855,Kennemore; Amy Michelle,11,0,20,9
1683361367296,LAWS 101,A00,201767,Golan; Tal,0,7,40,40
1683361368321,LIFR 1C,A00,185961,Staff,6,0,20,14
1683361369352,LIFR 1CX,A00,185962,Staff,7,0,20,13
1683361370383,LIFR 1D,A00,185963,Staff,9,0,20,11
1683361371411,LIFR 1DX,A00,185964,Staff,9,0,20,11
1683361372434,LIGN 101,A01,186039,Staff,43,0,50,7
1683361373461,LIGN 165,A00,186040,Staff,18,0,50,32
1683361374486,LTCS 108,A00,186041,Staff,6,0,10,4
1683361375513,LTCS 119,A00,186042,Staff,16,0,20,4
1683361376541,LTCS 130,A00,186043,Wesling; Megan E.,15,0,25,10
1683361378591,LTEA 138,A00,186119,Staff,14,0,40,26
1683361379618,LTEN 124,A00,186148,Staff,6,0,25,19
1683361380643,LTEN 178,A00,186149,Staff,7,0,15,8
1683361381686,LTEN 181,A00,186150,Blanco; John D,33,0,40,7
1683361382713,LTWL 120,A00,186160,Staff,20,0,25,5
1683361383741,LTWL 165,A00,186161,Staff,22,0,25,3
1683361384766,LTWR 100,A00,186162,Staff,0,5,15,15
1683361385791,LTWR 102,A00,186163,Doller; Ben,5,0,15,10
1683361386872,MAE 8,A01,186412,Staff,0,0,0,0
1683361387898,MAE 30B,A00,186445,Bahadori; Mohammad Yousef,83,0,100,17
1683361388924,MAE 40,A00,186592,Bewley; Thomas R,10,0,50,40
1683361389952,MAE 101B,A00,186593,Bahadori; Mohammad Yousef,81,0,100,19
1683361390980,MAE 105,A00,186594,Bandaru; Prabhakar,12,0,50,38
1683361392006,MAE 107,A00,186599,Pham; Hieu Tan,0,7,120,120
1683361393031,MAE 148,A01,186660,Silberman; Jack,3,0,16,13
1683361394064,MATH 10A,A01,188095,Staff,0,5,35,35
1683361395091,MATH 10B,A01,188097,Bowers; Adam R.,0,11,30,30
1683361395091,MATH 10B,A02,188099,Bowers; Adam R.,0,11,30,30
1683361395091,MATH 10B,B01,188104,Bowers; Adam R.,0,10,30,30
1683361395091,MATH 10B,B02,188106,Bowers; Adam R.,0,10,30,30
1683361396116,MATH 10C,A01,188111,Staff,0,18,30,30
1683361396116,MATH 10C,A02,188127,Staff,0,17,30,30
1683361396116,MATH 10C,A03,188131,Staff,0,18,30,30
1683361396116,MATH 10C,B01,188218,Staff,18,0,30,12
1683361396116,MATH 10C,B02,188244,Staff,13,0,30,17
1683361396116,MATH 10C,B03,188277,Staff,16,0,30,14
1683361397278,MATH 18,A01,188344,Bach; Quang Tran,18,0,30,12
1683361397278,MATH 18,A02,188345,Bach; Quang Tran,11,0,30,19
1683361397278,MATH 18,B01,188353,Bach; Quang Tran,10,0,30,20
1683361397278,MATH 18,B02,188354,Bach; Quang Tran,20,0,30,10
1683361398307,MATH 20A,A01,188374,Staff,12,0,35,23
1683361399337,MATH 20B,A01,188382,Ohm; Ko Woon,6,0,30,24
1683361399337,MATH 20B,A02,188383,Ohm; Ko Woon,21,0,30,9
1683361399337,MATH 20B,B01,188385,Ohm; Ko Woon,7,0,30,23
1683361399337,MATH 20B,B02,188392,Ohm; Ko Woon,22,0,30,8
1683361400370,MATH 20C,A01,188394,Harel; Guershon,10,0,30,20
1683361400370,MATH 20C,A02,188395,Harel; Guershon,15,0,30,15
1683361400370,MATH 20C,B01,188404,Harel; Guershon,4,0,30,26
1683361400370,MATH 20C,B02,188405,Harel; Guershon,19,0,30,11
1683361401404,MATH 20D,A01,188414,Hammock; Frances H,0,1,30,30
1683361401404,MATH 20D,A02,188415,Hammock; Frances H,3,0,30,27
1683361401404,MATH 20D,B01,188447,Hammock; Frances H,1,0,30,29
1683361401404,MATH 20D,B02,188486,Hammock; Frances H,8,0,30,22
1683361402432,MATH 20E,A01,188649,Staff,21,0,30,9
1683361402432,MATH 20E,A02,188650,Staff,23,0,30,7
1683361402432,MATH 20E,A03,188673,Staff,0,0,30,30
1683361403459,MATH 102,A01,188675,Staff,0,35,35,35
1683361404491,MATH 103B,A01,188681,Staff,3,0,35,32
1683361404491,MATH 103B,B01,188692,Staff,5,0,35,30
1683361405518,MATH 109,A01,188695,Salehi Golsefidy; Alireza,25,0,35,10
1683361405518,MATH 109,A02,188696,Salehi Golsefidy; Alireza,25,0,35,10
1683361406549,MATH 120A,A01,188698,Eggers; John Dietrich,7,0,35,28
1683361407579,MATH 142B,A01,188736,Ioana; Adrian,0,2,30,30
1683361407579,MATH 142B,A02,188741,Ioana; Adrian,0,0,30,30
1683361407579,MATH 142B,A03,188743,Ioana; Adrian,0,1,30,30
1683361408605,MATH 168A,A01,188790,Staff,0,9,35,35
1683361409634,MATH 170A,A01,188803,Nie; Jiawang,0,2,35,35
1683361409634,MATH 170A,A02,188811,Nie; Jiawang,0,0,35,35
1683361409634,MATH 170A,A03,188814,Nie; Jiawang,1,0,35,34
1683361409634,MATH 170A,A04,188815,Nie; Jiawang,13,0,35,22
1683361410659,MATH 193B,A01,188817,Staff,0,0,35,35
1683361410659,MATH 193B,A02,188818,Staff,5,0,35,30
1683361411689,MGT 4,A01,202857,Anderson; John Charles,61,0,80,19
1683361412718,MGT 12,A00,202858,Lindenberger; Wade Douglas,42,0,90,48
1683361413744,MGT 18,A00,202859,Staff,74,0,90,16
1683361414772,MGT 18GS,A00,202860,McKay; Michael J,13,0,28,15
1683361415799,MGT 45,A00,202861,Pecore; Joseph P.,15,0,90,75
1683361416825,MGT 100,A00,202863,Yavorsky; Daniel Ryan,28,0,90,62
1683361417851,MGT 103,A00,202864,Ehrich; Kristine R,0,17,90,90
1683361418876,MGT 112,A00,202865,Ehrich; Kristine R,15,0,90,75
1683361419902,MGT 121A,A00,202868,Staff,0,20,0,0
1683361420927,MGT 131B,A00,202869,Anderson; John Charles,59,0,90,31
1683361421950,MGT 136,A00,202871,Lindenberger; Wade Douglas,84,0,90,6
1683361422976,MGT 164,A00,202873,Staff,0,68,90,91
1683361424000,MGT 164GS,A00,202874,McKay; Mary A,13,0,28,15
1683361425028,MGT 180,A00,202875,Staff,0,50,90,91
1683361426058,MMW 11R,A01,205019,Herbst; Matthew,3,0,30,27
1683361426058,MMW 11R,A02,205026,Herbst; Matthew,29,0,30,1
1683361427090,MMW 15,A01,193512,Chang; Edmond Yi-Teh,0,9,28,28
1683361427090,MMW 15,A02,193513,Chang; Edmond Yi-Teh,0,5,28,28
1683361427090,MMW 15,A03,193514,Chang; Edmond Yi-Teh,0,5,28,28
1683361427090,MMW 15,A04,193515,Chang; Edmond Yi-Teh,0,5,28,28
1683361427090,MMW 15,A05,193516,Chang; Edmond Yi-Teh,0,4,28,28
1683361427090,MMW 15,A06,193517,Chang; Edmond Yi-Teh,0,5,28,28
1683361427090,MMW 15,B01,193519,Chang; Edmond Yi-Teh,0,5,28,28
1683361427090,MMW 15,B02,193520,Chang; Edmond Yi-Teh,0,5,28,28
1683361427090,MMW 15,B03,193521,Chang; Edmond Yi-Teh,0,5,28,28
1683361427090,MMW 15,B04,193522,Chang; Edmond Yi-Teh,0,4,28,28
1683361427090,MMW 15,B05,193523,Chang; Edmond Yi-Teh,0,5,28,28
1683361427090,MMW 15,B06,193524,Chang; Edmond Yi-Teh,0,4,28,28
1683361428115,MMW 122,A01,193526,Rahimi; Babak,0,15,28,28
1683361428115,MMW 122,A02,193527,Rahimi; Babak,0,14,28,28
1683361428115,MMW 122,A03,193528,Rahimi; Babak,0,0,0,0
1683361428115,MMW 122,A04,193529,Rahimi; Babak,0,0,0,0
1683361429139,MUS 1A,A01,186663,Staff,0,20,35,35
1683361430164,MUS 4,A01,186715,Staff,0,12,35,35
1683361431190,MUS 5R,A01,186796,Dubnov; Shlomo,0,17,35,35
1683361432219,MUS 6,A01,186798,Staff,0,4,25,25
1683361433247,MUS 7,A01,186830,Staff,13,0,35,22
1683361434276,MUS 8,A01,186930,Staff,0,26,35,35
1683361435302,MUS 15,A01,186932,Staff,0,16,35,35
1683361435302,MUS 15,B01,186934,Staff,0,15,35,35
1683361436332,MUS 80,A00,186935,Staff,0,0,20,20
1683361436332,MUS 80,B00,186936,Staff,25,0,25,0
1683361437359,NANO 11,A00,204702,Lipomi; Darren John,0,0,0,0
1683361438401,NANO 15,A01,204709,Yang; Kesong,0,1,0,0
1683361439428,NANO 114,A00,202069,Jahed Motlagh; Zeinab,3,0,10,7
1683361440455,PHIL 1,A00,186955,Grush; Rick Scott,32,0,40,8
1683361441480,PHIL 10,A01,186973,Grush; Rick Scott,28,0,35,7
1683361441480,PHIL 10,A02,186974,Grush; Rick Scott,33,0,35,2
1683361442505,PHIL 13,A01,186976,Staff,7,0,35,28
1683361442505,PHIL 13,A02,186977,Staff,16,0,35,19
1683361443530,PHIL 14,A01,186979,Staff,31,0,35,4
1683361443530,PHIL 14,A02,186986,Staff,32,0,35,3
1683361444558,PHIL 28,A01,186988,Staff,16,0,30,14
1683361444558,PHIL 28,A02,186989,Staff,1,0,30,29
1683361444558,PHIL 28,A03,186990,Staff,9,0,30,21
1683361444558,PHIL 28,A04,186991,Staff,26,0,30,4
1683361445582,PHIL 120,A00,186997,Staff,23,0,40,17
1683361446609,PHIL 137,A00,187003,Staff,9,0,40,31
1683361447636,PHIL 150,A00,187015,Staff,47,0,70,23
1683361448662,PHIL 167,A00,187021,Lamey; Andy M.,35,0,40,5
1683361449687,PHIL 174,A01,202226,Staff,17,0,20,3
1683361449687,PHIL 174,A02,202235,Staff,20,0,20,0
1683361450719,PHIL 191A,A00,258918,Staff,0,0,1,1
1683361451745,PHYS 1A,A00,187028,Staff,27,0,60,33
1683361452771,PHYS 1AL,001,187036,Staff,2,0,30,28
1683361452771,PHYS 1AL,002,187049,Staff,18,0,30,12
1683361453799,PHYS 1B,A00,187058,Staff,22,0,60,38
1683361454826,PHYS 1BL,001,187064,Staff,0,0,30,30
1683361454826,PHYS 1BL,002,187070,Staff,5,0,30,25
1683361455854,PHYS 1C,A00,187082,Staff,31,0,120,89
1683361456879,PHYS 1CL,001,187088,Staff,0,9,30,30
1683361456879,PHYS 1CL,002,187089,Staff,0,2,30,30
1683361456879,PHYS 1CL,009,262693,Staff,11,0,30,19
1683361457903,PHYS 2B,A01,187097,Staff,54,0,115,61
1683361458928,PHYS 2C,A01,187099,Staff,67,0,115,48
1683361459954,PHYS 2CL,A01,187101,Staff,5,0,28,23
1683361459954,PHYS 2CL,A02,187102,Staff,15,0,28,13
1683361460979,PHYS 2D,A01,187123,Shotwell; Brian,95,0,115,20
1683361462004,PHYS 4B,A01,187133,Grinstein; Benjamin,35,0,50,15
1683361463030,POLI 10,A00,188819,Staff,0,4,50,50
1683361464055,POLI 11,A00,188827,Staff,43,0,50,7
1683361465080,POLI 13R,A00,188828,Staff,0,1,20,20
1683361466105,POLI 27,A01,188830,Elgin; Samuel Zincke,0,1,70,70
1683361467129,POLI 30,A00,188832,Desposato; Scott,31,0,50,19
1683361468155,POLI 102F,A00,188834,Staff,3,0,40,37
1683361469182,POLI 104A,A00,188852,Staff,14,0,30,16
1683361470209,POLI 104I,A00,188853,Staff,0,6,20,20
1683361471236,POLI 110B,A00,188854,Wiens; David,7,0,20,13
1683361472263,POLI 112A,A00,188855,Wiens; David,5,0,30,25
1683361473290,POLI 117R,A00,188856,Forman; Fonna,0,11,20,20
1683361474317,POLI 118,A00,188857,Ingham; Sean,8,0,20,12
1683361475344,POLI 120G,A00,188858,Staff,9,0,30,21
1683361476368,POLI 131CR,A00,188863,Hoston; Germaine,23,0,50,27
1683361477395,POLI 133,A00,188864,Nellis; Gareth Hb,44,0,50,6
1683361478423,POLI 134D,A00,188865,Desposato; Scott,27,0,30,3
1683361479451,POLI 142A,A00,188871,Gartzke; Erik,22,0,50,28
1683361480480,POLI 142K,A00,188874,Staff,38,0,50,12
1683361481504,POLI 143,A00,188940,Gartzke; Erik,16,0,30,14
1683361482528,POLI 153,A00,188943,Staff,3,0,20,17
1683361483555,POLI 160AA,A00,188944,Staff,11,0,40,29
1683361484580,POLI 170A,A00,188945,Staff,11,0,30,19
1683361486632,PSYC 1,A00,188952,Staff,37,0,90,53
1683361487656,PSYC 2,B00,188953,Staff,19,0,35,16
1683361488680,PSYC 6,A00,188970,Staff,47,0,60,13
1683361489705,PSYC 7,A00,188973,Staff,37,0,45,8
1683361490802,PSYC 60,A01,188980,Rickard; Timothy C.,43,0,60,17
1683361491827,PSYC 70,A01,189001,Steiner; Eric Tomas,23,0,45,22
1683361492852,PSYC 100,A00,189005,Lacefield; Katharine I,0,98,120,120
1683361493880,PSYC 102,A00,189008,Staff,9,0,30,21
1683361494904,PSYC 106,B00,189026,Gorman; Michael R.,34,0,60,26
1683361495931,PSYC 114,B01,189033,Winkielman; Piotr,0,32,30,30
1683361496956,PSYC 131,A00,189036,Anagnostaras; Stephan,0,43,60,60
1683361497979,PSYC 136,A00,189041,Lowe; Angela Beth,0,7,25,25
1683361499004,PSYC 137,A00,189057,Winkielman; Piotr,0,34,25,25
1683361500030,PSYC 144,A00,189107,Wixted; John T,0,7,50,50
1683361502078,PSYC 162,A00,189142,Staff,0,8,85,85
1683361503105,PSYC 172,A00,189144,Gorman; Michael R.,0,7,30,30
1683361505156,PSYC 179,A00,189146,Lacefield; Katharine I,0,84,120,120
1683361506183,PSYC 181,A00,189147,Anagnostaras; Stephan,0,44,90,90
1683361507208,PSYC 190R,A00,189148,Barner; David A.,0,22,80,80
1683361508236,PSYC 191,A00,189275,Rickard; Timothy C.,0,7,25,25
1683361509262,PSYC 193,A00,189276,Chapman; Eddie Nathaniel,0,1,0,4
1683361510291,PSYC 193L,A01,189281,Lowe; Angela Beth,12,0,20,8
1683361510291,PSYC 193L,B01,189285,Staff,28,0,35,7
1683361511316,RELI 149,A00,187137,Rahimi; Babak,7,0,40,33
1683361512344,SE 9,A01,187315,Staff,0,2,18,18
1683361513368,SE 101B,A00,187409,Staff,24,0,30,6
1683361514393,SE 110B,A00,187444,Staff,10,0,40,30
1683361515416,SE 130B,A00,187449,Staff,31,0,40,9
1683361516440,SE 150A,A00,187516,Staff,9,0,20,11
1683361517464,SE 154,A00,187528,Staff,30,0,50,20
1683361518494,SIO 3,A01,258171,Staff,35,0,40,5
1683361519522,SIO 10,A00,187144,Cook; Geoffrey W,0,3,75,75
1683361520548,SIO 45,A00,187152,Cook; Geoffrey W,1,0,100,99
1683361521575,SIO 109R,A00,194486,Staff,0,3,20,20
1683361523624,SIO 187,A01,187233,Kacev; David,12,0,40,28
1683361524650,SOCI 1,A01,258656,Thorpe; Charles Robert,28,0,30,2
1683361524650,SOCI 1,A02,258658,Thorpe; Charles Robert,30,0,30,0
1683361524650,SOCI 1,A03,258661,Thorpe; Charles Robert,25,0,25,0
1683361524650,SOCI 1,A04,258666,Thorpe; Charles Robert,22,0,25,3
1683361524650,SOCI 1,A05,258897,Thorpe; Charles Robert,23,0,25,2
1683361524650,SOCI 1,A06,258898,Thorpe; Charles Robert,25,0,25,0
1683361525674,SOCI 30,A01,258903,Pardo Guerra; Juan Pablo,15,0,30,15
1683361526702,SOCI 102,A00,258904,Staff,9,0,25,16
1683361527725,SOCI 106,A00,258905,Staff,19,0,25,6
1683361528752,SOCI 111,A00,258907,Ribas Norris; Janet Vanesa,26,0,30,4
1683361529776,SOCI 121R,A00,258908,Pardo Guerra; Juan Pablo,10,0,30,20
1683361530800,SOCI 126,A01,203330,Staff,14,0,20,6
1683361531824,SOCI 131,A00,258909,Thorpe; Charles Robert,31,0,60,29
1683361532847,SOCI 135,A00,258910,Payne; Christine Anna,0,9,30,30
1683361533871,SOCI 157,A00,258911,Staff,12,0,30,18
1683361534899,SOCI 184,A00,258912,Staff,25,0,30,5
1683361535924,SOCI 188D,A00,258913,Staff,22,0,30,8
1683361536949,SYN 2,001,187529,Staff,10,0,16,6
1683361536949,SYN 2,002,201452,Staff,0,18,16,16
1683361536949,SYN 2,003,201469,Staff,3,0,16,13
1683361537975,SYN 100,A01,187531,Staff,0,9,20,20
1683361537975,SYN 100,B01,201491,Staff,0,12,20,20
1683361539004,TDAC 1,A00,189286,Walsh; Kim C.,3,0,20,17
1683361539004,TDAC 1,B00,189287,Harting; Carla Kelso,11,0,20,9
1683361540028,TDAC 101,A00,189300,Walsh; Kim C.,16,0,20,4
1683361540028,TDAC 101,B00,189301,Harting; Carla Kelso,18,0,20,2
1683361541053,TDAC 102,A00,189304,Basso; Beatrice,14,0,20,6
1683361542078,TDAC 108,A00,189305,Staff,18,0,20,2
1683361543104,TDDE 131,A00,189310,Staff,19,0,20,1
1683361543104,TDDE 131,B00,189314,Staff,19,0,20,1
1683361543104,TDDE 131,C00,189315,Staff,48,0,50,2
1683361543104,TDDE 131,D00,189316,Staff,14,0,15,1
1683361543104,TDDE 131,E00,204841,Staff,20,0,20,0
1683361544129,TDGE 10,A00,189289,Staff,30,0,50,20
1683361544129,TDGE 10,B00,189290,Havis; Allan,1,0,50,49
1683361545155,TDGE 11,A00,189291,Fulton; Julia,0,3,50,50
1683361545155,TDGE 11,B00,189292,Staff,20,0,25,5
1683361545155,TDGE 11,C00,260270,Staff,0,0,0,0
1683361546179,TDGE 25,A00,189294,Staff,3,0,20,17
1683361547204,TDGE 124,A00,189318,Fulton; Julia,0,8,50,50
1683361548227,TDGE 125,A00,189319,Staff,13,0,25,12
1683361548227,TDGE 125,B00,189320,Staff,23,0,25,2
1683361549254,TDGE 127,A00,189322,Havis; Allan,0,0,50,50
1683361550279,TDHT 101,A00,189323,Staff,18,0,25,7
1683361550279,TDHT 101,B00,189324,Staff,25,0,25,0
1683361551307,TDHT 102,A00,189325,Staff,49,0,50,1
1683361552334,TDMV 1,A00,189295,Arcidiacono; Kristin,19,0,30,11
1683361552334,TDMV 1,B00,189296,Caligagan; Maria T.,24,0,30,6
1683361553359,TDMV 2,A00,189297,Sammartano; Tonnie,28,0,30,2
1683361553359,TDMV 2,B00,189299,Arcidiacono; Kristin,24,0,30,6
1683361554387,TDMV 3,A00,204998,Rincon; Alicia,22,0,30,8
1683361555415,TDMV 120,A00,189458,Sammartano; Tonnie,28,0,30,2
1683361556440,TDMV 138,A00,189541,Jun; Grace Shin Hae,22,0,40,18
1683361557464,TDMV 142,A00,189717,Caligagan; Tony,24,0,30,6
1683361557464,TDMV 142,B00,189718,Caligagan; Maria T.,25,0,30,5
1683361558492,TMC 2,A01,187533,Staff,25,0,25,0
1683361558492,TMC 2,A02,187534,Staff,25,0,25,0
1683361559520,USP 1,A01,187536,Kwak; Nancy,0,16,25,25
1683361560547,USP 5,A01,187538,Staff,10,0,25,15
1683361561572,USP 101,A00,199253,Staff,0,4,0,0
1683361562597,USP 124,A00,187562,Boomhower; Matthew Charles,1,0,30,29
1683361563622,USP 138,A00,187582,Staff,20,0,25,5
1683361564647,USP 152,A01,187597,Staff,4,0,25,21
1683361565671,USP 153,A00,187598,Staff,19,0,25,6
1683361566698,USP 168,A00,187607,Kwak; Nancy,2,0,5,3
1683361567726,USP 173,A00,187619,Staff,4,0,25,21
1683361568752,USP 181,A00,187638,Staff,0,3,25,25
1683361569780,VIS 103,A00,187650,Cruz; Edwin Teddy,22,0,75,53
1683361570810,VIS 110D,A00,187669,Staff,12,0,22,10
1683361571834,VIS 127C,A00,187720,Shen; Kuiyi,67,0,146,79
1683361572859,VIS 149,A00,187731,Yoldas; Pinar,0,14,22,22
1683361573884,VIS 151,A01,188091,Staff,22,0,34,12
1683361573884,VIS 151,A02,188092,Staff,11,0,34,23
1683361574910,VIS 160B,A00,188093,Stalbaum; Brett,0,0,10,10
1683361576962,WCWP 10B,A00,201720,Staff,10,0,15,5
1683361576962,WCWP 10B,B00,201722,Staff,9,0,15,6
1683361577989,WCWP 100,A00,201725,Gagnon; Jeffrey C,0,0,2,2
1683361577989,WCWP 100,B00,201727,Staff,0,4,15,15
1683361581138,ANBI 133,A00,258401,Wilder; Linnea Lorene,34,0,40,6
1683361582163,ANBI 140,A00,258395,Hrvoj Mihic; Branka,18,0,25,7
1683361583193,ANSC 120,A00,258402,Bialecki; Jon Anthony,27,0,40,13
1683361584221,ANSC 144,A00,258400,Staff,14,0,40,26
1683361586270,ANSC 166,A00,258396,Parish; Steven Martin,157,0,175,18
1683361587299,ANSC 180,A00,193533,Staff,9,0,20,11
1683361588327,ANSC 188,A00,258397,Jassal; Aftab,33,0,40,7
1683361589351,ANTH 3,A01,258316,Staff,23,0,30,7
1683361590379,ANTH 5,A00,258394,Semendeferi; Ekaterini,16,0,20,4
1683361591407,ANTH 21,A01,258331,Staff,8,0,40,32
1683361592430,ANTH 103,A00,258398,Varma; Saiba,15,0,25,10
1683361593463,AWP 10,001,202034,Staff,0,0,0,0
1683361593463,AWP 10,002,202035,Staff,0,0,0,0
1683361593463,AWP 10,003,202036,Staff,0,0,0,0
1683361593463,AWP 10,004,202037,Staff,0,0,0,0
1683361593463,AWP 10,005,202038,Staff,0,0,0,0
1683361593463,AWP 10,006,202039,Staff,0,0,0,0
1683361593463,AWP 10,007,202040,Staff,0,0,0,0
1683361593463,AWP 10,008,202041,Staff,0,0,0,0
1683361593463,AWP 10,009,202042,Staff,0,0,0,0
1683361593463,AWP 10,010,202043,Staff,0,0,0,0
1683361593463,AWP 10,011,202044,Staff,0,0,0,0
1683361593463,AWP 10,012,202045,Staff,0,0,0,0
1683361593463,AWP 10,013,202046,Staff,0,0,0,0
1683361593463,AWP 10,014,202047,Staff,0,0,0,0
1683361593463,AWP 10,015,202048,Staff,0,0,0,0
1683361593463,AWP 10,016,202049,Staff,0,0,0,0
1683361593463,AWP 10,017,202050,Staff,0,0,0,0
1683361593463,AWP 10,018,202051,Staff,0,0,0,0
1683361593463,AWP 10,019,202052,Staff,0,0,0,0
1683361593463,AWP 10,020,202053,Staff,0,0,0,0
1683361593463,AWP 10,021,202054,Staff,0,0,0,0
1683361593463,AWP 10,022,202055,Staff,0,0,0,0
1683361593463,AWP 10,023,202056,Staff,0,0,0,0
1683361593463,AWP 10,024,202057,Staff,0,0,0,0
1683361593463,AWP 10,025,202058,Staff,0,0,0,0
1683361593463,AWP 10,026,202059,Staff,0,0,0,0
1683361594546,AWP 102,001,202032,Staff,0,0,0,0
1683361594546,AWP 102,002,202033,Staff,0,0,0,0
1683361595575,BENG 100,A01,254234,Taylor Amos; Alyssa C,31,0,40,9
1683361596602,BENG 196,001,270013,Engler; Adam J.,9999,0,9999,0
1683361597629,BICD 100R,A01,202018,Smith; Laurie,0,7,32,32
1683361597629,BICD 100R,A02,202019,Smith; Laurie,0,2,32,32
1683361597629,BICD 100R,A03,202020,Smith; Laurie,0,1,32,32
1683361597629,BICD 100R,A04,202021,Smith; Laurie,9,0,32,23
1683361597629,BICD 100R,A05,202022,Smith; Laurie,12,0,32,20
1683361598659,BICD 136,A01,193242,Gustafson-Brown; Cindy,0,2,32,32
1683361598659,BICD 136,A02,193244,Gustafson-Brown; Cindy,14,0,32,18
1683361599694,BIEB 102,A01,193249,Butler; Shannon Rhey,0,2,32,32
1683361599694,BIEB 102,A02,193251,Butler; Shannon Rhey,0,0,32,32
1683361599694,BIEB 102,A03,193253,Butler; Shannon Rhey,0,1,32,32
1683361599694,BIEB 102,A04,193255,Butler; Shannon Rhey,17,0,32,15
1683361599694,BIEB 102,A05,193265,Butler; Shannon Rhey,26,0,32,6
1683361599694,BIEB 102,A06,193269,Butler; Shannon Rhey,16,0,32,16
1683361601743,BIEB 150,A01,193274,Staff,0,0,32,32
1683361601743,BIEB 150,A02,193285,Staff,23,0,32,9
1683361602769,BIEB 194,A00,193286,Kurle; Carolyn M.,22,0,32,10
1683361603795,BILD 1,A01,192291,Staff,16,0,32,16
1683361603795,BILD 1,A02,192292,Staff,30,0,32,2
1683361603795,BILD 1,B01,192520,Reuther; Keefe,0,1,0,0
1683361603795,BILD 1,B02,192532,Reuther; Keefe,0,1,0,0
1683361604819,BILD 3,A01,192556,Butler; Shannon Rhey,0,0,32,32
1683361604819,BILD 3,A02,192581,Butler; Shannon Rhey,4,0,32,28
1683361604819,BILD 3,A03,192611,Butler; Shannon Rhey,23,0,32,9
1683361604819,BILD 3,A04,192612,Butler; Shannon Rhey,25,0,32,7
1683361604819,BILD 3,A05,192613,Butler; Shannon Rhey,27,0,32,5
1683361604819,BILD 3,A06,192679,Butler; Shannon Rhey,27,0,32,5
1683361604819,BILD 3,A07,192682,Butler; Shannon Rhey,22,0,32,10
1683361605849,BILD 4,A01,192836,Reuther; Keefe,0,0,24,24
1683361605849,BILD 4,A02,193044,Reuther; Keefe,4,0,24,20
1683361606879,BILD 10,A01,193142,Gustafson-Brown; Cindy,30,0,32,2
1683361606879,BILD 10,A02,193149,Gustafson-Brown; Cindy,31,0,32,1
1683361607908,BIMM 100,A01,193301,Staff,1,6,32,31
1683361607908,BIMM 100,A02,193312,Staff,0,5,32,32
1683361607908,BIMM 100,A03,193323,Staff,0,8,32,32
1683361608935,BIMM 101,A01,193329,McDonnell; Lisa Marie,0,3,24,24
1683361608935,BIMM 101,A02,193339,McDonnell; Lisa Marie,0,3,24,24
1683361608935,BIMM 101,B01,193354,McDonnell; Lisa Marie,0,3,24,24
1683361608935,BIMM 101,B02,193357,McDonnell; Lisa Marie,0,3,24,24
1683361609967,BIMM 110,A01,193377,Tat; John,0,11,32,32
1683361609967,BIMM 110,A02,193378,Tat; John,0,9,32,32
1683361610994,BIMM 120,A01,206116,Staff,0,0,32,32
1683361610994,BIMM 120,A02,206117,Staff,8,0,32,24
1683361610994,BIMM 120,A03,206121,Staff,21,0,32,11
1683361612021,BIPN 100,A01,193393,Park; Ji Young,0,14,32,32
1683361612021,BIPN 100,A02,193402,Park; Ji Young,0,13,32,32
1683361612021,BIPN 100,A03,193413,Park; Ji Young,0,14,32,32
1683361612021,BIPN 100,A04,193414,Park; Ji Young,0,13,32,32
1683361613048,BIPN 102,A01,193429,Staff,0,0,32,32
1683361613048,BIPN 102,A02,193438,Staff,22,0,32,10
1683361614074,BIPN 106,A01,193450,Reyes Gonzalez; Catalina,0,2,40,40
1683361615101,BIPN 134,A01,193465,Cooke; James Edward,1,0,32,31
1683361615101,BIPN 134,A02,193474,Cooke; James Edward,25,0,32,7
1683361615101,BIPN 134,A03,193485,Cooke; James Edward,29,0,32,3
1683361615101,BIPN 134,A04,193486,Cooke; James Edward,21,0,32,11
1683361615101,BIPN 134,A05,193491,Cooke; James Edward,31,0,32,1
1683361615101,BIPN 134,A06,193501,Cooke; James Edward,30,0,32,2
1683361615101,BIPN 134,A07,193510,Cooke; James Edward,29,0,32,3
1683361617150,BISP 194,A00,222522,Staff,14,0,32,18
1683361618175,CAT 124,A01,202407,Staff,19,0,25,6
1683361619201,CAT 125,A00,202408,Marchisotto; Jennifer Anne,4,0,20,16
1683361620234,CAT 125R,A00,202409,Smith; Lauryn Alissa,0,11,20,20
1683361620234,CAT 125R,B00,202410,Morales; Celeste Georgianna,0,11,20,20
1683361620234,CAT 125R,C00,202411,Irwin; Matthew Joseph,0,10,20,20
1683361621274,CENG 15,A01,204712,Yang; Kesong,0,1,0,0
1683361622300,CENG 114,A00,202070,Jahed Motlagh; Zeinab,5,0,20,15
1683361623325,CGS 105,A00,185477,Wesling; Megan E.,24,0,40,16
1683361624353,CGS 106,A00,185494,Staff,13,0,22,9
1683361625381,CGS 108,A00,185495,Staff,14,0,20,6
1683361626406,CGS 114,A00,185496,Staff,13,0,18,5
1683361627429,CGS 119,A00,185501,Staff,15,0,20,5
1683361628459,CGS 120,A00,185511,Staff,13,0,20,7
1683361629485,CHEM 4,A01,184675,Bussey; Thomas J,96,0,100,4
1683361630511,CHEM 6A,A01,184677,Staff,34,0,60,26
1683361631535,CHEM 6B,A01,184679,Staff,65,0,100,35
1683361632562,CHEM 6C,A01,184681,Bussey; Thomas J,1,0,50,49
1683361632562,CHEM 6C,A02,184682,Bussey; Thomas J,34,0,50,16
1683361633587,CHEM 40A,A01,184684,Albizati; Kim F.,37,0,100,63
1683361634618,CHEM 40B,A01,184686,Albizati; Kim F.,0,20,100,100
1683361635646,CHEM 41B,A01,184690,Staff,52,0,100,48
1683361636672,COGS 3,A01,184715,Boyle; Mary E. T.,0,25,40,40
1683361637698,COGS 14B,A01,185172,Staff,0,15,38,38
1683361638726,COGS 18,A01,184736,Staff,16,0,80,64
1683361639751,COGS 100,A01,184932,Staff,0,5,73,73
1683361640779,COGS 101A,A01,184935,Staff,0,39,30,30
1683361641805,COGS 101B,A01,184944,Staff,0,2,30,30
1683361642833,COGS 101C,A01,184946,Staff,0,12,30,30
1683361643860,COGS 102A,A01,184951,Johnson; Christine M.,2,0,40,38
1683361644887,COGS 107B,A01,184953,Mooshagian; Eric Frederick,0,50,40,40
1683361645912,COGS 118B,A01,184959,Gupta; Anjum,0,48,40,40
1683361646936,COGS 153,A00,184961,Staff,0,15,30,30
1683361647966,COGS 177,A00,184962,Staff,0,20,30,30
1683361648995,COGS 187A,A01,184969,Boyle; Mary E. T.,0,17,40,40
1683361650024,COMM 10,A01,185174,Staff,0,5,25,25
1683361650024,COMM 10,A02,185189,Staff,0,5,25,25
1683361650024,COMM 10,A03,269821,Staff,0,0,0,0
1683361651052,COMM 100B,A01,185475,Staff,0,0,0,2
1683361651052,COMM 100B,A02,185476,Staff,13,0,25,12
1683361652078,COMM 100C,A01,185314,Staff,1,0,25,24
1683361652078,COMM 100C,A02,185327,Staff,19,0,25,6
1683361653103,COMM 110M,A00,185349,Staff,2,0,40,38
1683361654130,COMM 113T,A00,185352,Staff,24,0,40,16
1683361655155,COMM 114I,A00,185353,Staff,33,0,40,7
1683361656179,COMM 131,A00,185354,Staff,19,0,30,11
1683361657208,CSE 8A,A50,185358,Cao; Yingjun,0,46,10,10
1683361658234,CSE 8B,A01,185362,Staff,0,46,50,50
1683361659262,CSE 11,A01,185416,Cao; Yingjun,0,92,10,10
1683361660289,CSE 20,A01,185445,Briones; Jor-el Thomas Caparas,5,0,25,20
1683361661320,CSE 21,A01,185447,Staff,10,0,50,40
1683361662349,CSE 101,A01,185451,Staff,0,13,50,50
1683361662349,CSE 101,B01,185453,Jones; Miles E,0,11,50,50
1683361664406,CSE 141,A01,185458,Eldon; John,20,0,100,80
1683361665430,CSE 141L,A01,185461,Eldon; John,12,0,100,88
1683361666456,CSE 142,A01,185463,Staff,36,0,60,24
1683361666456,CSE 142,B01,201355,Staff,0,7,60,60
1683361667482,CSE 142L,A01,185470,Staff,36,0,60,24
1683361667482,CSE 142L,B01,201417,Staff,0,6,60,60
1683361668507,CSE 190,A00,201433,Staff,32,0,49,17
1683361669540,DOC 1,A01,259136,Strom; Megan C.,7,0,15,8
1683361669540,DOC 1,A02,259137,Strom; Megan C.,14,0,15,1
1683361669540,DOC 1,A03,259138,Strom; Megan C.,14,0,15,1
1683361669540,DOC 1,A04,259139,Strom; Megan C.,14,0,15,1
1683361670566,DOC 100D,A00,259140,Pass; Natalye Joann,16,0,25,9
1683361671597,DSGN 1,A01,184749,Rill; Bryan,0,25,30,30
1683361672625,DSGN 100,A01,185168,Staff,0,2,25,25
1683361673657,ECE 5,A01,185626,Morris; Karcher William,0,10,0,0
1683361674686,ECE 101,A01,185628,Staff,17,0,70,53
1683361675717,ECE 107,A01,185635,Baghdadchi; Saharnaz,0,0,20,20
1683361675717,ECE 107,A02,185638,Baghdadchi; Saharnaz,4,0,20,16
1683361676743,ECE 148,A01,185647,Silberman; Jack,0,0,16,16
1683361677770,ECON 1,A01,185537,Crane; Meredith Helen,54,0,70,16
1683361678796,ECON 3,A01,185549,Crane; Meredith Helen,32,0,70,38
1683361679821,ECON 4,A01,203354,Anderson; John Charles,0,4,10,10
1683361680846,ECON 100A,A01,185574,Staff,0,4,40,40
1683361681871,ECON 100B,A01,185576,Staff,0,12,50,50
1683361682897,ECON 100C,A01,185589,Newhouse; Herbert S,29,0,70,41
1683361683924,ECON 105,A00,185608,Vespa; Emanuel Ignacio,19,0,35,16
1683361684955,ECON 109,A01,185610,Shishkin; Denis,10,0,35,25
1683361685983,ECON 110A,A01,185612,Staff,11,0,40,29
1683361687012,ECON 120A,A01,185615,Staff,20,0,40,20
1683361688042,ECON 120C,A01,185617,Sun; Yixiao,0,21,70,70
1683361689110,ECON 144,A00,203346,Squires; Dale E,3,0,35,32
1683361690134,ECON 171,A01,203349,Newhouse; Herbert S,0,1,35,35
1683361691162,ECON 173A,A01,185621,Toda; Alexis Akira,21,0,35,14
1683361692190,EDS 25,A01,202413,Staff,0,1,0,0
1683361692190,EDS 25,A02,202414,Staff,0,1,0,0
1683361692190,EDS 25,A03,202415,Staff,0,0,0,0
1683361692190,EDS 25,A04,202416,Staff,0,1,0,0
1683361692190,EDS 25,A05,202439,Staff,0,0,0,0
1683361692190,EDS 25,A06,202440,Staff,0,0,0,0
1683361692190,EDS 25,B01,202631,Staff,0,0,0,0
1683361692190,EDS 25,B02,202632,Staff,0,0,0,0
1683361692190,EDS 25,B03,202639,Staff,0,0,0,0
1683361692190,EDS 25,B04,202640,Staff,0,0,0,0
1683361692190,EDS 25,B05,202643,Staff,0,0,0,0
1683361692190,EDS 25,B06,202644,Staff,0,0,0,0
1683361693214,EDS 38,A01,202659,Black; Alison Michelle,24,0,25,1
1683361694239,EDS 115,A00,202652,Staff,18,0,30,12
1683361695264,EDS 125,A00,202649,Staff,14,0,30,16
1683361696288,EDS 126,A01,203332,Staff,30,0,30,0
1683361697313,EDS 139,A00,202838,Staff,16,0,25,9
1683361698414,EDS 146,A01,202655,Staff,14,0,25,11
1683361699441,ENG 15,A00,185667,Staff,0,1,0,0
1683361699441,ENG 15,B00,185672,Staff,0,0,0,0
1683361699441,ENG 15,C00,185675,Staff,0,0,0,0
1683361699441,ENG 15,D00,185682,Staff,0,0,0,0
1683361699441,ENG 15,E00,185684,Staff,0,0,0,0
1683361700466,ETHN 103,A00,185710,Staff,0,4,35,35
1683361701495,ETHN 103A,A00,199228,Man; Simeon S,2,0,9,7
1683361702521,ETHN 109,A00,185711,Staff,18,0,35,17
1683361703554,ETHN 142,A00,185726,Staff,0,4,30,30
1683361704580,ETHN 163J,A00,199229,Man; Simeon S,5,0,8,3
1683361705609,ETHN 168,A00,185727,Staff,8,0,10,2
1683361706638,ETHN 182,A00,185728,Staff,0,0,35,35
1683361707663,ETHN 183,A00,185737,Staff,8,0,18,10
1683361708692,GLBH 111,A01,209361,Burgos; Jose L.,0,0,0,0
1683361710753,HIEU 104,A00,185792,Staff,16,0,20,4
1683361711782,HIEU 115,A00,185800,Staff,1,0,20,19
1683361712808,HIEU 128,A00,185801,Staff,0,7,20,20
1683361713834,HIEU 147,A00,185802,Staff,16,0,20,4
1683361714859,HIEU 154,A00,185823,Staff,12,0,20,8
1683361715884,HILA 102,A00,185826,Staff,13,0,20,7
1683361716911,HILD 2C,A01,185778,Staff,0,12,20,20
1683361717940,HILD 7B,A01,185780,Kwak; Nancy,0,15,32,32
1683361717940,HILD 7B,A02,185781,Kwak; Nancy,0,18,32,32
1683361718964,HILD 30,A01,185791,Staff,14,0,20,6
1683361719989,HISC 119,A00,185830,Golan; Tal,0,9,20,20
1683361721014,HITO 156GS,A00,185831,Patterson; Patrick H.,0,0,0,23
1683361722039,HIUS 103,A00,185832,Man; Simeon S,1,6,20,19
1683361723068,HIUS 117,A00,185836,Kwak; Nancy,2,0,20,18
1683361724093,HIUS 125,A00,185840,Man; Simeon S,0,0,23,23
1683361725121,HIUS 149,A00,185845,Staff,0,0,20,20
1683361726149,HUM 3,A01,185882,Zavodny; Tatiana Sophia,0,7,50,50
1683361726149,HUM 3,B01,185899,Caldwell; Michael Alan,0,18,50,50
1683361727174,HUM 3GS,A00,185900,Patterson; Patrick H.,0,0,0,23
1683361728209,HUM 4,A01,185938,Zroka; Amy Liane,31,0,50,19
1683361728209,HUM 4,B01,185956,Watkins; Eric,0,3,50,50
1683361728209,HUM 4,B02,202209,Watkins; Eric,0,2,50,50
1683361728209,HUM 4,B03,202210,Watkins; Eric,0,2,50,50
1683361729234,HUM 5,A01,185958,West; Geoffrey Scott,3,0,50,47
1683361729234,HUM 5,A02,202215,West; Geoffrey Scott,0,0,50,50
1683361730262,INTL 190,A00,185959,Gagnon; Jeffrey C,0,0,0,9
1683361730262,INTL 190,B00,185960,Lettieri; Michael Joseph,0,0,0,1
1683361731290,JAPN 180,A00,254509,Staff,4,0,30,26
1683361732317,LATI 10,A01,202853,Kennemore; Amy Michelle,4,0,35,31
1683361732317,LATI 10,A02,202854,Kennemore; Amy Michelle,2,0,35,33
1683361732317,LATI 10,A03,270054,Kennemore; Amy Michelle,30,0,30,0
1683361733343,LATI 180,A00,202855,Kennemore; Amy Michelle,11,0,20,9
1683361734369,LAWS 101,A00,201767,Golan; Tal,0,7,40,40
1683361735394,LIFR 1C,A00,185961,Staff,6,0,20,14
1683361736423,LIFR 1CX,A00,185962,Staff,7,0,20,13
1683361737451,LIFR 1D,A00,185963,Staff,9,0,20,11
1683361738480,LIFR 1DX,A00,185964,Staff,9,0,20,11
1683361739505,LIGN 101,A01,186039,Staff,43,0,50,7
1683361740530,LIGN 165,A00,186040,Staff,18,0,50,32
1683361741555,LTCS 108,A00,186041,Staff,6,0,10,4
1683361742580,LTCS 119,A00,186042,Staff,16,0,20,4
1683361743606,LTCS 130,A00,186043,Wesling; Megan E.,15,0,25,10
1683361745661,LTEA 138,A00,186119,Staff,14,0,40,26
1683361746690,LTEN 124,A00,186148,Staff,6,0,25,19
1683361747716,LTEN 178,A00,186149,Staff,7,0,15,8
1683361748747,LTEN 181,A00,186150,Blanco; John D,33,0,40,7
1683361749776,LTWL 120,A00,186160,Staff,20,0,25,5
1683361750801,LTWL 165,A00,186161,Staff,22,0,25,3
1683361751826,LTWR 100,A00,186162,Staff,0,5,15,15
1683361752853,LTWR 102,A00,186163,Doller; Ben,5,0,15,10
1683361753878,MAE 8,A01,186412,Staff,0,0,0,0
1683361754907,MAE 30B,A00,186445,Bahadori; Mohammad Yousef,83,0,100,17
1683361755935,MAE 40,A00,186592,Bewley; Thomas R,10,0,50,40
1683361756964,MAE 101B,A00,186593,Bahadori; Mohammad Yousef,81,0,100,19
1683361757993,MAE 105,A00,186594,Bandaru; Prabhakar,12,0,50,38
1683361759022,MAE 107,A00,186599,Pham; Hieu Tan,0,7,120,120
1683361760047,MAE 148,A01,186660,Silberman; Jack,3,0,16,13
1683361761078,MATH 10A,A01,188095,Staff,0,5,35,35
1683361762112,MATH 10B,A01,188097,Bowers; Adam R.,0,11,30,30
1683361762112,MATH 10B,A02,188099,Bowers; Adam R.,0,11,30,30
1683361762112,MATH 10B,B01,188104,Bowers; Adam R.,0,10,30,30
1683361762112,MATH 10B,B02,188106,Bowers; Adam R.,0,10,30,30
1683361763140,MATH 10C,A01,188111,Staff,0,18,30,30
1683361763140,MATH 10C,A02,188127,Staff,0,17,30,30
1683361763140,MATH 10C,A03,188131,Staff,0,18,30,30
1683361763140,MATH 10C,B01,188218,Staff,18,0,30,12
1683361763140,MATH 10C,B02,188244,Staff,13,0,30,17
1683361763140,MATH 10C,B03,188277,Staff,16,0,30,14
1683361764166,MATH 18,A01,188344,Bach; Quang Tran,18,0,30,12
1683361764166,MATH 18,A02,188345,Bach; Quang Tran,11,0,30,19
1683361764166,MATH 18,B01,188353,Bach; Quang Tran,10,0,30,20
1683361764166,MATH 18,B02,188354,Bach; Quang Tran,20,0,30,10
1683361765192,MATH 20A,A01,188374,Staff,12,0,35,23
1683361766224,MATH 20B,A01,188382,Ohm; Ko Woon,6,0,30,24
1683361766224,MATH 20B,A02,188383,Ohm; Ko Woon,21,0,30,9
1683361766224,MATH 20B,B01,188385,Ohm; Ko Woon,7,0,30,23
1683361766224,MATH 20B,B02,188392,Ohm; Ko Woon,22,0,30,8
1683361767251,MATH 20C,A01,188394,Harel; Guershon,10,0,30,20
1683361767251,MATH 20C,A02,188395,Harel; Guershon,15,0,30,15
1683361767251,MATH 20C,B01,188404,Harel; Guershon,4,0,30,26
1683361767251,MATH 20C,B02,188405,Harel; Guershon,19,0,30,11
1683361768275,MATH 20D,A01,188414,Hammock; Frances H,0,1,30,30
1683361768275,MATH 20D,A02,188415,Hammock; Frances H,3,0,30,27
1683361768275,MATH 20D,B01,188447,Hammock; Frances H,1,0,30,29
1683361768275,MATH 20D,B02,188486,Hammock; Frances H,8,0,30,22
1683361769300,MATH 20E,A01,188649,Staff,21,0,30,9
1683361769300,MATH 20E,A02,188650,Staff,23,0,30,7
1683361769300,MATH 20E,A03,188673,Staff,0,0,30,30
1683361770328,MATH 102,A01,188675,Staff,0,35,35,35
1683361771359,MATH 103B,A01,188681,Staff,3,0,35,32
1683361771359,MATH 103B,B01,188692,Staff,5,0,35,30
1683361772383,MATH 109,A01,188695,Salehi Golsefidy; Alireza,25,0,35,10
1683361772383,MATH 109,A02,188696,Salehi Golsefidy; Alireza,25,0,35,10
1683361773416,MATH 120A,A01,188698,Eggers; John Dietrich,7,0,35,28
1683361774446,MATH 142B,A01,188736,Ioana; Adrian,0,2,30,30
1683361774446,MATH 142B,A02,188741,Ioana; Adrian,0,0,30,30
1683361774446,MATH 142B,A03,188743,Ioana; Adrian,0,1,30,30
1683361775474,MATH 168A,A01,188790,Staff,0,9,35,35
1683361776505,MATH 170A,A01,188803,Nie; Jiawang,0,2,35,35
1683361776505,MATH 170A,A02,188811,Nie; Jiawang,0,0,35,35
1683361776505,MATH 170A,A03,188814,Nie; Jiawang,1,0,35,34
1683361776505,MATH 170A,A04,188815,Nie; Jiawang,13,0,35,22
1683361777531,MATH 193B,A01,188817,Staff,0,0,35,35
1683361777531,MATH 193B,A02,188818,Staff,5,0,35,30
1683361778557,MGT 4,A01,202857,Anderson; John Charles,61,0,80,19
1683361779585,MGT 12,A00,202858,Lindenberger; Wade Douglas,42,0,90,48
1683361780613,MGT 18,A00,202859,Staff,74,0,90,16
1683361781640,MGT 18GS,A00,202860,McKay; Michael J,13,0,28,15
1683361782668,MGT 45,A00,202861,Pecore; Joseph P.,15,0,90,75
1683361783730,MGT 100,A00,202863,Yavorsky; Daniel Ryan,28,0,90,62
1683361784757,MGT 103,A00,202864,Ehrich; Kristine R,0,17,90,90
1683361785781,MGT 112,A00,202865,Ehrich; Kristine R,15,0,90,75
1683361786810,MGT 121A,A00,202868,Staff,0,20,0,0
1683361787837,MGT 131B,A00,202869,Anderson; John Charles,59,0,90,31
1683361788862,MGT 136,A00,202871,Lindenberger; Wade Douglas,84,0,90,6
1683361789887,MGT 164,A00,202873,Staff,0,68,90,91
1683361790912,MGT 164GS,A00,202874,McKay; Mary A,13,0,28,15
1683361791938,MGT 180,A00,202875,Staff,0,50,90,91
1683361792964,MMW 11R,A01,205019,Herbst; Matthew,3,0,30,27
1683361792964,MMW 11R,A02,205026,Herbst; Matthew,29,0,30,1
1683361793990,MMW 15,A01,193512,Chang; Edmond Yi-Teh,0,9,28,28
1683361793990,MMW 15,A02,193513,Chang; Edmond Yi-Teh,0,5,28,28
1683361793990,MMW 15,A03,193514,Chang; Edmond Yi-Teh,0,5,28,28
1683361793990,MMW 15,A04,193515,Chang; Edmond Yi-Teh,0,5,28,28
1683361793990,MMW 15,A05,193516,Chang; Edmond Yi-Teh,0,4,28,28
1683361793990,MMW 15,A06,193517,Chang; Edmond Yi-Teh,0,5,28,28
1683361793990,MMW 15,B01,193519,Chang; Edmond Yi-Teh,0,5,28,28
1683361793990,MMW 15,B02,193520,Chang; Edmond Yi-Teh,0,5,28,28
1683361793990,MMW 15,B03,193521,Chang; Edmond Yi-Teh,0,5,28,28
1683361793990,MMW 15,B04,193522,Chang; Edmond Yi-Teh,0,4,28,28
1683361793990,MMW 15,B05,193523,Chang; Edmond Yi-Teh,0,5,28,28
1683361793990,MMW 15,B06,193524,Chang; Edmond Yi-Teh,0,4,28,28
1683361795017,MMW 122,A01,193526,Rahimi; Babak,0,15,28,28
1683361795017,MMW 122,A02,193527,Rahimi; Babak,0,14,28,28
1683361795017,MMW 122,A03,193528,Rahimi; Babak,0,0,0,0
1683361795017,MMW 122,A04,193529,Rahimi; Babak,0,0,0,0
1683361796041,MUS 1A,A01,186663,Staff,0,20,35,35
1683361797072,MUS 4,A01,186715,Staff,0,12,35,35
1683361798100,MUS 5R,A01,186796,Dubnov; Shlomo,0,17,35,35
1683361799127,MUS 6,A01,186798,Staff,0,4,25,25
1683361800152,MUS 7,A01,186830,Staff,13,0,35,22
1683361801177,MUS 8,A01,186930,Staff,0,26,35,35
1683361802267,MUS 15,A01,186932,Staff,0,16,35,35
1683361802267,MUS 15,B01,186934,Staff,0,15,35,35
1683361803295,MUS 80,A00,186935,Staff,0,0,20,20
1683361803295,MUS 80,B00,186936,Staff,25,0,25,0
1683361804320,NANO 11,A00,204702,Lipomi; Darren John,0,0,0,0
1683361805348,NANO 15,A01,204709,Yang; Kesong,0,1,0,0
1683361806376,NANO 114,A00,202069,Jahed Motlagh; Zeinab,3,0,10,7
1683361807408,PHIL 1,A00,186955,Grush; Rick Scott,32,0,40,8
1683361808435,PHIL 10,A01,186973,Grush; Rick Scott,28,0,35,7
1683361808435,PHIL 10,A02,186974,Grush; Rick Scott,33,0,35,2
1683361809463,PHIL 13,A01,186976,Staff,7,0,35,28
1683361809463,PHIL 13,A02,186977,Staff,16,0,35,19
1683361810491,PHIL 14,A01,186979,Staff,31,0,35,4
1683361810491,PHIL 14,A02,186986,Staff,32,0,35,3
1683361811521,PHIL 28,A01,186988,Staff,16,0,30,14
1683361811521,PHIL 28,A02,186989,Staff,1,0,30,29
1683361811521,PHIL 28,A03,186990,Staff,9,0,30,21
1683361811521,PHIL 28,A04,186991,Staff,26,0,30,4
1683361812548,PHIL 120,A00,186997,Staff,23,0,40,17
1683361813572,PHIL 137,A00,187003,Staff,9,0,40,31
1683361814597,PHIL 150,A00,187015,Staff,47,0,70,23
1683361815627,PHIL 167,A00,187021,Lamey; Andy M.,35,0,40,5
1683361816657,PHIL 174,A01,202226,Staff,17,0,20,3
1683361816657,PHIL 174,A02,202235,Staff,20,0,20,0
1683361817686,PHIL 191A,A00,258918,Staff,0,0,1,1
1683361818717,PHYS 1A,A00,187028,Staff,27,0,60,33
1683361819743,PHYS 1AL,001,187036,Staff,2,0,30,28
1683361819743,PHYS 1AL,002,187049,Staff,18,0,30,12
1683361820770,PHYS 1B,A00,187058,Staff,22,0,60,38
1683361821800,PHYS 1BL,001,187064,Staff,0,0,30,30
1683361821800,PHYS 1BL,002,187070,Staff,5,0,30,25
1683361822826,PHYS 1C,A00,187082,Staff,31,0,120,89
1683361823853,PHYS 1CL,001,187088,Staff,0,9,30,30
1683361823853,PHYS 1CL,002,187089,Staff,0,2,30,30
1683361823853,PHYS 1CL,009,262693,Staff,11,0,30,19
1683361824882,PHYS 2B,A01,187097,Staff,54,0,115,61
1683361825911,PHYS 2C,A01,187099,Staff,67,0,115,48
1683361826944,PHYS 2CL,A01,187101,Staff,5,0,28,23
1683361826944,PHYS 2CL,A02,187102,Staff,15,0,28,13
1683361827969,PHYS 2D,A01,187123,Shotwell; Brian,95,0,115,20
1683361828994,PHYS 4B,A01,187133,Grinstein; Benjamin,35,0,50,15
1683361830019,POLI 10,A00,188819,Staff,0,4,50,50
1683361831047,POLI 11,A00,188827,Staff,43,0,50,7
1683361832074,POLI 13R,A00,188828,Staff,0,1,20,20
1683361833105,POLI 27,A01,188830,Elgin; Samuel Zincke,0,1,70,70
1683361834131,POLI 30,A00,188832,Desposato; Scott,31,0,50,19
1683361835174,POLI 102F,A00,188834,Staff,3,0,40,37
1683361836203,POLI 104A,A00,188852,Staff,14,0,30,16
1683361837232,POLI 104I,A00,188853,Staff,0,6,20,20
1683361838261,POLI 110B,A00,188854,Wiens; David,7,0,20,13
1683361839288,POLI 112A,A00,188855,Wiens; David,5,0,30,25
1683361840312,POLI 117R,A00,188856,Forman; Fonna,0,11,20,20
1683361841340,POLI 118,A00,188857,Ingham; Sean,8,0,20,12
1683361842367,POLI 120G,A00,188858,Staff,9,0,30,21
1683361843392,POLI 131CR,A00,188863,Hoston; Germaine,23,0,50,27
1683361844418,POLI 133,A00,188864,Nellis; Gareth Hb,44,0,50,6
1683361845443,POLI 134D,A00,188865,Desposato; Scott,27,0,30,3
1683361846470,POLI 142A,A00,188871,Gartzke; Erik,22,0,50,28
1683361847495,POLI 142K,A00,188874,Staff,38,0,50,12
1683361848524,POLI 143,A00,188940,Gartzke; Erik,16,0,30,14
1683361849550,POLI 153,A00,188943,Staff,3,0,20,17
1683361850574,POLI 160AA,A00,188944,Staff,11,0,40,29
1683361851601,POLI 170A,A00,188945,Staff,11,0,30,19
1683361853655,PSYC 1,A00,188952,Staff,37,0,90,53
1683361854682,PSYC 2,B00,188953,Staff,19,0,35,16
1683361855705,PSYC 6,A00,188970,Staff,47,0,60,13
1683361856730,PSYC 7,A00,188973,Staff,37,0,45,8
1683361857756,PSYC 60,A01,188980,Rickard; Timothy C.,43,0,60,17
1683361858783,PSYC 70,A01,189001,Steiner; Eric Tomas,23,0,45,22
1683361859808,PSYC 100,A00,189005,Lacefield; Katharine I,0,98,120,120
1683361860831,PSYC 102,A00,189008,Staff,9,0,30,21
1683361861857,PSYC 106,B00,189026,Gorman; Michael R.,34,0,60,26
1683361862887,PSYC 114,B01,189033,Winkielman; Piotr,0,32,30,30
1683361863918,PSYC 131,A00,189036,Anagnostaras; Stephan,0,43,60,60
1683361864944,PSYC 136,A00,189041,Lowe; Angela Beth,0,7,25,25
1683361865973,PSYC 137,A00,189057,Winkielman; Piotr,0,34,25,25
1683361867010,PSYC 144,A00,189107,Wixted; John T,0,7,50,50
1683361869065,PSYC 162,A00,189142,Staff,0,8,85,85
1683361870094,PSYC 172,A00,189144,Gorman; Michael R.,0,7,30,30
1683361872144,PSYC 179,A00,189146,Lacefield; Katharine I,0,84,120,120
1683361873170,PSYC 181,A00,189147,Anagnostaras; Stephan,0,44,90,90
1683361874201,PSYC 190R,A00,189148,Barner; David A.,0,22,80,80
1683361875227,PSYC 191,A00,189275,Rickard; Timothy C.,0,7,25,25
1683361876250,PSYC 193,A00,189276,Chapman; Eddie Nathaniel,0,1,0,4
1683361877275,PSYC 193L,A01,189281,Lowe; Angela Beth,12,0,20,8
1683361877275,PSYC 193L,B01,189285,Staff,28,0,35,7
1683361878301,RELI 149,A00,187137,Rahimi; Babak,7,0,40,33
1683361879332,SE 9,A01,187315,Staff,0,2,18,18
1683361880357,SE 101B,A00,187409,Staff,24,0,30,6
1683361881383,SE 110B,A00,187444,Staff,10,0,40,30
1683361882408,SE 130B,A00,187449,Staff,31,0,40,9
1683361883432,SE 150A,A00,187516,Staff,9,0,20,11
1683361884457,SE 154,A00,187528,Staff,30,0,50,20
1683361885483,SIO 3,A01,258171,Staff,35,0,40,5
1683361886509,SIO 10,A00,187144,Cook; Geoffrey W,0,3,75,75
1683361887536,SIO 45,A00,187152,Cook; Geoffrey W,1,0,100,99
1683361888562,SIO 109R,A00,194486,Staff,0,3,20,20
1683361890620,SIO 187,A01,187233,Kacev; David,12,0,40,28
1683361891650,SOCI 1,A01,258656,Thorpe; Charles Robert,28,0,30,2
1683361891650,SOCI 1,A02,258658,Thorpe; Charles Robert,30,0,30,0
1683361891650,SOCI 1,A03,258661,Thorpe; Charles Robert,25,0,25,0
1683361891650,SOCI 1,A04,258666,Thorpe; Charles Robert,22,0,25,3
1683361891650,SOCI 1,A05,258897,Thorpe; Charles Robert,23,0,25,2
1683361891650,SOCI 1,A06,258898,Thorpe; Charles Robert,25,0,25,0
1683361892675,SOCI 30,A01,258903,Pardo Guerra; Juan Pablo,15,0,30,15
1683361893701,SOCI 102,A00,258904,Staff,9,0,25,16
1683361894725,SOCI 106,A00,258905,Staff,19,0,25,6
1683361895751,SOCI 111,A00,258907,Ribas Norris; Janet Vanesa,26,0,30,4
1683361896778,SOCI 121R,A00,258908,Pardo Guerra; Juan Pablo,10,0,30,20
1683361897804,SOCI 126,A01,203330,Staff,14,0,20,6
1683361898832,SOCI 131,A00,258909,Thorpe; Charles Robert,31,0,60,29
1683361899858,SOCI 135,A00,258910,Payne; Christine Anna,0,9,30,30
1683361900881,SOCI 157,A00,258911,Staff,12,0,30,18
1683361901907,SOCI 184,A00,258912,Staff,25,0,30,5
1683361902931,SOCI 188D,A00,258913,Staff,22,0,30,8
1683361903960,SYN 2,001,187529,Staff,10,0,16,6
1683361903960,SYN 2,002,201452,Staff,0,18,16,16
1683361903960,SYN 2,003,201469,Staff,3,0,16,13
1683361904989,SYN 100,A01,187531,Staff,0,9,20,20
1683361904989,SYN 100,B01,201491,Staff,0,12,20,20
1683361906071,TDAC 1,A00,189286,Walsh; Kim C.,3,0,20,17
1683361906071,TDAC 1,B00,189287,Harting; Carla Kelso,11,0,20,9
1683361907100,TDAC 101,A00,189300,Walsh; Kim C.,16,0,20,4
1683361907100,TDAC 101,B00,189301,Harting; Carla Kelso,18,0,20,2
1683361908126,TDAC 102,A00,189304,Basso; Beatrice,14,0,20,6
1683361909149,TDAC 108,A00,189305,Staff,18,0,20,2
1683361910180,TDDE 131,A00,189310,Staff,19,0,20,1
1683361910180,TDDE 131,B00,189314,Staff,19,0,20,1
1683361910180,TDDE 131,C00,189315,Staff,48,0,50,2
1683361910180,TDDE 131,D00,189316,Staff,14,0,15,1
1683361910180,TDDE 131,E00,204841,Staff,20,0,20,0
1683361911212,TDGE 10,A00,189289,Staff,30,0,50,20
1683361911212,TDGE 10,B00,189290,Havis; Allan,1,0,50,49
1683361912246,TDGE 11,A00,189291,Fulton; Julia,0,3,50,50
1683361912246,TDGE 11,B00,189292,Staff,20,0,25,5
1683361912246,TDGE 11,C00,260270,Staff,0,0,0,0
1683361913279,TDGE 25,A00,189294,Staff,3,0,20,17
1683361914308,TDGE 124,A00,189318,Fulton; Julia,0,8,50,50
1683361915336,TDGE 125,A00,189319,Staff,13,0,25,12
1683361915336,TDGE 125,B00,189320,Staff,23,0,25,2
1683361916362,TDGE 127,A00,189322,Havis; Allan,0,0,50,50
1683361917390,TDHT 101,A00,189323,Staff,18,0,25,7
1683361917390,TDHT 101,B00,189324,Staff,25,0,25,0
1683361918419,TDHT 102,A00,189325,Staff,49,0,50,1
1683361919446,TDMV 1,A00,189295,Arcidiacono; Kristin,19,0,30,11
1683361919446,TDMV 1,B00,189296,Caligagan; Maria T.,24,0,30,6
1683361920477,TDMV 2,A00,189297,Sammartano; Tonnie,28,0,30,2
1683361920477,TDMV 2,B00,189299,Arcidiacono; Kristin,24,0,30,6
1683361921508,TDMV 3,A00,204998,Rincon; Alicia,22,0,30,8
1683361922534,TDMV 120,A00,189458,Sammartano; Tonnie,28,0,30,2
1683361923563,TDMV 138,A00,189541,Jun; Grace Shin Hae,22,0,40,18
1683361924593,TDMV 142,A00,189717,Caligagan; Tony,24,0,30,6
1683361924593,TDMV 142,B00,189718,Caligagan; Maria T.,25,0,30,5
1683361925623,TMC 2,A01,187533,Staff,25,0,25,0
1683361925623,TMC 2,A02,187534,Staff,25,0,25,0
1683361926649,USP 1,A01,187536,Kwak; Nancy,0,16,25,25
1683361927679,USP 5,A01,187538,Staff,10,0,25,15
1683361928708,USP 101,A00,199253,Staff,0,4,0,0
1683361929733,USP 124,A00,187562,Boomhower; Matthew Charles,1,0,30,29
1683361930767,USP 138,A00,187582,Staff,20,0,25,5
1683361931793,USP 152,A01,187597,Staff,4,0,25,21
1683361932818,USP 153,A00,187598,Staff,19,0,25,6
1683361933846,USP 168,A00,187607,Kwak; Nancy,2,0,5,3
1683361934871,USP 173,A00,187619,Staff,4,0,25,21
1683361935896,USP 181,A00,187638,Staff,0,3,25,25
1683361936927,VIS 103,A00,187650,Cruz; Edwin Teddy,22,0,75,53
1683361937955,VIS 110D,A00,187669,Staff,12,0,22,10
1683361938986,VIS 127C,A00,187720,Shen; Kuiyi,67,0,146,79
1683361940012,VIS 149,A00,187731,Yoldas; Pinar,0,14,22,22
1683361941038,VIS 151,A01,188091,Staff,22,0,34,12
1683361941038,VIS 151,A02,188092,Staff,11,0,34,23
1683361942062,VIS 160B,A00,188093,Stalbaum; Brett,0,0,10,10
1683361944110,WCWP 10B,A00,201720,Staff,10,0,15,5
1683361944110,WCWP 10B,B00,201722,Staff,9,0,15,6
1683361945142,WCWP 100,A00,201725,Gagnon; Jeffrey C,0,0,2,2
1683361945142,WCWP 100,B00,201727,Staff,0,4,15,15
1683361948263,ANBI 133,A00,258401,Wilder; Linnea Lorene,34,0,40,6
1683361949288,ANBI 140,A00,258395,Hrvoj Mihic; Branka,18,0,25,7
1683361950318,ANSC 120,A00,258402,Bialecki; Jon Anthony,27,0,40,13
1683361951347,ANSC 144,A00,258400,Staff,14,0,40,26
1683361953402,ANSC 166,A00,258396,Parish; Steven Martin,157,0,175,18
1683361954430,ANSC 180,A00,193533,Staff,9,0,20,11
1683361955456,ANSC 188,A00,258397,Jassal; Aftab,33,0,40,7
1683361956489,ANTH 3,A01,258316,Staff,23,0,30,7
1683361957526,ANTH 5,A00,258394,Semendeferi; Ekaterini,16,0,20,4
1683361958551,ANTH 21,A01,258331,Staff,8,0,40,32
1683361959576,ANTH 103,A00,258398,Varma; Saiba,15,0,25,10
1683361960613,AWP 10,001,202034,Staff,0,0,0,0
1683361960613,AWP 10,002,202035,Staff,0,0,0,0
1683361960613,AWP 10,003,202036,Staff,0,0,0,0
1683361960613,AWP 10,004,202037,Staff,0,0,0,0
1683361960613,AWP 10,005,202038,Staff,0,0,0,0
1683361960613,AWP 10,006,202039,Staff,0,0,0,0
1683361960613,AWP 10,007,202040,Staff,0,0,0,0
1683361960613,AWP 10,008,202041,Staff,0,0,0,0
1683361960613,AWP 10,009,202042,Staff,0,0,0,0
1683361960613,AWP 10,010,202043,Staff,0,0,0,0
1683361960613,AWP 10,011,202044,Staff,0,0,0,0
1683361960613,AWP 10,012,202045,Staff,0,0,0,0
1683361960613,AWP 10,013,202046,Staff,0,0,0,0
1683361960613,AWP 10,014,202047,Staff,0,0,0,0
1683361960613,AWP 10,015,202048,Staff,0,0,0,0
1683361960613,AWP 10,016,202049,Staff,0,0,0,0
1683361960613,AWP 10,017,202050,Staff,0,0,0,0
1683361960613,AWP 10,018,202051,Staff,0,0,0,0
1683361960613,AWP 10,019,202052,Staff,0,0,0,0
1683361960613,AWP 10,020,202053,Staff,0,0,0,0
1683361960613,AWP 10,021,202054,Staff,0,0,0,0
1683361960613,AWP 10,022,202055,Staff,0,0,0,0
1683361960613,AWP 10,023,202056,Staff,0,0,0,0
1683361960613,AWP 10,024,202057,Staff,0,0,0,0
1683361960613,AWP 10,025,202058,Staff,0,0,0,0
1683361960613,AWP 10,026,202059,Staff,0,0,0,0
1683361961638,AWP 102,001,202032,Staff,0,0,0,0
1683361961638,AWP 102,002,202033,Staff,0,0,0,0
1683361962665,BENG 100,A01,254234,Taylor Amos; Alyssa C,31,0,40,9
1683361963695,BENG 196,001,270013,Engler; Adam J.,9999,0,9999,0
1683361964729,BICD 100R,A01,202018,Smith; Laurie,0,7,32,32
1683361964729,BICD 100R,A02,202019,Smith; Laurie,0,2,32,32
1683361964729,BICD 100R,A03,202020,Smith; Laurie,0,1,32,32
1683361964729,BICD 100R,A04,202021,Smith; Laurie,9,0,32,23
1683361964729,BICD 100R,A05,202022,Smith; Laurie,12,0,32,20
1683361965754,BICD 136,A01,193242,Gustafson-Brown; Cindy,0,2,32,32
1683361965754,BICD 136,A02,193244,Gustafson-Brown; Cindy,14,0,32,18
1683361966782,BIEB 102,A01,193249,Butler; Shannon Rhey,0,2,32,32
1683361966782,BIEB 102,A02,193251,Butler; Shannon Rhey,0,0,32,32
1683361966782,BIEB 102,A03,193253,Butler; Shannon Rhey,0,1,32,32
1683361966782,BIEB 102,A04,193255,Butler; Shannon Rhey,17,0,32,15
1683361966782,BIEB 102,A05,193265,Butler; Shannon Rhey,26,0,32,6
1683361966782,BIEB 102,A06,193269,Butler; Shannon Rhey,16,0,32,16
1683361968931,BIEB 150,A01,193274,Staff,0,0,32,32
1683361968931,BIEB 150,A02,193285,Staff,23,0,32,9
1683361969957,BIEB 194,A00,193286,Kurle; Carolyn M.,22,0,32,10
1683361970982,BILD 1,A01,192291,Staff,16,0,32,16
1683361970982,BILD 1,A02,192292,Staff,30,0,32,2
1683361970982,BILD 1,B01,192520,Reuther; Keefe,0,1,0,0
1683361970982,BILD 1,B02,192532,Reuther; Keefe,0,1,0,0
1683361972009,BILD 3,A01,192556,Butler; Shannon Rhey,0,0,32,32
1683361972009,BILD 3,A02,192581,Butler; Shannon Rhey,4,0,32,28
1683361972009,BILD 3,A03,192611,Butler; Shannon Rhey,23,0,32,9
1683361972009,BILD 3,A04,192612,Butler; Shannon Rhey,25,0,32,7
1683361972009,BILD 3,A05,192613,Butler; Shannon Rhey,27,0,32,5
1683361972009,BILD 3,A06,192679,Butler; Shannon Rhey,27,0,32,5
1683361972009,BILD 3,A07,192682,Butler; Shannon Rhey,21,0,32,11
1683361973036,BILD 4,A01,192836,Reuther; Keefe,0,0,24,24
1683361973036,BILD 4,A02,193044,Reuther; Keefe,4,0,24,20
1683361974067,BILD 10,A01,193142,Gustafson-Brown; Cindy,30,0,32,2
1683361974067,BILD 10,A02,193149,Gustafson-Brown; Cindy,31,0,32,1
1683361975094,BIMM 100,A01,193301,Staff,1,6,32,31
1683361975094,BIMM 100,A02,193312,Staff,0,5,32,32
1683361975094,BIMM 100,A03,193323,Staff,0,8,32,32
1683361976121,BIMM 101,A01,193329,McDonnell; Lisa Marie,0,3,24,24
1683361976121,BIMM 101,A02,193339,McDonnell; Lisa Marie,0,3,24,24
1683361976121,BIMM 101,B01,193354,McDonnell; Lisa Marie,0,3,24,24
1683361976121,BIMM 101,B02,193357,McDonnell; Lisa Marie,0,3,24,24
1683361977147,BIMM 110,A01,193377,Tat; John,0,11,32,32
1683361977147,BIMM 110,A02,193378,Tat; John,0,9,32,32
1683361978180,BIMM 120,A01,206116,Staff,0,0,32,32
1683361978180,BIMM 120,A02,206117,Staff,8,0,32,24
1683361978180,BIMM 120,A03,206121,Staff,21,0,32,11
1683361979210,BIPN 100,A01,193393,Park; Ji Young,0,14,32,32
1683361979210,BIPN 100,A02,193402,Park; Ji Young,0,13,32,32
1683361979210,BIPN 100,A03,193413,Park; Ji Young,0,14,32,32
1683361979210,BIPN 100,A04,193414,Park; Ji Young,0,13,32,32
1683361980238,BIPN 102,A01,193429,Staff,0,0,32,32
1683361980238,BIPN 102,A02,193438,Staff,22,0,32,10
1683361981276,BIPN 106,A01,193450,Reyes Gonzalez; Catalina,0,2,40,40
1683361982302,BIPN 134,A01,193465,Cooke; James Edward,1,0,32,31
1683361982302,BIPN 134,A02,193474,Cooke; James Edward,25,0,32,7
1683361982302,BIPN 134,A03,193485,Cooke; James Edward,29,0,32,3
1683361982302,BIPN 134,A04,193486,Cooke; James Edward,21,0,32,11
1683361982302,BIPN 134,A05,193491,Cooke; James Edward,31,0,32,1
1683361982302,BIPN 134,A06,193501,Cooke; James Edward,30,0,32,2
1683361982302,BIPN 134,A07,193510,Cooke; James Edward,29,0,32,3
1683361984366,BISP 194,A00,222522,Staff,14,0,32,18
1683361985395,CAT 124,A01,202407,Staff,19,0,25,6
1683361986419,CAT 125,A00,202408,Marchisotto; Jennifer Anne,4,0,20,16
1683361987446,CAT 125R,A00,202409,Smith; Lauryn Alissa,0,11,20,20
1683361987446,CAT 125R,B00,202410,Morales; Celeste Georgianna,0,11,20,20
1683361987446,CAT 125R,C00,202411,Irwin; Matthew Joseph,0,10,20,20
1683361988478,CENG 15,A01,204712,Yang; Kesong,0,1,0,0
1683361989505,CENG 114,A00,202070,Jahed Motlagh; Zeinab,5,0,20,15
1683361990531,CGS 105,A00,185477,Wesling; Megan E.,24,0,40,16
1683361991557,CGS 106,A00,185494,Staff,13,0,22,9
1683361992583,CGS 108,A00,185495,Staff,14,0,20,6
1683361993609,CGS 114,A00,185496,Staff,13,0,18,5
1683361994639,CGS 119,A00,185501,Staff,15,0,20,5
1683361995668,CGS 120,A00,185511,Staff,13,0,20,7
1683361996701,CHEM 4,A01,184675,Bussey; Thomas J,96,0,100,4
1683361997731,CHEM 6A,A01,184677,Staff,34,0,60,26
1683361998755,CHEM 6B,A01,184679,Staff,65,0,100,35
1683361999781,CHEM 6C,A01,184681,Bussey; Thomas J,1,0,50,49
1683361999781,CHEM 6C,A02,184682,Bussey; Thomas J,34,0,50,16
1683362000808,CHEM 40A,A01,184684,Albizati; Kim F.,37,0,100,63
1683362001835,CHEM 40B,A01,184686,Albizati; Kim F.,0,20,100,100
1683362002862,CHEM 41B,A01,184690,Staff,52,0,100,48
1683362003893,COGS 3,A01,184715,Boyle; Mary E. T.,0,25,40,40
1683362004924,COGS 14B,A01,185172,Staff,0,15,38,38
1683362005950,COGS 18,A01,184736,Staff,16,0,80,64
1683362006975,COGS 100,A01,184932,Staff,0,5,73,73
1683362008000,COGS 101A,A01,184935,Staff,0,39,30,30
1683362009025,COGS 101B,A01,184944,Staff,0,2,30,30
1683362010107,COGS 101C,A01,184946,Staff,0,12,30,30
1683362011135,COGS 102A,A01,184951,Johnson; Christine M.,2,0,40,38
1683362012161,COGS 107B,A01,184953,Mooshagian; Eric Frederick,0,50,40,40
1683362013187,COGS 118B,A01,184959,Gupta; Anjum,0,48,40,40
1683362014215,COGS 153,A00,184961,Staff,0,15,30,30
1683362015244,COGS 177,A00,184962,Staff,0,20,30,30
1683362016273,COGS 187A,A01,184969,Boyle; Mary E. T.,0,17,40,40
1683362017300,COMM 10,A01,185174,Staff,0,5,25,25
1683362017300,COMM 10,A02,185189,Staff,0,5,25,25
1683362017300,COMM 10,A03,269821,Staff,0,0,0,0
1683362018324,COMM 100B,A01,185475,Staff,0,0,0,2
1683362018324,COMM 100B,A02,185476,Staff,13,0,25,12
1683362019355,COMM 100C,A01,185314,Staff,1,0,25,24
1683362019355,COMM 100C,A02,185327,Staff,19,0,25,6
1683362020384,COMM 110M,A00,185349,Staff,2,0,40,38
1683362021408,COMM 113T,A00,185352,Staff,24,0,40,16
1683362022432,COMM 114I,A00,185353,Staff,33,0,40,7
1683362023457,COMM 131,A00,185354,Staff,19,0,30,11
1683362024486,CSE 8A,A50,185358,Cao; Yingjun,0,46,10,10
1683362025513,CSE 8B,A01,185362,Staff,0,46,50,50
1683362026538,CSE 11,A01,185416,Cao; Yingjun,0,92,10,10
1683362027569,CSE 20,A01,185445,Briones; Jor-el Thomas Caparas,5,0,25,20
1683362028597,CSE 21,A01,185447,Staff,10,0,50,40
1683362029628,CSE 101,A01,185451,Staff,0,13,50,50
1683362029628,CSE 101,B01,185453,Jones; Miles E,0,11,50,50
1683362031687,CSE 141,A01,185458,Eldon; John,20,0,100,80
1683362032714,CSE 141L,A01,185461,Eldon; John,12,0,100,88
1683362033744,CSE 142,A01,185463,Staff,36,0,60,24
1683362033744,CSE 142,B01,201355,Staff,0,7,60,60
1683362034773,CSE 142L,A01,185470,Staff,36,0,60,24
1683362034773,CSE 142L,B01,201417,Staff,0,6,60,60
1683362035801,CSE 190,A00,201433,Staff,32,0,49,17
1683362036864,DOC 1,A01,259136,Strom; Megan C.,7,0,15,8
1683362036864,DOC 1,A02,259137,Strom; Megan C.,14,0,15,1
1683362036864,DOC 1,A03,259138,Strom; Megan C.,14,0,15,1
1683362036864,DOC 1,A04,259139,Strom; Megan C.,14,0,15,1
1683362037893,DOC 100D,A00,259140,Pass; Natalye Joann,16,0,25,9
1683362038934,DSGN 1,A01,184749,Rill; Bryan,0,25,30,30
1683362039958,DSGN 100,A01,185168,Staff,0,2,25,25
1683362040983,ECE 5,A01,185626,Morris; Karcher William,0,10,0,0
1683362042010,ECE 101,A01,185628,Staff,17,0,70,53
1683362043035,ECE 107,A01,185635,Baghdadchi; Saharnaz,0,0,20,20
1683362043035,ECE 107,A02,185638,Baghdadchi; Saharnaz,4,0,20,16
1683362044062,ECE 148,A01,185647,Silberman; Jack,0,0,16,16
1683362045093,ECON 1,A01,185537,Crane; Meredith Helen,54,0,70,16
1683362046122,ECON 3,A01,185549,Crane; Meredith Helen,32,0,70,38
1683362047151,ECON 4,A01,203354,Anderson; John Charles,0,4,10,10
1683362048177,ECON 100A,A01,185574,Staff,0,4,40,40
1683362049203,ECON 100B,A01,185576,Staff,0,12,50,50
1683362050228,ECON 100C,A01,185589,Newhouse; Herbert S,29,0,70,41
1683362051256,ECON 105,A00,185608,Vespa; Emanuel Ignacio,19,0,35,16
1683362052281,ECON 109,A01,185610,Shishkin; Denis,10,0,35,25
1683362053303,ECON 110A,A01,185612,Staff,11,0,40,29
1683362054330,ECON 120A,A01,185615,Staff,20,0,40,20
1683362055355,ECON 120C,A01,185617,Sun; Yixiao,0,21,70,70
1683362056379,ECON 144,A00,203346,Squires; Dale E,3,0,35,32
1683362057403,ECON 171,A01,203349,Newhouse; Herbert S,0,1,35,35
1683362058452,ECON 173A,A01,185621,Toda; Alexis Akira,21,0,35,14
1683362059481,EDS 25,A01,202413,Staff,0,1,0,0
1683362059481,EDS 25,A02,202414,Staff,0,1,0,0
1683362059481,EDS 25,A03,202415,Staff,0,0,0,0
1683362059481,EDS 25,A04,202416,Staff,0,1,0,0
1683362059481,EDS 25,A05,202439,Staff,0,0,0,0
1683362059481,EDS 25,A06,202440,Staff,0,0,0,0
1683362059481,EDS 25,B01,202631,Staff,0,0,0,0
1683362059481,EDS 25,B02,202632,Staff,0,0,0,0
1683362059481,EDS 25,B03,202639,Staff,0,0,0,0
1683362059481,EDS 25,B04,202640,Staff,0,0,0,0
1683362059481,EDS 25,B05,202643,Staff,0,0,0,0
1683362059481,EDS 25,B06,202644,Staff,0,0,0,0
1683362060513,EDS 38,A01,202659,Black; Alison Michelle,24,0,25,1
1683362061537,EDS 115,A00,202652,Staff,18,0,30,12
1683362062566,EDS 125,A00,202649,Staff,14,0,30,16
1683362063596,EDS 126,A01,203332,Staff,30,0,30,0
1683362064623,EDS 139,A00,202838,Staff,16,0,25,9
1683362065652,EDS 146,A01,202655,Staff,14,0,25,11
1683362066678,ENG 15,A00,185667,Staff,0,1,0,0
1683362066678,ENG 15,B00,185672,Staff,0,0,0,0
1683362066678,ENG 15,C00,185675,Staff,0,0,0,0
1683362066678,ENG 15,D00,185682,Staff,0,0,0,0
1683362066678,ENG 15,E00,185684,Staff,0,0,0,0
1683362067704,ETHN 103,A00,185710,Staff,0,4,35,35
1683362068734,ETHN 103A,A00,199228,Man; Simeon S,2,0,9,7
1683362069759,ETHN 109,A00,185711,Staff,18,0,35,17
1683362070784,ETHN 142,A00,185726,Staff,0,4,30,30
1683362071809,ETHN 163J,A00,199229,Man; Simeon S,5,0,8,3
1683362072832,ETHN 168,A00,185727,Staff,8,0,10,2
1683362073856,ETHN 182,A00,185728,Staff,0,0,35,35
1683362074880,ETHN 183,A00,185737,Staff,8,0,18,10
1683362075905,GLBH 111,A01,209361,Burgos; Jose L.,0,0,0,0
1683362077965,HIEU 104,A00,185792,Staff,16,0,20,4
1683362078994,HIEU 115,A00,185800,Staff,1,0,20,19
1683362080022,HIEU 128,A00,185801,Staff,0,7,20,20
1683362081049,HIEU 147,A00,185802,Staff,16,0,20,4
1683362082076,HIEU 154,A00,185823,Staff,12,0,20,8
1683362083101,HILA 102,A00,185826,Staff,13,0,20,7
1683362084129,HILD 2C,A01,185778,Staff,0,12,20,20
1683362085158,HILD 7B,A01,185780,Kwak; Nancy,0,15,32,32
1683362085158,HILD 7B,A02,185781,Kwak; Nancy,0,18,32,32
1683362086186,HILD 30,A01,185791,Staff,14,0,20,6
1683362087211,HISC 119,A00,185830,Golan; Tal,0,9,20,20
1683362088238,HITO 156GS,A00,185831,Patterson; Patrick H.,0,0,0,23
1683362089262,HIUS 103,A00,185832,Man; Simeon S,1,6,20,19
1683362090290,HIUS 117,A00,185836,Kwak; Nancy,2,0,20,18
1683362091316,HIUS 125,A00,185840,Man; Simeon S,0,0,23,23
1683362092341,HIUS 149,A00,185845,Staff,0,0,20,20
1683362093374,HUM 3,A01,185882,Zavodny; Tatiana Sophia,0,7,50,50
1683362093374,HUM 3,B01,185899,Caldwell; Michael Alan,0,18,50,50
1683362094399,HUM 3GS,A00,185900,Patterson; Patrick H.,0,0,0,23
1683362095425,HUM 4,A01,185938,Zroka; Amy Liane,31,0,50,19
1683362095425,HUM 4,B01,185956,Watkins; Eric,0,3,50,50
1683362095425,HUM 4,B02,202209,Watkins; Eric,0,2,50,50
1683362095425,HUM 4,B03,202210,Watkins; Eric,0,2,50,50
1683362096451,HUM 5,A01,185958,West; Geoffrey Scott,3,0,50,47
1683362096451,HUM 5,A02,202215,West; Geoffrey Scott,0,0,50,50
1683362097477,INTL 190,A00,185959,Gagnon; Jeffrey C,0,0,0,9
1683362097477,INTL 190,B00,185960,Lettieri; Michael Joseph,0,0,0,1
1683362098503,JAPN 180,A00,254509,Staff,4,0,30,26
1683362099537,LATI 10,A01,202853,Kennemore; Amy Michelle,4,0,35,31
1683362099537,LATI 10,A02,202854,Kennemore; Amy Michelle,2,0,35,33
1683362099537,LATI 10,A03,270054,Kennemore; Amy Michelle,30,0,30,0
1683362100564,LATI 180,A00,202855,Kennemore; Amy Michelle,11,0,20,9
1683362101594,LAWS 101,A00,201767,Golan; Tal,0,7,40,40
1683362102618,LIFR 1C,A00,185961,Staff,6,0,20,14
1683362103643,LIFR 1CX,A00,185962,Staff,7,0,20,13
1683362104669,LIFR 1D,A00,185963,Staff,9,0,20,11
1683362105692,LIFR 1DX,A00,185964,Staff,9,0,20,11
1683362106716,LIGN 101,A01,186039,Staff,43,0,50,7
1683362107742,LIGN 165,A00,186040,Staff,18,0,50,32
1683362108765,LTCS 108,A00,186041,Staff,6,0,10,4
1683362109789,LTCS 119,A00,186042,Staff,16,0,20,4
1683362110814,LTCS 130,A00,186043,Wesling; Megan E.,15,0,25,10
1683362112865,LTEA 138,A00,186119,Staff,14,0,40,26
1683362113946,LTEN 124,A00,186148,Staff,6,0,25,19
1683362114972,LTEN 178,A00,186149,Staff,7,0,15,8
1683362115996,LTEN 181,A00,186150,Blanco; John D,33,0,40,7
1683362117021,LTWL 120,A00,186160,Staff,20,0,25,5
1683362118049,LTWL 165,A00,186161,Staff,22,0,25,3
1683362119073,LTWR 100,A00,186162,Staff,0,5,15,15
1683362120097,LTWR 102,A00,186163,Doller; Ben,5,0,15,10
1683362121126,MAE 8,A01,186412,Staff,0,0,0,0
1683362122151,MAE 30B,A00,186445,Bahadori; Mohammad Yousef,83,0,100,17
1683362123180,MAE 40,A00,186592,Bewley; Thomas R,10,0,50,40
1683362124208,MAE 101B,A00,186593,Bahadori; Mohammad Yousef,81,0,100,19
1683362125237,MAE 105,A00,186594,Bandaru; Prabhakar,12,0,50,38
1683362126264,MAE 107,A00,186599,Pham; Hieu Tan,0,7,120,120
1683362127290,MAE 148,A01,186660,Silberman; Jack,3,0,16,13
1683362128316,MATH 10A,A01,188095,Staff,0,5,35,35
1683362129343,MATH 10B,A01,188097,Bowers; Adam R.,0,11,30,30
1683362129343,MATH 10B,A02,188099,Bowers; Adam R.,0,11,30,30
1683362129343,MATH 10B,B01,188104,Bowers; Adam R.,0,10,30,30
1683362129343,MATH 10B,B02,188106,Bowers; Adam R.,0,10,30,30
1683362130386,MATH 10C,A01,188111,Staff,0,18,30,30
1683362130386,MATH 10C,A02,188127,Staff,0,17,30,30
1683362130386,MATH 10C,A03,188131,Staff,0,18,30,30
1683362130386,MATH 10C,B01,188218,Staff,18,0,30,12
1683362130386,MATH 10C,B02,188244,Staff,13,0,30,17
1683362130386,MATH 10C,B03,188277,Staff,16,0,30,14
1683362131412,MATH 18,A01,188344,Bach; Quang Tran,18,0,30,12
1683362131412,MATH 18,A02,188345,Bach; Quang Tran,11,0,30,19
1683362131412,MATH 18,B01,188353,Bach; Quang Tran,10,0,30,20
1683362131412,MATH 18,B02,188354,Bach; Quang Tran,20,0,30,10
1683362132437,MATH 20A,A01,188374,Staff,12,0,35,23
1683362133466,MATH 20B,A01,188382,Ohm; Ko Woon,6,0,30,24
1683362133466,MATH 20B,A02,188383,Ohm; Ko Woon,21,0,30,9
1683362133466,MATH 20B,B01,188385,Ohm; Ko Woon,7,0,30,23
1683362133466,MATH 20B,B02,188392,Ohm; Ko Woon,22,0,30,8
1683362134491,MATH 20C,A01,188394,Harel; Guershon,10,0,30,20
1683362134491,MATH 20C,A02,188395,Harel; Guershon,15,0,30,15
1683362134491,MATH 20C,B01,188404,Harel; Guershon,4,0,30,26
1683362134491,MATH 20C,B02,188405,Harel; Guershon,19,0,30,11
1683362135524,MATH 20D,A01,188414,Hammock; Frances H,0,1,30,30
1683362135524,MATH 20D,A02,188415,Hammock; Frances H,3,0,30,27
1683362135524,MATH 20D,B01,188447,Hammock; Frances H,1,0,30,29
1683362135524,MATH 20D,B02,188486,Hammock; Frances H,8,0,30,22
1683362136549,MATH 20E,A01,188649,Staff,21,0,30,9
1683362136549,MATH 20E,A02,188650,Staff,23,0,30,7
1683362136549,MATH 20E,A03,188673,Staff,0,0,30,30
1683362137577,MATH 102,A01,188675,Staff,0,35,35,35
1683362138603,MATH 103B,A01,188681,Staff,3,0,35,32
1683362138603,MATH 103B,B01,188692,Staff,5,0,35,30
1683362139629,MATH 109,A01,188695,Salehi Golsefidy; Alireza,25,0,35,10
1683362139629,MATH 109,A02,188696,Salehi Golsefidy; Alireza,25,0,35,10
1683362140659,MATH 120A,A01,188698,Eggers; John Dietrich,7,0,35,28
1683362141689,MATH 142B,A01,188736,Ioana; Adrian,0,2,30,30
1683362141689,MATH 142B,A02,188741,Ioana; Adrian,0,0,30,30
1683362141689,MATH 142B,A03,188743,Ioana; Adrian,0,1,30,30
1683362142718,MATH 168A,A01,188790,Staff,0,9,35,35
1683362143744,MATH 170A,A01,188803,Nie; Jiawang,0,2,35,35
1683362143744,MATH 170A,A02,188811,Nie; Jiawang,0,0,35,35
1683362143744,MATH 170A,A03,188814,Nie; Jiawang,1,0,35,34
1683362143744,MATH 170A,A04,188815,Nie; Jiawang,13,0,35,22
1683362144768,MATH 193B,A01,188817,Staff,0,0,35,35
1683362144768,MATH 193B,A02,188818,Staff,5,0,35,30
1683362145792,MGT 4,A01,202857,Anderson; John Charles,61,0,80,19
1683362146817,MGT 12,A00,202858,Lindenberger; Wade Douglas,42,0,90,48
1683362147842,MGT 18,A00,202859,Staff,74,0,90,16
1683362148871,MGT 18GS,A00,202860,McKay; Michael J,13,0,28,15
1683362149896,MGT 45,A00,202861,Pecore; Joseph P.,15,0,90,75
1683362150926,MGT 100,A00,202863,Yavorsky; Daniel Ryan,28,0,90,62
1683362151959,MGT 103,A00,202864,Ehrich; Kristine R,0,17,90,90
1683362152983,MGT 112,A00,202865,Ehrich; Kristine R,15,0,90,75
1683362154014,MGT 121A,A00,202868,Staff,0,20,0,0
1683362155042,MGT 131B,A00,202869,Anderson; John Charles,59,0,90,31
1683362156067,MGT 136,A00,202871,Lindenberger; Wade Douglas,84,0,90,6
1683362157096,MGT 164,A00,202873,Staff,0,68,90,91
1683362158121,MGT 164GS,A00,202874,McKay; Mary A,13,0,28,15
1683362159146,MGT 180,A00,202875,Staff,0,50,90,91
1683362160178,MMW 11R,A01,205019,Herbst; Matthew,3,0,30,27
1683362160178,MMW 11R,A02,205026,Herbst; Matthew,29,0,30,1
1683362161216,MMW 15,A01,193512,Chang; Edmond Yi-Teh,0,9,28,28
1683362161216,MMW 15,A02,193513,Chang; Edmond Yi-Teh,0,5,28,28
1683362161216,MMW 15,A03,193514,Chang; Edmond Yi-Teh,0,5,28,28
1683362161216,MMW 15,A04,193515,Chang; Edmond Yi-Teh,0,5,28,28
1683362161216,MMW 15,A05,193516,Chang; Edmond Yi-Teh,0,4,28,28
1683362161216,MMW 15,A06,193517,Chang; Edmond Yi-Teh,0,5,28,28
1683362161216,MMW 15,B01,193519,Chang; Edmond Yi-Teh,0,5,28,28
1683362161216,MMW 15,B02,193520,Chang; Edmond Yi-Teh,0,5,28,28
1683362161216,MMW 15,B03,193521,Chang; Edmond Yi-Teh,0,5,28,28
1683362161216,MMW 15,B04,193522,Chang; Edmond Yi-Teh,0,4,28,28
1683362161216,MMW 15,B05,193523,Chang; Edmond Yi-Teh,0,5,28,28
1683362161216,MMW 15,B06,193524,Chang; Edmond Yi-Teh,0,4,28,28
1683362162250,MMW 122,A01,193526,Rahimi; Babak,0,15,28,28
1683362162250,MMW 122,A02,193527,Rahimi; Babak,0,14,28,28
1683362162250,MMW 122,A03,193528,Rahimi; Babak,0,0,0,0
1683362162250,MMW 122,A04,193529,Rahimi; Babak,0,0,0,0
1683362163275,MUS 1A,A01,186663,Staff,0,20,35,35
1683362164301,MUS 4,A01,186715,Staff,0,12,35,35
1683362165330,MUS 5R,A01,186796,Dubnov; Shlomo,0,17,35,35
1683362166359,MUS 6,A01,186798,Staff,0,4,25,25
1683362167383,MUS 7,A01,186830,Staff,13,0,35,22
1683362168411,MUS 8,A01,186930,Staff,0,26,35,35
1683362169437,MUS 15,A01,186932,Staff,0,16,35,35
1683362169437,MUS 15,B01,186934,Staff,0,15,35,35
1683362170463,MUS 80,A00,186935,Staff,0,0,20,20
1683362170463,MUS 80,B00,186936,Staff,25,0,25,0
1683362171492,NANO 11,A00,204702,Lipomi; Darren John,0,0,0,0
1683362172519,NANO 15,A01,204709,Yang; Kesong,0,1,0,0
1683362173547,NANO 114,A00,202069,Jahed Motlagh; Zeinab,3,0,10,7
1683362174573,PHIL 1,A00,186955,Grush; Rick Scott,32,0,40,8
1683362175600,PHIL 10,A01,186973,Grush; Rick Scott,28,0,35,7
1683362175600,PHIL 10,A02,186974,Grush; Rick Scott,33,0,35,2
1683362176624,PHIL 13,A01,186976,Staff,7,0,35,28
1683362176624,PHIL 13,A02,186977,Staff,16,0,35,19
1683362177650,PHIL 14,A01,186979,Staff,31,0,35,4
1683362177650,PHIL 14,A02,186986,Staff,32,0,35,3
1683362178678,PHIL 28,A01,186988,Staff,16,0,30,14
1683362178678,PHIL 28,A02,186989,Staff,1,0,30,29
1683362178678,PHIL 28,A03,186990,Staff,9,0,30,21
1683362178678,PHIL 28,A04,186991,Staff,26,0,30,4
1683362179708,PHIL 120,A00,186997,Staff,23,0,40,17
1683362180735,PHIL 137,A00,187003,Staff,9,0,40,31
1683362181761,PHIL 150,A00,187015,Staff,47,0,70,23
1683362182787,PHIL 167,A00,187021,Lamey; Andy M.,35,0,40,5
1683362183815,PHIL 174,A01,202226,Staff,17,0,20,3
1683362183815,PHIL 174,A02,202235,Staff,20,0,20,0
1683362184841,PHIL 191A,A00,258918,Staff,0,0,1,1
1683362185875,PHYS 1A,A00,187028,Staff,27,0,60,33
1683362186901,PHYS 1AL,001,187036,Staff,2,0,30,28
1683362186901,PHYS 1AL,002,187049,Staff,18,0,30,12
1683362187926,PHYS 1B,A00,187058,Staff,22,0,60,38
1683362188952,PHYS 1BL,001,187064,Staff,0,0,30,30
1683362188952,PHYS 1BL,002,187070,Staff,5,0,30,25
1683362189978,PHYS 1C,A00,187082,Staff,31,0,120,89
1683362191008,PHYS 1CL,001,187088,Staff,0,9,30,30
1683362191008,PHYS 1CL,002,187089,Staff,0,2,30,30
1683362191008,PHYS 1CL,009,262693,Staff,11,0,30,19
1683362192036,PHYS 2B,A01,187097,Staff,54,0,115,61
1683362193070,PHYS 2C,A01,187099,Staff,67,0,115,48
1683362194097,PHYS 2CL,A01,187101,Staff,5,0,28,23
1683362194097,PHYS 2CL,A02,187102,Staff,15,0,28,13
1683362195123,PHYS 2D,A01,187123,Shotwell; Brian,95,0,115,20
1683362196148,PHYS 4B,A01,187133,Grinstein; Benjamin,35,0,50,15
1683362197172,POLI 10,A00,188819,Staff,0,4,50,50
1683362198200,POLI 11,A00,188827,Staff,43,0,50,7
1683362199226,POLI 13R,A00,188828,Staff,0,1,20,20
1683362200248,POLI 27,A01,188830,Elgin; Samuel Zincke,0,1,70,70
1683362201274,POLI 30,A00,188832,Desposato; Scott,31,0,50,19
1683362202298,POLI 102F,A00,188834,Staff,3,0,40,37
1683362203326,POLI 104A,A00,188852,Staff,14,0,30,16
1683362204350,POLI 104I,A00,188853,Staff,0,6,20,20
1683362205376,POLI 110B,A00,188854,Wiens; David,7,0,20,13
1683362206404,POLI 112A,A00,188855,Wiens; David,5,0,30,25
1683362207433,POLI 117R,A00,188856,Forman; Fonna,0,11,20,20
1683362208459,POLI 118,A00,188857,Ingham; Sean,8,0,20,12
1683362209488,POLI 120G,A00,188858,Staff,9,0,30,21
1683362210515,POLI 131CR,A00,188863,Hoston; Germaine,23,0,50,27
1683362211544,POLI 133,A00,188864,Nellis; Gareth Hb,44,0,50,6
1683362212570,POLI 134D,A00,188865,Desposato; Scott,27,0,30,3
1683362213600,POLI 142A,A00,188871,Gartzke; Erik,22,0,50,28
1683362214626,POLI 142K,A00,188874,Staff,38,0,50,12
1683362215651,POLI 143,A00,188940,Gartzke; Erik,16,0,30,14
1683362216678,POLI 153,A00,188943,Staff,3,0,20,17
1683362217760,POLI 160AA,A00,188944,Staff,11,0,40,29
1683362218788,POLI 170A,A00,188945,Staff,11,0,30,19
1683362220848,PSYC 1,A00,188952,Staff,37,0,90,53
1683362221877,PSYC 2,B00,188953,Staff,19,0,35,16
1683362222902,PSYC 6,A00,188970,Staff,47,0,60,13
1683362223930,PSYC 7,A00,188973,Staff,37,0,45,8
1683362224960,PSYC 60,A01,188980,Rickard; Timothy C.,43,0,60,17
1683362225990,PSYC 70,A01,189001,Steiner; Eric Tomas,23,0,45,22
1683362227020,PSYC 100,A00,189005,Lacefield; Katharine I,0,98,120,120
1683362228048,PSYC 102,A00,189008,Staff,9,0,30,21
1683362229077,PSYC 106,B00,189026,Gorman; Michael R.,34,0,60,26
1683362230107,PSYC 114,B01,189033,Winkielman; Piotr,0,32,30,30
1683362231136,PSYC 131,A00,189036,Anagnostaras; Stephan,0,43,60,60
1683362232165,PSYC 136,A00,189041,Lowe; Angela Beth,0,7,25,25
1683362233189,PSYC 137,A00,189057,Winkielman; Piotr,0,34,25,25
1683362234214,PSYC 144,A00,189107,Wixted; John T,0,7,50,50
1683362236299,PSYC 162,A00,189142,Staff,0,8,85,85
1683362237323,PSYC 172,A00,189144,Gorman; Michael R.,0,7,30,30
1683362239380,PSYC 179,A00,189146,Lacefield; Katharine I,0,84,120,120
1683362240410,PSYC 181,A00,189147,Anagnostaras; Stephan,0,44,90,90
1683362241439,PSYC 190R,A00,189148,Barner; David A.,0,22,80,80
1683362242465,PSYC 191,A00,189275,Rickard; Timothy C.,0,7,25,25
1683362243491,PSYC 193,A00,189276,Chapman; Eddie Nathaniel,0,1,0,4
1683362244523,PSYC 193L,A01,189281,Lowe; Angela Beth,12,0,20,8
1683362244523,PSYC 193L,B01,189285,Staff,28,0,35,7
1683362245550,RELI 149,A00,187137,Rahimi; Babak,7,0,40,33
1683362246579,SE 9,A01,187315,Staff,0,2,18,18
1683362247606,SE 101B,A00,187409,Staff,24,0,30,6
1683362248635,SE 110B,A00,187444,Staff,10,0,40,30
1683362249659,SE 130B,A00,187449,Staff,31,0,40,9
1683362250685,SE 150A,A00,187516,Staff,9,0,20,11
1683362251710,SE 154,A00,187528,Staff,30,0,50,20
1683362252735,SIO 3,A01,258171,Staff,35,0,40,5
1683362253761,SIO 10,A00,187144,Cook; Geoffrey W,0,3,75,75
1683362254786,SIO 45,A00,187152,Cook; Geoffrey W,1,0,100,99
1683362255814,SIO 109R,A00,194486,Staff,0,3,20,20
1683362257866,SIO 187,A01,187233,Kacev; David,12,0,40,28
1683362258892,SOCI 1,A01,258656,Thorpe; Charles Robert,28,0,30,2
1683362258892,SOCI 1,A02,258658,Thorpe; Charles Robert,30,0,30,0
1683362258892,SOCI 1,A03,258661,Thorpe; Charles Robert,25,0,25,0
1683362258892,SOCI 1,A04,258666,Thorpe; Charles Robert,22,0,25,3
1683362258892,SOCI 1,A05,258897,Thorpe; Charles Robert,23,0,25,2
1683362258892,SOCI 1,A06,258898,Thorpe; Charles Robert,25,0,25,0
1683362259918,SOCI 30,A01,258903,Pardo Guerra; Juan Pablo,15,0,30,15
1683362260947,SOCI 102,A00,258904,Staff,9,0,25,16
1683362261971,SOCI 106,A00,258905,Staff,19,0,25,6
1683362262997,SOCI 111,A00,258907,Ribas Norris; Janet Vanesa,26,0,30,4
1683362264021,SOCI 121R,A00,258908,Pardo Guerra; Juan Pablo,10,0,30,20
1683362265051,SOCI 126,A01,203330,Staff,14,0,20,6
1683362266079,SOCI 131,A00,258909,Thorpe; Charles Robert,31,0,60,29
1683362267106,SOCI 135,A00,258910,Payne; Christine Anna,0,9,30,30
1683362268130,SOCI 157,A00,258911,Staff,12,0,30,18
1683362269155,SOCI 184,A00,258912,Staff,25,0,30,5
1683362270183,SOCI 188D,A00,258913,Staff,22,0,30,8
1683362271208,SYN 2,001,187529,Staff,10,0,16,6
1683362271208,SYN 2,002,201452,Staff,0,18,16,16
1683362271208,SYN 2,003,201469,Staff,3,0,16,13
1683362272232,SYN 100,A01,187531,Staff,0,9,20,20
1683362272232,SYN 100,B01,201491,Staff,0,12,20,20
1683362273260,TDAC 1,A00,189286,Walsh; Kim C.,3,0,20,17
1683362273260,TDAC 1,B00,189287,Harting; Carla Kelso,11,0,20,9
1683362274288,TDAC 101,A00,189300,Walsh; Kim C.,16,0,20,4
1683362274288,TDAC 101,B00,189301,Harting; Carla Kelso,18,0,20,2
1683362275313,TDAC 102,A00,189304,Basso; Beatrice,14,0,20,6
1683362276338,TDAC 108,A00,189305,Staff,18,0,20,2
1683362277362,TDDE 131,A00,189310,Staff,19,0,20,1
1683362277362,TDDE 131,B00,189314,Staff,19,0,20,1
1683362277362,TDDE 131,C00,189315,Staff,48,0,50,2
1683362277362,TDDE 131,D00,189316,Staff,14,0,15,1
1683362277362,TDDE 131,E00,204841,Staff,20,0,20,0
1683362278390,TDGE 10,A00,189289,Staff,30,0,50,20
1683362278390,TDGE 10,B00,189290,Havis; Allan,1,0,50,49
1683362279415,TDGE 11,A00,189291,Fulton; Julia,0,3,50,50
1683362279415,TDGE 11,B00,189292,Staff,20,0,25,5
1683362279415,TDGE 11,C00,260270,Staff,0,0,0,0
1683362280438,TDGE 25,A00,189294,Staff,3,0,20,17
1683362281465,TDGE 124,A00,189318,Fulton; Julia,0,8,50,50
1683362282491,TDGE 125,A00,189319,Staff,13,0,25,12
1683362282491,TDGE 125,B00,189320,Staff,23,0,25,2
1683362283520,TDGE 127,A00,189322,Havis; Allan,0,0,50,50
1683362284552,TDHT 101,A00,189323,Staff,18,0,25,7
1683362284552,TDHT 101,B00,189324,Staff,25,0,25,0
1683362285580,TDHT 102,A00,189325,Staff,49,0,50,1
1683362286608,TDMV 1,A00,189295,Arcidiacono; Kristin,19,0,30,11
1683362286608,TDMV 1,B00,189296,Caligagan; Maria T.,24,0,30,6
1683362287638,TDMV 2,A00,189297,Sammartano; Tonnie,28,0,30,2
1683362287638,TDMV 2,B00,189299,Arcidiacono; Kristin,24,0,30,6
1683362288665,TDMV 3,A00,204998,Rincon; Alicia,22,0,30,8
1683362289691,TDMV 120,A00,189458,Sammartano; Tonnie,28,0,30,2
1683362290717,TDMV 138,A00,189541,Jun; Grace Shin Hae,22,0,40,18
1683362291747,TDMV 142,A00,189717,Caligagan; Tony,24,0,30,6
1683362291747,TDMV 142,B00,189718,Caligagan; Maria T.,25,0,30,5
1683362292775,TMC 2,A01,187533,Staff,25,0,25,0
1683362292775,TMC 2,A02,187534,Staff,25,0,25,0
1683362293806,USP 1,A01,187536,Kwak; Nancy,0,16,25,25
1683362294834,USP 5,A01,187538,Staff,10,0,25,15
1683362295864,USP 101,A00,199253,Staff,0,4,0,0
1683362296889,USP 124,A00,187562,Boomhower; Matthew Charles,1,0,30,29
1683362297917,USP 138,A00,187582,Staff,20,0,25,5
1683362298944,USP 152,A01,187597,Staff,4,0,25,21
1683362299968,USP 153,A00,187598,Staff,19,0,25,6
1683362300992,USP 168,A00,187607,Kwak; Nancy,2,0,5,3
1683362302018,USP 173,A00,187619,Staff,4,0,25,21
1683362303044,USP 181,A00,187638,Staff,0,3,25,25
1683362304074,VIS 103,A00,187650,Cruz; Edwin Teddy,22,0,75,53
1683362305104,VIS 110D,A00,187669,Staff,12,0,22,10
1683362306130,VIS 127C,A00,187720,Shen; Kuiyi,67,0,146,79
1683362307155,VIS 149,A00,187731,Yoldas; Pinar,0,14,22,22
1683362308179,VIS 151,A01,188091,Staff,22,0,34,12
1683362308179,VIS 151,A02,188092,Staff,11,0,34,23
1683362309204,VIS 160B,A00,188093,Stalbaum; Brett,0,0,10,10
1683362311255,WCWP 10B,A00,201720,Staff,10,0,15,5
1683362311255,WCWP 10B,B00,201722,Staff,9,0,15,6
1683362312282,WCWP 100,A00,201725,Gagnon; Jeffrey C,0,0,2,2
1683362312282,WCWP 100,B00,201727,Staff,0,4,15,15
1683362315399,ANBI 133,A00,258401,Wilder; Linnea Lorene,34,0,40,6
1683362316423,ANBI 140,A00,258395,Hrvoj Mihic; Branka,18,0,25,7
1683362317452,ANSC 120,A00,258402,Bialecki; Jon Anthony,27,0,40,13
1683362318480,ANSC 144,A00,258400,Staff,14,0,40,26
1683362320542,ANSC 166,A00,258396,Parish; Steven Martin,157,0,175,18
1683362321624,ANSC 180,A00,193533,Staff,9,0,20,11
1683362322652,ANSC 188,A00,258397,Jassal; Aftab,33,0,40,7
1683362323681,ANTH 3,A01,258316,Staff,23,0,30,7
1683362324711,ANTH 5,A00,258394,Semendeferi; Ekaterini,16,0,20,4
1683362325736,ANTH 21,A01,258331,Staff,8,0,40,32
1683362326762,ANTH 103,A00,258398,Varma; Saiba,15,0,25,10
1683362327793,AWP 10,001,202034,Staff,0,0,0,0
1683362327793,AWP 10,002,202035,Staff,0,0,0,0
1683362327793,AWP 10,003,202036,Staff,0,0,0,0
1683362327793,AWP 10,004,202037,Staff,0,0,0,0
1683362327793,AWP 10,005,202038,Staff,0,0,0,0
1683362327793,AWP 10,006,202039,Staff,0,0,0,0
1683362327793,AWP 10,007,202040,Staff,0,0,0,0
1683362327793,AWP 10,008,202041,Staff,0,0,0,0
1683362327793,AWP 10,009,202042,Staff,0,0,0,0
1683362327793,AWP 10,010,202043,Staff,0,0,0,0
1683362327793,AWP 10,011,202044,Staff,0,0,0,0
1683362327793,AWP 10,012,202045,Staff,0,0,0,0
1683362327793,AWP 10,013,202046,Staff,0,0,0,0
1683362327793,AWP 10,014,202047,Staff,0,0,0,0
1683362327793,AWP 10,015,202048,Staff,0,0,0,0
1683362327793,AWP 10,016,202049,Staff,0,0,0,0
1683362327793,AWP 10,017,202050,Staff,0,0,0,0
1683362327793,AWP 10,018,202051,Staff,0,0,0,0
1683362327793,AWP 10,019,202052,Staff,0,0,0,0
1683362327793,AWP 10,020,202053,Staff,0,0,0,0
1683362327793,AWP 10,021,202054,Staff,0,0,0,0
1683362327793,AWP 10,022,202055,Staff,0,0,0,0
1683362327793,AWP 10,023,202056,Staff,0,0,0,0
1683362327793,AWP 10,024,202057,Staff,0,0,0,0
1683362327793,AWP 10,025,202058,Staff,0,0,0,0
1683362327793,AWP 10,026,202059,Staff,0,0,0,0
1683362328817,AWP 102,001,202032,Staff,0,0,0,0
1683362328817,AWP 102,002,202033,Staff,0,0,0,0
1683362329847,BENG 100,A01,254234,Taylor Amos; Alyssa C,31,0,40,9
1683362330875,BENG 196,001,270013,Engler; Adam J.,9999,0,9999,0
1683362331908,BICD 100R,A01,202018,Smith; Laurie,0,7,32,32
1683362331908,BICD 100R,A02,202019,Smith; Laurie,0,2,32,32
1683362331908,BICD 100R,A03,202020,Smith; Laurie,0,1,32,32
1683362331908,BICD 100R,A04,202021,Smith; Laurie,9,0,32,23
1683362331908,BICD 100R,A05,202022,Smith; Laurie,12,0,32,20
1683362332939,BICD 136,A01,193242,Gustafson-Brown; Cindy,0,2,32,32
1683362332939,BICD 136,A02,193244,Gustafson-Brown; Cindy,14,0,32,18
1683362334010,BIEB 102,A01,193249,Butler; Shannon Rhey,0,2,32,32
1683362334010,BIEB 102,A02,193251,Butler; Shannon Rhey,0,0,32,32
1683362334010,BIEB 102,A03,193253,Butler; Shannon Rhey,0,1,32,32
1683362334010,BIEB 102,A04,193255,Butler; Shannon Rhey,17,0,32,15
1683362334010,BIEB 102,A05,193265,Butler; Shannon Rhey,26,0,32,6
1683362334010,BIEB 102,A06,193269,Butler; Shannon Rhey,16,0,32,16
1683362336063,BIEB 150,A01,193274,Staff,0,0,32,32
1683362336063,BIEB 150,A02,193285,Staff,23,0,32,9
1683362337091,BIEB 194,A00,193286,Kurle; Carolyn M.,22,0,32,10
1683362338118,BILD 1,A01,192291,Staff,16,0,32,16
1683362338118,BILD 1,A02,192292,Staff,30,0,32,2
1683362338118,BILD 1,B01,192520,Reuther; Keefe,0,1,0,0
1683362338118,BILD 1,B02,192532,Reuther; Keefe,0,1,0,0
1683362339143,BILD 3,A01,192556,Butler; Shannon Rhey,0,0,32,32
1683362339143,BILD 3,A02,192581,Butler; Shannon Rhey,4,0,32,28
1683362339143,BILD 3,A03,192611,Butler; Shannon Rhey,23,0,32,9
1683362339143,BILD 3,A04,192612,Butler; Shannon Rhey,25,0,32,7
1683362339143,BILD 3,A05,192613,Butler; Shannon Rhey,27,0,32,5
1683362339143,BILD 3,A06,192679,Butler; Shannon Rhey,27,0,32,5
1683362339143,BILD 3,A07,192682,Butler; Shannon Rhey,21,0,32,11
1683362340177,BILD 4,A01,192836,Reuther; Keefe,0,0,24,24
1683362340177,BILD 4,A02,193044,Reuther; Keefe,4,0,24,20
1683362341206,BILD 10,A01,193142,Gustafson-Brown; Cindy,30,0,32,2
1683362341206,BILD 10,A02,193149,Gustafson-Brown; Cindy,31,0,32,1
1683362342233,BIMM 100,A01,193301,Staff,1,6,32,31
1683362342233,BIMM 100,A02,193312,Staff,0,5,32,32
1683362342233,BIMM 100,A03,193323,Staff,0,8,32,32
1683362343260,BIMM 101,A01,193329,McDonnell; Lisa Marie,0,3,24,24
1683362343260,BIMM 101,A02,193339,McDonnell; Lisa Marie,0,3,24,24
1683362343260,BIMM 101,B01,193354,McDonnell; Lisa Marie,0,3,24,24
1683362343260,BIMM 101,B02,193357,McDonnell; Lisa Marie,0,3,24,24
1683362344287,BIMM 110,A01,193377,Tat; John,0,11,32,32
1683362344287,BIMM 110,A02,193378,Tat; John,0,9,32,32
1683362345312,BIMM 120,A01,206116,Staff,0,0,32,32
1683362345312,BIMM 120,A02,206117,Staff,8,0,32,24
1683362345312,BIMM 120,A03,206121,Staff,21,0,32,11
1683362346337,BIPN 100,A01,193393,Park; Ji Young,0,14,32,32
1683362346337,BIPN 100,A02,193402,Park; Ji Young,0,13,32,32
1683362346337,BIPN 100,A03,193413,Park; Ji Young,0,14,32,32
1683362346337,BIPN 100,A04,193414,Park; Ji Young,0,13,32,32
1683362347362,BIPN 102,A01,193429,Staff,0,0,32,32
1683362347362,BIPN 102,A02,193438,Staff,22,0,32,10
1683362348388,BIPN 106,A01,193450,Reyes Gonzalez; Catalina,0,2,40,40
1683362349414,BIPN 134,A01,193465,Cooke; James Edward,1,0,32,31
1683362349414,BIPN 134,A02,193474,Cooke; James Edward,25,0,32,7
1683362349414,BIPN 134,A03,193485,Cooke; James Edward,29,0,32,3
1683362349414,BIPN 134,A04,193486,Cooke; James Edward,21,0,32,11
1683362349414,BIPN 134,A05,193491,Cooke; James Edward,31,0,32,1
1683362349414,BIPN 134,A06,193501,Cooke; James Edward,30,0,32,2
1683362349414,BIPN 134,A07,193510,Cooke; James Edward,29,0,32,3
1683362351469,BISP 194,A00,222522,Staff,14,0,32,18
1683362352498,CAT 124,A01,202407,Staff,19,0,25,6
1683362353528,CAT 125,A00,202408,Marchisotto; Jennifer Anne,4,0,20,16
1683362354564,CAT 125R,A00,202409,Smith; Lauryn Alissa,0,11,20,20
1683362354564,CAT 125R,B00,202410,Morales; Celeste Georgianna,0,11,20,20
1683362354564,CAT 125R,C00,202411,Irwin; Matthew Joseph,0,10,20,20
1683362355590,CENG 15,A01,204712,Yang; Kesong,0,1,0,0
1683362356618,CENG 114,A00,202070,Jahed Motlagh; Zeinab,5,0,20,15
1683362357644,CGS 105,A00,185477,Wesling; Megan E.,24,0,40,16
1683362358679,CGS 106,A00,185494,Staff,13,0,22,9
1683362359706,CGS 108,A00,185495,Staff,14,0,20,6
1683362360735,CGS 114,A00,185496,Staff,13,0,18,5
1683362361762,CGS 119,A00,185501,Staff,15,0,20,5
1683362362791,CGS 120,A00,185511,Staff,13,0,20,7
1683362363826,CHEM 4,A01,184675,Bussey; Thomas J,96,0,100,4
1683362364856,CHEM 6A,A01,184677,Staff,34,0,60,26
1683362365885,CHEM 6B,A01,184679,Staff,65,0,100,35
1683362366911,CHEM 6C,A01,184681,Bussey; Thomas J,1,0,50,49
1683362366911,CHEM 6C,A02,184682,Bussey; Thomas J,34,0,50,16
1683362367935,CHEM 40A,A01,184684,Albizati; Kim F.,37,0,100,63
1683362368965,CHEM 40B,A01,184686,Albizati; Kim F.,0,20,100,100
1683362369993,CHEM 41B,A01,184690,Staff,52,0,100,48
1683362371021,COGS 3,A01,184715,Boyle; Mary E. T.,0,25,40,40
1683362372049,COGS 14B,A01,185172,Staff,0,15,38,38
1683362373077,COGS 18,A01,184736,Staff,16,0,80,64
1683362374105,COGS 100,A01,184932,Staff,0,5,73,73
1683362375130,COGS 101A,A01,184935,Staff,0,39,30,30
1683362376155,COGS 101B,A01,184944,Staff,0,2,30,30
1683362377184,COGS 101C,A01,184946,Staff,0,12,30,30
1683362378214,COGS 102A,A01,184951,Johnson; Christine M.,2,0,40,38
1683362379244,COGS 107B,A01,184953,Mooshagian; Eric Frederick,0,50,40,40
1683362380269,COGS 118B,A01,184959,Gupta; Anjum,0,48,40,40
1683362381294,COGS 153,A00,184961,Staff,0,15,30,30
1683362382318,COGS 177,A00,184962,Staff,0,20,30,30
1683362383346,COGS 187A,A01,184969,Boyle; Mary E. T.,0,17,40,40
1683362384376,COMM 10,A01,185174,Staff,0,5,25,25
1683362384376,COMM 10,A02,185189,Staff,0,5,25,25
1683362384376,COMM 10,A03,269821,Staff,0,0,0,0
1683362385401,COMM 100B,A01,185475,Staff,0,0,0,2
1683362385401,COMM 100B,A02,185476,Staff,13,0,25,12
1683362386426,COMM 100C,A01,185314,Staff,1,0,25,24
1683362386426,COMM 100C,A02,185327,Staff,19,0,25,6
1683362387451,COMM 110M,A00,185349,Staff,2,0,40,38
1683362388478,COMM 113T,A00,185352,Staff,24,0,40,16
1683362389502,COMM 114I,A00,185353,Staff,33,0,40,7
1683362390526,COMM 131,A00,185354,Staff,19,0,30,11
1683362391553,CSE 8A,A50,185358,Cao; Yingjun,0,46,10,10
1683362392579,CSE 8B,A01,185362,Staff,0,46,50,50
1683362393605,CSE 11,A01,185416,Cao; Yingjun,0,92,10,10
1683362394667,CSE 20,A01,185445,Briones; Jor-el Thomas Caparas,5,0,25,20
1683362395751,CSE 21,A01,185447,Staff,10,0,50,40
1683362396779,CSE 101,A01,185451,Staff,0,13,50,50
1683362396779,CSE 101,B01,185453,Jones; Miles E,0,11,50,50
1683362398836,CSE 141,A01,185458,Eldon; John,20,0,100,80
1683362399864,CSE 141L,A01,185461,Eldon; John,12,0,100,88
1683362400889,CSE 142,A01,185463,Staff,36,0,60,24
1683362400889,CSE 142,B01,201355,Staff,0,7,60,60
1683362401917,CSE 142L,A01,185470,Staff,36,0,60,24
1683362401917,CSE 142L,B01,201417,Staff,0,6,60,60
1683362402942,CSE 190,A00,201433,Staff,32,0,49,17
1683362403978,DOC 1,A01,259136,Strom; Megan C.,7,0,15,8
1683362403978,DOC 1,A02,259137,Strom; Megan C.,14,0,15,1
1683362403978,DOC 1,A03,259138,Strom; Megan C.,14,0,15,1
1683362403978,DOC 1,A04,259139,Strom; Megan C.,14,0,15,1
1683362405005,DOC 100D,A00,259140,Pass; Natalye Joann,16,0,25,9
1683362406056,DSGN 1,A01,184749,Rill; Bryan,0,25,30,30
1683362407084,DSGN 100,A01,185168,Staff,0,2,25,25
1683362408110,ECE 5,A01,185626,Morris; Karcher William,0,10,0,0
1683362409139,ECE 101,A01,185628,Staff,17,0,70,53
1683362410167,ECE 107,A01,185635,Baghdadchi; Saharnaz,0,0,20,20
1683362410167,ECE 107,A02,185638,Baghdadchi; Saharnaz,4,0,20,16
1683362411209,ECE 148,A01,185647,Silberman; Jack,0,0,16,16
1683362412239,ECON 1,A01,185537,Crane; Meredith Helen,54,0,70,16
1683362413269,ECON 3,A01,185549,Crane; Meredith Helen,32,0,70,38
1683362414294,ECON 4,A01,203354,Anderson; John Charles,0,4,10,10
1683362415317,ECON 100A,A01,185574,Staff,0,4,40,40
1683362416345,ECON 100B,A01,185576,Staff,0,12,50,50
1683362417375,ECON 100C,A01,185589,Newhouse; Herbert S,29,0,70,41
1683362418403,ECON 105,A00,185608,Vespa; Emanuel Ignacio,19,0,35,16
1683362419466,ECON 109,A01,185610,Shishkin; Denis,10,0,35,25
1683362420491,ECON 110A,A01,185612,Staff,11,0,40,29
1683362421516,ECON 120A,A01,185615,Staff,20,0,40,20
1683362422542,ECON 120C,A01,185617,Sun; Yixiao,0,21,70,70
1683362423567,ECON 144,A00,203346,Squires; Dale E,3,0,35,32
1683362424594,ECON 171,A01,203349,Newhouse; Herbert S,0,1,35,35
1683362425678,ECON 173A,A01,185621,Toda; Alexis Akira,21,0,35,14
1683362426708,EDS 25,A01,202413,Staff,0,1,0,0
1683362426708,EDS 25,A02,202414,Staff,0,1,0,0
1683362426708,EDS 25,A03,202415,Staff,0,0,0,0
1683362426708,EDS 25,A04,202416,Staff,0,1,0,0
1683362426708,EDS 25,A05,202439,Staff,0,0,0,0
1683362426708,EDS 25,A06,202440,Staff,0,0,0,0
1683362426708,EDS 25,B01,202631,Staff,0,0,0,0
1683362426708,EDS 25,B02,202632,Staff,0,0,0,0
1683362426708,EDS 25,B03,202639,Staff,0,0,0,0
1683362426708,EDS 25,B04,202640,Staff,0,0,0,0
1683362426708,EDS 25,B05,202643,Staff,0,0,0,0
1683362426708,EDS 25,B06,202644,Staff,0,0,0,0
1683362427734,EDS 38,A01,202659,Black; Alison Michelle,24,0,25,1
1683362428759,EDS 115,A00,202652,Staff,18,0,30,12
1683362429785,EDS 125,A00,202649,Staff,14,0,30,16
1683362430816,EDS 126,A01,203332,Staff,30,0,30,0
1683362431843,EDS 139,A00,202838,Staff,16,0,25,9
1683362432871,EDS 146,A01,202655,Staff,14,0,25,11
1683362433898,ENG 15,A00,185667,Staff,0,1,0,0
1683362433898,ENG 15,B00,185672,Staff,0,0,0,0
1683362433898,ENG 15,C00,185675,Staff,0,0,0,0
1683362433898,ENG 15,D00,185682,Staff,0,0,0,0
1683362433898,ENG 15,E00,185684,Staff,0,0,0,0
1683362434923,ETHN 103,A00,185710,Staff,0,4,35,35
1683362435950,ETHN 103A,A00,199228,Man; Simeon S,2,0,9,7
1683362436976,ETHN 109,A00,185711,Staff,18,0,35,17
1683362438000,ETHN 142,A00,185726,Staff,0,4,30,30
1683362439030,ETHN 163J,A00,199229,Man; Simeon S,5,0,8,3
1683362440054,ETHN 168,A00,185727,Staff,8,0,10,2
1683362441081,ETHN 182,A00,185728,Staff,0,0,35,35
1683362442110,ETHN 183,A00,185737,Staff,8,0,18,10
1683362443139,GLBH 111,A01,209361,Burgos; Jose L.,0,0,0,0
1683362445191,HIEU 104,A00,185792,Staff,16,0,20,4
1683362446215,HIEU 115,A00,185800,Staff,1,0,20,19
1683362447242,HIEU 128,A00,185801,Staff,0,7,20,20
1683362448266,HIEU 147,A00,185802,Staff,16,0,20,4
1683362449293,HIEU 154,A00,185823,Staff,12,0,20,8
1683362450317,HILA 102,A00,185826,Staff,13,0,20,7
1683362451342,HILD 2C,A01,185778,Staff,0,12,20,20
1683362452368,HILD 7B,A01,185780,Kwak; Nancy,0,15,32,32
1683362452368,HILD 7B,A02,185781,Kwak; Nancy,0,18,32,32
1683362453393,HILD 30,A01,185791,Staff,14,0,20,6
1683362454419,HISC 119,A00,185830,Golan; Tal,0,9,20,20
1683362455443,HITO 156GS,A00,185831,Patterson; Patrick H.,0,0,0,23
1683362456469,HIUS 103,A00,185832,Man; Simeon S,1,6,20,19
1683362457494,HIUS 117,A00,185836,Kwak; Nancy,2,0,20,18
1683362458518,HIUS 125,A00,185840,Man; Simeon S,0,0,23,23
1683362459543,HIUS 149,A00,185845,Staff,0,0,20,20
1683362460575,HUM 3,A01,185882,Zavodny; Tatiana Sophia,0,7,50,50
1683362460575,HUM 3,B01,185899,Caldwell; Michael Alan,0,18,50,50
1683362461602,HUM 3GS,A00,185900,Patterson; Patrick H.,0,0,0,23
1683362462642,HUM 4,A01,185938,Zroka; Amy Liane,31,0,50,19
1683362462642,HUM 4,B01,185956,Watkins; Eric,0,3,50,50
1683362462642,HUM 4,B02,202209,Watkins; Eric,0,2,50,50
1683362462642,HUM 4,B03,202210,Watkins; Eric,0,2,50,50
1683362463672,HUM 5,A01,185958,West; Geoffrey Scott,3,0,50,47
1683362463672,HUM 5,A02,202215,West; Geoffrey Scott,0,0,50,50
1683362464703,INTL 190,A00,185959,Gagnon; Jeffrey C,0,0,0,9
1683362464703,INTL 190,B00,185960,Lettieri; Michael Joseph,0,0,0,1
1683362465736,JAPN 180,A00,254509,Staff,4,0,30,26
1683362466767,LATI 10,A01,202853,Kennemore; Amy Michelle,4,0,35,31
1683362466767,LATI 10,A02,202854,Kennemore; Amy Michelle,2,0,35,33
1683362466767,LATI 10,A03,270054,Kennemore; Amy Michelle,30,0,30,0
1683362467795,LATI 180,A00,202855,Kennemore; Amy Michelle,11,0,20,9
1683362468825,LAWS 101,A00,201767,Golan; Tal,0,7,40,40
1683362469853,LIFR 1C,A00,185961,Staff,6,0,20,14
1683362470883,LIFR 1CX,A00,185962,Staff,7,0,20,13
1683362471908,LIFR 1D,A00,185963,Staff,9,0,20,11
1683362472934,LIFR 1DX,A00,185964,Staff,9,0,20,11
1683362473960,LIGN 101,A01,186039,Staff,43,0,50,7
1683362474990,LIGN 165,A00,186040,Staff,18,0,50,32
1683362476022,LTCS 108,A00,186041,Staff,6,0,10,4
1683362477050,LTCS 119,A00,186042,Staff,16,0,20,4
1683362478085,LTCS 130,A00,186043,Wesling; Megan E.,15,0,25,10
1683362480146,LTEA 138,A00,186119,Staff,14,0,40,26
1683362481171,LTEN 124,A00,186148,Staff,6,0,25,19
1683362482196,LTEN 178,A00,186149,Staff,7,0,15,8
1683362483227,LTEN 181,A00,186150,Blanco; John D,33,0,40,7
1683362484252,LTWL 120,A00,186160,Staff,20,0,25,5
1683362485277,LTWL 165,A00,186161,Staff,22,0,25,3
1683362486302,LTWR 100,A00,186162,Staff,0,5,15,15
1683362487329,LTWR 102,A00,186163,Doller; Ben,5,0,15,10
1683362488353,MAE 8,A01,186412,Staff,0,0,0,0
1683362489379,MAE 30B,A00,186445,Bahadori; Mohammad Yousef,83,0,100,17
1683362490406,MAE 40,A00,186592,Bewley; Thomas R,10,0,50,40
1683362491433,MAE 101B,A00,186593,Bahadori; Mohammad Yousef,81,0,100,19
1683362492458,MAE 105,A00,186594,Bandaru; Prabhakar,12,0,50,38
1683362493482,MAE 107,A00,186599,Pham; Hieu Tan,0,7,120,120
1683362494510,MAE 148,A01,186660,Silberman; Jack,3,0,16,13
1683362495535,MATH 10A,A01,188095,Staff,0,5,35,35
1683362496568,MATH 10B,A01,188097,Bowers; Adam R.,0,11,30,30
1683362496568,MATH 10B,A02,188099,Bowers; Adam R.,0,11,30,30
1683362496568,MATH 10B,B01,188104,Bowers; Adam R.,0,10,30,30
1683362496568,MATH 10B,B02,188106,Bowers; Adam R.,0,10,30,30
1683362497608,MATH 10C,A01,188111,Staff,0,18,30,30
1683362497608,MATH 10C,A02,188127,Staff,0,17,30,30
1683362497608,MATH 10C,A03,188131,Staff,0,18,30,30
1683362497608,MATH 10C,B01,188218,Staff,18,0,30,12
1683362497608,MATH 10C,B02,188244,Staff,13,0,30,17
1683362497608,MATH 10C,B03,188277,Staff,16,0,30,14
1683362498640,MATH 18,A01,188344,Bach; Quang Tran,18,0,30,12
1683362498640,MATH 18,A02,188345,Bach; Quang Tran,11,0,30,19
1683362498640,MATH 18,B01,188353,Bach; Quang Tran,10,0,30,20
1683362498640,MATH 18,B02,188354,Bach; Quang Tran,20,0,30,10
1683362499667,MATH 20A,A01,188374,Staff,12,0,35,23
1683362500694,MATH 20B,A01,188382,Ohm; Ko Woon,6,0,30,24
1683362500694,MATH 20B,A02,188383,Ohm; Ko Woon,21,0,30,9
1683362500694,MATH 20B,B01,188385,Ohm; Ko Woon,7,0,30,23
1683362500694,MATH 20B,B02,188392,Ohm; Ko Woon,22,0,30,8
1683362501721,MATH 20C,A01,188394,Harel; Guershon,10,0,30,20
1683362501721,MATH 20C,A02,188395,Harel; Guershon,15,0,30,15
1683362501721,MATH 20C,B01,188404,Harel; Guershon,4,0,30,26
1683362501721,MATH 20C,B02,188405,Harel; Guershon,19,0,30,11
1683362502748,MATH 20D,A01,188414,Hammock; Frances H,0,1,30,30
1683362502748,MATH 20D,A02,188415,Hammock; Frances H,3,0,30,27
1683362502748,MATH 20D,B01,188447,Hammock; Frances H,1,0,30,29
1683362502748,MATH 20D,B02,188486,Hammock; Frances H,8,0,30,22
1683362503773,MATH 20E,A01,188649,Staff,21,0,30,9
1683362503773,MATH 20E,A02,188650,Staff,23,0,30,7
1683362503773,MATH 20E,A03,188673,Staff,0,0,30,30
1683362504799,MATH 102,A01,188675,Staff,0,35,35,35
1683362505825,MATH 103B,A01,188681,Staff,3,0,35,32
1683362505825,MATH 103B,B01,188692,Staff,5,0,35,30
1683362506851,MATH 109,A01,188695,Salehi Golsefidy; Alireza,25,0,35,10
1683362506851,MATH 109,A02,188696,Salehi Golsefidy; Alireza,25,0,35,10
1683362507882,MATH 120A,A01,188698,Eggers; John Dietrich,7,0,35,28
1683362508913,MATH 142B,A01,188736,Ioana; Adrian,0,2,30,30
1683362508913,MATH 142B,A02,188741,Ioana; Adrian,0,0,30,30
1683362508913,MATH 142B,A03,188743,Ioana; Adrian,0,1,30,30
1683362509942,MATH 168A,A01,188790,Staff,0,9,35,35
1683362510974,MATH 170A,A01,188803,Nie; Jiawang,0,2,35,35
1683362510974,MATH 170A,A02,188811,Nie; Jiawang,0,0,35,35
1683362510974,MATH 170A,A03,188814,Nie; Jiawang,1,0,35,34
1683362510974,MATH 170A,A04,188815,Nie; Jiawang,13,0,35,22
1683362512002,MATH 193B,A01,188817,Staff,0,0,35,35
1683362512002,MATH 193B,A02,188818,Staff,5,0,35,30
1683362513034,MGT 4,A01,202857,Anderson; John Charles,61,0,80,19
1683362514068,MGT 12,A00,202858,Lindenberger; Wade Douglas,42,0,90,48
1683362515092,MGT 18,A00,202859,Staff,74,0,90,16
1683362516118,MGT 18GS,A00,202860,McKay; Michael J,13,0,28,15
1683362517144,MGT 45,A00,202861,Pecore; Joseph P.,15,0,90,75
1683362518178,MGT 100,A00,202863,Yavorsky; Daniel Ryan,28,0,90,62
1683362519205,MGT 103,A00,202864,Ehrich; Kristine R,0,17,90,90
1683362520237,MGT 112,A00,202865,Ehrich; Kristine R,15,0,90,75
1683362521269,MGT 121A,A00,202868,Staff,0,20,0,0
1683362522298,MGT 131B,A00,202869,Anderson; John Charles,59,0,90,31
1683362523327,MGT 136,A00,202871,Lindenberger; Wade Douglas,84,0,90,6
1683362524357,MGT 164,A00,202873,Staff,0,68,90,91
1683362525383,MGT 164GS,A00,202874,McKay; Mary A,13,0,28,15
1683362526412,MGT 180,A00,202875,Staff,0,50,90,91
1683362527437,MMW 11R,A01,205019,Herbst; Matthew,3,0,30,27
1683362527437,MMW 11R,A02,205026,Herbst; Matthew,29,0,30,1
1683362528479,MMW 15,A01,193512,Chang; Edmond Yi-Teh,0,9,28,28
1683362528479,MMW 15,A02,193513,Chang; Edmond Yi-Teh,0,5,28,28
1683362528479,MMW 15,A03,193514,Chang; Edmond Yi-Teh,0,5,28,28
1683362528479,MMW 15,A04,193515,Chang; Edmond Yi-Teh,0,5,28,28
1683362528479,MMW 15,A05,193516,Chang; Edmond Yi-Teh,0,4,28,28
1683362528479,MMW 15,A06,193517,Chang; Edmond Yi-Teh,0,5,28,28
1683362528479,MMW 15,B01,193519,Chang; Edmond Yi-Teh,0,5,28,28
1683362528479,MMW 15,B02,193520,Chang; Edmond Yi-Teh,0,5,28,28
1683362528479,MMW 15,B03,193521,Chang; Edmond Yi-Teh,0,5,28,28
1683362528479,MMW 15,B04,193522,Chang; Edmond Yi-Teh,0,4,28,28
1683362528479,MMW 15,B05,193523,Chang; Edmond Yi-Teh,0,5,28,28
1683362528479,MMW 15,B06,193524,Chang; Edmond Yi-Teh,0,4,28,28
1683362529579,MMW 122,A01,193526,Rahimi; Babak,0,15,28,28
1683362529579,MMW 122,A02,193527,Rahimi; Babak,0,14,28,28
1683362529579,MMW 122,A03,193528,Rahimi; Babak,0,0,0,0
1683362529579,MMW 122,A04,193529,Rahimi; Babak,0,0,0,0
1683362530609,MUS 1A,A01,186663,Staff,0,20,35,35
1683362531634,MUS 4,A01,186715,Staff,0,12,35,35
1683362532661,MUS 5R,A01,186796,Dubnov; Shlomo,0,17,35,35
1683362533685,MUS 6,A01,186798,Staff,0,4,25,25
1683362534715,MUS 7,A01,186830,Staff,13,0,35,22
1683362535745,MUS 8,A01,186930,Staff,0,26,35,35
1683362536775,MUS 15,A01,186932,Staff,0,16,35,35
1683362536775,MUS 15,B01,186934,Staff,0,15,35,35
1683362537800,MUS 80,A00,186935,Staff,0,0,20,20
1683362537800,MUS 80,B00,186936,Staff,25,0,25,0
1683362538844,NANO 11,A00,204702,Lipomi; Darren John,0,0,0,0
1683362539870,NANO 15,A01,204709,Yang; Kesong,0,1,0,0
1683362540895,NANO 114,A00,202069,Jahed Motlagh; Zeinab,3,0,10,7
1683362541920,PHIL 1,A00,186955,Grush; Rick Scott,32,0,40,8
1683362542947,PHIL 10,A01,186973,Grush; Rick Scott,28,0,35,7
1683362542947,PHIL 10,A02,186974,Grush; Rick Scott,33,0,35,2
1683362543977,PHIL 13,A01,186976,Staff,7,0,35,28
1683362543977,PHIL 13,A02,186977,Staff,16,0,35,19
1683362545007,PHIL 14,A01,186979,Staff,31,0,35,4
1683362545007,PHIL 14,A02,186986,Staff,32,0,35,3
1683362546034,PHIL 28,A01,186988,Staff,16,0,30,14
1683362546034,PHIL 28,A02,186989,Staff,1,0,30,29
1683362546034,PHIL 28,A03,186990,Staff,9,0,30,21
1683362546034,PHIL 28,A04,186991,Staff,26,0,30,4
1683362547061,PHIL 120,A00,186997,Staff,23,0,40,17
1683362548084,PHIL 137,A00,187003,Staff,9,0,40,31
1683362549110,PHIL 150,A00,187015,Staff,47,0,70,23
1683362550136,PHIL 167,A00,187021,Lamey; Andy M.,35,0,40,5
1683362551166,PHIL 174,A01,202226,Staff,17,0,20,3
1683362551166,PHIL 174,A02,202235,Staff,20,0,20,0
1683362552192,PHIL 191A,A00,258918,Staff,0,0,1,1
1683362553218,PHYS 1A,A00,187028,Staff,27,0,60,33
1683362554243,PHYS 1AL,001,187036,Staff,2,0,30,28
1683362554243,PHYS 1AL,002,187049,Staff,18,0,30,12
1683362555267,PHYS 1B,A00,187058,Staff,22,0,60,38
1683362556297,PHYS 1BL,001,187064,Staff,0,0,30,30
1683362556297,PHYS 1BL,002,187070,Staff,5,0,30,25
1683362557322,PHYS 1C,A00,187082,Staff,31,0,120,89
1683362558349,PHYS 1CL,001,187088,Staff,0,9,30,30
1683362558349,PHYS 1CL,002,187089,Staff,0,2,30,30
1683362558349,PHYS 1CL,009,262693,Staff,11,0,30,19
1683362559374,PHYS 2B,A01,187097,Staff,54,0,115,61
1683362560399,PHYS 2C,A01,187099,Staff,67,0,115,48
1683362561430,PHYS 2CL,A01,187101,Staff,5,0,28,23
1683362561430,PHYS 2CL,A02,187102,Staff,15,0,28,13
1683362562455,PHYS 2D,A01,187123,Shotwell; Brian,95,0,115,20
1683362563482,PHYS 4B,A01,187133,Grinstein; Benjamin,35,0,50,15
1683362564512,POLI 10,A00,188819,Staff,0,4,50,50
1683362565537,POLI 11,A00,188827,Staff,43,0,50,7
1683362566562,POLI 13R,A00,188828,Staff,0,1,20,20
1683362567589,POLI 27,A01,188830,Elgin; Samuel Zincke,0,1,70,70
1683362568615,POLI 30,A00,188832,Desposato; Scott,31,0,50,19
1683362569646,POLI 102F,A00,188834,Staff,3,0,40,37
1683362570672,POLI 104A,A00,188852,Staff,14,0,30,16
1683362571701,POLI 104I,A00,188853,Staff,0,6,20,20
1683362572730,POLI 110B,A00,188854,Wiens; David,7,0,20,13
1683362573758,POLI 112A,A00,188855,Wiens; David,5,0,30,25
1683362574784,POLI 117R,A00,188856,Forman; Fonna,0,11,20,20
1683362575809,POLI 118,A00,188857,Ingham; Sean,8,0,20,12
1683362576835,POLI 120G,A00,188858,Staff,9,0,30,21
1683362577862,POLI 131CR,A00,188863,Hoston; Germaine,23,0,50,27
1683362578890,POLI 133,A00,188864,Nellis; Gareth Hb,44,0,50,6
1683362579915,POLI 134D,A00,188865,Desposato; Scott,27,0,30,3
1683362580944,POLI 142A,A00,188871,Gartzke; Erik,22,0,50,28
1683362581978,POLI 142K,A00,188874,Staff,38,0,50,12
1683362583003,POLI 143,A00,188940,Gartzke; Erik,16,0,30,14
1683362584029,POLI 153,A00,188943,Staff,3,0,20,17
1683362585055,POLI 160AA,A00,188944,Staff,11,0,40,29
1683362586082,POLI 170A,A00,188945,Staff,11,0,30,19
1683362588137,PSYC 1,A00,188952,Staff,37,0,90,53
1683362589165,PSYC 2,B00,188953,Staff,19,0,35,16
1683362590190,PSYC 6,A00,188970,Staff,47,0,60,13
1683362591214,PSYC 7,A00,188973,Staff,37,0,45,8
1683362592242,PSYC 60,A01,188980,Rickard; Timothy C.,43,0,60,17
1683362593270,PSYC 70,A01,189001,Steiner; Eric Tomas,23,0,45,22
1683362594299,PSYC 100,A00,189005,Lacefield; Katharine I,0,98,120,120
1683362595325,PSYC 102,A00,189008,Staff,9,0,30,21
1683362596351,PSYC 106,B00,189026,Gorman; Michael R.,34,0,60,26
1683362597378,PSYC 114,B01,189033,Winkielman; Piotr,0,32,30,30
1683362598408,PSYC 131,A00,189036,Anagnostaras; Stephan,0,43,60,60
1683362599436,PSYC 136,A00,189041,Lowe; Angela Beth,0,7,25,25
1683362600466,PSYC 137,A00,189057,Winkielman; Piotr,0,34,25,25
1683362601492,PSYC 144,A00,189107,Wixted; John T,0,7,50,50
1683362603543,PSYC 162,A00,189142,Staff,0,8,85,85
1683362604570,PSYC 172,A00,189144,Gorman; Michael R.,0,7,30,30
1683362606623,PSYC 179,A00,189146,Lacefield; Katharine I,0,84,120,120
1683362607653,PSYC 181,A00,189147,Anagnostaras; Stephan,0,44,90,90
1683362608681,PSYC 190R,A00,189148,Barner; David A.,0,22,80,80
1683362609706,PSYC 191,A00,189275,Rickard; Timothy C.,0,7,25,25
1683362610730,PSYC 193,A00,189276,Chapman; Eddie Nathaniel,0,1,0,4
1683362611757,PSYC 193L,A01,189281,Lowe; Angela Beth,12,0,20,8
1683362611757,PSYC 193L,B01,189285,Staff,28,0,35,7
1683362612786,RELI 149,A00,187137,Rahimi; Babak,7,0,40,33
1683362613811,SE 9,A01,187315,Staff,0,2,18,18
1683362614840,SE 101B,A00,187409,Staff,24,0,30,6
1683362615870,SE 110B,A00,187444,Staff,10,0,40,30
1683362616896,SE 130B,A00,187449,Staff,31,0,40,9
1683362617921,SE 150A,A00,187516,Staff,9,0,20,11
1683362618950,SE 154,A00,187528,Staff,30,0,50,20
1683362619976,SIO 3,A01,258171,Staff,35,0,40,5
1683362621001,SIO 10,A00,187144,Cook; Geoffrey W,0,3,75,75
1683362622026,SIO 45,A00,187152,Cook; Geoffrey W,1,0,100,99
1683362623051,SIO 109R,A00,194486,Staff,0,3,20,20
1683362625108,SIO 187,A01,187233,Kacev; David,12,0,40,28
1683362626140,SOCI 1,A01,258656,Thorpe; Charles Robert,28,0,30,2
1683362626140,SOCI 1,A02,258658,Thorpe; Charles Robert,30,0,30,0
1683362626140,SOCI 1,A03,258661,Thorpe; Charles Robert,25,0,25,0
1683362626140,SOCI 1,A04,258666,Thorpe; Charles Robert,22,0,25,3
1683362626140,SOCI 1,A05,258897,Thorpe; Charles Robert,23,0,25,2
1683362626140,SOCI 1,A06,258898,Thorpe; Charles Robert,25,0,25,0
1683362627166,SOCI 30,A01,258903,Pardo Guerra; Juan Pablo,15,0,30,15
1683362628192,SOCI 102,A00,258904,Staff,9,0,25,16
1683362629215,SOCI 106,A00,258905,Staff,19,0,25,6
1683362630240,SOCI 111,A00,258907,Ribas Norris; Janet Vanesa,26,0,30,4
1683362631268,SOCI 121R,A00,258908,Pardo Guerra; Juan Pablo,10,0,30,20
1683362632300,SOCI 126,A01,203330,Staff,14,0,20,6
1683362633383,SOCI 131,A00,258909,Thorpe; Charles Robert,31,0,60,29
1683362634410,SOCI 135,A00,258910,Payne; Christine Anna,0,9,30,30
1683362635438,SOCI 157,A00,258911,Staff,12,0,30,18
1683362636463,SOCI 184,A00,258912,Staff,25,0,30,5
1683362637489,SOCI 188D,A00,258913,Staff,22,0,30,8
1683362638514,SYN 2,001,187529,Staff,10,0,16,6
1683362638514,SYN 2,002,201452,Staff,0,18,16,16
1683362638514,SYN 2,003,201469,Staff,3,0,16,13
1683362639539,SYN 100,A01,187531,Staff,0,9,20,20
1683362639539,SYN 100,B01,201491,Staff,0,12,20,20
1683362640570,TDAC 1,A00,189286,Walsh; Kim C.,3,0,20,17
1683362640570,TDAC 1,B00,189287,Harting; Carla Kelso,11,0,20,9
1683362641600,TDAC 101,A00,189300,Walsh; Kim C.,16,0,20,4
1683362641600,TDAC 101,B00,189301,Harting; Carla Kelso,18,0,20,2
1683362642625,TDAC 102,A00,189304,Basso; Beatrice,14,0,20,6
1683362643654,TDAC 108,A00,189305,Staff,18,0,20,2
1683362644680,TDDE 131,A00,189310,Staff,19,0,20,1
1683362644680,TDDE 131,B00,189314,Staff,19,0,20,1
1683362644680,TDDE 131,C00,189315,Staff,48,0,50,2
1683362644680,TDDE 131,D00,189316,Staff,14,0,15,1
1683362644680,TDDE 131,E00,204841,Staff,20,0,20,0
1683362645706,TDGE 10,A00,189289,Staff,30,0,50,20
1683362645706,TDGE 10,B00,189290,Havis; Allan,1,0,50,49
1683362646744,TDGE 11,A00,189291,Fulton; Julia,0,3,50,50
1683362646744,TDGE 11,B00,189292,Staff,20,0,25,5
1683362646744,TDGE 11,C00,260270,Staff,0,0,0,0
1683362647769,TDGE 25,A00,189294,Staff,3,0,20,17
1683362648798,TDGE 124,A00,189318,Fulton; Julia,0,8,50,50
1683362649825,TDGE 125,A00,189319,Staff,13,0,25,12
1683362649825,TDGE 125,B00,189320,Staff,23,0,25,2
1683362650851,TDGE 127,A00,189322,Havis; Allan,0,0,50,50
1683362651880,TDHT 101,A00,189323,Staff,18,0,25,7
1683362651880,TDHT 101,B00,189324,Staff,25,0,25,0
1683362652905,TDHT 102,A00,189325,Staff,49,0,50,1
1683362653929,TDMV 1,A00,189295,Arcidiacono; Kristin,19,0,30,11
1683362653929,TDMV 1,B00,189296,Caligagan; Maria T.,24,0,30,6
1683362654952,TDMV 2,A00,189297,Sammartano; Tonnie,28,0,30,2
1683362654952,TDMV 2,B00,189299,Arcidiacono; Kristin,24,0,30,6
1683362655979,TDMV 3,A00,204998,Rincon; Alicia,22,0,30,8
1683362657003,TDMV 120,A00,189458,Sammartano; Tonnie,28,0,30,2
1683362658030,TDMV 138,A00,189541,Jun; Grace Shin Hae,22,0,40,18
1683362659058,TDMV 142,A00,189717,Caligagan; Tony,24,0,30,6
1683362659058,TDMV 142,B00,189718,Caligagan; Maria T.,25,0,30,5
1683362660087,TMC 2,A01,187533,Staff,25,0,25,0
1683362660087,TMC 2,A02,187534,Staff,25,0,25,0
1683362661112,USP 1,A01,187536,Kwak; Nancy,0,16,25,25
1683362662139,USP 5,A01,187538,Staff,10,0,25,15
1683362663166,USP 101,A00,199253,Staff,0,4,0,0
1683362664194,USP 124,A00,187562,Boomhower; Matthew Charles,1,0,30,29
1683362665218,USP 138,A00,187582,Staff,20,0,25,5
1683362666248,USP 152,A01,187597,Staff,4,0,25,21
1683362667279,USP 153,A00,187598,Staff,19,0,25,6
1683362668305,USP 168,A00,187607,Kwak; Nancy,2,0,5,3
1683362669334,USP 173,A00,187619,Staff,4,0,25,21
1683362670359,USP 181,A00,187638,Staff,0,3,25,25
1683362671388,VIS 103,A00,187650,Cruz; Edwin Teddy,22,0,75,53
1683362672415,VIS 110D,A00,187669,Staff,12,0,22,10
1683362673448,VIS 127C,A00,187720,Shen; Kuiyi,67,0,146,79
1683362674471,VIS 149,A00,187731,Yoldas; Pinar,0,14,22,22
1683362675499,VIS 151,A01,188091,Staff,22,0,34,12
1683362675499,VIS 151,A02,188092,Staff,11,0,34,23
1683362676527,VIS 160B,A00,188093,Stalbaum; Brett,0,0,10,10
1683362678583,WCWP 10B,A00,201720,Staff,10,0,15,5
1683362678583,WCWP 10B,B00,201722,Staff,9,0,15,6
1683362679609,WCWP 100,A00,201725,Gagnon; Jeffrey C,0,0,2,2
1683362679609,WCWP 100,B00,201727,Staff,0,4,15,15
1683362682724,ANBI 133,A00,258401,Wilder; Linnea Lorene,34,0,40,6
1683362683749,ANBI 140,A00,258395,Hrvoj Mihic; Branka,18,0,25,7
1683362684776,ANSC 120,A00,258402,Bialecki; Jon Anthony,27,0,40,13
1683362685805,ANSC 144,A00,258400,Staff,14,0,40,26
1683362687860,ANSC 166,A00,258396,Parish; Steven Martin,157,0,175,18
1683362688886,ANSC 180,A00,193533,Staff,9,0,20,11
1683362689917,ANSC 188,A00,258397,Jassal; Aftab,33,0,40,7
1683362690941,ANTH 3,A01,258316,Staff,23,0,30,7
1683362691966,ANTH 5,A00,258394,Semendeferi; Ekaterini,16,0,20,4
1683362692992,ANTH 21,A01,258331,Staff,8,0,40,32
1683362694018,ANTH 103,A00,258398,Varma; Saiba,15,0,25,10
1683362695048,AWP 10,001,202034,Staff,0,0,0,0
1683362695048,AWP 10,002,202035,Staff,0,0,0,0
1683362695048,AWP 10,003,202036,Staff,0,0,0,0
1683362695048,AWP 10,004,202037,Staff,0,0,0,0
1683362695048,AWP 10,005,202038,Staff,0,0,0,0
1683362695048,AWP 10,006,202039,Staff,0,0,0,0
1683362695048,AWP 10,007,202040,Staff,0,0,0,0
1683362695048,AWP 10,008,202041,Staff,0,0,0,0
1683362695048,AWP 10,009,202042,Staff,0,0,0,0
1683362695048,AWP 10,010,202043,Staff,0,0,0,0
1683362695048,AWP 10,011,202044,Staff,0,0,0,0
1683362695048,AWP 10,012,202045,Staff,0,0,0,0
1683362695048,AWP 10,013,202046,Staff,0,0,0,0
1683362695048,AWP 10,014,202047,Staff,0,0,0,0
1683362695048,AWP 10,015,202048,Staff,0,0,0,0
1683362695048,AWP 10,016,202049,Staff,0,0,0,0
1683362695048,AWP 10,017,202050,Staff,0,0,0,0
1683362695048,AWP 10,018,202051,Staff,0,0,0,0
1683362695048,AWP 10,019,202052,Staff,0,0,0,0
1683362695048,AWP 10,020,202053,Staff,0,0,0,0
1683362695048,AWP 10,021,202054,Staff,0,0,0,0
1683362695048,AWP 10,022,202055,Staff,0,0,0,0
1683362695048,AWP 10,023,202056,Staff,0,0,0,0
1683362695048,AWP 10,024,202057,Staff,0,0,0,0
1683362695048,AWP 10,025,202058,Staff,0,0,0,0
1683362695048,AWP 10,026,202059,Staff,0,0,0,0
1683362696072,AWP 102,001,202032,Staff,0,0,0,0
1683362696072,AWP 102,002,202033,Staff,0,0,0,0
1683362697098,BENG 100,A01,254234,Taylor Amos; Alyssa C,31,0,40,9
1683362698120,BENG 196,001,270013,Engler; Adam J.,9999,0,9999,0
1683362699148,BICD 100R,A01,202018,Smith; Laurie,0,7,32,32
1683362699148,BICD 100R,A02,202019,Smith; Laurie,0,2,32,32
1683362699148,BICD 100R,A03,202020,Smith; Laurie,0,1,32,32
1683362699148,BICD 100R,A04,202021,Smith; Laurie,9,0,32,23
1683362699148,BICD 100R,A05,202022,Smith; Laurie,12,0,32,20
1683362700174,BICD 136,A01,193242,Gustafson-Brown; Cindy,0,2,32,32
1683362700174,BICD 136,A02,193244,Gustafson-Brown; Cindy,14,0,32,18
1683362701202,BIEB 102,A01,193249,Butler; Shannon Rhey,0,2,32,32
1683362701202,BIEB 102,A02,193251,Butler; Shannon Rhey,0,0,32,32
1683362701202,BIEB 102,A03,193253,Butler; Shannon Rhey,0,1,32,32
1683362701202,BIEB 102,A04,193255,Butler; Shannon Rhey,17,0,32,15
1683362701202,BIEB 102,A05,193265,Butler; Shannon Rhey,26,0,32,6
1683362701202,BIEB 102,A06,193269,Butler; Shannon Rhey,16,0,32,16
1683362703251,BIEB 150,A01,193274,Staff,0,0,32,32
1683362703251,BIEB 150,A02,193285,Staff,23,0,32,9
1683362704281,BIEB 194,A00,193286,Kurle; Carolyn M.,22,0,32,10
1683362705312,BILD 1,A01,192291,Staff,16,0,32,16
1683362705312,BILD 1,A02,192292,Staff,30,0,32,2
1683362705312,BILD 1,B01,192520,Reuther; Keefe,0,1,0,0
1683362705312,BILD 1,B02,192532,Reuther; Keefe,0,1,0,0
1683362706345,BILD 3,A01,192556,Butler; Shannon Rhey,0,0,32,32
1683362706345,BILD 3,A02,192581,Butler; Shannon Rhey,4,0,32,28
1683362706345,BILD 3,A03,192611,Butler; Shannon Rhey,23,0,32,9
1683362706345,BILD 3,A04,192612,Butler; Shannon Rhey,25,0,32,7
1683362706345,BILD 3,A05,192613,Butler; Shannon Rhey,27,0,32,5
1683362706345,BILD 3,A06,192679,Butler; Shannon Rhey,27,0,32,5
1683362706345,BILD 3,A07,192682,Butler; Shannon Rhey,21,0,32,11
1683362707380,BILD 4,A01,192836,Reuther; Keefe,0,0,24,24
1683362707380,BILD 4,A02,193044,Reuther; Keefe,4,0,24,20
1683362708408,BILD 10,A01,193142,Gustafson-Brown; Cindy,30,0,32,2
1683362708408,BILD 10,A02,193149,Gustafson-Brown; Cindy,31,0,32,1
1683362709432,BIMM 100,A01,193301,Staff,1,6,32,31
1683362709432,BIMM 100,A02,193312,Staff,0,5,32,32
1683362709432,BIMM 100,A03,193323,Staff,0,8,32,32
1683362710459,BIMM 101,A01,193329,McDonnell; Lisa Marie,0,3,24,24
1683362710459,BIMM 101,A02,193339,McDonnell; Lisa Marie,0,3,24,24
1683362710459,BIMM 101,B01,193354,McDonnell; Lisa Marie,0,3,24,24
1683362710459,BIMM 101,B02,193357,McDonnell; Lisa Marie,0,3,24,24
1683362711486,BIMM 110,A01,193377,Tat; John,0,11,32,32
1683362711486,BIMM 110,A02,193378,Tat; John,0,9,32,32
1683362712516,BIMM 120,A01,206116,Staff,0,0,32,32
1683362712516,BIMM 120,A02,206117,Staff,8,0,32,24
1683362712516,BIMM 120,A03,206121,Staff,21,0,32,11
1683362713546,BIPN 100,A01,193393,Park; Ji Young,0,14,32,32
1683362713546,BIPN 100,A02,193402,Park; Ji Young,0,13,32,32
1683362713546,BIPN 100,A03,193413,Park; Ji Young,0,14,32,32
1683362713546,BIPN 100,A04,193414,Park; Ji Young,0,13,32,32
1683362714571,BIPN 102,A01,193429,Staff,0,0,32,32
1683362714571,BIPN 102,A02,193438,Staff,22,0,32,10
1683362715603,BIPN 106,A01,193450,Reyes Gonzalez; Catalina,0,2,40,40
1683362716629,BIPN 134,A01,193465,Cooke; James Edward,1,0,32,31
1683362716629,BIPN 134,A02,193474,Cooke; James Edward,25,0,32,7
1683362716629,BIPN 134,A03,193485,Cooke; James Edward,29,0,32,3
1683362716629,BIPN 134,A04,193486,Cooke; James Edward,21,0,32,11
1683362716629,BIPN 134,A05,193491,Cooke; James Edward,31,0,32,1
1683362716629,BIPN 134,A06,193501,Cooke; James Edward,30,0,32,2
1683362716629,BIPN 134,A07,193510,Cooke; James Edward,29,0,32,3
1683362718680,BISP 194,A00,222522,Staff,14,0,32,18
1683362719704,CAT 124,A01,202407,Staff,19,0,25,6
1683362720734,CAT 125,A00,202408,Marchisotto; Jennifer Anne,4,0,20,16
1683362721764,CAT 125R,A00,202409,Smith; Lauryn Alissa,0,11,20,20
1683362721764,CAT 125R,B00,202410,Morales; Celeste Georgianna,0,11,20,20
1683362721764,CAT 125R,C00,202411,Irwin; Matthew Joseph,0,10,20,20
1683362722792,CENG 15,A01,204712,Yang; Kesong,0,1,0,0
1683362723822,CENG 114,A00,202070,Jahed Motlagh; Zeinab,5,0,20,15
1683362724852,CGS 105,A00,185477,Wesling; Megan E.,24,0,40,16
1683362725878,CGS 106,A00,185494,Staff,13,0,22,9
1683362726905,CGS 108,A00,185495,Staff,14,0,20,6
1683362727932,CGS 114,A00,185496,Staff,13,0,18,5
1683362728956,CGS 119,A00,185501,Staff,15,0,20,5
1683362729981,CGS 120,A00,185511,Staff,13,0,20,7
1683362731009,CHEM 4,A01,184675,Bussey; Thomas J,96,0,100,4
1683362732037,CHEM 6A,A01,184677,Staff,34,0,60,26
1683362733062,CHEM 6B,A01,184679,Staff,65,0,100,35
1683362734087,CHEM 6C,A01,184681,Bussey; Thomas J,1,0,50,49
1683362734087,CHEM 6C,A02,184682,Bussey; Thomas J,34,0,50,16
1683362735113,CHEM 40A,A01,184684,Albizati; Kim F.,37,0,100,63
1683362736139,CHEM 40B,A01,184686,Albizati; Kim F.,0,20,100,100
1683362737223,CHEM 41B,A01,184690,Staff,52,0,100,48
1683362738252,COGS 3,A01,184715,Boyle; Mary E. T.,0,25,40,40
1683362739281,COGS 14B,A01,185172,Staff,0,15,38,38
1683362740309,COGS 18,A01,184736,Staff,16,0,80,64
1683362741333,COGS 100,A01,184932,Staff,0,5,73,73
1683362742358,COGS 101A,A01,184935,Staff,0,39,30,30
1683362743383,COGS 101B,A01,184944,Staff,0,2,30,30
1683362744407,COGS 101C,A01,184946,Staff,0,12,30,30
1683362745432,COGS 102A,A01,184951,Johnson; Christine M.,2,0,40,38
1683362746461,COGS 107B,A01,184953,Mooshagian; Eric Frederick,0,50,40,40
1683362747488,COGS 118B,A01,184959,Gupta; Anjum,0,48,40,40
1683362748515,COGS 153,A00,184961,Staff,0,15,30,30
1683362749538,COGS 177,A00,184962,Staff,0,20,30,30
1683362750570,COGS 187A,A01,184969,Boyle; Mary E. T.,0,17,40,40
1683362751594,COMM 10,A01,185174,Staff,0,5,25,25
1683362751594,COMM 10,A02,185189,Staff,0,5,25,25
1683362751594,COMM 10,A03,269821,Staff,0,0,0,0
1683362752625,COMM 100B,A01,185475,Staff,0,0,0,2
1683362752625,COMM 100B,A02,185476,Staff,13,0,25,12
1683362753650,COMM 100C,A01,185314,Staff,1,0,25,24
1683362753650,COMM 100C,A02,185327,Staff,19,0,25,6
1683362754675,COMM 110M,A00,185349,Staff,2,0,40,38
1683362755707,COMM 113T,A00,185352,Staff,24,0,40,16
1683362756732,COMM 114I,A00,185353,Staff,33,0,40,7
1683362757755,COMM 131,A00,185354,Staff,19,0,30,11
1683362758781,CSE 8A,A50,185358,Cao; Yingjun,0,46,10,10
1683362759811,CSE 8B,A01,185362,Staff,0,46,50,50
1683362760837,CSE 11,A01,185416,Cao; Yingjun,0,92,10,10
1683362761868,CSE 20,A01,185445,Briones; Jor-el Thomas Caparas,5,0,25,20
1683362762898,CSE 21,A01,185447,Staff,10,0,50,40
1683362763925,CSE 101,A01,185451,Staff,0,13,50,50
1683362763925,CSE 101,B01,185453,Jones; Miles E,0,11,50,50
1683362765977,CSE 141,A01,185458,Eldon; John,20,0,100,80
1683362767003,CSE 141L,A01,185461,Eldon; John,12,0,100,88
1683362768033,CSE 142,A01,185463,Staff,36,0,60,24
1683362768033,CSE 142,B01,201355,Staff,0,7,60,60
1683362769060,CSE 142L,A01,185470,Staff,36,0,60,24
1683362769060,CSE 142L,B01,201417,Staff,0,6,60,60
1683362770087,CSE 190,A00,201433,Staff,32,0,49,17
1683362771118,DOC 1,A01,259136,Strom; Megan C.,7,0,15,8
1683362771118,DOC 1,A02,259137,Strom; Megan C.,14,0,15,1
1683362771118,DOC 1,A03,259138,Strom; Megan C.,14,0,15,1
1683362771118,DOC 1,A04,259139,Strom; Megan C.,14,0,15,1
1683362772146,DOC 100D,A00,259140,Pass; Natalye Joann,16,0,25,9
1683362773172,DSGN 1,A01,184749,Rill; Bryan,0,25,30,30
1683362774201,DSGN 100,A01,185168,Staff,0,2,25,25
1683362775230,ECE 5,A01,185626,Morris; Karcher William,0,10,0,0
1683362776255,ECE 101,A01,185628,Staff,17,0,70,53
1683362777281,ECE 107,A01,185635,Baghdadchi; Saharnaz,0,0,20,20
1683362777281,ECE 107,A02,185638,Baghdadchi; Saharnaz,4,0,20,16
1683362778308,ECE 148,A01,185647,Silberman; Jack,0,0,16,16
1683362779338,ECON 1,A01,185537,Crane; Meredith Helen,54,0,70,16
1683362780366,ECON 3,A01,185549,Crane; Meredith Helen,32,0,70,38
1683362781396,ECON 4,A01,203354,Anderson; John Charles,0,4,10,10
1683362782425,ECON 100A,A01,185574,Staff,0,4,40,40
1683362783454,ECON 100B,A01,185576,Staff,0,12,50,50
1683362784479,ECON 100C,A01,185589,Newhouse; Herbert S,29,0,70,41
1683362785505,ECON 105,A00,185608,Vespa; Emanuel Ignacio,19,0,35,16
1683362786531,ECON 109,A01,185610,Shishkin; Denis,10,0,35,25
1683362787556,ECON 110A,A01,185612,Staff,11,0,40,29
1683362788583,ECON 120A,A01,185615,Staff,20,0,40,20
1683362789608,ECON 120C,A01,185617,Sun; Yixiao,0,21,70,70
1683362790633,ECON 144,A00,203346,Squires; Dale E,3,0,35,32
1683362791657,ECON 171,A01,203349,Newhouse; Herbert S,0,1,35,35
1683362792682,ECON 173A,A01,185621,Toda; Alexis Akira,21,0,35,14
1683362793708,EDS 25,A01,202413,Staff,0,1,0,0
1683362793708,EDS 25,A02,202414,Staff,0,1,0,0
1683362793708,EDS 25,A03,202415,Staff,0,0,0,0
1683362793708,EDS 25,A04,202416,Staff,0,1,0,0
1683362793708,EDS 25,A05,202439,Staff,0,0,0,0
1683362793708,EDS 25,A06,202440,Staff,0,0,0,0
1683362793708,EDS 25,B01,202631,Staff,0,0,0,0
1683362793708,EDS 25,B02,202632,Staff,0,0,0,0
1683362793708,EDS 25,B03,202639,Staff,0,0,0,0
1683362793708,EDS 25,B04,202640,Staff,0,0,0,0
1683362793708,EDS 25,B05,202643,Staff,0,0,0,0
1683362793708,EDS 25,B06,202644,Staff,0,0,0,0
1683362794737,EDS 38,A01,202659,Black; Alison Michelle,24,0,25,1
1683362795762,EDS 115,A00,202652,Staff,18,0,30,12
1683362796789,EDS 125,A00,202649,Staff,14,0,30,16
1683362797818,EDS 126,A01,203332,Staff,30,0,30,0
1683362798844,EDS 139,A00,202838,Staff,16,0,25,9
1683362799880,EDS 146,A01,202655,Staff,14,0,25,11
1683362800913,ENG 15,A00,185667,Staff,0,1,0,0
1683362800913,ENG 15,B00,185672,Staff,0,0,0,0
1683362800913,ENG 15,C00,185675,Staff,0,0,0,0
1683362800913,ENG 15,D00,185682,Staff,0,0,0,0
1683362800913,ENG 15,E00,185684,Staff,0,0,0,0
1683362801938,ETHN 103,A00,185710,Staff,0,4,35,35
1683362802964,ETHN 103A,A00,199228,Man; Simeon S,2,0,9,7
1683362803989,ETHN 109,A00,185711,Staff,18,0,35,17
1683362805015,ETHN 142,A00,185726,Staff,0,4,30,30
1683362806039,ETHN 163J,A00,199229,Man; Simeon S,5,0,8,3
1683362807065,ETHN 168,A00,185727,Staff,8,0,10,2
1683362808089,ETHN 182,A00,185728,Staff,0,0,35,35
1683362809118,ETHN 183,A00,185737,Staff,8,0,18,10
1683362810148,GLBH 111,A01,209361,Burgos; Jose L.,0,0,0,0
1683362812198,HIEU 104,A00,185792,Staff,16,0,20,4
1683362813227,HIEU 115,A00,185800,Staff,1,0,20,19
1683362814252,HIEU 128,A00,185801,Staff,0,7,20,20
1683362815276,HIEU 147,A00,185802,Staff,16,0,20,4
1683362816306,HIEU 154,A00,185823,Staff,12,0,20,8
1683362817330,HILA 102,A00,185826,Staff,13,0,20,7
1683362818354,HILD 2C,A01,185778,Staff,0,12,20,20
1683362819379,HILD 7B,A01,185780,Kwak; Nancy,0,15,32,32
1683362819379,HILD 7B,A02,185781,Kwak; Nancy,0,18,32,32
1683362820408,HILD 30,A01,185791,Staff,14,0,20,6
1683362821449,HISC 119,A00,185830,Golan; Tal,0,9,20,20
1683362822481,HITO 156GS,A00,185831,Patterson; Patrick H.,0,0,0,23
1683362823505,HIUS 103,A00,185832,Man; Simeon S,1,6,20,19
1683362824531,HIUS 117,A00,185836,Kwak; Nancy,2,0,20,18
1683362825555,HIUS 125,A00,185840,Man; Simeon S,0,0,23,23
1683362826584,HIUS 149,A00,185845,Staff,0,0,20,20
1683362827611,HUM 3,A01,185882,Zavodny; Tatiana Sophia,0,7,50,50
1683362827611,HUM 3,B01,185899,Caldwell; Michael Alan,0,18,50,50
1683362828636,HUM 3GS,A00,185900,Patterson; Patrick H.,0,0,0,23
1683362829664,HUM 4,A01,185938,Zroka; Amy Liane,31,0,50,19
1683362829664,HUM 4,B01,185956,Watkins; Eric,0,3,50,50
1683362829664,HUM 4,B02,202209,Watkins; Eric,0,2,50,50
1683362829664,HUM 4,B03,202210,Watkins; Eric,0,2,50,50
1683362830692,HUM 5,A01,185958,West; Geoffrey Scott,3,0,50,47
1683362830692,HUM 5,A02,202215,West; Geoffrey Scott,0,0,50,50
1683362831722,INTL 190,A00,185959,Gagnon; Jeffrey C,0,0,0,9
1683362831722,INTL 190,B00,185960,Lettieri; Michael Joseph,0,0,0,1
1683362832751,JAPN 180,A00,254509,Staff,4,0,30,26
1683362833788,LATI 10,A01,202853,Kennemore; Amy Michelle,4,0,35,31
1683362833788,LATI 10,A02,202854,Kennemore; Amy Michelle,2,0,35,33
1683362833788,LATI 10,A03,270054,Kennemore; Amy Michelle,30,0,30,0
1683362834816,LATI 180,A00,202855,Kennemore; Amy Michelle,11,0,20,9
1683362835846,LAWS 101,A00,201767,Golan; Tal,0,7,40,40
1683362836872,LIFR 1C,A00,185961,Staff,6,0,20,14
1683362837901,LIFR 1CX,A00,185962,Staff,7,0,20,13
1683362838927,LIFR 1D,A00,185963,Staff,9,0,20,11
1683362839952,LIFR 1DX,A00,185964,Staff,9,0,20,11
1683362841036,LIGN 101,A01,186039,Staff,43,0,50,7
1683362842060,LIGN 165,A00,186040,Staff,18,0,50,32
1683362843089,LTCS 108,A00,186041,Staff,6,0,10,4
1683362844113,LTCS 119,A00,186042,Staff,16,0,20,4
1683362845146,LTCS 130,A00,186043,Wesling; Megan E.,15,0,25,10
1683362847201,LTEA 138,A00,186119,Staff,14,0,40,26
1683362848223,LTEN 124,A00,186148,Staff,6,0,25,19
1683362849255,LTEN 178,A00,186149,Staff,7,0,15,8
1683362850284,LTEN 181,A00,186150,Blanco; John D,33,0,40,7
1683362851312,LTWL 120,A00,186160,Staff,20,0,25,5
1683362852343,LTWL 165,A00,186161,Staff,22,0,25,3
1683362853371,LTWR 100,A00,186162,Staff,0,5,15,15
1683362854398,LTWR 102,A00,186163,Doller; Ben,5,0,15,10
1683362855424,MAE 8,A01,186412,Staff,0,0,0,0
1683362856449,MAE 30B,A00,186445,Bahadori; Mohammad Yousef,83,0,100,17
1683362857472,MAE 40,A00,186592,Bewley; Thomas R,10,0,50,40
1683362858498,MAE 101B,A00,186593,Bahadori; Mohammad Yousef,81,0,100,19
1683362859526,MAE 105,A00,186594,Bandaru; Prabhakar,12,0,50,38
1683362860556,MAE 107,A00,186599,Pham; Hieu Tan,0,7,120,120
1683362861580,MAE 148,A01,186660,Silberman; Jack,3,0,16,13
1683362862606,MATH 10A,A01,188095,Staff,0,5,35,35
1683362863632,MATH 10B,A01,188097,Bowers; Adam R.,0,11,30,30
1683362863632,MATH 10B,A02,188099,Bowers; Adam R.,0,11,30,30
1683362863632,MATH 10B,B01,188104,Bowers; Adam R.,0,10,30,30
1683362863632,MATH 10B,B02,188106,Bowers; Adam R.,0,10,30,30
1683362864664,MATH 10C,A01,188111,Staff,0,18,30,30
1683362864664,MATH 10C,A02,188127,Staff,0,17,30,30
1683362864664,MATH 10C,A03,188131,Staff,0,18,30,30
1683362864664,MATH 10C,B01,188218,Staff,18,0,30,12
1683362864664,MATH 10C,B02,188244,Staff,13,0,30,17
1683362864664,MATH 10C,B03,188277,Staff,16,0,30,14
1683362865695,MATH 18,A01,188344,Bach; Quang Tran,18,0,30,12
1683362865695,MATH 18,A02,188345,Bach; Quang Tran,11,0,30,19
1683362865695,MATH 18,B01,188353,Bach; Quang Tran,10,0,30,20
1683362865695,MATH 18,B02,188354,Bach; Quang Tran,20,0,30,10
1683362866730,MATH 20A,A01,188374,Staff,12,0,35,23
1683362867758,MATH 20B,A01,188382,Ohm; Ko Woon,6,0,30,24
1683362867758,MATH 20B,A02,188383,Ohm; Ko Woon,21,0,30,9
1683362867758,MATH 20B,B01,188385,Ohm; Ko Woon,7,0,30,23
1683362867758,MATH 20B,B02,188392,Ohm; Ko Woon,22,0,30,8
1683362868784,MATH 20C,A01,188394,Harel; Guershon,10,0,30,20
1683362868784,MATH 20C,A02,188395,Harel; Guershon,15,0,30,15
1683362868784,MATH 20C,B01,188404,Harel; Guershon,4,0,30,26
1683362868784,MATH 20C,B02,188405,Harel; Guershon,19,0,30,11
1683362869814,MATH 20D,A01,188414,Hammock; Frances H,0,1,30,30
1683362869814,MATH 20D,A02,188415,Hammock; Frances H,3,0,30,27
1683362869814,MATH 20D,B01,188447,Hammock; Frances H,1,0,30,29
1683362869814,MATH 20D,B02,188486,Hammock; Frances H,8,0,30,22
1683362870840,MATH 20E,A01,188649,Staff,21,0,30,9
1683362870840,MATH 20E,A02,188650,Staff,23,0,30,7
1683362870840,MATH 20E,A03,188673,Staff,0,0,30,30
1683362871866,MATH 102,A01,188675,Staff,0,35,35,35
1683362872893,MATH 103B,A01,188681,Staff,3,0,35,32
1683362872893,MATH 103B,B01,188692,Staff,5,0,35,30
1683362873919,MATH 109,A01,188695,Salehi Golsefidy; Alireza,25,0,35,10
1683362873919,MATH 109,A02,188696,Salehi Golsefidy; Alireza,25,0,35,10
1683362874949,MATH 120A,A01,188698,Eggers; John Dietrich,7,0,35,28
1683362875975,MATH 142B,A01,188736,Ioana; Adrian,0,2,30,30
1683362875975,MATH 142B,A02,188741,Ioana; Adrian,0,0,30,30
1683362875975,MATH 142B,A03,188743,Ioana; Adrian,0,1,30,30
1683362877005,MATH 168A,A01,188790,Staff,0,9,35,35
1683362878030,MATH 170A,A01,188803,Nie; Jiawang,0,2,35,35
1683362878030,MATH 170A,A02,188811,Nie; Jiawang,0,0,35,35
1683362878030,MATH 170A,A03,188814,Nie; Jiawang,1,0,35,34
1683362878030,MATH 170A,A04,188815,Nie; Jiawang,13,0,35,22
1683362879059,MATH 193B,A01,188817,Staff,0,0,35,35
1683362879059,MATH 193B,A02,188818,Staff,5,0,35,30
1683362880085,MGT 4,A01,202857,Anderson; John Charles,61,0,80,19
1683362881111,MGT 12,A00,202858,Lindenberger; Wade Douglas,42,0,90,48
1683362882139,MGT 18,A00,202859,Staff,74,0,90,16
1683362883168,MGT 18GS,A00,202860,McKay; Michael J,13,0,28,15
1683362884194,MGT 45,A00,202861,Pecore; Joseph P.,15,0,90,75
1683362885224,MGT 100,A00,202863,Yavorsky; Daniel Ryan,28,0,90,62
1683362886254,MGT 103,A00,202864,Ehrich; Kristine R,0,17,90,90
1683362887283,MGT 112,A00,202865,Ehrich; Kristine R,15,0,90,75
1683362888315,MGT 121A,A00,202868,Staff,0,20,0,0
1683362889343,MGT 131B,A00,202869,Anderson; John Charles,59,0,90,31
1683362890373,MGT 136,A00,202871,Lindenberger; Wade Douglas,84,0,90,6
1683362891407,MGT 164,A00,202873,Staff,0,68,90,91
1683362892436,MGT 164GS,A00,202874,McKay; Mary A,13,0,28,15
1683362893464,MGT 180,A00,202875,Staff,0,50,90,91
1683362894498,MMW 11R,A01,205019,Herbst; Matthew,3,0,30,27
1683362894498,MMW 11R,A02,205026,Herbst; Matthew,29,0,30,1
1683362895529,MMW 15,A01,193512,Chang; Edmond Yi-Teh,0,9,28,28
1683362895529,MMW 15,A02,193513,Chang; Edmond Yi-Teh,0,5,28,28
1683362895529,MMW 15,A03,193514,Chang; Edmond Yi-Teh,0,5,28,28
1683362895529,MMW 15,A04,193515,Chang; Edmond Yi-Teh,0,5,28,28
1683362895529,MMW 15,A05,193516,Chang; Edmond Yi-Teh,0,4,28,28
1683362895529,MMW 15,A06,193517,Chang; Edmond Yi-Teh,0,5,28,28
1683362895529,MMW 15,B01,193519,Chang; Edmond Yi-Teh,0,5,28,28
1683362895529,MMW 15,B02,193520,Chang; Edmond Yi-Teh,0,5,28,28
1683362895529,MMW 15,B03,193521,Chang; Edmond Yi-Teh,0,5,28,28
1683362895529,MMW 15,B04,193522,Chang; Edmond Yi-Teh,0,4,28,28
1683362895529,MMW 15,B05,193523,Chang; Edmond Yi-Teh,0,5,28,28
1683362895529,MMW 15,B06,193524,Chang; Edmond Yi-Teh,0,4,28,28
1683362896557,MMW 122,A01,193526,Rahimi; Babak,0,15,28,28
1683362896557,MMW 122,A02,193527,Rahimi; Babak,0,14,28,28
1683362896557,MMW 122,A03,193528,Rahimi; Babak,0,0,0,0
1683362896557,MMW 122,A04,193529,Rahimi; Babak,0,0,0,0
1683362897583,MUS 1A,A01,186663,Staff,0,20,35,35
1683362898613,MUS 4,A01,186715,Staff,0,12,35,35
1683362899643,MUS 5R,A01,186796,Dubnov; Shlomo,0,17,35,35
1683362900671,MUS 6,A01,186798,Staff,0,4,25,25
1683362901695,MUS 7,A01,186830,Staff,13,0,35,22
1683362902721,MUS 8,A01,186930,Staff,0,26,35,35
1683362903748,MUS 15,A01,186932,Staff,0,16,35,35
1683362903748,MUS 15,B01,186934,Staff,0,15,35,35
1683362904783,MUS 80,A00,186935,Staff,0,0,20,20
1683362904783,MUS 80,B00,186936,Staff,25,0,25,0
1683362905809,NANO 11,A00,204702,Lipomi; Darren John,0,0,0,0
1683362906836,NANO 15,A01,204709,Yang; Kesong,0,1,0,0
1683362907868,NANO 114,A00,202069,Jahed Motlagh; Zeinab,3,0,10,7
1683362908894,PHIL 1,A00,186955,Grush; Rick Scott,32,0,40,8
1683362909920,PHIL 10,A01,186973,Grush; Rick Scott,28,0,35,7
1683362909920,PHIL 10,A02,186974,Grush; Rick Scott,33,0,35,2
1683362910945,PHIL 13,A01,186976,Staff,7,0,35,28
1683362910945,PHIL 13,A02,186977,Staff,16,0,35,19
1683362911970,PHIL 14,A01,186979,Staff,31,0,35,4
1683362911970,PHIL 14,A02,186986,Staff,32,0,35,3
1683362912997,PHIL 28,A01,186988,Staff,16,0,30,14
1683362912997,PHIL 28,A02,186989,Staff,1,0,30,29
1683362912997,PHIL 28,A03,186990,Staff,9,0,30,21
1683362912997,PHIL 28,A04,186991,Staff,26,0,30,4
1683362914022,PHIL 120,A00,186997,Staff,23,0,40,17
1683362915048,PHIL 137,A00,187003,Staff,9,0,40,31
1683362916074,PHIL 150,A00,187015,Staff,47,0,70,23
1683362917100,PHIL 167,A00,187021,Lamey; Andy M.,35,0,40,5
1683362918129,PHIL 174,A01,202226,Staff,17,0,20,3
1683362918129,PHIL 174,A02,202235,Staff,20,0,20,0
1683362919154,PHIL 191A,A00,258918,Staff,0,0,1,1
1683362920185,PHYS 1A,A00,187028,Staff,27,0,60,33
1683362921215,PHYS 1AL,001,187036,Staff,2,0,30,28
1683362921215,PHYS 1AL,002,187049,Staff,18,0,30,12
1683362922243,PHYS 1B,A00,187058,Staff,22,0,60,38
1683362923268,PHYS 1BL,001,187064,Staff,0,0,30,30
1683362923268,PHYS 1BL,002,187070,Staff,5,0,30,25
1683362924293,PHYS 1C,A00,187082,Staff,31,0,120,89
1683362925321,PHYS 1CL,001,187088,Staff,0,9,30,30
1683362925321,PHYS 1CL,002,187089,Staff,0,2,30,30
1683362925321,PHYS 1CL,009,262693,Staff,11,0,30,19
1683362926345,PHYS 2B,A01,187097,Staff,54,0,115,61
1683362927370,PHYS 2C,A01,187099,Staff,67,0,115,48
1683362928396,PHYS 2CL,A01,187101,Staff,5,0,28,23
1683362928396,PHYS 2CL,A02,187102,Staff,15,0,28,13
1683362929426,PHYS 2D,A01,187123,Shotwell; Brian,95,0,115,20
1683362930454,PHYS 4B,A01,187133,Grinstein; Benjamin,35,0,50,15
1683362931480,POLI 10,A00,188819,Staff,0,4,50,50
1683362932504,POLI 11,A00,188827,Staff,43,0,50,7
1683362933529,POLI 13R,A00,188828,Staff,0,1,20,20
1683362934556,POLI 27,A01,188830,Elgin; Samuel Zincke,0,1,70,70
1683362935582,POLI 30,A00,188832,Desposato; Scott,31,0,50,19
1683362936608,POLI 102F,A00,188834,Staff,3,0,40,37
1683362937638,POLI 104A,A00,188852,Staff,14,0,30,16
1683362938665,POLI 104I,A00,188853,Staff,0,6,20,20
1683362939697,POLI 110B,A00,188854,Wiens; David,7,0,20,13
1683362940722,POLI 112A,A00,188855,Wiens; David,5,0,30,25
1683362941747,POLI 117R,A00,188856,Forman; Fonna,0,11,20,20
1683362942774,POLI 118,A00,188857,Ingham; Sean,8,0,20,12
1683362943803,POLI 120G,A00,188858,Staff,9,0,30,21
1683362944903,POLI 131CR,A00,188863,Hoston; Germaine,23,0,50,27
1683362945926,POLI 133,A00,188864,Nellis; Gareth Hb,44,0,50,6
1683362946956,POLI 134D,A00,188865,Desposato; Scott,27,0,30,3
1683362947981,POLI 142A,A00,188871,Gartzke; Erik,22,0,50,28
1683362949006,POLI 142K,A00,188874,Staff,38,0,50,12
1683362950030,POLI 143,A00,188940,Gartzke; Erik,16,0,30,14
1683362951059,POLI 153,A00,188943,Staff,3,0,20,17
1683362952086,POLI 160AA,A00,188944,Staff,11,0,40,29
1683362953113,POLI 170A,A00,188945,Staff,11,0,30,19
1683362955165,PSYC 1,A00,188952,Staff,37,0,90,53
1683362956195,PSYC 2,B00,188953,Staff,19,0,35,16
1683362957221,PSYC 6,A00,188970,Staff,47,0,60,13
1683362958248,PSYC 7,A00,188973,Staff,37,0,45,8
1683362959279,PSYC 60,A01,188980,Rickard; Timothy C.,43,0,60,17
1683362960306,PSYC 70,A01,189001,Steiner; Eric Tomas,23,0,45,22
1683362961334,PSYC 100,A00,189005,Lacefield; Katharine I,0,98,120,120
1683362962357,PSYC 102,A00,189008,Staff,9,0,30,21
1683362963383,PSYC 106,B00,189026,Gorman; Michael R.,34,0,60,26
1683362964414,PSYC 114,B01,189033,Winkielman; Piotr,0,32,30,30
1683362965442,PSYC 131,A00,189036,Anagnostaras; Stephan,0,43,60,60
1683362966470,PSYC 136,A00,189041,Lowe; Angela Beth,0,7,25,25
1683362967498,PSYC 137,A00,189057,Winkielman; Piotr,0,34,25,25
1683362968524,PSYC 144,A00,189107,Wixted; John T,0,7,50,50
1683362970575,PSYC 162,A00,189142,Staff,0,8,85,85
1683362971605,PSYC 172,A00,189144,Gorman; Michael R.,0,7,30,30
1683362973661,PSYC 179,A00,189146,Lacefield; Katharine I,0,84,120,120
1683362974685,PSYC 181,A00,189147,Anagnostaras; Stephan,0,44,90,90
1683362975711,PSYC 190R,A00,189148,Barner; David A.,0,22,80,80
1683362976736,PSYC 191,A00,189275,Rickard; Timothy C.,0,7,25,25
1683362977764,PSYC 193,A00,189276,Chapman; Eddie Nathaniel,0,1,0,4
1683362978789,PSYC 193L,A01,189281,Lowe; Angela Beth,12,0,20,8
1683362978789,PSYC 193L,B01,189285,Staff,28,0,35,7
1683362979820,RELI 149,A00,187137,Rahimi; Babak,7,0,40,33
1683362980849,SE 9,A01,187315,Staff,0,2,18,18
1683362981875,SE 101B,A00,187409,Staff,24,0,30,6
1683362982904,SE 110B,A00,187444,Staff,10,0,40,30
1683362983932,SE 130B,A00,187449,Staff,31,0,40,9
1683362984962,SE 150A,A00,187516,Staff,9,0,20,11
1683362985986,SE 154,A00,187528,Staff,30,0,50,20
1683362987035,SIO 3,A01,258171,Staff,35,0,40,5
1683362988061,SIO 10,A00,187144,Cook; Geoffrey W,0,3,75,75
1683362989091,SIO 45,A00,187152,Cook; Geoffrey W,1,0,100,99
1683362990118,SIO 109R,A00,194486,Staff,0,3,20,20
1683362992170,SIO 187,A01,187233,Kacev; David,12,0,40,28
1683362993200,SOCI 1,A01,258656,Thorpe; Charles Robert,28,0,30,2
1683362993200,SOCI 1,A02,258658,Thorpe; Charles Robert,30,0,30,0
1683362993200,SOCI 1,A03,258661,Thorpe; Charles Robert,25,0,25,0
1683362993200,SOCI 1,A04,258666,Thorpe; Charles Robert,22,0,25,3
1683362993200,SOCI 1,A05,258897,Thorpe; Charles Robert,23,0,25,2
1683362993200,SOCI 1,A06,258898,Thorpe; Charles Robert,25,0,25,0
1683362994230,SOCI 30,A01,258903,Pardo Guerra; Juan Pablo,15,0,30,15
1683362995254,SOCI 102,A00,258904,Staff,9,0,25,16
1683362996278,SOCI 106,A00,258905,Staff,19,0,25,6
1683362997301,SOCI 111,A00,258907,Ribas Norris; Janet Vanesa,26,0,30,4
1683362998327,SOCI 121R,A00,258908,Pardo Guerra; Juan Pablo,10,0,30,20
1683362999356,SOCI 126,A01,203330,Staff,14,0,20,6
1683363000383,SOCI 131,A00,258909,Thorpe; Charles Robert,31,0,60,29
1683363001409,SOCI 135,A00,258910,Payne; Christine Anna,0,9,30,30
1683363002433,SOCI 157,A00,258911,Staff,12,0,30,18
1683363003458,SOCI 184,A00,258912,Staff,25,0,30,5
1683363004483,SOCI 188D,A00,258913,Staff,22,0,30,8
1683363005516,SYN 2,001,187529,Staff,10,0,16,6
1683363005516,SYN 2,002,201452,Staff,0,18,16,16
1683363005516,SYN 2,003,201469,Staff,3,0,16,13
1683363006543,SYN 100,A01,187531,Staff,0,9,20,20
1683363006543,SYN 100,B01,201491,Staff,0,12,20,20
1683363007569,TDAC 1,A00,189286,Walsh; Kim C.,3,0,20,17
1683363007569,TDAC 1,B00,189287,Harting; Carla Kelso,11,0,20,9
1683363008594,TDAC 101,A00,189300,Walsh; Kim C.,16,0,20,4
1683363008594,TDAC 101,B00,189301,Harting; Carla Kelso,18,0,20,2
1683363009624,TDAC 102,A00,189304,Basso; Beatrice,14,0,20,6
1683363010657,TDAC 108,A00,189305,Staff,18,0,20,2
1683363011685,TDDE 131,A00,189310,Staff,19,0,20,1
1683363011685,TDDE 131,B00,189314,Staff,19,0,20,1
1683363011685,TDDE 131,C00,189315,Staff,48,0,50,2
1683363011685,TDDE 131,D00,189316,Staff,14,0,15,1
1683363011685,TDDE 131,E00,204841,Staff,20,0,20,0
1683363012710,TDGE 10,A00,189289,Staff,30,0,50,20
1683363012710,TDGE 10,B00,189290,Havis; Allan,1,0,50,49
1683363013737,TDGE 11,A00,189291,Fulton; Julia,0,3,50,50
1683363013737,TDGE 11,B00,189292,Staff,20,0,25,5
1683363013737,TDGE 11,C00,260270,Staff,0,0,0,0
1683363014762,TDGE 25,A00,189294,Staff,3,0,20,17
1683363015788,TDGE 124,A00,189318,Fulton; Julia,0,8,50,50
1683363016816,TDGE 125,A00,189319,Staff,13,0,25,12
1683363016816,TDGE 125,B00,189320,Staff,23,0,25,2
1683363017844,TDGE 127,A00,189322,Havis; Allan,0,0,50,50
1683363018868,TDHT 101,A00,189323,Staff,18,0,25,7
1683363018868,TDHT 101,B00,189324,Staff,25,0,25,0
1683363019896,TDHT 102,A00,189325,Staff,49,0,50,1
1683363020925,TDMV 1,A00,189295,Arcidiacono; Kristin,19,0,30,11
1683363020925,TDMV 1,B00,189296,Caligagan; Maria T.,24,0,30,6
1683363021949,TDMV 2,A00,189297,Sammartano; Tonnie,28,0,30,2
1683363021949,TDMV 2,B00,189299,Arcidiacono; Kristin,24,0,30,6
1683363022982,TDMV 3,A00,204998,Rincon; Alicia,22,0,30,8
1683363024014,TDMV 120,A00,189458,Sammartano; Tonnie,28,0,30,2
1683363025042,TDMV 138,A00,189541,Jun; Grace Shin Hae,22,0,40,18
1683363026073,TDMV 142,A00,189717,Caligagan; Tony,24,0,30,6
1683363026073,TDMV 142,B00,189718,Caligagan; Maria T.,25,0,30,5
1683363027101,TMC 2,A01,187533,Staff,25,0,25,0
1683363027101,TMC 2,A02,187534,Staff,25,0,25,0
1683363028126,USP 1,A01,187536,Kwak; Nancy,0,16,25,25
1683363029151,USP 5,A01,187538,Staff,10,0,25,15
1683363030177,USP 101,A00,199253,Staff,0,4,0,0
1683363031205,USP 124,A00,187562,Boomhower; Matthew Charles,1,0,30,29
1683363032230,USP 138,A00,187582,Staff,20,0,25,5
1683363033255,USP 152,A01,187597,Staff,4,0,25,21
1683363034280,USP 153,A00,187598,Staff,19,0,25,6
1683363035305,USP 168,A00,187607,Kwak; Nancy,2,0,5,3
1683363036335,USP 173,A00,187619,Staff,4,0,25,21
1683363037363,USP 181,A00,187638,Staff,0,3,25,25
1683363038393,VIS 103,A00,187650,Cruz; Edwin Teddy,22,0,75,53
1683363039417,VIS 110D,A00,187669,Staff,12,0,22,10
1683363040441,VIS 127C,A00,187720,Shen; Kuiyi,67,0,146,79
1683363041465,VIS 149,A00,187731,Yoldas; Pinar,0,14,22,22
1683363042488,VIS 151,A01,188091,Staff,22,0,34,12
1683363042488,VIS 151,A02,188092,Staff,11,0,34,23
1683363043512,VIS 160B,A00,188093,Stalbaum; Brett,0,0,10,10
1683363045561,WCWP 10B,A00,201720,Staff,10,0,15,5
1683363045561,WCWP 10B,B00,201722,Staff,9,0,15,6
1683363046588,WCWP 100,A00,201725,Gagnon; Jeffrey C,0,0,2,2
1683363046588,WCWP 100,B00,201727,Staff,0,4,15,15
1683363049787,ANBI 133,A00,258401,Wilder; Linnea Lorene,34,0,40,6
1683363050815,ANBI 140,A00,258395,Hrvoj Mihic; Branka,18,0,25,7
1683363051840,ANSC 120,A00,258402,Bialecki; Jon Anthony,27,0,40,13
1683363052864,ANSC 144,A00,258400,Staff,14,0,40,26
1683363054917,ANSC 166,A00,258396,Parish; Steven Martin,157,0,175,18
1683363055946,ANSC 180,A00,193533,Staff,9,0,20,11
1683363056974,ANSC 188,A00,258397,Jassal; Aftab,33,0,40,7
1683363058006,ANTH 3,A01,258316,Staff,23,0,30,7
1683363059035,ANTH 5,A00,258394,Semendeferi; Ekaterini,16,0,20,4
1683363060063,ANTH 21,A01,258331,Staff,8,0,40,32
1683363061090,ANTH 103,A00,258398,Varma; Saiba,15,0,25,10
1683363062126,AWP 10,001,202034,Staff,0,0,0,0
1683363062126,AWP 10,002,202035,Staff,0,0,0,0
1683363062126,AWP 10,003,202036,Staff,0,0,0,0
1683363062126,AWP 10,004,202037,Staff,0,0,0,0
1683363062126,AWP 10,005,202038,Staff,0,0,0,0
1683363062126,AWP 10,006,202039,Staff,0,0,0,0
1683363062126,AWP 10,007,202040,Staff,0,0,0,0
1683363062126,AWP 10,008,202041,Staff,0,0,0,0
1683363062126,AWP 10,009,202042,Staff,0,0,0,0
1683363062126,AWP 10,010,202043,Staff,0,0,0,0
1683363062126,AWP 10,011,202044,Staff,0,0,0,0
1683363062126,AWP 10,012,202045,Staff,0,0,0,0
1683363062126,AWP 10,013,202046,Staff,0,0,0,0
1683363062126,AWP 10,014,202047,Staff,0,0,0,0
1683363062126,AWP 10,015,202048,Staff,0,0,0,0
1683363062126,AWP 10,016,202049,Staff,0,0,0,0
1683363062126,AWP 10,017,202050,Staff,0,0,0,0
1683363062126,AWP 10,018,202051,Staff,0,0,0,0
1683363062126,AWP 10,019,202052,Staff,0,0,0,0
1683363062126,AWP 10,020,202053,Staff,0,0,0,0
1683363062126,AWP 10,021,202054,Staff,0,0,0,0
1683363062126,AWP 10,022,202055,Staff,0,0,0,0
1683363062126,AWP 10,023,202056,Staff,0,0,0,0
1683363062126,AWP 10,024,202057,Staff,0,0,0,0
1683363062126,AWP 10,025,202058,Staff,0,0,0,0
1683363062126,AWP 10,026,202059,Staff,0,0,0,0
1683363063150,AWP 102,001,202032,Staff,0,0,0,0
1683363063150,AWP 102,002,202033,Staff,0,0,0,0
1683363064182,BENG 100,A01,254234,Taylor Amos; Alyssa C,31,0,40,9
1683363065209,BENG 196,001,270013,Engler; Adam J.,9999,0,9999,0
1683363066243,BICD 100R,A01,202018,Smith; Laurie,0,7,32,32
1683363066243,BICD 100R,A02,202019,Smith; Laurie,0,2,32,32
1683363066243,BICD 100R,A03,202020,Smith; Laurie,0,1,32,32
1683363066243,BICD 100R,A04,202021,Smith; Laurie,9,0,32,23
1683363066243,BICD 100R,A05,202022,Smith; Laurie,12,0,32,20
1683363067270,BICD 136,A01,193242,Gustafson-Brown; Cindy,0,2,32,32
1683363067270,BICD 136,A02,193244,Gustafson-Brown; Cindy,14,0,32,18
1683363068306,BIEB 102,A01,193249,Butler; Shannon Rhey,0,2,32,32
1683363068306,BIEB 102,A02,193251,Butler; Shannon Rhey,0,0,32,32
1683363068306,BIEB 102,A03,193253,Butler; Shannon Rhey,0,1,32,32
1683363068306,BIEB 102,A04,193255,Butler; Shannon Rhey,17,0,32,15
1683363068306,BIEB 102,A05,193265,Butler; Shannon Rhey,26,0,32,6
1683363068306,BIEB 102,A06,193269,Butler; Shannon Rhey,16,0,32,16
1683363070360,BIEB 150,A01,193274,Staff,0,0,32,32
1683363070360,BIEB 150,A02,193285,Staff,23,0,32,9
1683363071386,BIEB 194,A00,193286,Kurle; Carolyn M.,22,0,32,10
1683363072413,BILD 1,A01,192291,Staff,16,0,32,16
1683363072413,BILD 1,A02,192292,Staff,30,0,32,2
1683363072413,BILD 1,B01,192520,Reuther; Keefe,0,1,0,0
1683363072413,BILD 1,B02,192532,Reuther; Keefe,0,1,0,0
1683363073439,BILD 3,A01,192556,Butler; Shannon Rhey,0,0,32,32
1683363073439,BILD 3,A02,192581,Butler; Shannon Rhey,4,0,32,28
1683363073439,BILD 3,A03,192611,Butler; Shannon Rhey,23,0,32,9
1683363073439,BILD 3,A04,192612,Butler; Shannon Rhey,25,0,32,7
1683363073439,BILD 3,A05,192613,Butler; Shannon Rhey,27,0,32,5
1683363073439,BILD 3,A06,192679,Butler; Shannon Rhey,27,0,32,5
1683363073439,BILD 3,A07,192682,Butler; Shannon Rhey,21,0,32,11
1683363074465,BILD 4,A01,192836,Reuther; Keefe,0,0,24,24
1683363074465,BILD 4,A02,193044,Reuther; Keefe,4,0,24,20
1683363075496,BILD 10,A01,193142,Gustafson-Brown; Cindy,30,0,32,2
1683363075496,BILD 10,A02,193149,Gustafson-Brown; Cindy,31,0,32,1
1683363076526,BIMM 100,A01,193301,Staff,1,6,32,31
1683363076526,BIMM 100,A02,193312,Staff,0,5,32,32
1683363076526,BIMM 100,A03,193323,Staff,0,8,32,32
1683363077552,BIMM 101,A01,193329,McDonnell; Lisa Marie,0,3,24,24
1683363077552,BIMM 101,A02,193339,McDonnell; Lisa Marie,0,3,24,24
1683363077552,BIMM 101,B01,193354,McDonnell; Lisa Marie,0,3,24,24
1683363077552,BIMM 101,B02,193357,McDonnell; Lisa Marie,0,3,24,24
1683363078580,BIMM 110,A01,193377,Tat; John,0,11,32,32
1683363078580,BIMM 110,A02,193378,Tat; John,0,9,32,32
1683363079606,BIMM 120,A01,206116,Staff,0,0,32,32
1683363079606,BIMM 120,A02,206117,Staff,8,0,32,24
1683363079606,BIMM 120,A03,206121,Staff,21,0,32,11
1683363080633,BIPN 100,A01,193393,Park; Ji Young,0,14,32,32
1683363080633,BIPN 100,A02,193402,Park; Ji Young,0,13,32,32
1683363080633,BIPN 100,A03,193413,Park; Ji Young,0,14,32,32
1683363080633,BIPN 100,A04,193414,Park; Ji Young,0,13,32,32
1683363081660,BIPN 102,A01,193429,Staff,0,0,32,32
1683363081660,BIPN 102,A02,193438,Staff,22,0,32,10
1683363082688,BIPN 106,A01,193450,Reyes Gonzalez; Catalina,0,2,40,40
1683363083718,BIPN 134,A01,193465,Cooke; James Edward,1,0,32,31
1683363083718,BIPN 134,A02,193474,Cooke; James Edward,25,0,32,7
1683363083718,BIPN 134,A03,193485,Cooke; James Edward,29,0,32,3
1683363083718,BIPN 134,A04,193486,Cooke; James Edward,21,0,32,11
1683363083718,BIPN 134,A05,193491,Cooke; James Edward,31,0,32,1
1683363083718,BIPN 134,A06,193501,Cooke; James Edward,30,0,32,2
1683363083718,BIPN 134,A07,193510,Cooke; James Edward,29,0,32,3
1683363085770,BISP 194,A00,222522,Staff,14,0,32,18
1683363086797,CAT 124,A01,202407,Staff,19,0,25,6
1683363087823,CAT 125,A00,202408,Marchisotto; Jennifer Anne,4,0,20,16
1683363088848,CAT 125R,A00,202409,Smith; Lauryn Alissa,0,11,20,20
1683363088848,CAT 125R,B00,202410,Morales; Celeste Georgianna,0,11,20,20
1683363088848,CAT 125R,C00,202411,Irwin; Matthew Joseph,0,10,20,20
1683363089872,CENG 15,A01,204712,Yang; Kesong,0,1,0,0
1683363090901,CENG 114,A00,202070,Jahed Motlagh; Zeinab,5,0,20,15
1683363091930,CGS 105,A00,185477,Wesling; Megan E.,24,0,40,16
1683363092953,CGS 106,A00,185494,Staff,13,0,22,9
1683363093977,CGS 108,A00,185495,Staff,14,0,20,6
1683363095004,CGS 114,A00,185496,Staff,13,0,18,5
1683363096032,CGS 119,A00,185501,Staff,15,0,20,5
1683363097056,CGS 120,A00,185511,Staff,13,0,20,7
1683363098082,CHEM 4,A01,184675,Bussey; Thomas J,96,0,100,4
1683363099111,CHEM 6A,A01,184677,Staff,34,0,60,26
1683363100140,CHEM 6B,A01,184679,Staff,65,0,100,35
1683363101164,CHEM 6C,A01,184681,Bussey; Thomas J,1,0,50,49
1683363101164,CHEM 6C,A02,184682,Bussey; Thomas J,34,0,50,16
1683363102194,CHEM 40A,A01,184684,Albizati; Kim F.,37,0,100,63
1683363103218,CHEM 40B,A01,184686,Albizati; Kim F.,0,20,100,100
1683363104244,CHEM 41B,A01,184690,Staff,52,0,100,48
1683363105267,COGS 3,A01,184715,Boyle; Mary E. T.,0,25,40,40
1683363106293,COGS 14B,A01,185172,Staff,0,15,38,38
1683363107323,COGS 18,A01,184736,Staff,16,0,80,64
1683363108352,COGS 100,A01,184932,Staff,0,5,73,73
1683363109380,COGS 101A,A01,184935,Staff,0,39,30,30
1683363110406,COGS 101B,A01,184944,Staff,0,2,30,30
1683363111438,COGS 101C,A01,184946,Staff,0,12,30,30
1683363112466,COGS 102A,A01,184951,Johnson; Christine M.,2,0,40,38
1683363113492,COGS 107B,A01,184953,Mooshagian; Eric Frederick,0,50,40,40
1683363114523,COGS 118B,A01,184959,Gupta; Anjum,0,48,40,40
1683363115551,COGS 153,A00,184961,Staff,0,15,30,30
1683363116578,COGS 177,A00,184962,Staff,0,20,30,30
1683363117604,COGS 187A,A01,184969,Boyle; Mary E. T.,0,17,40,40
1683363118631,COMM 10,A01,185174,Staff,0,5,25,25
1683363118631,COMM 10,A02,185189,Staff,0,5,25,25
1683363118631,COMM 10,A03,269821,Staff,0,0,0,0
1683363119658,COMM 100B,A01,185475,Staff,0,0,0,2
1683363119658,COMM 100B,A02,185476,Staff,13,0,25,12
1683363120685,COMM 100C,A01,185314,Staff,1,0,25,24
1683363120685,COMM 100C,A02,185327,Staff,19,0,25,6
1683363121712,COMM 110M,A00,185349,Staff,2,0,40,38
1683363122737,COMM 113T,A00,185352,Staff,24,0,40,16
1683363123769,COMM 114I,A00,185353,Staff,33,0,40,7
1683363124799,COMM 131,A00,185354,Staff,19,0,30,11
1683363125828,CSE 8A,A50,185358,Cao; Yingjun,0,46,10,10
1683363126858,CSE 8B,A01,185362,Staff,0,46,50,50
1683363127888,CSE 11,A01,185416,Cao; Yingjun,0,92,10,10
1683363128914,CSE 20,A01,185445,Briones; Jor-el Thomas Caparas,5,0,25,20
1683363129942,CSE 21,A01,185447,Staff,10,0,50,40
1683363130974,CSE 101,A01,185451,Staff,0,13,50,50
1683363130974,CSE 101,B01,185453,Jones; Miles E,0,11,50,50
1683363133031,CSE 141,A01,185458,Eldon; John,20,0,100,80
1683363134063,CSE 141L,A01,185461,Eldon; John,12,0,100,88
1683363135100,CSE 142,A01,185463,Staff,36,0,60,24
1683363135100,CSE 142,B01,201355,Staff,0,7,60,60
1683363136125,CSE 142L,A01,185470,Staff,36,0,60,24
1683363136125,CSE 142L,B01,201417,Staff,0,6,60,60
1683363137151,CSE 190,A00,201433,Staff,32,0,49,17
1683363138181,DOC 1,A01,259136,Strom; Megan C.,7,0,15,8
1683363138181,DOC 1,A02,259137,Strom; Megan C.,14,0,15,1
1683363138181,DOC 1,A03,259138,Strom; Megan C.,14,0,15,1
1683363138181,DOC 1,A04,259139,Strom; Megan C.,14,0,15,1
1683363139206,DOC 100D,A00,259140,Pass; Natalye Joann,16,0,25,9
1683363140231,DSGN 1,A01,184749,Rill; Bryan,0,25,30,30
1683363141262,DSGN 100,A01,185168,Staff,0,2,25,25
1683363142293,ECE 5,A01,185626,Morris; Karcher William,0,10,0,0
1683363143323,ECE 101,A01,185628,Staff,17,0,70,53
1683363144353,ECE 107,A01,185635,Baghdadchi; Saharnaz,0,0,20,20
1683363144353,ECE 107,A02,185638,Baghdadchi; Saharnaz,4,0,20,16
1683363145379,ECE 148,A01,185647,Silberman; Jack,0,0,16,16
1683363146404,ECON 1,A01,185537,Crane; Meredith Helen,54,0,70,16
1683363147433,ECON 3,A01,185549,Crane; Meredith Helen,32,0,70,38
1683363148460,ECON 4,A01,203354,Anderson; John Charles,0,4,10,10
1683363149489,ECON 100A,A01,185574,Staff,0,4,40,40
1683363150515,ECON 100B,A01,185576,Staff,0,12,50,50
1683363151541,ECON 100C,A01,185589,Newhouse; Herbert S,29,0,70,41
1683363152625,ECON 105,A00,185608,Vespa; Emanuel Ignacio,19,0,35,16
1683363153650,ECON 109,A01,185610,Shishkin; Denis,10,0,35,25
1683363154675,ECON 110A,A01,185612,Staff,11,0,40,29
1683363155700,ECON 120A,A01,185615,Staff,20,0,40,20
1683363156726,ECON 120C,A01,185617,Sun; Yixiao,0,21,70,70
1683363157752,ECON 144,A00,203346,Squires; Dale E,3,0,35,32
1683363158777,ECON 171,A01,203349,Newhouse; Herbert S,0,1,35,35
1683363159809,ECON 173A,A01,185621,Toda; Alexis Akira,21,0,35,14
1683363160844,EDS 25,A01,202413,Staff,0,1,0,0
1683363160844,EDS 25,A02,202414,Staff,0,1,0,0
1683363160844,EDS 25,A03,202415,Staff,0,0,0,0
1683363160844,EDS 25,A04,202416,Staff,0,1,0,0
1683363160844,EDS 25,A05,202439,Staff,0,0,0,0
1683363160844,EDS 25,A06,202440,Staff,0,0,0,0
1683363160844,EDS 25,B01,202631,Staff,0,0,0,0
1683363160844,EDS 25,B02,202632,Staff,0,0,0,0
1683363160844,EDS 25,B03,202639,Staff,0,0,0,0
1683363160844,EDS 25,B04,202640,Staff,0,0,0,0
1683363160844,EDS 25,B05,202643,Staff,0,0,0,0
1683363160844,EDS 25,B06,202644,Staff,0,0,0,0
1683363161870,EDS 38,A01,202659,Black; Alison Michelle,24,0,25,1
1683363162894,EDS 115,A00,202652,Staff,18,0,30,12
1683363163921,EDS 125,A00,202649,Staff,14,0,30,16
1683363164946,EDS 126,A01,203332,Staff,30,0,30,0
1683363165973,EDS 139,A00,202838,Staff,16,0,25,9
1683363167005,EDS 146,A01,202655,Staff,14,0,25,11
1683363168048,ENG 15,A00,185667,Staff,0,1,0,0
1683363168048,ENG 15,B00,185672,Staff,0,0,0,0
1683363168048,ENG 15,C00,185675,Staff,0,0,0,0
1683363168048,ENG 15,D00,185682,Staff,0,0,0,0
1683363168048,ENG 15,E00,185684,Staff,0,0,0,0
1683363169073,ETHN 103,A00,185710,Staff,0,4,35,35
1683363170105,ETHN 103A,A00,199228,Man; Simeon S,2,0,9,7
1683363171133,ETHN 109,A00,185711,Staff,18,0,35,17
1683363172161,ETHN 142,A00,185726,Staff,0,4,30,30
1683363173188,ETHN 163J,A00,199229,Man; Simeon S,5,0,8,3
1683363174217,ETHN 168,A00,185727,Staff,8,0,10,2
1683363175242,ETHN 182,A00,185728,Staff,0,0,35,35
1683363176270,ETHN 183,A00,185737,Staff,8,0,18,10
1683363177298,GLBH 111,A01,209361,Burgos; Jose L.,0,0,0,0
1683363179355,HIEU 104,A00,185792,Staff,16,0,20,4
1683363180382,HIEU 115,A00,185800,Staff,1,0,20,19
1683363181412,HIEU 128,A00,185801,Staff,0,7,20,20
1683363182441,HIEU 147,A00,185802,Staff,16,0,20,4
1683363183471,HIEU 154,A00,185823,Staff,12,0,20,8
1683363184495,HILA 102,A00,185826,Staff,13,0,20,7
1683363185519,HILD 2C,A01,185778,Staff,0,12,20,20
1683363186545,HILD 7B,A01,185780,Kwak; Nancy,0,15,32,32
1683363186545,HILD 7B,A02,185781,Kwak; Nancy,0,18,32,32
1683363187575,HILD 30,A01,185791,Staff,14,0,20,6
1683363188600,HISC 119,A00,185830,Golan; Tal,0,9,20,20
1683363189626,HITO 156GS,A00,185831,Patterson; Patrick H.,0,0,0,23
1683363190650,HIUS 103,A00,185832,Man; Simeon S,1,6,20,19
1683363191676,HIUS 117,A00,185836,Kwak; Nancy,2,0,20,18
1683363192701,HIUS 125,A00,185840,Man; Simeon S,0,0,23,23
1683363193727,HIUS 149,A00,185845,Staff,0,0,20,20
1683363194755,HUM 3,A01,185882,Zavodny; Tatiana Sophia,0,7,50,50
1683363194755,HUM 3,B01,185899,Caldwell; Michael Alan,0,18,50,50
1683363195781,HUM 3GS,A00,185900,Patterson; Patrick H.,0,0,0,23
1683363196807,HUM 4,A01,185938,Zroka; Amy Liane,31,0,50,19
1683363196807,HUM 4,B01,185956,Watkins; Eric,0,3,50,50
1683363196807,HUM 4,B02,202209,Watkins; Eric,0,2,50,50
1683363196807,HUM 4,B03,202210,Watkins; Eric,0,2,50,50
1683363197836,HUM 5,A01,185958,West; Geoffrey Scott,3,0,50,47
1683363197836,HUM 5,A02,202215,West; Geoffrey Scott,0,0,50,50
1683363198864,INTL 190,A00,185959,Gagnon; Jeffrey C,0,0,0,9
1683363198864,INTL 190,B00,185960,Lettieri; Michael Joseph,0,0,0,1
1683363199891,JAPN 180,A00,254509,Staff,4,0,30,26
1683363200925,LATI 10,A01,202853,Kennemore; Amy Michelle,4,0,35,31
1683363200925,LATI 10,A02,202854,Kennemore; Amy Michelle,2,0,35,33
1683363200925,LATI 10,A03,270054,Kennemore; Amy Michelle,30,0,30,0
1683363201954,LATI 180,A00,202855,Kennemore; Amy Michelle,11,0,20,9
1683363202980,LAWS 101,A00,201767,Golan; Tal,0,7,40,40
1683363204007,LIFR 1C,A00,185961,Staff,6,0,20,14
1683363205038,LIFR 1CX,A00,185962,Staff,7,0,20,13
1683363206064,LIFR 1D,A00,185963,Staff,9,0,20,11
1683363207091,LIFR 1DX,A00,185964,Staff,9,0,20,11
1683363208117,LIGN 101,A01,186039,Staff,43,0,50,7
1683363209142,LIGN 165,A00,186040,Staff,18,0,50,32
1683363210170,LTCS 108,A00,186041,Staff,6,0,10,4
1683363211198,LTCS 119,A00,186042,Staff,16,0,20,4
1683363212226,LTCS 130,A00,186043,Wesling; Megan E.,15,0,25,10
1683363214277,LTEA 138,A00,186119,Staff,14,0,40,26
1683363215304,LTEN 124,A00,186148,Staff,6,0,25,19
1683363216328,LTEN 178,A00,186149,Staff,7,0,15,8
1683363217358,LTEN 181,A00,186150,Blanco; John D,33,0,40,7
1683363218382,LTWL 120,A00,186160,Staff,20,0,25,5
1683363219408,LTWL 165,A00,186161,Staff,22,0,25,3
1683363220433,LTWR 100,A00,186162,Staff,0,5,15,15
1683363221458,LTWR 102,A00,186163,Doller; Ben,5,0,15,10
1683363222486,MAE 8,A01,186412,Staff,0,0,0,0
1683363223515,MAE 30B,A00,186445,Bahadori; Mohammad Yousef,83,0,100,17
1683363224544,MAE 40,A00,186592,Bewley; Thomas R,10,0,50,40
1683363225568,MAE 101B,A00,186593,Bahadori; Mohammad Yousef,81,0,100,19
1683363226594,MAE 105,A00,186594,Bandaru; Prabhakar,12,0,50,38
1683363227619,MAE 107,A00,186599,Pham; Hieu Tan,0,7,120,120
1683363228643,MAE 148,A01,186660,Silberman; Jack,3,0,16,13
1683363229677,MATH 10A,A01,188095,Staff,0,5,35,35
1683363230708,MATH 10B,A01,188097,Bowers; Adam R.,0,11,30,30
1683363230708,MATH 10B,A02,188099,Bowers; Adam R.,0,11,30,30
1683363230708,MATH 10B,B01,188104,Bowers; Adam R.,0,10,30,30
1683363230708,MATH 10B,B02,188106,Bowers; Adam R.,0,10,30,30
1683363231735,MATH 10C,A01,188111,Staff,0,18,30,30
1683363231735,MATH 10C,A02,188127,Staff,0,17,30,30
1683363231735,MATH 10C,A03,188131,Staff,0,18,30,30
1683363231735,MATH 10C,B01,188218,Staff,18,0,30,12
1683363231735,MATH 10C,B02,188244,Staff,13,0,30,17
1683363231735,MATH 10C,B03,188277,Staff,16,0,30,14
1683363232767,MATH 18,A01,188344,Bach; Quang Tran,18,0,30,12
1683363232767,MATH 18,A02,188345,Bach; Quang Tran,11,0,30,19
1683363232767,MATH 18,B01,188353,Bach; Quang Tran,10,0,30,20
1683363232767,MATH 18,B02,188354,Bach; Quang Tran,20,0,30,10
1683363233797,MATH 20A,A01,188374,Staff,12,0,35,23
1683363234826,MATH 20B,A01,188382,Ohm; Ko Woon,6,0,30,24
1683363234826,MATH 20B,A02,188383,Ohm; Ko Woon,21,0,30,9
1683363234826,MATH 20B,B01,188385,Ohm; Ko Woon,7,0,30,23
1683363234826,MATH 20B,B02,188392,Ohm; Ko Woon,22,0,30,8
1683363235853,MATH 20C,A01,188394,Harel; Guershon,10,0,30,20
1683363235853,MATH 20C,A02,188395,Harel; Guershon,15,0,30,15
1683363235853,MATH 20C,B01,188404,Harel; Guershon,4,0,30,26
1683363235853,MATH 20C,B02,188405,Harel; Guershon,19,0,30,11
1683363236879,MATH 20D,A01,188414,Hammock; Frances H,0,1,30,30
1683363236879,MATH 20D,A02,188415,Hammock; Frances H,3,0,30,27
1683363236879,MATH 20D,B01,188447,Hammock; Frances H,1,0,30,29
1683363236879,MATH 20D,B02,188486,Hammock; Frances H,8,0,30,22
1683363237909,MATH 20E,A01,188649,Staff,21,0,30,9
1683363237909,MATH 20E,A02,188650,Staff,23,0,30,7
1683363237909,MATH 20E,A03,188673,Staff,0,0,30,30
1683363238937,MATH 102,A01,188675,Staff,0,35,35,35
1683363239966,MATH 103B,A01,188681,Staff,3,0,35,32
1683363239966,MATH 103B,B01,188692,Staff,5,0,35,30
1683363240995,MATH 109,A01,188695,Salehi Golsefidy; Alireza,25,0,35,10
1683363240995,MATH 109,A02,188696,Salehi Golsefidy; Alireza,25,0,35,10
1683363242024,MATH 120A,A01,188698,Eggers; John Dietrich,7,0,35,28
1683363243054,MATH 142B,A01,188736,Ioana; Adrian,0,2,30,30
1683363243054,MATH 142B,A02,188741,Ioana; Adrian,0,0,30,30
1683363243054,MATH 142B,A03,188743,Ioana; Adrian,0,1,30,30
1683363244079,MATH 168A,A01,188790,Staff,0,9,35,35
1683363245106,MATH 170A,A01,188803,Nie; Jiawang,0,2,35,35
1683363245106,MATH 170A,A02,188811,Nie; Jiawang,0,0,35,35
1683363245106,MATH 170A,A03,188814,Nie; Jiawang,1,0,35,34
1683363245106,MATH 170A,A04,188815,Nie; Jiawang,13,0,35,22
1683363246130,MATH 193B,A01,188817,Staff,0,0,35,35
1683363246130,MATH 193B,A02,188818,Staff,5,0,35,30
1683363247155,MGT 4,A01,202857,Anderson; John Charles,61,0,80,19
1683363248180,MGT 12,A00,202858,Lindenberger; Wade Douglas,42,0,90,48
1683363249208,MGT 18,A00,202859,Staff,74,0,90,16
1683363250232,MGT 18GS,A00,202860,McKay; Michael J,13,0,28,15
1683363251260,MGT 45,A00,202861,Pecore; Joseph P.,15,0,90,75
1683363252287,MGT 100,A00,202863,Yavorsky; Daniel Ryan,28,0,90,62
1683363253316,MGT 103,A00,202864,Ehrich; Kristine R,0,17,90,90
1683363254346,MGT 112,A00,202865,Ehrich; Kristine R,15,0,90,75
1683363255376,MGT 121A,A00,202868,Staff,0,20,0,0
1683363256474,MGT 131B,A00,202869,Anderson; John Charles,59,0,90,31
1683363257499,MGT 136,A00,202871,Lindenberger; Wade Douglas,84,0,90,6
1683363258524,MGT 164,A00,202873,Staff,0,68,90,91
1683363259550,MGT 164GS,A00,202874,McKay; Mary A,13,0,28,15
1683363260574,MGT 180,A00,202875,Staff,0,50,90,91
1683363261603,MMW 11R,A01,205019,Herbst; Matthew,3,0,30,27
1683363261603,MMW 11R,A02,205026,Herbst; Matthew,29,0,30,1
1683363262638,MMW 15,A01,193512,Chang; Edmond Yi-Teh,0,9,28,28
1683363262638,MMW 15,A02,193513,Chang; Edmond Yi-Teh,0,5,28,28
1683363262638,MMW 15,A03,193514,Chang; Edmond Yi-Teh,0,5,28,28
1683363262638,MMW 15,A04,193515,Chang; Edmond Yi-Teh,0,5,28,28
1683363262638,MMW 15,A05,193516,Chang; Edmond Yi-Teh,0,4,28,28
1683363262638,MMW 15,A06,193517,Chang; Edmond Yi-Teh,0,5,28,28
1683363262638,MMW 15,B01,193519,Chang; Edmond Yi-Teh,0,5,28,28
1683363262638,MMW 15,B02,193520,Chang; Edmond Yi-Teh,0,5,28,28
1683363262638,MMW 15,B03,193521,Chang; Edmond Yi-Teh,0,5,28,28
1683363262638,MMW 15,B04,193522,Chang; Edmond Yi-Teh,0,4,28,28
1683363262638,MMW 15,B05,193523,Chang; Edmond Yi-Teh,0,5,28,28
1683363262638,MMW 15,B06,193524,Chang; Edmond Yi-Teh,0,4,28,28
1683363263671,MMW 122,A01,193526,Rahimi; Babak,0,15,28,28
1683363263671,MMW 122,A02,193527,Rahimi; Babak,0,14,28,28
1683363263671,MMW 122,A03,193528,Rahimi; Babak,0,0,0,0
1683363263671,MMW 122,A04,193529,Rahimi; Babak,0,0,0,0
1683363264700,MUS 1A,A01,186663,Staff,0,20,35,35
1683363265723,MUS 4,A01,186715,Staff,0,12,35,35
1683363266747,MUS 5R,A01,186796,Dubnov; Shlomo,0,17,35,35
1683363267772,MUS 6,A01,186798,Staff,0,4,25,25
1683363268798,MUS 7,A01,186830,Staff,13,0,35,22
1683363269822,MUS 8,A01,186930,Staff,0,26,35,35
1683363270854,MUS 15,A01,186932,Staff,0,16,35,35
1683363270854,MUS 15,B01,186934,Staff,0,15,35,35
1683363271883,MUS 80,A00,186935,Staff,0,0,20,20
1683363271883,MUS 80,B00,186936,Staff,25,0,25,0
1683363272909,NANO 11,A00,204702,Lipomi; Darren John,0,0,0,0
1683363273941,NANO 15,A01,204709,Yang; Kesong,0,1,0,0
1683363274970,NANO 114,A00,202069,Jahed Motlagh; Zeinab,3,0,10,7
1683363276000,PHIL 1,A00,186955,Grush; Rick Scott,32,0,40,8
1683363277027,PHIL 10,A01,186973,Grush; Rick Scott,28,0,35,7
1683363277027,PHIL 10,A02,186974,Grush; Rick Scott,33,0,35,2
1683363278052,PHIL 13,A01,186976,Staff,7,0,35,28
1683363278052,PHIL 13,A02,186977,Staff,16,0,35,19
1683363279079,PHIL 14,A01,186979,Staff,31,0,35,4
1683363279079,PHIL 14,A02,186986,Staff,32,0,35,3
1683363280108,PHIL 28,A01,186988,Staff,16,0,30,14
1683363280108,PHIL 28,A02,186989,Staff,1,0,30,29
1683363280108,PHIL 28,A03,186990,Staff,9,0,30,21
1683363280108,PHIL 28,A04,186991,Staff,26,0,30,4
1683363281134,PHIL 120,A00,186997,Staff,23,0,40,17
1683363282161,PHIL 137,A00,187003,Staff,9,0,40,31
1683363283184,PHIL 150,A00,187015,Staff,47,0,70,23
1683363284208,PHIL 167,A00,187021,Lamey; Andy M.,35,0,40,5
1683363285233,PHIL 174,A01,202226,Staff,17,0,20,3
1683363285233,PHIL 174,A02,202235,Staff,20,0,20,0
1683363286260,PHIL 191A,A00,258918,Staff,0,0,1,1
1683363287286,PHYS 1A,A00,187028,Staff,27,0,60,33
1683363288312,PHYS 1AL,001,187036,Staff,2,0,30,28
1683363288312,PHYS 1AL,002,187049,Staff,18,0,30,12
1683363289337,PHYS 1B,A00,187058,Staff,22,0,60,38
1683363290360,PHYS 1BL,001,187064,Staff,0,0,30,30
1683363290360,PHYS 1BL,002,187070,Staff,5,0,30,25
1683363291384,PHYS 1C,A00,187082,Staff,31,0,120,89
1683363292410,PHYS 1CL,001,187088,Staff,0,9,30,30
1683363292410,PHYS 1CL,002,187089,Staff,0,2,30,30
1683363292410,PHYS 1CL,009,262693,Staff,11,0,30,19
1683363293435,PHYS 2B,A01,187097,Staff,54,0,115,61
1683363294460,PHYS 2C,A01,187099,Staff,67,0,115,48
1683363295488,PHYS 2CL,A01,187101,Staff,5,0,28,23
1683363295488,PHYS 2CL,A02,187102,Staff,15,0,28,13
1683363296517,PHYS 2D,A01,187123,Shotwell; Brian,95,0,115,20
1683363297549,PHYS 4B,A01,187133,Grinstein; Benjamin,35,0,50,15
1683363298574,POLI 10,A00,188819,Staff,0,4,50,50
1683363299600,POLI 11,A00,188827,Staff,43,0,50,7
1683363300624,POLI 13R,A00,188828,Staff,0,1,20,20
1683363301651,POLI 27,A01,188830,Elgin; Samuel Zincke,0,1,70,70
1683363302676,POLI 30,A00,188832,Desposato; Scott,31,0,50,19
1683363303701,POLI 102F,A00,188834,Staff,3,0,40,37
1683363304727,POLI 104A,A00,188852,Staff,14,0,30,16
1683363305751,POLI 104I,A00,188853,Staff,0,6,20,20
1683363306776,POLI 110B,A00,188854,Wiens; David,7,0,20,13
1683363307802,POLI 112A,A00,188855,Wiens; David,5,0,30,25
1683363308825,POLI 117R,A00,188856,Forman; Fonna,0,11,20,20
1683363309851,POLI 118,A00,188857,Ingham; Sean,8,0,20,12
1683363310880,POLI 120G,A00,188858,Staff,9,0,30,21
1683363311909,POLI 131CR,A00,188863,Hoston; Germaine,23,0,50,27
1683363312934,POLI 133,A00,188864,Nellis; Gareth Hb,44,0,50,6
1683363313961,POLI 134D,A00,188865,Desposato; Scott,27,0,30,3
1683363314986,POLI 142A,A00,188871,Gartzke; Erik,22,0,50,28
1683363316013,POLI 142K,A00,188874,Staff,38,0,50,12
1683363317043,POLI 143,A00,188940,Gartzke; Erik,16,0,30,14
1683363318072,POLI 153,A00,188943,Staff,3,0,20,17
1683363319100,POLI 160AA,A00,188944,Staff,11,0,40,29
1683363320134,POLI 170A,A00,188945,Staff,11,0,30,19
1683363322188,PSYC 1,A00,188952,Staff,37,0,90,53
1683363323218,PSYC 2,B00,188953,Staff,19,0,35,16
1683363324243,PSYC 6,A00,188970,Staff,47,0,60,13
1683363325268,PSYC 7,A00,188973,Staff,37,0,45,8
1683363326294,PSYC 60,A01,188980,Rickard; Timothy C.,43,0,60,17
1683363327320,PSYC 70,A01,189001,Steiner; Eric Tomas,23,0,45,22
1683363328344,PSYC 100,A00,189005,Lacefield; Katharine I,0,98,120,120
1683363329368,PSYC 102,A00,189008,Staff,9,0,30,21
1683363330398,PSYC 106,B00,189026,Gorman; Michael R.,34,0,60,26
1683363331425,PSYC 114,B01,189033,Winkielman; Piotr,0,32,30,30
1683363332450,PSYC 131,A00,189036,Anagnostaras; Stephan,0,43,60,60
1683363333474,PSYC 136,A00,189041,Lowe; Angela Beth,0,7,25,25
1683363334497,PSYC 137,A00,189057,Winkielman; Piotr,0,34,25,25
1683363335521,PSYC 144,A00,189107,Wixted; John T,0,7,50,50
1683363337571,PSYC 162,A00,189142,Staff,0,8,85,85
1683363338596,PSYC 172,A00,189144,Gorman; Michael R.,0,7,30,30
1683363340650,PSYC 179,A00,189146,Lacefield; Katharine I,0,84,120,120
1683363341679,PSYC 181,A00,189147,Anagnostaras; Stephan,0,44,90,90
1683363342707,PSYC 190R,A00,189148,Barner; David A.,0,22,80,80
1683363343733,PSYC 191,A00,189275,Rickard; Timothy C.,0,7,25,25
1683363344757,PSYC 193,A00,189276,Chapman; Eddie Nathaniel,0,1,0,4
1683363345782,PSYC 193L,A01,189281,Lowe; Angela Beth,12,0,20,8
1683363345782,PSYC 193L,B01,189285,Staff,28,0,35,7
1683363346807,RELI 149,A00,187137,Rahimi; Babak,7,0,40,33
1683363347833,SE 9,A01,187315,Staff,0,2,18,18
1683363348857,SE 101B,A00,187409,Staff,24,0,30,6
1683363349886,SE 110B,A00,187444,Staff,10,0,40,30
1683363350917,SE 130B,A00,187449,Staff,31,0,40,9
1683363351942,SE 150A,A00,187516,Staff,9,0,20,11
1683363352971,SE 154,A00,187528,Staff,30,0,50,20
1683363353996,SIO 3,A01,258171,Staff,35,0,40,5
1683363355021,SIO 10,A00,187144,Cook; Geoffrey W,0,3,75,75
1683363356045,SIO 45,A00,187152,Cook; Geoffrey W,1,0,100,99
1683363357069,SIO 109R,A00,194486,Staff,0,3,20,20
1683363359119,SIO 187,A01,187233,Kacev; David,12,0,40,28
1683363360201,SOCI 1,A01,258656,Thorpe; Charles Robert,28,0,30,2
1683363360201,SOCI 1,A02,258658,Thorpe; Charles Robert,30,0,30,0
1683363360201,SOCI 1,A03,258661,Thorpe; Charles Robert,25,0,25,0
1683363360201,SOCI 1,A04,258666,Thorpe; Charles Robert,22,0,25,3
1683363360201,SOCI 1,A05,258897,Thorpe; Charles Robert,23,0,25,2
1683363360201,SOCI 1,A06,258898,Thorpe; Charles Robert,25,0,25,0
1683363361226,SOCI 30,A01,258903,Pardo Guerra; Juan Pablo,15,0,30,15
1683363362252,SOCI 102,A00,258904,Staff,9,0,25,16
1683363363278,SOCI 106,A00,258905,Staff,19,0,25,6
1683363364302,SOCI 111,A00,258907,Ribas Norris; Janet Vanesa,26,0,30,4
1683363365330,SOCI 121R,A00,258908,Pardo Guerra; Juan Pablo,10,0,30,20
1683363366355,SOCI 126,A01,203330,Staff,14,0,20,6
1683363367381,SOCI 131,A00,258909,Thorpe; Charles Robert,31,0,60,29
1683363368405,SOCI 135,A00,258910,Payne; Christine Anna,0,9,30,30
1683363369430,SOCI 157,A00,258911,Staff,12,0,30,18
1683363370457,SOCI 184,A00,258912,Staff,25,0,30,5
1683363371482,SOCI 188D,A00,258913,Staff,22,0,30,8
1683363372508,SYN 2,001,187529,Staff,10,0,16,6
1683363372508,SYN 2,002,201452,Staff,0,18,16,16
1683363372508,SYN 2,003,201469,Staff,3,0,16,13
1683363373534,SYN 100,A01,187531,Staff,0,9,20,20
1683363373534,SYN 100,B01,201491,Staff,0,12,20,20
1683363374560,TDAC 1,A00,189286,Walsh; Kim C.,3,0,20,17
1683363374560,TDAC 1,B00,189287,Harting; Carla Kelso,11,0,20,9
1683363375584,TDAC 101,A00,189300,Walsh; Kim C.,16,0,20,4
1683363375584,TDAC 101,B00,189301,Harting; Carla Kelso,18,0,20,2
1683363376614,TDAC 102,A00,189304,Basso; Beatrice,14,0,20,6
1683363377637,TDAC 108,A00,189305,Staff,18,0,20,2
1683363378663,TDDE 131,A00,189310,Staff,19,0,20,1
1683363378663,TDDE 131,B00,189314,Staff,19,0,20,1
1683363378663,TDDE 131,C00,189315,Staff,48,0,50,2
1683363378663,TDDE 131,D00,189316,Staff,14,0,15,1
1683363378663,TDDE 131,E00,204841,Staff,20,0,20,0
1683363379687,TDGE 10,A00,189289,Staff,30,0,50,20
1683363379687,TDGE 10,B00,189290,Havis; Allan,1,0,50,49
1683363380711,TDGE 11,A00,189291,Fulton; Julia,0,3,50,50
1683363380711,TDGE 11,B00,189292,Staff,20,0,25,5
1683363380711,TDGE 11,C00,260270,Staff,0,0,0,0
1683363381736,TDGE 25,A00,189294,Staff,3,0,20,17
1683363382760,TDGE 124,A00,189318,Fulton; Julia,0,8,50,50
1683363383785,TDGE 125,A00,189319,Staff,13,0,25,12
1683363383785,TDGE 125,B00,189320,Staff,23,0,25,2
1683363384811,TDGE 127,A00,189322,Havis; Allan,0,0,50,50
1683363385839,TDHT 101,A00,189323,Staff,18,0,25,7
1683363385839,TDHT 101,B00,189324,Staff,25,0,25,0
1683363386867,TDHT 102,A00,189325,Staff,49,0,50,1
1683363387898,TDMV 1,A00,189295,Arcidiacono; Kristin,19,0,30,11
1683363387898,TDMV 1,B00,189296,Caligagan; Maria T.,24,0,30,6
1683363388925,TDMV 2,A00,189297,Sammartano; Tonnie,28,0,30,2
1683363388925,TDMV 2,B00,189299,Arcidiacono; Kristin,24,0,30,6
1683363389954,TDMV 3,A00,204998,Rincon; Alicia,22,0,30,8
1683363390982,TDMV 120,A00,189458,Sammartano; Tonnie,28,0,30,2
1683363392009,TDMV 138,A00,189541,Jun; Grace Shin Hae,22,0,40,18
1683363393039,TDMV 142,A00,189717,Caligagan; Tony,24,0,30,6
1683363393039,TDMV 142,B00,189718,Caligagan; Maria T.,25,0,30,5
1683363394069,TMC 2,A01,187533,Staff,25,0,25,0
1683363394069,TMC 2,A02,187534,Staff,25,0,25,0
1683363395095,USP 1,A01,187536,Kwak; Nancy,0,16,25,25
1683363396119,USP 5,A01,187538,Staff,10,0,25,15
1683363397144,USP 101,A00,199253,Staff,0,4,0,0
1683363398168,USP 124,A00,187562,Boomhower; Matthew Charles,1,0,30,29
1683363399191,USP 138,A00,187582,Staff,20,0,25,5
1683363400220,USP 152,A01,187597,Staff,4,0,25,21
1683363401244,USP 153,A00,187598,Staff,19,0,25,6
1683363402273,USP 168,A00,187607,Kwak; Nancy,2,0,5,3
1683363403300,USP 173,A00,187619,Staff,4,0,25,21
1683363404327,USP 181,A00,187638,Staff,0,3,25,25
1683363405357,VIS 103,A00,187650,Cruz; Edwin Teddy,22,0,75,53
1683363406383,VIS 110D,A00,187669,Staff,12,0,22,10
1683363407408,VIS 127C,A00,187720,Shen; Kuiyi,67,0,146,79
1683363408432,VIS 149,A00,187731,Yoldas; Pinar,0,14,22,22
1683363409457,VIS 151,A01,188091,Staff,22,0,34,12
1683363409457,VIS 151,A02,188092,Staff,11,0,34,23
1683363410483,VIS 160B,A00,188093,Stalbaum; Brett,0,0,10,10
1683363412534,WCWP 10B,A00,201720,Staff,10,0,15,5
1683363412534,WCWP 10B,B00,201722,Staff,9,0,15,6
1683363413565,WCWP 100,A00,201725,Gagnon; Jeffrey C,0,0,2,2
1683363413565,WCWP 100,B00,201727,Staff,0,4,15,15
1683363416696,ANBI 133,A00,258401,Wilder; Linnea Lorene,34,0,40,6
1683363417719,ANBI 140,A00,258395,Hrvoj Mihic; Branka,18,0,25,7
1683363418744,ANSC 120,A00,258402,Bialecki; Jon Anthony,27,0,40,13
1683363419769,ANSC 144,A00,258400,Staff,14,0,40,26
1683363421818,ANSC 166,A00,258396,Parish; Steven Martin,157,0,175,18
1683363422842,ANSC 180,A00,193533,Staff,9,0,20,11
1683363423867,ANSC 188,A00,258397,Jassal; Aftab,33,0,40,7
1683363424891,ANTH 3,A01,258316,Staff,23,0,30,7
1683363425918,ANTH 5,A00,258394,Semendeferi; Ekaterini,16,0,20,4
1683363426945,ANTH 21,A01,258331,Staff,8,0,40,32
1683363427973,ANTH 103,A00,258398,Varma; Saiba,15,0,25,10
1683363429002,AWP 10,001,202034,Staff,0,0,0,0
1683363429002,AWP 10,002,202035,Staff,0,0,0,0
1683363429002,AWP 10,003,202036,Staff,0,0,0,0
1683363429002,AWP 10,004,202037,Staff,0,0,0,0
1683363429002,AWP 10,005,202038,Staff,0,0,0,0
1683363429002,AWP 10,006,202039,Staff,0,0,0,0
1683363429002,AWP 10,007,202040,Staff,0,0,0,0
1683363429002,AWP 10,008,202041,Staff,0,0,0,0
1683363429002,AWP 10,009,202042,Staff,0,0,0,0
1683363429002,AWP 10,010,202043,Staff,0,0,0,0
1683363429002,AWP 10,011,202044,Staff,0,0,0,0
1683363429002,AWP 10,012,202045,Staff,0,0,0,0
1683363429002,AWP 10,013,202046,Staff,0,0,0,0
1683363429002,AWP 10,014,202047,Staff,0,0,0,0
1683363429002,AWP 10,015,202048,Staff,0,0,0,0
1683363429002,AWP 10,016,202049,Staff,0,0,0,0
1683363429002,AWP 10,017,202050,Staff,0,0,0,0
1683363429002,AWP 10,018,202051,Staff,0,0,0,0
1683363429002,AWP 10,019,202052,Staff,0,0,0,0
1683363429002,AWP 10,020,202053,Staff,0,0,0,0
1683363429002,AWP 10,021,202054,Staff,0,0,0,0
1683363429002,AWP 10,022,202055,Staff,0,0,0,0
1683363429002,AWP 10,023,202056,Staff,0,0,0,0
1683363429002,AWP 10,024,202057,Staff,0,0,0,0
1683363429002,AWP 10,025,202058,Staff,0,0,0,0
1683363429002,AWP 10,026,202059,Staff,0,0,0,0
1683363430029,AWP 102,001,202032,Staff,0,0,0,0
1683363430029,AWP 102,002,202033,Staff,0,0,0,0
1683363431054,BENG 100,A01,254234,Taylor Amos; Alyssa C,31,0,40,9
1683363432077,BENG 196,001,270013,Engler; Adam J.,9999,0,9999,0
1683363433103,BICD 100R,A01,202018,Smith; Laurie,0,7,32,32
1683363433103,BICD 100R,A02,202019,Smith; Laurie,0,2,32,32
1683363433103,BICD 100R,A03,202020,Smith; Laurie,0,1,32,32
1683363433103,BICD 100R,A04,202021,Smith; Laurie,9,0,32,23
1683363433103,BICD 100R,A05,202022,Smith; Laurie,12,0,32,20
1683363434126,BICD 136,A01,193242,Gustafson-Brown; Cindy,0,2,32,32
1683363434126,BICD 136,A02,193244,Gustafson-Brown; Cindy,14,0,32,18
1683363435154,BIEB 102,A01,193249,Butler; Shannon Rhey,0,2,32,32
1683363435154,BIEB 102,A02,193251,Butler; Shannon Rhey,0,0,32,32
1683363435154,BIEB 102,A03,193253,Butler; Shannon Rhey,0,1,32,32
1683363435154,BIEB 102,A04,193255,Butler; Shannon Rhey,17,0,32,15
1683363435154,BIEB 102,A05,193265,Butler; Shannon Rhey,26,0,32,6
1683363435154,BIEB 102,A06,193269,Butler; Shannon Rhey,16,0,32,16
1683363437206,BIEB 150,A01,193274,Staff,0,0,32,32
1683363437206,BIEB 150,A02,193285,Staff,23,0,32,9
1683363438234,BIEB 194,A00,193286,Kurle; Carolyn M.,22,0,32,10
1683363439267,BILD 1,A01,192291,Staff,16,0,32,16
1683363439267,BILD 1,A02,192292,Staff,30,0,32,2
1683363439267,BILD 1,B01,192520,Reuther; Keefe,0,1,0,0
1683363439267,BILD 1,B02,192532,Reuther; Keefe,0,1,0,0
1683363440293,BILD 3,A01,192556,Butler; Shannon Rhey,0,0,32,32
1683363440293,BILD 3,A02,192581,Butler; Shannon Rhey,4,0,32,28
1683363440293,BILD 3,A03,192611,Butler; Shannon Rhey,23,0,32,9
1683363440293,BILD 3,A04,192612,Butler; Shannon Rhey,25,0,32,7
1683363440293,BILD 3,A05,192613,Butler; Shannon Rhey,27,0,32,5
1683363440293,BILD 3,A06,192679,Butler; Shannon Rhey,27,0,32,5
1683363440293,BILD 3,A07,192682,Butler; Shannon Rhey,21,0,32,11
1683363441318,BILD 4,A01,192836,Reuther; Keefe,0,0,24,24
1683363441318,BILD 4,A02,193044,Reuther; Keefe,4,0,24,20
1683363442343,BILD 10,A01,193142,Gustafson-Brown; Cindy,30,0,32,2
1683363442343,BILD 10,A02,193149,Gustafson-Brown; Cindy,31,0,32,1
1683363443368,BIMM 100,A01,193301,Staff,1,6,32,31
1683363443368,BIMM 100,A02,193312,Staff,0,5,32,32
1683363443368,BIMM 100,A03,193323,Staff,0,8,32,32
1683363444394,BIMM 101,A01,193329,McDonnell; Lisa Marie,0,3,24,24
1683363444394,BIMM 101,A02,193339,McDonnell; Lisa Marie,0,3,24,24
1683363444394,BIMM 101,B01,193354,McDonnell; Lisa Marie,0,3,24,24
1683363444394,BIMM 101,B02,193357,McDonnell; Lisa Marie,0,3,24,24
1683363445422,BIMM 110,A01,193377,Tat; John,0,11,32,32
1683363445422,BIMM 110,A02,193378,Tat; John,0,9,32,32
1683363446452,BIMM 120,A01,206116,Staff,0,0,32,32
1683363446452,BIMM 120,A02,206117,Staff,8,0,32,24
1683363446452,BIMM 120,A03,206121,Staff,21,0,32,11
1683363447482,BIPN 100,A01,193393,Park; Ji Young,0,14,32,32
1683363447482,BIPN 100,A02,193402,Park; Ji Young,0,13,32,32
1683363447482,BIPN 100,A03,193413,Park; Ji Young,0,14,32,32
1683363447482,BIPN 100,A04,193414,Park; Ji Young,0,13,32,32
1683363448511,BIPN 102,A01,193429,Staff,0,0,32,32
1683363448511,BIPN 102,A02,193438,Staff,22,0,32,10
1683363449535,BIPN 106,A01,193450,Reyes Gonzalez; Catalina,0,2,40,40
1683363450562,BIPN 134,A01,193465,Cooke; James Edward,1,0,32,31
1683363450562,BIPN 134,A02,193474,Cooke; James Edward,25,0,32,7
1683363450562,BIPN 134,A03,193485,Cooke; James Edward,29,0,32,3
1683363450562,BIPN 134,A04,193486,Cooke; James Edward,21,0,32,11
1683363450562,BIPN 134,A05,193491,Cooke; James Edward,31,0,32,1
1683363450562,BIPN 134,A06,193501,Cooke; James Edward,30,0,32,2
1683363450562,BIPN 134,A07,193510,Cooke; James Edward,29,0,32,3
1683363452616,BISP 194,A00,222522,Staff,14,0,32,18
1683363453640,CAT 124,A01,202407,Staff,19,0,25,6
1683363454666,CAT 125,A00,202408,Marchisotto; Jennifer Anne,4,0,20,16
1683363455692,CAT 125R,A00,202409,Smith; Lauryn Alissa,0,11,20,20
1683363455692,CAT 125R,B00,202410,Morales; Celeste Georgianna,0,11,20,20
1683363455692,CAT 125R,C00,202411,Irwin; Matthew Joseph,0,10,20,20
1683363456717,CENG 15,A01,204712,Yang; Kesong,0,1,0,0
1683363457741,CENG 114,A00,202070,Jahed Motlagh; Zeinab,5,0,20,15
1683363458766,CGS 105,A00,185477,Wesling; Megan E.,24,0,40,16
1683363459791,CGS 106,A00,185494,Staff,13,0,22,9
1683363460815,CGS 108,A00,185495,Staff,14,0,20,6
1683363461839,CGS 114,A00,185496,Staff,13,0,18,5
1683363462868,CGS 119,A00,185501,Staff,15,0,20,5
1683363463966,CGS 120,A00,185511,Staff,13,0,20,7
1683363464992,CHEM 4,A01,184675,Bussey; Thomas J,96,0,100,4
1683363466020,CHEM 6A,A01,184677,Staff,34,0,60,26
1683363467045,CHEM 6B,A01,184679,Staff,65,0,100,35
1683363468071,CHEM 6C,A01,184681,Bussey; Thomas J,1,0,50,49
1683363468071,CHEM 6C,A02,184682,Bussey; Thomas J,34,0,50,16
1683363469094,CHEM 40A,A01,184684,Albizati; Kim F.,37,0,100,63
1683363470120,CHEM 40B,A01,184686,Albizati; Kim F.,0,20,100,100
1683363471145,CHEM 41B,A01,184690,Staff,52,0,100,48
1683363472168,COGS 3,A01,184715,Boyle; Mary E. T.,0,25,40,40
1683363473193,COGS 14B,A01,185172,Staff,0,15,38,38
1683363474222,COGS 18,A01,184736,Staff,16,0,80,64
1683363475247,COGS 100,A01,184932,Staff,0,5,73,73
1683363476276,COGS 101A,A01,184935,Staff,0,39,30,30
1683363477302,COGS 101B,A01,184944,Staff,0,2,30,30
1683363478325,COGS 101C,A01,184946,Staff,0,12,30,30
1683363479348,COGS 102A,A01,184951,Johnson; Christine M.,2,0,40,38
1683363480373,COGS 107B,A01,184953,Mooshagian; Eric Frederick,0,50,40,40
1683363481398,COGS 118B,A01,184959,Gupta; Anjum,0,48,40,40
1683363482422,COGS 153,A00,184961,Staff,0,15,30,30
1683363483446,COGS 177,A00,184962,Staff,0,20,30,30
1683363484471,COGS 187A,A01,184969,Boyle; Mary E. T.,0,17,40,40
1683363485496,COMM 10,A01,185174,Staff,0,5,25,25
1683363485496,COMM 10,A02,185189,Staff,0,5,25,25
1683363485496,COMM 10,A03,269821,Staff,0,0,0,0
1683363486521,COMM 100B,A01,185475,Staff,0,0,0,2
1683363486521,COMM 100B,A02,185476,Staff,13,0,25,12
1683363487546,COMM 100C,A01,185314,Staff,1,0,25,24
1683363487546,COMM 100C,A02,185327,Staff,19,0,25,6
1683363488572,COMM 110M,A00,185349,Staff,2,0,40,38
1683363489601,COMM 113T,A00,185352,Staff,24,0,40,16
1683363490626,COMM 114I,A00,185353,Staff,33,0,40,7
1683363491651,COMM 131,A00,185354,Staff,19,0,30,11
1683363492680,CSE 8A,A50,185358,Cao; Yingjun,0,46,10,10
1683363493705,CSE 8B,A01,185362,Staff,0,46,50,50
1683363494730,CSE 11,A01,185416,Cao; Yingjun,0,92,10,10
1683363495753,CSE 20,A01,185445,Briones; Jor-el Thomas Caparas,5,0,25,20
1683363496782,CSE 21,A01,185447,Staff,10,0,50,40
1683363497808,CSE 101,A01,185451,Staff,0,13,50,50
1683363497808,CSE 101,B01,185453,Jones; Miles E,0,11,50,50
1683363499862,CSE 141,A01,185458,Eldon; John,20,0,100,80
1683363500887,CSE 141L,A01,185461,Eldon; John,12,0,100,88
1683363501912,CSE 142,A01,185463,Staff,36,0,60,24
1683363501912,CSE 142,B01,201355,Staff,0,7,60,60
1683363502938,CSE 142L,A01,185470,Staff,36,0,60,24
1683363502938,CSE 142L,B01,201417,Staff,0,6,60,60
1683363503963,CSE 190,A00,201433,Staff,32,0,49,17
1683363504988,DOC 1,A01,259136,Strom; Megan C.,7,0,15,8
1683363504988,DOC 1,A02,259137,Strom; Megan C.,14,0,15,1
1683363504988,DOC 1,A03,259138,Strom; Megan C.,14,0,15,1
1683363504988,DOC 1,A04,259139,Strom; Megan C.,14,0,15,1
1683363506014,DOC 100D,A00,259140,Pass; Natalye Joann,16,0,25,9
1683363507042,DSGN 1,A01,184749,Rill; Bryan,0,25,30,30
1683363508071,DSGN 100,A01,185168,Staff,0,2,25,25
1683363509097,ECE 5,A01,185626,Morris; Karcher William,0,10,0,0
1683363510127,ECE 101,A01,185628,Staff,17,0,70,53
1683363511154,ECE 107,A01,185635,Baghdadchi; Saharnaz,0,0,20,20
1683363511154,ECE 107,A02,185638,Baghdadchi; Saharnaz,4,0,20,16
1683363512182,ECE 148,A01,185647,Silberman; Jack,0,0,16,16
1683363513207,ECON 1,A01,185537,Crane; Meredith Helen,54,0,70,16
1683363514230,ECON 3,A01,185549,Crane; Meredith Helen,32,0,70,38
1683363515259,ECON 4,A01,203354,Anderson; John Charles,0,4,10,10
1683363516284,ECON 100A,A01,185574,Staff,0,4,40,40
1683363517308,ECON 100B,A01,185576,Staff,0,12,50,50
1683363518334,ECON 100C,A01,185589,Newhouse; Herbert S,29,0,70,41
1683363519362,ECON 105,A00,185608,Vespa; Emanuel Ignacio,19,0,35,16
1683363520393,ECON 109,A01,185610,Shishkin; Denis,10,0,35,25
1683363521422,ECON 110A,A01,185612,Staff,11,0,40,29
1683363522447,ECON 120A,A01,185615,Staff,20,0,40,20
1683363523472,ECON 120C,A01,185617,Sun; Yixiao,0,21,70,70
1683363524496,ECON 144,A00,203346,Squires; Dale E,3,0,35,32
1683363525520,ECON 171,A01,203349,Newhouse; Herbert S,0,1,35,35
1683363526545,ECON 173A,A01,185621,Toda; Alexis Akira,21,0,35,14
1683363527571,EDS 25,A01,202413,Staff,0,1,0,0
1683363527571,EDS 25,A02,202414,Staff,0,1,0,0
1683363527571,EDS 25,A03,202415,Staff,0,0,0,0
1683363527571,EDS 25,A04,202416,Staff,0,1,0,0
1683363527571,EDS 25,A05,202439,Staff,0,0,0,0
1683363527571,EDS 25,A06,202440,Staff,0,0,0,0
1683363527571,EDS 25,B01,202631,Staff,0,0,0,0
1683363527571,EDS 25,B02,202632,Staff,0,0,0,0
1683363527571,EDS 25,B03,202639,Staff,0,0,0,0
1683363527571,EDS 25,B04,202640,Staff,0,0,0,0
1683363527571,EDS 25,B05,202643,Staff,0,0,0,0
1683363527571,EDS 25,B06,202644,Staff,0,0,0,0
1683363528595,EDS 38,A01,202659,Black; Alison Michelle,24,0,25,1
1683363529624,EDS 115,A00,202652,Staff,18,0,30,12
1683363530648,EDS 125,A00,202649,Staff,14,0,30,16
1683363531672,EDS 126,A01,203332,Staff,30,0,30,0
1683363532697,EDS 139,A00,202838,Staff,16,0,25,9
1683363533722,EDS 146,A01,202655,Staff,14,0,25,11
1683363534748,ENG 15,A00,185667,Staff,0,1,0,0
1683363534748,ENG 15,B00,185672,Staff,0,0,0,0
1683363534748,ENG 15,C00,185675,Staff,0,0,0,0
1683363534748,ENG 15,D00,185682,Staff,0,0,0,0
1683363534748,ENG 15,E00,185684,Staff,0,0,0,0
1683363535772,ETHN 103,A00,185710,Staff,0,4,35,35
1683363536798,ETHN 103A,A00,199228,Man; Simeon S,2,0,9,7
1683363537824,ETHN 109,A00,185711,Staff,18,0,35,17
1683363538849,ETHN 142,A00,185726,Staff,0,4,30,30
1683363539876,ETHN 163J,A00,199229,Man; Simeon S,5,0,8,3
1683363540903,ETHN 168,A00,185727,Staff,8,0,10,2
1683363541926,ETHN 182,A00,185728,Staff,0,0,35,35
1683363542952,ETHN 183,A00,185737,Staff,8,0,18,10
1683363543975,GLBH 111,A01,209361,Burgos; Jose L.,0,0,0,0
1683363546035,HIEU 104,A00,185792,Staff,16,0,20,4
1683363547062,HIEU 115,A00,185800,Staff,1,0,20,19
1683363548087,HIEU 128,A00,185801,Staff,0,7,20,20
1683363549114,HIEU 147,A00,185802,Staff,16,0,20,4
1683363550140,HIEU 154,A00,185823,Staff,12,0,20,8
1683363551167,HILA 102,A00,185826,Staff,13,0,20,7
1683363552192,HILD 2C,A01,185778,Staff,0,12,20,20
1683363553218,HILD 7B,A01,185780,Kwak; Nancy,0,15,32,32
1683363553218,HILD 7B,A02,185781,Kwak; Nancy,0,18,32,32
1683363554243,HILD 30,A01,185791,Staff,14,0,20,6
1683363555268,HISC 119,A00,185830,Golan; Tal,0,9,20,20
1683363556291,HITO 156GS,A00,185831,Patterson; Patrick H.,0,0,0,23
1683363557319,HIUS 103,A00,185832,Man; Simeon S,1,6,20,19
1683363558345,HIUS 117,A00,185836,Kwak; Nancy,2,0,20,18
1683363559369,HIUS 125,A00,185840,Man; Simeon S,0,0,23,23
1683363560397,HIUS 149,A00,185845,Staff,0,0,20,20
1683363561423,HUM 3,A01,185882,Zavodny; Tatiana Sophia,0,7,50,50
1683363561423,HUM 3,B01,185899,Caldwell; Michael Alan,0,18,50,50
1683363562448,HUM 3GS,A00,185900,Patterson; Patrick H.,0,0,0,23
1683363563474,HUM 4,A01,185938,Zroka; Amy Liane,31,0,50,19
1683363563474,HUM 4,B01,185956,Watkins; Eric,0,3,50,50
1683363563474,HUM 4,B02,202209,Watkins; Eric,0,2,50,50
1683363563474,HUM 4,B03,202210,Watkins; Eric,0,2,50,50
1683363564499,HUM 5,A01,185958,West; Geoffrey Scott,3,0,50,47
1683363564499,HUM 5,A02,202215,West; Geoffrey Scott,0,0,50,50
1683363565524,INTL 190,A00,185959,Gagnon; Jeffrey C,0,0,0,9
1683363565524,INTL 190,B00,185960,Lettieri; Michael Joseph,0,0,0,1
1683363566552,JAPN 180,A00,254509,Staff,4,0,30,26
1683363567638,LATI 10,A01,202853,Kennemore; Amy Michelle,4,0,35,31
1683363567638,LATI 10,A02,202854,Kennemore; Amy Michelle,2,0,35,33
1683363567638,LATI 10,A03,270054,Kennemore; Amy Michelle,30,0,30,0
1683363568666,LATI 180,A00,202855,Kennemore; Amy Michelle,11,0,20,9
1683363569691,LAWS 101,A00,201767,Golan; Tal,0,7,40,40
1683363570716,LIFR 1C,A00,185961,Staff,6,0,20,14
1683363571740,LIFR 1CX,A00,185962,Staff,7,0,20,13
1683363572765,LIFR 1D,A00,185963,Staff,9,0,20,11
1683363573791,LIFR 1DX,A00,185964,Staff,9,0,20,11
1683363574817,LIGN 101,A01,186039,Staff,43,0,50,7
1683363575841,LIGN 165,A00,186040,Staff,18,0,50,32
1683363576865,LTCS 108,A00,186041,Staff,6,0,10,4
1683363577889,LTCS 119,A00,186042,Staff,16,0,20,4
1683363578914,LTCS 130,A00,186043,Wesling; Megan E.,15,0,25,10
1683363580965,LTEA 138,A00,186119,Staff,14,0,40,26
1683363581992,LTEN 124,A00,186148,Staff,6,0,25,19
1683363583017,LTEN 178,A00,186149,Staff,7,0,15,8
1683363584043,LTEN 181,A00,186150,Blanco; John D,33,0,40,7
1683363585068,LTWL 120,A00,186160,Staff,20,0,25,5
1683363586094,LTWL 165,A00,186161,Staff,22,0,25,3
1683363587117,LTWR 100,A00,186162,Staff,0,5,15,15
1683363588142,LTWR 102,A00,186163,Doller; Ben,5,0,15,10
1683363589165,MAE 8,A01,186412,Staff,0,0,0,0
1683363590190,MAE 30B,A00,186445,Bahadori; Mohammad Yousef,83,0,100,17
1683363591215,MAE 40,A00,186592,Bewley; Thomas R,10,0,50,40
1683363592238,MAE 101B,A00,186593,Bahadori; Mohammad Yousef,81,0,100,19
1683363593263,MAE 105,A00,186594,Bandaru; Prabhakar,12,0,50,38
1683363594287,MAE 107,A00,186599,Pham; Hieu Tan,0,7,120,120
1683363595311,MAE 148,A01,186660,Silberman; Jack,3,0,16,13
1683363596336,MATH 10A,A01,188095,Staff,0,5,35,35
1683363597365,MATH 10B,A01,188097,Bowers; Adam R.,0,11,30,30
1683363597365,MATH 10B,A02,188099,Bowers; Adam R.,0,11,30,30
1683363597365,MATH 10B,B01,188104,Bowers; Adam R.,0,10,30,30
1683363597365,MATH 10B,B02,188106,Bowers; Adam R.,0,10,30,30
1683363598391,MATH 10C,A01,188111,Staff,0,18,30,30
1683363598391,MATH 10C,A02,188127,Staff,0,17,30,30
1683363598391,MATH 10C,A03,188131,Staff,0,18,30,30
1683363598391,MATH 10C,B01,188218,Staff,18,0,30,12
1683363598391,MATH 10C,B02,188244,Staff,13,0,30,17
1683363598391,MATH 10C,B03,188277,Staff,16,0,30,14
1683363599417,MATH 18,A01,188344,Bach; Quang Tran,18,0,30,12
1683363599417,MATH 18,A02,188345,Bach; Quang Tran,11,0,30,19
1683363599417,MATH 18,B01,188353,Bach; Quang Tran,10,0,30,20
1683363599417,MATH 18,B02,188354,Bach; Quang Tran,20,0,30,10
1683363600441,MATH 20A,A01,188374,Staff,12,0,35,23
1683363601465,MATH 20B,A01,188382,Ohm; Ko Woon,6,0,30,24
1683363601465,MATH 20B,A02,188383,Ohm; Ko Woon,21,0,30,9
1683363601465,MATH 20B,B01,188385,Ohm; Ko Woon,7,0,30,23
1683363601465,MATH 20B,B02,188392,Ohm; Ko Woon,22,0,30,8
1683363602491,MATH 20C,A01,188394,Harel; Guershon,10,0,30,20
1683363602491,MATH 20C,A02,188395,Harel; Guershon,15,0,30,15
1683363602491,MATH 20C,B01,188404,Harel; Guershon,4,0,30,26
1683363602491,MATH 20C,B02,188405,Harel; Guershon,19,0,30,11
1683363603521,MATH 20D,A01,188414,Hammock; Frances H,0,1,30,30
1683363603521,MATH 20D,A02,188415,Hammock; Frances H,3,0,30,27
1683363603521,MATH 20D,B01,188447,Hammock; Frances H,1,0,30,29
1683363603521,MATH 20D,B02,188486,Hammock; Frances H,8,0,30,22
1683363604547,MATH 20E,A01,188649,Staff,21,0,30,9
1683363604547,MATH 20E,A02,188650,Staff,23,0,30,7
1683363604547,MATH 20E,A03,188673,Staff,0,0,30,30
1683363605573,MATH 102,A01,188675,Staff,0,35,35,35
1683363606601,MATH 103B,A01,188681,Staff,3,0,35,32
1683363606601,MATH 103B,B01,188692,Staff,5,0,35,30
1683363607628,MATH 109,A01,188695,Salehi Golsefidy; Alireza,25,0,35,10
1683363607628,MATH 109,A02,188696,Salehi Golsefidy; Alireza,25,0,35,10
1683363608658,MATH 120A,A01,188698,Eggers; John Dietrich,7,0,35,28
1683363609686,MATH 142B,A01,188736,Ioana; Adrian,0,2,30,30
1683363609686,MATH 142B,A02,188741,Ioana; Adrian,0,0,30,30
1683363609686,MATH 142B,A03,188743,Ioana; Adrian,0,1,30,30
1683363610715,MATH 168A,A01,188790,Staff,0,9,35,35
1683363611741,MATH 170A,A01,188803,Nie; Jiawang,0,2,35,35
1683363611741,MATH 170A,A02,188811,Nie; Jiawang,0,0,35,35
1683363611741,MATH 170A,A03,188814,Nie; Jiawang,1,0,35,34
1683363611741,MATH 170A,A04,188815,Nie; Jiawang,13,0,35,22
1683363612769,MATH 193B,A01,188817,Staff,0,0,35,35
1683363612769,MATH 193B,A02,188818,Staff,5,0,35,30
1683363613793,MGT 4,A01,202857,Anderson; John Charles,61,0,80,19
1683363614817,MGT 12,A00,202858,Lindenberger; Wade Douglas,42,0,90,48
1683363615840,MGT 18,A00,202859,Staff,74,0,90,16
1683363616866,MGT 18GS,A00,202860,McKay; Michael J,13,0,28,15
1683363617892,MGT 45,A00,202861,Pecore; Joseph P.,15,0,90,75
1683363618920,MGT 100,A00,202863,Yavorsky; Daniel Ryan,28,0,90,62
1683363619950,MGT 103,A00,202864,Ehrich; Kristine R,0,17,90,90
1683363620973,MGT 112,A00,202865,Ehrich; Kristine R,15,0,90,75
1683363622000,MGT 121A,A00,202868,Staff,0,20,0,0
1683363623024,MGT 131B,A00,202869,Anderson; John Charles,59,0,90,31
1683363624054,MGT 136,A00,202871,Lindenberger; Wade Douglas,84,0,90,6
1683363625078,MGT 164,A00,202873,Staff,0,68,90,91
1683363626102,MGT 164GS,A00,202874,McKay; Mary A,13,0,28,15
1683363627127,MGT 180,A00,202875,Staff,0,50,90,91
1683363628158,MMW 11R,A01,205019,Herbst; Matthew,3,0,30,27
1683363628158,MMW 11R,A02,205026,Herbst; Matthew,29,0,30,1
1683363629184,MMW 15,A01,193512,Chang; Edmond Yi-Teh,0,9,28,28
1683363629184,MMW 15,A02,193513,Chang; Edmond Yi-Teh,0,5,28,28
1683363629184,MMW 15,A03,193514,Chang; Edmond Yi-Teh,0,5,28,28
1683363629184,MMW 15,A04,193515,Chang; Edmond Yi-Teh,0,5,28,28
1683363629184,MMW 15,A05,193516,Chang; Edmond Yi-Teh,0,4,28,28
1683363629184,MMW 15,A06,193517,Chang; Edmond Yi-Teh,0,5,28,28
1683363629184,MMW 15,B01,193519,Chang; Edmond Yi-Teh,0,5,28,28
1683363629184,MMW 15,B02,193520,Chang; Edmond Yi-Teh,0,5,28,28
1683363629184,MMW 15,B03,193521,Chang; Edmond Yi-Teh,0,5,28,28
1683363629184,MMW 15,B04,193522,Chang; Edmond Yi-Teh,0,4,28,28
1683363629184,MMW 15,B05,193523,Chang; Edmond Yi-Teh,0,5,28,28
1683363629184,MMW 15,B06,193524,Chang; Edmond Yi-Teh,0,4,28,28
1683363630208,MMW 122,A01,193526,Rahimi; Babak,0,15,28,28
1683363630208,MMW 122,A02,193527,Rahimi; Babak,0,14,28,28
1683363630208,MMW 122,A03,193528,Rahimi; Babak,0,0,0,0
1683363630208,MMW 122,A04,193529,Rahimi; Babak,0,0,0,0
1683363631233,MUS 1A,A01,186663,Staff,0,20,35,35
1683363632263,MUS 4,A01,186715,Staff,0,12,35,35
1683363633289,MUS 5R,A01,186796,Dubnov; Shlomo,0,17,35,35
1683363634313,MUS 6,A01,186798,Staff,0,4,25,25
1683363635338,MUS 7,A01,186830,Staff,13,0,35,22
1683363636362,MUS 8,A01,186930,Staff,0,26,35,35
1683363637387,MUS 15,A01,186932,Staff,0,16,35,35
1683363637387,MUS 15,B01,186934,Staff,0,15,35,35
1683363638415,MUS 80,A00,186935,Staff,0,0,20,20
1683363638415,MUS 80,B00,186936,Staff,25,0,25,0
1683363639446,NANO 11,A00,204702,Lipomi; Darren John,0,0,0,0
1683363640470,NANO 15,A01,204709,Yang; Kesong,0,1,0,0
1683363641497,NANO 114,A00,202069,Jahed Motlagh; Zeinab,3,0,10,7
1683363642526,PHIL 1,A00,186955,Grush; Rick Scott,32,0,40,8
1683363643550,PHIL 10,A01,186973,Grush; Rick Scott,28,0,35,7
1683363643550,PHIL 10,A02,186974,Grush; Rick Scott,33,0,35,2
1683363644575,PHIL 13,A01,186976,Staff,7,0,35,28
1683363644575,PHIL 13,A02,186977,Staff,16,0,35,19
1683363645599,PHIL 14,A01,186979,Staff,31,0,35,4
1683363645599,PHIL 14,A02,186986,Staff,32,0,35,3
1683363646623,PHIL 28,A01,186988,Staff,16,0,30,14
1683363646623,PHIL 28,A02,186989,Staff,1,0,30,29
1683363646623,PHIL 28,A03,186990,Staff,9,0,30,21
1683363646623,PHIL 28,A04,186991,Staff,26,0,30,4
1683363647648,PHIL 120,A00,186997,Staff,23,0,40,17
1683363648672,PHIL 137,A00,187003,Staff,9,0,40,31
1683363649698,PHIL 150,A00,187015,Staff,47,0,70,23
1683363650725,PHIL 167,A00,187021,Lamey; Andy M.,35,0,40,5
1683363651749,PHIL 174,A01,202226,Staff,17,0,20,3
1683363651749,PHIL 174,A02,202235,Staff,20,0,20,0
1683363652773,PHIL 191A,A00,258918,Staff,0,0,1,1
1683363653796,PHYS 1A,A00,187028,Staff,27,0,60,33
1683363654821,PHYS 1AL,001,187036,Staff,2,0,30,28
1683363654821,PHYS 1AL,002,187049,Staff,18,0,30,12
1683363655844,PHYS 1B,A00,187058,Staff,22,0,60,38
1683363656874,PHYS 1BL,001,187064,Staff,0,0,30,30
1683363656874,PHYS 1BL,002,187070,Staff,5,0,30,25
1683363657898,PHYS 1C,A00,187082,Staff,31,0,120,89
1683363658922,PHYS 1CL,001,187088,Staff,0,9,30,30
1683363658922,PHYS 1CL,002,187089,Staff,0,2,30,30
1683363658922,PHYS 1CL,009,262693,Staff,11,0,30,19
1683363659950,PHYS 2B,A01,187097,Staff,54,0,115,61
1683363660976,PHYS 2C,A01,187099,Staff,67,0,115,48
1683363662025,PHYS 2CL,A01,187101,Staff,5,0,28,23
1683363662025,PHYS 2CL,A02,187102,Staff,15,0,28,13
1683363663052,PHYS 2D,A01,187123,Shotwell; Brian,95,0,115,20
1683363664077,PHYS 4B,A01,187133,Grinstein; Benjamin,35,0,50,15
1683363665100,POLI 10,A00,188819,Staff,0,4,50,50
1683363666128,POLI 11,A00,188827,Staff,43,0,50,7
1683363667154,POLI 13R,A00,188828,Staff,0,1,20,20
1683363668180,POLI 27,A01,188830,Elgin; Samuel Zincke,0,1,70,70
1683363669210,POLI 30,A00,188832,Desposato; Scott,31,0,50,19
1683363670235,POLI 102F,A00,188834,Staff,3,0,40,37
1683363671315,POLI 104A,A00,188852,Staff,14,0,30,16
1683363672340,POLI 104I,A00,188853,Staff,0,6,20,20
1683363673366,POLI 110B,A00,188854,Wiens; David,7,0,20,13
1683363674393,POLI 112A,A00,188855,Wiens; David,5,0,30,25
1683363675418,POLI 117R,A00,188856,Forman; Fonna,0,11,20,20
1683363676443,POLI 118,A00,188857,Ingham; Sean,8,0,20,12
1683363677468,POLI 120G,A00,188858,Staff,9,0,30,21
1683363678495,POLI 131CR,A00,188863,Hoston; Germaine,23,0,50,27
1683363679520,POLI 133,A00,188864,Nellis; Gareth Hb,44,0,50,6
1683363680550,POLI 134D,A00,188865,Desposato; Scott,27,0,30,3
1683363681579,POLI 142A,A00,188871,Gartzke; Erik,22,0,50,28
1683363682609,POLI 142K,A00,188874,Staff,38,0,50,12
1683363683638,POLI 143,A00,188940,Gartzke; Erik,16,0,30,14
1683363684666,POLI 153,A00,188943,Staff,3,0,20,17
1683363685694,POLI 160AA,A00,188944,Staff,11,0,40,29
1683363686723,POLI 170A,A00,188945,Staff,11,0,30,19
1683363688773,PSYC 1,A00,188952,Staff,37,0,90,53
1683363689797,PSYC 2,B00,188953,Staff,19,0,35,16
1683363690827,PSYC 6,A00,188970,Staff,47,0,60,13
1683363691852,PSYC 7,A00,188973,Staff,37,0,45,8
1683363692877,PSYC 60,A01,188980,Rickard; Timothy C.,43,0,60,17
1683363693904,PSYC 70,A01,189001,Steiner; Eric Tomas,23,0,45,22
1683363694927,PSYC 100,A00,189005,Lacefield; Katharine I,0,98,120,120
1683363695955,PSYC 102,A00,189008,Staff,9,0,30,21
1683363696979,PSYC 106,B00,189026,Gorman; Michael R.,34,0,60,26
1683363698023,PSYC 114,B01,189033,Winkielman; Piotr,0,32,30,30
1683363699048,PSYC 131,A00,189036,Anagnostaras; Stephan,0,43,60,60
1683363700074,PSYC 136,A00,189041,Lowe; Angela Beth,0,7,25,25
1683363701099,PSYC 137,A00,189057,Winkielman; Piotr,0,34,25,25
1683363702129,PSYC 144,A00,189107,Wixted; John T,0,7,50,50
1683363704178,PSYC 162,A00,189142,Staff,0,8,85,85
1683363705207,PSYC 172,A00,189144,Gorman; Michael R.,0,7,30,30
1683363707260,PSYC 179,A00,189146,Lacefield; Katharine I,0,84,120,120
1683363708285,PSYC 181,A00,189147,Anagnostaras; Stephan,0,44,90,90
1683363709315,PSYC 190R,A00,189148,Barner; David A.,0,22,80,80
1683363710340,PSYC 191,A00,189275,Rickard; Timothy C.,0,7,25,25
1683363711364,PSYC 193,A00,189276,Chapman; Eddie Nathaniel,0,1,0,4
1683363712389,PSYC 193L,A01,189281,Lowe; Angela Beth,12,0,20,8
1683363712389,PSYC 193L,B01,189285,Staff,28,0,35,7
1683363713416,RELI 149,A00,187137,Rahimi; Babak,7,0,40,33
1683363714442,SE 9,A01,187315,Staff,0,2,18,18
1683363715468,SE 101B,A00,187409,Staff,24,0,30,6
1683363716494,SE 110B,A00,187444,Staff,10,0,40,30
1683363717520,SE 130B,A00,187449,Staff,31,0,40,9
1683363718548,SE 150A,A00,187516,Staff,9,0,20,11
1683363719574,SE 154,A00,187528,Staff,30,0,50,20
1683363720598,SIO 3,A01,258171,Staff,35,0,40,5
1683363721627,SIO 10,A00,187144,Cook; Geoffrey W,0,3,75,75
1683363722654,SIO 45,A00,187152,Cook; Geoffrey W,1,0,100,99
1683363723682,SIO 109R,A00,194486,Staff,0,3,20,20
1683363725742,SIO 187,A01,187233,Kacev; David,12,0,40,28
1683363726776,SOCI 1,A01,258656,Thorpe; Charles Robert,28,0,30,2
1683363726776,SOCI 1,A02,258658,Thorpe; Charles Robert,30,0,30,0
1683363726776,SOCI 1,A03,258661,Thorpe; Charles Robert,25,0,25,0
1683363726776,SOCI 1,A04,258666,Thorpe; Charles Robert,22,0,25,3
1683363726776,SOCI 1,A05,258897,Thorpe; Charles Robert,23,0,25,2
1683363726776,SOCI 1,A06,258898,Thorpe; Charles Robert,25,0,25,0
1683363727807,SOCI 30,A01,258903,Pardo Guerra; Juan Pablo,15,0,30,15
1683363728835,SOCI 102,A00,258904,Staff,9,0,25,16
1683363729864,SOCI 106,A00,258905,Staff,19,0,25,6
1683363730889,SOCI 111,A00,258907,Ribas Norris; Janet Vanesa,26,0,30,4
1683363731916,SOCI 121R,A00,258908,Pardo Guerra; Juan Pablo,10,0,30,20
1683363732941,SOCI 126,A01,203330,Staff,14,0,20,6
1683363733965,SOCI 131,A00,258909,Thorpe; Charles Robert,31,0,60,29
1683363734992,SOCI 135,A00,258910,Payne; Christine Anna,0,9,30,30
1683363736015,SOCI 157,A00,258911,Staff,12,0,30,18
1683363737041,SOCI 184,A00,258912,Staff,25,0,30,5
1683363738064,SOCI 188D,A00,258913,Staff,22,0,30,8
1683363739092,SYN 2,001,187529,Staff,10,0,16,6
1683363739092,SYN 2,002,201452,Staff,0,18,16,16
1683363739092,SYN 2,003,201469,Staff,3,0,16,13
1683363740118,SYN 100,A01,187531,Staff,0,9,20,20
1683363740118,SYN 100,B01,201491,Staff,0,12,20,20
1683363741142,TDAC 1,A00,189286,Walsh; Kim C.,3,0,20,17
1683363741142,TDAC 1,B00,189287,Harting; Carla Kelso,11,0,20,9
1683363742166,TDAC 101,A00,189300,Walsh; Kim C.,16,0,20,4
1683363742166,TDAC 101,B00,189301,Harting; Carla Kelso,18,0,20,2
1683363743196,TDAC 102,A00,189304,Basso; Beatrice,14,0,20,6
1683363744222,TDAC 108,A00,189305,Staff,18,0,20,2
1683363745250,TDDE 131,A00,189310,Staff,19,0,20,1
1683363745250,TDDE 131,B00,189314,Staff,19,0,20,1
1683363745250,TDDE 131,C00,189315,Staff,48,0,50,2
1683363745250,TDDE 131,D00,189316,Staff,14,0,15,1
1683363745250,TDDE 131,E00,204841,Staff,20,0,20,0
1683363746275,TDGE 10,A00,189289,Staff,30,0,50,20
1683363746275,TDGE 10,B00,189290,Havis; Allan,1,0,50,49
1683363747301,TDGE 11,A00,189291,Fulton; Julia,0,3,50,50
1683363747301,TDGE 11,B00,189292,Staff,20,0,25,5
1683363747301,TDGE 11,C00,260270,Staff,0,0,0,0
1683363748324,TDGE 25,A00,189294,Staff,3,0,20,17
1683363749353,TDGE 124,A00,189318,Fulton; Julia,0,8,50,50
1683363750378,TDGE 125,A00,189319,Staff,13,0,25,12
1683363750378,TDGE 125,B00,189320,Staff,23,0,25,2
1683363751401,TDGE 127,A00,189322,Havis; Allan,0,0,50,50
1683363752427,TDHT 101,A00,189323,Staff,18,0,25,7
1683363752427,TDHT 101,B00,189324,Staff,25,0,25,0
1683363753451,TDHT 102,A00,189325,Staff,49,0,50,1
1683363754477,TDMV 1,A00,189295,Arcidiacono; Kristin,19,0,30,11
1683363754477,TDMV 1,B00,189296,Caligagan; Maria T.,24,0,30,6
1683363755505,TDMV 2,A00,189297,Sammartano; Tonnie,28,0,30,2
1683363755505,TDMV 2,B00,189299,Arcidiacono; Kristin,24,0,30,6
1683363756530,TDMV 3,A00,204998,Rincon; Alicia,22,0,30,8
1683363757553,TDMV 120,A00,189458,Sammartano; Tonnie,28,0,30,2
1683363758577,TDMV 138,A00,189541,Jun; Grace Shin Hae,22,0,40,18
1683363759601,TDMV 142,A00,189717,Caligagan; Tony,24,0,30,6
1683363759601,TDMV 142,B00,189718,Caligagan; Maria T.,25,0,30,5
1683363760625,TMC 2,A01,187533,Staff,25,0,25,0
1683363760625,TMC 2,A02,187534,Staff,25,0,25,0
1683363761650,USP 1,A01,187536,Kwak; Nancy,0,16,25,25
1683363762674,USP 5,A01,187538,Staff,10,0,25,15
1683363763698,USP 101,A00,199253,Staff,0,4,0,0
1683363764725,USP 124,A00,187562,Boomhower; Matthew Charles,1,0,30,29
1683363765749,USP 138,A00,187582,Staff,20,0,25,5
1683363766775,USP 152,A01,187597,Staff,4,0,25,21
1683363767803,USP 153,A00,187598,Staff,19,0,25,6
1683363768832,USP 168,A00,187607,Kwak; Nancy,2,0,5,3
1683363769860,USP 173,A00,187619,Staff,4,0,25,21
1683363770888,USP 181,A00,187638,Staff,0,3,25,25
1683363771916,VIS 103,A00,187650,Cruz; Edwin Teddy,22,0,75,53
1683363772940,VIS 110D,A00,187669,Staff,12,0,22,10
1683363773964,VIS 127C,A00,187720,Shen; Kuiyi,67,0,146,79
1683363775048,VIS 149,A00,187731,Yoldas; Pinar,0,14,22,22
1683363776071,VIS 151,A01,188091,Staff,22,0,34,12
1683363776071,VIS 151,A02,188092,Staff,11,0,34,23
1683363777099,VIS 160B,A00,188093,Stalbaum; Brett,0,0,10,10
1683363779150,WCWP 10B,A00,201720,Staff,10,0,15,5
1683363779150,WCWP 10B,B00,201722,Staff,9,0,15,6
1683363780176,WCWP 100,A00,201725,Gagnon; Jeffrey C,0,0,2,2
1683363780176,WCWP 100,B00,201727,Staff,0,4,15,15
1683363783383,ANBI 133,A00,258401,Wilder; Linnea Lorene,34,0,40,6
1683363784407,ANBI 140,A00,258395,Hrvoj Mihic; Branka,18,0,25,7
1683363785435,ANSC 120,A00,258402,Bialecki; Jon Anthony,27,0,40,13
1683363786461,ANSC 144,A00,258400,Staff,14,0,40,26
1683363788525,ANSC 166,A00,258396,Parish; Steven Martin,157,0,175,18
1683363789555,ANSC 180,A00,193533,Staff,9,0,20,11
1683363790584,ANSC 188,A00,258397,Jassal; Aftab,33,0,40,7
1683363791614,ANTH 3,A01,258316,Staff,23,0,30,7
1683363792639,ANTH 5,A00,258394,Semendeferi; Ekaterini,16,0,20,4
1683363793667,ANTH 21,A01,258331,Staff,8,0,40,32
1683363794691,ANTH 103,A00,258398,Varma; Saiba,15,0,25,10
1683363795726,AWP 10,001,202034,Staff,0,0,0,0
1683363795726,AWP 10,002,202035,Staff,0,0,0,0
1683363795726,AWP 10,003,202036,Staff,0,0,0,0
1683363795726,AWP 10,004,202037,Staff,0,0,0,0
1683363795726,AWP 10,005,202038,Staff,0,0,0,0
1683363795726,AWP 10,006,202039,Staff,0,0,0,0
1683363795726,AWP 10,007,202040,Staff,0,0,0,0
1683363795726,AWP 10,008,202041,Staff,0,0,0,0
1683363795726,AWP 10,009,202042,Staff,0,0,0,0
1683363795726,AWP 10,010,202043,Staff,0,0,0,0
1683363795726,AWP 10,011,202044,Staff,0,0,0,0
1683363795726,AWP 10,012,202045,Staff,0,0,0,0
1683363795726,AWP 10,013,202046,Staff,0,0,0,0
1683363795726,AWP 10,014,202047,Staff,0,0,0,0
1683363795726,AWP 10,015,202048,Staff,0,0,0,0
1683363795726,AWP 10,016,202049,Staff,0,0,0,0
1683363795726,AWP 10,017,202050,Staff,0,0,0,0
1683363795726,AWP 10,018,202051,Staff,0,0,0,0
1683363795726,AWP 10,019,202052,Staff,0,0,0,0
1683363795726,AWP 10,020,202053,Staff,0,0,0,0
1683363795726,AWP 10,021,202054,Staff,0,0,0,0
1683363795726,AWP 10,022,202055,Staff,0,0,0,0
1683363795726,AWP 10,023,202056,Staff,0,0,0,0
1683363795726,AWP 10,024,202057,Staff,0,0,0,0
1683363795726,AWP 10,025,202058,Staff,0,0,0,0
1683363795726,AWP 10,026,202059,Staff,0,0,0,0
1683363796750,AWP 102,001,202032,Staff,0,0,0,0
1683363796750,AWP 102,002,202033,Staff,0,0,0,0
1683363797776,BENG 100,A01,254234,Taylor Amos; Alyssa C,31,0,40,9
1683363798803,BENG 196,001,270013,Engler; Adam J.,9999,0,9999,0
1683363799830,BICD 100R,A01,202018,Smith; Laurie,0,7,32,32
1683363799830,BICD 100R,A02,202019,Smith; Laurie,0,2,32,32
1683363799830,BICD 100R,A03,202020,Smith; Laurie,0,1,32,32
1683363799830,BICD 100R,A04,202021,Smith; Laurie,9,0,32,23
1683363799830,BICD 100R,A05,202022,Smith; Laurie,12,0,32,20
1683363800857,BICD 136,A01,193242,Gustafson-Brown; Cindy,0,2,32,32
1683363800857,BICD 136,A02,193244,Gustafson-Brown; Cindy,14,0,32,18
1683363801883,BIEB 102,A01,193249,Butler; Shannon Rhey,0,2,32,32
1683363801883,BIEB 102,A02,193251,Butler; Shannon Rhey,0,0,32,32
1683363801883,BIEB 102,A03,193253,Butler; Shannon Rhey,0,1,32,32
1683363801883,BIEB 102,A04,193255,Butler; Shannon Rhey,17,0,32,15
1683363801883,BIEB 102,A05,193265,Butler; Shannon Rhey,26,0,32,6
1683363801883,BIEB 102,A06,193269,Butler; Shannon Rhey,16,0,32,16
1683363803935,BIEB 150,A01,193274,Staff,0,0,32,32
1683363803935,BIEB 150,A02,193285,Staff,23,0,32,9
1683363804964,BIEB 194,A00,193286,Kurle; Carolyn M.,22,0,32,10
1683363805994,BILD 1,A01,192291,Staff,16,0,32,16
1683363805994,BILD 1,A02,192292,Staff,30,0,32,2
1683363805994,BILD 1,B01,192520,Reuther; Keefe,0,1,0,0
1683363805994,BILD 1,B02,192532,Reuther; Keefe,0,1,0,0
1683363807025,BILD 3,A01,192556,Butler; Shannon Rhey,0,0,32,32
1683363807025,BILD 3,A02,192581,Butler; Shannon Rhey,4,0,32,28
1683363807025,BILD 3,A03,192611,Butler; Shannon Rhey,23,0,32,9
1683363807025,BILD 3,A04,192612,Butler; Shannon Rhey,25,0,32,7
1683363807025,BILD 3,A05,192613,Butler; Shannon Rhey,27,0,32,5
1683363807025,BILD 3,A06,192679,Butler; Shannon Rhey,27,0,32,5
1683363807025,BILD 3,A07,192682,Butler; Shannon Rhey,21,0,32,11
1683363808050,BILD 4,A01,192836,Reuther; Keefe,0,0,24,24
1683363808050,BILD 4,A02,193044,Reuther; Keefe,4,0,24,20
1683363809075,BILD 10,A01,193142,Gustafson-Brown; Cindy,30,0,32,2
1683363809075,BILD 10,A02,193149,Gustafson-Brown; Cindy,31,0,32,1
1683363810100,BIMM 100,A01,193301,Staff,1,6,32,31
1683363810100,BIMM 100,A02,193312,Staff,0,5,32,32
1683363810100,BIMM 100,A03,193323,Staff,0,8,32,32
1683363811124,BIMM 101,A01,193329,McDonnell; Lisa Marie,0,3,24,24
1683363811124,BIMM 101,A02,193339,McDonnell; Lisa Marie,0,3,24,24
1683363811124,BIMM 101,B01,193354,McDonnell; Lisa Marie,0,3,24,24
1683363811124,BIMM 101,B02,193357,McDonnell; Lisa Marie,0,3,24,24
1683363812151,BIMM 110,A01,193377,Tat; John,0,11,32,32
1683363812151,BIMM 110,A02,193378,Tat; John,0,9,32,32
1683363813177,BIMM 120,A01,206116,Staff,0,0,32,32
1683363813177,BIMM 120,A02,206117,Staff,8,0,32,24
1683363813177,BIMM 120,A03,206121,Staff,21,0,32,11
1683363814201,BIPN 100,A01,193393,Park; Ji Young,0,14,32,32
1683363814201,BIPN 100,A02,193402,Park; Ji Young,0,13,32,32
1683363814201,BIPN 100,A03,193413,Park; Ji Young,0,14,32,32
1683363814201,BIPN 100,A04,193414,Park; Ji Young,0,13,32,32
1683363815226,BIPN 102,A01,193429,Staff,0,0,32,32
1683363815226,BIPN 102,A02,193438,Staff,22,0,32,10
1683363816250,BIPN 106,A01,193450,Reyes Gonzalez; Catalina,0,2,40,40
1683363817274,BIPN 134,A01,193465,Cooke; James Edward,1,0,32,31
1683363817274,BIPN 134,A02,193474,Cooke; James Edward,25,0,32,7
1683363817274,BIPN 134,A03,193485,Cooke; James Edward,29,0,32,3
1683363817274,BIPN 134,A04,193486,Cooke; James Edward,21,0,32,11
1683363817274,BIPN 134,A05,193491,Cooke; James Edward,31,0,32,1
1683363817274,BIPN 134,A06,193501,Cooke; James Edward,30,0,32,2
1683363817274,BIPN 134,A07,193510,Cooke; James Edward,29,0,32,3
1683363819330,BISP 194,A00,222522,Staff,14,0,32,18
1683363820354,CAT 124,A01,202407,Staff,19,0,25,6
1683363821378,CAT 125,A00,202408,Marchisotto; Jennifer Anne,4,0,20,16
1683363822406,CAT 125R,A00,202409,Smith; Lauryn Alissa,0,11,20,20
1683363822406,CAT 125R,B00,202410,Morales; Celeste Georgianna,0,11,20,20
1683363822406,CAT 125R,C00,202411,Irwin; Matthew Joseph,0,10,20,20
1683363823435,CENG 15,A01,204712,Yang; Kesong,0,1,0,0
1683363824460,CENG 114,A00,202070,Jahed Motlagh; Zeinab,5,0,20,15
1683363825486,CGS 105,A00,185477,Wesling; Megan E.,24,0,40,16
1683363826510,CGS 106,A00,185494,Staff,13,0,22,9
1683363827535,CGS 108,A00,185495,Staff,14,0,20,6
1683363828562,CGS 114,A00,185496,Staff,13,0,18,5
1683363829589,CGS 119,A00,185501,Staff,15,0,20,5
1683363830617,CGS 120,A00,185511,Staff,13,0,20,7
1683363831646,CHEM 4,A01,184675,Bussey; Thomas J,96,0,100,4
1683363832673,CHEM 6A,A01,184677,Staff,34,0,60,26
1683363833702,CHEM 6B,A01,184679,Staff,65,0,100,35
1683363834731,CHEM 6C,A01,184681,Bussey; Thomas J,1,0,50,49
1683363834731,CHEM 6C,A02,184682,Bussey; Thomas J,34,0,50,16
1683363835755,CHEM 40A,A01,184684,Albizati; Kim F.,37,0,100,63
1683363836783,CHEM 40B,A01,184686,Albizati; Kim F.,0,20,100,100
1683363837807,CHEM 41B,A01,184690,Staff,52,0,100,48
1683363838831,COGS 3,A01,184715,Boyle; Mary E. T.,0,25,40,40
1683363839858,COGS 14B,A01,185172,Staff,0,15,38,38
1683363840886,COGS 18,A01,184736,Staff,16,0,80,64
1683363841910,COGS 100,A01,184932,Staff,0,5,73,73
1683363842935,COGS 101A,A01,184935,Staff,0,39,30,30
1683363843959,COGS 101B,A01,184944,Staff,0,2,30,30
1683363844984,COGS 101C,A01,184946,Staff,0,12,30,30
1683363846008,COGS 102A,A01,184951,Johnson; Christine M.,2,0,40,38
1683363847037,COGS 107B,A01,184953,Mooshagian; Eric Frederick,0,50,40,40
1683363848066,COGS 118B,A01,184959,Gupta; Anjum,0,48,40,40
1683363849089,COGS 153,A00,184961,Staff,0,15,30,30
1683363850117,COGS 177,A00,184962,Staff,0,20,30,30
1683363851146,COGS 187A,A01,184969,Boyle; Mary E. T.,0,17,40,40
1683363852175,COMM 10,A01,185174,Staff,0,5,25,25
1683363852175,COMM 10,A02,185189,Staff,0,5,25,25
1683363852175,COMM 10,A03,269821,Staff,0,0,0,0
1683363853199,COMM 100B,A01,185475,Staff,0,0,0,2
1683363853199,COMM 100B,A02,185476,Staff,13,0,25,12
1683363854225,COMM 100C,A01,185314,Staff,1,0,25,24
1683363854225,COMM 100C,A02,185327,Staff,19,0,25,6
1683363855249,COMM 110M,A00,185349,Staff,2,0,40,38
1683363856272,COMM 113T,A00,185352,Staff,24,0,40,16
1683363857296,COMM 114I,A00,185353,Staff,33,0,40,7
1683363858319,COMM 131,A00,185354,Staff,19,0,30,11
1683363859347,CSE 8A,A50,185358,Cao; Yingjun,0,46,10,10
1683363860374,CSE 8B,A01,185362,Staff,0,46,50,50
1683363861401,CSE 11,A01,185416,Cao; Yingjun,0,92,10,10
1683363862426,CSE 20,A01,185445,Briones; Jor-el Thomas Caparas,5,0,25,20
1683363863451,CSE 21,A01,185447,Staff,10,0,50,40
1683363864476,CSE 101,A01,185451,Staff,0,13,50,50
1683363864476,CSE 101,B01,185453,Jones; Miles E,0,11,50,50
1683363866528,CSE 141,A01,185458,Eldon; John,20,0,100,80
1683363867554,CSE 141L,A01,185461,Eldon; John,12,0,100,88
1683363868582,CSE 142,A01,185463,Staff,36,0,60,24
1683363868582,CSE 142,B01,201355,Staff,0,7,60,60
1683363869609,CSE 142L,A01,185470,Staff,36,0,60,24
1683363869609,CSE 142L,B01,201417,Staff,0,6,60,60
1683363870633,CSE 190,A00,201433,Staff,32,0,49,17
1683363871658,DOC 1,A01,259136,Strom; Megan C.,7,0,15,8
1683363871658,DOC 1,A02,259137,Strom; Megan C.,14,0,15,1
1683363871658,DOC 1,A03,259138,Strom; Megan C.,14,0,15,1
1683363871658,DOC 1,A04,259139,Strom; Megan C.,14,0,15,1
1683363872686,DOC 100D,A00,259140,Pass; Natalye Joann,16,0,25,9
1683363873715,DSGN 1,A01,184749,Rill; Bryan,0,25,30,30
1683363874739,DSGN 100,A01,185168,Staff,0,2,25,25
1683363875764,ECE 5,A01,185626,Morris; Karcher William,0,10,0,0
1683363876789,ECE 101,A01,185628,Staff,17,0,70,53
1683363877814,ECE 107,A01,185635,Baghdadchi; Saharnaz,0,0,20,20
1683363877814,ECE 107,A02,185638,Baghdadchi; Saharnaz,4,0,20,16
1683363878894,ECE 148,A01,185647,Silberman; Jack,0,0,16,16
1683363879922,ECON 1,A01,185537,Crane; Meredith Helen,54,0,70,16
1683363880950,ECON 3,A01,185549,Crane; Meredith Helen,32,0,70,38
1683363881978,ECON 4,A01,203354,Anderson; John Charles,0,4,10,10
1683363883006,ECON 100A,A01,185574,Staff,0,4,40,40
1683363884034,ECON 100B,A01,185576,Staff,0,12,50,50
1683363885060,ECON 100C,A01,185589,Newhouse; Herbert S,29,0,70,41
1683363886086,ECON 105,A00,185608,Vespa; Emanuel Ignacio,19,0,35,16
1683363887109,ECON 109,A01,185610,Shishkin; Denis,10,0,35,25
1683363888134,ECON 110A,A01,185612,Staff,11,0,40,29
1683363889161,ECON 120A,A01,185615,Staff,20,0,40,20
1683363890187,ECON 120C,A01,185617,Sun; Yixiao,0,21,70,70
1683363891216,ECON 144,A00,203346,Squires; Dale E,3,0,35,32
1683363892243,ECON 171,A01,203349,Newhouse; Herbert S,0,1,35,35
1683363893269,ECON 173A,A01,185621,Toda; Alexis Akira,21,0,35,14
1683363894295,EDS 25,A01,202413,Staff,0,1,0,0
1683363894295,EDS 25,A02,202414,Staff,0,1,0,0
1683363894295,EDS 25,A03,202415,Staff,0,0,0,0
1683363894295,EDS 25,A04,202416,Staff,0,1,0,0
1683363894295,EDS 25,A05,202439,Staff,0,0,0,0
1683363894295,EDS 25,A06,202440,Staff,0,0,0,0
1683363894295,EDS 25,B01,202631,Staff,0,0,0,0
1683363894295,EDS 25,B02,202632,Staff,0,0,0,0
1683363894295,EDS 25,B03,202639,Staff,0,0,0,0
1683363894295,EDS 25,B04,202640,Staff,0,0,0,0
1683363894295,EDS 25,B05,202643,Staff,0,0,0,0
1683363894295,EDS 25,B06,202644,Staff,0,0,0,0
1683363895322,EDS 38,A01,202659,Black; Alison Michelle,24,0,25,1
1683363896348,EDS 115,A00,202652,Staff,18,0,30,12
1683363897372,EDS 125,A00,202649,Staff,14,0,30,16
1683363898396,EDS 126,A01,203332,Staff,30,0,30,0
1683363899422,EDS 139,A00,202838,Staff,16,0,25,9
1683363900449,EDS 146,A01,202655,Staff,14,0,25,11
1683363901478,ENG 15,A00,185667,Staff,0,1,0,0
1683363901478,ENG 15,B00,185672,Staff,0,0,0,0
1683363901478,ENG 15,C00,185675,Staff,0,0,0,0
1683363901478,ENG 15,D00,185682,Staff,0,0,0,0
1683363901478,ENG 15,E00,185684,Staff,0,0,0,0
1683363902504,ETHN 103,A00,185710,Staff,0,4,35,35
1683363903530,ETHN 103A,A00,199228,Man; Simeon S,2,0,9,7
1683363904554,ETHN 109,A00,185711,Staff,18,0,35,17
1683363905582,ETHN 142,A00,185726,Staff,0,4,30,30
1683363906607,ETHN 163J,A00,199229,Man; Simeon S,5,0,8,3
1683363907634,ETHN 168,A00,185727,Staff,8,0,10,2
1683363908657,ETHN 182,A00,185728,Staff,0,0,35,35
1683363909685,ETHN 183,A00,185737,Staff,8,0,18,10
1683363910709,GLBH 111,A01,209361,Burgos; Jose L.,0,0,0,0
1683363912761,HIEU 104,A00,185792,Staff,16,0,20,4
1683363913785,HIEU 115,A00,185800,Staff,1,0,20,19
1683363914812,HIEU 128,A00,185801,Staff,0,7,20,20
1683363915836,HIEU 147,A00,185802,Staff,16,0,20,4
1683363916860,HIEU 154,A00,185823,Staff,12,0,20,8
1683363917894,HILA 102,A00,185826,Staff,13,0,20,7
1683363918919,HILD 2C,A01,185778,Staff,0,12,20,20
1683363919945,HILD 7B,A01,185780,Kwak; Nancy,0,15,32,32
1683363919945,HILD 7B,A02,185781,Kwak; Nancy,0,18,32,32
1683363920971,HILD 30,A01,185791,Staff,14,0,20,6
1683363921996,HISC 119,A00,185830,Golan; Tal,0,9,20,20
1683363923023,HITO 156GS,A00,185831,Patterson; Patrick H.,0,0,0,23
1683363924047,HIUS 103,A00,185832,Man; Simeon S,1,6,20,19
1683363925071,HIUS 117,A00,185836,Kwak; Nancy,2,0,20,18
1683363926096,HIUS 125,A00,185840,Man; Simeon S,0,0,23,23
1683363927120,HIUS 149,A00,185845,Staff,0,0,20,20
1683363928145,HUM 3,A01,185882,Zavodny; Tatiana Sophia,0,7,50,50
1683363928145,HUM 3,B01,185899,Caldwell; Michael Alan,0,18,50,50
1683363929172,HUM 3GS,A00,185900,Patterson; Patrick H.,0,0,0,23
1683363930203,HUM 4,A01,185938,Zroka; Amy Liane,31,0,50,19
1683363930203,HUM 4,B01,185956,Watkins; Eric,0,3,50,50
1683363930203,HUM 4,B02,202209,Watkins; Eric,0,2,50,50
1683363930203,HUM 4,B03,202210,Watkins; Eric,0,2,50,50
1683363931227,HUM 5,A01,185958,West; Geoffrey Scott,3,0,50,47
1683363931227,HUM 5,A02,202215,West; Geoffrey Scott,0,0,50,50
1683363932255,INTL 190,A00,185959,Gagnon; Jeffrey C,0,0,0,9
1683363932255,INTL 190,B00,185960,Lettieri; Michael Joseph,0,0,0,1
1683363933281,JAPN 180,A00,254509,Staff,4,0,30,26
1683363934309,LATI 10,A01,202853,Kennemore; Amy Michelle,4,0,35,31
1683363934309,LATI 10,A02,202854,Kennemore; Amy Michelle,2,0,35,33
1683363934309,LATI 10,A03,270054,Kennemore; Amy Michelle,30,0,30,0
1683363935333,LATI 180,A00,202855,Kennemore; Amy Michelle,11,0,20,9
1683363936357,LAWS 101,A00,201767,Golan; Tal,0,7,40,40
1683363937383,LIFR 1C,A00,185961,Staff,6,0,20,14
1683363938406,LIFR 1CX,A00,185962,Staff,7,0,20,13
1683363939430,LIFR 1D,A00,185963,Staff,9,0,20,11
1683363940457,LIFR 1DX,A00,185964,Staff,9,0,20,11
1683363941483,LIGN 101,A01,186039,Staff,43,0,50,7
1683363942507,LIGN 165,A00,186040,Staff,18,0,50,32
1683363943532,LTCS 108,A00,186041,Staff,6,0,10,4
1683363944555,LTCS 119,A00,186042,Staff,16,0,20,4
1683363945579,LTCS 130,A00,186043,Wesling; Megan E.,15,0,25,10
1683363947628,LTEA 138,A00,186119,Staff,14,0,40,26
1683363948652,LTEN 124,A00,186148,Staff,6,0,25,19
1683363949679,LTEN 178,A00,186149,Staff,7,0,15,8
1683363950705,LTEN 181,A00,186150,Blanco; John D,33,0,40,7
1683363951733,LTWL 120,A00,186160,Staff,20,0,25,5
1683363952760,LTWL 165,A00,186161,Staff,22,0,25,3
1683363953783,LTWR 100,A00,186162,Staff,0,5,15,15
1683363954807,LTWR 102,A00,186163,Doller; Ben,5,0,15,10
1683363955833,MAE 8,A01,186412,Staff,0,0,0,0
1683363956858,MAE 30B,A00,186445,Bahadori; Mohammad Yousef,83,0,100,17
1683363957882,MAE 40,A00,186592,Bewley; Thomas R,10,0,50,40
1683363958910,MAE 101B,A00,186593,Bahadori; Mohammad Yousef,81,0,100,19
1683363959935,MAE 105,A00,186594,Bandaru; Prabhakar,12,0,50,38
1683363960963,MAE 107,A00,186599,Pham; Hieu Tan,0,7,120,120
1683363961988,MAE 148,A01,186660,Silberman; Jack,3,0,16,13
1683363963013,MATH 10A,A01,188095,Staff,0,5,35,35
1683363964043,MATH 10B,A01,188097,Bowers; Adam R.,0,11,30,30
1683363964043,MATH 10B,A02,188099,Bowers; Adam R.,0,11,30,30
1683363964043,MATH 10B,B01,188104,Bowers; Adam R.,0,10,30,30
1683363964043,MATH 10B,B02,188106,Bowers; Adam R.,0,10,30,30
1683363965070,MATH 10C,A01,188111,Staff,0,18,30,30
1683363965070,MATH 10C,A02,188127,Staff,0,17,30,30
1683363965070,MATH 10C,A03,188131,Staff,0,18,30,30
1683363965070,MATH 10C,B01,188218,Staff,18,0,30,12
1683363965070,MATH 10C,B02,188244,Staff,13,0,30,17
1683363965070,MATH 10C,B03,188277,Staff,16,0,30,14
1683363966098,MATH 18,A01,188344,Bach; Quang Tran,18,0,30,12
1683363966098,MATH 18,A02,188345,Bach; Quang Tran,11,0,30,19
1683363966098,MATH 18,B01,188353,Bach; Quang Tran,10,0,30,20
1683363966098,MATH 18,B02,188354,Bach; Quang Tran,20,0,30,10
1683363967125,MATH 20A,A01,188374,Staff,12,0,35,23
1683363968150,MATH 20B,A01,188382,Ohm; Ko Woon,6,0,30,24
1683363968150,MATH 20B,A02,188383,Ohm; Ko Woon,21,0,30,9
1683363968150,MATH 20B,B01,188385,Ohm; Ko Woon,7,0,30,23
1683363968150,MATH 20B,B02,188392,Ohm; Ko Woon,22,0,30,8
1683363969176,MATH 20C,A01,188394,Harel; Guershon,10,0,30,20
1683363969176,MATH 20C,A02,188395,Harel; Guershon,15,0,30,15
1683363969176,MATH 20C,B01,188404,Harel; Guershon,4,0,30,26
1683363969176,MATH 20C,B02,188405,Harel; Guershon,19,0,30,11
1683363970207,MATH 20D,A01,188414,Hammock; Frances H,0,1,30,30
1683363970207,MATH 20D,A02,188415,Hammock; Frances H,3,0,30,27
1683363970207,MATH 20D,B01,188447,Hammock; Frances H,1,0,30,29
1683363970207,MATH 20D,B02,188486,Hammock; Frances H,8,0,30,22
1683363971231,MATH 20E,A01,188649,Staff,21,0,30,9
1683363971231,MATH 20E,A02,188650,Staff,23,0,30,7
1683363971231,MATH 20E,A03,188673,Staff,0,0,30,30
1683363972259,MATH 102,A01,188675,Staff,0,35,35,35
1683363973284,MATH 103B,A01,188681,Staff,3,0,35,32
1683363973284,MATH 103B,B01,188692,Staff,5,0,35,30
1683363974308,MATH 109,A01,188695,Salehi Golsefidy; Alireza,25,0,35,10
1683363974308,MATH 109,A02,188696,Salehi Golsefidy; Alireza,25,0,35,10
1683363975334,MATH 120A,A01,188698,Eggers; John Dietrich,7,0,35,28
1683363976359,MATH 142B,A01,188736,Ioana; Adrian,0,2,30,30
1683363976359,MATH 142B,A02,188741,Ioana; Adrian,0,0,30,30
1683363976359,MATH 142B,A03,188743,Ioana; Adrian,0,1,30,30
1683363977387,MATH 168A,A01,188790,Staff,0,9,35,35
1683363978415,MATH 170A,A01,188803,Nie; Jiawang,0,2,35,35
1683363978415,MATH 170A,A02,188811,Nie; Jiawang,0,0,35,35
1683363978415,MATH 170A,A03,188814,Nie; Jiawang,1,0,35,34
1683363978415,MATH 170A,A04,188815,Nie; Jiawang,13,0,35,22
1683363979439,MATH 193B,A01,188817,Staff,0,0,35,35
1683363979439,MATH 193B,A02,188818,Staff,5,0,35,30
1683363980463,MGT 4,A01,202857,Anderson; John Charles,61,0,80,19
1683363981486,MGT 12,A00,202858,Lindenberger; Wade Douglas,42,0,90,48
1683363982583,MGT 18,A00,202859,Staff,74,0,90,16
1683363983608,MGT 18GS,A00,202860,McKay; Michael J,13,0,28,15
1683363984635,MGT 45,A00,202861,Pecore; Joseph P.,15,0,90,75
1683363985660,MGT 100,A00,202863,Yavorsky; Daniel Ryan,28,0,90,62
1683363986689,MGT 103,A00,202864,Ehrich; Kristine R,0,17,90,90
1683363987713,MGT 112,A00,202865,Ehrich; Kristine R,15,0,90,75
1683363988737,MGT 121A,A00,202868,Staff,0,20,0,0
1683363989765,MGT 131B,A00,202869,Anderson; John Charles,59,0,90,31
1683363990791,MGT 136,A00,202871,Lindenberger; Wade Douglas,84,0,90,6
1683363991818,MGT 164,A00,202873,Staff,0,68,90,91
1683363992844,MGT 164GS,A00,202874,McKay; Mary A,13,0,28,15
1683363993871,MGT 180,A00,202875,Staff,0,50,90,91
1683363994895,MMW 11R,A01,205019,Herbst; Matthew,3,0,30,27
1683363994895,MMW 11R,A02,205026,Herbst; Matthew,29,0,30,1
1683363995920,MMW 15,A01,193512,Chang; Edmond Yi-Teh,0,9,28,28
1683363995920,MMW 15,A02,193513,Chang; Edmond Yi-Teh,0,5,28,28
1683363995920,MMW 15,A03,193514,Chang; Edmond Yi-Teh,0,5,28,28
1683363995920,MMW 15,A04,193515,Chang; Edmond Yi-Teh,0,5,28,28
1683363995920,MMW 15,A05,193516,Chang; Edmond Yi-Teh,0,4,28,28
1683363995920,MMW 15,A06,193517,Chang; Edmond Yi-Teh,0,5,28,28
1683363995920,MMW 15,B01,193519,Chang; Edmond Yi-Teh,0,5,28,28
1683363995920,MMW 15,B02,193520,Chang; Edmond Yi-Teh,0,5,28,28
1683363995920,MMW 15,B03,193521,Chang; Edmond Yi-Teh,0,5,28,28
1683363995920,MMW 15,B04,193522,Chang; Edmond Yi-Teh,0,4,28,28
1683363995920,MMW 15,B05,193523,Chang; Edmond Yi-Teh,0,5,28,28
1683363995920,MMW 15,B06,193524,Chang; Edmond Yi-Teh,0,4,28,28
1683363996945,MMW 122,A01,193526,Rahimi; Babak,0,15,28,28
1683363996945,MMW 122,A02,193527,Rahimi; Babak,0,14,28,28
1683363996945,MMW 122,A03,193528,Rahimi; Babak,0,0,0,0
1683363996945,MMW 122,A04,193529,Rahimi; Babak,0,0,0,0
1683363997969,MUS 1A,A01,186663,Staff,0,20,35,35
1683363998993,MUS 4,A01,186715,Staff,0,12,35,35
1683364000016,MUS 5R,A01,186796,Dubnov; Shlomo,0,17,35,35
1683364001042,MUS 6,A01,186798,Staff,0,4,25,25
1683364002066,MUS 7,A01,186830,Staff,13,0,35,22
1683364003090,MUS 8,A01,186930,Staff,0,26,35,35
1683364004117,MUS 15,A01,186932,Staff,0,16,35,35
1683364004117,MUS 15,B01,186934,Staff,0,15,35,35
1683364005140,MUS 80,A00,186935,Staff,0,0,20,20
1683364005140,MUS 80,B00,186936,Staff,25,0,25,0
1683364006165,NANO 11,A00,204702,Lipomi; Darren John,0,0,0,0
1683364007189,NANO 15,A01,204709,Yang; Kesong,0,1,0,0
1683364008217,NANO 114,A00,202069,Jahed Motlagh; Zeinab,3,0,10,7
1683364009242,PHIL 1,A00,186955,Grush; Rick Scott,32,0,40,8
1683364010266,PHIL 10,A01,186973,Grush; Rick Scott,28,0,35,7
1683364010266,PHIL 10,A02,186974,Grush; Rick Scott,33,0,35,2
1683364011292,PHIL 13,A01,186976,Staff,7,0,35,28
1683364011292,PHIL 13,A02,186977,Staff,16,0,35,19
1683364012317,PHIL 14,A01,186979,Staff,31,0,35,4
1683364012317,PHIL 14,A02,186986,Staff,32,0,35,3
1683364013343,PHIL 28,A01,186988,Staff,16,0,30,14
1683364013343,PHIL 28,A02,186989,Staff,1,0,30,29
1683364013343,PHIL 28,A03,186990,Staff,9,0,30,21
1683364013343,PHIL 28,A04,186991,Staff,26,0,30,4
1683364014370,PHIL 120,A00,186997,Staff,23,0,40,17
1683364015394,PHIL 137,A00,187003,Staff,9,0,40,31
1683364016420,PHIL 150,A00,187015,Staff,47,0,70,23
1683364017444,PHIL 167,A00,187021,Lamey; Andy M.,35,0,40,5
1683364018472,PHIL 174,A01,202226,Staff,17,0,20,3
1683364018472,PHIL 174,A02,202235,Staff,20,0,20,0
1683364019496,PHIL 191A,A00,258918,Staff,0,0,1,1
1683364020519,PHYS 1A,A00,187028,Staff,27,0,60,33
1683364021544,PHYS 1AL,001,187036,Staff,2,0,30,28
1683364021544,PHYS 1AL,002,187049,Staff,18,0,30,12
1683364022572,PHYS 1B,A00,187058,Staff,22,0,60,38
1683364023600,PHYS 1BL,001,187064,Staff,0,0,30,30
1683364023600,PHYS 1BL,002,187070,Staff,5,0,30,25
1683364024626,PHYS 1C,A00,187082,Staff,31,0,120,89
1683364025650,PHYS 1CL,001,187088,Staff,0,9,30,30
1683364025650,PHYS 1CL,002,187089,Staff,0,2,30,30
1683364025650,PHYS 1CL,009,262693,Staff,11,0,30,19
1683364026675,PHYS 2B,A01,187097,Staff,54,0,115,61
1683364027698,PHYS 2C,A01,187099,Staff,67,0,115,48
1683364028723,PHYS 2CL,A01,187101,Staff,5,0,28,23
1683364028723,PHYS 2CL,A02,187102,Staff,15,0,28,13
1683364029748,PHYS 2D,A01,187123,Shotwell; Brian,95,0,115,20
1683364030777,PHYS 4B,A01,187133,Grinstein; Benjamin,35,0,50,15
1683364031804,POLI 10,A00,188819,Staff,0,4,50,50
1683364032828,POLI 11,A00,188827,Staff,43,0,50,7
1683364033853,POLI 13R,A00,188828,Staff,0,1,20,20
1683364034880,POLI 27,A01,188830,Elgin; Samuel Zincke,0,1,70,70
1683364035907,POLI 30,A00,188832,Desposato; Scott,31,0,50,19
1683364036931,POLI 102F,A00,188834,Staff,3,0,40,37
1683364037956,POLI 104A,A00,188852,Staff,14,0,30,16
1683364038982,POLI 104I,A00,188853,Staff,0,6,20,20
1683364040006,POLI 110B,A00,188854,Wiens; David,7,0,20,13
1683364041029,POLI 112A,A00,188855,Wiens; David,5,0,30,25
1683364042056,POLI 117R,A00,188856,Forman; Fonna,0,11,20,20
1683364043083,POLI 118,A00,188857,Ingham; Sean,8,0,20,12
1683364044111,POLI 120G,A00,188858,Staff,9,0,30,21
1683364045135,POLI 131CR,A00,188863,Hoston; Germaine,23,0,50,27
1683364046163,POLI 133,A00,188864,Nellis; Gareth Hb,44,0,50,6
1683364047189,POLI 134D,A00,188865,Desposato; Scott,27,0,30,3
1683364048218,POLI 142A,A00,188871,Gartzke; Erik,22,0,50,28
1683364049243,POLI 142K,A00,188874,Staff,38,0,50,12
1683364050271,POLI 143,A00,188940,Gartzke; Erik,16,0,30,14
1683364051301,POLI 153,A00,188943,Staff,3,0,20,17
1683364052325,POLI 160AA,A00,188944,Staff,11,0,40,29
1683364053349,POLI 170A,A00,188945,Staff,11,0,30,19
1683364055403,PSYC 1,A00,188952,Staff,37,0,90,53
1683364056427,PSYC 2,B00,188953,Staff,19,0,35,16
1683364057453,PSYC 6,A00,188970,Staff,47,0,60,13
1683364058476,PSYC 7,A00,188973,Staff,37,0,45,8
1683364059505,PSYC 60,A01,188980,Rickard; Timothy C.,43,0,60,17
1683364060530,PSYC 70,A01,189001,Steiner; Eric Tomas,23,0,45,22
1683364061554,PSYC 100,A00,189005,Lacefield; Katharine I,0,98,120,120
1683364062582,PSYC 102,A00,189008,Staff,9,0,30,21
1683364063610,PSYC 106,B00,189026,Gorman; Michael R.,34,0,60,26
1683364064634,PSYC 114,B01,189033,Winkielman; Piotr,0,32,30,30
1683364065661,PSYC 131,A00,189036,Anagnostaras; Stephan,0,43,60,60
1683364066689,PSYC 136,A00,189041,Lowe; Angela Beth,0,7,25,25
1683364067717,PSYC 137,A00,189057,Winkielman; Piotr,0,34,25,25
1683364068746,PSYC 144,A00,189107,Wixted; John T,0,7,50,50
1683364070795,PSYC 162,A00,189142,Staff,0,8,85,85
1683364071818,PSYC 172,A00,189144,Gorman; Michael R.,0,7,30,30
1683364073866,PSYC 179,A00,189146,Lacefield; Katharine I,0,84,120,120
1683364074893,PSYC 181,A00,189147,Anagnostaras; Stephan,0,44,90,90
1683364075920,PSYC 190R,A00,189148,Barner; David A.,0,22,80,80
1683364076945,PSYC 191,A00,189275,Rickard; Timothy C.,0,7,25,25
1683364077970,PSYC 193,A00,189276,Chapman; Eddie Nathaniel,0,1,0,4
1683364078995,PSYC 193L,A01,189281,Lowe; Angela Beth,12,0,20,8
1683364078995,PSYC 193L,B01,189285,Staff,28,0,35,7
1683364080020,RELI 149,A00,187137,Rahimi; Babak,7,0,40,33
1683364081047,SE 9,A01,187315,Staff,0,2,18,18
1683364082078,SE 101B,A00,187409,Staff,24,0,30,6
1683364083106,SE 110B,A00,187444,Staff,10,0,40,30
1683364084130,SE 130B,A00,187449,Staff,31,0,40,9
1683364085158,SE 150A,A00,187516,Staff,9,0,20,11
1683364086243,SE 154,A00,187528,Staff,30,0,50,20
1683364087271,SIO 3,A01,258171,Staff,35,0,40,5
1683364088296,SIO 10,A00,187144,Cook; Geoffrey W,0,3,75,75
1683364089325,SIO 45,A00,187152,Cook; Geoffrey W,1,0,100,99
1683364090352,SIO 109R,A00,194486,Staff,0,3,20,20
1683364092401,SIO 187,A01,187233,Kacev; David,12,0,40,28
1683364093428,SOCI 1,A01,258656,Thorpe; Charles Robert,28,0,30,2
1683364093428,SOCI 1,A02,258658,Thorpe; Charles Robert,30,0,30,0
1683364093428,SOCI 1,A03,258661,Thorpe; Charles Robert,25,0,25,0
1683364093428,SOCI 1,A04,258666,Thorpe; Charles Robert,22,0,25,3
1683364093428,SOCI 1,A05,258897,Thorpe; Charles Robert,23,0,25,2
1683364093428,SOCI 1,A06,258898,Thorpe; Charles Robert,25,0,25,0
1683364094456,SOCI 30,A01,258903,Pardo Guerra; Juan Pablo,15,0,30,15
1683364095480,SOCI 102,A00,258904,Staff,9,0,25,16
1683364096504,SOCI 106,A00,258905,Staff,19,0,25,6
1683364097528,SOCI 111,A00,258907,Ribas Norris; Janet Vanesa,26,0,30,4
1683364098551,SOCI 121R,A00,258908,Pardo Guerra; Juan Pablo,10,0,30,20
1683364099575,SOCI 126,A01,203330,Staff,14,0,20,6
1683364100603,SOCI 131,A00,258909,Thorpe; Charles Robert,31,0,60,29
1683364101630,SOCI 135,A00,258910,Payne; Christine Anna,0,9,30,30
1683364102657,SOCI 157,A00,258911,Staff,12,0,30,18
1683364103681,SOCI 184,A00,258912,Staff,25,0,30,5
1683364104705,SOCI 188D,A00,258913,Staff,22,0,30,8
1683364105729,SYN 2,001,187529,Staff,10,0,16,6
1683364105729,SYN 2,002,201452,Staff,0,18,16,16
1683364105729,SYN 2,003,201469,Staff,3,0,16,13
1683364106755,SYN 100,A01,187531,Staff,0,9,20,20
1683364106755,SYN 100,B01,201491,Staff,0,12,20,20
1683364107779,TDAC 1,A00,189286,Walsh; Kim C.,3,0,20,17
1683364107779,TDAC 1,B00,189287,Harting; Carla Kelso,11,0,20,9
1683364108806,TDAC 101,A00,189300,Walsh; Kim C.,16,0,20,4
1683364108806,TDAC 101,B00,189301,Harting; Carla Kelso,18,0,20,2
1683364109834,TDAC 102,A00,189304,Basso; Beatrice,14,0,20,6
1683364110862,TDAC 108,A00,189305,Staff,18,0,20,2
1683364111891,TDDE 131,A00,189310,Staff,19,0,20,1
1683364111891,TDDE 131,B00,189314,Staff,19,0,20,1
1683364111891,TDDE 131,C00,189315,Staff,48,0,50,2
1683364111891,TDDE 131,D00,189316,Staff,14,0,15,1
1683364111891,TDDE 131,E00,204841,Staff,20,0,20,0
1683364112920,TDGE 10,A00,189289,Staff,30,0,50,20
1683364112920,TDGE 10,B00,189290,Havis; Allan,1,0,50,49
1683364113948,TDGE 11,A00,189291,Fulton; Julia,0,3,50,50
1683364113948,TDGE 11,B00,189292,Staff,20,0,25,5
1683364113948,TDGE 11,C00,260270,Staff,0,0,0,0
1683364114977,TDGE 25,A00,189294,Staff,3,0,20,17
1683364116002,TDGE 124,A00,189318,Fulton; Julia,0,8,50,50
1683364117027,TDGE 125,A00,189319,Staff,13,0,25,12
1683364117027,TDGE 125,B00,189320,Staff,23,0,25,2
1683364118053,TDGE 127,A00,189322,Havis; Allan,0,0,50,50
1683364119080,TDHT 101,A00,189323,Staff,18,0,25,7
1683364119080,TDHT 101,B00,189324,Staff,25,0,25,0
1683364120105,TDHT 102,A00,189325,Staff,49,0,50,1
1683364121130,TDMV 1,A00,189295,Arcidiacono; Kristin,19,0,30,11
1683364121130,TDMV 1,B00,189296,Caligagan; Maria T.,24,0,30,6
1683364122156,TDMV 2,A00,189297,Sammartano; Tonnie,28,0,30,2
1683364122156,TDMV 2,B00,189299,Arcidiacono; Kristin,24,0,30,6
1683364123180,TDMV 3,A00,204998,Rincon; Alicia,22,0,30,8
1683364124204,TDMV 120,A00,189458,Sammartano; Tonnie,28,0,30,2
1683364125231,TDMV 138,A00,189541,Jun; Grace Shin Hae,22,0,40,18
1683364126260,TDMV 142,A00,189717,Caligagan; Tony,24,0,30,6
1683364126260,TDMV 142,B00,189718,Caligagan; Maria T.,25,0,30,5
1683364127288,TMC 2,A01,187533,Staff,25,0,25,0
1683364127288,TMC 2,A02,187534,Staff,25,0,25,0
1683364128316,USP 1,A01,187536,Kwak; Nancy,0,16,25,25
1683364129342,USP 5,A01,187538,Staff,10,0,25,15
1683364130366,USP 101,A00,199253,Staff,0,4,0,0
1683364131391,USP 124,A00,187562,Boomhower; Matthew Charles,1,0,30,29
1683364132420,USP 138,A00,187582,Staff,20,0,25,5
1683364133444,USP 152,A01,187597,Staff,4,0,25,21
1683364134469,USP 153,A00,187598,Staff,19,0,25,6
1683364135493,USP 168,A00,187607,Kwak; Nancy,2,0,5,3
1683364136519,USP 173,A00,187619,Staff,4,0,25,21
1683364137547,USP 181,A00,187638,Staff,0,3,25,25
1683364138575,VIS 103,A00,187650,Cruz; Edwin Teddy,22,0,75,53
1683364139600,VIS 110D,A00,187669,Staff,12,0,22,10
1683364140624,VIS 127C,A00,187720,Shen; Kuiyi,67,0,146,79
1683364141648,VIS 149,A00,187731,Yoldas; Pinar,0,14,22,22
1683364142672,VIS 151,A01,188091,Staff,22,0,34,12
1683364142672,VIS 151,A02,188092,Staff,11,0,34,23
1683364143696,VIS 160B,A00,188093,Stalbaum; Brett,0,0,10,10
1683364145749,WCWP 10B,A00,201720,Staff,10,0,15,5
1683364145749,WCWP 10B,B00,201722,Staff,9,0,15,6
1683364146776,WCWP 100,A00,201725,Gagnon; Jeffrey C,0,0,2,2
1683364146776,WCWP 100,B00,201727,Staff,0,4,15,15
1683364149907,ANBI 133,A00,258401,Wilder; Linnea Lorene,34,0,40,6
1683364150935,ANBI 140,A00,258395,Hrvoj Mihic; Branka,18,0,25,7
1683364151961,ANSC 120,A00,258402,Bialecki; Jon Anthony,27,0,40,13
1683364152988,ANSC 144,A00,258400,Staff,14,0,40,26
1683364155039,ANSC 166,A00,258396,Parish; Steven Martin,157,0,175,18
1683364156069,ANSC 180,A00,193533,Staff,9,0,20,11
1683364157094,ANSC 188,A00,258397,Jassal; Aftab,33,0,40,7
1683364158117,ANTH 3,A01,258316,Staff,23,0,30,7
1683364159146,ANTH 5,A00,258394,Semendeferi; Ekaterini,16,0,20,4
1683364160170,ANTH 21,A01,258331,Staff,8,0,40,32
1683364161195,ANTH 103,A00,258398,Varma; Saiba,15,0,25,10
1683364162227,AWP 10,001,202034,Staff,0,0,0,0
1683364162227,AWP 10,002,202035,Staff,0,0,0,0
1683364162227,AWP 10,003,202036,Staff,0,0,0,0
1683364162227,AWP 10,004,202037,Staff,0,0,0,0
1683364162227,AWP 10,005,202038,Staff,0,0,0,0
1683364162227,AWP 10,006,202039,Staff,0,0,0,0
1683364162227,AWP 10,007,202040,Staff,0,0,0,0
1683364162227,AWP 10,008,202041,Staff,0,0,0,0
1683364162227,AWP 10,009,202042,Staff,0,0,0,0
1683364162227,AWP 10,010,202043,Staff,0,0,0,0
1683364162227,AWP 10,011,202044,Staff,0,0,0,0
1683364162227,AWP 10,012,202045,Staff,0,0,0,0
1683364162227,AWP 10,013,202046,Staff,0,0,0,0
1683364162227,AWP 10,014,202047,Staff,0,0,0,0
1683364162227,AWP 10,015,202048,Staff,0,0,0,0
1683364162227,AWP 10,016,202049,Staff,0,0,0,0
1683364162227,AWP 10,017,202050,Staff,0,0,0,0
1683364162227,AWP 10,018,202051,Staff,0,0,0,0
1683364162227,AWP 10,019,202052,Staff,0,0,0,0
1683364162227,AWP 10,020,202053,Staff,0,0,0,0
1683364162227,AWP 10,021,202054,Staff,0,0,0,0
1683364162227,AWP 10,022,202055,Staff,0,0,0,0
1683364162227,AWP 10,023,202056,Staff,0,0,0,0
1683364162227,AWP 10,024,202057,Staff,0,0,0,0
1683364162227,AWP 10,025,202058,Staff,0,0,0,0
1683364162227,AWP 10,026,202059,Staff,0,0,0,0
1683364163250,AWP 102,001,202032,Staff,0,0,0,0
1683364163250,AWP 102,002,202033,Staff,0,0,0,0
1683364164274,BENG 100,A01,254234,Taylor Amos; Alyssa C,31,0,40,9
1683364165300,BENG 196,001,270013,Engler; Adam J.,9999,0,9999,0
1683364166324,BICD 100R,A01,202018,Smith; Laurie,0,7,32,32
1683364166324,BICD 100R,A02,202019,Smith; Laurie,0,2,32,32
1683364166324,BICD 100R,A03,202020,Smith; Laurie,0,1,32,32
1683364166324,BICD 100R,A04,202021,Smith; Laurie,9,0,32,23
1683364166324,BICD 100R,A05,202022,Smith; Laurie,12,0,32,20
1683364167348,BICD 136,A01,193242,Gustafson-Brown; Cindy,0,2,32,32
1683364167348,BICD 136,A02,193244,Gustafson-Brown; Cindy,14,0,32,18
1683364168373,BIEB 102,A01,193249,Butler; Shannon Rhey,0,2,32,32
1683364168373,BIEB 102,A02,193251,Butler; Shannon Rhey,0,0,32,32
1683364168373,BIEB 102,A03,193253,Butler; Shannon Rhey,0,1,32,32
1683364168373,BIEB 102,A04,193255,Butler; Shannon Rhey,17,0,32,15
1683364168373,BIEB 102,A05,193265,Butler; Shannon Rhey,26,0,32,6
1683364168373,BIEB 102,A06,193269,Butler; Shannon Rhey,16,0,32,16
1683364170427,BIEB 150,A01,193274,Staff,0,0,32,32
1683364170427,BIEB 150,A02,193285,Staff,23,0,32,9
1683364171455,BIEB 194,A00,193286,Kurle; Carolyn M.,22,0,32,10
1683364172489,BILD 1,A01,192291,Staff,16,0,32,16
1683364172489,BILD 1,A02,192292,Staff,30,0,32,2
1683364172489,BILD 1,B01,192520,Reuther; Keefe,0,1,0,0
1683364172489,BILD 1,B02,192532,Reuther; Keefe,0,1,0,0
1683364173520,BILD 3,A01,192556,Butler; Shannon Rhey,0,0,32,32
1683364173520,BILD 3,A02,192581,Butler; Shannon Rhey,4,0,32,28
1683364173520,BILD 3,A03,192611,Butler; Shannon Rhey,23,0,32,9
1683364173520,BILD 3,A04,192612,Butler; Shannon Rhey,25,0,32,7
1683364173520,BILD 3,A05,192613,Butler; Shannon Rhey,27,0,32,5
1683364173520,BILD 3,A06,192679,Butler; Shannon Rhey,27,0,32,5
1683364173520,BILD 3,A07,192682,Butler; Shannon Rhey,21,0,32,11
1683364174552,BILD 4,A01,192836,Reuther; Keefe,0,0,24,24
1683364174552,BILD 4,A02,193044,Reuther; Keefe,4,0,24,20
1683364175578,BILD 10,A01,193142,Gustafson-Brown; Cindy,30,0,32,2
1683364175578,BILD 10,A02,193149,Gustafson-Brown; Cindy,31,0,32,1
1683364176603,BIMM 100,A01,193301,Staff,1,6,32,31
1683364176603,BIMM 100,A02,193312,Staff,0,5,32,32
1683364176603,BIMM 100,A03,193323,Staff,0,8,32,32
1683364177629,BIMM 101,A01,193329,McDonnell; Lisa Marie,0,3,24,24
1683364177629,BIMM 101,A02,193339,McDonnell; Lisa Marie,0,3,24,24
1683364177629,BIMM 101,B01,193354,McDonnell; Lisa Marie,0,3,24,24
1683364177629,BIMM 101,B02,193357,McDonnell; Lisa Marie,0,3,24,24
1683364178654,BIMM 110,A01,193377,Tat; John,0,11,32,32
1683364178654,BIMM 110,A02,193378,Tat; John,0,9,32,32
1683364179679,BIMM 120,A01,206116,Staff,0,0,32,32
1683364179679,BIMM 120,A02,206117,Staff,8,0,32,24
1683364179679,BIMM 120,A03,206121,Staff,21,0,32,11
1683364180703,BIPN 100,A01,193393,Park; Ji Young,0,14,32,32
1683364180703,BIPN 100,A02,193402,Park; Ji Young,0,13,32,32
1683364180703,BIPN 100,A03,193413,Park; Ji Young,0,14,32,32
1683364180703,BIPN 100,A04,193414,Park; Ji Young,0,13,32,32
1683364181732,BIPN 102,A01,193429,Staff,0,0,32,32
1683364181732,BIPN 102,A02,193438,Staff,22,0,32,10
1683364182760,BIPN 106,A01,193450,Reyes Gonzalez; Catalina,0,2,40,40
1683364183789,BIPN 134,A01,193465,Cooke; James Edward,1,0,32,31
1683364183789,BIPN 134,A02,193474,Cooke; James Edward,25,0,32,7
1683364183789,BIPN 134,A03,193485,Cooke; James Edward,29,0,32,3
1683364183789,BIPN 134,A04,193486,Cooke; James Edward,21,0,32,11
1683364183789,BIPN 134,A05,193491,Cooke; James Edward,31,0,32,1
1683364183789,BIPN 134,A06,193501,Cooke; James Edward,30,0,32,2
1683364183789,BIPN 134,A07,193510,Cooke; James Edward,29,0,32,3
1683364185842,BISP 194,A00,222522,Staff,14,0,32,18
1683364186865,CAT 124,A01,202407,Staff,19,0,25,6
1683364187888,CAT 125,A00,202408,Marchisotto; Jennifer Anne,4,0,20,16
1683364188913,CAT 125R,A00,202409,Smith; Lauryn Alissa,0,11,20,20
1683364188913,CAT 125R,B00,202410,Morales; Celeste Georgianna,0,11,20,20
1683364188913,CAT 125R,C00,202411,Irwin; Matthew Joseph,0,10,20,20
1683364189995,CENG 15,A01,204712,Yang; Kesong,0,1,0,0
1683364191019,CENG 114,A00,202070,Jahed Motlagh; Zeinab,5,0,20,15
1683364192042,CGS 105,A00,185477,Wesling; Megan E.,24,0,40,16
1683364193066,CGS 106,A00,185494,Staff,13,0,22,9
1683364194090,CGS 108,A00,185495,Staff,14,0,20,6
1683364195118,CGS 114,A00,185496,Staff,13,0,18,5
1683364196145,CGS 119,A00,185501,Staff,15,0,20,5
1683364197173,CGS 120,A00,185511,Staff,13,0,20,7
1683364198203,CHEM 4,A01,184675,Bussey; Thomas J,96,0,100,4
1683364199228,CHEM 6A,A01,184677,Staff,34,0,60,26
1683364200254,CHEM 6B,A01,184679,Staff,65,0,100,35
1683364201279,CHEM 6C,A01,184681,Bussey; Thomas J,1,0,50,49
1683364201279,CHEM 6C,A02,184682,Bussey; Thomas J,34,0,50,16
1683364202307,CHEM 40A,A01,184684,Albizati; Kim F.,37,0,100,63
1683364203335,CHEM 40B,A01,184686,Albizati; Kim F.,0,20,100,100
1683364204360,CHEM 41B,A01,184690,Staff,52,0,100,48
1683364205389,COGS 3,A01,184715,Boyle; Mary E. T.,0,25,40,40
1683364206416,COGS 14B,A01,185172,Staff,0,15,38,38
1683364207442,COGS 18,A01,184736,Staff,16,0,80,64
1683364208466,COGS 100,A01,184932,Staff,0,5,73,73
1683364209494,COGS 101A,A01,184935,Staff,0,39,30,30
1683364210521,COGS 101B,A01,184944,Staff,0,2,30,30
1683364211545,COGS 101C,A01,184946,Staff,0,12,30,30
1683364212568,COGS 102A,A01,184951,Johnson; Christine M.,2,0,40,38
1683364213596,COGS 107B,A01,184953,Mooshagian; Eric Frederick,0,50,40,40
1683364214623,COGS 118B,A01,184959,Gupta; Anjum,0,48,40,40
1683364215651,COGS 153,A00,184961,Staff,0,15,30,30
1683364216676,COGS 177,A00,184962,Staff,0,20,30,30
1683364217704,COGS 187A,A01,184969,Boyle; Mary E. T.,0,17,40,40
1683364218731,COMM 10,A01,185174,Staff,0,5,25,25
1683364218731,COMM 10,A02,185189,Staff,0,5,25,25
1683364218731,COMM 10,A03,269821,Staff,0,0,0,0
1683364219761,COMM 100B,A01,185475,Staff,0,0,0,2
1683364219761,COMM 100B,A02,185476,Staff,13,0,25,12
1683364220787,COMM 100C,A01,185314,Staff,1,0,25,24
1683364220787,COMM 100C,A02,185327,Staff,19,0,25,6
1683364221811,COMM 110M,A00,185349,Staff,2,0,40,38
1683364222835,COMM 113T,A00,185352,Staff,24,0,40,16
1683364223858,COMM 114I,A00,185353,Staff,33,0,40,7
1683364224882,COMM 131,A00,185354,Staff,19,0,30,11
1683364225910,CSE 8A,A50,185358,Cao; Yingjun,0,46,10,10
1683364226937,CSE 8B,A01,185362,Staff,0,46,50,50
1683364227965,CSE 11,A01,185416,Cao; Yingjun,0,92,10,10
1683364228993,CSE 20,A01,185445,Briones; Jor-el Thomas Caparas,5,0,25,20
1683364230017,CSE 21,A01,185447,Staff,10,0,50,40
1683364231042,CSE 101,A01,185451,Staff,0,13,50,50
1683364231042,CSE 101,B01,185453,Jones; Miles E,0,11,50,50
1683364233090,CSE 141,A01,185458,Eldon; John,20,0,100,80
1683364234112,CSE 141L,A01,185461,Eldon; John,12,0,100,88
1683364235137,CSE 142,A01,185463,Staff,36,0,60,24
1683364235137,CSE 142,B01,201355,Staff,0,7,60,60
1683364236160,CSE 142L,A01,185470,Staff,36,0,60,24
1683364236160,CSE 142L,B01,201417,Staff,0,6,60,60
1683364237183,CSE 190,A00,201433,Staff,32,0,49,17
1683364238207,DOC 1,A01,259136,Strom; Megan C.,7,0,15,8
1683364238207,DOC 1,A02,259137,Strom; Megan C.,14,0,15,1
1683364238207,DOC 1,A03,259138,Strom; Megan C.,14,0,15,1
1683364238207,DOC 1,A04,259139,Strom; Megan C.,14,0,15,1
1683364239230,DOC 100D,A00,259140,Pass; Natalye Joann,16,0,25,9
1683364240254,DSGN 1,A01,184749,Rill; Bryan,0,25,30,30
1683364241279,DSGN 100,A01,185168,Staff,0,2,25,25
1683364242307,ECE 5,A01,185626,Morris; Karcher William,0,10,0,0
1683364243333,ECE 101,A01,185628,Staff,17,0,70,53
1683364244359,ECE 107,A01,185635,Baghdadchi; Saharnaz,0,0,20,20
1683364244359,ECE 107,A02,185638,Baghdadchi; Saharnaz,4,0,20,16
1683364245383,ECE 148,A01,185647,Silberman; Jack,0,0,16,16
1683364246406,ECON 1,A01,185537,Crane; Meredith Helen,54,0,70,16
1683364247432,ECON 3,A01,185549,Crane; Meredith Helen,32,0,70,38
1683364248459,ECON 4,A01,203354,Anderson; John Charles,0,4,10,10
1683364249486,ECON 100A,A01,185574,Staff,0,4,40,40
1683364250516,ECON 100B,A01,185576,Staff,0,12,50,50
1683364251543,ECON 100C,A01,185589,Newhouse; Herbert S,29,0,70,41
1683364252570,ECON 105,A00,185608,Vespa; Emanuel Ignacio,19,0,35,16
1683364253597,ECON 109,A01,185610,Shishkin; Denis,10,0,35,25
1683364254624,ECON 110A,A01,185612,Staff,11,0,40,29
1683364255650,ECON 120A,A01,185615,Staff,20,0,40,20
1683364256678,ECON 120C,A01,185617,Sun; Yixiao,0,21,70,70
1683364257705,ECON 144,A00,203346,Squires; Dale E,3,0,35,32
1683364258730,ECON 171,A01,203349,Newhouse; Herbert S,0,1,35,35
1683364259751,ECON 173A,A01,185621,Toda; Alexis Akira,21,0,35,14
1683364260775,EDS 25,A01,202413,Staff,0,1,0,0
1683364260775,EDS 25,A02,202414,Staff,0,1,0,0
1683364260775,EDS 25,A03,202415,Staff,0,0,0,0
1683364260775,EDS 25,A04,202416,Staff,0,1,0,0
1683364260775,EDS 25,A05,202439,Staff,0,0,0,0
1683364260775,EDS 25,A06,202440,Staff,0,0,0,0
1683364260775,EDS 25,B01,202631,Staff,0,0,0,0
1683364260775,EDS 25,B02,202632,Staff,0,0,0,0
1683364260775,EDS 25,B03,202639,Staff,0,0,0,0
1683364260775,EDS 25,B04,202640,Staff,0,0,0,0
1683364260775,EDS 25,B05,202643,Staff,0,0,0,0
1683364260775,EDS 25,B06,202644,Staff,0,0,0,0
1683364261800,EDS 38,A01,202659,Black; Alison Michelle,24,0,25,1
1683364262825,EDS 115,A00,202652,Staff,18,0,30,12
1683364263850,EDS 125,A00,202649,Staff,14,0,30,16
1683364264877,EDS 126,A01,203332,Staff,30,0,30,0
1683364265902,EDS 139,A00,202838,Staff,16,0,25,9
1683364266930,EDS 146,A01,202655,Staff,14,0,25,11
1683364267959,ENG 15,A00,185667,Staff,0,1,0,0
1683364267959,ENG 15,B00,185672,Staff,0,0,0,0
1683364267959,ENG 15,C00,185675,Staff,0,0,0,0
1683364267959,ENG 15,D00,185682,Staff,0,0,0,0
1683364267959,ENG 15,E00,185684,Staff,0,0,0,0
1683364268988,ETHN 103,A00,185710,Staff,0,4,35,35
1683364270014,ETHN 103A,A00,199228,Man; Simeon S,2,0,9,7
1683364271043,ETHN 109,A00,185711,Staff,18,0,35,17
1683364272068,ETHN 142,A00,185726,Staff,0,4,30,30
1683364273093,ETHN 163J,A00,199229,Man; Simeon S,5,0,8,3
1683364274121,ETHN 168,A00,185727,Staff,8,0,10,2
1683364275151,ETHN 182,A00,185728,Staff,0,0,35,35
1683364276179,ETHN 183,A00,185737,Staff,8,0,18,10
1683364277206,GLBH 111,A01,209361,Burgos; Jose L.,0,0,0,0
1683364279255,HIEU 104,A00,185792,Staff,16,0,20,4
1683364280278,HIEU 115,A00,185800,Staff,1,0,20,19
1683364281305,HIEU 128,A00,185801,Staff,0,7,20,20
1683364282333,HIEU 147,A00,185802,Staff,16,0,20,4
1683364283360,HIEU 154,A00,185823,Staff,12,0,20,8
1683364284384,HILA 102,A00,185826,Staff,13,0,20,7
1683364285407,HILD 2C,A01,185778,Staff,0,12,20,20
1683364286433,HILD 7B,A01,185780,Kwak; Nancy,0,15,32,32
1683364286433,HILD 7B,A02,185781,Kwak; Nancy,0,18,32,32
1683364287460,HILD 30,A01,185791,Staff,14,0,20,6
1683364288486,HISC 119,A00,185830,Golan; Tal,0,9,20,20
1683364289510,HITO 156GS,A00,185831,Patterson; Patrick H.,0,0,0,23
1683364290538,HIUS 103,A00,185832,Man; Simeon S,1,6,20,19
1683364291565,HIUS 117,A00,185836,Kwak; Nancy,2,0,20,18
1683364292590,HIUS 125,A00,185840,Man; Simeon S,0,0,23,23
1683364293669,HIUS 149,A00,185845,Staff,0,0,20,20
1683364294698,HUM 3,A01,185882,Zavodny; Tatiana Sophia,0,7,50,50
1683364294698,HUM 3,B01,185899,Caldwell; Michael Alan,0,18,50,50
1683364295722,HUM 3GS,A00,185900,Patterson; Patrick H.,0,0,0,23
1683364296752,HUM 4,A01,185938,Zroka; Amy Liane,31,0,50,19
1683364296752,HUM 4,B01,185956,Watkins; Eric,0,3,50,50
1683364296752,HUM 4,B02,202209,Watkins; Eric,0,2,50,50
1683364296752,HUM 4,B03,202210,Watkins; Eric,0,2,50,50
1683364297776,HUM 5,A01,185958,West; Geoffrey Scott,3,0,50,47
1683364297776,HUM 5,A02,202215,West; Geoffrey Scott,0,0,50,50
1683364298799,INTL 190,A00,185959,Gagnon; Jeffrey C,0,0,0,9
1683364298799,INTL 190,B00,185960,Lettieri; Michael Joseph,0,0,0,1
1683364299822,JAPN 180,A00,254509,Staff,4,0,30,26
1683364300851,LATI 10,A01,202853,Kennemore; Amy Michelle,4,0,35,31
1683364300851,LATI 10,A02,202854,Kennemore; Amy Michelle,2,0,35,33
1683364300851,LATI 10,A03,270054,Kennemore; Amy Michelle,30,0,30,0
1683364301874,LATI 180,A00,202855,Kennemore; Amy Michelle,11,0,20,9
1683364302905,LAWS 101,A00,201767,Golan; Tal,0,7,40,40
1683364303934,LIFR 1C,A00,185961,Staff,6,0,20,14
1683364304958,LIFR 1CX,A00,185962,Staff,7,0,20,13
1683364305985,LIFR 1D,A00,185963,Staff,9,0,20,11
1683364307014,LIFR 1DX,A00,185964,Staff,9,0,20,11
1683364308040,LIGN 101,A01,186039,Staff,43,0,50,7
1683364309064,LIGN 165,A00,186040,Staff,18,0,50,32
1683364310088,LTCS 108,A00,186041,Staff,6,0,10,4
1683364311115,LTCS 119,A00,186042,Staff,16,0,20,4
1683364312145,LTCS 130,A00,186043,Wesling; Megan E.,15,0,25,10
1683364314199,LTEA 138,A00,186119,Staff,14,0,40,26
1683364315223,LTEN 124,A00,186148,Staff,6,0,25,19
1683364316247,LTEN 178,A00,186149,Staff,7,0,15,8
1683364317274,LTEN 181,A00,186150,Blanco; John D,33,0,40,7
1683364318301,LTWL 120,A00,186160,Staff,20,0,25,5
1683364319327,LTWL 165,A00,186161,Staff,22,0,25,3
1683364320355,LTWR 100,A00,186162,Staff,0,5,15,15
1683364321383,LTWR 102,A00,186163,Doller; Ben,5,0,15,10
1683364322409,MAE 8,A01,186412,Staff,0,0,0,0
1683364323433,MAE 30B,A00,186445,Bahadori; Mohammad Yousef,83,0,100,17
1683364324456,MAE 40,A00,186592,Bewley; Thomas R,10,0,50,40
1683364325479,MAE 101B,A00,186593,Bahadori; Mohammad Yousef,81,0,100,19
1683364326504,MAE 105,A00,186594,Bandaru; Prabhakar,12,0,50,38
1683364327528,MAE 107,A00,186599,Pham; Hieu Tan,0,7,120,120
1683364328552,MAE 148,A01,186660,Silberman; Jack,3,0,16,13
1683364329578,MATH 10A,A01,188095,Staff,0,5,35,35
1683364330604,MATH 10B,A01,188097,Bowers; Adam R.,0,11,30,30
1683364330604,MATH 10B,A02,188099,Bowers; Adam R.,0,11,30,30
1683364330604,MATH 10B,B01,188104,Bowers; Adam R.,0,10,30,30
1683364330604,MATH 10B,B02,188106,Bowers; Adam R.,0,10,30,30
1683364331629,MATH 10C,A01,188111,Staff,0,18,30,30
1683364331629,MATH 10C,A02,188127,Staff,0,17,30,30
1683364331629,MATH 10C,A03,188131,Staff,0,18,30,30
1683364331629,MATH 10C,B01,188218,Staff,18,0,30,12
1683364331629,MATH 10C,B02,188244,Staff,13,0,30,17
1683364331629,MATH 10C,B03,188277,Staff,16,0,30,14
1683364332654,MATH 18,A01,188344,Bach; Quang Tran,18,0,30,12
1683364332654,MATH 18,A02,188345,Bach; Quang Tran,11,0,30,19
1683364332654,MATH 18,B01,188353,Bach; Quang Tran,10,0,30,20
1683364332654,MATH 18,B02,188354,Bach; Quang Tran,20,0,30,10
1683364333677,MATH 20A,A01,188374,Staff,12,0,35,23
1683364334704,MATH 20B,A01,188382,Ohm; Ko Woon,6,0,30,24
1683364334704,MATH 20B,A02,188383,Ohm; Ko Woon,21,0,30,9
1683364334704,MATH 20B,B01,188385,Ohm; Ko Woon,7,0,30,23
1683364334704,MATH 20B,B02,188392,Ohm; Ko Woon,22,0,30,8
1683364335733,MATH 20C,A01,188394,Harel; Guershon,10,0,30,20
1683364335733,MATH 20C,A02,188395,Harel; Guershon,15,0,30,15
1683364335733,MATH 20C,B01,188404,Harel; Guershon,4,0,30,26
1683364335733,MATH 20C,B02,188405,Harel; Guershon,19,0,30,11
1683364336765,MATH 20D,A01,188414,Hammock; Frances H,0,1,30,30
1683364336765,MATH 20D,A02,188415,Hammock; Frances H,3,0,30,27
1683364336765,MATH 20D,B01,188447,Hammock; Frances H,1,0,30,29
1683364336765,MATH 20D,B02,188486,Hammock; Frances H,8,0,30,22
1683364337794,MATH 20E,A01,188649,Staff,21,0,30,9
1683364337794,MATH 20E,A02,188650,Staff,23,0,30,7
1683364337794,MATH 20E,A03,188673,Staff,0,0,30,30
1683364338822,MATH 102,A01,188675,Staff,0,35,35,35
1683364339852,MATH 103B,A01,188681,Staff,3,0,35,32
1683364339852,MATH 103B,B01,188692,Staff,5,0,35,30
1683364340879,MATH 109,A01,188695,Salehi Golsefidy; Alireza,25,0,35,10
1683364340879,MATH 109,A02,188696,Salehi Golsefidy; Alireza,25,0,35,10
1683364341904,MATH 120A,A01,188698,Eggers; John Dietrich,7,0,35,28
1683364342933,MATH 142B,A01,188736,Ioana; Adrian,0,2,30,30
1683364342933,MATH 142B,A02,188741,Ioana; Adrian,0,0,30,30
1683364342933,MATH 142B,A03,188743,Ioana; Adrian,0,1,30,30
1683364343963,MATH 168A,A01,188790,Staff,0,9,35,35
1683364344988,MATH 170A,A01,188803,Nie; Jiawang,0,2,35,35
1683364344988,MATH 170A,A02,188811,Nie; Jiawang,0,0,35,35
1683364344988,MATH 170A,A03,188814,Nie; Jiawang,1,0,35,34
1683364344988,MATH 170A,A04,188815,Nie; Jiawang,13,0,35,22
1683364346013,MATH 193B,A01,188817,Staff,0,0,35,35
1683364346013,MATH 193B,A02,188818,Staff,5,0,35,30
1683364347037,MGT 4,A01,202857,Anderson; John Charles,61,0,80,19
1683364348062,MGT 12,A00,202858,Lindenberger; Wade Douglas,42,0,90,48
1683364349087,MGT 18,A00,202859,Staff,74,0,90,16
1683364350113,MGT 18GS,A00,202860,McKay; Michael J,13,0,28,15
1683364351138,MGT 45,A00,202861,Pecore; Joseph P.,15,0,90,75
1683364352165,MGT 100,A00,202863,Yavorsky; Daniel Ryan,28,0,90,62
1683364353193,MGT 103,A00,202864,Ehrich; Kristine R,0,17,90,90
1683364354218,MGT 112,A00,202865,Ehrich; Kristine R,15,0,90,75
1683364355245,MGT 121A,A00,202868,Staff,0,20,0,0
1683364356273,MGT 131B,A00,202869,Anderson; John Charles,59,0,90,31
1683364357300,MGT 136,A00,202871,Lindenberger; Wade Douglas,84,0,90,6
1683364358331,MGT 164,A00,202873,Staff,0,68,90,91
1683364359357,MGT 164GS,A00,202874,McKay; Mary A,13,0,28,15
1683364360381,MGT 180,A00,202875,Staff,0,50,90,91
1683364361405,MMW 11R,A01,205019,Herbst; Matthew,3,0,30,27
1683364361405,MMW 11R,A02,205026,Herbst; Matthew,29,0,30,1
1683364362431,MMW 15,A01,193512,Chang; Edmond Yi-Teh,0,9,28,28
1683364362431,MMW 15,A02,193513,Chang; Edmond Yi-Teh,0,5,28,28
1683364362431,MMW 15,A03,193514,Chang; Edmond Yi-Teh,0,5,28,28
1683364362431,MMW 15,A04,193515,Chang; Edmond Yi-Teh,0,5,28,28
1683364362431,MMW 15,A05,193516,Chang; Edmond Yi-Teh,0,4,28,28
1683364362431,MMW 15,A06,193517,Chang; Edmond Yi-Teh,0,5,28,28
1683364362431,MMW 15,B01,193519,Chang; Edmond Yi-Teh,0,5,28,28
1683364362431,MMW 15,B02,193520,Chang; Edmond Yi-Teh,0,5,28,28
1683364362431,MMW 15,B03,193521,Chang; Edmond Yi-Teh,0,5,28,28
1683364362431,MMW 15,B04,193522,Chang; Edmond Yi-Teh,0,4,28,28
1683364362431,MMW 15,B05,193523,Chang; Edmond Yi-Teh,0,5,28,28
1683364362431,MMW 15,B06,193524,Chang; Edmond Yi-Teh,0,4,28,28
1683364363455,MMW 122,A01,193526,Rahimi; Babak,0,15,28,28
1683364363455,MMW 122,A02,193527,Rahimi; Babak,0,14,28,28
1683364363455,MMW 122,A03,193528,Rahimi; Babak,0,0,0,0
1683364363455,MMW 122,A04,193529,Rahimi; Babak,0,0,0,0
1683364364482,MUS 1A,A01,186663,Staff,0,20,35,35
1683364365511,MUS 4,A01,186715,Staff,0,12,35,35
1683364366538,MUS 5R,A01,186796,Dubnov; Shlomo,0,17,35,35
1683364367562,MUS 6,A01,186798,Staff,0,4,25,25
1683364368586,MUS 7,A01,186830,Staff,13,0,35,22
1683364369608,MUS 8,A01,186930,Staff,0,26,35,35
1683364370632,MUS 15,A01,186932,Staff,0,16,35,35
1683364370632,MUS 15,B01,186934,Staff,0,15,35,35
1683364371657,MUS 80,A00,186935,Staff,0,0,20,20
1683364371657,MUS 80,B00,186936,Staff,25,0,25,0
1683364372681,NANO 11,A00,204702,Lipomi; Darren John,0,0,0,0
1683364373709,NANO 15,A01,204709,Yang; Kesong,0,1,0,0
1683364374738,NANO 114,A00,202069,Jahed Motlagh; Zeinab,3,0,10,7
1683364375765,PHIL 1,A00,186955,Grush; Rick Scott,32,0,40,8
1683364376792,PHIL 10,A01,186973,Grush; Rick Scott,28,0,35,7
1683364376792,PHIL 10,A02,186974,Grush; Rick Scott,33,0,35,2
1683364377818,PHIL 13,A01,186976,Staff,7,0,35,28
1683364377818,PHIL 13,A02,186977,Staff,16,0,35,19
1683364378844,PHIL 14,A01,186979,Staff,31,0,35,4
1683364378844,PHIL 14,A02,186986,Staff,32,0,35,3
1683364379872,PHIL 28,A01,186988,Staff,16,0,30,14
1683364379872,PHIL 28,A02,186989,Staff,1,0,30,29
1683364379872,PHIL 28,A03,186990,Staff,9,0,30,21
1683364379872,PHIL 28,A04,186991,Staff,26,0,30,4
1683364380896,PHIL 120,A00,186997,Staff,23,0,40,17
1683364381923,PHIL 137,A00,187003,Staff,9,0,40,31
1683364382949,PHIL 150,A00,187015,Staff,47,0,70,23
1683364383979,PHIL 167,A00,187021,Lamey; Andy M.,35,0,40,5
1683364385003,PHIL 174,A01,202226,Staff,17,0,20,3
1683364385003,PHIL 174,A02,202235,Staff,20,0,20,0
1683364386034,PHIL 191A,A00,258918,Staff,0,0,1,1
1683364387060,PHYS 1A,A00,187028,Staff,27,0,60,33
1683364388089,PHYS 1AL,001,187036,Staff,2,0,30,28
1683364388089,PHYS 1AL,002,187049,Staff,18,0,30,12
1683364389113,PHYS 1B,A00,187058,Staff,22,0,60,38
1683364390139,PHYS 1BL,001,187064,Staff,0,0,30,30
1683364390139,PHYS 1BL,002,187070,Staff,5,0,30,25
1683364391164,PHYS 1C,A00,187082,Staff,31,0,120,89
1683364392190,PHYS 1CL,001,187088,Staff,0,9,30,30
1683364392190,PHYS 1CL,002,187089,Staff,0,2,30,30
1683364392190,PHYS 1CL,009,262693,Staff,11,0,30,19
1683364393213,PHYS 2B,A01,187097,Staff,54,0,115,61
1683364394238,PHYS 2C,A01,187099,Staff,67,0,115,48
1683364395262,PHYS 2CL,A01,187101,Staff,5,0,28,23
1683364395262,PHYS 2CL,A02,187102,Staff,15,0,28,13
1683364396288,PHYS 2D,A01,187123,Shotwell; Brian,95,0,115,20
1683364397374,PHYS 4B,A01,187133,Grinstein; Benjamin,35,0,50,15
1683364398398,POLI 10,A00,188819,Staff,0,4,50,50
1683364399421,POLI 11,A00,188827,Staff,43,0,50,7
1683364400448,POLI 13R,A00,188828,Staff,0,1,20,20
1683364401475,POLI 27,A01,188830,Elgin; Samuel Zincke,0,1,70,70
1683364402502,POLI 30,A00,188832,Desposato; Scott,31,0,50,19
1683364403530,POLI 102F,A00,188834,Staff,3,0,40,37
1683364404553,POLI 104A,A00,188852,Staff,14,0,30,16
1683364405576,POLI 104I,A00,188853,Staff,0,6,20,20
1683364406603,POLI 110B,A00,188854,Wiens; David,7,0,20,13
1683364407628,POLI 112A,A00,188855,Wiens; David,5,0,30,25
1683364408653,POLI 117R,A00,188856,Forman; Fonna,0,11,20,20
1683364409676,POLI 118,A00,188857,Ingham; Sean,8,0,20,12
1683364410700,POLI 120G,A00,188858,Staff,9,0,30,21
1683364411723,POLI 131CR,A00,188863,Hoston; Germaine,23,0,50,27
1683364412748,POLI 133,A00,188864,Nellis; Gareth Hb,44,0,50,6
1683364413771,POLI 134D,A00,188865,Desposato; Scott,27,0,30,3
1683364414796,POLI 142A,A00,188871,Gartzke; Erik,22,0,50,28
1683364415821,POLI 142K,A00,188874,Staff,38,0,50,12
1683364416845,POLI 143,A00,188940,Gartzke; Erik,16,0,30,14
1683364417872,POLI 153,A00,188943,Staff,3,0,20,17
1683364418901,POLI 160AA,A00,188944,Staff,11,0,40,29
1683364419926,POLI 170A,A00,188945,Staff,11,0,30,19
1683364421973,PSYC 1,A00,188952,Staff,37,0,90,53
1683364422998,PSYC 2,B00,188953,Staff,19,0,35,16
1683364424023,PSYC 6,A00,188970,Staff,47,0,60,13
1683364425048,PSYC 7,A00,188973,Staff,37,0,45,8
1683364426077,PSYC 60,A01,188980,Rickard; Timothy C.,43,0,60,17
1683364427102,PSYC 70,A01,189001,Steiner; Eric Tomas,23,0,45,22
1683364428126,PSYC 100,A00,189005,Lacefield; Katharine I,0,98,120,120
1683364429148,PSYC 102,A00,189008,Staff,9,0,30,21
1683364430173,PSYC 106,B00,189026,Gorman; Michael R.,34,0,60,26
1683364431201,PSYC 114,B01,189033,Winkielman; Piotr,0,32,30,30
1683364432226,PSYC 131,A00,189036,Anagnostaras; Stephan,0,43,60,60
1683364433253,PSYC 136,A00,189041,Lowe; Angela Beth,0,7,25,25
1683364434280,PSYC 137,A00,189057,Winkielman; Piotr,0,34,25,25
1683364435308,PSYC 144,A00,189107,Wixted; John T,0,7,50,50
1683364437356,PSYC 162,A00,189142,Staff,0,8,85,85
1683364438379,PSYC 172,A00,189144,Gorman; Michael R.,0,7,30,30
1683364440426,PSYC 179,A00,189146,Lacefield; Katharine I,0,84,120,120
1683364441454,PSYC 181,A00,189147,Anagnostaras; Stephan,0,44,90,90
1683364442481,PSYC 190R,A00,189148,Barner; David A.,0,22,80,80
1683364443511,PSYC 191,A00,189275,Rickard; Timothy C.,0,7,25,25
1683364444539,PSYC 193,A00,189276,Chapman; Eddie Nathaniel,0,1,0,4
1683364445567,PSYC 193L,A01,189281,Lowe; Angela Beth,12,0,20,8
1683364445567,PSYC 193L,B01,189285,Staff,28,0,35,7
1683364446594,RELI 149,A00,187137,Rahimi; Babak,7,0,40,33
1683364447618,SE 9,A01,187315,Staff,0,2,18,18
1683364448645,SE 101B,A00,187409,Staff,24,0,30,6
1683364449672,SE 110B,A00,187444,Staff,10,0,40,30
1683364450697,SE 130B,A00,187449,Staff,31,0,40,9
1683364451721,SE 150A,A00,187516,Staff,9,0,20,11
1683364452746,SE 154,A00,187528,Staff,30,0,50,20
1683364453773,SIO 3,A01,258171,Staff,35,0,40,5
1683364454797,SIO 10,A00,187144,Cook; Geoffrey W,0,3,75,75
1683364455825,SIO 45,A00,187152,Cook; Geoffrey W,1,0,100,99
1683364456849,SIO 109R,A00,194486,Staff,0,3,20,20
1683364458903,SIO 187,A01,187233,Kacev; David,12,0,40,28
1683364459933,SOCI 1,A01,258656,Thorpe; Charles Robert,28,0,30,2
1683364459933,SOCI 1,A02,258658,Thorpe; Charles Robert,30,0,30,0
1683364459933,SOCI 1,A03,258661,Thorpe; Charles Robert,25,0,25,0
1683364459933,SOCI 1,A04,258666,Thorpe; Charles Robert,22,0,25,3
1683364459933,SOCI 1,A05,258897,Thorpe; Charles Robert,23,0,25,2
1683364459933,SOCI 1,A06,258898,Thorpe; Charles Robert,25,0,25,0
1683364460961,SOCI 30,A01,258903,Pardo Guerra; Juan Pablo,15,0,30,15
1683364461988,SOCI 102,A00,258904,Staff,9,0,25,16
1683364463019,SOCI 106,A00,258905,Staff,19,0,25,6
1683364464047,SOCI 111,A00,258907,Ribas Norris; Janet Vanesa,26,0,30,4
1683364465071,SOCI 121R,A00,258908,Pardo Guerra; Juan Pablo,10,0,30,20
1683364466101,SOCI 126,A01,203330,Staff,14,0,20,6
1683364467130,SOCI 131,A00,258909,Thorpe; Charles Robert,31,0,60,29
1683364468157,SOCI 135,A00,258910,Payne; Christine Anna,0,9,30,30
1683364469186,SOCI 157,A00,258911,Staff,12,0,30,18
1683364470214,SOCI 184,A00,258912,Staff,25,0,30,5
1683364471237,SOCI 188D,A00,258913,Staff,22,0,30,8
1683364472261,SYN 2,001,187529,Staff,10,0,16,6
1683364472261,SYN 2,002,201452,Staff,0,18,16,16
1683364472261,SYN 2,003,201469,Staff,3,0,16,13
1683364473288,SYN 100,A01,187531,Staff,0,9,20,20
1683364473288,SYN 100,B01,201491,Staff,0,12,20,20
1683364474318,TDAC 1,A00,189286,Walsh; Kim C.,3,0,20,17
1683364474318,TDAC 1,B00,189287,Harting; Carla Kelso,11,0,20,9
1683364475341,TDAC 101,A00,189300,Walsh; Kim C.,16,0,20,4
1683364475341,TDAC 101,B00,189301,Harting; Carla Kelso,18,0,20,2
1683364476365,TDAC 102,A00,189304,Basso; Beatrice,14,0,20,6
1683364477389,TDAC 108,A00,189305,Staff,18,0,20,2
1683364478414,TDDE 131,A00,189310,Staff,19,0,20,1
1683364478414,TDDE 131,B00,189314,Staff,19,0,20,1
1683364478414,TDDE 131,C00,189315,Staff,48,0,50,2
1683364478414,TDDE 131,D00,189316,Staff,14,0,15,1
1683364478414,TDDE 131,E00,204841,Staff,20,0,20,0
1683364479440,TDGE 10,A00,189289,Staff,30,0,50,20
1683364479440,TDGE 10,B00,189290,Havis; Allan,1,0,50,49
1683364480468,TDGE 11,A00,189291,Fulton; Julia,0,3,50,50
1683364480468,TDGE 11,B00,189292,Staff,20,0,25,5
1683364480468,TDGE 11,C00,260270,Staff,0,0,0,0
1683364481495,TDGE 25,A00,189294,Staff,3,0,20,17
1683364482518,TDGE 124,A00,189318,Fulton; Julia,0,8,50,50
1683364483542,TDGE 125,A00,189319,Staff,13,0,25,12
1683364483542,TDGE 125,B00,189320,Staff,23,0,25,2
1683364484566,TDGE 127,A00,189322,Havis; Allan,0,0,50,50
1683364485594,TDHT 101,A00,189323,Staff,18,0,25,7
1683364485594,TDHT 101,B00,189324,Staff,25,0,25,0
1683364486618,TDHT 102,A00,189325,Staff,49,0,50,1
1683364487642,TDMV 1,A00,189295,Arcidiacono; Kristin,19,0,30,11
1683364487642,TDMV 1,B00,189296,Caligagan; Maria T.,24,0,30,6
1683364488665,TDMV 2,A00,189297,Sammartano; Tonnie,28,0,30,2
1683364488665,TDMV 2,B00,189299,Arcidiacono; Kristin,24,0,30,6
1683364489690,TDMV 3,A00,204998,Rincon; Alicia,22,0,30,8
1683364490714,TDMV 120,A00,189458,Sammartano; Tonnie,28,0,30,2
1683364491737,TDMV 138,A00,189541,Jun; Grace Shin Hae,22,0,40,18
1683364492764,TDMV 142,A00,189717,Caligagan; Tony,24,0,30,6
1683364492764,TDMV 142,B00,189718,Caligagan; Maria T.,25,0,30,5
1683364493788,TMC 2,A01,187533,Staff,25,0,25,0
1683364493788,TMC 2,A02,187534,Staff,25,0,25,0
1683364494815,USP 1,A01,187536,Kwak; Nancy,0,16,25,25
1683364495843,USP 5,A01,187538,Staff,10,0,25,15
1683364496871,USP 101,A00,199253,Staff,0,4,0,0
1683364497895,USP 124,A00,187562,Boomhower; Matthew Charles,1,0,30,29
1683364498919,USP 138,A00,187582,Staff,20,0,25,5
1683364499944,USP 152,A01,187597,Staff,4,0,25,21
1683364501040,USP 153,A00,187598,Staff,19,0,25,6
1683364502064,USP 168,A00,187607,Kwak; Nancy,2,0,5,3
1683364503089,USP 173,A00,187619,Staff,4,0,25,21
1683364504116,USP 181,A00,187638,Staff,0,3,25,25
1683364505143,VIS 103,A00,187650,Cruz; Edwin Teddy,22,0,75,53
1683364506171,VIS 110D,A00,187669,Staff,12,0,22,10
1683364507194,VIS 127C,A00,187720,Shen; Kuiyi,67,0,146,79
1683364508222,VIS 149,A00,187731,Yoldas; Pinar,0,14,22,22
1683364509249,VIS 151,A01,188091,Staff,22,0,34,12
1683364509249,VIS 151,A02,188092,Staff,11,0,34,23
1683364510275,VIS 160B,A00,188093,Stalbaum; Brett,0,0,10,10
1683364512334,WCWP 10B,A00,201720,Staff,10,0,15,5
1683364512334,WCWP 10B,B00,201722,Staff,9,0,15,6
1683364513362,WCWP 100,A00,201725,Gagnon; Jeffrey C,0,0,2,2
1683364513362,WCWP 100,B00,201727,Staff,0,4,15,15
1683364516486,ANBI 133,A00,258401,Wilder; Linnea Lorene,34,0,40,6
1683364517510,ANBI 140,A00,258395,Hrvoj Mihic; Branka,18,0,25,7
1683364518533,ANSC 120,A00,258402,Bialecki; Jon Anthony,27,0,40,13
1683364519557,ANSC 144,A00,258400,Staff,14,0,40,26
1683364521609,ANSC 166,A00,258396,Parish; Steven Martin,157,0,175,18
1683364522637,ANSC 180,A00,193533,Staff,9,0,20,11
1683364523665,ANSC 188,A00,258397,Jassal; Aftab,33,0,40,7
1683364524689,ANTH 3,A01,258316,Staff,23,0,30,7
1683364525712,ANTH 5,A00,258394,Semendeferi; Ekaterini,16,0,20,4
1683364526735,ANTH 21,A01,258331,Staff,8,0,40,32
1683364527759,ANTH 103,A00,258398,Varma; Saiba,15,0,25,10
1683364528786,AWP 10,001,202034,Staff,0,0,0,0
1683364528786,AWP 10,002,202035,Staff,0,0,0,0
1683364528786,AWP 10,003,202036,Staff,0,0,0,0
1683364528786,AWP 10,004,202037,Staff,0,0,0,0
1683364528786,AWP 10,005,202038,Staff,0,0,0,0
1683364528786,AWP 10,006,202039,Staff,0,0,0,0
1683364528786,AWP 10,007,202040,Staff,0,0,0,0
1683364528786,AWP 10,008,202041,Staff,0,0,0,0
1683364528786,AWP 10,009,202042,Staff,0,0,0,0
1683364528786,AWP 10,010,202043,Staff,0,0,0,0
1683364528786,AWP 10,011,202044,Staff,0,0,0,0
1683364528786,AWP 10,012,202045,Staff,0,0,0,0
1683364528786,AWP 10,013,202046,Staff,0,0,0,0
1683364528786,AWP 10,014,202047,Staff,0,0,0,0
1683364528786,AWP 10,015,202048,Staff,0,0,0,0
1683364528786,AWP 10,016,202049,Staff,0,0,0,0
1683364528786,AWP 10,017,202050,Staff,0,0,0,0
1683364528786,AWP 10,018,202051,Staff,0,0,0,0
1683364528786,AWP 10,019,202052,Staff,0,0,0,0
1683364528786,AWP 10,020,202053,Staff,0,0,0,0
1683364528786,AWP 10,021,202054,Staff,0,0,0,0
1683364528786,AWP 10,022,202055,Staff,0,0,0,0
1683364528786,AWP 10,023,202056,Staff,0,0,0,0
1683364528786,AWP 10,024,202057,Staff,0,0,0,0
1683364528786,AWP 10,025,202058,Staff,0,0,0,0
1683364528786,AWP 10,026,202059,Staff,0,0,0,0
1683364529813,AWP 102,001,202032,Staff,0,0,0,0
1683364529813,AWP 102,002,202033,Staff,0,0,0,0
1683364530841,BENG 100,A01,254234,Taylor Amos; Alyssa C,31,0,40,9
1683364531866,BENG 196,001,270013,Engler; Adam J.,9999,0,9999,0
1683364532895,BICD 100R,A01,202018,Smith; Laurie,0,7,32,32
1683364532895,BICD 100R,A02,202019,Smith; Laurie,0,2,32,32
1683364532895,BICD 100R,A03,202020,Smith; Laurie,0,1,32,32
1683364532895,BICD 100R,A04,202021,Smith; Laurie,9,0,32,23
1683364532895,BICD 100R,A05,202022,Smith; Laurie,12,0,32,20
1683364533922,BICD 136,A01,193242,Gustafson-Brown; Cindy,0,2,32,32
1683364533922,BICD 136,A02,193244,Gustafson-Brown; Cindy,14,0,32,18
1683364534952,BIEB 102,A01,193249,Butler; Shannon Rhey,0,2,32,32
1683364534952,BIEB 102,A02,193251,Butler; Shannon Rhey,0,0,32,32
1683364534952,BIEB 102,A03,193253,Butler; Shannon Rhey,0,1,32,32
1683364534952,BIEB 102,A04,193255,Butler; Shannon Rhey,17,0,32,15
1683364534952,BIEB 102,A05,193265,Butler; Shannon Rhey,26,0,32,6
1683364534952,BIEB 102,A06,193269,Butler; Shannon Rhey,16,0,32,16
1683364537003,BIEB 150,A01,193274,Staff,0,0,32,32
1683364537003,BIEB 150,A02,193285,Staff,23,0,32,9
1683364538027,BIEB 194,A00,193286,Kurle; Carolyn M.,22,0,32,10
1683364539054,BILD 1,A01,192291,Staff,16,0,32,16
1683364539054,BILD 1,A02,192292,Staff,30,0,32,2
1683364539054,BILD 1,B01,192520,Reuther; Keefe,0,1,0,0
1683364539054,BILD 1,B02,192532,Reuther; Keefe,0,1,0,0
1683364540083,BILD 3,A01,192556,Butler; Shannon Rhey,0,0,32,32
1683364540083,BILD 3,A02,192581,Butler; Shannon Rhey,4,0,32,28
1683364540083,BILD 3,A03,192611,Butler; Shannon Rhey,23,0,32,9
1683364540083,BILD 3,A04,192612,Butler; Shannon Rhey,25,0,32,7
1683364540083,BILD 3,A05,192613,Butler; Shannon Rhey,27,0,32,5
1683364540083,BILD 3,A06,192679,Butler; Shannon Rhey,27,0,32,5
1683364540083,BILD 3,A07,192682,Butler; Shannon Rhey,21,0,32,11
1683364541109,BILD 4,A01,192836,Reuther; Keefe,0,0,24,24
1683364541109,BILD 4,A02,193044,Reuther; Keefe,4,0,24,20
1683364542139,BILD 10,A01,193142,Gustafson-Brown; Cindy,30,0,32,2
1683364542139,BILD 10,A02,193149,Gustafson-Brown; Cindy,31,0,32,1
1683364543168,BIMM 100,A01,193301,Staff,1,6,32,31
1683364543168,BIMM 100,A02,193312,Staff,0,5,32,32
1683364543168,BIMM 100,A03,193323,Staff,0,8,32,32
1683364544194,BIMM 101,A01,193329,McDonnell; Lisa Marie,0,3,24,24
1683364544194,BIMM 101,A02,193339,McDonnell; Lisa Marie,0,3,24,24
1683364544194,BIMM 101,B01,193354,McDonnell; Lisa Marie,0,3,24,24
1683364544194,BIMM 101,B02,193357,McDonnell; Lisa Marie,0,3,24,24
1683364545219,BIMM 110,A01,193377,Tat; John,0,11,32,32
1683364545219,BIMM 110,A02,193378,Tat; John,0,9,32,32
1683364546242,BIMM 120,A01,206116,Staff,0,0,32,32
1683364546242,BIMM 120,A02,206117,Staff,8,0,32,24
1683364546242,BIMM 120,A03,206121,Staff,21,0,32,11
1683364547267,BIPN 100,A01,193393,Park; Ji Young,0,14,32,32
1683364547267,BIPN 100,A02,193402,Park; Ji Young,0,13,32,32
1683364547267,BIPN 100,A03,193413,Park; Ji Young,0,14,32,32
1683364547267,BIPN 100,A04,193414,Park; Ji Young,0,13,32,32
1683364548295,BIPN 102,A01,193429,Staff,0,0,32,32
1683364548295,BIPN 102,A02,193438,Staff,22,0,32,10
1683364549322,BIPN 106,A01,193450,Reyes Gonzalez; Catalina,0,2,40,40
1683364550351,BIPN 134,A01,193465,Cooke; James Edward,1,0,32,31
1683364550351,BIPN 134,A02,193474,Cooke; James Edward,25,0,32,7
1683364550351,BIPN 134,A03,193485,Cooke; James Edward,29,0,32,3
1683364550351,BIPN 134,A04,193486,Cooke; James Edward,21,0,32,11
1683364550351,BIPN 134,A05,193491,Cooke; James Edward,31,0,32,1
1683364550351,BIPN 134,A06,193501,Cooke; James Edward,30,0,32,2
1683364550351,BIPN 134,A07,193510,Cooke; James Edward,29,0,32,3
1683364552401,BISP 194,A00,222522,Staff,14,0,32,18
1683364553427,CAT 124,A01,202407,Staff,19,0,25,6
1683364554451,CAT 125,A00,202408,Marchisotto; Jennifer Anne,4,0,20,16
1683364555476,CAT 125R,A00,202409,Smith; Lauryn Alissa,0,11,20,20
1683364555476,CAT 125R,B00,202410,Morales; Celeste Georgianna,0,11,20,20
1683364555476,CAT 125R,C00,202411,Irwin; Matthew Joseph,0,10,20,20
1683364556499,CENG 15,A01,204712,Yang; Kesong,0,1,0,0
1683364557523,CENG 114,A00,202070,Jahed Motlagh; Zeinab,5,0,20,15
1683364558545,CGS 105,A00,185477,Wesling; Megan E.,24,0,40,16
1683364559569,CGS 106,A00,185494,Staff,13,0,22,9
1683364560593,CGS 108,A00,185495,Staff,14,0,20,6
1683364561619,CGS 114,A00,185496,Staff,13,0,18,5
1683364562646,CGS 119,A00,185501,Staff,15,0,20,5
1683364563673,CGS 120,A00,185511,Staff,13,0,20,7
1683364564699,CHEM 4,A01,184675,Bussey; Thomas J,96,0,100,4
1683364565722,CHEM 6A,A01,184677,Staff,34,0,60,26
1683364566746,CHEM 6B,A01,184679,Staff,65,0,100,35
1683364567772,CHEM 6C,A01,184681,Bussey; Thomas J,1,0,50,49
1683364567772,CHEM 6C,A02,184682,Bussey; Thomas J,34,0,50,16
1683364568797,CHEM 40A,A01,184684,Albizati; Kim F.,37,0,100,63
1683364569823,CHEM 40B,A01,184686,Albizati; Kim F.,0,20,100,100
1683364570848,CHEM 41B,A01,184690,Staff,52,0,100,48
1683364571873,COGS 3,A01,184715,Boyle; Mary E. T.,0,25,40,40
1683364572898,COGS 14B,A01,185172,Staff,0,15,38,38
1683364573922,COGS 18,A01,184736,Staff,16,0,80,64
1683364574949,COGS 100,A01,184932,Staff,0,5,73,73
1683364575978,COGS 101A,A01,184935,Staff,0,39,30,30
1683364577005,COGS 101B,A01,184944,Staff,0,2,30,30
1683364578030,COGS 101C,A01,184946,Staff,0,12,30,30
1683364579054,COGS 102A,A01,184951,Johnson; Christine M.,2,0,40,38
1683364580078,COGS 107B,A01,184953,Mooshagian; Eric Frederick,0,50,40,40
1683364581103,COGS 118B,A01,184959,Gupta; Anjum,0,48,40,40
1683364582126,COGS 153,A00,184961,Staff,0,15,30,30
1683364583154,COGS 177,A00,184962,Staff,0,20,30,30
1683364584180,COGS 187A,A01,184969,Boyle; Mary E. T.,0,17,40,40
1683364585210,COMM 10,A01,185174,Staff,0,5,25,25
1683364585210,COMM 10,A02,185189,Staff,0,5,25,25
1683364585210,COMM 10,A03,269821,Staff,0,0,0,0
1683364586234,COMM 100B,A01,185475,Staff,0,0,0,2
1683364586234,COMM 100B,A02,185476,Staff,13,0,25,12
1683364587259,COMM 100C,A01,185314,Staff,1,0,25,24
1683364587259,COMM 100C,A02,185327,Staff,19,0,25,6
1683364588281,COMM 110M,A00,185349,Staff,2,0,40,38
1683364589307,COMM 113T,A00,185352,Staff,24,0,40,16
1683364590331,COMM 114I,A00,185353,Staff,33,0,40,7
1683364591357,COMM 131,A00,185354,Staff,19,0,30,11
1683364592381,CSE 8A,A50,185358,Cao; Yingjun,0,46,10,10
1683364593405,CSE 8B,A01,185362,Staff,0,46,50,50
1683364594433,CSE 11,A01,185416,Cao; Yingjun,0,92,10,10
1683364595460,CSE 20,A01,185445,Briones; Jor-el Thomas Caparas,5,0,25,20
1683364596488,CSE 21,A01,185447,Staff,10,0,50,40
1683364597517,CSE 101,A01,185451,Staff,0,13,50,50
1683364597517,CSE 101,B01,185453,Jones; Miles E,0,11,50,50
1683364599565,CSE 141,A01,185458,Eldon; John,20,0,100,80
1683364600591,CSE 141L,A01,185461,Eldon; John,12,0,100,88
1683364601616,CSE 142,A01,185463,Staff,36,0,60,24
1683364601616,CSE 142,B01,201355,Staff,0,7,60,60
1683364602641,CSE 142L,A01,185470,Staff,36,0,60,24
1683364602641,CSE 142L,B01,201417,Staff,0,6,60,60
1683364603669,CSE 190,A00,201433,Staff,32,0,49,17
1683364604752,DOC 1,A01,259136,Strom; Megan C.,7,0,15,8
1683364604752,DOC 1,A02,259137,Strom; Megan C.,14,0,15,1
1683364604752,DOC 1,A03,259138,Strom; Megan C.,14,0,15,1
1683364604752,DOC 1,A04,259139,Strom; Megan C.,14,0,15,1
1683364605776,DOC 100D,A00,259140,Pass; Natalye Joann,16,0,25,9
1683364606801,DSGN 1,A01,184749,Rill; Bryan,0,25,30,30
1683364607827,DSGN 100,A01,185168,Staff,0,2,25,25
1683364608855,ECE 5,A01,185626,Morris; Karcher William,0,10,0,0
1683364609882,ECE 101,A01,185628,Staff,17,0,70,53
1683364610910,ECE 107,A01,185635,Baghdadchi; Saharnaz,0,0,20,20
1683364610910,ECE 107,A02,185638,Baghdadchi; Saharnaz,4,0,20,16
1683364611937,ECE 148,A01,185647,Silberman; Jack,0,0,16,16
1683364612965,ECON 1,A01,185537,Crane; Meredith Helen,54,0,70,16
1683364613994,ECON 3,A01,185549,Crane; Meredith Helen,32,0,70,38
1683364615023,ECON 4,A01,203354,Anderson; John Charles,0,4,10,10
1683364616046,ECON 100A,A01,185574,Staff,0,4,40,40
1683364617072,ECON 100B,A01,185576,Staff,0,12,50,50
1683364618096,ECON 100C,A01,185589,Newhouse; Herbert S,29,0,70,41
1683364619121,ECON 105,A00,185608,Vespa; Emanuel Ignacio,19,0,35,16
1683364620146,ECON 109,A01,185610,Shishkin; Denis,10,0,35,25
1683364621172,ECON 110A,A01,185612,Staff,11,0,40,29
1683364622200,ECON 120A,A01,185615,Staff,20,0,40,20
1683364623230,ECON 120C,A01,185617,Sun; Yixiao,0,21,70,70
1683364624254,ECON 144,A00,203346,Squires; Dale E,3,0,35,32
1683364625282,ECON 171,A01,203349,Newhouse; Herbert S,0,1,35,35
1683364626308,ECON 173A,A01,185621,Toda; Alexis Akira,21,0,35,14
1683364627334,EDS 25,A01,202413,Staff,0,1,0,0
1683364627334,EDS 25,A02,202414,Staff,0,1,0,0
1683364627334,EDS 25,A03,202415,Staff,0,0,0,0
1683364627334,EDS 25,A04,202416,Staff,0,1,0,0
1683364627334,EDS 25,A05,202439,Staff,0,0,0,0
1683364627334,EDS 25,A06,202440,Staff,0,0,0,0
1683364627334,EDS 25,B01,202631,Staff,0,0,0,0
1683364627334,EDS 25,B02,202632,Staff,0,0,0,0
1683364627334,EDS 25,B03,202639,Staff,0,0,0,0
1683364627334,EDS 25,B04,202640,Staff,0,0,0,0
1683364627334,EDS 25,B05,202643,Staff,0,0,0,0
1683364627334,EDS 25,B06,202644,Staff,0,0,0,0
1683364628362,EDS 38,A01,202659,Black; Alison Michelle,24,0,25,1
1683364629386,EDS 115,A00,202652,Staff,18,0,30,12
1683364630415,EDS 125,A00,202649,Staff,14,0,30,16
1683364631443,EDS 126,A01,203332,Staff,30,0,30,0
1683364632471,EDS 139,A00,202838,Staff,16,0,25,9
1683364633501,EDS 146,A01,202655,Staff,14,0,25,11
1683364634525,ENG 15,A00,185667,Staff,0,1,0,0
1683364634525,ENG 15,B00,185672,Staff,0,0,0,0
1683364634525,ENG 15,C00,185675,Staff,0,0,0,0
1683364634525,ENG 15,D00,185682,Staff,0,0,0,0
1683364634525,ENG 15,E00,185684,Staff,0,0,0,0
1683364635553,ETHN 103,A00,185710,Staff,0,4,35,35
1683364636579,ETHN 103A,A00,199228,Man; Simeon S,2,0,9,7
1683364637605,ETHN 109,A00,185711,Staff,18,0,35,17
1683364638632,ETHN 142,A00,185726,Staff,0,4,30,30
1683364639658,ETHN 163J,A00,199229,Man; Simeon S,5,0,8,3
1683364640683,ETHN 168,A00,185727,Staff,8,0,10,2
1683364641707,ETHN 182,A00,185728,Staff,0,0,35,35
1683364642732,ETHN 183,A00,185737,Staff,8,0,18,10
1683364643758,GLBH 111,A01,209361,Burgos; Jose L.,0,0,0,0
1683364645810,HIEU 104,A00,185792,Staff,16,0,20,4
1683364646838,HIEU 115,A00,185800,Staff,1,0,20,19
1683364647866,HIEU 128,A00,185801,Staff,0,7,20,20
1683364648897,HIEU 147,A00,185802,Staff,16,0,20,4
1683364649923,HIEU 154,A00,185823,Staff,12,0,20,8
1683364650951,HILA 102,A00,185826,Staff,13,0,20,7
1683364651976,HILD 2C,A01,185778,Staff,0,12,20,20
1683364653002,HILD 7B,A01,185780,Kwak; Nancy,0,15,32,32
1683364653002,HILD 7B,A02,185781,Kwak; Nancy,0,18,32,32
1683364654024,HILD 30,A01,185791,Staff,14,0,20,6
1683364655052,HISC 119,A00,185830,Golan; Tal,0,9,20,20
1683364656079,HITO 156GS,A00,185831,Patterson; Patrick H.,0,0,0,23
1683364657102,HIUS 103,A00,185832,Man; Simeon S,1,6,20,19
1683364658131,HIUS 117,A00,185836,Kwak; Nancy,2,0,20,18
1683364659160,HIUS 125,A00,185840,Man; Simeon S,0,0,23,23
1683364660188,HIUS 149,A00,185845,Staff,0,0,20,20
1683364661215,HUM 3,A01,185882,Zavodny; Tatiana Sophia,0,7,50,50
1683364661215,HUM 3,B01,185899,Caldwell; Michael Alan,0,18,50,50
1683364662237,HUM 3GS,A00,185900,Patterson; Patrick H.,0,0,0,23
1683364663262,HUM 4,A01,185938,Zroka; Amy Liane,31,0,50,19
1683364663262,HUM 4,B01,185956,Watkins; Eric,0,3,50,50
1683364663262,HUM 4,B02,202209,Watkins; Eric,0,2,50,50
1683364663262,HUM 4,B03,202210,Watkins; Eric,0,2,50,50
1683364664286,HUM 5,A01,185958,West; Geoffrey Scott,3,0,50,47
1683364664286,HUM 5,A02,202215,West; Geoffrey Scott,0,0,50,50
1683364665312,INTL 190,A00,185959,Gagnon; Jeffrey C,0,0,0,9
1683364665312,INTL 190,B00,185960,Lettieri; Michael Joseph,0,0,0,1
1683364666341,JAPN 180,A00,254509,Staff,4,0,30,26
1683364667367,LATI 10,A01,202853,Kennemore; Amy Michelle,4,0,35,31
1683364667367,LATI 10,A02,202854,Kennemore; Amy Michelle,2,0,35,33
1683364667367,LATI 10,A03,270054,Kennemore; Amy Michelle,30,0,30,0
1683364668392,LATI 180,A00,202855,Kennemore; Amy Michelle,11,0,20,9
1683364669416,LAWS 101,A00,201767,Golan; Tal,0,7,40,40
1683364670443,LIFR 1C,A00,185961,Staff,6,0,20,14
1683364671471,LIFR 1CX,A00,185962,Staff,7,0,20,13
1683364672496,LIFR 1D,A00,185963,Staff,9,0,20,11
1683364673521,LIFR 1DX,A00,185964,Staff,9,0,20,11
1683364674546,LIGN 101,A01,186039,Staff,43,0,50,7
1683364675572,LIGN 165,A00,186040,Staff,18,0,50,32
1683364676596,LTCS 108,A00,186041,Staff,6,0,10,4
1683364677621,LTCS 119,A00,186042,Staff,16,0,20,4
1683364678645,LTCS 130,A00,186043,Wesling; Megan E.,15,0,25,10
1683364680699,LTEA 138,A00,186119,Staff,14,0,40,26
1683364681724,LTEN 124,A00,186148,Staff,6,0,25,19
1683364682748,LTEN 178,A00,186149,Staff,7,0,15,8
1683364683773,LTEN 181,A00,186150,Blanco; John D,33,0,40,7
1683364684798,LTWL 120,A00,186160,Staff,20,0,25,5
1683364685826,LTWL 165,A00,186161,Staff,22,0,25,3
1683364686852,LTWR 100,A00,186162,Staff,0,5,15,15
1683364687879,LTWR 102,A00,186163,Doller; Ben,5,0,15,10
1683364688906,MAE 8,A01,186412,Staff,0,0,0,0
1683364689935,MAE 30B,A00,186445,Bahadori; Mohammad Yousef,83,0,100,17
1683364690965,MAE 40,A00,186592,Bewley; Thomas R,10,0,50,40
1683364691990,MAE 101B,A00,186593,Bahadori; Mohammad Yousef,81,0,100,19
1683364693018,MAE 105,A00,186594,Bandaru; Prabhakar,12,0,50,38
1683364694044,MAE 107,A00,186599,Pham; Hieu Tan,0,7,120,120
1683364695070,MAE 148,A01,186660,Silberman; Jack,3,0,16,13
1683364696097,MATH 10A,A01,188095,Staff,0,5,35,35
1683364697127,MATH 10B,A01,188097,Bowers; Adam R.,0,11,30,30
1683364697127,MATH 10B,A02,188099,Bowers; Adam R.,0,11,30,30
1683364697127,MATH 10B,B01,188104,Bowers; Adam R.,0,10,30,30
1683364697127,MATH 10B,B02,188106,Bowers; Adam R.,0,10,30,30
1683364698156,MATH 10C,A01,188111,Staff,0,18,30,30
1683364698156,MATH 10C,A02,188127,Staff,0,17,30,30
1683364698156,MATH 10C,A03,188131,Staff,0,18,30,30
1683364698156,MATH 10C,B01,188218,Staff,18,0,30,12
1683364698156,MATH 10C,B02,188244,Staff,13,0,30,17
1683364698156,MATH 10C,B03,188277,Staff,16,0,30,14
1683364699187,MATH 18,A01,188344,Bach; Quang Tran,18,0,30,12
1683364699187,MATH 18,A02,188345,Bach; Quang Tran,11,0,30,19
1683364699187,MATH 18,B01,188353,Bach; Quang Tran,10,0,30,20
1683364699187,MATH 18,B02,188354,Bach; Quang Tran,20,0,30,10
1683364700211,MATH 20A,A01,188374,Staff,12,0,35,23
1683364701236,MATH 20B,A01,188382,Ohm; Ko Woon,6,0,30,24
1683364701236,MATH 20B,A02,188383,Ohm; Ko Woon,21,0,30,9
1683364701236,MATH 20B,B01,188385,Ohm; Ko Woon,7,0,30,23
1683364701236,MATH 20B,B02,188392,Ohm; Ko Woon,22,0,30,8
1683364702259,MATH 20C,A01,188394,Harel; Guershon,10,0,30,20
1683364702259,MATH 20C,A02,188395,Harel; Guershon,15,0,30,15
1683364702259,MATH 20C,B01,188404,Harel; Guershon,4,0,30,26
1683364702259,MATH 20C,B02,188405,Harel; Guershon,19,0,30,11
1683364703284,MATH 20D,A01,188414,Hammock; Frances H,0,1,30,30
1683364703284,MATH 20D,A02,188415,Hammock; Frances H,3,0,30,27
1683364703284,MATH 20D,B01,188447,Hammock; Frances H,1,0,30,29
1683364703284,MATH 20D,B02,188486,Hammock; Frances H,8,0,30,22
1683364704309,MATH 20E,A01,188649,Staff,21,0,30,9
1683364704309,MATH 20E,A02,188650,Staff,23,0,30,7
1683364704309,MATH 20E,A03,188673,Staff,0,0,30,30
1683364705338,MATH 102,A01,188675,Staff,0,35,35,35
1683364706368,MATH 103B,A01,188681,Staff,3,0,35,32
1683364706368,MATH 103B,B01,188692,Staff,5,0,35,30
1683364707397,MATH 109,A01,188695,Salehi Golsefidy; Alireza,25,0,35,10
1683364707397,MATH 109,A02,188696,Salehi Golsefidy; Alireza,25,0,35,10
1683364708483,MATH 120A,A01,188698,Eggers; John Dietrich,7,0,35,28
1683364709508,MATH 142B,A01,188736,Ioana; Adrian,0,2,30,30
1683364709508,MATH 142B,A02,188741,Ioana; Adrian,0,0,30,30
1683364709508,MATH 142B,A03,188743,Ioana; Adrian,0,1,30,30
1683364710535,MATH 168A,A01,188790,Staff,0,9,35,35
1683364711564,MATH 170A,A01,188803,Nie; Jiawang,0,2,35,35
1683364711564,MATH 170A,A02,188811,Nie; Jiawang,0,0,35,35
1683364711564,MATH 170A,A03,188814,Nie; Jiawang,1,0,35,34
1683364711564,MATH 170A,A04,188815,Nie; Jiawang,13,0,35,22
1683364712591,MATH 193B,A01,188817,Staff,0,0,35,35
1683364712591,MATH 193B,A02,188818,Staff,5,0,35,30
1683364713619,MGT 4,A01,202857,Anderson; John Charles,61,0,80,19
1683364714647,MGT 12,A00,202858,Lindenberger; Wade Douglas,42,0,90,48
1683364715674,MGT 18,A00,202859,Staff,74,0,90,16
1683364716699,MGT 18GS,A00,202860,McKay; Michael J,13,0,28,15
1683364717724,MGT 45,A00,202861,Pecore; Joseph P.,15,0,90,75
1683364718749,MGT 100,A00,202863,Yavorsky; Daniel Ryan,28,0,90,62
1683364719772,MGT 103,A00,202864,Ehrich; Kristine R,0,17,90,90
1683364720800,MGT 112,A00,202865,Ehrich; Kristine R,15,0,90,75
1683364721828,MGT 121A,A00,202868,Staff,0,20,0,0
1683364722856,MGT 131B,A00,202869,Anderson; John Charles,59,0,90,31
1683364723883,MGT 136,A00,202871,Lindenberger; Wade Douglas,84,0,90,6
1683364724909,MGT 164,A00,202873,Staff,0,68,90,91
1683364725935,MGT 164GS,A00,202874,McKay; Mary A,13,0,28,15
1683364726960,MGT 180,A00,202875,Staff,0,50,90,91
1683364727985,MMW 11R,A01,205019,Herbst; Matthew,3,0,30,27
1683364727985,MMW 11R,A02,205026,Herbst; Matthew,29,0,30,1
1683364729011,MMW 15,A01,193512,Chang; Edmond Yi-Teh,0,9,28,28
1683364729011,MMW 15,A02,193513,Chang; Edmond Yi-Teh,0,5,28,28
1683364729011,MMW 15,A03,193514,Chang; Edmond Yi-Teh,0,5,28,28
1683364729011,MMW 15,A04,193515,Chang; Edmond Yi-Teh,0,5,28,28
1683364729011,MMW 15,A05,193516,Chang; Edmond Yi-Teh,0,4,28,28
1683364729011,MMW 15,A06,193517,Chang; Edmond Yi-Teh,0,5,28,28
1683364729011,MMW 15,B01,193519,Chang; Edmond Yi-Teh,0,5,28,28
1683364729011,MMW 15,B02,193520,Chang; Edmond Yi-Teh,0,5,28,28
1683364729011,MMW 15,B03,193521,Chang; Edmond Yi-Teh,0,5,28,28
1683364729011,MMW 15,B04,193522,Chang; Edmond Yi-Teh,0,4,28,28
1683364729011,MMW 15,B05,193523,Chang; Edmond Yi-Teh,0,5,28,28
1683364729011,MMW 15,B06,193524,Chang; Edmond Yi-Teh,0,4,28,28
1683364730036,MMW 122,A01,193526,Rahimi; Babak,0,15,28,28
1683364730036,MMW 122,A02,193527,Rahimi; Babak,0,14,28,28
1683364730036,MMW 122,A03,193528,Rahimi; Babak,0,0,0,0
1683364730036,MMW 122,A04,193529,Rahimi; Babak,0,0,0,0
1683364731065,MUS 1A,A01,186663,Staff,0,20,35,35
1683364732090,MUS 4,A01,186715,Staff,0,12,35,35
1683364733118,MUS 5R,A01,186796,Dubnov; Shlomo,0,17,35,35
1683364734146,MUS 6,A01,186798,Staff,0,4,25,25
1683364735174,MUS 7,A01,186830,Staff,13,0,35,22
1683364736203,MUS 8,A01,186930,Staff,0,26,35,35
1683364737228,MUS 15,A01,186932,Staff,0,16,35,35
1683364737228,MUS 15,B01,186934,Staff,0,15,35,35
1683364738251,MUS 80,A00,186935,Staff,0,0,20,20
1683364738251,MUS 80,B00,186936,Staff,25,0,25,0
1683364739276,NANO 11,A00,204702,Lipomi; Darren John,0,0,0,0
1683364740301,NANO 15,A01,204709,Yang; Kesong,0,1,0,0
1683364741329,NANO 114,A00,202069,Jahed Motlagh; Zeinab,3,0,10,7
1683364742358,PHIL 1,A00,186955,Grush; Rick Scott,32,0,40,8
1683364743386,PHIL 10,A01,186973,Grush; Rick Scott,28,0,35,7
1683364743386,PHIL 10,A02,186974,Grush; Rick Scott,33,0,35,2
1683364744412,PHIL 13,A01,186976,Staff,7,0,35,28
1683364744412,PHIL 13,A02,186977,Staff,16,0,35,19
1683364745436,PHIL 14,A01,186979,Staff,31,0,35,4
1683364745436,PHIL 14,A02,186986,Staff,32,0,35,3
1683364746460,PHIL 28,A01,186988,Staff,16,0,30,14
1683364746460,PHIL 28,A02,186989,Staff,1,0,30,29
1683364746460,PHIL 28,A03,186990,Staff,9,0,30,21
1683364746460,PHIL 28,A04,186991,Staff,26,0,30,4
1683364747490,PHIL 120,A00,186997,Staff,23,0,40,17
1683364748517,PHIL 137,A00,187003,Staff,9,0,40,31
1683364749541,PHIL 150,A00,187015,Staff,47,0,70,23
1683364750570,PHIL 167,A00,187021,Lamey; Andy M.,35,0,40,5
1683364751598,PHIL 174,A01,202226,Staff,17,0,20,3
1683364751598,PHIL 174,A02,202235,Staff,20,0,20,0
1683364752627,PHIL 191A,A00,258918,Staff,0,0,1,1
1683364753656,PHYS 1A,A00,187028,Staff,27,0,60,33
1683364754681,PHYS 1AL,001,187036,Staff,2,0,30,28
1683364754681,PHYS 1AL,002,187049,Staff,18,0,30,12
1683364755706,PHYS 1B,A00,187058,Staff,22,0,60,38
1683364756731,PHYS 1BL,001,187064,Staff,0,0,30,30
1683364756731,PHYS 1BL,002,187070,Staff,5,0,30,25
1683364757758,PHYS 1C,A00,187082,Staff,31,0,120,89
1683364758787,PHYS 1CL,001,187088,Staff,0,9,30,30
1683364758787,PHYS 1CL,002,187089,Staff,0,2,30,30
1683364758787,PHYS 1CL,009,262693,Staff,11,0,30,19
1683364759817,PHYS 2B,A01,187097,Staff,54,0,115,61
1683364760843,PHYS 2C,A01,187099,Staff,67,0,115,48
1683364761869,PHYS 2CL,A01,187101,Staff,5,0,28,23
1683364761869,PHYS 2CL,A02,187102,Staff,15,0,28,13
1683364762899,PHYS 2D,A01,187123,Shotwell; Brian,95,0,115,20
1683364763929,PHYS 4B,A01,187133,Grinstein; Benjamin,35,0,50,15
1683364764956,POLI 10,A00,188819,Staff,0,4,50,50
1683364765986,POLI 11,A00,188827,Staff,43,0,50,7
1683364767010,POLI 13R,A00,188828,Staff,0,1,20,20
1683364768243,POLI 27,A01,188830,Elgin; Samuel Zincke,0,1,70,70
1683364769272,POLI 30,A00,188832,Desposato; Scott,31,0,50,19
1683364770297,POLI 102F,A00,188834,Staff,3,0,40,37
1683364771321,POLI 104A,A00,188852,Staff,14,0,30,16
1683364772346,POLI 104I,A00,188853,Staff,0,6,20,20
1683364773372,POLI 110B,A00,188854,Wiens; David,7,0,20,13
1683364774397,POLI 112A,A00,188855,Wiens; David,5,0,30,25
1683364775422,POLI 117R,A00,188856,Forman; Fonna,0,11,20,20
1683364776446,POLI 118,A00,188857,Ingham; Sean,8,0,20,12
1683364777471,POLI 120G,A00,188858,Staff,9,0,30,21
1683364778502,POLI 131CR,A00,188863,Hoston; Germaine,23,0,50,27
1683364779529,POLI 133,A00,188864,Nellis; Gareth Hb,44,0,50,6
1683364780557,POLI 134D,A00,188865,Desposato; Scott,27,0,30,3
1683364781585,POLI 142A,A00,188871,Gartzke; Erik,22,0,50,28
1683364782610,POLI 142K,A00,188874,Staff,38,0,50,12
1683364783634,POLI 143,A00,188940,Gartzke; Erik,16,0,30,14
1683364784661,POLI 153,A00,188943,Staff,3,0,20,17
1683364785689,POLI 160AA,A00,188944,Staff,11,0,40,29
1683364786713,POLI 170A,A00,188945,Staff,11,0,30,19
1683364788765,PSYC 1,A00,188952,Staff,37,0,90,53
1683364789792,PSYC 2,B00,188953,Staff,19,0,35,16
1683364790817,PSYC 6,A00,188970,Staff,47,0,60,13
1683364791844,PSYC 7,A00,188973,Staff,37,0,45,8
1683364792870,PSYC 60,A01,188980,Rickard; Timothy C.,43,0,60,17
1683364793896,PSYC 70,A01,189001,Steiner; Eric Tomas,23,0,45,22
1683364794920,PSYC 100,A00,189005,Lacefield; Katharine I,0,98,120,120
1683364795944,PSYC 102,A00,189008,Staff,9,0,30,21
1683364796969,PSYC 106,B00,189026,Gorman; Michael R.,34,0,60,26
1683364797994,PSYC 114,B01,189033,Winkielman; Piotr,0,32,30,30
1683364799019,PSYC 131,A00,189036,Anagnostaras; Stephan,0,43,60,60
1683364800043,PSYC 136,A00,189041,Lowe; Angela Beth,0,7,25,25
1683364801067,PSYC 137,A00,189057,Winkielman; Piotr,0,34,25,25
1683364802094,PSYC 144,A00,189107,Wixted; John T,0,7,50,50
1683364804146,PSYC 162,A00,189142,Staff,0,8,85,85
1683364805173,PSYC 172,A00,189144,Gorman; Michael R.,0,7,30,30
1683364807223,PSYC 179,A00,189146,Lacefield; Katharine I,0,84,120,120
1683364808252,PSYC 181,A00,189147,Anagnostaras; Stephan,0,44,90,90
1683364809279,PSYC 190R,A00,189148,Barner; David A.,0,22,80,80
1683364810303,PSYC 191,A00,189275,Rickard; Timothy C.,0,7,25,25
1683364811327,PSYC 193,A00,189276,Chapman; Eddie Nathaniel,0,1,0,4
1683364812410,PSYC 193L,A01,189281,Lowe; Angela Beth,12,0,20,8
1683364812410,PSYC 193L,B01,189285,Staff,28,0,35,7
1683364813437,RELI 149,A00,187137,Rahimi; Babak,7,0,40,33
1683364814465,SE 9,A01,187315,Staff,0,2,18,18
1683364815492,SE 101B,A00,187409,Staff,24,0,30,6
1683364816518,SE 110B,A00,187444,Staff,10,0,40,30
1683364817541,SE 130B,A00,187449,Staff,31,0,40,9
1683364818566,SE 150A,A00,187516,Staff,9,0,20,11
1683364819592,SE 154,A00,187528,Staff,30,0,50,20
1683364820620,SIO 3,A01,258171,Staff,35,0,40,5
1683364821649,SIO 10,A00,187144,Cook; Geoffrey W,0,3,75,75
1683364822678,SIO 45,A00,187152,Cook; Geoffrey W,1,0,100,99
1683364823705,SIO 109R,A00,194486,Staff,0,3,20,20
1683364825757,SIO 187,A01,187233,Kacev; David,12,0,40,28
1683364826788,SOCI 1,A01,258656,Thorpe; Charles Robert,28,0,30,2
1683364826788,SOCI 1,A02,258658,Thorpe; Charles Robert,30,0,30,0
1683364826788,SOCI 1,A03,258661,Thorpe; Charles Robert,25,0,25,0
1683364826788,SOCI 1,A04,258666,Thorpe; Charles Robert,22,0,25,3
1683364826788,SOCI 1,A05,258897,Thorpe; Charles Robert,23,0,25,2
1683364826788,SOCI 1,A06,258898,Thorpe; Charles Robert,25,0,25,0
1683364827816,SOCI 30,A01,258903,Pardo Guerra; Juan Pablo,15,0,30,15
1683364828838,SOCI 102,A00,258904,Staff,9,0,25,16
1683364829862,SOCI 106,A00,258905,Staff,19,0,25,6
1683364830887,SOCI 111,A00,258907,Ribas Norris; Janet Vanesa,26,0,30,4
1683364831914,SOCI 121R,A00,258908,Pardo Guerra; Juan Pablo,10,0,30,20
1683364832938,SOCI 126,A01,203330,Staff,14,0,20,6
1683364833962,SOCI 131,A00,258909,Thorpe; Charles Robert,31,0,60,29
1683364834987,SOCI 135,A00,258910,Payne; Christine Anna,0,9,30,30
1683364836011,SOCI 157,A00,258911,Staff,12,0,30,18
1683364837037,SOCI 184,A00,258912,Staff,25,0,30,5
1683364838066,SOCI 188D,A00,258913,Staff,22,0,30,8
1683364839095,SYN 2,001,187529,Staff,10,0,16,6
1683364839095,SYN 2,002,201452,Staff,0,18,16,16
1683364839095,SYN 2,003,201469,Staff,3,0,16,13
1683364840123,SYN 100,A01,187531,Staff,0,9,20,20
1683364840123,SYN 100,B01,201491,Staff,0,12,20,20
1683364841152,TDAC 1,A00,189286,Walsh; Kim C.,3,0,20,17
1683364841152,TDAC 1,B00,189287,Harting; Carla Kelso,11,0,20,9
1683364842177,TDAC 101,A00,189300,Walsh; Kim C.,16,0,20,4
1683364842177,TDAC 101,B00,189301,Harting; Carla Kelso,18,0,20,2
1683364843205,TDAC 102,A00,189304,Basso; Beatrice,14,0,20,6
1683364844234,TDAC 108,A00,189305,Staff,18,0,20,2
1683364845260,TDDE 131,A00,189310,Staff,19,0,20,1
1683364845260,TDDE 131,B00,189314,Staff,19,0,20,1
1683364845260,TDDE 131,C00,189315,Staff,48,0,50,2
1683364845260,TDDE 131,D00,189316,Staff,14,0,15,1
1683364845260,TDDE 131,E00,204841,Staff,20,0,20,0
1683364846286,TDGE 10,A00,189289,Staff,30,0,50,20
1683364846286,TDGE 10,B00,189290,Havis; Allan,1,0,50,49
1683364847313,TDGE 11,A00,189291,Fulton; Julia,0,3,50,50
1683364847313,TDGE 11,B00,189292,Staff,20,0,25,5
1683364847313,TDGE 11,C00,260270,Staff,0,0,0,0
1683364848337,TDGE 25,A00,189294,Staff,3,0,20,17
1683364849361,TDGE 124,A00,189318,Fulton; Julia,0,8,50,50
1683364850386,TDGE 125,A00,189319,Staff,13,0,25,12
1683364850386,TDGE 125,B00,189320,Staff,23,0,25,2
1683364851413,TDGE 127,A00,189322,Havis; Allan,0,0,50,50
1683364852440,TDHT 101,A00,189323,Staff,18,0,25,7
1683364852440,TDHT 101,B00,189324,Staff,25,0,25,0
1683364853467,TDHT 102,A00,189325,Staff,49,0,50,1
1683364854495,TDMV 1,A00,189295,Arcidiacono; Kristin,19,0,30,11
1683364854495,TDMV 1,B00,189296,Caligagan; Maria T.,24,0,30,6
1683364855519,TDMV 2,A00,189297,Sammartano; Tonnie,28,0,30,2
1683364855519,TDMV 2,B00,189299,Arcidiacono; Kristin,24,0,30,6
1683364856544,TDMV 3,A00,204998,Rincon; Alicia,22,0,30,8
1683364857568,TDMV 120,A00,189458,Sammartano; Tonnie,28,0,30,2
1683364858592,TDMV 138,A00,189541,Jun; Grace Shin Hae,22,0,40,18
1683364859617,TDMV 142,A00,189717,Caligagan; Tony,24,0,30,6
1683364859617,TDMV 142,B00,189718,Caligagan; Maria T.,25,0,30,5
1683364860645,TMC 2,A01,187533,Staff,25,0,25,0
1683364860645,TMC 2,A02,187534,Staff,25,0,25,0
1683364861677,USP 1,A01,187536,Kwak; Nancy,0,16,25,25
1683364862704,USP 5,A01,187538,Staff,10,0,25,15
1683364863730,USP 101,A00,199253,Staff,0,4,0,0
1683364864755,USP 124,A00,187562,Boomhower; Matthew Charles,1,0,30,29
1683364865778,USP 138,A00,187582,Staff,20,0,25,5
1683364866802,USP 152,A01,187597,Staff,4,0,25,21
1683364867829,USP 153,A00,187598,Staff,19,0,25,6
1683364868854,USP 168,A00,187607,Kwak; Nancy,2,0,5,3
1683364869881,USP 173,A00,187619,Staff,4,0,25,21
1683364870906,USP 181,A00,187638,Staff,0,3,25,25
1683364871930,VIS 103,A00,187650,Cruz; Edwin Teddy,22,0,75,53
1683364872958,VIS 110D,A00,187669,Staff,12,0,22,10
1683364873987,VIS 127C,A00,187720,Shen; Kuiyi,67,0,146,79
1683364875012,VIS 149,A00,187731,Yoldas; Pinar,0,14,22,22
1683364876039,VIS 151,A01,188091,Staff,22,0,34,12
1683364876039,VIS 151,A02,188092,Staff,11,0,34,23
1683364877064,VIS 160B,A00,188093,Stalbaum; Brett,0,0,10,10
1683364879115,WCWP 10B,A00,201720,Staff,10,0,15,5
1683364879115,WCWP 10B,B00,201722,Staff,9,0,15,6
1683364880142,WCWP 100,A00,201725,Gagnon; Jeffrey C,0,0,2,2
1683364880142,WCWP 100,B00,201727,Staff,0,4,15,15
1683364883250,ANBI 133,A00,258401,Wilder; Linnea Lorene,34,0,40,6
1683364884277,ANBI 140,A00,258395,Hrvoj Mihic; Branka,18,0,25,7
1683364885301,ANSC 120,A00,258402,Bialecki; Jon Anthony,27,0,40,13
1683364886325,ANSC 144,A00,258400,Staff,14,0,40,26
1683364888373,ANSC 166,A00,258396,Parish; Steven Martin,157,0,175,18
1683364889398,ANSC 180,A00,193533,Staff,9,0,20,11
1683364890426,ANSC 188,A00,258397,Jassal; Aftab,33,0,40,7
1683364891455,ANTH 3,A01,258316,Staff,23,0,30,7
1683364892481,ANTH 5,A00,258394,Semendeferi; Ekaterini,16,0,20,4
1683364893505,ANTH 21,A01,258331,Staff,8,0,40,32
1683364894534,ANTH 103,A00,258398,Varma; Saiba,15,0,25,10
1683364895569,AWP 10,001,202034,Staff,0,0,0,0
1683364895569,AWP 10,002,202035,Staff,0,0,0,0
1683364895569,AWP 10,003,202036,Staff,0,0,0,0
1683364895569,AWP 10,004,202037,Staff,0,0,0,0
1683364895569,AWP 10,005,202038,Staff,0,0,0,0
1683364895569,AWP 10,006,202039,Staff,0,0,0,0
1683364895569,AWP 10,007,202040,Staff,0,0,0,0
1683364895569,AWP 10,008,202041,Staff,0,0,0,0
1683364895569,AWP 10,009,202042,Staff,0,0,0,0
1683364895569,AWP 10,010,202043,Staff,0,0,0,0
1683364895569,AWP 10,011,202044,Staff,0,0,0,0
1683364895569,AWP 10,012,202045,Staff,0,0,0,0
1683364895569,AWP 10,013,202046,Staff,0,0,0,0
1683364895569,AWP 10,014,202047,Staff,0,0,0,0
1683364895569,AWP 10,015,202048,Staff,0,0,0,0
1683364895569,AWP 10,016,202049,Staff,0,0,0,0
1683364895569,AWP 10,017,202050,Staff,0,0,0,0
1683364895569,AWP 10,018,202051,Staff,0,0,0,0
1683364895569,AWP 10,019,202052,Staff,0,0,0,0
1683364895569,AWP 10,020,202053,Staff,0,0,0,0
1683364895569,AWP 10,021,202054,Staff,0,0,0,0
1683364895569,AWP 10,022,202055,Staff,0,0,0,0
1683364895569,AWP 10,023,202056,Staff,0,0,0,0
1683364895569,AWP 10,024,202057,Staff,0,0,0,0
1683364895569,AWP 10,025,202058,Staff,0,0,0,0
1683364895569,AWP 10,026,202059,Staff,0,0,0,0
1683364896597,AWP 102,001,202032,Staff,0,0,0,0
1683364896597,AWP 102,002,202033,Staff,0,0,0,0
1683364897626,BENG 100,A01,254234,Taylor Amos; Alyssa C,31,0,40,9
1683364898650,BENG 196,001,270013,Engler; Adam J.,9999,0,9999,0
1683364899674,BICD 100R,A01,202018,Smith; Laurie,0,7,32,32
1683364899674,BICD 100R,A02,202019,Smith; Laurie,0,2,32,32
1683364899674,BICD 100R,A03,202020,Smith; Laurie,0,1,32,32
1683364899674,BICD 100R,A04,202021,Smith; Laurie,9,0,32,23
1683364899674,BICD 100R,A05,202022,Smith; Laurie,12,0,32,20
1683364900702,BICD 136,A01,193242,Gustafson-Brown; Cindy,0,2,32,32
1683364900702,BICD 136,A02,193244,Gustafson-Brown; Cindy,14,0,32,18
1683364901733,BIEB 102,A01,193249,Butler; Shannon Rhey,0,2,32,32
1683364901733,BIEB 102,A02,193251,Butler; Shannon Rhey,0,0,32,32
1683364901733,BIEB 102,A03,193253,Butler; Shannon Rhey,0,1,32,32
1683364901733,BIEB 102,A04,193255,Butler; Shannon Rhey,17,0,32,15
1683364901733,BIEB 102,A05,193265,Butler; Shannon Rhey,26,0,32,6
1683364901733,BIEB 102,A06,193269,Butler; Shannon Rhey,16,0,32,16
1683364903784,BIEB 150,A01,193274,Staff,0,0,32,32
1683364903784,BIEB 150,A02,193285,Staff,23,0,32,9
1683364904809,BIEB 194,A00,193286,Kurle; Carolyn M.,22,0,32,10
1683364905837,BILD 1,A01,192291,Staff,16,0,32,16
1683364905837,BILD 1,A02,192292,Staff,30,0,32,2
1683364905837,BILD 1,B01,192520,Reuther; Keefe,0,1,0,0
1683364905837,BILD 1,B02,192532,Reuther; Keefe,0,1,0,0
1683364906863,BILD 3,A01,192556,Butler; Shannon Rhey,0,0,32,32
1683364906863,BILD 3,A02,192581,Butler; Shannon Rhey,4,0,32,28
1683364906863,BILD 3,A03,192611,Butler; Shannon Rhey,23,0,32,9
1683364906863,BILD 3,A04,192612,Butler; Shannon Rhey,25,0,32,7
1683364906863,BILD 3,A05,192613,Butler; Shannon Rhey,27,0,32,5
1683364906863,BILD 3,A06,192679,Butler; Shannon Rhey,27,0,32,5
1683364906863,BILD 3,A07,192682,Butler; Shannon Rhey,21,0,32,11
1683364907892,BILD 4,A01,192836,Reuther; Keefe,0,0,24,24
1683364907892,BILD 4,A02,193044,Reuther; Keefe,4,0,24,20
1683364908917,BILD 10,A01,193142,Gustafson-Brown; Cindy,30,0,32,2
1683364908917,BILD 10,A02,193149,Gustafson-Brown; Cindy,31,0,32,1
1683364909942,BIMM 100,A01,193301,Staff,1,6,32,31
1683364909942,BIMM 100,A02,193312,Staff,0,5,32,32
1683364909942,BIMM 100,A03,193323,Staff,0,8,32,32
1683364910970,BIMM 101,A01,193329,McDonnell; Lisa Marie,0,3,24,24
1683364910970,BIMM 101,A02,193339,McDonnell; Lisa Marie,0,3,24,24
1683364910970,BIMM 101,B01,193354,McDonnell; Lisa Marie,0,3,24,24
1683364910970,BIMM 101,B02,193357,McDonnell; Lisa Marie,0,3,24,24
1683364912000,BIMM 110,A01,193377,Tat; John,0,11,32,32
1683364912000,BIMM 110,A02,193378,Tat; John,0,9,32,32
1683364913030,BIMM 120,A01,206116,Staff,0,0,32,32
1683364913030,BIMM 120,A02,206117,Staff,8,0,32,24
1683364913030,BIMM 120,A03,206121,Staff,21,0,32,11
1683364914057,BIPN 100,A01,193393,Park; Ji Young,0,14,32,32
1683364914057,BIPN 100,A02,193402,Park; Ji Young,0,13,32,32
1683364914057,BIPN 100,A03,193413,Park; Ji Young,0,14,32,32
1683364914057,BIPN 100,A04,193414,Park; Ji Young,0,13,32,32
1683364915083,BIPN 102,A01,193429,Staff,0,0,32,32
1683364915083,BIPN 102,A02,193438,Staff,22,0,32,10
1683364916170,BIPN 106,A01,193450,Reyes Gonzalez; Catalina,0,2,40,40
1683364917196,BIPN 134,A01,193465,Cooke; James Edward,1,0,32,31
1683364917196,BIPN 134,A02,193474,Cooke; James Edward,25,0,32,7
1683364917196,BIPN 134,A03,193485,Cooke; James Edward,29,0,32,3
1683364917196,BIPN 134,A04,193486,Cooke; James Edward,21,0,32,11
1683364917196,BIPN 134,A05,193491,Cooke; James Edward,31,0,32,1
1683364917196,BIPN 134,A06,193501,Cooke; James Edward,30,0,32,2
1683364917196,BIPN 134,A07,193510,Cooke; James Edward,29,0,32,3
1683364919247,BISP 194,A00,222522,Staff,14,0,32,18
1683364920274,CAT 124,A01,202407,Staff,19,0,25,6
1683364921302,CAT 125,A00,202408,Marchisotto; Jennifer Anne,4,0,20,16
1683364922328,CAT 125R,A00,202409,Smith; Lauryn Alissa,0,11,20,20
1683364922328,CAT 125R,B00,202410,Morales; Celeste Georgianna,0,11,20,20
1683364922328,CAT 125R,C00,202411,Irwin; Matthew Joseph,0,10,20,20
1683364923354,CENG 15,A01,204712,Yang; Kesong,0,1,0,0
1683364924377,CENG 114,A00,202070,Jahed Motlagh; Zeinab,5,0,20,15
1683364925403,CGS 105,A00,185477,Wesling; Megan E.,24,0,40,16
1683364926428,CGS 106,A00,185494,Staff,13,0,22,9
1683364927453,CGS 108,A00,185495,Staff,14,0,20,6
1683364928477,CGS 114,A00,185496,Staff,13,0,18,5
1683364929505,CGS 119,A00,185501,Staff,15,0,20,5
1683364930531,CGS 120,A00,185511,Staff,13,0,20,7
1683364931556,CHEM 4,A01,184675,Bussey; Thomas J,96,0,100,4
1683364932582,CHEM 6A,A01,184677,Staff,34,0,60,26
1683364933607,CHEM 6B,A01,184679,Staff,65,0,100,35
1683364934632,CHEM 6C,A01,184681,Bussey; Thomas J,1,0,50,49
1683364934632,CHEM 6C,A02,184682,Bussey; Thomas J,34,0,50,16
1683364935655,CHEM 40A,A01,184684,Albizati; Kim F.,37,0,100,63
1683364936680,CHEM 40B,A01,184686,Albizati; Kim F.,0,20,100,100
1683364937706,CHEM 41B,A01,184690,Staff,52,0,100,48
1683364938736,COGS 3,A01,184715,Boyle; Mary E. T.,0,25,40,40
1683364939765,COGS 14B,A01,185172,Staff,0,15,38,38
1683364940794,COGS 18,A01,184736,Staff,16,0,80,64
1683364941820,COGS 100,A01,184932,Staff,0,5,73,73
1683364942845,COGS 101A,A01,184935,Staff,0,39,30,30
1683364943870,COGS 101B,A01,184944,Staff,0,2,30,30
1683364944895,COGS 101C,A01,184946,Staff,0,12,30,30
1683364945922,COGS 102A,A01,184951,Johnson; Christine M.,2,0,40,38
1683364946947,COGS 107B,A01,184953,Mooshagian; Eric Frederick,0,50,40,40
1683364947973,COGS 118B,A01,184959,Gupta; Anjum,0,48,40,40
1683364948998,COGS 153,A00,184961,Staff,0,15,30,30
1683364950027,COGS 177,A00,184962,Staff,0,20,30,30
1683364951053,COGS 187A,A01,184969,Boyle; Mary E. T.,0,17,40,40
1683364952080,COMM 10,A01,185174,Staff,0,5,25,25
1683364952080,COMM 10,A02,185189,Staff,0,5,25,25
1683364952080,COMM 10,A03,269821,Staff,0,0,0,0
1683364953105,COMM 100B,A01,185475,Staff,0,0,0,2
1683364953105,COMM 100B,A02,185476,Staff,13,0,25,12
1683364954133,COMM 100C,A01,185314,Staff,1,0,25,24
1683364954133,COMM 100C,A02,185327,Staff,19,0,25,6
1683364955161,COMM 110M,A00,185349,Staff,2,0,40,38
1683364956189,COMM 113T,A00,185352,Staff,24,0,40,16
1683364957215,COMM 114I,A00,185353,Staff,33,0,40,7
1683364958241,COMM 131,A00,185354,Staff,19,0,30,11
1683364959266,CSE 8A,A50,185358,Cao; Yingjun,0,46,10,10
1683364960294,CSE 8B,A01,185362,Staff,0,46,50,50
1683364961322,CSE 11,A01,185416,Cao; Yingjun,0,92,10,10
1683364962347,CSE 20,A01,185445,Briones; Jor-el Thomas Caparas,5,0,25,20
1683364963371,CSE 21,A01,185447,Staff,10,0,50,40
1683364964398,CSE 101,A01,185451,Staff,0,13,50,50
1683364964398,CSE 101,B01,185453,Jones; Miles E,0,11,50,50
1683364966447,CSE 141,A01,185458,Eldon; John,20,0,100,80
1683364967476,CSE 141L,A01,185461,Eldon; John,12,0,100,88
1683364968505,CSE 142,A01,185463,Staff,36,0,60,24
1683364968505,CSE 142,B01,201355,Staff,0,7,60,60
1683364969534,CSE 142L,A01,185470,Staff,36,0,60,24
1683364969534,CSE 142L,B01,201417,Staff,0,6,60,60
1683364970561,CSE 190,A00,201433,Staff,32,0,49,17
1683364971588,DOC 1,A01,259136,Strom; Megan C.,7,0,15,8
1683364971588,DOC 1,A02,259137,Strom; Megan C.,14,0,15,1
1683364971588,DOC 1,A03,259138,Strom; Megan C.,14,0,15,1
1683364971588,DOC 1,A04,259139,Strom; Megan C.,14,0,15,1
1683364972614,DOC 100D,A00,259140,Pass; Natalye Joann,16,0,25,9
1683364973639,DSGN 1,A01,184749,Rill; Bryan,0,25,30,30
1683364974667,DSGN 100,A01,185168,Staff,0,2,25,25
1683364975696,ECE 5,A01,185626,Morris; Karcher William,0,10,0,0
1683364976720,ECE 101,A01,185628,Staff,17,0,70,53
1683364977746,ECE 107,A01,185635,Baghdadchi; Saharnaz,0,0,20,20
1683364977746,ECE 107,A02,185638,Baghdadchi; Saharnaz,4,0,20,16
1683364978771,ECE 148,A01,185647,Silberman; Jack,0,0,16,16
1683364979798,ECON 1,A01,185537,Crane; Meredith Helen,54,0,70,16
1683364980826,ECON 3,A01,185549,Crane; Meredith Helen,32,0,70,38
1683364981853,ECON 4,A01,203354,Anderson; John Charles,0,4,10,10
1683364982881,ECON 100A,A01,185574,Staff,0,4,40,40
1683364983909,ECON 100B,A01,185576,Staff,0,12,50,50
1683364984941,ECON 100C,A01,185589,Newhouse; Herbert S,29,0,70,41
1683364985967,ECON 105,A00,185608,Vespa; Emanuel Ignacio,19,0,35,16
1683364986997,ECON 109,A01,185610,Shishkin; Denis,10,0,35,25
1683364988022,ECON 110A,A01,185612,Staff,11,0,40,29
1683364989048,ECON 120A,A01,185615,Staff,20,0,40,20
1683364990074,ECON 120C,A01,185617,Sun; Yixiao,0,21,70,70
1683364991102,ECON 144,A00,203346,Squires; Dale E,3,0,35,32
1683364992131,ECON 171,A01,203349,Newhouse; Herbert S,0,1,35,35
1683364993157,ECON 173A,A01,185621,Toda; Alexis Akira,21,0,35,14
1683364994183,EDS 25,A01,202413,Staff,0,1,0,0
1683364994183,EDS 25,A02,202414,Staff,0,1,0,0
1683364994183,EDS 25,A03,202415,Staff,0,0,0,0
1683364994183,EDS 25,A04,202416,Staff,0,1,0,0
1683364994183,EDS 25,A05,202439,Staff,0,0,0,0
1683364994183,EDS 25,A06,202440,Staff,0,0,0,0
1683364994183,EDS 25,B01,202631,Staff,0,0,0,0
1683364994183,EDS 25,B02,202632,Staff,0,0,0,0
1683364994183,EDS 25,B03,202639,Staff,0,0,0,0
1683364994183,EDS 25,B04,202640,Staff,0,0,0,0
1683364994183,EDS 25,B05,202643,Staff,0,0,0,0
1683364994183,EDS 25,B06,202644,Staff,0,0,0,0
1683364995207,EDS 38,A01,202659,Black; Alison Michelle,24,0,25,1
1683364996232,EDS 115,A00,202652,Staff,18,0,30,12
1683364997256,EDS 125,A00,202649,Staff,14,0,30,16
1683364998285,EDS 126,A01,203332,Staff,30,0,30,0
1683364999311,EDS 139,A00,202838,Staff,16,0,25,9
1683365000338,EDS 146,A01,202655,Staff,14,0,25,11
1683365001363,ENG 15,A00,185667,Staff,0,1,0,0
1683365001363,ENG 15,B00,185672,Staff,0,0,0,0
1683365001363,ENG 15,C00,185675,Staff,0,0,0,0
1683365001363,ENG 15,D00,185682,Staff,0,0,0,0
1683365001363,ENG 15,E00,185684,Staff,0,0,0,0
1683365002390,ETHN 103,A00,185710,Staff,0,4,35,35
1683365003415,ETHN 103A,A00,199228,Man; Simeon S,2,0,9,7
1683365004442,ETHN 109,A00,185711,Staff,18,0,35,17
1683365005469,ETHN 142,A00,185726,Staff,0,4,30,30
1683365006497,ETHN 163J,A00,199229,Man; Simeon S,5,0,8,3
1683365007525,ETHN 168,A00,185727,Staff,8,0,10,2
1683365008552,ETHN 182,A00,185728,Staff,0,0,35,35
1683365009581,ETHN 183,A00,185737,Staff,8,0,18,10
1683365010606,GLBH 111,A01,209361,Burgos; Jose L.,0,0,0,0
1683365012658,HIEU 104,A00,185792,Staff,16,0,20,4
1683365013685,HIEU 115,A00,185800,Staff,1,0,20,19
1683365014709,HIEU 128,A00,185801,Staff,0,7,20,20
1683365015734,HIEU 147,A00,185802,Staff,16,0,20,4
1683365016758,HIEU 154,A00,185823,Staff,12,0,20,8
1683365017783,HILA 102,A00,185826,Staff,13,0,20,7
1683365018809,HILD 2C,A01,185778,Staff,0,12,20,20
1683365019908,HILD 7B,A01,185780,Kwak; Nancy,0,15,32,32
1683365019908,HILD 7B,A02,185781,Kwak; Nancy,0,18,32,32
1683365020935,HILD 30,A01,185791,Staff,14,0,20,6
1683365021963,HISC 119,A00,185830,Golan; Tal,0,9,20,20
1683365022988,HITO 156GS,A00,185831,Patterson; Patrick H.,0,0,0,23
1683365024013,HIUS 103,A00,185832,Man; Simeon S,1,6,20,19
1683365025038,HIUS 117,A00,185836,Kwak; Nancy,2,0,20,18
1683365026067,HIUS 125,A00,185840,Man; Simeon S,0,0,23,23
1683365027094,HIUS 149,A00,185845,Staff,0,0,20,20
1683365028123,HUM 3,A01,185882,Zavodny; Tatiana Sophia,0,7,50,50
1683365028123,HUM 3,B01,185899,Caldwell; Michael Alan,0,18,50,50
1683365029188,HUM 3GS,A00,185900,Patterson; Patrick H.,0,0,0,23
1683365030218,HUM 4,A01,185938,Zroka; Amy Liane,31,0,50,19
1683365030218,HUM 4,B01,185956,Watkins; Eric,0,3,50,50
1683365030218,HUM 4,B02,202209,Watkins; Eric,0,2,50,50
1683365030218,HUM 4,B03,202210,Watkins; Eric,0,2,50,50
1683365031245,HUM 5,A01,185958,West; Geoffrey Scott,3,0,50,47
1683365031245,HUM 5,A02,202215,West; Geoffrey Scott,0,0,50,50
1683365032268,INTL 190,A00,185959,Gagnon; Jeffrey C,0,0,0,9
1683365032268,INTL 190,B00,185960,Lettieri; Michael Joseph,0,0,0,1
1683365033293,JAPN 180,A00,254509,Staff,4,0,30,26
1683365034320,LATI 10,A01,202853,Kennemore; Amy Michelle,4,0,35,31
1683365034320,LATI 10,A02,202854,Kennemore; Amy Michelle,2,0,35,33
1683365034320,LATI 10,A03,270054,Kennemore; Amy Michelle,30,0,30,0
1683365035345,LATI 180,A00,202855,Kennemore; Amy Michelle,11,0,20,9
1683365036373,LAWS 101,A00,201767,Golan; Tal,0,7,40,40
1683365037404,LIFR 1C,A00,185961,Staff,6,0,20,14
1683365038434,LIFR 1CX,A00,185962,Staff,7,0,20,13
1683365039461,LIFR 1D,A00,185963,Staff,9,0,20,11
1683365040486,LIFR 1DX,A00,185964,Staff,9,0,20,11
1683365041512,LIGN 101,A01,186039,Staff,43,0,50,7
1683365042540,LIGN 165,A00,186040,Staff,18,0,50,32
1683365043566,LTCS 108,A00,186041,Staff,6,0,10,4
1683365044594,LTCS 119,A00,186042,Staff,16,0,20,4
1683365045622,LTCS 130,A00,186043,Wesling; Megan E.,15,0,25,10
1683365047673,LTEA 138,A00,186119,Staff,14,0,40,26
1683365048698,LTEN 124,A00,186148,Staff,6,0,25,19
1683365049722,LTEN 178,A00,186149,Staff,7,0,15,8
1683365050750,LTEN 181,A00,186150,Blanco; John D,33,0,40,7
1683365051775,LTWL 120,A00,186160,Staff,20,0,25,5
1683365052800,LTWL 165,A00,186161,Staff,22,0,25,3
1683365053826,LTWR 100,A00,186162,Staff,0,5,15,15
1683365054854,LTWR 102,A00,186163,Doller; Ben,5,0,15,10
1683365055882,MAE 8,A01,186412,Staff,0,0,0,0
1683365056906,MAE 30B,A00,186445,Bahadori; Mohammad Yousef,83,0,100,17
1683365057930,MAE 40,A00,186592,Bewley; Thomas R,10,0,50,40
1683365058955,MAE 101B,A00,186593,Bahadori; Mohammad Yousef,81,0,100,19
1683365059979,MAE 105,A00,186594,Bandaru; Prabhakar,12,0,50,38
1683365061003,MAE 107,A00,186599,Pham; Hieu Tan,0,7,120,120
1683365062033,MAE 148,A01,186660,Silberman; Jack,3,0,16,13
1683365063058,MATH 10A,A01,188095,Staff,0,5,35,35
1683365064088,MATH 10B,A01,188097,Bowers; Adam R.,0,11,30,30
1683365064088,MATH 10B,A02,188099,Bowers; Adam R.,0,11,30,30
1683365064088,MATH 10B,B01,188104,Bowers; Adam R.,0,10,30,30
1683365064088,MATH 10B,B02,188106,Bowers; Adam R.,0,10,30,30
1683365065116,MATH 10C,A01,188111,Staff,0,18,30,30
1683365065116,MATH 10C,A02,188127,Staff,0,17,30,30
1683365065116,MATH 10C,A03,188131,Staff,0,18,30,30
1683365065116,MATH 10C,B01,188218,Staff,18,0,30,12
1683365065116,MATH 10C,B02,188244,Staff,13,0,30,17
1683365065116,MATH 10C,B03,188277,Staff,16,0,30,14
1683365066146,MATH 18,A01,188344,Bach; Quang Tran,18,0,30,12
1683365066146,MATH 18,A02,188345,Bach; Quang Tran,11,0,30,19
1683365066146,MATH 18,B01,188353,Bach; Quang Tran,10,0,30,20
1683365066146,MATH 18,B02,188354,Bach; Quang Tran,20,0,30,10
1683365067172,MATH 20A,A01,188374,Staff,12,0,35,23
1683365068199,MATH 20B,A01,188382,Ohm; Ko Woon,6,0,30,24
1683365068199,MATH 20B,A02,188383,Ohm; Ko Woon,21,0,30,9
1683365068199,MATH 20B,B01,188385,Ohm; Ko Woon,7,0,30,23
1683365068199,MATH 20B,B02,188392,Ohm; Ko Woon,22,0,30,8
1683365069228,MATH 20C,A01,188394,Harel; Guershon,10,0,30,20
1683365069228,MATH 20C,A02,188395,Harel; Guershon,15,0,30,15
1683365069228,MATH 20C,B01,188404,Harel; Guershon,4,0,30,26
1683365069228,MATH 20C,B02,188405,Harel; Guershon,19,0,30,11
1683365070254,MATH 20D,A01,188414,Hammock; Frances H,0,1,30,30
1683365070254,MATH 20D,A02,188415,Hammock; Frances H,3,0,30,27
1683365070254,MATH 20D,B01,188447,Hammock; Frances H,1,0,30,29
1683365070254,MATH 20D,B02,188486,Hammock; Frances H,8,0,30,22
1683365071283,MATH 20E,A01,188649,Staff,21,0,30,9
1683365071283,MATH 20E,A02,188650,Staff,23,0,30,7
1683365071283,MATH 20E,A03,188673,Staff,0,0,30,30
1683365072311,MATH 102,A01,188675,Staff,0,35,35,35
1683365073336,MATH 103B,A01,188681,Staff,3,0,35,32
1683365073336,MATH 103B,B01,188692,Staff,5,0,35,30
1683365074363,MATH 109,A01,188695,Salehi Golsefidy; Alireza,25,0,35,10
1683365074363,MATH 109,A02,188696,Salehi Golsefidy; Alireza,25,0,35,10
1683365075397,MATH 120A,A01,188698,Eggers; John Dietrich,7,0,35,28
1683365076422,MATH 142B,A01,188736,Ioana; Adrian,0,2,30,30
1683365076422,MATH 142B,A02,188741,Ioana; Adrian,0,0,30,30
1683365076422,MATH 142B,A03,188743,Ioana; Adrian,0,1,30,30
1683365077447,MATH 168A,A01,188790,Staff,0,9,35,35
1683365078472,MATH 170A,A01,188803,Nie; Jiawang,0,2,35,35
1683365078472,MATH 170A,A02,188811,Nie; Jiawang,0,0,35,35
1683365078472,MATH 170A,A03,188814,Nie; Jiawang,1,0,35,34
1683365078472,MATH 170A,A04,188815,Nie; Jiawang,13,0,35,22
1683365079497,MATH 193B,A01,188817,Staff,0,0,35,35
1683365079497,MATH 193B,A02,188818,Staff,5,0,35,30
1683365080523,MGT 4,A01,202857,Anderson; John Charles,61,0,80,19
1683365081548,MGT 12,A00,202858,Lindenberger; Wade Douglas,42,0,90,48
1683365082576,MGT 18,A00,202859,Staff,74,0,90,16
1683365083603,MGT 18GS,A00,202860,McKay; Michael J,13,0,28,15
1683365084629,MGT 45,A00,202861,Pecore; Joseph P.,15,0,90,75
1683365085658,MGT 100,A00,202863,Yavorsky; Daniel Ryan,28,0,90,62
1683365086685,MGT 103,A00,202864,Ehrich; Kristine R,0,17,90,90
1683365087709,MGT 112,A00,202865,Ehrich; Kristine R,15,0,90,75
1683365088733,MGT 121A,A00,202868,Staff,0,20,0,0
1683365089762,MGT 131B,A00,202869,Anderson; John Charles,59,0,90,31
1683365090787,MGT 136,A00,202871,Lindenberger; Wade Douglas,84,0,90,6
1683365091811,MGT 164,A00,202873,Staff,0,68,90,91
1683365092838,MGT 164GS,A00,202874,McKay; Mary A,13,0,28,15
1683365093865,MGT 180,A00,202875,Staff,0,50,90,91
1683365094889,MMW 11R,A01,205019,Herbst; Matthew,3,0,30,27
1683365094889,MMW 11R,A02,205026,Herbst; Matthew,29,0,30,1
1683365095915,MMW 15,A01,193512,Chang; Edmond Yi-Teh,0,9,28,28
1683365095915,MMW 15,A02,193513,Chang; Edmond Yi-Teh,0,5,28,28
1683365095915,MMW 15,A03,193514,Chang; Edmond Yi-Teh,0,5,28,28
1683365095915,MMW 15,A04,193515,Chang; Edmond Yi-Teh,0,5,28,28
1683365095915,MMW 15,A05,193516,Chang; Edmond Yi-Teh,0,4,28,28
1683365095915,MMW 15,A06,193517,Chang; Edmond Yi-Teh,0,5,28,28
1683365095915,MMW 15,B01,193519,Chang; Edmond Yi-Teh,0,5,28,28
1683365095915,MMW 15,B02,193520,Chang; Edmond Yi-Teh,0,5,28,28
1683365095915,MMW 15,B03,193521,Chang; Edmond Yi-Teh,0,5,28,28
1683365095915,MMW 15,B04,193522,Chang; Edmond Yi-Teh,0,4,28,28
1683365095915,MMW 15,B05,193523,Chang; Edmond Yi-Teh,0,5,28,28
1683365095915,MMW 15,B06,193524,Chang; Edmond Yi-Teh,0,4,28,28
1683365096943,MMW 122,A01,193526,Rahimi; Babak,0,15,28,28
1683365096943,MMW 122,A02,193527,Rahimi; Babak,0,14,28,28
1683365096943,MMW 122,A03,193528,Rahimi; Babak,0,0,0,0
1683365096943,MMW 122,A04,193529,Rahimi; Babak,0,0,0,0
1683365097969,MUS 1A,A01,186663,Staff,0,20,35,35
1683365098994,MUS 4,A01,186715,Staff,0,12,35,35
1683365100019,MUS 5R,A01,186796,Dubnov; Shlomo,0,17,35,35
1683365101044,MUS 6,A01,186798,Staff,0,4,25,25
1683365102072,MUS 7,A01,186830,Staff,13,0,35,22
1683365103098,MUS 8,A01,186930,Staff,0,26,35,35
1683365104122,MUS 15,A01,186932,Staff,0,16,35,35
1683365104122,MUS 15,B01,186934,Staff,0,15,35,35
1683365105149,MUS 80,A00,186935,Staff,0,0,20,20
1683365105149,MUS 80,B00,186936,Staff,25,0,25,0
1683365106174,NANO 11,A00,204702,Lipomi; Darren John,0,0,0,0
1683365107199,NANO 15,A01,204709,Yang; Kesong,0,1,0,0
1683365108222,NANO 114,A00,202069,Jahed Motlagh; Zeinab,3,0,10,7
1683365109250,PHIL 1,A00,186955,Grush; Rick Scott,32,0,40,8
1683365110274,PHIL 10,A01,186973,Grush; Rick Scott,28,0,35,7
1683365110274,PHIL 10,A02,186974,Grush; Rick Scott,33,0,35,2
1683365111298,PHIL 13,A01,186976,Staff,7,0,35,28
1683365111298,PHIL 13,A02,186977,Staff,16,0,35,19
1683365112326,PHIL 14,A01,186979,Staff,31,0,35,4
1683365112326,PHIL 14,A02,186986,Staff,32,0,35,3
1683365113355,PHIL 28,A01,186988,Staff,16,0,30,14
1683365113355,PHIL 28,A02,186989,Staff,1,0,30,29
1683365113355,PHIL 28,A03,186990,Staff,9,0,30,21
1683365113355,PHIL 28,A04,186991,Staff,26,0,30,4
1683365114381,PHIL 120,A00,186997,Staff,23,0,40,17
1683365115407,PHIL 137,A00,187003,Staff,9,0,40,31
1683365116434,PHIL 150,A00,187015,Staff,47,0,70,23
1683365117460,PHIL 167,A00,187021,Lamey; Andy M.,35,0,40,5
1683365118488,PHIL 174,A01,202226,Staff,17,0,20,3
1683365118488,PHIL 174,A02,202235,Staff,20,0,20,0
1683365119514,PHIL 191A,A00,258918,Staff,0,0,1,1
1683365120538,PHYS 1A,A00,187028,Staff,27,0,60,33
1683365121566,PHYS 1AL,001,187036,Staff,2,0,30,28
1683365121566,PHYS 1AL,002,187049,Staff,18,0,30,12
1683365122594,PHYS 1B,A00,187058,Staff,22,0,60,38
1683365123681,PHYS 1BL,001,187064,Staff,0,0,30,30
1683365123681,PHYS 1BL,002,187070,Staff,5,0,30,25
1683365124708,PHYS 1C,A00,187082,Staff,31,0,120,89
1683365125733,PHYS 1CL,001,187088,Staff,0,9,30,30
1683365125733,PHYS 1CL,002,187089,Staff,0,2,30,30
1683365125733,PHYS 1CL,009,262693,Staff,11,0,30,19
1683365126758,PHYS 2B,A01,187097,Staff,54,0,115,61
1683365127783,PHYS 2C,A01,187099,Staff,67,0,115,48
1683365128808,PHYS 2CL,A01,187101,Staff,5,0,28,23
1683365128808,PHYS 2CL,A02,187102,Staff,15,0,28,13
1683365129833,PHYS 2D,A01,187123,Shotwell; Brian,95,0,115,20
1683365130862,PHYS 4B,A01,187133,Grinstein; Benjamin,35,0,50,15
1683365131891,POLI 10,A00,188819,Staff,0,4,50,50
1683365132916,POLI 11,A00,188827,Staff,43,0,50,7
1683365133940,POLI 13R,A00,188828,Staff,0,1,20,20
1683365134965,POLI 27,A01,188830,Elgin; Samuel Zincke,0,1,70,70
1683365135992,POLI 30,A00,188832,Desposato; Scott,31,0,50,19
1683365137019,POLI 102F,A00,188834,Staff,3,0,40,37
1683365138044,POLI 104A,A00,188852,Staff,14,0,30,16
1683365139069,POLI 104I,A00,188853,Staff,0,6,20,20
1683365140095,POLI 110B,A00,188854,Wiens; David,7,0,20,13
1683365141121,POLI 112A,A00,188855,Wiens; David,5,0,30,25
1683365142166,POLI 117R,A00,188856,Forman; Fonna,0,11,20,20
1683365143192,POLI 118,A00,188857,Ingham; Sean,8,0,20,12
1683365144221,POLI 120G,A00,188858,Staff,9,0,30,21
1683365145249,POLI 131CR,A00,188863,Hoston; Germaine,23,0,50,27
1683365146277,POLI 133,A00,188864,Nellis; Gareth Hb,44,0,50,6
1683365147309,POLI 134D,A00,188865,Desposato; Scott,27,0,30,3
1683365148337,POLI 142A,A00,188871,Gartzke; Erik,22,0,50,28
1683365149363,POLI 142K,A00,188874,Staff,38,0,50,12
1683365150390,POLI 143,A00,188940,Gartzke; Erik,16,0,30,14
1683365151419,POLI 153,A00,188943,Staff,3,0,20,17
1683365152446,POLI 160AA,A00,188944,Staff,11,0,40,29
1683365153473,POLI 170A,A00,188945,Staff,11,0,30,19
1683365155524,PSYC 1,A00,188952,Staff,37,0,90,53
1683365156551,PSYC 2,B00,188953,Staff,19,0,35,16
1683365157578,PSYC 6,A00,188970,Staff,47,0,60,13
1683365158607,PSYC 7,A00,188973,Staff,37,0,45,8
1683365159633,PSYC 60,A01,188980,Rickard; Timothy C.,43,0,60,17
1683365160662,PSYC 70,A01,189001,Steiner; Eric Tomas,23,0,45,22
1683365161686,PSYC 100,A00,189005,Lacefield; Katharine I,0,98,120,120
1683365162710,PSYC 102,A00,189008,Staff,9,0,30,21
1683365163734,PSYC 106,B00,189026,Gorman; Michael R.,34,0,60,26
1683365164761,PSYC 114,B01,189033,Winkielman; Piotr,0,32,30,30
1683365165785,PSYC 131,A00,189036,Anagnostaras; Stephan,0,43,60,60
1683365166811,PSYC 136,A00,189041,Lowe; Angela Beth,0,7,25,25
1683365167837,PSYC 137,A00,189057,Winkielman; Piotr,0,34,25,25
1683365168862,PSYC 144,A00,189107,Wixted; John T,0,7,50,50
1683365170912,PSYC 162,A00,189142,Staff,0,8,85,85
1683365171937,PSYC 172,A00,189144,Gorman; Michael R.,0,7,30,30
1683365173984,PSYC 179,A00,189146,Lacefield; Katharine I,0,84,120,120
1683365175011,PSYC 181,A00,189147,Anagnostaras; Stephan,0,44,90,90
1683365176037,PSYC 190R,A00,189148,Barner; David A.,0,22,80,80
1683365177062,PSYC 191,A00,189275,Rickard; Timothy C.,0,7,25,25
1683365178090,PSYC 193,A00,189276,Chapman; Eddie Nathaniel,0,1,0,4
1683365179115,PSYC 193L,A01,189281,Lowe; Angela Beth,12,0,20,8
1683365179115,PSYC 193L,B01,189285,Staff,28,0,35,7
1683365180142,RELI 149,A00,187137,Rahimi; Babak,7,0,40,33
1683365181167,SE 9,A01,187315,Staff,0,2,18,18
1683365182191,SE 101B,A00,187409,Staff,24,0,30,6
1683365183217,SE 110B,A00,187444,Staff,10,0,40,30
1683365184243,SE 130B,A00,187449,Staff,31,0,40,9
1683365185268,SE 150A,A00,187516,Staff,9,0,20,11
1683365186292,SE 154,A00,187528,Staff,30,0,50,20
1683365187318,SIO 3,A01,258171,Staff,35,0,40,5
1683365188343,SIO 10,A00,187144,Cook; Geoffrey W,0,3,75,75
1683365189371,SIO 45,A00,187152,Cook; Geoffrey W,1,0,100,99
1683365190398,SIO 109R,A00,194486,Staff,0,3,20,20
1683365192449,SIO 187,A01,187233,Kacev; David,12,0,40,28
1683365193474,SOCI 1,A01,258656,Thorpe; Charles Robert,28,0,30,2
1683365193474,SOCI 1,A02,258658,Thorpe; Charles Robert,30,0,30,0
1683365193474,SOCI 1,A03,258661,Thorpe; Charles Robert,25,0,25,0
1683365193474,SOCI 1,A04,258666,Thorpe; Charles Robert,22,0,25,3
1683365193474,SOCI 1,A05,258897,Thorpe; Charles Robert,23,0,25,2
1683365193474,SOCI 1,A06,258898,Thorpe; Charles Robert,25,0,25,0
1683365194499,SOCI 30,A01,258903,Pardo Guerra; Juan Pablo,15,0,30,15
1683365195523,SOCI 102,A00,258904,Staff,9,0,25,16
1683365196548,SOCI 106,A00,258905,Staff,19,0,25,6
1683365197573,SOCI 111,A00,258907,Ribas Norris; Janet Vanesa,26,0,30,4
1683365198600,SOCI 121R,A00,258908,Pardo Guerra; Juan Pablo,10,0,30,20
1683365199624,SOCI 126,A01,203330,Staff,14,0,20,6
1683365200648,SOCI 131,A00,258909,Thorpe; Charles Robert,31,0,60,29
1683365201672,SOCI 135,A00,258910,Payne; Christine Anna,0,9,30,30
1683365202695,SOCI 157,A00,258911,Staff,12,0,30,18
1683365203718,SOCI 184,A00,258912,Staff,25,0,30,5
1683365204743,SOCI 188D,A00,258913,Staff,22,0,30,8
1683365205770,SYN 2,001,187529,Staff,10,0,16,6
1683365205770,SYN 2,002,201452,Staff,0,18,16,16
1683365205770,SYN 2,003,201469,Staff,3,0,16,13
1683365206799,SYN 100,A01,187531,Staff,0,9,20,20
1683365206799,SYN 100,B01,201491,Staff,0,12,20,20
1683365207825,TDAC 1,A00,189286,Walsh; Kim C.,3,0,20,17
1683365207825,TDAC 1,B00,189287,Harting; Carla Kelso,11,0,20,9
1683365208849,TDAC 101,A00,189300,Walsh; Kim C.,16,0,20,4
1683365208849,TDAC 101,B00,189301,Harting; Carla Kelso,18,0,20,2
1683365209874,TDAC 102,A00,189304,Basso; Beatrice,14,0,20,6
1683365210898,TDAC 108,A00,189305,Staff,18,0,20,2
1683365211926,TDDE 131,A00,189310,Staff,19,0,20,1
1683365211926,TDDE 131,B00,189314,Staff,19,0,20,1
1683365211926,TDDE 131,C00,189315,Staff,48,0,50,2
1683365211926,TDDE 131,D00,189316,Staff,14,0,15,1
1683365211926,TDDE 131,E00,204841,Staff,20,0,20,0
1683365212951,TDGE 10,A00,189289,Staff,30,0,50,20
1683365212951,TDGE 10,B00,189290,Havis; Allan,1,0,50,49
1683365213976,TDGE 11,A00,189291,Fulton; Julia,0,3,50,50
1683365213976,TDGE 11,B00,189292,Staff,20,0,25,5
1683365213976,TDGE 11,C00,260270,Staff,0,0,0,0
1683365215002,TDGE 25,A00,189294,Staff,3,0,20,17
1683365216028,TDGE 124,A00,189318,Fulton; Julia,0,8,50,50
1683365217052,TDGE 125,A00,189319,Staff,13,0,25,12
1683365217052,TDGE 125,B00,189320,Staff,23,0,25,2
1683365218079,TDGE 127,A00,189322,Havis; Allan,0,0,50,50
1683365219108,TDHT 101,A00,189323,Staff,18,0,25,7
1683365219108,TDHT 101,B00,189324,Staff,25,0,25,0
1683365220136,TDHT 102,A00,189325,Staff,49,0,50,1
1683365221160,TDMV 1,A00,189295,Arcidiacono; Kristin,19,0,30,11
1683365221160,TDMV 1,B00,189296,Caligagan; Maria T.,24,0,30,6
1683365222186,TDMV 2,A00,189297,Sammartano; Tonnie,28,0,30,2
1683365222186,TDMV 2,B00,189299,Arcidiacono; Kristin,24,0,30,6
1683365223211,TDMV 3,A00,204998,Rincon; Alicia,22,0,30,8
1683365224235,TDMV 120,A00,189458,Sammartano; Tonnie,28,0,30,2
1683365225260,TDMV 138,A00,189541,Jun; Grace Shin Hae,22,0,40,18
1683365226289,TDMV 142,A00,189717,Caligagan; Tony,24,0,30,6
1683365226289,TDMV 142,B00,189718,Caligagan; Maria T.,25,0,30,5
1683365227372,TMC 2,A01,187533,Staff,25,0,25,0
1683365227372,TMC 2,A02,187534,Staff,25,0,25,0
1683365228399,USP 1,A01,187536,Kwak; Nancy,0,16,25,25
1683365229424,USP 5,A01,187538,Staff,10,0,25,15
1683365230447,USP 101,A00,199253,Staff,0,4,0,0
1683365231472,USP 124,A00,187562,Boomhower; Matthew Charles,1,0,30,29
1683365232497,USP 138,A00,187582,Staff,20,0,25,5
1683365233525,USP 152,A01,187597,Staff,4,0,25,21
1683365234552,USP 153,A00,187598,Staff,19,0,25,6
1683365235581,USP 168,A00,187607,Kwak; Nancy,2,0,5,3
1683365236607,USP 173,A00,187619,Staff,4,0,25,21
1683365237632,USP 181,A00,187638,Staff,0,3,25,25
1683365238657,VIS 103,A00,187650,Cruz; Edwin Teddy,22,0,75,53
1683365239684,VIS 110D,A00,187669,Staff,12,0,22,10
1683365240708,VIS 127C,A00,187720,Shen; Kuiyi,67,0,146,79
1683365241734,VIS 149,A00,187731,Yoldas; Pinar,0,14,22,22
1683365242759,VIS 151,A01,188091,Staff,22,0,34,12
1683365242759,VIS 151,A02,188092,Staff,11,0,34,23
1683365243785,VIS 160B,A00,188093,Stalbaum; Brett,0,0,10,10
1683365245838,WCWP 10B,A00,201720,Staff,10,0,15,5
1683365245838,WCWP 10B,B00,201722,Staff,9,0,15,6
1683365246866,WCWP 100,A00,201725,Gagnon; Jeffrey C,0,0,2,2
1683365246866,WCWP 100,B00,201727,Staff,0,4,15,15
1683365250010,ANBI 133,A00,258401,Wilder; Linnea Lorene,34,0,40,6
1683365251041,ANBI 140,A00,258395,Hrvoj Mihic; Branka,18,0,25,7
1683365252069,ANSC 120,A00,258402,Bialecki; Jon Anthony,27,0,40,13
1683365253096,ANSC 144,A00,258400,Staff,14,0,40,26
1683365255151,ANSC 166,A00,258396,Parish; Steven Martin,157,0,175,18
1683365256176,ANSC 180,A00,193533,Staff,9,0,20,11
1683365257198,ANSC 188,A00,258397,Jassal; Aftab,33,0,40,7
1683365258222,ANTH 3,A01,258316,Staff,23,0,30,7
1683365259247,ANTH 5,A00,258394,Semendeferi; Ekaterini,16,0,20,4
1683365260271,ANTH 21,A01,258331,Staff,8,0,40,32
1683365261299,ANTH 103,A00,258398,Varma; Saiba,15,0,25,10
1683365262327,AWP 10,001,202034,Staff,0,0,0,0
1683365262327,AWP 10,002,202035,Staff,0,0,0,0
1683365262327,AWP 10,003,202036,Staff,0,0,0,0
1683365262327,AWP 10,004,202037,Staff,0,0,0,0
1683365262327,AWP 10,005,202038,Staff,0,0,0,0
1683365262327,AWP 10,006,202039,Staff,0,0,0,0
1683365262327,AWP 10,007,202040,Staff,0,0,0,0
1683365262327,AWP 10,008,202041,Staff,0,0,0,0
1683365262327,AWP 10,009,202042,Staff,0,0,0,0
1683365262327,AWP 10,010,202043,Staff,0,0,0,0
1683365262327,AWP 10,011,202044,Staff,0,0,0,0
1683365262327,AWP 10,012,202045,Staff,0,0,0,0
1683365262327,AWP 10,013,202046,Staff,0,0,0,0
1683365262327,AWP 10,014,202047,Staff,0,0,0,0
1683365262327,AWP 10,015,202048,Staff,0,0,0,0
1683365262327,AWP 10,016,202049,Staff,0,0,0,0
1683365262327,AWP 10,017,202050,Staff,0,0,0,0
1683365262327,AWP 10,018,202051,Staff,0,0,0,0
1683365262327,AWP 10,019,202052,Staff,0,0,0,0
1683365262327,AWP 10,020,202053,Staff,0,0,0,0
1683365262327,AWP 10,021,202054,Staff,0,0,0,0
1683365262327,AWP 10,022,202055,Staff,0,0,0,0
1683365262327,AWP 10,023,202056,Staff,0,0,0,0
1683365262327,AWP 10,024,202057,Staff,0,0,0,0
1683365262327,AWP 10,025,202058,Staff,0,0,0,0
1683365262327,AWP 10,026,202059,Staff,0,0,0,0
1683365263351,AWP 102,001,202032,Staff,0,0,0,0
1683365263351,AWP 102,002,202033,Staff,0,0,0,0
1683365264379,BENG 100,A01,254234,Taylor Amos; Alyssa C,31,0,40,9
1683365265404,BENG 196,001,270013,Engler; Adam J.,9999,0,9999,0
1683365266427,BICD 100R,A01,202018,Smith; Laurie,0,7,32,32
1683365266427,BICD 100R,A02,202019,Smith; Laurie,0,2,32,32
1683365266427,BICD 100R,A03,202020,Smith; Laurie,0,1,32,32
1683365266427,BICD 100R,A04,202021,Smith; Laurie,9,0,32,23
1683365266427,BICD 100R,A05,202022,Smith; Laurie,12,0,32,20
1683365267453,BICD 136,A01,193242,Gustafson-Brown; Cindy,0,2,32,32
1683365267453,BICD 136,A02,193244,Gustafson-Brown; Cindy,14,0,32,18
1683365268479,BIEB 102,A01,193249,Butler; Shannon Rhey,0,2,32,32
1683365268479,BIEB 102,A02,193251,Butler; Shannon Rhey,0,0,32,32
1683365268479,BIEB 102,A03,193253,Butler; Shannon Rhey,0,1,32,32
1683365268479,BIEB 102,A04,193255,Butler; Shannon Rhey,17,0,32,15
1683365268479,BIEB 102,A05,193265,Butler; Shannon Rhey,26,0,32,6
1683365268479,BIEB 102,A06,193269,Butler; Shannon Rhey,16,0,32,16
1683365270531,BIEB 150,A01,193274,Staff,0,0,32,32
1683365270531,BIEB 150,A02,193285,Staff,23,0,32,9
1683365271555,BIEB 194,A00,193286,Kurle; Carolyn M.,22,0,32,10
1683365272582,BILD 1,A01,192291,Staff,16,0,32,16
1683365272582,BILD 1,A02,192292,Staff,30,0,32,2
1683365272582,BILD 1,B01,192520,Reuther; Keefe,0,1,0,0
1683365272582,BILD 1,B02,192532,Reuther; Keefe,0,1,0,0
1683365273612,BILD 3,A01,192556,Butler; Shannon Rhey,0,0,32,32
1683365273612,BILD 3,A02,192581,Butler; Shannon Rhey,4,0,32,28
1683365273612,BILD 3,A03,192611,Butler; Shannon Rhey,23,0,32,9
1683365273612,BILD 3,A04,192612,Butler; Shannon Rhey,25,0,32,7
1683365273612,BILD 3,A05,192613,Butler; Shannon Rhey,27,0,32,5
1683365273612,BILD 3,A06,192679,Butler; Shannon Rhey,27,0,32,5
1683365273612,BILD 3,A07,192682,Butler; Shannon Rhey,21,0,32,11
1683365274642,BILD 4,A01,192836,Reuther; Keefe,0,0,24,24
1683365274642,BILD 4,A02,193044,Reuther; Keefe,4,0,24,20
1683365275671,BILD 10,A01,193142,Gustafson-Brown; Cindy,30,0,32,2
1683365275671,BILD 10,A02,193149,Gustafson-Brown; Cindy,31,0,32,1
1683365276700,BIMM 100,A01,193301,Staff,1,6,32,31
1683365276700,BIMM 100,A02,193312,Staff,0,5,32,32
1683365276700,BIMM 100,A03,193323,Staff,0,8,32,32
1683365277730,BIMM 101,A01,193329,McDonnell; Lisa Marie,0,3,24,24
1683365277730,BIMM 101,A02,193339,McDonnell; Lisa Marie,0,3,24,24
1683365277730,BIMM 101,B01,193354,McDonnell; Lisa Marie,0,3,24,24
1683365277730,BIMM 101,B02,193357,McDonnell; Lisa Marie,0,3,24,24
1683365278757,BIMM 110,A01,193377,Tat; John,0,11,32,32
1683365278757,BIMM 110,A02,193378,Tat; John,0,9,32,32
1683365279782,BIMM 120,A01,206116,Staff,0,0,32,32
1683365279782,BIMM 120,A02,206117,Staff,8,0,32,24
1683365279782,BIMM 120,A03,206121,Staff,21,0,32,11
1683365280807,BIPN 100,A01,193393,Park; Ji Young,0,14,32,32
1683365280807,BIPN 100,A02,193402,Park; Ji Young,0,13,32,32
1683365280807,BIPN 100,A03,193413,Park; Ji Young,0,14,32,32
1683365280807,BIPN 100,A04,193414,Park; Ji Young,0,13,32,32
1683365281846,BIPN 102,A01,193429,Staff,0,0,32,32
1683365281846,BIPN 102,A02,193438,Staff,22,0,32,10
1683365282873,BIPN 106,A01,193450,Reyes Gonzalez; Catalina,0,2,40,40
1683365283902,BIPN 134,A01,193465,Cooke; James Edward,1,0,32,31
1683365283902,BIPN 134,A02,193474,Cooke; James Edward,25,0,32,7
1683365283902,BIPN 134,A03,193485,Cooke; James Edward,29,0,32,3
1683365283902,BIPN 134,A04,193486,Cooke; James Edward,21,0,32,11
1683365283902,BIPN 134,A05,193491,Cooke; James Edward,31,0,32,1
1683365283902,BIPN 134,A06,193501,Cooke; James Edward,30,0,32,2
1683365283902,BIPN 134,A07,193510,Cooke; James Edward,29,0,32,3
1683365285952,BISP 194,A00,222522,Staff,14,0,32,18
1683365286979,CAT 124,A01,202407,Staff,19,0,25,6
1683365288007,CAT 125,A00,202408,Marchisotto; Jennifer Anne,4,0,20,16
1683365289037,CAT 125R,A00,202409,Smith; Lauryn Alissa,0,11,20,20
1683365289037,CAT 125R,B00,202410,Morales; Celeste Georgianna,0,11,20,20
1683365289037,CAT 125R,C00,202411,Irwin; Matthew Joseph,0,10,20,20
1683365290064,CENG 15,A01,204712,Yang; Kesong,0,1,0,0
1683365291092,CENG 114,A00,202070,Jahed Motlagh; Zeinab,5,0,20,15
1683365292119,CGS 105,A00,185477,Wesling; Megan E.,24,0,40,16
1683365293145,CGS 106,A00,185494,Staff,13,0,22,9
1683365294169,CGS 108,A00,185495,Staff,14,0,20,6
1683365295194,CGS 114,A00,185496,Staff,13,0,18,5
1683365296217,CGS 119,A00,185501,Staff,15,0,20,5
1683365297240,CGS 120,A00,185511,Staff,13,0,20,7
1683365298265,CHEM 4,A01,184675,Bussey; Thomas J,96,0,100,4
1683365299295,CHEM 6A,A01,184677,Staff,34,0,60,26
1683365300321,CHEM 6B,A01,184679,Staff,65,0,100,35
1683365301351,CHEM 6C,A01,184681,Bussey; Thomas J,1,0,50,49
1683365301351,CHEM 6C,A02,184682,Bussey; Thomas J,34,0,50,16
1683365302377,CHEM 40A,A01,184684,Albizati; Kim F.,37,0,100,63
1683365303401,CHEM 40B,A01,184686,Albizati; Kim F.,0,20,100,100
1683365304426,CHEM 41B,A01,184690,Staff,52,0,100,48
1683365305449,COGS 3,A01,184715,Boyle; Mary E. T.,0,25,40,40
1683365306474,COGS 14B,A01,185172,Staff,0,15,38,38
1683365307502,COGS 18,A01,184736,Staff,16,0,80,64
1683365308530,COGS 100,A01,184932,Staff,0,5,73,73
1683365309557,COGS 101A,A01,184935,Staff,0,39,30,30
1683365310592,COGS 101B,A01,184944,Staff,0,2,30,30
1683365311622,COGS 101C,A01,184946,Staff,0,12,30,30
1683365312650,COGS 102A,A01,184951,Johnson; Christine M.,2,0,40,38
1683365313678,COGS 107B,A01,184953,Mooshagian; Eric Frederick,0,50,40,40
1683365314703,COGS 118B,A01,184959,Gupta; Anjum,0,48,40,40
1683365315730,COGS 153,A00,184961,Staff,0,15,30,30
1683365316756,COGS 177,A00,184962,Staff,0,20,30,30
1683365317781,COGS 187A,A01,184969,Boyle; Mary E. T.,0,17,40,40
1683365318806,COMM 10,A01,185174,Staff,0,5,25,25
1683365318806,COMM 10,A02,185189,Staff,0,5,25,25
1683365318806,COMM 10,A03,269821,Staff,0,0,0,0
1683365319831,COMM 100B,A01,185475,Staff,0,0,0,2
1683365319831,COMM 100B,A02,185476,Staff,13,0,25,12
1683365320855,COMM 100C,A01,185314,Staff,1,0,25,24
1683365320855,COMM 100C,A02,185327,Staff,19,0,25,6
1683365321880,COMM 110M,A00,185349,Staff,2,0,40,38
1683365322904,COMM 113T,A00,185352,Staff,24,0,40,16
1683365323930,COMM 114I,A00,185353,Staff,33,0,40,7
1683365324957,COMM 131,A00,185354,Staff,19,0,30,11
1683365325982,CSE 8A,A50,185358,Cao; Yingjun,0,46,10,10
1683365327010,CSE 8B,A01,185362,Staff,0,46,50,50
1683365328038,CSE 11,A01,185416,Cao; Yingjun,0,92,10,10
1683365329065,CSE 20,A01,185445,Briones; Jor-el Thomas Caparas,5,0,25,20
1683365330093,CSE 21,A01,185447,Staff,10,0,50,40
1683365331177,CSE 101,A01,185451,Staff,0,13,50,50
1683365331177,CSE 101,B01,185453,Jones; Miles E,0,11,50,50
1683365333251,CSE 141,A01,185458,Eldon; John,20,0,100,80
1683365334279,CSE 141L,A01,185461,Eldon; John,12,0,100,88
1683365335305,CSE 142,A01,185463,Staff,36,0,60,24
1683365335305,CSE 142,B01,201355,Staff,0,7,60,60
1683365336331,CSE 142L,A01,185470,Staff,36,0,60,24
1683365336331,CSE 142L,B01,201417,Staff,0,6,60,60
1683365337355,CSE 190,A00,201433,Staff,32,0,49,17
1683365338380,DOC 1,A01,259136,Strom; Megan C.,7,0,15,8
1683365338380,DOC 1,A02,259137,Strom; Megan C.,14,0,15,1
1683365338380,DOC 1,A03,259138,Strom; Megan C.,14,0,15,1
1683365338380,DOC 1,A04,259139,Strom; Megan C.,14,0,15,1
1683365339405,DOC 100D,A00,259140,Pass; Natalye Joann,16,0,25,9
1683365340434,DSGN 1,A01,184749,Rill; Bryan,0,25,30,30
1683365341462,DSGN 100,A01,185168,Staff,0,2,25,25
1683365342491,ECE 5,A01,185626,Morris; Karcher William,0,10,0,0
1683365343519,ECE 101,A01,185628,Staff,17,0,70,53
1683365344544,ECE 107,A01,185635,Baghdadchi; Saharnaz,0,0,20,20
1683365344544,ECE 107,A02,185638,Baghdadchi; Saharnaz,4,0,20,16
1683365345569,ECE 148,A01,185647,Silberman; Jack,0,0,16,16
1683365346593,ECON 1,A01,185537,Crane; Meredith Helen,54,0,70,16
1683365347619,ECON 3,A01,185549,Crane; Meredith Helen,32,0,70,38
1683365348643,ECON 4,A01,203354,Anderson; John Charles,0,4,10,10
1683365349666,ECON 100A,A01,185574,Staff,0,4,40,40
1683365350691,ECON 100B,A01,185576,Staff,0,12,50,50
1683365351715,ECON 100C,A01,185589,Newhouse; Herbert S,29,0,70,41
1683365352742,ECON 105,A00,185608,Vespa; Emanuel Ignacio,19,0,35,16
1683365353770,ECON 109,A01,185610,Shishkin; Denis,10,0,35,25
1683365354798,ECON 110A,A01,185612,Staff,11,0,40,29
1683365355826,ECON 120A,A01,185615,Staff,20,0,40,20
1683365356851,ECON 120C,A01,185617,Sun; Yixiao,0,21,70,70
1683365357878,ECON 144,A00,203346,Squires; Dale E,3,0,35,32
1683365358902,ECON 171,A01,203349,Newhouse; Herbert S,0,1,35,35
1683365359926,ECON 173A,A01,185621,Toda; Alexis Akira,21,0,35,14
1683365360952,EDS 25,A01,202413,Staff,0,1,0,0
1683365360952,EDS 25,A02,202414,Staff,0,1,0,0
1683365360952,EDS 25,A03,202415,Staff,0,0,0,0
1683365360952,EDS 25,A04,202416,Staff,0,1,0,0
1683365360952,EDS 25,A05,202439,Staff,0,0,0,0
1683365360952,EDS 25,A06,202440,Staff,0,0,0,0
1683365360952,EDS 25,B01,202631,Staff,0,0,0,0
1683365360952,EDS 25,B02,202632,Staff,0,0,0,0
1683365360952,EDS 25,B03,202639,Staff,0,0,0,0
1683365360952,EDS 25,B04,202640,Staff,0,0,0,0
1683365360952,EDS 25,B05,202643,Staff,0,0,0,0
1683365360952,EDS 25,B06,202644,Staff,0,0,0,0
1683365361978,EDS 38,A01,202659,Black; Alison Michelle,24,0,25,1
1683365363007,EDS 115,A00,202652,Staff,18,0,30,12
1683365364033,EDS 125,A00,202649,Staff,14,0,30,16
1683365365060,EDS 126,A01,203332,Staff,30,0,30,0
1683365366088,EDS 139,A00,202838,Staff,16,0,25,9
1683365367112,EDS 146,A01,202655,Staff,14,0,25,11
1683365368135,ENG 15,A00,185667,Staff,0,1,0,0
1683365368135,ENG 15,B00,185672,Staff,0,0,0,0
1683365368135,ENG 15,C00,185675,Staff,0,0,0,0
1683365368135,ENG 15,D00,185682,Staff,0,0,0,0
1683365368135,ENG 15,E00,185684,Staff,0,0,0,0
1683365369160,ETHN 103,A00,185710,Staff,0,4,35,35
1683365370184,ETHN 103A,A00,199228,Man; Simeon S,2,0,9,7
1683365371206,ETHN 109,A00,185711,Staff,18,0,35,17
1683365372230,ETHN 142,A00,185726,Staff,0,4,30,30
1683365373255,ETHN 163J,A00,199229,Man; Simeon S,5,0,8,3
1683365374278,ETHN 168,A00,185727,Staff,8,0,10,2
1683365375302,ETHN 182,A00,185728,Staff,0,0,35,35
1683365376328,ETHN 183,A00,185737,Staff,8,0,18,10
1683365377354,GLBH 111,A01,209361,Burgos; Jose L.,0,0,0,0
1683365379411,HIEU 104,A00,185792,Staff,16,0,20,4
1683365380435,HIEU 115,A00,185800,Staff,1,0,20,19
1683365381458,HIEU 128,A00,185801,Staff,0,7,20,20
1683365382482,HIEU 147,A00,185802,Staff,16,0,20,4
1683365383507,HIEU 154,A00,185823,Staff,12,0,20,8
1683365384533,HILA 102,A00,185826,Staff,13,0,20,7
1683365385561,HILD 2C,A01,185778,Staff,0,12,20,20
1683365386590,HILD 7B,A01,185780,Kwak; Nancy,0,15,32,32
1683365386590,HILD 7B,A02,185781,Kwak; Nancy,0,18,32,32
1683365387617,HILD 30,A01,185791,Staff,14,0,20,6
1683365388645,HISC 119,A00,185830,Golan; Tal,0,9,20,20
1683365389670,HITO 156GS,A00,185831,Patterson; Patrick H.,0,0,0,23
1683365390694,HIUS 103,A00,185832,Man; Simeon S,1,6,20,19
1683365391722,HIUS 117,A00,185836,Kwak; Nancy,2,0,20,18
1683365392746,HIUS 125,A00,185840,Man; Simeon S,0,0,23,23
1683365393770,HIUS 149,A00,185845,Staff,0,0,20,20
1683365394794,HUM 3,A01,185882,Zavodny; Tatiana Sophia,0,7,50,50
1683365394794,HUM 3,B01,185899,Caldwell; Michael Alan,0,18,50,50
1683365395818,HUM 3GS,A00,185900,Patterson; Patrick H.,0,0,0,23
1683365396842,HUM 4,A01,185938,Zroka; Amy Liane,31,0,50,19
1683365396842,HUM 4,B01,185956,Watkins; Eric,0,3,50,50
1683365396842,HUM 4,B02,202209,Watkins; Eric,0,2,50,50
1683365396842,HUM 4,B03,202210,Watkins; Eric,0,2,50,50
1683365397867,HUM 5,A01,185958,West; Geoffrey Scott,3,0,50,47
1683365397867,HUM 5,A02,202215,West; Geoffrey Scott,0,0,50,50
1683365398891,INTL 190,A00,185959,Gagnon; Jeffrey C,0,0,0,9
1683365398891,INTL 190,B00,185960,Lettieri; Michael Joseph,0,0,0,1
1683365399917,JAPN 180,A00,254509,Staff,4,0,30,26
1683365400945,LATI 10,A01,202853,Kennemore; Amy Michelle,4,0,35,31
1683365400945,LATI 10,A02,202854,Kennemore; Amy Michelle,2,0,35,33
1683365400945,LATI 10,A03,270054,Kennemore; Amy Michelle,30,0,30,0
1683365401973,LATI 180,A00,202855,Kennemore; Amy Michelle,11,0,20,9
1683365403001,LAWS 101,A00,201767,Golan; Tal,0,7,40,40
1683365404025,LIFR 1C,A00,185961,Staff,6,0,20,14
1683365405049,LIFR 1CX,A00,185962,Staff,7,0,20,13
1683365406072,LIFR 1D,A00,185963,Staff,9,0,20,11
1683365407097,LIFR 1DX,A00,185964,Staff,9,0,20,11
1683365408125,LIGN 101,A01,186039,Staff,43,0,50,7
1683365409153,LIGN 165,A00,186040,Staff,18,0,50,32
1683365410183,LTCS 108,A00,186041,Staff,6,0,10,4
1683365411207,LTCS 119,A00,186042,Staff,16,0,20,4
1683365412232,LTCS 130,A00,186043,Wesling; Megan E.,15,0,25,10
1683365414281,LTEA 138,A00,186119,Staff,14,0,40,26
1683365415305,LTEN 124,A00,186148,Staff,6,0,25,19
1683365416332,LTEN 178,A00,186149,Staff,7,0,15,8
1683365417358,LTEN 181,A00,186150,Blanco; John D,33,0,40,7
1683365418385,LTWL 120,A00,186160,Staff,20,0,25,5
1683365419411,LTWL 165,A00,186161,Staff,22,0,25,3
1683365420435,LTWR 100,A00,186162,Staff,0,5,15,15
1683365421463,LTWR 102,A00,186163,Doller; Ben,5,0,15,10
1683365422488,MAE 8,A01,186412,Staff,0,0,0,0
1683365423514,MAE 30B,A00,186445,Bahadori; Mohammad Yousef,83,0,100,17
1683365424544,MAE 40,A00,186592,Bewley; Thomas R,10,0,50,40
1683365425573,MAE 101B,A00,186593,Bahadori; Mohammad Yousef,81,0,100,19
1683365426603,MAE 105,A00,186594,Bandaru; Prabhakar,12,0,50,38
1683365427628,MAE 107,A00,186599,Pham; Hieu Tan,0,7,120,120
1683365428653,MAE 148,A01,186660,Silberman; Jack,3,0,16,13
1683365429679,MATH 10A,A01,188095,Staff,0,5,35,35
1683365430704,MATH 10B,A01,188097,Bowers; Adam R.,0,11,30,30
1683365430704,MATH 10B,A02,188099,Bowers; Adam R.,0,11,30,30
1683365430704,MATH 10B,B01,188104,Bowers; Adam R.,0,10,30,30
1683365430704,MATH 10B,B02,188106,Bowers; Adam R.,0,10,30,30
1683365431738,MATH 10C,A01,188111,Staff,0,18,30,30
1683365431738,MATH 10C,A02,188127,Staff,0,17,30,30
1683365431738,MATH 10C,A03,188131,Staff,0,18,30,30
1683365431738,MATH 10C,B01,188218,Staff,18,0,30,12
1683365431738,MATH 10C,B02,188244,Staff,13,0,30,17
1683365431738,MATH 10C,B03,188277,Staff,16,0,30,14
1683365432764,MATH 18,A01,188344,Bach; Quang Tran,18,0,30,12
1683365432764,MATH 18,A02,188345,Bach; Quang Tran,11,0,30,19
1683365432764,MATH 18,B01,188353,Bach; Quang Tran,10,0,30,20
1683365432764,MATH 18,B02,188354,Bach; Quang Tran,20,0,30,10
1683365433789,MATH 20A,A01,188374,Staff,12,0,35,23
1683365434874,MATH 20B,A01,188382,Ohm; Ko Woon,6,0,30,24
1683365434874,MATH 20B,A02,188383,Ohm; Ko Woon,21,0,30,9
1683365434874,MATH 20B,B01,188385,Ohm; Ko Woon,7,0,30,23
1683365434874,MATH 20B,B02,188392,Ohm; Ko Woon,22,0,30,8
1683365435898,MATH 20C,A01,188394,Harel; Guershon,10,0,30,20
1683365435898,MATH 20C,A02,188395,Harel; Guershon,15,0,30,15
1683365435898,MATH 20C,B01,188404,Harel; Guershon,4,0,30,26
1683365435898,MATH 20C,B02,188405,Harel; Guershon,19,0,30,11
1683365436924,MATH 20D,A01,188414,Hammock; Frances H,0,1,30,30
1683365436924,MATH 20D,A02,188415,Hammock; Frances H,3,0,30,27
1683365436924,MATH 20D,B01,188447,Hammock; Frances H,1,0,30,29
1683365436924,MATH 20D,B02,188486,Hammock; Frances H,8,0,30,22
1683365437948,MATH 20E,A01,188649,Staff,21,0,30,9
1683365437948,MATH 20E,A02,188650,Staff,23,0,30,7
1683365437948,MATH 20E,A03,188673,Staff,0,0,30,30
1683365438971,MATH 102,A01,188675,Staff,0,35,35,35
1683365439995,MATH 103B,A01,188681,Staff,3,0,35,32
1683365439995,MATH 103B,B01,188692,Staff,5,0,35,30
1683365441020,MATH 109,A01,188695,Salehi Golsefidy; Alireza,25,0,35,10
1683365441020,MATH 109,A02,188696,Salehi Golsefidy; Alireza,25,0,35,10
1683365442046,MATH 120A,A01,188698,Eggers; John Dietrich,7,0,35,28
1683365443071,MATH 142B,A01,188736,Ioana; Adrian,0,2,30,30
1683365443071,MATH 142B,A02,188741,Ioana; Adrian,0,0,30,30
1683365443071,MATH 142B,A03,188743,Ioana; Adrian,0,1,30,30
1683365444100,MATH 168A,A01,188790,Staff,0,9,35,35
1683365445123,MATH 170A,A01,188803,Nie; Jiawang,0,2,35,35
1683365445123,MATH 170A,A02,188811,Nie; Jiawang,0,0,35,35
1683365445123,MATH 170A,A03,188814,Nie; Jiawang,1,0,35,34
1683365445123,MATH 170A,A04,188815,Nie; Jiawang,13,0,35,22
1683365446147,MATH 193B,A01,188817,Staff,0,0,35,35
1683365446147,MATH 193B,A02,188818,Staff,5,0,35,30
1683365447184,MGT 4,A01,202857,Anderson; John Charles,61,0,80,19
1683365448208,MGT 12,A00,202858,Lindenberger; Wade Douglas,42,0,90,48
1683365449232,MGT 18,A00,202859,Staff,74,0,90,16
1683365450260,MGT 18GS,A00,202860,McKay; Michael J,13,0,28,15
1683365451284,MGT 45,A00,202861,Pecore; Joseph P.,15,0,90,75
1683365452316,MGT 100,A00,202863,Yavorsky; Daniel Ryan,28,0,90,62
1683365453342,MGT 103,A00,202864,Ehrich; Kristine R,0,17,90,90
1683365454365,MGT 112,A00,202865,Ehrich; Kristine R,15,0,90,75
1683365455390,MGT 121A,A00,202868,Staff,0,20,0,0
1683365456415,MGT 131B,A00,202869,Anderson; John Charles,59,0,90,31
1683365457439,MGT 136,A00,202871,Lindenberger; Wade Douglas,84,0,90,6
1683365458464,MGT 164,A00,202873,Staff,0,68,90,91
1683365459490,MGT 164GS,A00,202874,McKay; Mary A,13,0,28,15
1683365460513,MGT 180,A00,202875,Staff,0,50,90,91
1683365461539,MMW 11R,A01,205019,Herbst; Matthew,3,0,30,27
1683365461539,MMW 11R,A02,205026,Herbst; Matthew,29,0,30,1
1683365462577,MMW 15,A01,193512,Chang; Edmond Yi-Teh,0,9,28,28
1683365462577,MMW 15,A02,193513,Chang; Edmond Yi-Teh,0,5,28,28
1683365462577,MMW 15,A03,193514,Chang; Edmond Yi-Teh,0,5,28,28
1683365462577,MMW 15,A04,193515,Chang; Edmond Yi-Teh,0,5,28,28
1683365462577,MMW 15,A05,193516,Chang; Edmond Yi-Teh,0,4,28,28
1683365462577,MMW 15,A06,193517,Chang; Edmond Yi-Teh,0,5,28,28
1683365462577,MMW 15,B01,193519,Chang; Edmond Yi-Teh,0,5,28,28
1683365462577,MMW 15,B02,193520,Chang; Edmond Yi-Teh,0,5,28,28
1683365462577,MMW 15,B03,193521,Chang; Edmond Yi-Teh,0,5,28,28
1683365462577,MMW 15,B04,193522,Chang; Edmond Yi-Teh,0,4,28,28
1683365462577,MMW 15,B05,193523,Chang; Edmond Yi-Teh,0,5,28,28
1683365462577,MMW 15,B06,193524,Chang; Edmond Yi-Teh,0,4,28,28
1683365463606,MMW 122,A01,193526,Rahimi; Babak,0,15,28,28
1683365463606,MMW 122,A02,193527,Rahimi; Babak,0,14,28,28
1683365463606,MMW 122,A03,193528,Rahimi; Babak,0,0,0,0
1683365463606,MMW 122,A04,193529,Rahimi; Babak,0,0,0,0
1683365464635,MUS 1A,A01,186663,Staff,0,20,35,35
1683365465661,MUS 4,A01,186715,Staff,0,12,35,35
1683365466690,MUS 5R,A01,186796,Dubnov; Shlomo,0,17,35,35
1683365467715,MUS 6,A01,186798,Staff,0,4,25,25
1683365468742,MUS 7,A01,186830,Staff,13,0,35,22
1683365469769,MUS 8,A01,186930,Staff,0,26,35,35
1683365470794,MUS 15,A01,186932,Staff,0,16,35,35
1683365470794,MUS 15,B01,186934,Staff,0,15,35,35
1683365471825,MUS 80,A00,186935,Staff,0,0,20,20
1683365471825,MUS 80,B00,186936,Staff,25,0,25,0
1683365472851,NANO 11,A00,204702,Lipomi; Darren John,0,0,0,0
1683365473877,NANO 15,A01,204709,Yang; Kesong,0,1,0,0
1683365474903,NANO 114,A00,202069,Jahed Motlagh; Zeinab,3,0,10,7
1683365475930,PHIL 1,A00,186955,Grush; Rick Scott,32,0,40,8
1683365476956,PHIL 10,A01,186973,Grush; Rick Scott,28,0,35,7
1683365476956,PHIL 10,A02,186974,Grush; Rick Scott,33,0,35,2
1683365477982,PHIL 13,A01,186976,Staff,7,0,35,28
1683365477982,PHIL 13,A02,186977,Staff,16,0,35,19
1683365479006,PHIL 14,A01,186979,Staff,31,0,35,4
1683365479006,PHIL 14,A02,186986,Staff,32,0,35,3
1683365480030,PHIL 28,A01,186988,Staff,16,0,30,14
1683365480030,PHIL 28,A02,186989,Staff,1,0,30,29
1683365480030,PHIL 28,A03,186990,Staff,9,0,30,21
1683365480030,PHIL 28,A04,186991,Staff,26,0,30,4
1683365481056,PHIL 120,A00,186997,Staff,23,0,40,17
1683365482082,PHIL 137,A00,187003,Staff,9,0,40,31
1683365483110,PHIL 150,A00,187015,Staff,47,0,70,23
1683365484139,PHIL 167,A00,187021,Lamey; Andy M.,35,0,40,5
1683365485165,PHIL 174,A01,202226,Staff,17,0,20,3
1683365485165,PHIL 174,A02,202235,Staff,20,0,20,0
1683365486189,PHIL 191A,A00,258918,Staff,0,0,1,1
1683365487217,PHYS 1A,A00,187028,Staff,27,0,60,33
1683365488244,PHYS 1AL,001,187036,Staff,2,0,30,28
1683365488244,PHYS 1AL,002,187049,Staff,18,0,30,12
1683365489269,PHYS 1B,A00,187058,Staff,22,0,60,38
1683365490293,PHYS 1BL,001,187064,Staff,0,0,30,30
1683365490293,PHYS 1BL,002,187070,Staff,5,0,30,25
1683365491320,PHYS 1C,A00,187082,Staff,31,0,120,89
1683365492349,PHYS 1CL,001,187088,Staff,0,9,30,30
1683365492349,PHYS 1CL,002,187089,Staff,0,2,30,30
1683365492349,PHYS 1CL,009,262693,Staff,11,0,30,19
1683365493373,PHYS 2B,A01,187097,Staff,54,0,115,61
1683365494401,PHYS 2C,A01,187099,Staff,67,0,115,48
1683365495426,PHYS 2CL,A01,187101,Staff,5,0,28,23
1683365495426,PHYS 2CL,A02,187102,Staff,15,0,28,13
1683365496452,PHYS 2D,A01,187123,Shotwell; Brian,95,0,115,20
1683365497478,PHYS 4B,A01,187133,Grinstein; Benjamin,35,0,50,15
1683365498504,POLI 10,A00,188819,Staff,0,4,50,50
1683365499531,POLI 11,A00,188827,Staff,43,0,50,7
1683365500557,POLI 13R,A00,188828,Staff,0,1,20,20
1683365501586,POLI 27,A01,188830,Elgin; Samuel Zincke,0,1,70,70
1683365502611,POLI 30,A00,188832,Desposato; Scott,31,0,50,19
1683365503636,POLI 102F,A00,188834,Staff,3,0,40,37
1683365504659,POLI 104A,A00,188852,Staff,14,0,30,16
1683365505682,POLI 104I,A00,188853,Staff,0,6,20,20
1683365506711,POLI 110B,A00,188854,Wiens; David,7,0,20,13
1683365507735,POLI 112A,A00,188855,Wiens; David,5,0,30,25
1683365508762,POLI 117R,A00,188856,Forman; Fonna,0,11,20,20
1683365509787,POLI 118,A00,188857,Ingham; Sean,8,0,20,12
1683365510814,POLI 120G,A00,188858,Staff,9,0,30,21
1683365511839,POLI 131CR,A00,188863,Hoston; Germaine,23,0,50,27
1683365512864,POLI 133,A00,188864,Nellis; Gareth Hb,44,0,50,6
1683365513898,POLI 134D,A00,188865,Desposato; Scott,27,0,30,3
1683365514925,POLI 142A,A00,188871,Gartzke; Erik,22,0,50,28
1683365515951,POLI 142K,A00,188874,Staff,38,0,50,12
1683365516979,POLI 143,A00,188940,Gartzke; Erik,16,0,30,14
1683365518007,POLI 153,A00,188943,Staff,3,0,20,17
1683365519032,POLI 160AA,A00,188944,Staff,11,0,40,29
1683365520059,POLI 170A,A00,188945,Staff,11,0,30,19
1683365522114,PSYC 1,A00,188952,Staff,37,0,90,53
1683365523138,PSYC 2,B00,188953,Staff,19,0,35,16
1683365524163,PSYC 6,A00,188970,Staff,47,0,60,13
1683365525186,PSYC 7,A00,188973,Staff,37,0,45,8
1683365526212,PSYC 60,A01,188980,Rickard; Timothy C.,43,0,60,17
1683365527237,PSYC 70,A01,189001,Steiner; Eric Tomas,23,0,45,22
1683365528263,PSYC 100,A00,189005,Lacefield; Katharine I,0,98,120,120
1683365529288,PSYC 102,A00,189008,Staff,9,0,30,21
1683365530317,PSYC 106,B00,189026,Gorman; Michael R.,34,0,60,26
1683365531342,PSYC 114,B01,189033,Winkielman; Piotr,0,32,30,30
1683365532370,PSYC 131,A00,189036,Anagnostaras; Stephan,0,43,60,60
1683365533393,PSYC 136,A00,189041,Lowe; Angela Beth,0,7,25,25
1683365534419,PSYC 137,A00,189057,Winkielman; Piotr,0,34,25,25
1683365535447,PSYC 144,A00,189107,Wixted; John T,0,7,50,50
1683365537503,PSYC 162,A00,189142,Staff,0,8,85,85
1683365538588,PSYC 172,A00,189144,Gorman; Michael R.,0,7,30,30
1683365540639,PSYC 179,A00,189146,Lacefield; Katharine I,0,84,120,120
1683365541666,PSYC 181,A00,189147,Anagnostaras; Stephan,0,44,90,90
1683365542693,PSYC 190R,A00,189148,Barner; David A.,0,22,80,80
1683365543722,PSYC 191,A00,189275,Rickard; Timothy C.,0,7,25,25
1683365544750,PSYC 193,A00,189276,Chapman; Eddie Nathaniel,0,1,0,4
1683365545778,PSYC 193L,A01,189281,Lowe; Angela Beth,12,0,20,8
1683365545778,PSYC 193L,B01,189285,Staff,28,0,35,7
1683365546806,RELI 149,A00,187137,Rahimi; Babak,7,0,40,33
1683365547832,SE 9,A01,187315,Staff,0,2,18,18
1683365548856,SE 101B,A00,187409,Staff,24,0,30,6
1683365549886,SE 110B,A00,187444,Staff,10,0,40,30
1683365550910,SE 130B,A00,187449,Staff,31,0,40,9
1683365551935,SE 150A,A00,187516,Staff,9,0,20,11
1683365552964,SE 154,A00,187528,Staff,30,0,50,20
1683365553990,SIO 3,A01,258171,Staff,35,0,40,5
1683365555015,SIO 10,A00,187144,Cook; Geoffrey W,0,3,75,75
1683365556041,SIO 45,A00,187152,Cook; Geoffrey W,1,0,100,99
1683365557065,SIO 109R,A00,194486,Staff,0,3,20,20
1683365559116,SIO 187,A01,187233,Kacev; David,12,0,40,28
1683365560143,SOCI 1,A01,258656,Thorpe; Charles Robert,28,0,30,2
1683365560143,SOCI 1,A02,258658,Thorpe; Charles Robert,30,0,30,0
1683365560143,SOCI 1,A03,258661,Thorpe; Charles Robert,25,0,25,0
1683365560143,SOCI 1,A04,258666,Thorpe; Charles Robert,22,0,25,3
1683365560143,SOCI 1,A05,258897,Thorpe; Charles Robert,23,0,25,2
1683365560143,SOCI 1,A06,258898,Thorpe; Charles Robert,25,0,25,0
1683365561169,SOCI 30,A01,258903,Pardo Guerra; Juan Pablo,15,0,30,15
1683365562192,SOCI 102,A00,258904,Staff,9,0,25,16
1683365563215,SOCI 106,A00,258905,Staff,19,0,25,6
1683365564245,SOCI 111,A00,258907,Ribas Norris; Janet Vanesa,26,0,30,4
1683365565267,SOCI 121R,A00,258908,Pardo Guerra; Juan Pablo,10,0,30,20
1683365566295,SOCI 126,A01,203330,Staff,14,0,20,6
1683365567320,SOCI 131,A00,258909,Thorpe; Charles Robert,31,0,60,29
1683365568344,SOCI 135,A00,258910,Payne; Christine Anna,0,9,30,30
1683365569371,SOCI 157,A00,258911,Staff,12,0,30,18
1683365570395,SOCI 184,A00,258912,Staff,25,0,30,5
1683365571423,SOCI 188D,A00,258913,Staff,22,0,30,8
1683365572452,SYN 2,001,187529,Staff,10,0,16,6
1683365572452,SYN 2,002,201452,Staff,0,18,16,16
1683365572452,SYN 2,003,201469,Staff,3,0,16,13
1683365573479,SYN 100,A01,187531,Staff,0,9,20,20
1683365573479,SYN 100,B01,201491,Staff,0,12,20,20
1683365574507,TDAC 1,A00,189286,Walsh; Kim C.,3,0,20,17
1683365574507,TDAC 1,B00,189287,Harting; Carla Kelso,11,0,20,9
1683365575535,TDAC 101,A00,189300,Walsh; Kim C.,16,0,20,4
1683365575535,TDAC 101,B00,189301,Harting; Carla Kelso,18,0,20,2
1683365576565,TDAC 102,A00,189304,Basso; Beatrice,14,0,20,6
1683365577590,TDAC 108,A00,189305,Staff,18,0,20,2
1683365578617,TDDE 131,A00,189310,Staff,19,0,20,1
1683365578617,TDDE 131,B00,189314,Staff,19,0,20,1
1683365578617,TDDE 131,C00,189315,Staff,48,0,50,2
1683365578617,TDDE 131,D00,189316,Staff,14,0,15,1
1683365578617,TDDE 131,E00,204841,Staff,20,0,20,0
1683365579641,TDGE 10,A00,189289,Staff,30,0,50,20
1683365579641,TDGE 10,B00,189290,Havis; Allan,1,0,50,49
1683365580667,TDGE 11,A00,189291,Fulton; Julia,0,3,50,50
1683365580667,TDGE 11,B00,189292,Staff,20,0,25,5
1683365580667,TDGE 11,C00,260270,Staff,0,0,0,0
1683365581696,TDGE 25,A00,189294,Staff,3,0,20,17
1683365582718,TDGE 124,A00,189318,Fulton; Julia,0,8,50,50
1683365583746,TDGE 125,A00,189319,Staff,13,0,25,12
1683365583746,TDGE 125,B00,189320,Staff,23,0,25,2
1683365584773,TDGE 127,A00,189322,Havis; Allan,0,0,50,50
1683365585797,TDHT 101,A00,189323,Staff,18,0,25,7
1683365585797,TDHT 101,B00,189324,Staff,25,0,25,0
1683365586822,TDHT 102,A00,189325,Staff,49,0,50,1
1683365587847,TDMV 1,A00,189295,Arcidiacono; Kristin,19,0,30,11
1683365587847,TDMV 1,B00,189296,Caligagan; Maria T.,24,0,30,6
1683365588873,TDMV 2,A00,189297,Sammartano; Tonnie,28,0,30,2
1683365588873,TDMV 2,B00,189299,Arcidiacono; Kristin,24,0,30,6
1683365589903,TDMV 3,A00,204998,Rincon; Alicia,22,0,30,8
1683365590927,TDMV 120,A00,189458,Sammartano; Tonnie,28,0,30,2
1683365591950,TDMV 138,A00,189541,Jun; Grace Shin Hae,22,0,40,18
1683365592975,TDMV 142,A00,189717,Caligagan; Tony,24,0,30,6
1683365592975,TDMV 142,B00,189718,Caligagan; Maria T.,25,0,30,5
1683365594000,TMC 2,A01,187533,Staff,25,0,25,0
1683365594000,TMC 2,A02,187534,Staff,25,0,25,0
1683365595026,USP 1,A01,187536,Kwak; Nancy,0,16,25,25
1683365596054,USP 5,A01,187538,Staff,10,0,25,15
1683365597084,USP 101,A00,199253,Staff,0,4,0,0
1683365598109,USP 124,A00,187562,Boomhower; Matthew Charles,1,0,30,29
1683365599136,USP 138,A00,187582,Staff,20,0,25,5
1683365600164,USP 152,A01,187597,Staff,4,0,25,21
1683365601193,USP 153,A00,187598,Staff,19,0,25,6
1683365602217,USP 168,A00,187607,Kwak; Nancy,2,0,5,3
1683365603242,USP 173,A00,187619,Staff,4,0,25,21
1683365604267,USP 181,A00,187638,Staff,0,3,25,25
1683365605291,VIS 103,A00,187650,Cruz; Edwin Teddy,22,0,75,53
1683365606315,VIS 110D,A00,187669,Staff,12,0,22,10
1683365607339,VIS 127C,A00,187720,Shen; Kuiyi,67,0,146,79
1683365608363,VIS 149,A00,187731,Yoldas; Pinar,0,14,22,22
1683365609389,VIS 151,A01,188091,Staff,22,0,34,12
1683365609389,VIS 151,A02,188092,Staff,11,0,34,23
1683365610412,VIS 160B,A00,188093,Stalbaum; Brett,0,0,10,10
1683365612466,WCWP 10B,A00,201720,Staff,10,0,15,5
1683365612466,WCWP 10B,B00,201722,Staff,9,0,15,6
1683365613496,WCWP 100,A00,201725,Gagnon; Jeffrey C,0,0,2,2
1683365613496,WCWP 100,B00,201727,Staff,0,4,15,15
1683365616603,ANBI 133,A00,258401,Wilder; Linnea Lorene,34,0,40,6
1683365617630,ANBI 140,A00,258395,Hrvoj Mihic; Branka,18,0,25,7
1683365618659,ANSC 120,A00,258402,Bialecki; Jon Anthony,27,0,40,13
1683365619683,ANSC 144,A00,258400,Staff,14,0,40,26
1683365621735,ANSC 166,A00,258396,Parish; Steven Martin,158,0,175,17
1683365622760,ANSC 180,A00,193533,Staff,9,0,20,11
1683365623785,ANSC 188,A00,258397,Jassal; Aftab,33,0,40,7
1683365624810,ANTH 3,A01,258316,Staff,23,0,30,7
1683365625835,ANTH 5,A00,258394,Semendeferi; Ekaterini,16,0,20,4
1683365626862,ANTH 21,A01,258331,Staff,8,0,40,32
1683365627890,ANTH 103,A00,258398,Varma; Saiba,15,0,25,10
1683365628928,AWP 10,001,202034,Staff,0,0,0,0
1683365628928,AWP 10,002,202035,Staff,0,0,0,0
1683365628928,AWP 10,003,202036,Staff,0,0,0,0
1683365628928,AWP 10,004,202037,Staff,0,0,0,0
1683365628928,AWP 10,005,202038,Staff,0,0,0,0
1683365628928,AWP 10,006,202039,Staff,0,0,0,0
1683365628928,AWP 10,007,202040,Staff,0,0,0,0
1683365628928,AWP 10,008,202041,Staff,0,0,0,0
1683365628928,AWP 10,009,202042,Staff,0,0,0,0
1683365628928,AWP 10,010,202043,Staff,0,0,0,0
1683365628928,AWP 10,011,202044,Staff,0,0,0,0
1683365628928,AWP 10,012,202045,Staff,0,0,0,0
1683365628928,AWP 10,013,202046,Staff,0,0,0,0
1683365628928,AWP 10,014,202047,Staff,0,0,0,0
1683365628928,AWP 10,015,202048,Staff,0,0,0,0
1683365628928,AWP 10,016,202049,Staff,0,0,0,0
1683365628928,AWP 10,017,202050,Staff,0,0,0,0
1683365628928,AWP 10,018,202051,Staff,0,0,0,0
1683365628928,AWP 10,019,202052,Staff,0,0,0,0
1683365628928,AWP 10,020,202053,Staff,0,0,0,0
1683365628928,AWP 10,021,202054,Staff,0,0,0,0
1683365628928,AWP 10,022,202055,Staff,0,0,0,0
1683365628928,AWP 10,023,202056,Staff,0,0,0,0
1683365628928,AWP 10,024,202057,Staff,0,0,0,0
1683365628928,AWP 10,025,202058,Staff,0,0,0,0
1683365628928,AWP 10,026,202059,Staff,0,0,0,0
1683365629952,AWP 102,001,202032,Staff,0,0,0,0
1683365629952,AWP 102,002,202033,Staff,0,0,0,0
1683365630983,BENG 100,A01,254234,Taylor Amos; Alyssa C,31,0,40,9
1683365632007,BENG 196,001,270013,Engler; Adam J.,9999,0,9999,0
1683365633033,BICD 100R,A01,202018,Smith; Laurie,0,7,32,32
1683365633033,BICD 100R,A02,202019,Smith; Laurie,0,2,32,32
1683365633033,BICD 100R,A03,202020,Smith; Laurie,0,1,32,32
1683365633033,BICD 100R,A04,202021,Smith; Laurie,9,0,32,23
1683365633033,BICD 100R,A05,202022,Smith; Laurie,12,0,32,20
1683365634060,BICD 136,A01,193242,Gustafson-Brown; Cindy,0,2,32,32
1683365634060,BICD 136,A02,193244,Gustafson-Brown; Cindy,14,0,32,18
1683365635088,BIEB 102,A01,193249,Butler; Shannon Rhey,0,2,32,32
1683365635088,BIEB 102,A02,193251,Butler; Shannon Rhey,0,0,32,32
1683365635088,BIEB 102,A03,193253,Butler; Shannon Rhey,0,1,32,32
1683365635088,BIEB 102,A04,193255,Butler; Shannon Rhey,17,0,32,15
1683365635088,BIEB 102,A05,193265,Butler; Shannon Rhey,26,0,32,6
1683365635088,BIEB 102,A06,193269,Butler; Shannon Rhey,16,0,32,16
1683365637137,BIEB 150,A01,193274,Staff,0,0,32,32
1683365637137,BIEB 150,A02,193285,Staff,23,0,32,9
1683365638161,BIEB 194,A00,193286,Kurle; Carolyn M.,22,0,32,10
1683365639196,BILD 1,A01,192291,Staff,16,0,32,16
1683365639196,BILD 1,A02,192292,Staff,30,0,32,2
1683365639196,BILD 1,B01,192520,Reuther; Keefe,0,1,0,0
1683365639196,BILD 1,B02,192532,Reuther; Keefe,0,1,0,0
1683365640231,BILD 3,A01,192556,Butler; Shannon Rhey,0,0,32,32
1683365640231,BILD 3,A02,192581,Butler; Shannon Rhey,4,0,32,28
1683365640231,BILD 3,A03,192611,Butler; Shannon Rhey,23,0,32,9
1683365640231,BILD 3,A04,192612,Butler; Shannon Rhey,25,0,32,7
1683365640231,BILD 3,A05,192613,Butler; Shannon Rhey,27,0,32,5
1683365640231,BILD 3,A06,192679,Butler; Shannon Rhey,27,0,32,5
1683365640231,BILD 3,A07,192682,Butler; Shannon Rhey,21,0,32,11
1683365641265,BILD 4,A01,192836,Reuther; Keefe,0,0,24,24
1683365641265,BILD 4,A02,193044,Reuther; Keefe,4,0,24,20
1683365642346,BILD 10,A01,193142,Gustafson-Brown; Cindy,30,0,32,2
1683365642346,BILD 10,A02,193149,Gustafson-Brown; Cindy,31,0,32,1
1683365643376,BIMM 100,A01,193301,Staff,1,6,32,31
1683365643376,BIMM 100,A02,193312,Staff,0,5,32,32
1683365643376,BIMM 100,A03,193323,Staff,0,8,32,32
1683365644408,BIMM 101,A01,193329,McDonnell; Lisa Marie,0,3,24,24
1683365644408,BIMM 101,A02,193339,McDonnell; Lisa Marie,0,3,24,24
1683365644408,BIMM 101,B01,193354,McDonnell; Lisa Marie,0,3,24,24
1683365644408,BIMM 101,B02,193357,McDonnell; Lisa Marie,0,3,24,24
1683365645434,BIMM 110,A01,193377,Tat; John,0,11,32,32
1683365645434,BIMM 110,A02,193378,Tat; John,0,9,32,32
1683365646464,BIMM 120,A01,206116,Staff,0,0,32,32
1683365646464,BIMM 120,A02,206117,Staff,8,0,32,24
1683365646464,BIMM 120,A03,206121,Staff,21,0,32,11
1683365647490,BIPN 100,A01,193393,Park; Ji Young,0,14,32,32
1683365647490,BIPN 100,A02,193402,Park; Ji Young,0,13,32,32
1683365647490,BIPN 100,A03,193413,Park; Ji Young,0,14,32,32
1683365647490,BIPN 100,A04,193414,Park; Ji Young,0,13,32,32
1683365648517,BIPN 102,A01,193429,Staff,0,0,32,32
1683365648517,BIPN 102,A02,193438,Staff,22,0,32,10
1683365649543,BIPN 106,A01,193450,Reyes Gonzalez; Catalina,0,2,40,40
1683365650569,BIPN 134,A01,193465,Cooke; James Edward,1,0,32,31
1683365650569,BIPN 134,A02,193474,Cooke; James Edward,25,0,32,7
1683365650569,BIPN 134,A03,193485,Cooke; James Edward,29,0,32,3
1683365650569,BIPN 134,A04,193486,Cooke; James Edward,21,0,32,11
1683365650569,BIPN 134,A05,193491,Cooke; James Edward,31,0,32,1
1683365650569,BIPN 134,A06,193501,Cooke; James Edward,30,0,32,2
1683365650569,BIPN 134,A07,193510,Cooke; James Edward,29,0,32,3
1683365652620,BISP 194,A00,222522,Staff,14,0,32,18
1683365653649,CAT 124,A01,202407,Staff,19,0,25,6
1683365654675,CAT 125,A00,202408,Marchisotto; Jennifer Anne,4,0,20,16
1683365655707,CAT 125R,A00,202409,Smith; Lauryn Alissa,0,11,20,20
1683365655707,CAT 125R,B00,202410,Morales; Celeste Georgianna,0,11,20,20
1683365655707,CAT 125R,C00,202411,Irwin; Matthew Joseph,0,10,20,20
1683365656738,CENG 15,A01,204712,Yang; Kesong,0,1,0,0
1683365657765,CENG 114,A00,202070,Jahed Motlagh; Zeinab,5,0,20,15
1683365658796,CGS 105,A00,185477,Wesling; Megan E.,24,0,40,16
1683365659827,CGS 106,A00,185494,Staff,13,0,22,9
1683365660852,CGS 108,A00,185495,Staff,14,0,20,6
1683365661877,CGS 114,A00,185496,Staff,13,0,18,5
1683365662909,CGS 119,A00,185501,Staff,15,0,20,5
1683365663933,CGS 120,A00,185511,Staff,13,0,20,7
1683365664960,CHEM 4,A01,184675,Bussey; Thomas J,96,0,100,4
1683365665985,CHEM 6A,A01,184677,Staff,34,0,60,26
1683365667009,CHEM 6B,A01,184679,Staff,65,0,100,35
1683365668034,CHEM 6C,A01,184681,Bussey; Thomas J,1,0,50,49
1683365668034,CHEM 6C,A02,184682,Bussey; Thomas J,34,0,50,16
1683365669062,CHEM 40A,A01,184684,Albizati; Kim F.,37,0,100,63
1683365670095,CHEM 40B,A01,184686,Albizati; Kim F.,0,20,100,100
1683365671122,CHEM 41B,A01,184690,Staff,52,0,100,48
1683365672151,COGS 3,A01,184715,Boyle; Mary E. T.,0,25,40,40
1683365673176,COGS 14B,A01,185172,Staff,0,15,38,38
1683365674199,COGS 18,A01,184736,Staff,16,0,80,64
1683365675224,COGS 100,A01,184932,Staff,0,5,73,73
1683365676252,COGS 101A,A01,184935,Staff,0,39,30,30
1683365677277,COGS 101B,A01,184944,Staff,0,2,30,30
1683365678303,COGS 101C,A01,184946,Staff,0,12,30,30
1683365679331,COGS 102A,A01,184951,Johnson; Christine M.,2,0,40,38
1683365680355,COGS 107B,A01,184953,Mooshagian; Eric Frederick,0,50,40,40
1683365681386,COGS 118B,A01,184959,Gupta; Anjum,0,48,40,40
1683365682410,COGS 153,A00,184961,Staff,0,15,30,30
1683365683433,COGS 177,A00,184962,Staff,0,20,30,30
1683365684458,COGS 187A,A01,184969,Boyle; Mary E. T.,0,17,40,40
1683365685481,COMM 10,A01,185174,Staff,0,5,25,25
1683365685481,COMM 10,A02,185189,Staff,0,5,25,25
1683365685481,COMM 10,A03,269821,Staff,0,0,0,0
1683365686510,COMM 100B,A01,185475,Staff,0,0,0,2
1683365686510,COMM 100B,A02,185476,Staff,13,0,25,12
1683365687533,COMM 100C,A01,185314,Staff,1,0,25,24
1683365687533,COMM 100C,A02,185327,Staff,19,0,25,6
1683365688560,COMM 110M,A00,185349,Staff,2,0,40,38
1683365689586,COMM 113T,A00,185352,Staff,24,0,40,16
1683365690613,COMM 114I,A00,185353,Staff,33,0,40,7
1683365691645,COMM 131,A00,185354,Staff,19,0,30,11
1683365692670,CSE 8A,A50,185358,Cao; Yingjun,0,46,10,10
1683365693699,CSE 8B,A01,185362,Staff,0,46,50,50
1683365694726,CSE 11,A01,185416,Cao; Yingjun,0,92,10,10
1683365695754,CSE 20,A01,185445,Briones; Jor-el Thomas Caparas,5,0,25,20
1683365696781,CSE 21,A01,185447,Staff,10,0,50,40
1683365697808,CSE 101,A01,185451,Staff,0,13,50,50
1683365697808,CSE 101,B01,185453,Jones; Miles E,0,11,50,50
1683365699857,CSE 141,A01,185458,Eldon; John,20,0,100,80
1683365700881,CSE 141L,A01,185461,Eldon; John,12,0,100,88
1683365701910,CSE 142,A01,185463,Staff,36,0,60,24
1683365701910,CSE 142,B01,201355,Staff,0,7,60,60
1683365702935,CSE 142L,A01,185470,Staff,36,0,60,24
1683365702935,CSE 142L,B01,201417,Staff,0,6,60,60
1683365703960,CSE 190,A00,201433,Staff,32,0,49,17
1683365704990,DOC 1,A01,259136,Strom; Megan C.,7,0,15,8
1683365704990,DOC 1,A02,259137,Strom; Megan C.,14,0,15,1
1683365704990,DOC 1,A03,259138,Strom; Megan C.,14,0,15,1
1683365704990,DOC 1,A04,259139,Strom; Megan C.,14,0,15,1
1683365706017,DOC 100D,A00,259140,Pass; Natalye Joann,16,0,25,9
1683365707045,DSGN 1,A01,184749,Rill; Bryan,0,25,30,30
1683365708069,DSGN 100,A01,185168,Staff,0,2,25,25
1683365709095,ECE 5,A01,185626,Morris; Karcher William,0,10,0,0
1683365710119,ECE 101,A01,185628,Staff,17,0,70,53
1683365711145,ECE 107,A01,185635,Baghdadchi; Saharnaz,0,0,20,20
1683365711145,ECE 107,A02,185638,Baghdadchi; Saharnaz,4,0,20,16
1683365712169,ECE 148,A01,185647,Silberman; Jack,0,0,16,16
1683365713196,ECON 1,A01,185537,Crane; Meredith Helen,54,0,70,16
1683365714223,ECON 3,A01,185549,Crane; Meredith Helen,32,0,70,38
1683365715250,ECON 4,A01,203354,Anderson; John Charles,0,4,10,10
1683365716275,ECON 100A,A01,185574,Staff,0,4,40,40
1683365717300,ECON 100B,A01,185576,Staff,0,12,50,50
1683365718325,ECON 100C,A01,185589,Newhouse; Herbert S,29,0,70,41
1683365719350,ECON 105,A00,185608,Vespa; Emanuel Ignacio,19,0,35,16
1683365720374,ECON 109,A01,185610,Shishkin; Denis,10,0,35,25
1683365721399,ECON 110A,A01,185612,Staff,11,0,40,29
1683365722426,ECON 120A,A01,185615,Staff,20,0,40,20
1683365723454,ECON 120C,A01,185617,Sun; Yixiao,0,21,70,70
1683365724482,ECON 144,A00,203346,Squires; Dale E,3,0,35,32
1683365725511,ECON 171,A01,203349,Newhouse; Herbert S,0,1,35,35
1683365726537,ECON 173A,A01,185621,Toda; Alexis Akira,21,0,35,14
1683365727566,EDS 25,A01,202413,Staff,0,1,0,0
1683365727566,EDS 25,A02,202414,Staff,0,1,0,0
1683365727566,EDS 25,A03,202415,Staff,0,0,0,0
1683365727566,EDS 25,A04,202416,Staff,0,1,0,0
1683365727566,EDS 25,A05,202439,Staff,0,0,0,0
1683365727566,EDS 25,A06,202440,Staff,0,0,0,0
1683365727566,EDS 25,B01,202631,Staff,0,0,0,0
1683365727566,EDS 25,B02,202632,Staff,0,0,0,0
1683365727566,EDS 25,B03,202639,Staff,0,0,0,0
1683365727566,EDS 25,B04,202640,Staff,0,0,0,0
1683365727566,EDS 25,B05,202643,Staff,0,0,0,0
1683365727566,EDS 25,B06,202644,Staff,0,0,0,0
1683365728593,EDS 38,A01,202659,Black; Alison Michelle,24,0,25,1
1683365729618,EDS 115,A00,202652,Staff,18,0,30,12
1683365730641,EDS 125,A00,202649,Staff,14,0,30,16
1683365731666,EDS 126,A01,203332,Staff,30,0,30,0
1683365732691,EDS 139,A00,202838,Staff,16,0,25,9
1683365733715,EDS 146,A01,202655,Staff,14,0,25,11
1683365734740,ENG 15,A00,185667,Staff,0,1,0,0
1683365734740,ENG 15,B00,185672,Staff,0,0,0,0
1683365734740,ENG 15,C00,185675,Staff,0,0,0,0
1683365734740,ENG 15,D00,185682,Staff,0,0,0,0
1683365734740,ENG 15,E00,185684,Staff,0,0,0,0
1683365735766,ETHN 103,A00,185710,Staff,0,4,35,35
1683365736794,ETHN 103A,A00,199228,Man; Simeon S,2,0,9,7
1683365737817,ETHN 109,A00,185711,Staff,18,0,35,17
1683365738844,ETHN 142,A00,185726,Staff,0,4,30,30
1683365739868,ETHN 163J,A00,199229,Man; Simeon S,5,0,8,3
1683365740892,ETHN 168,A00,185727,Staff,8,0,10,2
1683365741919,ETHN 182,A00,185728,Staff,0,0,35,35
1683365742946,ETHN 183,A00,185737,Staff,8,0,18,10
1683365743976,GLBH 111,A01,209361,Burgos; Jose L.,0,0,0,0
1683365746100,HIEU 104,A00,185792,Staff,16,0,20,4
1683365747124,HIEU 115,A00,185800,Staff,1,0,20,19
1683365748149,HIEU 128,A00,185801,Staff,0,7,20,20
1683365749172,HIEU 147,A00,185802,Staff,16,0,20,4
1683365750197,HIEU 154,A00,185823,Staff,12,0,20,8
1683365751221,HILA 102,A00,185826,Staff,13,0,20,7
1683365752246,HILD 2C,A01,185778,Staff,0,12,20,20
1683365753271,HILD 7B,A01,185780,Kwak; Nancy,0,15,32,32
1683365753271,HILD 7B,A02,185781,Kwak; Nancy,0,18,32,32
1683365754299,HILD 30,A01,185791,Staff,14,0,20,6
1683365755327,HISC 119,A00,185830,Golan; Tal,0,9,20,20
1683365756356,HITO 156GS,A00,185831,Patterson; Patrick H.,0,0,0,23
1683365757382,HIUS 103,A00,185832,Man; Simeon S,1,6,20,19
1683365758406,HIUS 117,A00,185836,Kwak; Nancy,2,0,20,18
1683365759430,HIUS 125,A00,185840,Man; Simeon S,0,0,23,23
1683365760458,HIUS 149,A00,185845,Staff,0,0,20,20
1683365761489,HUM 3,A01,185882,Zavodny; Tatiana Sophia,0,7,50,50
1683365761489,HUM 3,B01,185899,Caldwell; Michael Alan,0,18,50,50
1683365762512,HUM 3GS,A00,185900,Patterson; Patrick H.,0,0,0,23
1683365763538,HUM 4,A01,185938,Zroka; Amy Liane,31,0,50,19
1683365763538,HUM 4,B01,185956,Watkins; Eric,0,3,50,50
1683365763538,HUM 4,B02,202209,Watkins; Eric,0,2,50,50
1683365763538,HUM 4,B03,202210,Watkins; Eric,0,2,50,50
1683365764563,HUM 5,A01,185958,West; Geoffrey Scott,3,0,50,47
1683365764563,HUM 5,A02,202215,West; Geoffrey Scott,0,0,50,50
1683365765589,INTL 190,A00,185959,Gagnon; Jeffrey C,0,0,0,9
1683365765589,INTL 190,B00,185960,Lettieri; Michael Joseph,0,0,0,1
1683365766613,JAPN 180,A00,254509,Staff,4,0,30,26
1683365767641,LATI 10,A01,202853,Kennemore; Amy Michelle,4,0,35,31
1683365767641,LATI 10,A02,202854,Kennemore; Amy Michelle,2,0,35,33
1683365767641,LATI 10,A03,270054,Kennemore; Amy Michelle,30,0,30,0
1683365768666,LATI 180,A00,202855,Kennemore; Amy Michelle,11,0,20,9
1683365769691,LAWS 101,A00,201767,Golan; Tal,0,7,40,40
1683365770716,LIFR 1C,A00,185961,Staff,6,0,20,14
1683365771744,LIFR 1CX,A00,185962,Staff,7,0,20,13
1683365772771,LIFR 1D,A00,185963,Staff,9,0,20,11
1683365773799,LIFR 1DX,A00,185964,Staff,9,0,20,11
1683365774823,LIGN 101,A01,186039,Staff,43,0,50,7
1683365775849,LIGN 165,A00,186040,Staff,18,0,50,32
1683365776877,LTCS 108,A00,186041,Staff,6,0,10,4
1683365777901,LTCS 119,A00,186042,Staff,16,0,20,4
1683365778926,LTCS 130,A00,186043,Wesling; Megan E.,15,0,25,10
1683365780975,LTEA 138,A00,186119,Staff,14,0,40,26
1683365782000,LTEN 124,A00,186148,Staff,6,0,25,19
1683365783025,LTEN 178,A00,186149,Staff,7,0,15,8
1683365784050,LTEN 181,A00,186150,Blanco; John D,33,0,40,7
1683365785077,LTWL 120,A00,186160,Staff,20,0,25,5
1683365786104,LTWL 165,A00,186161,Staff,22,0,25,3
1683365787130,LTWR 100,A00,186162,Staff,0,5,15,15
1683365788157,LTWR 102,A00,186163,Doller; Ben,5,0,15,10
1683365789181,MAE 8,A01,186412,Staff,0,0,0,0
1683365790206,MAE 30B,A00,186445,Bahadori; Mohammad Yousef,83,0,100,17
1683365791228,MAE 40,A00,186592,Bewley; Thomas R,10,0,50,40
1683365792252,MAE 101B,A00,186593,Bahadori; Mohammad Yousef,81,0,100,19
1683365793277,MAE 105,A00,186594,Bandaru; Prabhakar,12,0,50,38
1683365794301,MAE 107,A00,186599,Pham; Hieu Tan,0,7,120,120
1683365795325,MAE 148,A01,186660,Silberman; Jack,3,0,16,13
1683365796351,MATH 10A,A01,188095,Staff,0,5,35,35
1683365797381,MATH 10B,A01,188097,Bowers; Adam R.,0,11,30,30
1683365797381,MATH 10B,A02,188099,Bowers; Adam R.,0,11,30,30
1683365797381,MATH 10B,B01,188104,Bowers; Adam R.,0,10,30,30
1683365797381,MATH 10B,B02,188106,Bowers; Adam R.,0,10,30,30
1683365798411,MATH 10C,A01,188111,Staff,0,18,30,30
1683365798411,MATH 10C,A02,188127,Staff,0,17,30,30
1683365798411,MATH 10C,A03,188131,Staff,0,18,30,30
1683365798411,MATH 10C,B01,188218,Staff,18,0,30,12
1683365798411,MATH 10C,B02,188244,Staff,13,0,30,17
1683365798411,MATH 10C,B03,188277,Staff,16,0,30,14
1683365799440,MATH 18,A01,188344,Bach; Quang Tran,18,0,30,12
1683365799440,MATH 18,A02,188345,Bach; Quang Tran,11,0,30,19
1683365799440,MATH 18,B01,188353,Bach; Quang Tran,10,0,30,20
1683365799440,MATH 18,B02,188354,Bach; Quang Tran,20,0,30,10
1683365800464,MATH 20A,A01,188374,Staff,12,0,35,23
1683365801489,MATH 20B,A01,188382,Ohm; Ko Woon,6,0,30,24
1683365801489,MATH 20B,A02,188383,Ohm; Ko Woon,21,0,30,9
1683365801489,MATH 20B,B01,188385,Ohm; Ko Woon,7,0,30,23
1683365801489,MATH 20B,B02,188392,Ohm; Ko Woon,22,0,30,8
1683365802514,MATH 20C,A01,188394,Harel; Guershon,10,0,30,20
1683365802514,MATH 20C,A02,188395,Harel; Guershon,15,0,30,15
1683365802514,MATH 20C,B01,188404,Harel; Guershon,4,0,30,26
1683365802514,MATH 20C,B02,188405,Harel; Guershon,19,0,30,11
1683365803541,MATH 20D,A01,188414,Hammock; Frances H,0,1,30,30
1683365803541,MATH 20D,A02,188415,Hammock; Frances H,3,0,30,27
1683365803541,MATH 20D,B01,188447,Hammock; Frances H,1,0,30,29
1683365803541,MATH 20D,B02,188486,Hammock; Frances H,8,0,30,22
1683365804566,MATH 20E,A01,188649,Staff,21,0,30,9
1683365804566,MATH 20E,A02,188650,Staff,23,0,30,7
1683365804566,MATH 20E,A03,188673,Staff,0,0,30,30
1683365805590,MATH 102,A01,188675,Staff,0,35,35,35
1683365806619,MATH 103B,A01,188681,Staff,3,0,35,32
1683365806619,MATH 103B,B01,188692,Staff,5,0,35,30
1683365807644,MATH 109,A01,188695,Salehi Golsefidy; Alireza,25,0,35,10
1683365807644,MATH 109,A02,188696,Salehi Golsefidy; Alireza,25,0,35,10
1683365808668,MATH 120A,A01,188698,Eggers; John Dietrich,7,0,35,28
1683365809693,MATH 142B,A01,188736,Ioana; Adrian,0,2,30,30
1683365809693,MATH 142B,A02,188741,Ioana; Adrian,0,0,30,30
1683365809693,MATH 142B,A03,188743,Ioana; Adrian,0,1,30,30
1683365810717,MATH 168A,A01,188790,Staff,0,9,35,35
1683365811742,MATH 170A,A01,188803,Nie; Jiawang,0,2,35,35
1683365811742,MATH 170A,A02,188811,Nie; Jiawang,0,0,35,35
1683365811742,MATH 170A,A03,188814,Nie; Jiawang,1,0,35,34
1683365811742,MATH 170A,A04,188815,Nie; Jiawang,13,0,35,22
1683365812767,MATH 193B,A01,188817,Staff,0,0,35,35
1683365812767,MATH 193B,A02,188818,Staff,5,0,35,30
1683365813795,MGT 4,A01,202857,Anderson; John Charles,61,0,80,19
1683365814819,MGT 12,A00,202858,Lindenberger; Wade Douglas,42,0,90,48
1683365815844,MGT 18,A00,202859,Staff,74,0,90,16
1683365816871,MGT 18GS,A00,202860,McKay; Michael J,13,0,28,15
1683365817898,MGT 45,A00,202861,Pecore; Joseph P.,15,0,90,75
1683365818932,MGT 100,A00,202863,Yavorsky; Daniel Ryan,28,0,90,62
1683365819960,MGT 103,A00,202864,Ehrich; Kristine R,0,17,90,90
1683365820985,MGT 112,A00,202865,Ehrich; Kristine R,15,0,90,75
1683365822016,MGT 121A,A00,202868,Staff,0,20,0,0
1683365823045,MGT 131B,A00,202869,Anderson; John Charles,59,0,90,31
1683365824074,MGT 136,A00,202871,Lindenberger; Wade Douglas,84,0,90,6
1683365825099,MGT 164,A00,202873,Staff,0,68,90,91
1683365826124,MGT 164GS,A00,202874,McKay; Mary A,13,0,28,15
1683365827148,MGT 180,A00,202875,Staff,0,50,90,91
1683365828176,MMW 11R,A01,205019,Herbst; Matthew,3,0,30,27
1683365828176,MMW 11R,A02,205026,Herbst; Matthew,29,0,30,1
1683365829201,MMW 15,A01,193512,Chang; Edmond Yi-Teh,0,9,28,28
1683365829201,MMW 15,A02,193513,Chang; Edmond Yi-Teh,0,5,28,28
1683365829201,MMW 15,A03,193514,Chang; Edmond Yi-Teh,0,5,28,28
1683365829201,MMW 15,A04,193515,Chang; Edmond Yi-Teh,0,5,28,28
1683365829201,MMW 15,A05,193516,Chang; Edmond Yi-Teh,0,4,28,28
1683365829201,MMW 15,A06,193517,Chang; Edmond Yi-Teh,0,5,28,28
1683365829201,MMW 15,B01,193519,Chang; Edmond Yi-Teh,0,5,28,28
1683365829201,MMW 15,B02,193520,Chang; Edmond Yi-Teh,0,5,28,28
1683365829201,MMW 15,B03,193521,Chang; Edmond Yi-Teh,0,5,28,28
1683365829201,MMW 15,B04,193522,Chang; Edmond Yi-Teh,0,4,28,28
1683365829201,MMW 15,B05,193523,Chang; Edmond Yi-Teh,0,5,28,28
1683365829201,MMW 15,B06,193524,Chang; Edmond Yi-Teh,0,4,28,28
1683365830225,MMW 122,A01,193526,Rahimi; Babak,0,15,28,28
1683365830225,MMW 122,A02,193527,Rahimi; Babak,0,14,28,28
1683365830225,MMW 122,A03,193528,Rahimi; Babak,0,0,0,0
1683365830225,MMW 122,A04,193529,Rahimi; Babak,0,0,0,0
1683365831253,MUS 1A,A01,186663,Staff,0,20,35,35
1683365832280,MUS 4,A01,186715,Staff,0,12,35,35
1683365833303,MUS 5R,A01,186796,Dubnov; Shlomo,0,17,35,35
1683365834328,MUS 6,A01,186798,Staff,0,4,25,25
1683365835353,MUS 7,A01,186830,Staff,13,0,35,22
1683365836376,MUS 8,A01,186930,Staff,0,26,35,35
1683365837407,MUS 15,A01,186932,Staff,0,16,35,35
1683365837407,MUS 15,B01,186934,Staff,0,15,35,35
1683365838436,MUS 80,A00,186935,Staff,0,0,20,20
1683365838436,MUS 80,B00,186936,Staff,25,0,25,0
1683365839465,NANO 11,A00,204702,Lipomi; Darren John,0,0,0,0
1683365840490,NANO 15,A01,204709,Yang; Kesong,0,1,0,0
1683365841515,NANO 114,A00,202069,Jahed Motlagh; Zeinab,3,0,10,7
1683365842542,PHIL 1,A00,186955,Grush; Rick Scott,32,0,40,8
1683365843570,PHIL 10,A01,186973,Grush; Rick Scott,28,0,35,7
1683365843570,PHIL 10,A02,186974,Grush; Rick Scott,33,0,35,2
1683365844599,PHIL 13,A01,186976,Staff,7,0,35,28
1683365844599,PHIL 13,A02,186977,Staff,16,0,35,19
1683365845627,PHIL 14,A01,186979,Staff,31,0,35,4
1683365845627,PHIL 14,A02,186986,Staff,32,0,35,3
1683365846654,PHIL 28,A01,186988,Staff,16,0,30,14
1683365846654,PHIL 28,A02,186989,Staff,1,0,30,29
1683365846654,PHIL 28,A03,186990,Staff,9,0,30,21
1683365846654,PHIL 28,A04,186991,Staff,26,0,30,4
1683365847678,PHIL 120,A00,186997,Staff,23,0,40,17
1683365848704,PHIL 137,A00,187003,Staff,9,0,40,31
1683365849785,PHIL 150,A00,187015,Staff,47,0,70,23
1683365850810,PHIL 167,A00,187021,Lamey; Andy M.,35,0,40,5
1683365851835,PHIL 174,A01,202226,Staff,17,0,20,3
1683365851835,PHIL 174,A02,202235,Staff,20,0,20,0
1683365852861,PHIL 191A,A00,258918,Staff,0,0,1,1
1683365853885,PHYS 1A,A00,187028,Staff,27,0,60,33
1683365854911,PHYS 1AL,001,187036,Staff,2,0,30,28
1683365854911,PHYS 1AL,002,187049,Staff,18,0,30,12
1683365855941,PHYS 1B,A00,187058,Staff,22,0,60,38
1683365856969,PHYS 1BL,001,187064,Staff,0,0,30,30
1683365856969,PHYS 1BL,002,187070,Staff,5,0,30,25
1683365857998,PHYS 1C,A00,187082,Staff,31,0,120,89
1683365859027,PHYS 1CL,001,187088,Staff,0,9,30,30
1683365859027,PHYS 1CL,002,187089,Staff,0,2,30,30
1683365859027,PHYS 1CL,009,262693,Staff,11,0,30,19
1683365860055,PHYS 2B,A01,187097,Staff,54,0,115,61
1683365861080,PHYS 2C,A01,187099,Staff,67,0,115,48
1683365862104,PHYS 2CL,A01,187101,Staff,5,0,28,23
1683365862104,PHYS 2CL,A02,187102,Staff,15,0,28,13
1683365863133,PHYS 2D,A01,187123,Shotwell; Brian,95,0,115,20
1683365864159,PHYS 4B,A01,187133,Grinstein; Benjamin,35,0,50,15
1683365865185,POLI 10,A00,188819,Staff,0,4,50,50
1683365866210,POLI 11,A00,188827,Staff,43,0,50,7
1683365867234,POLI 13R,A00,188828,Staff,0,1,20,20
1683365868262,POLI 27,A01,188830,Elgin; Samuel Zincke,0,1,70,70
1683365869290,POLI 30,A00,188832,Desposato; Scott,31,0,50,19
1683365870315,POLI 102F,A00,188834,Staff,3,0,40,37
1683365871339,POLI 104A,A00,188852,Staff,14,0,30,16
1683365872364,POLI 104I,A00,188853,Staff,0,6,20,20
1683365873388,POLI 110B,A00,188854,Wiens; David,7,0,20,13
1683365874415,POLI 112A,A00,188855,Wiens; David,5,0,30,25
1683365875438,POLI 117R,A00,188856,Forman; Fonna,0,11,20,20
1683365876466,POLI 118,A00,188857,Ingham; Sean,8,0,20,12
1683365877490,POLI 120G,A00,188858,Staff,9,0,30,21
1683365878515,POLI 131CR,A00,188863,Hoston; Germaine,23,0,50,27
1683365879540,POLI 133,A00,188864,Nellis; Gareth Hb,44,0,50,6
1683365880564,POLI 134D,A00,188865,Desposato; Scott,27,0,30,3
1683365881593,POLI 142A,A00,188871,Gartzke; Erik,22,0,50,28
1683365882622,POLI 142K,A00,188874,Staff,38,0,50,12
1683365883647,POLI 143,A00,188940,Gartzke; Erik,16,0,30,14
1683365884676,POLI 153,A00,188943,Staff,3,0,20,17
1683365885702,POLI 160AA,A00,188944,Staff,11,0,40,29
1683365886730,POLI 170A,A00,188945,Staff,11,0,30,19
1683365888780,PSYC 1,A00,188952,Staff,37,0,90,53
1683365889806,PSYC 2,B00,188953,Staff,19,0,35,16
1683365890830,PSYC 6,A00,188970,Staff,47,0,60,13
1683365891855,PSYC 7,A00,188973,Staff,37,0,45,8
1683365892879,PSYC 60,A01,188980,Rickard; Timothy C.,43,0,60,17
1683365893904,PSYC 70,A01,189001,Steiner; Eric Tomas,23,0,45,22
1683365894930,PSYC 100,A00,189005,Lacefield; Katharine I,0,98,120,120
1683365895954,PSYC 102,A00,189008,Staff,9,0,30,21
1683365896978,PSYC 106,B00,189026,Gorman; Michael R.,34,0,60,26
1683365898003,PSYC 114,B01,189033,Winkielman; Piotr,0,32,30,30
1683365899028,PSYC 131,A00,189036,Anagnostaras; Stephan,0,43,60,60
1683365900056,PSYC 136,A00,189041,Lowe; Angela Beth,0,7,25,25
1683365901080,PSYC 137,A00,189057,Winkielman; Piotr,0,34,25,25
1683365902105,PSYC 144,A00,189107,Wixted; John T,0,7,50,50
1683365904155,PSYC 162,A00,189142,Staff,0,8,85,85
1683365905181,PSYC 172,A00,189144,Gorman; Michael R.,0,7,30,30
1683365907234,PSYC 179,A00,189146,Lacefield; Katharine I,0,84,120,120
1683365908260,PSYC 181,A00,189147,Anagnostaras; Stephan,0,44,90,90
1683365909287,PSYC 190R,A00,189148,Barner; David A.,0,22,80,80
1683365910317,PSYC 191,A00,189275,Rickard; Timothy C.,0,7,25,25
1683365911345,PSYC 193,A00,189276,Chapman; Eddie Nathaniel,0,1,0,4
1683365912371,PSYC 193L,A01,189281,Lowe; Angela Beth,12,0,20,8
1683365912371,PSYC 193L,B01,189285,Staff,28,0,35,7
1683365913396,RELI 149,A00,187137,Rahimi; Babak,7,0,40,33
1683365914421,SE 9,A01,187315,Staff,0,2,18,18
1683365915445,SE 101B,A00,187409,Staff,24,0,30,6
1683365916470,SE 110B,A00,187444,Staff,10,0,40,30
1683365917496,SE 130B,A00,187449,Staff,31,0,40,9
1683365918522,SE 150A,A00,187516,Staff,9,0,20,11
1683365919547,SE 154,A00,187528,Staff,30,0,50,20
1683365920574,SIO 3,A01,258171,Staff,35,0,40,5
1683365921600,SIO 10,A00,187144,Cook; Geoffrey W,0,3,75,75
1683365922627,SIO 45,A00,187152,Cook; Geoffrey W,1,0,100,99
1683365923655,SIO 109R,A00,194486,Staff,0,3,20,20
1683365925708,SIO 187,A01,187233,Kacev; David,12,0,40,28
1683365926734,SOCI 1,A01,258656,Thorpe; Charles Robert,28,0,30,2
1683365926734,SOCI 1,A02,258658,Thorpe; Charles Robert,30,0,30,0
1683365926734,SOCI 1,A03,258661,Thorpe; Charles Robert,25,0,25,0
1683365926734,SOCI 1,A04,258666,Thorpe; Charles Robert,22,0,25,3
1683365926734,SOCI 1,A05,258897,Thorpe; Charles Robert,23,0,25,2
1683365926734,SOCI 1,A06,258898,Thorpe; Charles Robert,25,0,25,0
1683365927761,SOCI 30,A01,258903,Pardo Guerra; Juan Pablo,15,0,30,15
1683365928787,SOCI 102,A00,258904,Staff,9,0,25,16
1683365929815,SOCI 106,A00,258905,Staff,19,0,25,6
1683365930843,SOCI 111,A00,258907,Ribas Norris; Janet Vanesa,26,0,30,4
1683365931870,SOCI 121R,A00,258908,Pardo Guerra; Juan Pablo,10,0,30,20
1683365932897,SOCI 126,A01,203330,Staff,14,0,20,6
1683365933925,SOCI 131,A00,258909,Thorpe; Charles Robert,31,0,60,29
1683365934949,SOCI 135,A00,258910,Payne; Christine Anna,0,9,30,30
1683365935973,SOCI 157,A00,258911,Staff,12,0,30,18
1683365936999,SOCI 184,A00,258912,Staff,25,0,30,5
1683365938027,SOCI 188D,A00,258913,Staff,22,0,30,8
1683365939054,SYN 2,001,187529,Staff,10,0,16,6
1683365939054,SYN 2,002,201452,Staff,0,18,16,16
1683365939054,SYN 2,003,201469,Staff,3,0,16,13
1683365940082,SYN 100,A01,187531,Staff,0,9,20,20
1683365940082,SYN 100,B01,201491,Staff,0,12,20,20
1683365941114,TDAC 1,A00,189286,Walsh; Kim C.,3,0,20,17
1683365941114,TDAC 1,B00,189287,Harting; Carla Kelso,11,0,20,9
1683365942138,TDAC 101,A00,189300,Walsh; Kim C.,16,0,20,4
1683365942138,TDAC 101,B00,189301,Harting; Carla Kelso,18,0,20,2
1683365943163,TDAC 102,A00,189304,Basso; Beatrice,14,0,20,6
1683365944189,TDAC 108,A00,189305,Staff,18,0,20,2
1683365945219,TDDE 131,A00,189310,Staff,19,0,20,1
1683365945219,TDDE 131,B00,189314,Staff,19,0,20,1
1683365945219,TDDE 131,C00,189315,Staff,48,0,50,2
1683365945219,TDDE 131,D00,189316,Staff,14,0,15,1
1683365945219,TDDE 131,E00,204841,Staff,20,0,20,0
1683365946246,TDGE 10,A00,189289,Staff,30,0,50,20
1683365946246,TDGE 10,B00,189290,Havis; Allan,1,0,50,49
1683365947274,TDGE 11,A00,189291,Fulton; Julia,0,3,50,50
1683365947274,TDGE 11,B00,189292,Staff,20,0,25,5
1683365947274,TDGE 11,C00,260270,Staff,0,0,0,0
1683365948298,TDGE 25,A00,189294,Staff,3,0,20,17
1683365949325,TDGE 124,A00,189318,Fulton; Julia,0,8,50,50
1683365950353,TDGE 125,A00,189319,Staff,13,0,25,12
1683365950353,TDGE 125,B00,189320,Staff,23,0,25,2
1683365951380,TDGE 127,A00,189322,Havis; Allan,0,0,50,50
1683365952408,TDHT 101,A00,189323,Staff,18,0,25,7
1683365952408,TDHT 101,B00,189324,Staff,25,0,25,0
1683365953492,TDHT 102,A00,189325,Staff,49,0,50,1
1683365954518,TDMV 1,A00,189295,Arcidiacono; Kristin,19,0,30,11
1683365954518,TDMV 1,B00,189296,Caligagan; Maria T.,24,0,30,6
1683365955545,TDMV 2,A00,189297,Sammartano; Tonnie,28,0,30,2
1683365955545,TDMV 2,B00,189299,Arcidiacono; Kristin,24,0,30,6
1683365956574,TDMV 3,A00,204998,Rincon; Alicia,22,0,30,8
1683365957602,TDMV 120,A00,189458,Sammartano; Tonnie,28,0,30,2
1683365958631,TDMV 138,A00,189541,Jun; Grace Shin Hae,22,0,40,18
1683365959657,TDMV 142,A00,189717,Caligagan; Tony,24,0,30,6
1683365959657,TDMV 142,B00,189718,Caligagan; Maria T.,25,0,30,5
1683365960682,TMC 2,A01,187533,Staff,25,0,25,0
1683365960682,TMC 2,A02,187534,Staff,25,0,25,0
1683365961706,USP 1,A01,187536,Kwak; Nancy,0,16,25,25
1683365962732,USP 5,A01,187538,Staff,10,0,25,15
1683365963756,USP 101,A00,199253,Staff,0,4,0,0
1683365964783,USP 124,A00,187562,Boomhower; Matthew Charles,1,0,30,29
1683365965809,USP 138,A00,187582,Staff,20,0,25,5
1683365966833,USP 152,A01,187597,Staff,4,0,25,21
1683365967858,USP 153,A00,187598,Staff,19,0,25,6
1683365968885,USP 168,A00,187607,Kwak; Nancy,2,0,5,3
1683365969910,USP 173,A00,187619,Staff,4,0,25,21
1683365970935,USP 181,A00,187638,Staff,0,3,25,25
1683365971959,VIS 103,A00,187650,Cruz; Edwin Teddy,22,0,75,53
1683365972984,VIS 110D,A00,187669,Staff,12,0,22,10
1683365974013,VIS 127C,A00,187720,Shen; Kuiyi,67,0,146,79
1683365975038,VIS 149,A00,187731,Yoldas; Pinar,0,14,22,22
1683365976061,VIS 151,A01,188091,Staff,22,0,34,12
1683365976061,VIS 151,A02,188092,Staff,11,0,34,23
1683365977089,VIS 160B,A00,188093,Stalbaum; Brett,0,0,10,10
1683365979143,WCWP 10B,A00,201720,Staff,10,0,15,5
1683365979143,WCWP 10B,B00,201722,Staff,9,0,15,6
1683365980169,WCWP 100,A00,201725,Gagnon; Jeffrey C,0,0,2,2
1683365980169,WCWP 100,B00,201727,Staff,0,4,15,15
1683365983349,ANBI 133,A00,258401,Wilder; Linnea Lorene,34,0,40,6
1683365984373,ANBI 140,A00,258395,Hrvoj Mihic; Branka,18,0,25,7
1683365985398,ANSC 120,A00,258402,Bialecki; Jon Anthony,27,0,40,13
1683365986425,ANSC 144,A00,258400,Staff,14,0,40,26
1683365988476,ANSC 166,A00,258396,Parish; Steven Martin,158,0,175,17
1683365989503,ANSC 180,A00,193533,Staff,9,0,20,11
1683365990526,ANSC 188,A00,258397,Jassal; Aftab,33,0,40,7
1683365991552,ANTH 3,A01,258316,Staff,23,0,30,7
1683365992580,ANTH 5,A00,258394,Semendeferi; Ekaterini,16,0,20,4
1683365993607,ANTH 21,A01,258331,Staff,8,0,40,32
1683365994635,ANTH 103,A00,258398,Varma; Saiba,15,0,25,10
1683365995667,AWP 10,001,202034,Staff,0,0,0,0
1683365995667,AWP 10,002,202035,Staff,0,0,0,0
1683365995667,AWP 10,003,202036,Staff,0,0,0,0
1683365995667,AWP 10,004,202037,Staff,0,0,0,0
1683365995667,AWP 10,005,202038,Staff,0,0,0,0
1683365995667,AWP 10,006,202039,Staff,0,0,0,0
1683365995667,AWP 10,007,202040,Staff,0,0,0,0
1683365995667,AWP 10,008,202041,Staff,0,0,0,0
1683365995667,AWP 10,009,202042,Staff,0,0,0,0
1683365995667,AWP 10,010,202043,Staff,0,0,0,0
1683365995667,AWP 10,011,202044,Staff,0,0,0,0
1683365995667,AWP 10,012,202045,Staff,0,0,0,0
1683365995667,AWP 10,013,202046,Staff,0,0,0,0
1683365995667,AWP 10,014,202047,Staff,0,0,0,0
1683365995667,AWP 10,015,202048,Staff,0,0,0,0
1683365995667,AWP 10,016,202049,Staff,0,0,0,0
1683365995667,AWP 10,017,202050,Staff,0,0,0,0
1683365995667,AWP 10,018,202051,Staff,0,0,0,0
1683365995667,AWP 10,019,202052,Staff,0,0,0,0
1683365995667,AWP 10,020,202053,Staff,0,0,0,0
1683365995667,AWP 10,021,202054,Staff,0,0,0,0
1683365995667,AWP 10,022,202055,Staff,0,0,0,0
1683365995667,AWP 10,023,202056,Staff,0,0,0,0
1683365995667,AWP 10,024,202057,Staff,0,0,0,0
1683365995667,AWP 10,025,202058,Staff,0,0,0,0
1683365995667,AWP 10,026,202059,Staff,0,0,0,0
1683365996693,AWP 102,001,202032,Staff,0,0,0,0
1683365996693,AWP 102,002,202033,Staff,0,0,0,0
1683365997722,BENG 100,A01,254234,Taylor Amos; Alyssa C,31,0,40,9
1683365998748,BENG 196,001,270013,Engler; Adam J.,9999,0,9999,0
1683365999775,BICD 100R,A01,202018,Smith; Laurie,0,7,32,32
1683365999775,BICD 100R,A02,202019,Smith; Laurie,0,2,32,32
1683365999775,BICD 100R,A03,202020,Smith; Laurie,0,1,32,32
1683365999775,BICD 100R,A04,202021,Smith; Laurie,9,0,32,23
1683365999775,BICD 100R,A05,202022,Smith; Laurie,12,0,32,20
1683366000800,BICD 136,A01,193242,Gustafson-Brown; Cindy,0,2,32,32
1683366000800,BICD 136,A02,193244,Gustafson-Brown; Cindy,14,0,32,18
1683366001828,BIEB 102,A01,193249,Butler; Shannon Rhey,0,2,32,32
1683366001828,BIEB 102,A02,193251,Butler; Shannon Rhey,0,0,32,32
1683366001828,BIEB 102,A03,193253,Butler; Shannon Rhey,0,1,32,32
1683366001828,BIEB 102,A04,193255,Butler; Shannon Rhey,17,0,32,15
1683366001828,BIEB 102,A05,193265,Butler; Shannon Rhey,26,0,32,6
1683366001828,BIEB 102,A06,193269,Butler; Shannon Rhey,16,0,32,16
1683366003879,BIEB 150,A01,193274,Staff,0,0,32,32
1683366003879,BIEB 150,A02,193285,Staff,23,0,32,9
1683366004906,BIEB 194,A00,193286,Kurle; Carolyn M.,22,0,32,10
1683366005934,BILD 1,A01,192291,Staff,16,0,32,16
1683366005934,BILD 1,A02,192292,Staff,30,0,32,2
1683366005934,BILD 1,B01,192520,Reuther; Keefe,0,1,0,0
1683366005934,BILD 1,B02,192532,Reuther; Keefe,0,1,0,0
1683366006959,BILD 3,A01,192556,Butler; Shannon Rhey,0,0,32,32
1683366006959,BILD 3,A02,192581,Butler; Shannon Rhey,4,0,32,28
1683366006959,BILD 3,A03,192611,Butler; Shannon Rhey,23,0,32,9
1683366006959,BILD 3,A04,192612,Butler; Shannon Rhey,25,0,32,7
1683366006959,BILD 3,A05,192613,Butler; Shannon Rhey,27,0,32,5
1683366006959,BILD 3,A06,192679,Butler; Shannon Rhey,27,0,32,5
1683366006959,BILD 3,A07,192682,Butler; Shannon Rhey,21,0,32,11
1683366007984,BILD 4,A01,192836,Reuther; Keefe,0,0,24,24
1683366007984,BILD 4,A02,193044,Reuther; Keefe,4,0,24,20
1683366009007,BILD 10,A01,193142,Gustafson-Brown; Cindy,30,0,32,2
1683366009007,BILD 10,A02,193149,Gustafson-Brown; Cindy,31,0,32,1
1683366010032,BIMM 100,A01,193301,Staff,1,6,32,31
1683366010032,BIMM 100,A02,193312,Staff,0,5,32,32
1683366010032,BIMM 100,A03,193323,Staff,0,8,32,32
1683366011056,BIMM 101,A01,193329,McDonnell; Lisa Marie,0,3,24,24
1683366011056,BIMM 101,A02,193339,McDonnell; Lisa Marie,0,3,24,24
1683366011056,BIMM 101,B01,193354,McDonnell; Lisa Marie,0,3,24,24
1683366011056,BIMM 101,B02,193357,McDonnell; Lisa Marie,0,3,24,24
1683366012082,BIMM 110,A01,193377,Tat; John,0,11,32,32
1683366012082,BIMM 110,A02,193378,Tat; John,0,9,32,32
1683366013106,BIMM 120,A01,206116,Staff,0,0,32,32
1683366013106,BIMM 120,A02,206117,Staff,8,0,32,24
1683366013106,BIMM 120,A03,206121,Staff,21,0,32,11
1683366014131,BIPN 100,A01,193393,Park; Ji Young,0,14,32,32
1683366014131,BIPN 100,A02,193402,Park; Ji Young,0,13,32,32
1683366014131,BIPN 100,A03,193413,Park; Ji Young,0,14,32,32
1683366014131,BIPN 100,A04,193414,Park; Ji Young,0,13,32,32
1683366015155,BIPN 102,A01,193429,Staff,0,0,32,32
1683366015155,BIPN 102,A02,193438,Staff,22,0,32,10
1683366016179,BIPN 106,A01,193450,Reyes Gonzalez; Catalina,0,2,40,40
1683366017202,BIPN 134,A01,193465,Cooke; James Edward,1,0,32,31
1683366017202,BIPN 134,A02,193474,Cooke; James Edward,25,0,32,7
1683366017202,BIPN 134,A03,193485,Cooke; James Edward,29,0,32,3
1683366017202,BIPN 134,A04,193486,Cooke; James Edward,21,0,32,11
1683366017202,BIPN 134,A05,193491,Cooke; James Edward,31,0,32,1
1683366017202,BIPN 134,A06,193501,Cooke; James Edward,30,0,32,2
1683366017202,BIPN 134,A07,193510,Cooke; James Edward,29,0,32,3
1683366019251,BISP 194,A00,222522,Staff,14,0,32,18
1683366020279,CAT 124,A01,202407,Staff,19,0,25,6
1683366021308,CAT 125,A00,202408,Marchisotto; Jennifer Anne,4,0,20,16
1683366022338,CAT 125R,A00,202409,Smith; Lauryn Alissa,0,11,20,20
1683366022338,CAT 125R,B00,202410,Morales; Celeste Georgianna,0,11,20,20
1683366022338,CAT 125R,C00,202411,Irwin; Matthew Joseph,0,10,20,20
1683366023364,CENG 15,A01,204712,Yang; Kesong,0,1,0,0
1683366024390,CENG 114,A00,202070,Jahed Motlagh; Zeinab,5,0,20,15
1683366025414,CGS 105,A00,185477,Wesling; Megan E.,24,0,40,16
1683366026441,CGS 106,A00,185494,Staff,13,0,22,9
1683366027466,CGS 108,A00,185495,Staff,14,0,20,6
1683366028494,CGS 114,A00,185496,Staff,13,0,18,5
1683366029518,CGS 119,A00,185501,Staff,15,0,20,5
1683366030546,CGS 120,A00,185511,Staff,13,0,20,7
1683366031571,CHEM 4,A01,184675,Bussey; Thomas J,96,0,100,4
1683366032595,CHEM 6A,A01,184677,Staff,34,0,60,26
1683366033623,CHEM 6B,A01,184679,Staff,65,0,100,35
1683366034650,CHEM 6C,A01,184681,Bussey; Thomas J,1,0,50,49
1683366034650,CHEM 6C,A02,184682,Bussey; Thomas J,34,0,50,16
1683366035680,CHEM 40A,A01,184684,Albizati; Kim F.,37,0,100,63
1683366036709,CHEM 40B,A01,184686,Albizati; Kim F.,0,20,100,100
1683366037733,CHEM 41B,A01,184690,Staff,52,0,100,48
1683366038758,COGS 3,A01,184715,Boyle; Mary E. T.,0,25,40,40
1683366039783,COGS 14B,A01,185172,Staff,0,15,38,38
1683366040809,COGS 18,A01,184736,Staff,16,0,80,64
1683366041834,COGS 100,A01,184932,Staff,0,5,73,73
1683366042857,COGS 101A,A01,184935,Staff,0,39,30,30
1683366043885,COGS 101B,A01,184944,Staff,0,2,30,30
1683366044914,COGS 101C,A01,184946,Staff,0,12,30,30
1683366045939,COGS 102A,A01,184951,Johnson; Christine M.,2,0,40,38
1683366046968,COGS 107B,A01,184953,Mooshagian; Eric Frederick,0,50,40,40
1683366047994,COGS 118B,A01,184959,Gupta; Anjum,0,48,40,40
1683366049019,COGS 153,A00,184961,Staff,0,15,30,30
1683366050044,COGS 177,A00,184962,Staff,0,20,30,30
1683366051149,COGS 187A,A01,184969,Boyle; Mary E. T.,0,17,40,40
1683366052174,COMM 10,A01,185174,Staff,0,5,25,25
1683366052174,COMM 10,A02,185189,Staff,0,5,25,25
1683366052174,COMM 10,A03,269821,Staff,0,0,0,0
1683366053200,COMM 100B,A01,185475,Staff,0,0,0,2
1683366053200,COMM 100B,A02,185476,Staff,13,0,25,12
1683366054224,COMM 100C,A01,185314,Staff,1,0,25,24
1683366054224,COMM 100C,A02,185327,Staff,19,0,25,6
1683366055251,COMM 110M,A00,185349,Staff,2,0,40,38
1683366056280,COMM 113T,A00,185352,Staff,24,0,40,16
1683366057377,COMM 114I,A00,185353,Staff,33,0,40,7
1683366058405,COMM 131,A00,185354,Staff,19,0,30,11
1683366059434,CSE 8A,A50,185358,Cao; Yingjun,0,46,10,10
1683366060461,CSE 8B,A01,185362,Staff,0,46,50,50
1683366061488,CSE 11,A01,185416,Cao; Yingjun,0,92,10,10
1683366062516,CSE 20,A01,185445,Briones; Jor-el Thomas Caparas,5,0,25,20
1683366063544,CSE 21,A01,185447,Staff,10,0,50,40
1683366064568,CSE 101,A01,185451,Staff,0,13,50,50
1683366064568,CSE 101,B01,185453,Jones; Miles E,0,11,50,50
1683366066614,CSE 141,A01,185458,Eldon; John,20,0,100,80
1683366067638,CSE 141L,A01,185461,Eldon; John,12,0,100,88
1683366068666,CSE 142,A01,185463,Staff,36,0,60,24
1683366068666,CSE 142,B01,201355,Staff,0,7,60,60
1683366069691,CSE 142L,A01,185470,Staff,36,0,60,24
1683366069691,CSE 142L,B01,201417,Staff,0,6,60,60
1683366070715,CSE 190,A00,201433,Staff,32,0,49,17
1683366071741,DOC 1,A01,259136,Strom; Megan C.,7,0,15,8
1683366071741,DOC 1,A02,259137,Strom; Megan C.,14,0,15,1
1683366071741,DOC 1,A03,259138,Strom; Megan C.,14,0,15,1
1683366071741,DOC 1,A04,259139,Strom; Megan C.,14,0,15,1
1683366072770,DOC 100D,A00,259140,Pass; Natalye Joann,16,0,25,9
1683366073795,DSGN 1,A01,184749,Rill; Bryan,0,25,30,30
1683366074818,DSGN 100,A01,185168,Staff,0,2,25,25
1683366075842,ECE 5,A01,185626,Morris; Karcher William,0,10,0,0
1683366076865,ECE 101,A01,185628,Staff,17,0,70,53
1683366077893,ECE 107,A01,185635,Baghdadchi; Saharnaz,0,0,20,20
1683366077893,ECE 107,A02,185638,Baghdadchi; Saharnaz,4,0,20,16
1683366078917,ECE 148,A01,185647,Silberman; Jack,0,0,16,16
1683366079942,ECON 1,A01,185537,Crane; Meredith Helen,54,0,70,16
1683366080966,ECON 3,A01,185549,Crane; Meredith Helen,32,0,70,38
1683366081989,ECON 4,A01,203354,Anderson; John Charles,0,4,10,10
1683366083013,ECON 100A,A01,185574,Staff,0,4,40,40
1683366084042,ECON 100B,A01,185576,Staff,0,12,50,50
1683366085066,ECON 100C,A01,185589,Newhouse; Herbert S,29,0,70,41
1683366086092,ECON 105,A00,185608,Vespa; Emanuel Ignacio,19,0,35,16
1683366087119,ECON 109,A01,185610,Shishkin; Denis,10,0,35,25
1683366088143,ECON 110A,A01,185612,Staff,11,0,40,29
1683366089167,ECON 120A,A01,185615,Staff,20,0,40,20
1683366090193,ECON 120C,A01,185617,Sun; Yixiao,0,21,70,70
1683366091223,ECON 144,A00,203346,Squires; Dale E,3,0,35,32
1683366092250,ECON 171,A01,203349,Newhouse; Herbert S,0,1,35,35
1683366093275,ECON 173A,A01,185621,Toda; Alexis Akira,21,0,35,14
1683366094303,EDS 25,A01,202413,Staff,0,1,0,0
1683366094303,EDS 25,A02,202414,Staff,0,1,0,0
1683366094303,EDS 25,A03,202415,Staff,0,0,0,0
1683366094303,EDS 25,A04,202416,Staff,0,1,0,0
1683366094303,EDS 25,A05,202439,Staff,0,0,0,0
1683366094303,EDS 25,A06,202440,Staff,0,0,0,0
1683366094303,EDS 25,B01,202631,Staff,0,0,0,0
1683366094303,EDS 25,B02,202632,Staff,0,0,0,0
1683366094303,EDS 25,B03,202639,Staff,0,0,0,0
1683366094303,EDS 25,B04,202640,Staff,0,0,0,0
1683366094303,EDS 25,B05,202643,Staff,0,0,0,0
1683366094303,EDS 25,B06,202644,Staff,0,0,0,0
1683366095334,EDS 38,A01,202659,Black; Alison Michelle,24,0,25,1
1683366096359,EDS 115,A00,202652,Staff,18,0,30,12
1683366097384,EDS 125,A00,202649,Staff,14,0,30,16
1683366098407,EDS 126,A01,203332,Staff,30,0,30,0
1683366099431,EDS 139,A00,202838,Staff,16,0,25,9
1683366100456,EDS 146,A01,202655,Staff,14,0,25,11
1683366101484,ENG 15,A00,185667,Staff,0,1,0,0
1683366101484,ENG 15,B00,185672,Staff,0,0,0,0
1683366101484,ENG 15,C00,185675,Staff,0,0,0,0
1683366101484,ENG 15,D00,185682,Staff,0,0,0,0
1683366101484,ENG 15,E00,185684,Staff,0,0,0,0
1683366102511,ETHN 103,A00,185710,Staff,0,4,35,35
1683366103539,ETHN 103A,A00,199228,Man; Simeon S,2,0,9,7
1683366104564,ETHN 109,A00,185711,Staff,18,0,35,17
1683366105588,ETHN 142,A00,185726,Staff,0,4,30,30
1683366106613,ETHN 163J,A00,199229,Man; Simeon S,5,0,8,3
1683366107637,ETHN 168,A00,185727,Staff,8,0,10,2
1683366108661,ETHN 182,A00,185728,Staff,0,0,35,35
1683366109722,ETHN 183,A00,185737,Staff,8,0,18,10
1683366110747,GLBH 111,A01,209361,Burgos; Jose L.,0,0,0,0
1683366112803,HIEU 104,A00,185792,Staff,16,0,20,4
1683366113832,HIEU 115,A00,185800,Staff,1,0,20,19
1683366114863,HIEU 128,A00,185801,Staff,0,7,20,20
1683366115892,HIEU 147,A00,185802,Staff,16,0,20,4
1683366116918,HIEU 154,A00,185823,Staff,12,0,20,8
1683366117943,HILA 102,A00,185826,Staff,13,0,20,7
1683366118968,HILD 2C,A01,185778,Staff,0,12,20,20
1683366119992,HILD 7B,A01,185780,Kwak; Nancy,0,15,32,32
1683366119992,HILD 7B,A02,185781,Kwak; Nancy,0,18,32,32
1683366121017,HILD 30,A01,185791,Staff,14,0,20,6
1683366122045,HISC 119,A00,185830,Golan; Tal,0,9,20,20
1683366123071,HITO 156GS,A00,185831,Patterson; Patrick H.,0,0,0,23
1683366124099,HIUS 103,A00,185832,Man; Simeon S,1,6,20,19
1683366125127,HIUS 117,A00,185836,Kwak; Nancy,2,0,20,18
1683366126153,HIUS 125,A00,185840,Man; Simeon S,0,0,23,23
1683366127179,HIUS 149,A00,185845,Staff,0,0,20,20
1683366128206,HUM 3,A01,185882,Zavodny; Tatiana Sophia,0,7,50,50
1683366128206,HUM 3,B01,185899,Caldwell; Michael Alan,0,18,50,50
1683366129231,HUM 3GS,A00,185900,Patterson; Patrick H.,0,0,0,23
1683366130255,HUM 4,A01,185938,Zroka; Amy Liane,31,0,50,19
1683366130255,HUM 4,B01,185956,Watkins; Eric,0,3,50,50
1683366130255,HUM 4,B02,202209,Watkins; Eric,0,2,50,50
1683366130255,HUM 4,B03,202210,Watkins; Eric,0,2,50,50
1683366131281,HUM 5,A01,185958,West; Geoffrey Scott,3,0,50,47
1683366131281,HUM 5,A02,202215,West; Geoffrey Scott,0,0,50,50
1683366132310,INTL 190,A00,185959,Gagnon; Jeffrey C,0,0,0,9
1683366132310,INTL 190,B00,185960,Lettieri; Michael Joseph,0,0,0,1
1683366133337,JAPN 180,A00,254509,Staff,4,0,30,26
1683366134367,LATI 10,A01,202853,Kennemore; Amy Michelle,4,0,35,31
1683366134367,LATI 10,A02,202854,Kennemore; Amy Michelle,2,0,35,33
1683366134367,LATI 10,A03,270054,Kennemore; Amy Michelle,30,0,30,0
1683366135394,LATI 180,A00,202855,Kennemore; Amy Michelle,11,0,20,9
1683366136417,LAWS 101,A00,201767,Golan; Tal,0,7,40,40
1683366137442,LIFR 1C,A00,185961,Staff,6,0,20,14
1683366138468,LIFR 1CX,A00,185962,Staff,7,0,20,13
1683366139492,LIFR 1D,A00,185963,Staff,9,0,20,11
1683366140518,LIFR 1DX,A00,185964,Staff,9,0,20,11
1683366141544,LIGN 101,A01,186039,Staff,43,0,50,7
1683366142571,LIGN 165,A00,186040,Staff,18,0,50,32
1683366143599,LTCS 108,A00,186041,Staff,6,0,10,4
1683366144622,LTCS 119,A00,186042,Staff,16,0,20,4
1683366145647,LTCS 130,A00,186043,Wesling; Megan E.,15,0,25,10
1683366147701,LTEA 138,A00,186119,Staff,14,0,40,26
1683366148728,LTEN 124,A00,186148,Staff,6,0,25,19
1683366149756,LTEN 178,A00,186149,Staff,7,0,15,8
1683366150782,LTEN 181,A00,186150,Blanco; John D,33,0,40,7
1683366151806,LTWL 120,A00,186160,Staff,20,0,25,5
1683366152834,LTWL 165,A00,186161,Staff,22,0,25,3
1683366153861,LTWR 100,A00,186162,Staff,0,5,15,15
1683366154886,LTWR 102,A00,186163,Doller; Ben,5,0,15,10
1683366155910,MAE 8,A01,186412,Staff,0,0,0,0
1683366156936,MAE 30B,A00,186445,Bahadori; Mohammad Yousef,83,0,100,17
1683366157962,MAE 40,A00,186592,Bewley; Thomas R,10,0,50,40
1683366158987,MAE 101B,A00,186593,Bahadori; Mohammad Yousef,81,0,100,19
1683366160011,MAE 105,A00,186594,Bandaru; Prabhakar,12,0,50,38
1683366161092,MAE 107,A00,186599,Pham; Hieu Tan,0,7,120,120
1683366162116,MAE 148,A01,186660,Silberman; Jack,3,0,16,13
1683366163140,MATH 10A,A01,188095,Staff,0,5,35,35
1683366164171,MATH 10B,A01,188097,Bowers; Adam R.,0,11,30,30
1683366164171,MATH 10B,A02,188099,Bowers; Adam R.,0,11,30,30
1683366164171,MATH 10B,B01,188104,Bowers; Adam R.,0,10,30,30
1683366164171,MATH 10B,B02,188106,Bowers; Adam R.,0,10,30,30
1683366165202,MATH 10C,A01,188111,Staff,0,18,30,30
1683366165202,MATH 10C,A02,188127,Staff,0,17,30,30
1683366165202,MATH 10C,A03,188131,Staff,0,18,30,30
1683366165202,MATH 10C,B01,188218,Staff,18,0,30,12
1683366165202,MATH 10C,B02,188244,Staff,13,0,30,17
1683366165202,MATH 10C,B03,188277,Staff,16,0,30,14
1683366166229,MATH 18,A01,188344,Bach; Quang Tran,18,0,30,12
1683366166229,MATH 18,A02,188345,Bach; Quang Tran,11,0,30,19
1683366166229,MATH 18,B01,188353,Bach; Quang Tran,10,0,30,20
1683366166229,MATH 18,B02,188354,Bach; Quang Tran,20,0,30,10
1683366167256,MATH 20A,A01,188374,Staff,12,0,35,23
1683366168282,MATH 20B,A01,188382,Ohm; Ko Woon,6,0,30,24
1683366168282,MATH 20B,A02,188383,Ohm; Ko Woon,21,0,30,9
1683366168282,MATH 20B,B01,188385,Ohm; Ko Woon,7,0,30,23
1683366168282,MATH 20B,B02,188392,Ohm; Ko Woon,22,0,30,8
1683366169308,MATH 20C,A01,188394,Harel; Guershon,10,0,30,20
1683366169308,MATH 20C,A02,188395,Harel; Guershon,15,0,30,15
1683366169308,MATH 20C,B01,188404,Harel; Guershon,4,0,30,26
1683366169308,MATH 20C,B02,188405,Harel; Guershon,19,0,30,11
1683366170335,MATH 20D,A01,188414,Hammock; Frances H,0,1,30,30
1683366170335,MATH 20D,A02,188415,Hammock; Frances H,3,0,30,27
1683366170335,MATH 20D,B01,188447,Hammock; Frances H,1,0,30,29
1683366170335,MATH 20D,B02,188486,Hammock; Frances H,8,0,30,22
1683366171360,MATH 20E,A01,188649,Staff,21,0,30,9
1683366171360,MATH 20E,A02,188650,Staff,23,0,30,7
1683366171360,MATH 20E,A03,188673,Staff,0,0,30,30
1683366172385,MATH 102,A01,188675,Staff,0,35,35,35
1683366173411,MATH 103B,A01,188681,Staff,3,0,35,32
1683366173411,MATH 103B,B01,188692,Staff,5,0,35,30
1683366174435,MATH 109,A01,188695,Salehi Golsefidy; Alireza,25,0,35,10
1683366174435,MATH 109,A02,188696,Salehi Golsefidy; Alireza,25,0,35,10
1683366175459,MATH 120A,A01,188698,Eggers; John Dietrich,7,0,35,28
1683366176488,MATH 142B,A01,188736,Ioana; Adrian,0,2,30,30
1683366176488,MATH 142B,A02,188741,Ioana; Adrian,0,0,30,30
1683366176488,MATH 142B,A03,188743,Ioana; Adrian,0,1,30,30
1683366177515,MATH 168A,A01,188790,Staff,0,9,35,35
1683366178543,MATH 170A,A01,188803,Nie; Jiawang,0,2,35,35
1683366178543,MATH 170A,A02,188811,Nie; Jiawang,0,0,35,35
1683366178543,MATH 170A,A03,188814,Nie; Jiawang,1,0,35,34
1683366178543,MATH 170A,A04,188815,Nie; Jiawang,13,0,35,22
1683366179570,MATH 193B,A01,188817,Staff,0,0,35,35
1683366179570,MATH 193B,A02,188818,Staff,5,0,35,30
1683366180598,MGT 4,A01,202857,Anderson; John Charles,61,0,80,19
1683366181623,MGT 12,A00,202858,Lindenberger; Wade Douglas,41,0,90,49
1683366182648,MGT 18,A00,202859,Staff,74,0,90,16
1683366183675,MGT 18GS,A00,202860,McKay; Michael J,13,0,28,15
1683366184704,MGT 45,A00,202861,Pecore; Joseph P.,15,0,90,75
1683366185731,MGT 100,A00,202863,Yavorsky; Daniel Ryan,28,0,90,62
1683366186755,MGT 103,A00,202864,Ehrich; Kristine R,0,17,90,90
1683366187780,MGT 112,A00,202865,Ehrich; Kristine R,15,0,90,75
1683366188808,MGT 121A,A00,202868,Staff,0,20,0,0
1683366189835,MGT 131B,A00,202869,Anderson; John Charles,59,0,90,31
1683366190858,MGT 136,A00,202871,Lindenberger; Wade Douglas,84,0,90,6
1683366191884,MGT 164,A00,202873,Staff,0,68,90,91
1683366192911,MGT 164GS,A00,202874,McKay; Mary A,13,0,28,15
1683366193939,MGT 180,A00,202875,Staff,0,50,90,91
1683366194963,MMW 11R,A01,205019,Herbst; Matthew,3,0,30,27
1683366194963,MMW 11R,A02,205026,Herbst; Matthew,29,0,30,1
1683366195988,MMW 15,A01,193512,Chang; Edmond Yi-Teh,0,9,28,28
1683366195988,MMW 15,A02,193513,Chang; Edmond Yi-Teh,0,5,28,28
1683366195988,MMW 15,A03,193514,Chang; Edmond Yi-Teh,0,5,28,28
1683366195988,MMW 15,A04,193515,Chang; Edmond Yi-Teh,0,5,28,28
1683366195988,MMW 15,A05,193516,Chang; Edmond Yi-Teh,0,4,28,28
1683366195988,MMW 15,A06,193517,Chang; Edmond Yi-Teh,0,5,28,28
1683366195988,MMW 15,B01,193519,Chang; Edmond Yi-Teh,0,5,28,28
1683366195988,MMW 15,B02,193520,Chang; Edmond Yi-Teh,0,5,28,28
1683366195988,MMW 15,B03,193521,Chang; Edmond Yi-Teh,0,5,28,28
1683366195988,MMW 15,B04,193522,Chang; Edmond Yi-Teh,0,4,28,28
1683366195988,MMW 15,B05,193523,Chang; Edmond Yi-Teh,0,5,28,28
1683366195988,MMW 15,B06,193524,Chang; Edmond Yi-Teh,0,4,28,28
1683366197013,MMW 122,A01,193526,Rahimi; Babak,0,15,28,28
1683366197013,MMW 122,A02,193527,Rahimi; Babak,0,14,28,28
1683366197013,MMW 122,A03,193528,Rahimi; Babak,0,0,0,0
1683366197013,MMW 122,A04,193529,Rahimi; Babak,0,0,0,0
1683366198037,MUS 1A,A01,186663,Staff,0,20,35,35
1683366199064,MUS 4,A01,186715,Staff,0,12,35,35
1683366200088,MUS 5R,A01,186796,Dubnov; Shlomo,0,17,35,35
1683366201113,MUS 6,A01,186798,Staff,0,4,25,25
1683366202140,MUS 7,A01,186830,Staff,13,0,35,22
1683366203167,MUS 8,A01,186930,Staff,0,26,35,35
1683366204192,MUS 15,A01,186932,Staff,0,16,35,35
1683366204192,MUS 15,B01,186934,Staff,0,15,35,35
1683366205217,MUS 80,A00,186935,Staff,0,0,20,20
1683366205217,MUS 80,B00,186936,Staff,25,0,25,0
1683366206247,NANO 11,A00,204702,Lipomi; Darren John,0,0,0,0
1683366207273,NANO 15,A01,204709,Yang; Kesong,0,1,0,0
1683366208296,NANO 114,A00,202069,Jahed Motlagh; Zeinab,3,0,10,7
1683366209319,PHIL 1,A00,186955,Grush; Rick Scott,32,0,40,8
1683366210344,PHIL 10,A01,186973,Grush; Rick Scott,28,0,35,7
1683366210344,PHIL 10,A02,186974,Grush; Rick Scott,33,0,35,2
1683366211370,PHIL 13,A01,186976,Staff,7,0,35,28
1683366211370,PHIL 13,A02,186977,Staff,16,0,35,19
1683366212398,PHIL 14,A01,186979,Staff,31,0,35,4
1683366212398,PHIL 14,A02,186986,Staff,32,0,35,3
1683366213424,PHIL 28,A01,186988,Staff,16,0,30,14
1683366213424,PHIL 28,A02,186989,Staff,1,0,30,29
1683366213424,PHIL 28,A03,186990,Staff,9,0,30,21
1683366213424,PHIL 28,A04,186991,Staff,26,0,30,4
1683366214448,PHIL 120,A00,186997,Staff,23,0,40,17
1683366215474,PHIL 137,A00,187003,Staff,9,0,40,31
1683366216501,PHIL 150,A00,187015,Staff,47,0,70,23
1683366217532,PHIL 167,A00,187021,Lamey; Andy M.,35,0,40,5
1683366218562,PHIL 174,A01,202226,Staff,17,0,20,3
1683366218562,PHIL 174,A02,202235,Staff,20,0,20,0
1683366219589,PHIL 191A,A00,258918,Staff,0,0,1,1
1683366220613,PHYS 1A,A00,187028,Staff,27,0,60,33
1683366221639,PHYS 1AL,001,187036,Staff,2,0,30,28
1683366221639,PHYS 1AL,002,187049,Staff,18,0,30,12
1683366222667,PHYS 1B,A00,187058,Staff,22,0,60,38
1683366223750,PHYS 1BL,001,187064,Staff,0,0,30,30
1683366223750,PHYS 1BL,002,187070,Staff,5,0,30,25
1683366224778,PHYS 1C,A00,187082,Staff,31,0,120,89
1683366225805,PHYS 1CL,001,187088,Staff,0,9,30,30
1683366225805,PHYS 1CL,002,187089,Staff,0,2,30,30
1683366225805,PHYS 1CL,009,262693,Staff,11,0,30,19
1683366226830,PHYS 2B,A01,187097,Staff,54,0,115,61
1683366227853,PHYS 2C,A01,187099,Staff,67,0,115,48
1683366228877,PHYS 2CL,A01,187101,Staff,5,0,28,23
1683366228877,PHYS 2CL,A02,187102,Staff,15,0,28,13
1683366229902,PHYS 2D,A01,187123,Shotwell; Brian,95,0,115,20
1683366230926,PHYS 4B,A01,187133,Grinstein; Benjamin,35,0,50,15
1683366231952,POLI 10,A00,188819,Staff,0,4,50,50
1683366232976,POLI 11,A00,188827,Staff,43,0,50,7
1683366234002,POLI 13R,A00,188828,Staff,0,1,20,20
1683366235026,POLI 27,A01,188830,Elgin; Samuel Zincke,0,1,70,70
1683366236050,POLI 30,A00,188832,Desposato; Scott,31,0,50,19
1683366237079,POLI 102F,A00,188834,Staff,3,0,40,37
1683366238104,POLI 104A,A00,188852,Staff,14,0,30,16
1683366239128,POLI 104I,A00,188853,Staff,0,6,20,20
1683366240153,POLI 110B,A00,188854,Wiens; David,7,0,20,13
1683366241175,POLI 112A,A00,188855,Wiens; David,5,0,30,25
1683366242199,POLI 117R,A00,188856,Forman; Fonna,0,11,20,20
1683366243227,POLI 118,A00,188857,Ingham; Sean,8,0,20,12
1683366244251,POLI 120G,A00,188858,Staff,9,0,30,21
1683366245276,POLI 131CR,A00,188863,Hoston; Germaine,23,0,50,27
1683366246301,POLI 133,A00,188864,Nellis; Gareth Hb,44,0,50,6
1683366247326,POLI 134D,A00,188865,Desposato; Scott,27,0,30,3
1683366248354,POLI 142A,A00,188871,Gartzke; Erik,22,0,50,28
1683366249379,POLI 142K,A00,188874,Staff,38,0,50,12
1683366250407,POLI 143,A00,188940,Gartzke; Erik,16,0,30,14
1683366251430,POLI 153,A00,188943,Staff,3,0,20,17
1683366252457,POLI 160AA,A00,188944,Staff,11,0,40,29
1683366253482,POLI 170A,A00,188945,Staff,11,0,30,19
1683366255535,PSYC 1,A00,188952,Staff,37,0,90,53
1683366256564,PSYC 2,B00,188953,Staff,19,0,35,16
1683366257591,PSYC 6,A00,188970,Staff,47,0,60,13
1683366258618,PSYC 7,A00,188973,Staff,37,0,45,8
1683366259647,PSYC 60,A01,188980,Rickard; Timothy C.,43,0,60,17
1683366260677,PSYC 70,A01,189001,Steiner; Eric Tomas,23,0,45,22
1683366261705,PSYC 100,A00,189005,Lacefield; Katharine I,0,98,120,120
1683366262731,PSYC 102,A00,189008,Staff,9,0,30,21
1683366263758,PSYC 106,B00,189026,Gorman; Michael R.,34,0,60,26
1683366264842,PSYC 114,B01,189033,Winkielman; Piotr,0,32,30,30
1683366265866,PSYC 131,A00,189036,Anagnostaras; Stephan,0,43,60,60
1683366266890,PSYC 136,A00,189041,Lowe; Angela Beth,0,7,25,25
1683366267914,PSYC 137,A00,189057,Winkielman; Piotr,0,34,25,25
1683366268939,PSYC 144,A00,189107,Wixted; John T,0,7,50,50
1683366270985,PSYC 162,A00,189142,Staff,0,8,85,85
1683366272010,PSYC 172,A00,189144,Gorman; Michael R.,0,7,30,30
1683366274065,PSYC 179,A00,189146,Lacefield; Katharine I,0,84,120,120
1683366275094,PSYC 181,A00,189147,Anagnostaras; Stephan,0,44,90,90
1683366276119,PSYC 190R,A00,189148,Barner; David A.,0,22,80,80
1683366277142,PSYC 191,A00,189275,Rickard; Timothy C.,0,7,25,25
1683366278167,PSYC 193,A00,189276,Chapman; Eddie Nathaniel,0,1,0,4
1683366279193,PSYC 193L,A01,189281,Lowe; Angela Beth,12,0,20,8
1683366279193,PSYC 193L,B01,189285,Staff,28,0,35,7
1683366280221,RELI 149,A00,187137,Rahimi; Babak,7,0,40,33
1683366281247,SE 9,A01,187315,Staff,0,2,18,18
1683366282273,SE 101B,A00,187409,Staff,24,0,30,6
1683366283300,SE 110B,A00,187444,Staff,10,0,40,30
1683366284326,SE 130B,A00,187449,Staff,31,0,40,9
1683366285353,SE 150A,A00,187516,Staff,9,0,20,11
1683366286380,SE 154,A00,187528,Staff,30,0,50,20
1683366287404,SIO 3,A01,258171,Staff,35,0,40,5
1683366288429,SIO 10,A00,187144,Cook; Geoffrey W,0,3,75,75
1683366289454,SIO 45,A00,187152,Cook; Geoffrey W,1,0,100,99
1683366290481,SIO 109R,A00,194486,Staff,0,3,20,20
1683366292533,SIO 187,A01,187233,Kacev; David,12,0,40,28
1683366293557,SOCI 1,A01,258656,Thorpe; Charles Robert,28,0,30,2
1683366293557,SOCI 1,A02,258658,Thorpe; Charles Robert,30,0,30,0
1683366293557,SOCI 1,A03,258661,Thorpe; Charles Robert,25,0,25,0
1683366293557,SOCI 1,A04,258666,Thorpe; Charles Robert,22,0,25,3
1683366293557,SOCI 1,A05,258897,Thorpe; Charles Robert,23,0,25,2
1683366293557,SOCI 1,A06,258898,Thorpe; Charles Robert,25,0,25,0
1683366294584,SOCI 30,A01,258903,Pardo Guerra; Juan Pablo,15,0,30,15
1683366295614,SOCI 102,A00,258904,Staff,9,0,25,16
1683366296637,SOCI 106,A00,258905,Staff,19,0,25,6
1683366297667,SOCI 111,A00,258907,Ribas Norris; Janet Vanesa,26,0,30,4
1683366298694,SOCI 121R,A00,258908,Pardo Guerra; Juan Pablo,10,0,30,20
1683366299719,SOCI 126,A01,203330,Staff,14,0,20,6
1683366300742,SOCI 131,A00,258909,Thorpe; Charles Robert,31,0,60,29
1683366301769,SOCI 135,A00,258910,Payne; Christine Anna,0,9,30,30
1683366302794,SOCI 157,A00,258911,Staff,12,0,30,18
1683366303817,SOCI 184,A00,258912,Staff,25,0,30,5
1683366304844,SOCI 188D,A00,258913,Staff,22,0,30,8
1683366305871,SYN 2,001,187529,Staff,10,0,16,6
1683366305871,SYN 2,002,201452,Staff,0,18,16,16
1683366305871,SYN 2,003,201469,Staff,3,0,16,13
1683366306900,SYN 100,A01,187531,Staff,0,9,20,20
1683366306900,SYN 100,B01,201491,Staff,0,12,20,20
1683366307924,TDAC 1,A00,189286,Walsh; Kim C.,3,0,20,17
1683366307924,TDAC 1,B00,189287,Harting; Carla Kelso,11,0,20,9
1683366308948,TDAC 101,A00,189300,Walsh; Kim C.,16,0,20,4
1683366308948,TDAC 101,B00,189301,Harting; Carla Kelso,18,0,20,2
1683366309971,TDAC 102,A00,189304,Basso; Beatrice,14,0,20,6
1683366310996,TDAC 108,A00,189305,Staff,18,0,20,2
1683366312022,TDDE 131,A00,189310,Staff,19,0,20,1
1683366312022,TDDE 131,B00,189314,Staff,19,0,20,1
1683366312022,TDDE 131,C00,189315,Staff,48,0,50,2
1683366312022,TDDE 131,D00,189316,Staff,14,0,15,1
1683366312022,TDDE 131,E00,204841,Staff,20,0,20,0
1683366313045,TDGE 10,A00,189289,Staff,30,0,50,20
1683366313045,TDGE 10,B00,189290,Havis; Allan,1,0,50,49
1683366314069,TDGE 11,A00,189291,Fulton; Julia,0,3,50,50
1683366314069,TDGE 11,B00,189292,Staff,20,0,25,5
1683366314069,TDGE 11,C00,260270,Staff,0,0,0,0
1683366315093,TDGE 25,A00,189294,Staff,3,0,20,17
1683366316115,TDGE 124,A00,189318,Fulton; Julia,0,8,50,50
1683366317139,TDGE 125,A00,189319,Staff,13,0,25,12
1683366317139,TDGE 125,B00,189320,Staff,23,0,25,2
1683366318167,TDGE 127,A00,189322,Havis; Allan,0,0,50,50
1683366319193,TDHT 101,A00,189323,Staff,18,0,25,7
1683366319193,TDHT 101,B00,189324,Staff,25,0,25,0
1683366320220,TDHT 102,A00,189325,Staff,49,0,50,1
1683366321250,TDMV 1,A00,189295,Arcidiacono; Kristin,19,0,30,11
1683366321250,TDMV 1,B00,189296,Caligagan; Maria T.,24,0,30,6
1683366322278,TDMV 2,A00,189297,Sammartano; Tonnie,28,0,30,2
1683366322278,TDMV 2,B00,189299,Arcidiacono; Kristin,24,0,30,6
1683366323303,TDMV 3,A00,204998,Rincon; Alicia,22,0,30,8
1683366324332,TDMV 120,A00,189458,Sammartano; Tonnie,28,0,30,2
1683366325356,TDMV 138,A00,189541,Jun; Grace Shin Hae,22,0,40,18
1683366326381,TDMV 142,A00,189717,Caligagan; Tony,24,0,30,6
1683366326381,TDMV 142,B00,189718,Caligagan; Maria T.,25,0,30,5
1683366327404,TMC 2,A01,187533,Staff,25,0,25,0
1683366327404,TMC 2,A02,187534,Staff,25,0,25,0
1683366328431,USP 1,A01,187536,Kwak; Nancy,0,16,25,25
1683366329458,USP 5,A01,187538,Staff,10,0,25,15
1683366330485,USP 101,A00,199253,Staff,0,4,0,0
1683366331509,USP 124,A00,187562,Boomhower; Matthew Charles,1,0,30,29
1683366332533,USP 138,A00,187582,Staff,20,0,25,5
1683366333557,USP 152,A01,187597,Staff,4,0,25,21
1683366334583,USP 153,A00,187598,Staff,19,0,25,6
1683366335607,USP 168,A00,187607,Kwak; Nancy,2,0,5,3
1683366336630,USP 173,A00,187619,Staff,4,0,25,21
1683366337656,USP 181,A00,187638,Staff,0,3,25,25
1683366338682,VIS 103,A00,187650,Cruz; Edwin Teddy,22,0,75,53
1683366339705,VIS 110D,A00,187669,Staff,12,0,22,10
1683366340728,VIS 127C,A00,187720,Shen; Kuiyi,67,0,146,79
1683366341752,VIS 149,A00,187731,Yoldas; Pinar,0,14,22,22
1683366342776,VIS 151,A01,188091,Staff,22,0,34,12
1683366342776,VIS 151,A02,188092,Staff,11,0,34,23
1683366343803,VIS 160B,A00,188093,Stalbaum; Brett,0,0,10,10
1683366345862,WCWP 10B,A00,201720,Staff,10,0,15,5
1683366345862,WCWP 10B,B00,201722,Staff,9,0,15,6
1683366346886,WCWP 100,A00,201725,Gagnon; Jeffrey C,0,0,2,2
1683366346886,WCWP 100,B00,201727,Staff,0,4,15,15
1683366350006,ANBI 133,A00,258401,Wilder; Linnea Lorene,34,0,40,6
1683366351033,ANBI 140,A00,258395,Hrvoj Mihic; Branka,18,0,25,7
1683366352057,ANSC 120,A00,258402,Bialecki; Jon Anthony,27,0,40,13
1683366353084,ANSC 144,A00,258400,Staff,14,0,40,26
1683366355132,ANSC 166,A00,258396,Parish; Steven Martin,158,0,175,17
1683366356156,ANSC 180,A00,193533,Staff,9,0,20,11
1683366357180,ANSC 188,A00,258397,Jassal; Aftab,33,0,40,7
1683366358202,ANTH 3,A01,258316,Staff,23,0,30,7
1683366359226,ANTH 5,A00,258394,Semendeferi; Ekaterini,16,0,20,4
1683366360252,ANTH 21,A01,258331,Staff,8,0,40,32
1683366361279,ANTH 103,A00,258398,Varma; Saiba,15,0,25,10
1683366362314,AWP 10,001,202034,Staff,0,0,0,0
1683366362314,AWP 10,002,202035,Staff,0,0,0,0
1683366362314,AWP 10,003,202036,Staff,0,0,0,0
1683366362314,AWP 10,004,202037,Staff,0,0,0,0
1683366362314,AWP 10,005,202038,Staff,0,0,0,0
1683366362314,AWP 10,006,202039,Staff,0,0,0,0
1683366362314,AWP 10,007,202040,Staff,0,0,0,0
1683366362314,AWP 10,008,202041,Staff,0,0,0,0
1683366362314,AWP 10,009,202042,Staff,0,0,0,0
1683366362314,AWP 10,010,202043,Staff,0,0,0,0
1683366362314,AWP 10,011,202044,Staff,0,0,0,0
1683366362314,AWP 10,012,202045,Staff,0,0,0,0
1683366362314,AWP 10,013,202046,Staff,0,0,0,0
1683366362314,AWP 10,014,202047,Staff,0,0,0,0
1683366362314,AWP 10,015,202048,Staff,0,0,0,0
1683366362314,AWP 10,016,202049,Staff,0,0,0,0
1683366362314,AWP 10,017,202050,Staff,0,0,0,0
1683366362314,AWP 10,018,202051,Staff,0,0,0,0
1683366362314,AWP 10,019,202052,Staff,0,0,0,0
1683366362314,AWP 10,020,202053,Staff,0,0,0,0
1683366362314,AWP 10,021,202054,Staff,0,0,0,0
1683366362314,AWP 10,022,202055,Staff,0,0,0,0
1683366362314,AWP 10,023,202056,Staff,0,0,0,0
1683366362314,AWP 10,024,202057,Staff,0,0,0,0
1683366362314,AWP 10,025,202058,Staff,0,0,0,0
1683366362314,AWP 10,026,202059,Staff,0,0,0,0
1683366363339,AWP 102,001,202032,Staff,0,0,0,0
1683366363339,AWP 102,002,202033,Staff,0,0,0,0
1683366364365,BENG 100,A01,254234,Taylor Amos; Alyssa C,31,0,40,9
1683366365388,BENG 196,001,270013,Engler; Adam J.,9999,0,9999,0
1683366366413,BICD 100R,A01,202018,Smith; Laurie,0,7,32,32
1683366366413,BICD 100R,A02,202019,Smith; Laurie,0,2,32,32
1683366366413,BICD 100R,A03,202020,Smith; Laurie,0,1,32,32
1683366366413,BICD 100R,A04,202021,Smith; Laurie,9,0,32,23
1683366366413,BICD 100R,A05,202022,Smith; Laurie,12,0,32,20
1683366367436,BICD 136,A01,193242,Gustafson-Brown; Cindy,0,2,32,32
1683366367436,BICD 136,A02,193244,Gustafson-Brown; Cindy,14,0,32,18
1683366368521,BIEB 102,A01,193249,Butler; Shannon Rhey,0,2,32,32
1683366368521,BIEB 102,A02,193251,Butler; Shannon Rhey,0,0,32,32
1683366368521,BIEB 102,A03,193253,Butler; Shannon Rhey,0,1,32,32
1683366368521,BIEB 102,A04,193255,Butler; Shannon Rhey,17,0,32,15
1683366368521,BIEB 102,A05,193265,Butler; Shannon Rhey,26,0,32,6
1683366368521,BIEB 102,A06,193269,Butler; Shannon Rhey,16,0,32,16
1683366370575,BIEB 150,A01,193274,Staff,0,0,32,32
1683366370575,BIEB 150,A02,193285,Staff,23,0,32,9
1683366371602,BIEB 194,A00,193286,Kurle; Carolyn M.,22,0,32,10
1683366372632,BILD 1,A01,192291,Staff,16,0,32,16
1683366372632,BILD 1,A02,192292,Staff,30,0,32,2
1683366372632,BILD 1,B01,192520,Reuther; Keefe,0,1,0,0
1683366372632,BILD 1,B02,192532,Reuther; Keefe,0,1,0,0
1683366373662,BILD 3,A01,192556,Butler; Shannon Rhey,0,0,32,32
1683366373662,BILD 3,A02,192581,Butler; Shannon Rhey,4,0,32,28
1683366373662,BILD 3,A03,192611,Butler; Shannon Rhey,23,0,32,9
1683366373662,BILD 3,A04,192612,Butler; Shannon Rhey,25,0,32,7
1683366373662,BILD 3,A05,192613,Butler; Shannon Rhey,27,0,32,5
1683366373662,BILD 3,A06,192679,Butler; Shannon Rhey,27,0,32,5
1683366373662,BILD 3,A07,192682,Butler; Shannon Rhey,21,0,32,11
1683366374686,BILD 4,A01,192836,Reuther; Keefe,0,0,24,24
1683366374686,BILD 4,A02,193044,Reuther; Keefe,4,0,24,20
1683366375710,BILD 10,A01,193142,Gustafson-Brown; Cindy,30,0,32,2
1683366375710,BILD 10,A02,193149,Gustafson-Brown; Cindy,31,0,32,1
1683366376734,BIMM 100,A01,193301,Staff,1,6,32,31
1683366376734,BIMM 100,A02,193312,Staff,0,5,32,32
1683366376734,BIMM 100,A03,193323,Staff,0,8,32,32
1683366377760,BIMM 101,A01,193329,McDonnell; Lisa Marie,0,3,24,24
1683366377760,BIMM 101,A02,193339,McDonnell; Lisa Marie,0,3,24,24
1683366377760,BIMM 101,B01,193354,McDonnell; Lisa Marie,0,3,24,24
1683366377760,BIMM 101,B02,193357,McDonnell; Lisa Marie,0,3,24,24
1683366378784,BIMM 110,A01,193377,Tat; John,0,11,32,32
1683366378784,BIMM 110,A02,193378,Tat; John,0,9,32,32
1683366379808,BIMM 120,A01,206116,Staff,0,0,32,32
1683366379808,BIMM 120,A02,206117,Staff,8,0,32,24
1683366379808,BIMM 120,A03,206121,Staff,21,0,32,11
1683366380834,BIPN 100,A01,193393,Park; Ji Young,0,14,32,32
1683366380834,BIPN 100,A02,193402,Park; Ji Young,0,13,32,32
1683366380834,BIPN 100,A03,193413,Park; Ji Young,0,14,32,32
1683366380834,BIPN 100,A04,193414,Park; Ji Young,0,13,32,32
1683366381860,BIPN 102,A01,193429,Staff,0,0,32,32
1683366381860,BIPN 102,A02,193438,Staff,22,0,32,10
1683366382887,BIPN 106,A01,193450,Reyes Gonzalez; Catalina,0,2,40,40
1683366383917,BIPN 134,A01,193465,Cooke; James Edward,1,0,32,31
1683366383917,BIPN 134,A02,193474,Cooke; James Edward,25,0,32,7
1683366383917,BIPN 134,A03,193485,Cooke; James Edward,29,0,32,3
1683366383917,BIPN 134,A04,193486,Cooke; James Edward,21,0,32,11
1683366383917,BIPN 134,A05,193491,Cooke; James Edward,31,0,32,1
1683366383917,BIPN 134,A06,193501,Cooke; James Edward,30,0,32,2
1683366383917,BIPN 134,A07,193510,Cooke; James Edward,29,0,32,3
1683366385969,BISP 194,A00,222522,Staff,14,0,32,18
1683366386996,CAT 124,A01,202407,Staff,19,0,25,6
1683366388020,CAT 125,A00,202408,Marchisotto; Jennifer Anne,4,0,20,16
1683366389045,CAT 125R,A00,202409,Smith; Lauryn Alissa,0,11,20,20
1683366389045,CAT 125R,B00,202410,Morales; Celeste Georgianna,0,11,20,20
1683366389045,CAT 125R,C00,202411,Irwin; Matthew Joseph,0,10,20,20
1683366390074,CENG 15,A01,204712,Yang; Kesong,0,1,0,0
1683366391098,CENG 114,A00,202070,Jahed Motlagh; Zeinab,5,0,20,15
1683366392122,CGS 105,A00,185477,Wesling; Megan E.,24,0,40,16
1683366393149,CGS 106,A00,185494,Staff,13,0,22,9
1683366394172,CGS 108,A00,185495,Staff,14,0,20,6
1683366395195,CGS 114,A00,185496,Staff,13,0,18,5
1683366396221,CGS 119,A00,185501,Staff,15,0,20,5
1683366397245,CGS 120,A00,185511,Staff,13,0,20,7
1683366398271,CHEM 4,A01,184675,Bussey; Thomas J,96,0,100,4
1683366399298,CHEM 6A,A01,184677,Staff,34,0,60,26
1683366400325,CHEM 6B,A01,184679,Staff,65,0,100,35
1683366401355,CHEM 6C,A01,184681,Bussey; Thomas J,1,0,50,49
1683366401355,CHEM 6C,A02,184682,Bussey; Thomas J,34,0,50,16
1683366402379,CHEM 40A,A01,184684,Albizati; Kim F.,37,0,100,63
1683366403402,CHEM 40B,A01,184686,Albizati; Kim F.,0,20,100,100
1683366404429,CHEM 41B,A01,184690,Staff,52,0,100,48
1683366405455,COGS 3,A01,184715,Boyle; Mary E. T.,0,25,40,40
1683366406480,COGS 14B,A01,185172,Staff,0,15,38,38
1683366407508,COGS 18,A01,184736,Staff,16,0,80,64
1683366408532,COGS 100,A01,184932,Staff,0,5,73,73
1683366409557,COGS 101A,A01,184935,Staff,0,39,30,30
1683366410582,COGS 101B,A01,184944,Staff,0,2,30,30
1683366411606,COGS 101C,A01,184946,Staff,0,12,30,30
1683366412631,COGS 102A,A01,184951,Johnson; Christine M.,2,0,40,38
1683366413656,COGS 107B,A01,184953,Mooshagian; Eric Frederick,0,50,40,40
1683366414679,COGS 118B,A01,184959,Gupta; Anjum,0,48,40,40
1683366415703,COGS 153,A00,184961,Staff,0,15,30,30
1683366416726,COGS 177,A00,184962,Staff,0,20,30,30
1683366417750,COGS 187A,A01,184969,Boyle; Mary E. T.,0,17,40,40
1683366418775,COMM 10,A01,185174,Staff,0,5,25,25
1683366418775,COMM 10,A02,185189,Staff,0,5,25,25
1683366418775,COMM 10,A03,269821,Staff,0,0,0,0
1683366419803,COMM 100B,A01,185475,Staff,0,0,0,2
1683366419803,COMM 100B,A02,185476,Staff,13,0,25,12
1683366420830,COMM 100C,A01,185314,Staff,1,0,25,24
1683366420830,COMM 100C,A02,185327,Staff,19,0,25,6
1683366421856,COMM 110M,A00,185349,Staff,2,0,40,38
1683366422884,COMM 113T,A00,185352,Staff,24,0,40,16
1683366423913,COMM 114I,A00,185353,Staff,33,0,40,7
1683366424938,COMM 131,A00,185354,Staff,19,0,30,11
1683366425963,CSE 8A,A50,185358,Cao; Yingjun,0,46,10,10
1683366426987,CSE 8B,A01,185362,Staff,0,46,50,50
1683366428012,CSE 11,A01,185416,Cao; Yingjun,0,92,10,10
1683366429042,CSE 20,A01,185445,Briones; Jor-el Thomas Caparas,5,0,25,20
1683366430067,CSE 21,A01,185447,Staff,10,0,50,40
1683366431091,CSE 101,A01,185451,Staff,0,13,50,50
1683366431091,CSE 101,B01,185453,Jones; Miles E,0,11,50,50
1683366433140,CSE 141,A01,185458,Eldon; John,20,0,100,80
1683366434168,CSE 141L,A01,185461,Eldon; John,12,0,100,88
1683366435190,CSE 142,A01,185463,Staff,36,0,60,24
1683366435190,CSE 142,B01,201355,Staff,0,7,60,60
1683366436219,CSE 142L,A01,185470,Staff,36,0,60,24
1683366436219,CSE 142L,B01,201417,Staff,0,6,60,60
1683366437243,CSE 190,A00,201433,Staff,32,0,49,17
1683366438267,DOC 1,A01,259136,Strom; Megan C.,7,0,15,8
1683366438267,DOC 1,A02,259137,Strom; Megan C.,14,0,15,1
1683366438267,DOC 1,A03,259138,Strom; Megan C.,14,0,15,1
1683366438267,DOC 1,A04,259139,Strom; Megan C.,14,0,15,1
1683366439291,DOC 100D,A00,259140,Pass; Natalye Joann,16,0,25,9
1683366440317,DSGN 1,A01,184749,Rill; Bryan,0,25,30,30
1683366441340,DSGN 100,A01,185168,Staff,0,2,25,25
1683366442367,ECE 5,A01,185626,Morris; Karcher William,0,10,0,0
1683366443394,ECE 101,A01,185628,Staff,17,0,70,53
1683366444424,ECE 107,A01,185635,Baghdadchi; Saharnaz,0,0,20,20
1683366444424,ECE 107,A02,185638,Baghdadchi; Saharnaz,4,0,20,16
1683366445449,ECE 148,A01,185647,Silberman; Jack,0,0,16,16
1683366446474,ECON 1,A01,185537,Crane; Meredith Helen,54,0,70,16
1683366447499,ECON 3,A01,185549,Crane; Meredith Helen,32,0,70,38
1683366448523,ECON 4,A01,203354,Anderson; John Charles,0,4,10,10
1683366449548,ECON 100A,A01,185574,Staff,0,4,40,40
1683366450576,ECON 100B,A01,185576,Staff,0,12,50,50
1683366451602,ECON 100C,A01,185589,Newhouse; Herbert S,29,0,70,41
1683366452626,ECON 105,A00,185608,Vespa; Emanuel Ignacio,19,0,35,16
1683366453650,ECON 109,A01,185610,Shishkin; Denis,10,0,35,25
1683366454677,ECON 110A,A01,185612,Staff,11,0,40,29
1683366455704,ECON 120A,A01,185615,Staff,20,0,40,20
1683366456732,ECON 120C,A01,185617,Sun; Yixiao,0,21,70,70
1683366457758,ECON 144,A00,203346,Squires; Dale E,3,0,35,32
1683366458783,ECON 171,A01,203349,Newhouse; Herbert S,0,1,35,35
1683366459808,ECON 173A,A01,185621,Toda; Alexis Akira,21,0,35,14
1683366460834,EDS 25,A01,202413,Staff,0,1,0,0
1683366460834,EDS 25,A02,202414,Staff,0,1,0,0
1683366460834,EDS 25,A03,202415,Staff,0,0,0,0
1683366460834,EDS 25,A04,202416,Staff,0,1,0,0
1683366460834,EDS 25,A05,202439,Staff,0,0,0,0
1683366460834,EDS 25,A06,202440,Staff,0,0,0,0
1683366460834,EDS 25,B01,202631,Staff,0,0,0,0
1683366460834,EDS 25,B02,202632,Staff,0,0,0,0
1683366460834,EDS 25,B03,202639,Staff,0,0,0,0
1683366460834,EDS 25,B04,202640,Staff,0,0,0,0
1683366460834,EDS 25,B05,202643,Staff,0,0,0,0
1683366460834,EDS 25,B06,202644,Staff,0,0,0,0
1683366461862,EDS 38,A01,202659,Black; Alison Michelle,24,0,25,1
1683366462887,EDS 115,A00,202652,Staff,18,0,30,12
1683366463914,EDS 125,A00,202649,Staff,14,0,30,16
1683366464938,EDS 126,A01,203332,Staff,30,0,30,0
1683366465965,EDS 139,A00,202838,Staff,16,0,25,9
1683366466991,EDS 146,A01,202655,Staff,14,0,25,11
1683366468016,ENG 15,A00,185667,Staff,0,1,0,0
1683366468016,ENG 15,B00,185672,Staff,0,0,0,0
1683366468016,ENG 15,C00,185675,Staff,0,0,0,0
1683366468016,ENG 15,D00,185682,Staff,0,0,0,0
1683366468016,ENG 15,E00,185684,Staff,0,0,0,0
1683366469040,ETHN 103,A00,185710,Staff,0,4,35,35
1683366470066,ETHN 103A,A00,199228,Man; Simeon S,2,0,9,7
1683366471088,ETHN 109,A00,185711,Staff,18,0,35,17
1683366472168,ETHN 142,A00,185726,Staff,0,4,30,30
1683366473192,ETHN 163J,A00,199229,Man; Simeon S,5,0,8,3
1683366474216,ETHN 168,A00,185727,Staff,8,0,10,2
1683366475240,ETHN 182,A00,185728,Staff,0,0,35,35
1683366476265,ETHN 183,A00,185737,Staff,8,0,18,10
1683366477290,GLBH 111,A01,209361,Burgos; Jose L.,0,0,0,0
1683366479339,HIEU 104,A00,185792,Staff,16,0,20,4
1683366480363,HIEU 115,A00,185800,Staff,1,0,20,19
1683366481387,HIEU 128,A00,185801,Staff,0,7,20,20
1683366482410,HIEU 147,A00,185802,Staff,16,0,20,4
1683366483436,HIEU 154,A00,185823,Staff,12,0,20,8
1683366484459,HILA 102,A00,185826,Staff,13,0,20,7
1683366485488,HILD 2C,A01,185778,Staff,0,12,20,20
1683366486512,HILD 7B,A01,185780,Kwak; Nancy,0,15,32,32
1683366486512,HILD 7B,A02,185781,Kwak; Nancy,0,18,32,32
1683366487540,HILD 30,A01,185791,Staff,14,0,20,6
1683366488567,HISC 119,A00,185830,Golan; Tal,0,9,20,20
1683366489594,HITO 156GS,A00,185831,Patterson; Patrick H.,0,0,0,23
1683366490617,HIUS 103,A00,185832,Man; Simeon S,1,6,20,19
1683366491641,HIUS 117,A00,185836,Kwak; Nancy,2,0,20,18
1683366492665,HIUS 125,A00,185840,Man; Simeon S,0,0,23,23
1683366493690,HIUS 149,A00,185845,Staff,0,0,20,20
1683366494718,HUM 3,A01,185882,Zavodny; Tatiana Sophia,0,7,50,50
1683366494718,HUM 3,B01,185899,Caldwell; Michael Alan,0,18,50,50
1683366495744,HUM 3GS,A00,185900,Patterson; Patrick H.,0,0,0,23
1683366496772,HUM 4,A01,185938,Zroka; Amy Liane,31,0,50,19
1683366496772,HUM 4,B01,185956,Watkins; Eric,0,3,50,50
1683366496772,HUM 4,B02,202209,Watkins; Eric,0,2,50,50
1683366496772,HUM 4,B03,202210,Watkins; Eric,0,2,50,50
1683366497799,HUM 5,A01,185958,West; Geoffrey Scott,3,0,50,47
1683366497799,HUM 5,A02,202215,West; Geoffrey Scott,0,0,50,50
1683366498825,INTL 190,A00,185959,Gagnon; Jeffrey C,0,0,0,9
1683366498825,INTL 190,B00,185960,Lettieri; Michael Joseph,0,0,0,1
1683366499851,JAPN 180,A00,254509,Staff,4,0,30,26
1683366500875,LATI 10,A01,202853,Kennemore; Amy Michelle,4,0,35,31
1683366500875,LATI 10,A02,202854,Kennemore; Amy Michelle,2,0,35,33
1683366500875,LATI 10,A03,270054,Kennemore; Amy Michelle,30,0,30,0
1683366501902,LATI 180,A00,202855,Kennemore; Amy Michelle,11,0,20,9
1683366502929,LAWS 101,A00,201767,Golan; Tal,0,7,40,40
1683366503956,LIFR 1C,A00,185961,Staff,6,0,20,14
1683366504983,LIFR 1CX,A00,185962,Staff,7,0,20,13
1683366506018,LIFR 1D,A00,185963,Staff,9,0,20,11
1683366507046,LIFR 1DX,A00,185964,Staff,9,0,20,11
1683366508072,LIGN 101,A01,186039,Staff,43,0,50,7
1683366509102,LIGN 165,A00,186040,Staff,18,0,50,32
1683366510126,LTCS 108,A00,186041,Staff,6,0,10,4
1683366511150,LTCS 119,A00,186042,Staff,16,0,20,4
1683366512174,LTCS 130,A00,186043,Wesling; Megan E.,15,0,25,10
1683366514220,LTEA 138,A00,186119,Staff,14,0,40,26
1683366515245,LTEN 124,A00,186148,Staff,6,0,25,19
1683366516268,LTEN 178,A00,186149,Staff,7,0,15,8
1683366517291,LTEN 181,A00,186150,Blanco; John D,33,0,40,7
1683366518319,LTWL 120,A00,186160,Staff,20,0,25,5
1683366519347,LTWL 165,A00,186161,Staff,22,0,25,3
1683366520372,LTWR 100,A00,186162,Staff,0,5,15,15
1683366521397,LTWR 102,A00,186163,Doller; Ben,5,0,15,10
1683366522419,MAE 8,A01,186412,Staff,0,0,0,0
1683366523442,MAE 30B,A00,186445,Bahadori; Mohammad Yousef,83,0,100,17
1683366524465,MAE 40,A00,186592,Bewley; Thomas R,10,0,50,40
1683366525489,MAE 101B,A00,186593,Bahadori; Mohammad Yousef,81,0,100,19
1683366526516,MAE 105,A00,186594,Bandaru; Prabhakar,12,0,50,38
1683366527542,MAE 107,A00,186599,Pham; Hieu Tan,0,7,120,120
1683366528569,MAE 148,A01,186660,Silberman; Jack,3,0,16,13
1683366529598,MATH 10A,A01,188095,Staff,0,5,35,35
1683366530630,MATH 10B,A01,188097,Bowers; Adam R.,0,11,30,30
1683366530630,MATH 10B,A02,188099,Bowers; Adam R.,0,11,30,30
1683366530630,MATH 10B,B01,188104,Bowers; Adam R.,0,10,30,30
1683366530630,MATH 10B,B02,188106,Bowers; Adam R.,0,10,30,30
1683366531655,MATH 10C,A01,188111,Staff,0,18,30,30
1683366531655,MATH 10C,A02,188127,Staff,0,17,30,30
1683366531655,MATH 10C,A03,188131,Staff,0,18,30,30
1683366531655,MATH 10C,B01,188218,Staff,18,0,30,12
1683366531655,MATH 10C,B02,188244,Staff,13,0,30,17
1683366531655,MATH 10C,B03,188277,Staff,16,0,30,14
1683366532683,MATH 18,A01,188344,Bach; Quang Tran,18,0,30,12
1683366532683,MATH 18,A02,188345,Bach; Quang Tran,11,0,30,19
1683366532683,MATH 18,B01,188353,Bach; Quang Tran,10,0,30,20
1683366532683,MATH 18,B02,188354,Bach; Quang Tran,20,0,30,10
1683366533711,MATH 20A,A01,188374,Staff,12,0,35,23
1683366534738,MATH 20B,A01,188382,Ohm; Ko Woon,6,0,30,24
1683366534738,MATH 20B,A02,188383,Ohm; Ko Woon,21,0,30,9
1683366534738,MATH 20B,B01,188385,Ohm; Ko Woon,7,0,30,23
1683366534738,MATH 20B,B02,188392,Ohm; Ko Woon,22,0,30,8
1683366535766,MATH 20C,A01,188394,Harel; Guershon,10,0,30,20
1683366535766,MATH 20C,A02,188395,Harel; Guershon,15,0,30,15
1683366535766,MATH 20C,B01,188404,Harel; Guershon,4,0,30,26
1683366535766,MATH 20C,B02,188405,Harel; Guershon,19,0,30,11
1683366536792,MATH 20D,A01,188414,Hammock; Frances H,0,1,30,30
1683366536792,MATH 20D,A02,188415,Hammock; Frances H,3,0,30,27
1683366536792,MATH 20D,B01,188447,Hammock; Frances H,1,0,30,29
1683366536792,MATH 20D,B02,188486,Hammock; Frances H,8,0,30,22
1683366537821,MATH 20E,A01,188649,Staff,21,0,30,9
1683366537821,MATH 20E,A02,188650,Staff,23,0,30,7
1683366537821,MATH 20E,A03,188673,Staff,0,0,30,30
1683366538842,MATH 102,A01,188675,Staff,0,35,35,35
1683366539868,MATH 103B,A01,188681,Staff,3,0,35,32
1683366539868,MATH 103B,B01,188692,Staff,5,0,35,30
1683366540893,MATH 109,A01,188695,Salehi Golsefidy; Alireza,25,0,35,10
1683366540893,MATH 109,A02,188696,Salehi Golsefidy; Alireza,25,0,35,10
1683366541919,MATH 120A,A01,188698,Eggers; John Dietrich,7,0,35,28
1683366542946,MATH 142B,A01,188736,Ioana; Adrian,0,2,30,30
1683366542946,MATH 142B,A02,188741,Ioana; Adrian,0,0,30,30
1683366542946,MATH 142B,A03,188743,Ioana; Adrian,0,1,30,30
1683366543974,MATH 168A,A01,188790,Staff,0,9,35,35
1683366544998,MATH 170A,A01,188803,Nie; Jiawang,0,2,35,35
1683366544998,MATH 170A,A02,188811,Nie; Jiawang,0,0,35,35
1683366544998,MATH 170A,A03,188814,Nie; Jiawang,1,0,35,34
1683366544998,MATH 170A,A04,188815,Nie; Jiawang,13,0,35,22
1683366546022,MATH 193B,A01,188817,Staff,0,0,35,35
1683366546022,MATH 193B,A02,188818,Staff,5,0,35,30
1683366547046,MGT 4,A01,202857,Anderson; John Charles,61,0,80,19
1683366548070,MGT 12,A00,202858,Lindenberger; Wade Douglas,41,0,90,49
1683366549094,MGT 18,A00,202859,Staff,74,0,90,16
1683366550115,MGT 18GS,A00,202860,McKay; Michael J,13,0,28,15
1683366551139,MGT 45,A00,202861,Pecore; Joseph P.,15,0,90,75
1683366552168,MGT 100,A00,202863,Yavorsky; Daniel Ryan,28,0,90,62
1683366553191,MGT 103,A00,202864,Ehrich; Kristine R,0,17,90,90
1683366554222,MGT 112,A00,202865,Ehrich; Kristine R,15,0,90,75
1683366555249,MGT 121A,A00,202868,Staff,0,20,0,0
1683366556275,MGT 131B,A00,202869,Anderson; John Charles,59,0,90,31
1683366557299,MGT 136,A00,202871,Lindenberger; Wade Douglas,84,0,90,6
1683366558323,MGT 164,A00,202873,Staff,0,68,90,91
1683366559346,MGT 164GS,A00,202874,McKay; Mary A,13,0,28,15
1683366560370,MGT 180,A00,202875,Staff,0,50,90,91
1683366561393,MMW 11R,A01,205019,Herbst; Matthew,3,0,30,27
1683366561393,MMW 11R,A02,205026,Herbst; Matthew,29,0,30,1
1683366562422,MMW 15,A01,193512,Chang; Edmond Yi-Teh,0,9,28,28
1683366562422,MMW 15,A02,193513,Chang; Edmond Yi-Teh,0,5,28,28
1683366562422,MMW 15,A03,193514,Chang; Edmond Yi-Teh,0,5,28,28
1683366562422,MMW 15,A04,193515,Chang; Edmond Yi-Teh,0,5,28,28
1683366562422,MMW 15,A05,193516,Chang; Edmond Yi-Teh,0,4,28,28
1683366562422,MMW 15,A06,193517,Chang; Edmond Yi-Teh,0,5,28,28
1683366562422,MMW 15,B01,193519,Chang; Edmond Yi-Teh,0,5,28,28
1683366562422,MMW 15,B02,193520,Chang; Edmond Yi-Teh,0,5,28,28
1683366562422,MMW 15,B03,193521,Chang; Edmond Yi-Teh,0,5,28,28
1683366562422,MMW 15,B04,193522,Chang; Edmond Yi-Teh,0,4,28,28
1683366562422,MMW 15,B05,193523,Chang; Edmond Yi-Teh,0,5,28,28
1683366562422,MMW 15,B06,193524,Chang; Edmond Yi-Teh,0,4,28,28
1683366563448,MMW 122,A01,193526,Rahimi; Babak,0,15,28,28
1683366563448,MMW 122,A02,193527,Rahimi; Babak,0,14,28,28
1683366563448,MMW 122,A03,193528,Rahimi; Babak,0,0,0,0
1683366563448,MMW 122,A04,193529,Rahimi; Babak,0,0,0,0
1683366564476,MUS 1A,A01,186663,Staff,0,20,35,35
1683366565503,MUS 4,A01,186715,Staff,0,12,35,35
1683366566527,MUS 5R,A01,186796,Dubnov; Shlomo,0,17,35,35
1683366567548,MUS 6,A01,186798,Staff,0,4,25,25
1683366568575,MUS 7,A01,186830,Staff,13,0,35,22
1683366569602,MUS 8,A01,186930,Staff,0,26,35,35
1683366570630,MUS 15,A01,186932,Staff,0,16,35,35
1683366570630,MUS 15,B01,186934,Staff,0,15,35,35
1683366571658,MUS 80,A00,186935,Staff,0,0,20,20
1683366571658,MUS 80,B00,186936,Staff,25,0,25,0
1683366572681,NANO 11,A00,204702,Lipomi; Darren John,0,0,0,0
1683366573703,NANO 15,A01,204709,Yang; Kesong,0,1,0,0
1683366574729,NANO 114,A00,202069,Jahed Motlagh; Zeinab,3,0,10,7
1683366575808,PHIL 1,A00,186955,Grush; Rick Scott,32,0,40,8
1683366576832,PHIL 10,A01,186973,Grush; Rick Scott,28,0,35,7
1683366576832,PHIL 10,A02,186974,Grush; Rick Scott,33,0,35,2
1683366577856,PHIL 13,A01,186976,Staff,7,0,35,28
1683366577856,PHIL 13,A02,186977,Staff,16,0,35,19
1683366578879,PHIL 14,A01,186979,Staff,31,0,35,4
1683366578879,PHIL 14,A02,186986,Staff,32,0,35,3
1683366579907,PHIL 28,A01,186988,Staff,16,0,30,14
1683366579907,PHIL 28,A02,186989,Staff,1,0,30,29
1683366579907,PHIL 28,A03,186990,Staff,9,0,30,21
1683366579907,PHIL 28,A04,186991,Staff,26,0,30,4
1683366580932,PHIL 120,A00,186997,Staff,23,0,40,17
1683366581958,PHIL 137,A00,187003,Staff,9,0,40,31
1683366582986,PHIL 150,A00,187015,Staff,47,0,70,23
1683366584014,PHIL 167,A00,187021,Lamey; Andy M.,35,0,40,5
1683366585040,PHIL 174,A01,202226,Staff,17,0,20,3
1683366585040,PHIL 174,A02,202235,Staff,20,0,20,0
1683366586064,PHIL 191A,A00,258918,Staff,0,0,1,1
1683366587090,PHYS 1A,A00,187028,Staff,27,0,60,33
1683366588115,PHYS 1AL,001,187036,Staff,2,0,30,28
1683366588115,PHYS 1AL,002,187049,Staff,18,0,30,12
1683366589141,PHYS 1B,A00,187058,Staff,22,0,60,38
1683366590168,PHYS 1BL,001,187064,Staff,0,0,30,30
1683366590168,PHYS 1BL,002,187070,Staff,5,0,30,25
1683366591194,PHYS 1C,A00,187082,Staff,31,0,120,89
1683366592224,PHYS 1CL,001,187088,Staff,0,9,30,30
1683366592224,PHYS 1CL,002,187089,Staff,0,2,30,30
1683366592224,PHYS 1CL,009,262693,Staff,11,0,30,19
1683366593251,PHYS 2B,A01,187097,Staff,54,0,115,61
1683366594274,PHYS 2C,A01,187099,Staff,67,0,115,48
1683366595298,PHYS 2CL,A01,187101,Staff,5,0,28,23
1683366595298,PHYS 2CL,A02,187102,Staff,15,0,28,13
1683366596322,PHYS 2D,A01,187123,Shotwell; Brian,95,0,115,20
1683366597350,PHYS 4B,A01,187133,Grinstein; Benjamin,35,0,50,15
1683366598375,POLI 10,A00,188819,Staff,0,4,50,50
1683366599402,POLI 11,A00,188827,Staff,43,0,50,7
1683366600428,POLI 13R,A00,188828,Staff,0,1,20,20
1683366601462,POLI 27,A01,188830,Elgin; Samuel Zincke,0,1,70,70
1683366602487,POLI 30,A00,188832,Desposato; Scott,31,0,50,19
1683366603512,POLI 102F,A00,188834,Staff,3,0,40,37
1683366604535,POLI 104A,A00,188852,Staff,14,0,30,16
1683366605558,POLI 104I,A00,188853,Staff,0,6,20,20
1683366606583,POLI 110B,A00,188854,Wiens; David,7,0,20,13
1683366607610,POLI 112A,A00,188855,Wiens; David,5,0,30,25
1683366608634,POLI 117R,A00,188856,Forman; Fonna,0,11,20,20
1683366609658,POLI 118,A00,188857,Ingham; Sean,8,0,20,12
1683366610684,POLI 120G,A00,188858,Staff,9,0,30,21
1683366611714,POLI 131CR,A00,188863,Hoston; Germaine,23,0,50,27
1683366612741,POLI 133,A00,188864,Nellis; Gareth Hb,44,0,50,6
1683366613764,POLI 134D,A00,188865,Desposato; Scott,27,0,30,3
1683366614791,POLI 142A,A00,188871,Gartzke; Erik,22,0,50,28
1683366615818,POLI 142K,A00,188874,Staff,38,0,50,12
1683366616842,POLI 143,A00,188940,Gartzke; Erik,16,0,30,14
1683366617870,POLI 153,A00,188943,Staff,3,0,20,17
1683366618894,POLI 160AA,A00,188944,Staff,11,0,40,29
1683366619919,POLI 170A,A00,188945,Staff,11,0,30,19
1683366621966,PSYC 1,A00,188952,Staff,37,0,90,53
1683366622990,PSYC 2,B00,188953,Staff,19,0,35,16
1683366624013,PSYC 6,A00,188970,Staff,47,0,60,13
1683366625037,PSYC 7,A00,188973,Staff,37,0,45,8
1683366626064,PSYC 60,A01,188980,Rickard; Timothy C.,43,0,60,17
1683366627089,PSYC 70,A01,189001,Steiner; Eric Tomas,23,0,45,22
1683366628114,PSYC 100,A00,189005,Lacefield; Katharine I,0,98,120,120
1683366629138,PSYC 102,A00,189008,Staff,9,0,30,21
1683366630162,PSYC 106,B00,189026,Gorman; Michael R.,34,0,60,26
1683366631185,PSYC 114,B01,189033,Winkielman; Piotr,0,32,30,30
1683366632209,PSYC 131,A00,189036,Anagnostaras; Stephan,0,43,60,60
1683366633234,PSYC 136,A00,189041,Lowe; Angela Beth,0,7,25,25
1683366634262,PSYC 137,A00,189057,Winkielman; Piotr,0,34,25,25
1683366635288,PSYC 144,A00,189107,Wixted; John T,0,7,50,50
1683366637343,PSYC 162,A00,189142,Staff,0,8,85,85
1683366638370,PSYC 172,A00,189144,Gorman; Michael R.,0,7,30,30
1683366640414,PSYC 179,A00,189146,Lacefield; Katharine I,0,84,120,120
1683366641439,PSYC 181,A00,189147,Anagnostaras; Stephan,0,44,90,90
1683366642466,PSYC 190R,A00,189148,Barner; David A.,0,22,80,80
1683366643490,PSYC 191,A00,189275,Rickard; Timothy C.,0,7,25,25
1683366644514,PSYC 193,A00,189276,Chapman; Eddie Nathaniel,0,1,0,4
1683366645537,PSYC 193L,A01,189281,Lowe; Angela Beth,12,0,20,8
1683366645537,PSYC 193L,B01,189285,Staff,28,0,35,7
1683366646560,RELI 149,A00,187137,Rahimi; Babak,7,0,40,33
1683366647588,SE 9,A01,187315,Staff,0,2,18,18
1683366648614,SE 101B,A00,187409,Staff,24,0,30,6
1683366649642,SE 110B,A00,187444,Staff,10,0,40,30
1683366650671,SE 130B,A00,187449,Staff,31,0,40,9
1683366651696,SE 150A,A00,187516,Staff,9,0,20,11
1683366652719,SE 154,A00,187528,Staff,30,0,50,20
1683366653746,SIO 3,A01,258171,Staff,35,0,40,5
1683366654771,SIO 10,A00,187144,Cook; Geoffrey W,0,3,75,75
1683366655793,SIO 45,A00,187152,Cook; Geoffrey W,1,0,100,99
1683366656816,SIO 109R,A00,194486,Staff,0,3,20,20
1683366658864,SIO 187,A01,187233,Kacev; David,12,0,40,28
1683366659893,SOCI 1,A01,258656,Thorpe; Charles Robert,28,0,30,2
1683366659893,SOCI 1,A02,258658,Thorpe; Charles Robert,30,0,30,0
1683366659893,SOCI 1,A03,258661,Thorpe; Charles Robert,25,0,25,0
1683366659893,SOCI 1,A04,258666,Thorpe; Charles Robert,22,0,25,3
1683366659893,SOCI 1,A05,258897,Thorpe; Charles Robert,23,0,25,2
1683366659893,SOCI 1,A06,258898,Thorpe; Charles Robert,25,0,25,0
1683366660921,SOCI 30,A01,258903,Pardo Guerra; Juan Pablo,15,0,30,15
1683366661956,SOCI 102,A00,258904,Staff,9,0,25,16
1683366662979,SOCI 106,A00,258905,Staff,19,0,25,6
1683366664003,SOCI 111,A00,258907,Ribas Norris; Janet Vanesa,26,0,30,4
1683366665027,SOCI 121R,A00,258908,Pardo Guerra; Juan Pablo,10,0,30,20
1683366666051,SOCI 126,A01,203330,Staff,14,0,20,6
1683366667074,SOCI 131,A00,258909,Thorpe; Charles Robert,31,0,60,29
1683366668098,SOCI 135,A00,258910,Payne; Christine Anna,0,9,30,30
1683366669122,SOCI 157,A00,258911,Staff,12,0,30,18
1683366670146,SOCI 184,A00,258912,Staff,25,0,30,5
1683366671170,SOCI 188D,A00,258913,Staff,22,0,30,8
1683366672194,SYN 2,001,187529,Staff,10,0,16,6
1683366672194,SYN 2,002,201452,Staff,0,18,16,16
1683366672194,SYN 2,003,201469,Staff,3,0,16,13
1683366673218,SYN 100,A01,187531,Staff,0,9,20,20
1683366673218,SYN 100,B01,201491,Staff,0,12,20,20
1683366674241,TDAC 1,A00,189286,Walsh; Kim C.,3,0,20,17
1683366674241,TDAC 1,B00,189287,Harting; Carla Kelso,11,0,20,9
1683366675267,TDAC 101,A00,189300,Walsh; Kim C.,16,0,20,4
1683366675267,TDAC 101,B00,189301,Harting; Carla Kelso,18,0,20,2
1683366676293,TDAC 102,A00,189304,Basso; Beatrice,14,0,20,6
1683366677319,TDAC 108,A00,189305,Staff,18,0,20,2
1683366678346,TDDE 131,A00,189310,Staff,19,0,20,1
1683366678346,TDDE 131,B00,189314,Staff,19,0,20,1
1683366678346,TDDE 131,C00,189315,Staff,48,0,50,2
1683366678346,TDDE 131,D00,189316,Staff,14,0,15,1
1683366678346,TDDE 131,E00,204841,Staff,20,0,20,0
1683366679444,TDGE 10,A00,189289,Staff,30,0,50,20
1683366679444,TDGE 10,B00,189290,Havis; Allan,1,0,50,49
1683366680472,TDGE 11,A00,189291,Fulton; Julia,0,3,50,50
1683366680472,TDGE 11,B00,189292,Staff,20,0,25,5
1683366680472,TDGE 11,C00,260270,Staff,0,0,0,0
1683366681499,TDGE 25,A00,189294,Staff,3,0,20,17
1683366682522,TDGE 124,A00,189318,Fulton; Julia,0,8,50,50
1683366683547,TDGE 125,A00,189319,Staff,13,0,25,12
1683366683547,TDGE 125,B00,189320,Staff,23,0,25,2
1683366684574,TDGE 127,A00,189322,Havis; Allan,0,0,50,50
1683366685599,TDHT 101,A00,189323,Staff,18,0,25,7
1683366685599,TDHT 101,B00,189324,Staff,25,0,25,0
1683366686622,TDHT 102,A00,189325,Staff,49,0,50,1
1683366687650,TDMV 1,A00,189295,Arcidiacono; Kristin,19,0,30,11
1683366687650,TDMV 1,B00,189296,Caligagan; Maria T.,24,0,30,6
1683366688678,TDMV 2,A00,189297,Sammartano; Tonnie,28,0,30,2
1683366688678,TDMV 2,B00,189299,Arcidiacono; Kristin,24,0,30,6
1683366689701,TDMV 3,A00,204998,Rincon; Alicia,22,0,30,8
1683366690732,TDMV 120,A00,189458,Sammartano; Tonnie,28,0,30,2
1683366691755,TDMV 138,A00,189541,Jun; Grace Shin Hae,22,0,40,18
1683366692783,TDMV 142,A00,189717,Caligagan; Tony,24,0,30,6
1683366692783,TDMV 142,B00,189718,Caligagan; Maria T.,25,0,30,5
1683366693810,TMC 2,A01,187533,Staff,25,0,25,0
1683366693810,TMC 2,A02,187534,Staff,25,0,25,0
1683366694834,USP 1,A01,187536,Kwak; Nancy,0,16,25,25
1683366695862,USP 5,A01,187538,Staff,10,0,25,15
1683366696886,USP 101,A00,199253,Staff,0,4,0,0
1683366697910,USP 124,A00,187562,Boomhower; Matthew Charles,1,0,30,29
1683366698933,USP 138,A00,187582,Staff,20,0,25,5
1683366699957,USP 152,A01,187597,Staff,4,0,25,21
1683366700981,USP 153,A00,187598,Staff,19,0,25,6
1683366702004,USP 168,A00,187607,Kwak; Nancy,2,0,5,3
1683366703028,USP 173,A00,187619,Staff,4,0,25,21
1683366704051,USP 181,A00,187638,Staff,0,3,25,25
1683366705076,VIS 103,A00,187650,Cruz; Edwin Teddy,22,0,75,53
1683366706101,VIS 110D,A00,187669,Staff,12,0,22,10
1683366707128,VIS 127C,A00,187720,Shen; Kuiyi,67,0,146,79
1683366708152,VIS 149,A00,187731,Yoldas; Pinar,0,14,22,22
1683366709177,VIS 151,A01,188091,Staff,22,0,34,12
1683366709177,VIS 151,A02,188092,Staff,11,0,34,23
1683366710205,VIS 160B,A00,188093,Stalbaum; Brett,0,0,10,10
1683366712255,WCWP 10B,A00,201720,Staff,10,0,15,5
1683366712255,WCWP 10B,B00,201722,Staff,9,0,15,6
1683366713279,WCWP 100,A00,201725,Gagnon; Jeffrey C,0,0,2,2
1683366713279,WCWP 100,B00,201727,Staff,0,4,15,15
1683366716416,ANBI 133,A00,258401,Wilder; Linnea Lorene,34,0,40,6
1683366717444,ANBI 140,A00,258395,Hrvoj Mihic; Branka,18,0,25,7
1683366718472,ANSC 120,A00,258402,Bialecki; Jon Anthony,27,0,40,13
1683366719496,ANSC 144,A00,258400,Staff,14,0,40,26
1683366721546,ANSC 166,A00,258396,Parish; Steven Martin,158,0,175,17
1683366722574,ANSC 180,A00,193533,Staff,9,0,20,11
1683366723599,ANSC 188,A00,258397,Jassal; Aftab,33,0,40,7
1683366724627,ANTH 3,A01,258316,Staff,23,0,30,7
1683366725652,ANTH 5,A00,258394,Semendeferi; Ekaterini,16,0,20,4
1683366726676,ANTH 21,A01,258331,Staff,8,0,40,32
1683366727700,ANTH 103,A00,258398,Varma; Saiba,15,0,25,10
1683366728729,AWP 10,001,202034,Staff,0,0,0,0
1683366728729,AWP 10,002,202035,Staff,0,0,0,0
1683366728729,AWP 10,003,202036,Staff,0,0,0,0
1683366728729,AWP 10,004,202037,Staff,0,0,0,0
1683366728729,AWP 10,005,202038,Staff,0,0,0,0
1683366728729,AWP 10,006,202039,Staff,0,0,0,0
1683366728729,AWP 10,007,202040,Staff,0,0,0,0
1683366728729,AWP 10,008,202041,Staff,0,0,0,0
1683366728729,AWP 10,009,202042,Staff,0,0,0,0
1683366728729,AWP 10,010,202043,Staff,0,0,0,0
1683366728729,AWP 10,011,202044,Staff,0,0,0,0
1683366728729,AWP 10,012,202045,Staff,0,0,0,0
1683366728729,AWP 10,013,202046,Staff,0,0,0,0
1683366728729,AWP 10,014,202047,Staff,0,0,0,0
1683366728729,AWP 10,015,202048,Staff,0,0,0,0
1683366728729,AWP 10,016,202049,Staff,0,0,0,0
1683366728729,AWP 10,017,202050,Staff,0,0,0,0
1683366728729,AWP 10,018,202051,Staff,0,0,0,0
1683366728729,AWP 10,019,202052,Staff,0,0,0,0
1683366728729,AWP 10,020,202053,Staff,0,0,0,0
1683366728729,AWP 10,021,202054,Staff,0,0,0,0
1683366728729,AWP 10,022,202055,Staff,0,0,0,0
1683366728729,AWP 10,023,202056,Staff,0,0,0,0
1683366728729,AWP 10,024,202057,Staff,0,0,0,0
1683366728729,AWP 10,025,202058,Staff,0,0,0,0
1683366728729,AWP 10,026,202059,Staff,0,0,0,0
1683366729755,AWP 102,001,202032,Staff,0,0,0,0
1683366729755,AWP 102,002,202033,Staff,0,0,0,0
1683366730778,BENG 100,A01,254234,Taylor Amos; Alyssa C,31,0,40,9
1683366731805,BENG 196,001,270013,Engler; Adam J.,9999,0,9999,0
1683366732835,BICD 100R,A01,202018,Smith; Laurie,0,7,32,32
1683366732835,BICD 100R,A02,202019,Smith; Laurie,0,2,32,32
1683366732835,BICD 100R,A03,202020,Smith; Laurie,0,1,32,32
1683366732835,BICD 100R,A04,202021,Smith; Laurie,9,0,32,23
1683366732835,BICD 100R,A05,202022,Smith; Laurie,12,0,32,20
1683366733862,BICD 136,A01,193242,Gustafson-Brown; Cindy,0,2,32,32
1683366733862,BICD 136,A02,193244,Gustafson-Brown; Cindy,14,0,32,18
1683366734890,BIEB 102,A01,193249,Butler; Shannon Rhey,0,2,32,32
1683366734890,BIEB 102,A02,193251,Butler; Shannon Rhey,0,0,32,32
1683366734890,BIEB 102,A03,193253,Butler; Shannon Rhey,0,1,32,32
1683366734890,BIEB 102,A04,193255,Butler; Shannon Rhey,17,0,32,15
1683366734890,BIEB 102,A05,193265,Butler; Shannon Rhey,26,0,32,6
1683366734890,BIEB 102,A06,193269,Butler; Shannon Rhey,16,0,32,16
1683366736944,BIEB 150,A01,193274,Staff,0,0,32,32
1683366736944,BIEB 150,A02,193285,Staff,23,0,32,9
1683366737969,BIEB 194,A00,193286,Kurle; Carolyn M.,22,0,32,10
1683366738994,BILD 1,A01,192291,Staff,16,0,32,16
1683366738994,BILD 1,A02,192292,Staff,30,0,32,2
1683366738994,BILD 1,B01,192520,Reuther; Keefe,0,1,0,0
1683366738994,BILD 1,B02,192532,Reuther; Keefe,0,1,0,0
1683366740025,BILD 3,A01,192556,Butler; Shannon Rhey,0,0,32,32
1683366740025,BILD 3,A02,192581,Butler; Shannon Rhey,4,0,32,28
1683366740025,BILD 3,A03,192611,Butler; Shannon Rhey,23,0,32,9
1683366740025,BILD 3,A04,192612,Butler; Shannon Rhey,25,0,32,7
1683366740025,BILD 3,A05,192613,Butler; Shannon Rhey,27,0,32,5
1683366740025,BILD 3,A06,192679,Butler; Shannon Rhey,27,0,32,5
1683366740025,BILD 3,A07,192682,Butler; Shannon Rhey,21,0,32,11
1683366741053,BILD 4,A01,192836,Reuther; Keefe,0,0,24,24
1683366741053,BILD 4,A02,193044,Reuther; Keefe,4,0,24,20
1683366742077,BILD 10,A01,193142,Gustafson-Brown; Cindy,30,0,32,2
1683366742077,BILD 10,A02,193149,Gustafson-Brown; Cindy,31,0,32,1
1683366743103,BIMM 100,A01,193301,Staff,1,6,32,31
1683366743103,BIMM 100,A02,193312,Staff,0,5,32,32
1683366743103,BIMM 100,A03,193323,Staff,0,8,32,32
1683366744128,BIMM 101,A01,193329,McDonnell; Lisa Marie,0,3,24,24
1683366744128,BIMM 101,A02,193339,McDonnell; Lisa Marie,0,3,24,24
1683366744128,BIMM 101,B01,193354,McDonnell; Lisa Marie,0,3,24,24
1683366744128,BIMM 101,B02,193357,McDonnell; Lisa Marie,0,3,24,24
1683366745153,BIMM 110,A01,193377,Tat; John,0,11,32,32
1683366745153,BIMM 110,A02,193378,Tat; John,0,9,32,32
1683366746181,BIMM 120,A01,206116,Staff,0,0,32,32
1683366746181,BIMM 120,A02,206117,Staff,8,0,32,24
1683366746181,BIMM 120,A03,206121,Staff,21,0,32,11
1683366747206,BIPN 100,A01,193393,Park; Ji Young,0,14,32,32
1683366747206,BIPN 100,A02,193402,Park; Ji Young,0,13,32,32
1683366747206,BIPN 100,A03,193413,Park; Ji Young,0,14,32,32
1683366747206,BIPN 100,A04,193414,Park; Ji Young,0,13,32,32
1683366748230,BIPN 102,A01,193429,Staff,0,0,32,32
1683366748230,BIPN 102,A02,193438,Staff,22,0,32,10
1683366749256,BIPN 106,A01,193450,Reyes Gonzalez; Catalina,0,2,40,40
1683366750282,BIPN 134,A01,193465,Cooke; James Edward,1,0,32,31
1683366750282,BIPN 134,A02,193474,Cooke; James Edward,25,0,32,7
1683366750282,BIPN 134,A03,193485,Cooke; James Edward,29,0,32,3
1683366750282,BIPN 134,A04,193486,Cooke; James Edward,21,0,32,11
1683366750282,BIPN 134,A05,193491,Cooke; James Edward,31,0,32,1
1683366750282,BIPN 134,A06,193501,Cooke; James Edward,30,0,32,2
1683366750282,BIPN 134,A07,193510,Cooke; James Edward,29,0,32,3
1683366752333,BISP 194,A00,222522,Staff,14,0,32,18
1683366753357,CAT 124,A01,202407,Staff,19,0,25,6
1683366754384,CAT 125,A00,202408,Marchisotto; Jennifer Anne,4,0,20,16
1683366755409,CAT 125R,A00,202409,Smith; Lauryn Alissa,0,11,20,20
1683366755409,CAT 125R,B00,202410,Morales; Celeste Georgianna,0,11,20,20
1683366755409,CAT 125R,C00,202411,Irwin; Matthew Joseph,0,10,20,20
1683366756434,CENG 15,A01,204712,Yang; Kesong,0,1,0,0
1683366757457,CENG 114,A00,202070,Jahed Motlagh; Zeinab,5,0,20,15
1683366758481,CGS 105,A00,185477,Wesling; Megan E.,24,0,40,16
1683366759505,CGS 106,A00,185494,Staff,13,0,22,9
1683366760530,CGS 108,A00,185495,Staff,14,0,20,6
1683366761557,CGS 114,A00,185496,Staff,13,0,18,5
1683366762584,CGS 119,A00,185501,Staff,15,0,20,5
1683366763610,CGS 120,A00,185511,Staff,13,0,20,7
1683366764634,CHEM 4,A01,184675,Bussey; Thomas J,96,0,100,4
1683366765657,CHEM 6A,A01,184677,Staff,34,0,60,26
1683366766682,CHEM 6B,A01,184679,Staff,65,0,100,35
1683366767706,CHEM 6C,A01,184681,Bussey; Thomas J,1,0,50,49
1683366767706,CHEM 6C,A02,184682,Bussey; Thomas J,34,0,50,16
1683366768736,CHEM 40A,A01,184684,Albizati; Kim F.,37,0,100,63
1683366769763,CHEM 40B,A01,184686,Albizati; Kim F.,0,20,100,100
1683366770792,CHEM 41B,A01,184690,Staff,52,0,100,48
1683366771819,COGS 3,A01,184715,Boyle; Mary E. T.,0,25,40,40
1683366772847,COGS 14B,A01,185172,Staff,0,15,38,38
1683366773874,COGS 18,A01,184736,Staff,16,0,80,64
1683366774898,COGS 100,A01,184932,Staff,0,5,73,73
1683366775926,COGS 101A,A01,184935,Staff,0,39,30,30
1683366776954,COGS 101B,A01,184944,Staff,0,2,30,30
1683366777980,COGS 101C,A01,184946,Staff,0,12,30,30
1683366779008,COGS 102A,A01,184951,Johnson; Christine M.,2,0,40,38
1683366780049,COGS 107B,A01,184953,Mooshagian; Eric Frederick,0,50,40,40
1683366781073,COGS 118B,A01,184959,Gupta; Anjum,0,48,40,40
1683366782101,COGS 153,A00,184961,Staff,0,15,30,30
1683366783189,COGS 177,A00,184962,Staff,0,20,30,30
1683366784216,COGS 187A,A01,184969,Boyle; Mary E. T.,0,17,40,40
1683366785241,COMM 10,A01,185174,Staff,0,5,25,25
1683366785241,COMM 10,A02,185189,Staff,0,5,25,25
1683366785241,COMM 10,A03,269821,Staff,0,0,0,0
1683366786265,COMM 100B,A01,185475,Staff,0,0,0,2
1683366786265,COMM 100B,A02,185476,Staff,13,0,25,12
1683366787289,COMM 100C,A01,185314,Staff,1,0,25,24
1683366787289,COMM 100C,A02,185327,Staff,19,0,25,6
1683366788317,COMM 110M,A00,185349,Staff,2,0,40,38
1683366789342,COMM 113T,A00,185352,Staff,24,0,40,16
1683366790366,COMM 114I,A00,185353,Staff,33,0,40,7
1683366791390,COMM 131,A00,185354,Staff,19,0,30,11
1683366792415,CSE 8A,A50,185358,Cao; Yingjun,0,46,10,10
1683366793438,CSE 8B,A01,185362,Staff,0,46,50,50
1683366794461,CSE 11,A01,185416,Cao; Yingjun,0,92,10,10
1683366795485,CSE 20,A01,185445,Briones; Jor-el Thomas Caparas,5,0,25,20
1683366796510,CSE 21,A01,185447,Staff,10,0,50,40
1683366797535,CSE 101,A01,185451,Staff,0,13,50,50
1683366797535,CSE 101,B01,185453,Jones; Miles E,0,11,50,50
1683366799592,CSE 141,A01,185458,Eldon; John,20,0,100,80
1683366800621,CSE 141L,A01,185461,Eldon; John,12,0,100,88
1683366801647,CSE 142,A01,185463,Staff,36,0,60,24
1683366801647,CSE 142,B01,201355,Staff,0,7,60,60
1683366802671,CSE 142L,A01,185470,Staff,36,0,60,24
1683366802671,CSE 142L,B01,201417,Staff,0,6,60,60
1683366803695,CSE 190,A00,201433,Staff,32,0,49,17
1683366804721,DOC 1,A01,259136,Strom; Megan C.,7,0,15,8
1683366804721,DOC 1,A02,259137,Strom; Megan C.,14,0,15,1
1683366804721,DOC 1,A03,259138,Strom; Megan C.,14,0,15,1
1683366804721,DOC 1,A04,259139,Strom; Megan C.,14,0,15,1
1683366805745,DOC 100D,A00,259140,Pass; Natalye Joann,16,0,25,9
1683366806770,DSGN 1,A01,184749,Rill; Bryan,0,25,30,30
1683366807800,DSGN 100,A01,185168,Staff,0,2,25,25
1683366808825,ECE 5,A01,185626,Morris; Karcher William,0,10,0,0
1683366809849,ECE 101,A01,185628,Staff,17,0,70,53
1683366810877,ECE 107,A01,185635,Baghdadchi; Saharnaz,0,0,20,20
1683366810877,ECE 107,A02,185638,Baghdadchi; Saharnaz,4,0,20,16
1683366811904,ECE 148,A01,185647,Silberman; Jack,0,0,16,16
1683366812928,ECON 1,A01,185537,Crane; Meredith Helen,54,0,70,16
1683366813953,ECON 3,A01,185549,Crane; Meredith Helen,32,0,70,38
1683366814981,ECON 4,A01,203354,Anderson; John Charles,0,4,10,10
1683366816009,ECON 100A,A01,185574,Staff,0,4,40,40
1683366817036,ECON 100B,A01,185576,Staff,0,12,50,50
1683366818065,ECON 100C,A01,185589,Newhouse; Herbert S,29,0,70,41
1683366819091,ECON 105,A00,185608,Vespa; Emanuel Ignacio,19,0,35,16
1683366820119,ECON 109,A01,185610,Shishkin; Denis,10,0,35,25
1683366821142,ECON 110A,A01,185612,Staff,11,0,40,29
1683366822166,ECON 120A,A01,185615,Staff,20,0,40,20
1683366823190,ECON 120C,A01,185617,Sun; Yixiao,0,21,70,70
1683366824214,ECON 144,A00,203346,Squires; Dale E,3,0,35,32
1683366825239,ECON 171,A01,203349,Newhouse; Herbert S,0,1,35,35
1683366826264,ECON 173A,A01,185621,Toda; Alexis Akira,21,0,35,14
1683366827294,EDS 25,A01,202413,Staff,0,1,0,0
1683366827294,EDS 25,A02,202414,Staff,0,1,0,0
1683366827294,EDS 25,A03,202415,Staff,0,0,0,0
1683366827294,EDS 25,A04,202416,Staff,0,1,0,0
1683366827294,EDS 25,A05,202439,Staff,0,0,0,0
1683366827294,EDS 25,A06,202440,Staff,0,0,0,0
1683366827294,EDS 25,B01,202631,Staff,0,0,0,0
1683366827294,EDS 25,B02,202632,Staff,0,0,0,0
1683366827294,EDS 25,B03,202639,Staff,0,0,0,0
1683366827294,EDS 25,B04,202640,Staff,0,0,0,0
1683366827294,EDS 25,B05,202643,Staff,0,0,0,0
1683366827294,EDS 25,B06,202644,Staff,0,0,0,0
1683366828318,EDS 38,A01,202659,Black; Alison Michelle,24,0,25,1
1683366829344,EDS 115,A00,202652,Staff,18,0,30,12
1683366830371,EDS 125,A00,202649,Staff,14,0,30,16
1683366831402,EDS 126,A01,203332,Staff,30,0,30,0
1683366832425,EDS 139,A00,202838,Staff,16,0,25,9
1683366833451,EDS 146,A01,202655,Staff,14,0,25,11
1683366834478,ENG 15,A00,185667,Staff,0,1,0,0
1683366834478,ENG 15,B00,185672,Staff,0,0,0,0
1683366834478,ENG 15,C00,185675,Staff,0,0,0,0
1683366834478,ENG 15,D00,185682,Staff,0,0,0,0
1683366834478,ENG 15,E00,185684,Staff,0,0,0,0
1683366835502,ETHN 103,A00,185710,Staff,0,4,35,35
1683366836531,ETHN 103A,A00,199228,Man; Simeon S,2,0,9,7
1683366837558,ETHN 109,A00,185711,Staff,18,0,35,17
1683366838580,ETHN 142,A00,185726,Staff,0,4,30,30
1683366839604,ETHN 163J,A00,199229,Man; Simeon S,5,0,8,3
1683366840628,ETHN 168,A00,185727,Staff,8,0,10,2
1683366841654,ETHN 182,A00,185728,Staff,0,0,35,35
1683366842683,ETHN 183,A00,185737,Staff,8,0,18,10
1683366843710,GLBH 111,A01,209361,Burgos; Jose L.,0,0,0,0
1683366845759,HIEU 104,A00,185792,Staff,16,0,20,4
1683366846783,HIEU 115,A00,185800,Staff,1,0,20,19
1683366847807,HIEU 128,A00,185801,Staff,0,7,20,20
1683366848831,HIEU 147,A00,185802,Staff,16,0,20,4
1683366849855,HIEU 154,A00,185823,Staff,12,0,20,8
1683366850879,HILA 102,A00,185826,Staff,13,0,20,7
1683366851903,HILD 2C,A01,185778,Staff,0,12,20,20
1683366852927,HILD 7B,A01,185780,Kwak; Nancy,0,15,32,32
1683366852927,HILD 7B,A02,185781,Kwak; Nancy,0,18,32,32
1683366853952,HILD 30,A01,185791,Staff,14,0,20,6
1683366854981,HISC 119,A00,185830,Golan; Tal,0,9,20,20
1683366856007,HITO 156GS,A00,185831,Patterson; Patrick H.,0,0,0,23
1683366857034,HIUS 103,A00,185832,Man; Simeon S,1,6,20,19
1683366858057,HIUS 117,A00,185836,Kwak; Nancy,2,0,20,18
1683366859081,HIUS 125,A00,185840,Man; Simeon S,0,0,23,23
1683366860104,HIUS 149,A00,185845,Staff,0,0,20,20
1683366861134,HUM 3,A01,185882,Zavodny; Tatiana Sophia,0,7,50,50
1683366861134,HUM 3,B01,185899,Caldwell; Michael Alan,0,18,50,50
1683366862162,HUM 3GS,A00,185900,Patterson; Patrick H.,0,0,0,23
1683366863190,HUM 4,A01,185938,Zroka; Amy Liane,31,0,50,19
1683366863190,HUM 4,B01,185956,Watkins; Eric,0,3,50,50
1683366863190,HUM 4,B02,202209,Watkins; Eric,0,2,50,50
1683366863190,HUM 4,B03,202210,Watkins; Eric,0,2,50,50
1683366864218,HUM 5,A01,185958,West; Geoffrey Scott,3,0,50,47
1683366864218,HUM 5,A02,202215,West; Geoffrey Scott,0,0,50,50
1683366865244,INTL 190,A00,185959,Gagnon; Jeffrey C,0,0,0,9
1683366865244,INTL 190,B00,185960,Lettieri; Michael Joseph,0,0,0,1
1683366866270,JAPN 180,A00,254509,Staff,4,0,30,26
1683366867294,LATI 10,A01,202853,Kennemore; Amy Michelle,4,0,35,31
1683366867294,LATI 10,A02,202854,Kennemore; Amy Michelle,2,0,35,33
1683366867294,LATI 10,A03,270054,Kennemore; Amy Michelle,30,0,30,0
1683366868317,LATI 180,A00,202855,Kennemore; Amy Michelle,11,0,20,9
1683366869342,LAWS 101,A00,201767,Golan; Tal,0,7,40,40
1683366870366,LIFR 1C,A00,185961,Staff,6,0,20,14
1683366871390,LIFR 1CX,A00,185962,Staff,7,0,20,13
1683366872413,LIFR 1D,A00,185963,Staff,9,0,20,11
1683366873440,LIFR 1DX,A00,185964,Staff,9,0,20,11
1683366874464,LIGN 101,A01,186039,Staff,43,0,50,7
1683366875490,LIGN 165,A00,186040,Staff,18,0,50,32
1683366876518,LTCS 108,A00,186041,Staff,6,0,10,4
1683366877552,LTCS 119,A00,186042,Staff,16,0,20,4
1683366878580,LTCS 130,A00,186043,Wesling; Megan E.,15,0,25,10
1683366880630,LTEA 138,A00,186119,Staff,14,0,40,26
1683366881654,LTEN 124,A00,186148,Staff,6,0,25,19
1683366882678,LTEN 178,A00,186149,Staff,7,0,15,8
1683366883701,LTEN 181,A00,186150,Blanco; John D,33,0,40,7
1683366884727,LTWL 120,A00,186160,Staff,20,0,25,5
1683366885755,LTWL 165,A00,186161,Staff,22,0,25,3
1683366886832,LTWR 100,A00,186162,Staff,0,5,15,15
1683366887856,LTWR 102,A00,186163,Doller; Ben,5,0,15,10
1683366888880,MAE 8,A01,186412,Staff,0,0,0,0
1683366889903,MAE 30B,A00,186445,Bahadori; Mohammad Yousef,83,0,100,17
1683366890926,MAE 40,A00,186592,Bewley; Thomas R,10,0,50,40
1683366891953,MAE 101B,A00,186593,Bahadori; Mohammad Yousef,81,0,100,19
1683366892976,MAE 105,A00,186594,Bandaru; Prabhakar,12,0,50,38
1683366894000,MAE 107,A00,186599,Pham; Hieu Tan,0,7,120,120
1683366895025,MAE 148,A01,186660,Silberman; Jack,3,0,16,13
1683366896052,MATH 10A,A01,188095,Staff,0,5,35,35
1683366897076,MATH 10B,A01,188097,Bowers; Adam R.,0,11,30,30
1683366897076,MATH 10B,A02,188099,Bowers; Adam R.,0,11,30,30
1683366897076,MATH 10B,B01,188104,Bowers; Adam R.,0,10,30,30
1683366897076,MATH 10B,B02,188106,Bowers; Adam R.,0,10,30,30
1683366898104,MATH 10C,A01,188111,Staff,0,18,30,30
1683366898104,MATH 10C,A02,188127,Staff,0,17,30,30
1683366898104,MATH 10C,A03,188131,Staff,0,18,30,30
1683366898104,MATH 10C,B01,188218,Staff,18,0,30,12
1683366898104,MATH 10C,B02,188244,Staff,13,0,30,17
1683366898104,MATH 10C,B03,188277,Staff,16,0,30,14
1683366899128,MATH 18,A01,188344,Bach; Quang Tran,18,0,30,12
1683366899128,MATH 18,A02,188345,Bach; Quang Tran,11,0,30,19
1683366899128,MATH 18,B01,188353,Bach; Quang Tran,10,0,30,20
1683366899128,MATH 18,B02,188354,Bach; Quang Tran,20,0,30,10
1683366900155,MATH 20A,A01,188374,Staff,12,0,35,23
1683366901183,MATH 20B,A01,188382,Ohm; Ko Woon,6,0,30,24
1683366901183,MATH 20B,A02,188383,Ohm; Ko Woon,21,0,30,9
1683366901183,MATH 20B,B01,188385,Ohm; Ko Woon,7,0,30,23
1683366901183,MATH 20B,B02,188392,Ohm; Ko Woon,22,0,30,8
1683366902213,MATH 20C,A01,188394,Harel; Guershon,10,0,30,20
1683366902213,MATH 20C,A02,188395,Harel; Guershon,15,0,30,15
1683366902213,MATH 20C,B01,188404,Harel; Guershon,4,0,30,26
1683366902213,MATH 20C,B02,188405,Harel; Guershon,19,0,30,11
1683366903237,MATH 20D,A01,188414,Hammock; Frances H,0,1,30,30
1683366903237,MATH 20D,A02,188415,Hammock; Frances H,3,0,30,27
1683366903237,MATH 20D,B01,188447,Hammock; Frances H,1,0,30,29
1683366903237,MATH 20D,B02,188486,Hammock; Frances H,8,0,30,22
1683366904260,MATH 20E,A01,188649,Staff,21,0,30,9
1683366904260,MATH 20E,A02,188650,Staff,23,0,30,7
1683366904260,MATH 20E,A03,188673,Staff,0,0,30,30
1683366905284,MATH 102,A01,188675,Staff,0,35,35,35
1683366906308,MATH 103B,A01,188681,Staff,3,0,35,32
1683366906308,MATH 103B,B01,188692,Staff,5,0,35,30
1683366907332,MATH 109,A01,188695,Salehi Golsefidy; Alireza,25,0,35,10
1683366907332,MATH 109,A02,188696,Salehi Golsefidy; Alireza,25,0,35,10
1683366908359,MATH 120A,A01,188698,Eggers; John Dietrich,7,0,35,28
1683366909388,MATH 142B,A01,188736,Ioana; Adrian,0,2,30,30
1683366909388,MATH 142B,A02,188741,Ioana; Adrian,0,0,30,30
1683366909388,MATH 142B,A03,188743,Ioana; Adrian,0,1,30,30
1683366910410,MATH 168A,A01,188790,Staff,0,9,35,35
1683366911436,MATH 170A,A01,188803,Nie; Jiawang,0,2,35,35
1683366911436,MATH 170A,A02,188811,Nie; Jiawang,0,0,35,35
1683366911436,MATH 170A,A03,188814,Nie; Jiawang,1,0,35,34
1683366911436,MATH 170A,A04,188815,Nie; Jiawang,13,0,35,22
1683366912462,MATH 193B,A01,188817,Staff,0,0,35,35
1683366912462,MATH 193B,A02,188818,Staff,5,0,35,30
1683366913486,MGT 4,A01,202857,Anderson; John Charles,61,0,80,19
1683366914512,MGT 12,A00,202858,Lindenberger; Wade Douglas,41,0,90,49
1683366915539,MGT 18,A00,202859,Staff,74,0,90,16
1683366916564,MGT 18GS,A00,202860,McKay; Michael J,13,0,28,15
1683366917589,MGT 45,A00,202861,Pecore; Joseph P.,15,0,90,75
1683366918611,MGT 100,A00,202863,Yavorsky; Daniel Ryan,28,0,90,62
1683366919635,MGT 103,A00,202864,Ehrich; Kristine R,0,17,90,90
1683366920659,MGT 112,A00,202865,Ehrich; Kristine R,15,0,90,75
1683366921683,MGT 121A,A00,202868,Staff,0,20,0,0
1683366922710,MGT 131B,A00,202869,Anderson; John Charles,59,0,90,31
1683366923738,MGT 136,A00,202871,Lindenberger; Wade Douglas,84,0,90,6
1683366924764,MGT 164,A00,202873,Staff,0,68,90,91
1683366925787,MGT 164GS,A00,202874,McKay; Mary A,13,0,28,15
1683366926810,MGT 180,A00,202875,Staff,0,50,90,91
1683366927833,MMW 11R,A01,205019,Herbst; Matthew,3,0,30,27
1683366927833,MMW 11R,A02,205026,Herbst; Matthew,29,0,30,1
1683366928858,MMW 15,A01,193512,Chang; Edmond Yi-Teh,0,9,28,28
1683366928858,MMW 15,A02,193513,Chang; Edmond Yi-Teh,0,5,28,28
1683366928858,MMW 15,A03,193514,Chang; Edmond Yi-Teh,0,5,28,28
1683366928858,MMW 15,A04,193515,Chang; Edmond Yi-Teh,0,5,28,28
1683366928858,MMW 15,A05,193516,Chang; Edmond Yi-Teh,0,4,28,28
1683366928858,MMW 15,A06,193517,Chang; Edmond Yi-Teh,0,5,28,28
1683366928858,MMW 15,B01,193519,Chang; Edmond Yi-Teh,0,5,28,28
1683366928858,MMW 15,B02,193520,Chang; Edmond Yi-Teh,0,5,28,28
1683366928858,MMW 15,B03,193521,Chang; Edmond Yi-Teh,0,5,28,28
1683366928858,MMW 15,B04,193522,Chang; Edmond Yi-Teh,0,4,28,28
1683366928858,MMW 15,B05,193523,Chang; Edmond Yi-Teh,0,5,28,28
1683366928858,MMW 15,B06,193524,Chang; Edmond Yi-Teh,0,4,28,28
1683366929882,MMW 122,A01,193526,Rahimi; Babak,0,15,28,28
1683366929882,MMW 122,A02,193527,Rahimi; Babak,0,14,28,28
1683366929882,MMW 122,A03,193528,Rahimi; Babak,0,0,0,0
1683366929882,MMW 122,A04,193529,Rahimi; Babak,0,0,0,0
1683366930909,MUS 1A,A01,186663,Staff,0,20,35,35
1683366931936,MUS 4,A01,186715,Staff,0,12,35,35
1683366932960,MUS 5R,A01,186796,Dubnov; Shlomo,0,17,35,35
1683366933986,MUS 6,A01,186798,Staff,0,4,25,25
1683366935010,MUS 7,A01,186830,Staff,13,0,35,22
1683366936036,MUS 8,A01,186930,Staff,0,26,35,35
1683366937061,MUS 15,A01,186932,Staff,0,16,35,35
1683366937061,MUS 15,B01,186934,Staff,0,15,35,35
1683366938084,MUS 80,A00,186935,Staff,0,0,20,20
1683366938084,MUS 80,B00,186936,Staff,25,0,25,0
1683366939111,NANO 11,A00,204702,Lipomi; Darren John,0,0,0,0
1683366940135,NANO 15,A01,204709,Yang; Kesong,0,1,0,0
1683366941163,NANO 114,A00,202069,Jahed Motlagh; Zeinab,3,0,10,7
1683366942190,PHIL 1,A00,186955,Grush; Rick Scott,32,0,40,8
1683366943214,PHIL 10,A01,186973,Grush; Rick Scott,28,0,35,7
1683366943214,PHIL 10,A02,186974,Grush; Rick Scott,33,0,35,2
1683366944239,PHIL 13,A01,186976,Staff,7,0,35,28
1683366944239,PHIL 13,A02,186977,Staff,16,0,35,19
1683366945266,PHIL 14,A01,186979,Staff,31,0,35,4
1683366945266,PHIL 14,A02,186986,Staff,32,0,35,3
1683366946292,PHIL 28,A01,186988,Staff,16,0,30,14
1683366946292,PHIL 28,A02,186989,Staff,1,0,30,29
1683366946292,PHIL 28,A03,186990,Staff,9,0,30,21
1683366946292,PHIL 28,A04,186991,Staff,26,0,30,4
1683366947319,PHIL 120,A00,186997,Staff,23,0,40,17
1683366948346,PHIL 137,A00,187003,Staff,9,0,40,31
1683366949369,PHIL 150,A00,187015,Staff,47,0,70,23
1683366950396,PHIL 167,A00,187021,Lamey; Andy M.,35,0,40,5
1683366951421,PHIL 174,A01,202226,Staff,17,0,20,3
1683366951421,PHIL 174,A02,202235,Staff,20,0,20,0
1683366952445,PHIL 191A,A00,258918,Staff,0,0,1,1
1683366953468,PHYS 1A,A00,187028,Staff,27,0,60,33
1683366954492,PHYS 1AL,001,187036,Staff,2,0,30,28
1683366954492,PHYS 1AL,002,187049,Staff,18,0,30,12
1683366955516,PHYS 1B,A00,187058,Staff,22,0,60,38
1683366956540,PHYS 1BL,001,187064,Staff,0,0,30,30
1683366956540,PHYS 1BL,002,187070,Staff,5,0,30,25
1683366957565,PHYS 1C,A00,187082,Staff,31,0,120,89
1683366958589,PHYS 1CL,001,187088,Staff,0,9,30,30
1683366958589,PHYS 1CL,002,187089,Staff,0,2,30,30
1683366958589,PHYS 1CL,009,262693,Staff,11,0,30,19
1683366959616,PHYS 2B,A01,187097,Staff,54,0,115,61
1683366960643,PHYS 2C,A01,187099,Staff,67,0,115,48
1683366961672,PHYS 2CL,A01,187101,Staff,5,0,28,23
1683366961672,PHYS 2CL,A02,187102,Staff,15,0,28,13
1683366962701,PHYS 2D,A01,187123,Shotwell; Brian,95,0,115,20
1683366963726,PHYS 4B,A01,187133,Grinstein; Benjamin,35,0,50,15
1683366964750,POLI 10,A00,188819,Staff,0,4,50,50
1683366965774,POLI 11,A00,188827,Staff,43,0,50,7
1683366966799,POLI 13R,A00,188828,Staff,0,1,20,20
1683366967824,POLI 27,A01,188830,Elgin; Samuel Zincke,0,1,70,70
1683366968848,POLI 30,A00,188832,Desposato; Scott,31,0,50,19
1683366969871,POLI 102F,A00,188834,Staff,2,0,40,38
1683366970898,POLI 104A,A00,188852,Staff,14,0,30,16
1683366971922,POLI 104I,A00,188853,Staff,0,6,20,20
1683366972947,POLI 110B,A00,188854,Wiens; David,7,0,20,13
1683366973971,POLI 112A,A00,188855,Wiens; David,5,0,30,25
1683366974997,POLI 117R,A00,188856,Forman; Fonna,0,11,20,20
1683366976022,POLI 118,A00,188857,Ingham; Sean,8,0,20,12
1683366977045,POLI 120G,A00,188858,Staff,9,0,30,21
1683366978068,POLI 131CR,A00,188863,Hoston; Germaine,23,0,50,27
1683366979090,POLI 133,A00,188864,Nellis; Gareth Hb,44,0,50,6
1683366980118,POLI 134D,A00,188865,Desposato; Scott,27,0,30,3
1683366981145,POLI 142A,A00,188871,Gartzke; Erik,22,0,50,28
1683366982169,POLI 142K,A00,188874,Staff,38,0,50,12
1683366983193,POLI 143,A00,188940,Gartzke; Erik,16,0,30,14
1683366984215,POLI 153,A00,188943,Staff,3,0,20,17
1683366985240,POLI 160AA,A00,188944,Staff,11,0,40,29
1683366986264,POLI 170A,A00,188945,Staff,11,0,30,19
1683366988317,PSYC 1,A00,188952,Staff,37,0,90,53
1683366989342,PSYC 2,B00,188953,Staff,19,0,35,16
1683366990425,PSYC 6,A00,188970,Staff,47,0,60,13
1683366991448,PSYC 7,A00,188973,Staff,37,0,45,8
1683366992475,PSYC 60,A01,188980,Rickard; Timothy C.,43,0,60,17
1683366993502,PSYC 70,A01,189001,Steiner; Eric Tomas,23,0,45,22
1683366994530,PSYC 100,A00,189005,Lacefield; Katharine I,0,98,120,120
1683366995557,PSYC 102,A00,189008,Staff,9,0,30,21
1683366996580,PSYC 106,B00,189026,Gorman; Michael R.,34,0,60,26
1683366997603,PSYC 114,B01,189033,Winkielman; Piotr,0,32,30,30
1683366998626,PSYC 131,A00,189036,Anagnostaras; Stephan,0,43,60,60
1683366999650,PSYC 136,A00,189041,Lowe; Angela Beth,0,7,25,25
1683367000673,PSYC 137,A00,189057,Winkielman; Piotr,0,34,25,25
1683367001698,PSYC 144,A00,189107,Wixted; John T,0,7,50,50
1683367003752,PSYC 162,A00,189142,Staff,0,8,85,85
1683367004779,PSYC 172,A00,189144,Gorman; Michael R.,0,7,30,30
1683367006829,PSYC 179,A00,189146,Lacefield; Katharine I,0,84,120,120
1683367007852,PSYC 181,A00,189147,Anagnostaras; Stephan,0,44,90,90
1683367008879,PSYC 190R,A00,189148,Barner; David A.,0,22,80,80
1683367009905,PSYC 191,A00,189275,Rickard; Timothy C.,0,7,25,25
1683367010930,PSYC 193,A00,189276,Chapman; Eddie Nathaniel,0,1,0,4
1683367011959,PSYC 193L,A01,189281,Lowe; Angela Beth,12,0,20,8
1683367011959,PSYC 193L,B01,189285,Staff,28,0,35,7
1683367012988,RELI 149,A00,187137,Rahimi; Babak,7,0,40,33
1683367014017,SE 9,A01,187315,Staff,0,2,18,18
1683367015041,SE 101B,A00,187409,Staff,24,0,30,6
1683367016066,SE 110B,A00,187444,Staff,10,0,40,30
1683367017091,SE 130B,A00,187449,Staff,31,0,40,9
1683367018115,SE 150A,A00,187516,Staff,9,0,20,11
1683367019139,SE 154,A00,187528,Staff,30,0,50,20
1683367020169,SIO 3,A01,258171,Staff,35,0,40,5
1683367021195,SIO 10,A00,187144,Cook; Geoffrey W,0,3,75,75
1683367022222,SIO 45,A00,187152,Cook; Geoffrey W,1,0,100,99
1683367023250,SIO 109R,A00,194486,Staff,0,3,20,20
1683367025298,SIO 187,A01,187233,Kacev; David,12,0,40,28
1683367026322,SOCI 1,A01,258656,Thorpe; Charles Robert,28,0,30,2
1683367026322,SOCI 1,A02,258658,Thorpe; Charles Robert,30,0,30,0
1683367026322,SOCI 1,A03,258661,Thorpe; Charles Robert,25,0,25,0
1683367026322,SOCI 1,A04,258666,Thorpe; Charles Robert,22,0,25,3
1683367026322,SOCI 1,A05,258897,Thorpe; Charles Robert,23,0,25,2
1683367026322,SOCI 1,A06,258898,Thorpe; Charles Robert,25,0,25,0
1683367027346,SOCI 30,A01,258903,Pardo Guerra; Juan Pablo,15,0,30,15
1683367028374,SOCI 102,A00,258904,Staff,9,0,25,16
1683367029399,SOCI 106,A00,258905,Staff,19,0,25,6
1683367030425,SOCI 111,A00,258907,Ribas Norris; Janet Vanesa,26,0,30,4
1683367031452,SOCI 121R,A00,258908,Pardo Guerra; Juan Pablo,10,0,30,20
1683367032480,SOCI 126,A01,203330,Staff,14,0,20,6
1683367033506,SOCI 131,A00,258909,Thorpe; Charles Robert,31,0,60,29
1683367034535,SOCI 135,A00,258910,Payne; Christine Anna,0,9,30,30
1683367035562,SOCI 157,A00,258911,Staff,12,0,30,18
1683367036584,SOCI 184,A00,258912,Staff,25,0,30,5
1683367037607,SOCI 188D,A00,258913,Staff,22,0,30,8
1683367038632,SYN 2,001,187529,Staff,10,0,16,6
1683367038632,SYN 2,002,201452,Staff,0,18,16,16
1683367038632,SYN 2,003,201469,Staff,3,0,16,13
1683367039660,SYN 100,A01,187531,Staff,0,9,20,20
1683367039660,SYN 100,B01,201491,Staff,0,12,20,20
1683367040684,TDAC 1,A00,189286,Walsh; Kim C.,3,0,20,17
1683367040684,TDAC 1,B00,189287,Harting; Carla Kelso,11,0,20,9
1683367041712,TDAC 101,A00,189300,Walsh; Kim C.,16,0,20,4
1683367041712,TDAC 101,B00,189301,Harting; Carla Kelso,18,0,20,2
1683367042737,TDAC 102,A00,189304,Basso; Beatrice,14,0,20,6
1683367043761,TDAC 108,A00,189305,Staff,18,0,20,2
1683367044785,TDDE 131,A00,189310,Staff,19,0,20,1
1683367044785,TDDE 131,B00,189314,Staff,19,0,20,1
1683367044785,TDDE 131,C00,189315,Staff,48,0,50,2
1683367044785,TDDE 131,D00,189316,Staff,14,0,15,1
1683367044785,TDDE 131,E00,204841,Staff,20,0,20,0
1683367045809,TDGE 10,A00,189289,Staff,30,0,50,20
1683367045809,TDGE 10,B00,189290,Havis; Allan,1,0,50,49
1683367046834,TDGE 11,A00,189291,Fulton; Julia,0,3,50,50
1683367046834,TDGE 11,B00,189292,Staff,20,0,25,5
1683367046834,TDGE 11,C00,260270,Staff,0,0,0,0
1683367047858,TDGE 25,A00,189294,Staff,3,0,20,17
1683367048887,TDGE 124,A00,189318,Fulton; Julia,0,8,50,50
1683367049911,TDGE 125,A00,189319,Staff,13,0,25,12
1683367049911,TDGE 125,B00,189320,Staff,23,0,25,2
1683367050937,TDGE 127,A00,189322,Havis; Allan,0,0,50,50
1683367051961,TDHT 101,A00,189323,Staff,18,0,25,7
1683367051961,TDHT 101,B00,189324,Staff,25,0,25,0
1683367052989,TDHT 102,A00,189325,Staff,49,0,50,1
1683367054013,TDMV 1,A00,189295,Arcidiacono; Kristin,19,0,30,11
1683367054013,TDMV 1,B00,189296,Caligagan; Maria T.,24,0,30,6
1683367055042,TDMV 2,A00,189297,Sammartano; Tonnie,28,0,30,2
1683367055042,TDMV 2,B00,189299,Arcidiacono; Kristin,24,0,30,6
1683367056068,TDMV 3,A00,204998,Rincon; Alicia,22,0,30,8
1683367057091,TDMV 120,A00,189458,Sammartano; Tonnie,28,0,30,2
1683367058116,TDMV 138,A00,189541,Jun; Grace Shin Hae,22,0,40,18
1683367059141,TDMV 142,A00,189717,Caligagan; Tony,24,0,30,6
1683367059141,TDMV 142,B00,189718,Caligagan; Maria T.,25,0,30,5
1683367060163,TMC 2,A01,187533,Staff,25,0,25,0
1683367060163,TMC 2,A02,187534,Staff,25,0,25,0
1683367061190,USP 1,A01,187536,Kwak; Nancy,0,16,25,25
1683367062218,USP 5,A01,187538,Staff,10,0,25,15
1683367063246,USP 101,A00,199253,Staff,0,4,0,0
1683367064273,USP 124,A00,187562,Boomhower; Matthew Charles,1,0,30,29
1683367065297,USP 138,A00,187582,Staff,20,0,25,5
1683367066321,USP 152,A01,187597,Staff,4,0,25,21
1683367067344,USP 153,A00,187598,Staff,19,0,25,6
1683367068370,USP 168,A00,187607,Kwak; Nancy,2,0,5,3
1683367069395,USP 173,A00,187619,Staff,4,0,25,21
1683367070421,USP 181,A00,187638,Staff,0,3,25,25
1683367071447,VIS 103,A00,187650,Cruz; Edwin Teddy,22,0,75,53
1683367072474,VIS 110D,A00,187669,Staff,12,0,22,10
1683367073497,VIS 127C,A00,187720,Shen; Kuiyi,67,0,146,79
1683367074522,VIS 149,A00,187731,Yoldas; Pinar,0,14,22,22
1683367075547,VIS 151,A01,188091,Staff,22,0,34,12
1683367075547,VIS 151,A02,188092,Staff,11,0,34,23
1683367076576,VIS 160B,A00,188093,Stalbaum; Brett,0,0,10,10
1683367078626,WCWP 10B,A00,201720,Staff,10,0,15,5
1683367078626,WCWP 10B,B00,201722,Staff,9,0,15,6
1683367079653,WCWP 100,A00,201725,Gagnon; Jeffrey C,0,0,2,2
1683367079653,WCWP 100,B00,201727,Staff,0,4,15,15
1683367082746,ANBI 133,A00,258401,Wilder; Linnea Lorene,34,0,40,6
1683367083774,ANBI 140,A00,258395,Hrvoj Mihic; Branka,18,0,25,7
1683367084802,ANSC 120,A00,258402,Bialecki; Jon Anthony,27,0,40,13
1683367085830,ANSC 144,A00,258400,Staff,14,0,40,26
1683367087878,ANSC 166,A00,258396,Parish; Steven Martin,158,0,175,17
1683367088906,ANSC 180,A00,193533,Staff,9,0,20,11
1683367089936,ANSC 188,A00,258397,Jassal; Aftab,33,0,40,7
1683367090961,ANTH 3,A01,258316,Staff,23,0,30,7
1683367091986,ANTH 5,A00,258394,Semendeferi; Ekaterini,16,0,20,4
1683367093011,ANTH 21,A01,258331,Staff,8,0,40,32
1683367094092,ANTH 103,A00,258398,Varma; Saiba,15,0,25,10
1683367095124,AWP 10,001,202034,Staff,0,0,0,0
1683367095124,AWP 10,002,202035,Staff,0,0,0,0
1683367095124,AWP 10,003,202036,Staff,0,0,0,0
1683367095124,AWP 10,004,202037,Staff,0,0,0,0
1683367095124,AWP 10,005,202038,Staff,0,0,0,0
1683367095124,AWP 10,006,202039,Staff,0,0,0,0
1683367095124,AWP 10,007,202040,Staff,0,0,0,0
1683367095124,AWP 10,008,202041,Staff,0,0,0,0
1683367095124,AWP 10,009,202042,Staff,0,0,0,0
1683367095124,AWP 10,010,202043,Staff,0,0,0,0
1683367095124,AWP 10,011,202044,Staff,0,0,0,0
1683367095124,AWP 10,012,202045,Staff,0,0,0,0
1683367095124,AWP 10,013,202046,Staff,0,0,0,0
1683367095124,AWP 10,014,202047,Staff,0,0,0,0
1683367095124,AWP 10,015,202048,Staff,0,0,0,0
1683367095124,AWP 10,016,202049,Staff,0,0,0,0
1683367095124,AWP 10,017,202050,Staff,0,0,0,0
1683367095124,AWP 10,018,202051,Staff,0,0,0,0
1683367095124,AWP 10,019,202052,Staff,0,0,0,0
1683367095124,AWP 10,020,202053,Staff,0,0,0,0
1683367095124,AWP 10,021,202054,Staff,0,0,0,0
1683367095124,AWP 10,022,202055,Staff,0,0,0,0
1683367095124,AWP 10,023,202056,Staff,0,0,0,0
1683367095124,AWP 10,024,202057,Staff,0,0,0,0
1683367095124,AWP 10,025,202058,Staff,0,0,0,0
1683367095124,AWP 10,026,202059,Staff,0,0,0,0
1683367096149,AWP 102,001,202032,Staff,0,0,0,0
1683367096149,AWP 102,002,202033,Staff,0,0,0,0
1683367097176,BENG 100,A01,254234,Taylor Amos; Alyssa C,31,0,40,9
1683367098200,BENG 196,001,270013,Engler; Adam J.,9999,0,9999,0
1683367099224,BICD 100R,A01,202018,Smith; Laurie,0,7,32,32
1683367099224,BICD 100R,A02,202019,Smith; Laurie,0,2,32,32
1683367099224,BICD 100R,A03,202020,Smith; Laurie,0,1,32,32
1683367099224,BICD 100R,A04,202021,Smith; Laurie,9,0,32,23
1683367099224,BICD 100R,A05,202022,Smith; Laurie,12,0,32,20
1683367100248,BICD 136,A01,193242,Gustafson-Brown; Cindy,0,2,32,32
1683367100248,BICD 136,A02,193244,Gustafson-Brown; Cindy,14,0,32,18
1683367101274,BIEB 102,A01,193249,Butler; Shannon Rhey,0,2,32,32
1683367101274,BIEB 102,A02,193251,Butler; Shannon Rhey,0,0,32,32
1683367101274,BIEB 102,A03,193253,Butler; Shannon Rhey,0,1,32,32
1683367101274,BIEB 102,A04,193255,Butler; Shannon Rhey,17,0,32,15
1683367101274,BIEB 102,A05,193265,Butler; Shannon Rhey,26,0,32,6
1683367101274,BIEB 102,A06,193269,Butler; Shannon Rhey,16,0,32,16
1683367103322,BIEB 150,A01,193274,Staff,0,0,32,32
1683367103322,BIEB 150,A02,193285,Staff,23,0,32,9
1683367104347,BIEB 194,A00,193286,Kurle; Carolyn M.,22,0,32,10
1683367105373,BILD 1,A01,192291,Staff,16,0,32,16
1683367105373,BILD 1,A02,192292,Staff,30,0,32,2
1683367105373,BILD 1,B01,192520,Reuther; Keefe,0,1,0,0
1683367105373,BILD 1,B02,192532,Reuther; Keefe,0,1,0,0
1683367106399,BILD 3,A01,192556,Butler; Shannon Rhey,0,0,32,32
1683367106399,BILD 3,A02,192581,Butler; Shannon Rhey,4,0,32,28
1683367106399,BILD 3,A03,192611,Butler; Shannon Rhey,23,0,32,9
1683367106399,BILD 3,A04,192612,Butler; Shannon Rhey,25,0,32,7
1683367106399,BILD 3,A05,192613,Butler; Shannon Rhey,27,0,32,5
1683367106399,BILD 3,A06,192679,Butler; Shannon Rhey,27,0,32,5
1683367106399,BILD 3,A07,192682,Butler; Shannon Rhey,21,0,32,11
1683367107428,BILD 4,A01,192836,Reuther; Keefe,0,0,24,24
1683367107428,BILD 4,A02,193044,Reuther; Keefe,4,0,24,20
1683367108455,BILD 10,A01,193142,Gustafson-Brown; Cindy,30,0,32,2
1683367108455,BILD 10,A02,193149,Gustafson-Brown; Cindy,31,0,32,1
1683367109484,BIMM 100,A01,193301,Staff,1,6,32,31
1683367109484,BIMM 100,A02,193312,Staff,0,5,32,32
1683367109484,BIMM 100,A03,193323,Staff,0,8,32,32
1683367110515,BIMM 101,A01,193329,McDonnell; Lisa Marie,0,3,24,24
1683367110515,BIMM 101,A02,193339,McDonnell; Lisa Marie,0,3,24,24
1683367110515,BIMM 101,B01,193354,McDonnell; Lisa Marie,0,3,24,24
1683367110515,BIMM 101,B02,193357,McDonnell; Lisa Marie,0,3,24,24
1683367111538,BIMM 110,A01,193377,Tat; John,0,11,32,32
1683367111538,BIMM 110,A02,193378,Tat; John,0,9,32,32
1683367112562,BIMM 120,A01,206116,Staff,0,0,32,32
1683367112562,BIMM 120,A02,206117,Staff,8,0,32,24
1683367112562,BIMM 120,A03,206121,Staff,21,0,32,11
1683367113590,BIPN 100,A01,193393,Park; Ji Young,0,14,32,32
1683367113590,BIPN 100,A02,193402,Park; Ji Young,0,13,32,32
1683367113590,BIPN 100,A03,193413,Park; Ji Young,0,14,32,32
1683367113590,BIPN 100,A04,193414,Park; Ji Young,0,13,32,32
1683367114614,BIPN 102,A01,193429,Staff,0,0,32,32
1683367114614,BIPN 102,A02,193438,Staff,22,0,32,10
1683367115639,BIPN 106,A01,193450,Reyes Gonzalez; Catalina,0,2,40,40
1683367116664,BIPN 134,A01,193465,Cooke; James Edward,1,0,32,31
1683367116664,BIPN 134,A02,193474,Cooke; James Edward,25,0,32,7
1683367116664,BIPN 134,A03,193485,Cooke; James Edward,29,0,32,3
1683367116664,BIPN 134,A04,193486,Cooke; James Edward,21,0,32,11
1683367116664,BIPN 134,A05,193491,Cooke; James Edward,31,0,32,1
1683367116664,BIPN 134,A06,193501,Cooke; James Edward,30,0,32,2
1683367116664,BIPN 134,A07,193510,Cooke; James Edward,29,0,32,3
1683367118712,BISP 194,A00,222522,Staff,14,0,32,18
1683367119740,CAT 124,A01,202407,Staff,19,0,25,6
1683367120767,CAT 125,A00,202408,Marchisotto; Jennifer Anne,4,0,20,16
1683367121795,CAT 125R,A00,202409,Smith; Lauryn Alissa,0,11,20,20
1683367121795,CAT 125R,B00,202410,Morales; Celeste Georgianna,0,11,20,20
1683367121795,CAT 125R,C00,202411,Irwin; Matthew Joseph,0,10,20,20
1683367122823,CENG 15,A01,204712,Yang; Kesong,0,1,0,0
1683367123847,CENG 114,A00,202070,Jahed Motlagh; Zeinab,5,0,20,15
1683367124872,CGS 105,A00,185477,Wesling; Megan E.,24,0,40,16
1683367125897,CGS 106,A00,185494,Staff,13,0,22,9
1683367126921,CGS 108,A00,185495,Staff,14,0,20,6
1683367127944,CGS 114,A00,185496,Staff,13,0,18,5
1683367128968,CGS 119,A00,185501,Staff,15,0,20,5
1683367129997,CGS 120,A00,185511,Staff,13,0,20,7
1683367131027,CHEM 4,A01,184675,Bussey; Thomas J,96,0,100,4
1683367132051,CHEM 6A,A01,184677,Staff,34,0,60,26
1683367133075,CHEM 6B,A01,184679,Staff,65,0,100,35
1683367134105,CHEM 6C,A01,184681,Bussey; Thomas J,1,0,50,49
1683367134105,CHEM 6C,A02,184682,Bussey; Thomas J,34,0,50,16
1683367135128,CHEM 40A,A01,184684,Albizati; Kim F.,37,0,100,63
1683367136152,CHEM 40B,A01,184686,Albizati; Kim F.,0,20,100,100
1683367137183,CHEM 41B,A01,184690,Staff,52,0,100,48
1683367138208,COGS 3,A01,184715,Boyle; Mary E. T.,0,25,40,40
1683367139236,COGS 14B,A01,185172,Staff,0,15,38,38
1683367140263,COGS 18,A01,184736,Staff,16,0,80,64
1683367141288,COGS 100,A01,184932,Staff,0,5,73,73
1683367142318,COGS 101A,A01,184935,Staff,0,39,30,30
1683367143343,COGS 101B,A01,184944,Staff,0,2,30,30
1683367144371,COGS 101C,A01,184946,Staff,0,12,30,30
1683367145398,COGS 102A,A01,184951,Johnson; Christine M.,2,0,40,38
1683367146422,COGS 107B,A01,184953,Mooshagian; Eric Frederick,0,50,40,40
1683367147450,COGS 118B,A01,184959,Gupta; Anjum,0,48,40,40
1683367148478,COGS 153,A00,184961,Staff,0,15,30,30
1683367149506,COGS 177,A00,184962,Staff,0,20,30,30
1683367150533,COGS 187A,A01,184969,Boyle; Mary E. T.,0,17,40,40
1683367151562,COMM 10,A01,185174,Staff,0,5,25,25
1683367151562,COMM 10,A02,185189,Staff,0,5,25,25
1683367151562,COMM 10,A03,269821,Staff,0,0,0,0
1683367152587,COMM 100B,A01,185475,Staff,0,0,0,2
1683367152587,COMM 100B,A02,185476,Staff,13,0,25,12
1683367153612,COMM 100C,A01,185314,Staff,1,0,25,24
1683367153612,COMM 100C,A02,185327,Staff,19,0,25,6
1683367154643,COMM 110M,A00,185349,Staff,2,0,40,38
1683367155669,COMM 113T,A00,185352,Staff,24,0,40,16
1683367156697,COMM 114I,A00,185353,Staff,33,0,40,7
1683367157723,COMM 131,A00,185354,Staff,19,0,30,11
1683367158752,CSE 8A,A50,185358,Cao; Yingjun,0,46,10,10
1683367159779,CSE 8B,A01,185362,Staff,0,46,50,50
1683367160806,CSE 11,A01,185416,Cao; Yingjun,0,92,10,10
1683367161832,CSE 20,A01,185445,Briones; Jor-el Thomas Caparas,5,0,25,20
1683367162856,CSE 21,A01,185447,Staff,10,0,50,40
1683367163882,CSE 101,A01,185451,Staff,0,13,50,50
1683367163882,CSE 101,B01,185453,Jones; Miles E,0,11,50,50
1683367165932,CSE 141,A01,185458,Eldon; John,20,0,100,80
1683367166959,CSE 141L,A01,185461,Eldon; John,12,0,100,88
1683367167986,CSE 142,A01,185463,Staff,36,0,60,24
1683367167986,CSE 142,B01,201355,Staff,0,7,60,60
1683367169014,CSE 142L,A01,185470,Staff,36,0,60,24
1683367169014,CSE 142L,B01,201417,Staff,0,6,60,60
1683367170041,CSE 190,A00,201433,Staff,32,0,49,17
1683367171073,DOC 1,A01,259136,Strom; Megan C.,7,0,15,8
1683367171073,DOC 1,A02,259137,Strom; Megan C.,14,0,15,1
1683367171073,DOC 1,A03,259138,Strom; Megan C.,14,0,15,1
1683367171073,DOC 1,A04,259139,Strom; Megan C.,14,0,15,1
1683367172097,DOC 100D,A00,259140,Pass; Natalye Joann,16,0,25,9
1683367173125,DSGN 1,A01,184749,Rill; Bryan,0,25,30,30
1683367174150,DSGN 100,A01,185168,Staff,0,2,25,25
1683367175178,ECE 5,A01,185626,Morris; Karcher William,0,10,0,0
1683367176203,ECE 101,A01,185628,Staff,17,0,70,53
1683367177228,ECE 107,A01,185635,Baghdadchi; Saharnaz,0,0,20,20
1683367177228,ECE 107,A02,185638,Baghdadchi; Saharnaz,4,0,20,16
1683367178252,ECE 148,A01,185647,Silberman; Jack,0,0,16,16
1683367179281,ECON 1,A01,185537,Crane; Meredith Helen,54,0,70,16
1683367180306,ECON 3,A01,185549,Crane; Meredith Helen,32,0,70,38
1683367181334,ECON 4,A01,203354,Anderson; John Charles,0,4,10,10
1683367182359,ECON 100A,A01,185574,Staff,0,4,40,40
1683367183382,ECON 100B,A01,185576,Staff,0,12,50,50
1683367184404,ECON 100C,A01,185589,Newhouse; Herbert S,29,0,70,41
1683367185428,ECON 105,A00,185608,Vespa; Emanuel Ignacio,19,0,35,16
1683367186452,ECON 109,A01,185610,Shishkin; Denis,10,0,35,25
1683367187477,ECON 110A,A01,185612,Staff,11,0,40,29
1683367188503,ECON 120A,A01,185615,Staff,20,0,40,20
1683367189528,ECON 120C,A01,185617,Sun; Yixiao,0,21,70,70
1683367190550,ECON 144,A00,203346,Squires; Dale E,3,0,35,32
1683367191574,ECON 171,A01,203349,Newhouse; Herbert S,0,1,35,35
1683367192603,ECON 173A,A01,185621,Toda; Alexis Akira,21,0,35,14
1683367193629,EDS 25,A01,202413,Staff,0,1,0,0
1683367193629,EDS 25,A02,202414,Staff,0,1,0,0
1683367193629,EDS 25,A03,202415,Staff,0,0,0,0
1683367193629,EDS 25,A04,202416,Staff,0,1,0,0
1683367193629,EDS 25,A05,202439,Staff,0,0,0,0
1683367193629,EDS 25,A06,202440,Staff,0,0,0,0
1683367193629,EDS 25,B01,202631,Staff,0,0,0,0
1683367193629,EDS 25,B02,202632,Staff,0,0,0,0
1683367193629,EDS 25,B03,202639,Staff,0,0,0,0
1683367193629,EDS 25,B04,202640,Staff,0,0,0,0
1683367193629,EDS 25,B05,202643,Staff,0,0,0,0
1683367193629,EDS 25,B06,202644,Staff,0,0,0,0
1683367194653,EDS 38,A01,202659,Black; Alison Michelle,24,0,25,1
1683367195677,EDS 115,A00,202652,Staff,18,0,30,12
1683367196702,EDS 125,A00,202649,Staff,14,0,30,16
1683367197797,EDS 126,A01,203332,Staff,30,0,30,0
1683367198821,EDS 139,A00,202838,Staff,16,0,25,9
1683367199848,EDS 146,A01,202655,Staff,14,0,25,11
1683367200876,ENG 15,A00,185667,Staff,0,1,0,0
1683367200876,ENG 15,B00,185672,Staff,0,0,0,0
1683367200876,ENG 15,C00,185675,Staff,0,0,0,0
1683367200876,ENG 15,D00,185682,Staff,0,0,0,0
1683367200876,ENG 15,E00,185684,Staff,0,0,0,0
1683367201904,ETHN 103,A00,185710,Staff,0,4,35,35
1683367202931,ETHN 103A,A00,199228,Man; Simeon S,2,0,9,7
1683367203959,ETHN 109,A00,185711,Staff,18,0,35,17
1683367204983,ETHN 142,A00,185726,Staff,0,4,30,30
1683367206009,ETHN 163J,A00,199229,Man; Simeon S,5,0,8,3
1683367207032,ETHN 168,A00,185727,Staff,8,0,10,2
1683367208058,ETHN 182,A00,185728,Staff,0,0,35,35
1683367209084,ETHN 183,A00,185737,Staff,8,0,18,10
1683367210107,GLBH 111,A01,209361,Burgos; Jose L.,0,0,0,0
1683367212156,HIEU 104,A00,185792,Staff,16,0,20,4
1683367213182,HIEU 115,A00,185800,Staff,1,0,20,19
1683367214208,HIEU 128,A00,185801,Staff,0,7,20,20
1683367215232,HIEU 147,A00,185802,Staff,16,0,20,4
1683367216257,HIEU 154,A00,185823,Staff,12,0,20,8
1683367217284,HILA 102,A00,185826,Staff,13,0,20,7
1683367218308,HILD 2C,A01,185778,Staff,0,12,20,20
1683367219335,HILD 7B,A01,185780,Kwak; Nancy,0,15,32,32
1683367219335,HILD 7B,A02,185781,Kwak; Nancy,0,18,32,32
1683367220358,HILD 30,A01,185791,Staff,14,0,20,6
1683367221386,HISC 119,A00,185830,Golan; Tal,0,9,20,20
1683367222409,HITO 156GS,A00,185831,Patterson; Patrick H.,0,0,0,23
1683367223434,HIUS 103,A00,185832,Man; Simeon S,1,6,20,19
1683367224459,HIUS 117,A00,185836,Kwak; Nancy,2,0,20,18
1683367225483,HIUS 125,A00,185840,Man; Simeon S,0,0,23,23
1683367226510,HIUS 149,A00,185845,Staff,0,0,20,20
1683367227537,HUM 3,A01,185882,Zavodny; Tatiana Sophia,0,7,50,50
1683367227537,HUM 3,B01,185899,Caldwell; Michael Alan,0,18,50,50
1683367228564,HUM 3GS,A00,185900,Patterson; Patrick H.,0,0,0,23
1683367229590,HUM 4,A01,185938,Zroka; Amy Liane,31,0,50,19
1683367229590,HUM 4,B01,185956,Watkins; Eric,0,3,50,50
1683367229590,HUM 4,B02,202209,Watkins; Eric,0,2,50,50
1683367229590,HUM 4,B03,202210,Watkins; Eric,0,2,50,50
1683367230616,HUM 5,A01,185958,West; Geoffrey Scott,3,0,50,47
1683367230616,HUM 5,A02,202215,West; Geoffrey Scott,0,0,50,50
1683367231640,INTL 190,A00,185959,Gagnon; Jeffrey C,0,0,0,9
1683367231640,INTL 190,B00,185960,Lettieri; Michael Joseph,0,0,0,1
1683367232663,JAPN 180,A00,254509,Staff,4,0,30,26
1683367233688,LATI 10,A01,202853,Kennemore; Amy Michelle,4,0,35,31
1683367233688,LATI 10,A02,202854,Kennemore; Amy Michelle,2,0,35,33
1683367233688,LATI 10,A03,270054,Kennemore; Amy Michelle,30,0,30,0
1683367234711,LATI 180,A00,202855,Kennemore; Amy Michelle,11,0,20,9
1683367235735,LAWS 101,A00,201767,Golan; Tal,0,7,40,40
1683367236760,LIFR 1C,A00,185961,Staff,6,0,20,14
1683367237786,LIFR 1CX,A00,185962,Staff,7,0,20,13
1683367238810,LIFR 1D,A00,185963,Staff,9,0,20,11
1683367239834,LIFR 1DX,A00,185964,Staff,9,0,20,11
1683367240858,LIGN 101,A01,186039,Staff,43,0,50,7
1683367241885,LIGN 165,A00,186040,Staff,18,0,50,32
1683367242908,LTCS 108,A00,186041,Staff,6,0,10,4
1683367243933,LTCS 119,A00,186042,Staff,16,0,20,4
1683367244958,LTCS 130,A00,186043,Wesling; Megan E.,15,0,25,10
1683367247008,LTEA 138,A00,186119,Staff,14,0,40,26
1683367248036,LTEN 124,A00,186148,Staff,6,0,25,19
1683367249059,LTEN 178,A00,186149,Staff,7,0,15,8
1683367250083,LTEN 181,A00,186150,Blanco; John D,33,0,40,7
1683367251107,LTWL 120,A00,186160,Staff,20,0,25,5
1683367252130,LTWL 165,A00,186161,Staff,22,0,25,3
1683367253154,LTWR 100,A00,186162,Staff,0,5,15,15
1683367254180,LTWR 102,A00,186163,Doller; Ben,5,0,15,10
1683367255205,MAE 8,A01,186412,Staff,0,0,0,0
1683367256232,MAE 30B,A00,186445,Bahadori; Mohammad Yousef,83,0,100,17
1683367257255,MAE 40,A00,186592,Bewley; Thomas R,10,0,50,40
1683367258279,MAE 101B,A00,186593,Bahadori; Mohammad Yousef,81,0,100,19
1683367259303,MAE 105,A00,186594,Bandaru; Prabhakar,12,0,50,38
1683367260327,MAE 107,A00,186599,Pham; Hieu Tan,0,7,120,120
1683367261357,MAE 148,A01,186660,Silberman; Jack,3,0,16,13
1683367262382,MATH 10A,A01,188095,Staff,0,5,35,35
1683367263410,MATH 10B,A01,188097,Bowers; Adam R.,0,11,30,30
1683367263410,MATH 10B,A02,188099,Bowers; Adam R.,0,11,30,30
1683367263410,MATH 10B,B01,188104,Bowers; Adam R.,0,10,30,30
1683367263410,MATH 10B,B02,188106,Bowers; Adam R.,0,10,30,30
1683367264441,MATH 10C,A01,188111,Staff,0,18,30,30
1683367264441,MATH 10C,A02,188127,Staff,0,17,30,30
1683367264441,MATH 10C,A03,188131,Staff,0,18,30,30
1683367264441,MATH 10C,B01,188218,Staff,18,0,30,12
1683367264441,MATH 10C,B02,188244,Staff,13,0,30,17
1683367264441,MATH 10C,B03,188277,Staff,16,0,30,14
1683367265467,MATH 18,A01,188344,Bach; Quang Tran,18,0,30,12
1683367265467,MATH 18,A02,188345,Bach; Quang Tran,11,0,30,19
1683367265467,MATH 18,B01,188353,Bach; Quang Tran,10,0,30,20
1683367265467,MATH 18,B02,188354,Bach; Quang Tran,20,0,30,10
1683367266491,MATH 20A,A01,188374,Staff,12,0,35,23
1683367267517,MATH 20B,A01,188382,Ohm; Ko Woon,6,0,30,24
1683367267517,MATH 20B,A02,188383,Ohm; Ko Woon,21,0,30,9
1683367267517,MATH 20B,B01,188385,Ohm; Ko Woon,7,0,30,23
1683367267517,MATH 20B,B02,188392,Ohm; Ko Woon,22,0,30,8
1683367268564,MATH 20C,A01,188394,Harel; Guershon,10,0,30,20
1683367268564,MATH 20C,A02,188395,Harel; Guershon,15,0,30,15
1683367268564,MATH 20C,B01,188404,Harel; Guershon,4,0,30,26
1683367268564,MATH 20C,B02,188405,Harel; Guershon,19,0,30,11
1683367269594,MATH 20D,A01,188414,Hammock; Frances H,0,1,30,30
1683367269594,MATH 20D,A02,188415,Hammock; Frances H,3,0,30,27
1683367269594,MATH 20D,B01,188447,Hammock; Frances H,1,0,30,29
1683367269594,MATH 20D,B02,188486,Hammock; Frances H,8,0,30,22
1683367270623,MATH 20E,A01,188649,Staff,21,0,30,9
1683367270623,MATH 20E,A02,188650,Staff,23,0,30,7
1683367270623,MATH 20E,A03,188673,Staff,0,0,30,30
1683367271647,MATH 102,A01,188675,Staff,0,35,35,35
1683367272677,MATH 103B,A01,188681,Staff,3,0,35,32
1683367272677,MATH 103B,B01,188692,Staff,5,0,35,30
1683367273706,MATH 109,A01,188695,Salehi Golsefidy; Alireza,25,0,35,10
1683367273706,MATH 109,A02,188696,Salehi Golsefidy; Alireza,25,0,35,10
1683367274734,MATH 120A,A01,188698,Eggers; John Dietrich,7,0,35,28
1683367275758,MATH 142B,A01,188736,Ioana; Adrian,0,2,30,30
1683367275758,MATH 142B,A02,188741,Ioana; Adrian,0,0,30,30
1683367275758,MATH 142B,A03,188743,Ioana; Adrian,0,1,30,30
1683367276782,MATH 168A,A01,188790,Staff,0,9,35,35
1683367277807,MATH 170A,A01,188803,Nie; Jiawang,0,2,35,35
1683367277807,MATH 170A,A02,188811,Nie; Jiawang,0,0,35,35
1683367277807,MATH 170A,A03,188814,Nie; Jiawang,1,0,35,34
1683367277807,MATH 170A,A04,188815,Nie; Jiawang,13,0,35,22
1683367278835,MATH 193B,A01,188817,Staff,0,0,35,35
1683367278835,MATH 193B,A02,188818,Staff,5,0,35,30
1683367279863,MGT 4,A01,202857,Anderson; John Charles,61,0,80,19
1683367280885,MGT 12,A00,202858,Lindenberger; Wade Douglas,41,0,90,49
1683367281913,MGT 18,A00,202859,Staff,74,0,90,16
1683367282936,MGT 18GS,A00,202860,McKay; Michael J,13,0,28,15
1683367283960,MGT 45,A00,202861,Pecore; Joseph P.,15,0,90,75
1683367284985,MGT 100,A00,202863,Yavorsky; Daniel Ryan,28,0,90,62
1683367286009,MGT 103,A00,202864,Ehrich; Kristine R,0,17,90,90
1683367287034,MGT 112,A00,202865,Ehrich; Kristine R,15,0,90,75
1683367288058,MGT 121A,A00,202868,Staff,0,20,0,0
1683367289082,MGT 131B,A00,202869,Anderson; John Charles,59,0,90,31
1683367290106,MGT 136,A00,202871,Lindenberger; Wade Douglas,84,0,90,6
1683367291131,MGT 164,A00,202873,Staff,0,68,90,91
1683367292154,MGT 164GS,A00,202874,McKay; Mary A,13,0,28,15
1683367293182,MGT 180,A00,202875,Staff,0,50,90,91
1683367294206,MMW 11R,A01,205019,Herbst; Matthew,3,0,30,27
1683367294206,MMW 11R,A02,205026,Herbst; Matthew,29,0,30,1
1683367295237,MMW 15,A01,193512,Chang; Edmond Yi-Teh,0,9,28,28
1683367295237,MMW 15,A02,193513,Chang; Edmond Yi-Teh,0,5,28,28
1683367295237,MMW 15,A03,193514,Chang; Edmond Yi-Teh,0,5,28,28
1683367295237,MMW 15,A04,193515,Chang; Edmond Yi-Teh,0,5,28,28
1683367295237,MMW 15,A05,193516,Chang; Edmond Yi-Teh,0,4,28,28
1683367295237,MMW 15,A06,193517,Chang; Edmond Yi-Teh,0,5,28,28
1683367295237,MMW 15,B01,193519,Chang; Edmond Yi-Teh,0,5,28,28
1683367295237,MMW 15,B02,193520,Chang; Edmond Yi-Teh,0,5,28,28
1683367295237,MMW 15,B03,193521,Chang; Edmond Yi-Teh,0,5,28,28
1683367295237,MMW 15,B04,193522,Chang; Edmond Yi-Teh,0,4,28,28
1683367295237,MMW 15,B05,193523,Chang; Edmond Yi-Teh,0,5,28,28
1683367295237,MMW 15,B06,193524,Chang; Edmond Yi-Teh,0,4,28,28
1683367296264,MMW 122,A01,193526,Rahimi; Babak,0,15,28,28
1683367296264,MMW 122,A02,193527,Rahimi; Babak,0,14,28,28
1683367296264,MMW 122,A03,193528,Rahimi; Babak,0,0,0,0
1683367296264,MMW 122,A04,193529,Rahimi; Babak,0,0,0,0
1683367297292,MUS 1A,A01,186663,Staff,0,20,35,35
1683367298320,MUS 4,A01,186715,Staff,0,12,35,35
1683367299347,MUS 5R,A01,186796,Dubnov; Shlomo,0,17,35,35
1683367300375,MUS 6,A01,186798,Staff,0,4,25,25
1683367301456,MUS 7,A01,186830,Staff,13,0,35,22
1683367302480,MUS 8,A01,186930,Staff,0,26,35,35
1683367303506,MUS 15,A01,186932,Staff,0,16,35,35
1683367303506,MUS 15,B01,186934,Staff,0,15,35,35
1683367304530,MUS 80,A00,186935,Staff,0,0,20,20
1683367304530,MUS 80,B00,186936,Staff,25,0,25,0
1683367305555,NANO 11,A00,204702,Lipomi; Darren John,0,0,0,0
1683367306579,NANO 15,A01,204709,Yang; Kesong,0,1,0,0
1683367307603,NANO 114,A00,202069,Jahed Motlagh; Zeinab,3,0,10,7
1683367308632,PHIL 1,A00,186955,Grush; Rick Scott,32,0,40,8
1683367309657,PHIL 10,A01,186973,Grush; Rick Scott,28,0,35,7
1683367309657,PHIL 10,A02,186974,Grush; Rick Scott,33,0,35,2
1683367310682,PHIL 13,A01,186976,Staff,7,0,35,28
1683367310682,PHIL 13,A02,186977,Staff,16,0,35,19
1683367311706,PHIL 14,A01,186979,Staff,31,0,35,4
1683367311706,PHIL 14,A02,186986,Staff,32,0,35,3
1683367312731,PHIL 28,A01,186988,Staff,16,0,30,14
1683367312731,PHIL 28,A02,186989,Staff,1,0,30,29
1683367312731,PHIL 28,A03,186990,Staff,9,0,30,21
1683367312731,PHIL 28,A04,186991,Staff,26,0,30,4
1683367313758,PHIL 120,A00,186997,Staff,23,0,40,17
1683367314781,PHIL 137,A00,187003,Staff,9,0,40,31
1683367315818,PHIL 150,A00,187015,Staff,47,0,70,23
1683367316847,PHIL 167,A00,187021,Lamey; Andy M.,35,0,40,5
1683367317871,PHIL 174,A01,202226,Staff,17,0,20,3
1683367317871,PHIL 174,A02,202235,Staff,20,0,20,0
1683367318899,PHIL 191A,A00,258918,Staff,0,0,1,1
1683367319927,PHYS 1A,A00,187028,Staff,27,0,60,33
1683367320953,PHYS 1AL,001,187036,Staff,2,0,30,28
1683367320953,PHYS 1AL,002,187049,Staff,18,0,30,12
1683367321985,PHYS 1B,A00,187058,Staff,22,0,60,38
1683367323011,PHYS 1BL,001,187064,Staff,0,0,30,30
1683367323011,PHYS 1BL,002,187070,Staff,5,0,30,25
1683367324038,PHYS 1C,A00,187082,Staff,31,0,120,89
1683367325064,PHYS 1CL,001,187088,Staff,0,9,30,30
1683367325064,PHYS 1CL,002,187089,Staff,0,2,30,30
1683367325064,PHYS 1CL,009,262693,Staff,11,0,30,19
1683367326095,PHYS 2B,A01,187097,Staff,54,0,115,61
1683367327121,PHYS 2C,A01,187099,Staff,67,0,115,48
1683367328148,PHYS 2CL,A01,187101,Staff,5,0,28,23
1683367328148,PHYS 2CL,A02,187102,Staff,15,0,28,13
1683367329177,PHYS 2D,A01,187123,Shotwell; Brian,95,0,115,20
1683367330203,PHYS 4B,A01,187133,Grinstein; Benjamin,35,0,50,15
1683367331225,POLI 10,A00,188819,Staff,0,4,50,50
1683367332254,POLI 11,A00,188827,Staff,43,0,50,7
1683367333279,POLI 13R,A00,188828,Staff,0,1,20,20
1683367334307,POLI 27,A01,188830,Elgin; Samuel Zincke,0,1,70,70
1683367335331,POLI 30,A00,188832,Desposato; Scott,31,0,50,19
1683367336358,POLI 102F,A00,188834,Staff,2,0,40,38
1683367337384,POLI 104A,A00,188852,Staff,14,0,30,16
1683367338411,POLI 104I,A00,188853,Staff,0,6,20,20
1683367339440,POLI 110B,A00,188854,Wiens; David,7,0,20,13
1683367340464,POLI 112A,A00,188855,Wiens; David,5,0,30,25
1683367341489,POLI 117R,A00,188856,Forman; Fonna,0,11,20,20
1683367342518,POLI 118,A00,188857,Ingham; Sean,8,0,20,12
1683367343547,POLI 120G,A00,188858,Staff,9,0,30,21
1683367344572,POLI 131CR,A00,188863,Hoston; Germaine,23,0,50,27
1683367345596,POLI 133,A00,188864,Nellis; Gareth Hb,44,0,50,6
1683367346620,POLI 134D,A00,188865,Desposato; Scott,27,0,30,3
1683367347644,POLI 142A,A00,188871,Gartzke; Erik,22,0,50,28
1683367348670,POLI 142K,A00,188874,Staff,38,0,50,12
1683367349698,POLI 143,A00,188940,Gartzke; Erik,16,0,30,14
1683367350725,POLI 153,A00,188943,Staff,3,0,20,17
1683367351750,POLI 160AA,A00,188944,Staff,11,0,40,29
1683367352778,POLI 170A,A00,188945,Staff,11,0,30,19
1683367354827,PSYC 1,A00,188952,Staff,37,0,90,53
1683367355852,PSYC 2,B00,188953,Staff,19,0,35,16
1683367356880,PSYC 6,A00,188970,Staff,47,0,60,13
1683367357909,PSYC 7,A00,188973,Staff,37,0,45,8
1683367358937,PSYC 60,A01,188980,Rickard; Timothy C.,43,0,60,17
1683367359962,PSYC 70,A01,189001,Steiner; Eric Tomas,23,0,45,22
1683367360987,PSYC 100,A00,189005,Lacefield; Katharine I,0,98,120,120
1683367362013,PSYC 102,A00,189008,Staff,9,0,30,21
1683367363040,PSYC 106,B00,189026,Gorman; Michael R.,34,0,60,26
1683367364065,PSYC 114,B01,189033,Winkielman; Piotr,0,32,30,30
1683367365089,PSYC 131,A00,189036,Anagnostaras; Stephan,0,43,60,60
1683367366112,PSYC 136,A00,189041,Lowe; Angela Beth,0,7,25,25
1683367367137,PSYC 137,A00,189057,Winkielman; Piotr,0,34,25,25
1683367368162,PSYC 144,A00,189107,Wixted; John T,0,7,50,50
1683367370217,PSYC 162,A00,189142,Staff,0,8,85,85
1683367371247,PSYC 172,A00,189144,Gorman; Michael R.,0,7,30,30
1683367373294,PSYC 179,A00,189146,Lacefield; Katharine I,0,84,120,120
1683367374319,PSYC 181,A00,189147,Anagnostaras; Stephan,0,44,90,90
1683367375344,PSYC 190R,A00,189148,Barner; David A.,0,22,80,80
1683367376369,PSYC 191,A00,189275,Rickard; Timothy C.,0,7,25,25
1683367377391,PSYC 193,A00,189276,Chapman; Eddie Nathaniel,0,1,0,4
1683367378415,PSYC 193L,A01,189281,Lowe; Angela Beth,12,0,20,8
1683367378415,PSYC 193L,B01,189285,Staff,28,0,35,7
1683367379439,RELI 149,A00,187137,Rahimi; Babak,7,0,40,33
1683367380470,SE 9,A01,187315,Staff,0,2,18,18
1683367381494,SE 101B,A00,187409,Staff,24,0,30,6
1683367382518,SE 110B,A00,187444,Staff,10,0,40,30
1683367383547,SE 130B,A00,187449,Staff,31,0,40,9
1683367384575,SE 150A,A00,187516,Staff,9,0,20,11
1683367385603,SE 154,A00,187528,Staff,30,0,50,20
1683367386633,SIO 3,A01,258171,Staff,35,0,40,5
1683367387662,SIO 10,A00,187144,Cook; Geoffrey W,0,3,75,75
1683367388690,SIO 45,A00,187152,Cook; Geoffrey W,1,0,100,99
1683367389715,SIO 109R,A00,194486,Staff,0,3,20,20
1683367391764,SIO 187,A01,187233,Kacev; David,12,0,40,28
1683367392789,SOCI 1,A01,258656,Thorpe; Charles Robert,28,0,30,2
1683367392789,SOCI 1,A02,258658,Thorpe; Charles Robert,30,0,30,0
1683367392789,SOCI 1,A03,258661,Thorpe; Charles Robert,25,0,25,0
1683367392789,SOCI 1,A04,258666,Thorpe; Charles Robert,22,0,25,3
1683367392789,SOCI 1,A05,258897,Thorpe; Charles Robert,23,0,25,2
1683367392789,SOCI 1,A06,258898,Thorpe; Charles Robert,25,0,25,0
1683367393813,SOCI 30,A01,258903,Pardo Guerra; Juan Pablo,15,0,30,15
1683367394838,SOCI 102,A00,258904,Staff,9,0,25,16
1683367395863,SOCI 106,A00,258905,Staff,19,0,25,6
1683367396887,SOCI 111,A00,258907,Ribas Norris; Janet Vanesa,26,0,30,4
1683367397912,SOCI 121R,A00,258908,Pardo Guerra; Juan Pablo,10,0,30,20
1683367398939,SOCI 126,A01,203330,Staff,14,0,20,6
1683367399967,SOCI 131,A00,258909,Thorpe; Charles Robert,31,0,60,29
1683367400996,SOCI 135,A00,258910,Payne; Christine Anna,0,9,30,30
1683367402024,SOCI 157,A00,258911,Staff,12,0,30,18
1683367403048,SOCI 184,A00,258912,Staff,25,0,30,5
1683367404073,SOCI 188D,A00,258913,Staff,22,0,30,8
1683367405149,SYN 2,001,187529,Staff,10,0,16,6
1683367405149,SYN 2,002,201452,Staff,0,18,16,16
1683367405149,SYN 2,003,201469,Staff,3,0,16,13
1683367406176,SYN 100,A01,187531,Staff,0,9,20,20
1683367406176,SYN 100,B01,201491,Staff,0,12,20,20
1683367407200,TDAC 1,A00,189286,Walsh; Kim C.,3,0,20,17
1683367407200,TDAC 1,B00,189287,Harting; Carla Kelso,11,0,20,9
1683367408224,TDAC 101,A00,189300,Walsh; Kim C.,16,0,20,4
1683367408224,TDAC 101,B00,189301,Harting; Carla Kelso,18,0,20,2
1683367409253,TDAC 102,A00,189304,Basso; Beatrice,14,0,20,6
1683367410282,TDAC 108,A00,189305,Staff,18,0,20,2
1683367411314,TDDE 131,A00,189310,Staff,19,0,20,1
1683367411314,TDDE 131,B00,189314,Staff,19,0,20,1
1683367411314,TDDE 131,C00,189315,Staff,48,0,50,2
1683367411314,TDDE 131,D00,189316,Staff,14,0,15,1
1683367411314,TDDE 131,E00,204841,Staff,20,0,20,0
1683367412336,TDGE 10,A00,189289,Staff,30,0,50,20
1683367412336,TDGE 10,B00,189290,Havis; Allan,1,0,50,49
1683367413367,TDGE 11,A00,189291,Fulton; Julia,0,3,50,50
1683367413367,TDGE 11,B00,189292,Staff,20,0,25,5
1683367413367,TDGE 11,C00,260270,Staff,0,0,0,0
1683367414392,TDGE 25,A00,189294,Staff,3,0,20,17
1683367415419,TDGE 124,A00,189318,Fulton; Julia,0,8,50,50
1683367416441,TDGE 125,A00,189319,Staff,13,0,25,12
1683367416441,TDGE 125,B00,189320,Staff,23,0,25,2
1683367417468,TDGE 127,A00,189322,Havis; Allan,0,0,50,50
1683367418495,TDHT 101,A00,189323,Staff,18,0,25,7
1683367418495,TDHT 101,B00,189324,Staff,25,0,25,0
1683367419521,TDHT 102,A00,189325,Staff,49,0,50,1
1683367420548,TDMV 1,A00,189295,Arcidiacono; Kristin,19,0,30,11
1683367420548,TDMV 1,B00,189296,Caligagan; Maria T.,24,0,30,6
1683367421574,TDMV 2,A00,189297,Sammartano; Tonnie,28,0,30,2
1683367421574,TDMV 2,B00,189299,Arcidiacono; Kristin,24,0,30,6
1683367422603,TDMV 3,A00,204998,Rincon; Alicia,22,0,30,8
1683367423628,TDMV 120,A00,189458,Sammartano; Tonnie,28,0,30,2
1683367424651,TDMV 138,A00,189541,Jun; Grace Shin Hae,22,0,40,18
1683367425675,TDMV 142,A00,189717,Caligagan; Tony,24,0,30,6
1683367425675,TDMV 142,B00,189718,Caligagan; Maria T.,25,0,30,5
1683367426699,TMC 2,A01,187533,Staff,25,0,25,0
1683367426699,TMC 2,A02,187534,Staff,25,0,25,0
1683367427723,USP 1,A01,187536,Kwak; Nancy,0,16,25,25
1683367428751,USP 5,A01,187538,Staff,10,0,25,15
1683367429779,USP 101,A00,199253,Staff,0,4,0,0
1683367430806,USP 124,A00,187562,Boomhower; Matthew Charles,1,0,30,29
1683367431833,USP 138,A00,187582,Staff,20,0,25,5
1683367432860,USP 152,A01,187597,Staff,4,0,25,21
1683367433888,USP 153,A00,187598,Staff,19,0,25,6
1683367434912,USP 168,A00,187607,Kwak; Nancy,2,0,5,3
1683367435934,USP 173,A00,187619,Staff,4,0,25,21
1683367436958,USP 181,A00,187638,Staff,0,3,25,25
1683367437983,VIS 103,A00,187650,Cruz; Edwin Teddy,22,0,75,53
1683367439007,VIS 110D,A00,187669,Staff,12,0,22,10
1683367440035,VIS 127C,A00,187720,Shen; Kuiyi,67,0,146,79
1683367441062,VIS 149,A00,187731,Yoldas; Pinar,0,14,22,22
1683367442090,VIS 151,A01,188091,Staff,22,0,34,12
1683367442090,VIS 151,A02,188092,Staff,11,0,34,23
1683367443114,VIS 160B,A00,188093,Stalbaum; Brett,0,0,10,10
1683367445164,WCWP 10B,A00,201720,Staff,10,0,15,5
1683367445164,WCWP 10B,B00,201722,Staff,9,0,15,6
1683367446190,WCWP 100,A00,201725,Gagnon; Jeffrey C,0,0,2,2
1683367446190,WCWP 100,B00,201727,Staff,0,4,15,15
1683367449326,ANBI 133,A00,258401,Wilder; Linnea Lorene,34,0,40,6
1683367450354,ANBI 140,A00,258395,Hrvoj Mihic; Branka,18,0,25,7
1683367451379,ANSC 120,A00,258402,Bialecki; Jon Anthony,27,0,40,13
1683367452403,ANSC 144,A00,258400,Staff,14,0,40,26
1683367454452,ANSC 166,A00,258396,Parish; Steven Martin,158,0,175,17
1683367455476,ANSC 180,A00,193533,Staff,9,0,20,11
1683367456501,ANSC 188,A00,258397,Jassal; Aftab,33,0,40,7
1683367457529,ANTH 3,A01,258316,Staff,23,0,30,7
1683367458557,ANTH 5,A00,258394,Semendeferi; Ekaterini,16,0,20,4
1683367459582,ANTH 21,A01,258331,Staff,8,0,40,32
1683367460607,ANTH 103,A00,258398,Varma; Saiba,15,0,25,10
1683367461634,AWP 10,001,202034,Staff,0,0,0,0
1683367461634,AWP 10,002,202035,Staff,0,0,0,0
1683367461634,AWP 10,003,202036,Staff,0,0,0,0
1683367461634,AWP 10,004,202037,Staff,0,0,0,0
1683367461634,AWP 10,005,202038,Staff,0,0,0,0
1683367461634,AWP 10,006,202039,Staff,0,0,0,0
1683367461634,AWP 10,007,202040,Staff,0,0,0,0
1683367461634,AWP 10,008,202041,Staff,0,0,0,0
1683367461634,AWP 10,009,202042,Staff,0,0,0,0
1683367461634,AWP 10,010,202043,Staff,0,0,0,0
1683367461634,AWP 10,011,202044,Staff,0,0,0,0
1683367461634,AWP 10,012,202045,Staff,0,0,0,0
1683367461634,AWP 10,013,202046,Staff,0,0,0,0
1683367461634,AWP 10,014,202047,Staff,0,0,0,0
1683367461634,AWP 10,015,202048,Staff,0,0,0,0
1683367461634,AWP 10,016,202049,Staff,0,0,0,0
1683367461634,AWP 10,017,202050,Staff,0,0,0,0
1683367461634,AWP 10,018,202051,Staff,0,0,0,0
1683367461634,AWP 10,019,202052,Staff,0,0,0,0
1683367461634,AWP 10,020,202053,Staff,0,0,0,0
1683367461634,AWP 10,021,202054,Staff,0,0,0,0
1683367461634,AWP 10,022,202055,Staff,0,0,0,0
1683367461634,AWP 10,023,202056,Staff,0,0,0,0
1683367461634,AWP 10,024,202057,Staff,0,0,0,0
1683367461634,AWP 10,025,202058,Staff,0,0,0,0
1683367461634,AWP 10,026,202059,Staff,0,0,0,0
1683367462658,AWP 102,001,202032,Staff,0,0,0,0
1683367462658,AWP 102,002,202033,Staff,0,0,0,0
1683367463683,BENG 100,A01,254234,Taylor Amos; Alyssa C,31,0,40,9
1683367464710,BENG 196,001,270013,Engler; Adam J.,9999,0,9999,0
1683367465740,BICD 100R,A01,202018,Smith; Laurie,0,7,32,32
1683367465740,BICD 100R,A02,202019,Smith; Laurie,0,2,32,32
1683367465740,BICD 100R,A03,202020,Smith; Laurie,0,1,32,32
1683367465740,BICD 100R,A04,202021,Smith; Laurie,9,0,32,23
1683367465740,BICD 100R,A05,202022,Smith; Laurie,12,0,32,20
1683367466768,BICD 136,A01,193242,Gustafson-Brown; Cindy,0,2,32,32
1683367466768,BICD 136,A02,193244,Gustafson-Brown; Cindy,14,0,32,18
1683367467797,BIEB 102,A01,193249,Butler; Shannon Rhey,0,2,32,32
1683367467797,BIEB 102,A02,193251,Butler; Shannon Rhey,0,0,32,32
1683367467797,BIEB 102,A03,193253,Butler; Shannon Rhey,0,1,32,32
1683367467797,BIEB 102,A04,193255,Butler; Shannon Rhey,17,0,32,15
1683367467797,BIEB 102,A05,193265,Butler; Shannon Rhey,26,0,32,6
1683367467797,BIEB 102,A06,193269,Butler; Shannon Rhey,16,0,32,16
1683367469851,BIEB 150,A01,193274,Staff,0,0,32,32
1683367469851,BIEB 150,A02,193285,Staff,23,0,32,9
1683367470878,BIEB 194,A00,193286,Kurle; Carolyn M.,22,0,32,10
1683367471903,BILD 1,A01,192291,Staff,16,0,32,16
1683367471903,BILD 1,A02,192292,Staff,30,0,32,2
1683367471903,BILD 1,B01,192520,Reuther; Keefe,0,1,0,0
1683367471903,BILD 1,B02,192532,Reuther; Keefe,0,1,0,0
1683367472935,BILD 3,A01,192556,Butler; Shannon Rhey,0,0,32,32
1683367472935,BILD 3,A02,192581,Butler; Shannon Rhey,4,0,32,28
1683367472935,BILD 3,A03,192611,Butler; Shannon Rhey,23,0,32,9
1683367472935,BILD 3,A04,192612,Butler; Shannon Rhey,25,0,32,7
1683367472935,BILD 3,A05,192613,Butler; Shannon Rhey,27,0,32,5
1683367472935,BILD 3,A06,192679,Butler; Shannon Rhey,27,0,32,5
1683367472935,BILD 3,A07,192682,Butler; Shannon Rhey,21,0,32,11
1683367473963,BILD 4,A01,192836,Reuther; Keefe,0,0,24,24
1683367473963,BILD 4,A02,193044,Reuther; Keefe,4,0,24,20
1683367474987,BILD 10,A01,193142,Gustafson-Brown; Cindy,30,0,32,2
1683367474987,BILD 10,A02,193149,Gustafson-Brown; Cindy,31,0,32,1
1683367476012,BIMM 100,A01,193301,Staff,1,6,32,31
1683367476012,BIMM 100,A02,193312,Staff,0,5,32,32
1683367476012,BIMM 100,A03,193323,Staff,0,8,32,32
1683367477038,BIMM 101,A01,193329,McDonnell; Lisa Marie,0,3,24,24
1683367477038,BIMM 101,A02,193339,McDonnell; Lisa Marie,0,3,24,24
1683367477038,BIMM 101,B01,193354,McDonnell; Lisa Marie,0,3,24,24
1683367477038,BIMM 101,B02,193357,McDonnell; Lisa Marie,0,3,24,24
1683367478064,BIMM 110,A01,193377,Tat; John,0,11,32,32
1683367478064,BIMM 110,A02,193378,Tat; John,0,9,32,32
1683367479087,BIMM 120,A01,206116,Staff,0,0,32,32
1683367479087,BIMM 120,A02,206117,Staff,8,0,32,24
1683367479087,BIMM 120,A03,206121,Staff,21,0,32,11
1683367480117,BIPN 100,A01,193393,Park; Ji Young,0,14,32,32
1683367480117,BIPN 100,A02,193402,Park; Ji Young,0,13,32,32
1683367480117,BIPN 100,A03,193413,Park; Ji Young,0,14,32,32
1683367480117,BIPN 100,A04,193414,Park; Ji Young,0,13,32,32
1683367481145,BIPN 102,A01,193429,Staff,0,0,32,32
1683367481145,BIPN 102,A02,193438,Staff,22,0,32,10
1683367482174,BIPN 106,A01,193450,Reyes Gonzalez; Catalina,0,2,40,40
1683367483200,BIPN 134,A01,193465,Cooke; James Edward,1,0,32,31
1683367483200,BIPN 134,A02,193474,Cooke; James Edward,25,0,32,7
1683367483200,BIPN 134,A03,193485,Cooke; James Edward,29,0,32,3
1683367483200,BIPN 134,A04,193486,Cooke; James Edward,21,0,32,11
1683367483200,BIPN 134,A05,193491,Cooke; James Edward,31,0,32,1
1683367483200,BIPN 134,A06,193501,Cooke; James Edward,30,0,32,2
1683367483200,BIPN 134,A07,193510,Cooke; James Edward,29,0,32,3
1683367485250,BISP 194,A00,222522,Staff,14,0,32,18
1683367486276,CAT 124,A01,202407,Staff,19,0,25,6
1683367487301,CAT 125,A00,202408,Marchisotto; Jennifer Anne,4,0,20,16
1683367488325,CAT 125R,A00,202409,Smith; Lauryn Alissa,0,11,20,20
1683367488325,CAT 125R,B00,202410,Morales; Celeste Georgianna,0,11,20,20
1683367488325,CAT 125R,C00,202411,Irwin; Matthew Joseph,0,10,20,20
1683367489352,CENG 15,A01,204712,Yang; Kesong,0,1,0,0
1683367490380,CENG 114,A00,202070,Jahed Motlagh; Zeinab,5,0,20,15
1683367491408,CGS 105,A00,185477,Wesling; Megan E.,24,0,40,16
1683367492433,CGS 106,A00,185494,Staff,13,0,22,9
1683367493455,CGS 108,A00,185495,Staff,14,0,20,6
1683367494478,CGS 114,A00,185496,Staff,13,0,18,5
1683367495501,CGS 119,A00,185501,Staff,15,0,20,5
1683367496525,CGS 120,A00,185511,Staff,13,0,20,7
1683367497549,CHEM 4,A01,184675,Bussey; Thomas J,96,0,100,4
1683367498580,CHEM 6A,A01,184677,Staff,34,0,60,26
1683367499607,CHEM 6B,A01,184679,Staff,65,0,100,35
1683367500643,CHEM 6C,A01,184681,Bussey; Thomas J,1,0,50,49
1683367500643,CHEM 6C,A02,184682,Bussey; Thomas J,34,0,50,16
1683367501672,CHEM 40A,A01,184684,Albizati; Kim F.,37,0,100,63
1683367502695,CHEM 40B,A01,184686,Albizati; Kim F.,0,20,100,100
1683367503719,CHEM 41B,A01,184690,Staff,52,0,100,48
1683367504743,COGS 3,A01,184715,Boyle; Mary E. T.,0,25,40,40
1683367505767,COGS 14B,A01,185172,Staff,0,15,38,38
1683367506790,COGS 18,A01,184736,Staff,16,0,80,64
1683367507819,COGS 100,A01,184932,Staff,0,5,73,73
1683367508899,COGS 101A,A01,184935,Staff,0,39,30,30
1683367509922,COGS 101B,A01,184944,Staff,0,2,30,30
1683367510946,COGS 101C,A01,184946,Staff,0,12,30,30
1683367511969,COGS 102A,A01,184951,Johnson; Christine M.,2,0,40,38
1683367512992,COGS 107B,A01,184953,Mooshagian; Eric Frederick,0,50,40,40
1683367514017,COGS 118B,A01,184959,Gupta; Anjum,0,48,40,40
1683367515044,COGS 153,A00,184961,Staff,0,15,30,30
1683367516072,COGS 177,A00,184962,Staff,0,20,30,30
1683367517099,COGS 187A,A01,184969,Boyle; Mary E. T.,0,17,40,40
1683367518126,COMM 10,A01,185174,Staff,0,5,25,25
1683367518126,COMM 10,A02,185189,Staff,0,5,25,25
1683367518126,COMM 10,A03,269821,Staff,0,0,0,0
1683367519153,COMM 100B,A01,185475,Staff,0,0,0,2
1683367519153,COMM 100B,A02,185476,Staff,13,0,25,12
1683367520180,COMM 100C,A01,185314,Staff,1,0,25,24
1683367520180,COMM 100C,A02,185327,Staff,19,0,25,6
1683367521205,COMM 110M,A00,185349,Staff,2,0,40,38
1683367522231,COMM 113T,A00,185352,Staff,24,0,40,16
1683367523257,COMM 114I,A00,185353,Staff,33,0,40,7
1683367524284,COMM 131,A00,185354,Staff,19,0,30,11
1683367525313,CSE 8A,A50,185358,Cao; Yingjun,0,46,10,10
1683367526335,CSE 8B,A01,185362,Staff,0,46,50,50
1683367527364,CSE 11,A01,185416,Cao; Yingjun,0,92,10,10
1683367528388,CSE 20,A01,185445,Briones; Jor-el Thomas Caparas,5,0,25,20
1683367529415,CSE 21,A01,185447,Staff,10,0,50,40
1683367530457,CSE 101,A01,185451,Staff,0,13,50,50
1683367530457,CSE 101,B01,185453,Jones; Miles E,0,11,50,50
1683367532508,CSE 141,A01,185458,Eldon; John,20,0,100,80
1683367533538,CSE 141L,A01,185461,Eldon; John,12,0,100,88
1683367534567,CSE 142,A01,185463,Staff,36,0,60,24
1683367534567,CSE 142,B01,201355,Staff,0,7,60,60
1683367535591,CSE 142L,A01,185470,Staff,36,0,60,24
1683367535591,CSE 142L,B01,201417,Staff,0,6,60,60
1683367536615,CSE 190,A00,201433,Staff,32,0,49,17
1683367537640,DOC 1,A01,259136,Strom; Megan C.,7,0,15,8
1683367537640,DOC 1,A02,259137,Strom; Megan C.,14,0,15,1
1683367537640,DOC 1,A03,259138,Strom; Megan C.,14,0,15,1
1683367537640,DOC 1,A04,259139,Strom; Megan C.,14,0,15,1
1683367538664,DOC 100D,A00,259140,Pass; Natalye Joann,16,0,25,9
1683367539688,DSGN 1,A01,184749,Rill; Bryan,0,25,30,30
1683367540711,DSGN 100,A01,185168,Staff,0,2,25,25
1683367541734,ECE 5,A01,185626,Morris; Karcher William,0,10,0,0
1683367542758,ECE 101,A01,185628,Staff,17,0,70,53
1683367543785,ECE 107,A01,185635,Baghdadchi; Saharnaz,0,0,20,20
1683367543785,ECE 107,A02,185638,Baghdadchi; Saharnaz,4,0,20,16
1683367544812,ECE 148,A01,185647,Silberman; Jack,0,0,16,16
1683367545837,ECON 1,A01,185537,Crane; Meredith Helen,54,0,70,16
1683367546860,ECON 3,A01,185549,Crane; Meredith Helen,32,0,70,38
1683367547884,ECON 4,A01,203354,Anderson; John Charles,0,4,10,10
1683367548907,ECON 100A,A01,185574,Staff,0,4,40,40
1683367549932,ECON 100B,A01,185576,Staff,0,12,50,50
1683367550958,ECON 100C,A01,185589,Newhouse; Herbert S,29,0,70,41
1683367551986,ECON 105,A00,185608,Vespa; Emanuel Ignacio,19,0,35,16
1683367553010,ECON 109,A01,185610,Shishkin; Denis,10,0,35,25
1683367554033,ECON 110A,A01,185612,Staff,11,0,40,29
1683367555060,ECON 120A,A01,185615,Staff,20,0,40,20
1683367556089,ECON 120C,A01,185617,Sun; Yixiao,0,21,70,70
1683367557117,ECON 144,A00,203346,Squires; Dale E,3,0,35,32
1683367558144,ECON 171,A01,203349,Newhouse; Herbert S,0,1,35,35
1683367559168,ECON 173A,A01,185621,Toda; Alexis Akira,21,0,35,14
1683367560194,EDS 25,A01,202413,Staff,0,1,0,0
1683367560194,EDS 25,A02,202414,Staff,0,1,0,0
1683367560194,EDS 25,A03,202415,Staff,0,0,0,0
1683367560194,EDS 25,A04,202416,Staff,0,1,0,0
1683367560194,EDS 25,A05,202439,Staff,0,0,0,0
1683367560194,EDS 25,A06,202440,Staff,0,0,0,0
1683367560194,EDS 25,B01,202631,Staff,0,0,0,0
1683367560194,EDS 25,B02,202632,Staff,0,0,0,0
1683367560194,EDS 25,B03,202639,Staff,0,0,0,0
1683367560194,EDS 25,B04,202640,Staff,0,0,0,0
1683367560194,EDS 25,B05,202643,Staff,0,0,0,0
1683367560194,EDS 25,B06,202644,Staff,0,0,0,0
1683367561218,EDS 38,A01,202659,Black; Alison Michelle,24,0,25,1
1683367562243,EDS 115,A00,202652,Staff,18,0,30,12
1683367563267,EDS 125,A00,202649,Staff,14,0,30,16
1683367564294,EDS 126,A01,203332,Staff,30,0,30,0
1683367565322,EDS 139,A00,202838,Staff,16,0,25,9
1683367566346,EDS 146,A01,202655,Staff,14,0,25,11
1683367567371,ENG 15,A00,185667,Staff,0,1,0,0
1683367567371,ENG 15,B00,185672,Staff,0,0,0,0
1683367567371,ENG 15,C00,185675,Staff,0,0,0,0
1683367567371,ENG 15,D00,185682,Staff,0,0,0,0
1683367567371,ENG 15,E00,185684,Staff,0,0,0,0
1683367568396,ETHN 103,A00,185710,Staff,0,4,35,35
1683367569422,ETHN 103A,A00,199228,Man; Simeon S,2,0,9,7
1683367570449,ETHN 109,A00,185711,Staff,18,0,35,17
1683367571474,ETHN 142,A00,185726,Staff,0,4,30,30
1683367572501,ETHN 163J,A00,199229,Man; Simeon S,5,0,8,3
1683367573528,ETHN 168,A00,185727,Staff,8,0,10,2
1683367574554,ETHN 182,A00,185728,Staff,0,0,35,35
1683367575579,ETHN 183,A00,185737,Staff,8,0,18,10
1683367576606,GLBH 111,A01,209361,Burgos; Jose L.,0,0,0,0
1683367578673,HIEU 104,A00,185792,Staff,16,0,20,4
1683367579699,HIEU 115,A00,185800,Staff,1,0,20,19
1683367580731,HIEU 128,A00,185801,Staff,0,7,20,20
1683367581759,HIEU 147,A00,185802,Staff,16,0,20,4
1683367582785,HIEU 154,A00,185823,Staff,12,0,20,8
1683367583809,HILA 102,A00,185826,Staff,13,0,20,7
1683367584834,HILD 2C,A01,185778,Staff,0,12,20,20
1683367585858,HILD 7B,A01,185780,Kwak; Nancy,0,15,32,32
1683367585858,HILD 7B,A02,185781,Kwak; Nancy,0,18,32,32
1683367586881,HILD 30,A01,185791,Staff,14,0,20,6
1683367587908,HISC 119,A00,185830,Golan; Tal,0,9,20,20
1683367588935,HITO 156GS,A00,185831,Patterson; Patrick H.,0,0,0,23
1683367589965,HIUS 103,A00,185832,Man; Simeon S,1,6,20,19
1683367590989,HIUS 117,A00,185836,Kwak; Nancy,2,0,20,18
1683367592015,HIUS 125,A00,185840,Man; Simeon S,0,0,23,23
1683367593044,HIUS 149,A00,185845,Staff,0,0,20,20
1683367594073,HUM 3,A01,185882,Zavodny; Tatiana Sophia,0,7,50,50
1683367594073,HUM 3,B01,185899,Caldwell; Michael Alan,0,18,50,50
1683367595098,HUM 3GS,A00,185900,Patterson; Patrick H.,0,0,0,23
1683367596125,HUM 4,A01,185938,Zroka; Amy Liane,31,0,50,19
1683367596125,HUM 4,B01,185956,Watkins; Eric,0,3,50,50
1683367596125,HUM 4,B02,202209,Watkins; Eric,0,2,50,50
1683367596125,HUM 4,B03,202210,Watkins; Eric,0,2,50,50
1683367597147,HUM 5,A01,185958,West; Geoffrey Scott,3,0,50,47
1683367597147,HUM 5,A02,202215,West; Geoffrey Scott,0,0,50,50
1683367598172,INTL 190,A00,185959,Gagnon; Jeffrey C,0,0,0,9
1683367598172,INTL 190,B00,185960,Lettieri; Michael Joseph,0,0,0,1
1683367599199,JAPN 180,A00,254509,Staff,4,0,30,26
1683367600228,LATI 10,A01,202853,Kennemore; Amy Michelle,4,0,35,31
1683367600228,LATI 10,A02,202854,Kennemore; Amy Michelle,2,0,35,33
1683367600228,LATI 10,A03,270054,Kennemore; Amy Michelle,30,0,30,0
1683367601256,LATI 180,A00,202855,Kennemore; Amy Michelle,11,0,20,9
1683367602283,LAWS 101,A00,201767,Golan; Tal,0,7,40,40
1683367603308,LIFR 1C,A00,185961,Staff,6,0,20,14
1683367604333,LIFR 1CX,A00,185962,Staff,7,0,20,13
1683367605358,LIFR 1D,A00,185963,Staff,9,0,20,11
1683367606384,LIFR 1DX,A00,185964,Staff,9,0,20,11
1683367607410,LIGN 101,A01,186039,Staff,43,0,50,7
1683367608438,LIGN 165,A00,186040,Staff,18,0,50,32
1683367609465,LTCS 108,A00,186041,Staff,6,0,10,4
1683367610491,LTCS 119,A00,186042,Staff,16,0,20,4
1683367611519,LTCS 130,A00,186043,Wesling; Megan E.,15,0,25,10
1683367613632,LTEA 138,A00,186119,Staff,14,0,40,26
1683367614660,LTEN 124,A00,186148,Staff,6,0,25,19
1683367615686,LTEN 178,A00,186149,Staff,7,0,15,8
1683367616711,LTEN 181,A00,186150,Blanco; John D,33,0,40,7
1683367617735,LTWL 120,A00,186160,Staff,20,0,25,5
1683367618760,LTWL 165,A00,186161,Staff,22,0,25,3
1683367619785,LTWR 100,A00,186162,Staff,0,5,15,15
1683367620809,LTWR 102,A00,186163,Doller; Ben,5,0,15,10
1683367621835,MAE 8,A01,186412,Staff,0,0,0,0
1683367622861,MAE 30B,A00,186445,Bahadori; Mohammad Yousef,83,0,100,17
1683367623886,MAE 40,A00,186592,Bewley; Thomas R,10,0,50,40
1683367624910,MAE 101B,A00,186593,Bahadori; Mohammad Yousef,81,0,100,19
1683367625936,MAE 105,A00,186594,Bandaru; Prabhakar,12,0,50,38
1683367626965,MAE 107,A00,186599,Pham; Hieu Tan,0,7,120,120
1683367627991,MAE 148,A01,186660,Silberman; Jack,3,0,16,13
1683367629020,MATH 10A,A01,188095,Staff,0,5,35,35
1683367630050,MATH 10B,A01,188097,Bowers; Adam R.,0,11,30,30
1683367630050,MATH 10B,A02,188099,Bowers; Adam R.,0,11,30,30
1683367630050,MATH 10B,B01,188104,Bowers; Adam R.,0,10,30,30
1683367630050,MATH 10B,B02,188106,Bowers; Adam R.,0,10,30,30
1683367631081,MATH 10C,A01,188111,Staff,0,18,30,30
1683367631081,MATH 10C,A02,188127,Staff,0,17,30,30
1683367631081,MATH 10C,A03,188131,Staff,0,18,30,30
1683367631081,MATH 10C,B01,188218,Staff,18,0,30,12
1683367631081,MATH 10C,B02,188244,Staff,13,0,30,17
1683367631081,MATH 10C,B03,188277,Staff,16,0,30,14
1683367632111,MATH 18,A01,188344,Bach; Quang Tran,18,0,30,12
1683367632111,MATH 18,A02,188345,Bach; Quang Tran,11,0,30,19
1683367632111,MATH 18,B01,188353,Bach; Quang Tran,10,0,30,20
1683367632111,MATH 18,B02,188354,Bach; Quang Tran,20,0,30,10
1683367633139,MATH 20A,A01,188374,Staff,12,0,35,23
1683367634169,MATH 20B,A01,188382,Ohm; Ko Woon,6,0,30,24
1683367634169,MATH 20B,A02,188383,Ohm; Ko Woon,21,0,30,9
1683367634169,MATH 20B,B01,188385,Ohm; Ko Woon,7,0,30,23
1683367634169,MATH 20B,B02,188392,Ohm; Ko Woon,22,0,30,8
1683367635195,MATH 20C,A01,188394,Harel; Guershon,10,0,30,20
1683367635195,MATH 20C,A02,188395,Harel; Guershon,15,0,30,15
1683367635195,MATH 20C,B01,188404,Harel; Guershon,4,0,30,26
1683367635195,MATH 20C,B02,188405,Harel; Guershon,19,0,30,11
1683367636220,MATH 20D,A01,188414,Hammock; Frances H,0,1,30,30
1683367636220,MATH 20D,A02,188415,Hammock; Frances H,3,0,30,27
1683367636220,MATH 20D,B01,188447,Hammock; Frances H,1,0,30,29
1683367636220,MATH 20D,B02,188486,Hammock; Frances H,8,0,30,22
1683367637245,MATH 20E,A01,188649,Staff,21,0,30,9
1683367637245,MATH 20E,A02,188650,Staff,23,0,30,7
1683367637245,MATH 20E,A03,188673,Staff,0,0,30,30
1683367638269,MATH 102,A01,188675,Staff,0,35,35,35
1683367639294,MATH 103B,A01,188681,Staff,3,0,35,32
1683367639294,MATH 103B,B01,188692,Staff,5,0,35,30
1683367640337,MATH 109,A01,188695,Salehi Golsefidy; Alireza,25,0,35,10
1683367640337,MATH 109,A02,188696,Salehi Golsefidy; Alireza,25,0,35,10
1683367641362,MATH 120A,A01,188698,Eggers; John Dietrich,7,0,35,28
1683367642392,MATH 142B,A01,188736,Ioana; Adrian,0,2,30,30
1683367642392,MATH 142B,A02,188741,Ioana; Adrian,0,0,30,30
1683367642392,MATH 142B,A03,188743,Ioana; Adrian,0,1,30,30
1683367643422,MATH 168A,A01,188790,Staff,0,9,35,35
1683367644452,MATH 170A,A01,188803,Nie; Jiawang,0,2,35,35
1683367644452,MATH 170A,A02,188811,Nie; Jiawang,0,0,35,35
1683367644452,MATH 170A,A03,188814,Nie; Jiawang,1,0,35,34
1683367644452,MATH 170A,A04,188815,Nie; Jiawang,13,0,35,22
1683367645479,MATH 193B,A01,188817,Staff,0,0,35,35
1683367645479,MATH 193B,A02,188818,Staff,5,0,35,30
1683367646503,MGT 4,A01,202857,Anderson; John Charles,61,0,80,19
1683367647530,MGT 12,A00,202858,Lindenberger; Wade Douglas,41,0,90,49
1683367648553,MGT 18,A00,202859,Staff,74,0,90,16
1683367649578,MGT 18GS,A00,202860,McKay; Michael J,13,0,28,15
1683367650607,MGT 45,A00,202861,Pecore; Joseph P.,15,0,90,75
1683367651641,MGT 100,A00,202863,Yavorsky; Daniel Ryan,28,0,90,62
1683367652666,MGT 103,A00,202864,Ehrich; Kristine R,0,17,90,90
1683367653695,MGT 112,A00,202865,Ehrich; Kristine R,15,0,90,75
1683367654724,MGT 121A,A00,202868,Staff,0,20,0,0
1683367655752,MGT 131B,A00,202869,Anderson; John Charles,59,0,90,31
1683367656775,MGT 136,A00,202871,Lindenberger; Wade Douglas,84,0,90,6
1683367657799,MGT 164,A00,202873,Staff,0,68,90,91
1683367658824,MGT 164GS,A00,202874,McKay; Mary A,13,0,28,15
1683367659847,MGT 180,A00,202875,Staff,0,50,90,91
1683367660872,MMW 11R,A01,205019,Herbst; Matthew,3,0,30,27
1683367660872,MMW 11R,A02,205026,Herbst; Matthew,29,0,30,1
1683367661897,MMW 15,A01,193512,Chang; Edmond Yi-Teh,0,9,28,28
1683367661897,MMW 15,A02,193513,Chang; Edmond Yi-Teh,0,5,28,28
1683367661897,MMW 15,A03,193514,Chang; Edmond Yi-Teh,0,5,28,28
1683367661897,MMW 15,A04,193515,Chang; Edmond Yi-Teh,0,5,28,28
1683367661897,MMW 15,A05,193516,Chang; Edmond Yi-Teh,0,4,28,28
1683367661897,MMW 15,A06,193517,Chang; Edmond Yi-Teh,0,5,28,28
1683367661897,MMW 15,B01,193519,Chang; Edmond Yi-Teh,0,5,28,28
1683367661897,MMW 15,B02,193520,Chang; Edmond Yi-Teh,0,5,28,28
1683367661897,MMW 15,B03,193521,Chang; Edmond Yi-Teh,0,5,28,28
1683367661897,MMW 15,B04,193522,Chang; Edmond Yi-Teh,0,4,28,28
1683367661897,MMW 15,B05,193523,Chang; Edmond Yi-Teh,0,5,28,28
1683367661897,MMW 15,B06,193524,Chang; Edmond Yi-Teh,0,4,28,28
1683367662926,MMW 122,A01,193526,Rahimi; Babak,0,15,28,28
1683367662926,MMW 122,A02,193527,Rahimi; Babak,0,14,28,28
1683367662926,MMW 122,A03,193528,Rahimi; Babak,0,0,0,0
1683367662926,MMW 122,A04,193529,Rahimi; Babak,0,0,0,0
1683367663953,MUS 1A,A01,186663,Staff,0,20,35,35
1683367664980,MUS 4,A01,186715,Staff,0,12,35,35
1683367666009,MUS 5R,A01,186796,Dubnov; Shlomo,0,17,35,35
1683367667033,MUS 6,A01,186798,Staff,0,4,25,25
1683367668057,MUS 7,A01,186830,Staff,13,0,35,22
1683367669081,MUS 8,A01,186930,Staff,0,26,35,35
1683367670105,MUS 15,A01,186932,Staff,0,16,35,35
1683367670105,MUS 15,B01,186934,Staff,0,15,35,35
1683367671129,MUS 80,A00,186935,Staff,0,0,20,20
1683367671129,MUS 80,B00,186936,Staff,25,0,25,0
1683367672154,NANO 11,A00,204702,Lipomi; Darren John,0,0,0,0
1683367673180,NANO 15,A01,204709,Yang; Kesong,0,1,0,0
1683367674207,NANO 114,A00,202069,Jahed Motlagh; Zeinab,3,0,10,7
1683367675236,PHIL 1,A00,186955,Grush; Rick Scott,32,0,40,8
1683367676268,PHIL 10,A01,186973,Grush; Rick Scott,28,0,35,7
1683367676268,PHIL 10,A02,186974,Grush; Rick Scott,33,0,35,2
1683367677295,PHIL 13,A01,186976,Staff,7,0,35,28
1683367677295,PHIL 13,A02,186977,Staff,16,0,35,19
1683367678318,PHIL 14,A01,186979,Staff,31,0,35,4
1683367678318,PHIL 14,A02,186986,Staff,32,0,35,3
1683367679352,PHIL 28,A01,186988,Staff,16,0,30,14
1683367679352,PHIL 28,A02,186989,Staff,1,0,30,29
1683367679352,PHIL 28,A03,186990,Staff,9,0,30,21
1683367679352,PHIL 28,A04,186991,Staff,26,0,30,4
1683367680382,PHIL 120,A00,186997,Staff,23,0,40,17
1683367681405,PHIL 137,A00,187003,Staff,9,0,40,31
1683367682435,PHIL 150,A00,187015,Staff,47,0,70,23
1683367683460,PHIL 167,A00,187021,Lamey; Andy M.,35,0,40,5
1683367684485,PHIL 174,A01,202226,Staff,17,0,20,3
1683367684485,PHIL 174,A02,202235,Staff,20,0,20,0
1683367685510,PHIL 191A,A00,258918,Staff,0,0,1,1
1683367686535,PHYS 1A,A00,187028,Staff,27,0,60,33
1683367687560,PHYS 1AL,001,187036,Staff,2,0,30,28
1683367687560,PHYS 1AL,002,187049,Staff,18,0,30,12
1683367688588,PHYS 1B,A00,187058,Staff,22,0,60,38
1683367689612,PHYS 1BL,001,187064,Staff,0,0,30,30
1683367689612,PHYS 1BL,002,187070,Staff,5,0,30,25
1683367690639,PHYS 1C,A00,187082,Staff,31,0,120,89
1683367691668,PHYS 1CL,001,187088,Staff,0,9,30,30
1683367691668,PHYS 1CL,002,187089,Staff,0,2,30,30
1683367691668,PHYS 1CL,009,262693,Staff,11,0,30,19
1683367692696,PHYS 2B,A01,187097,Staff,54,0,115,61
1683367693724,PHYS 2C,A01,187099,Staff,67,0,115,48
1683367694752,PHYS 2CL,A01,187101,Staff,5,0,28,23
1683367694752,PHYS 2CL,A02,187102,Staff,15,0,28,13
1683367695778,PHYS 2D,A01,187123,Shotwell; Brian,95,0,115,20
1683367696804,PHYS 4B,A01,187133,Grinstein; Benjamin,35,0,50,15
1683367697829,POLI 10,A00,188819,Staff,0,4,50,50
1683367698856,POLI 11,A00,188827,Staff,43,0,50,7
1683367699881,POLI 13R,A00,188828,Staff,0,1,20,20
1683367700911,POLI 27,A01,188830,Elgin; Samuel Zincke,0,1,70,70
1683367701940,POLI 30,A00,188832,Desposato; Scott,31,0,50,19
1683367702967,POLI 102F,A00,188834,Staff,2,0,40,38
1683367703993,POLI 104A,A00,188852,Staff,14,0,30,16
1683367705019,POLI 104I,A00,188853,Staff,0,6,20,20
1683367706044,POLI 110B,A00,188854,Wiens; David,7,0,20,13
1683367707069,POLI 112A,A00,188855,Wiens; David,5,0,30,25
1683367708092,POLI 117R,A00,188856,Forman; Fonna,0,11,20,20
1683367709121,POLI 118,A00,188857,Ingham; Sean,8,0,20,12
1683367710151,POLI 120G,A00,188858,Staff,9,0,30,21
1683367711178,POLI 131CR,A00,188863,Hoston; Germaine,23,0,50,27
1683367712204,POLI 133,A00,188864,Nellis; Gareth Hb,44,0,50,6
1683367713237,POLI 134D,A00,188865,Desposato; Scott,27,0,30,3
1683367714264,POLI 142A,A00,188871,Gartzke; Erik,22,0,50,28
1683367715291,POLI 142K,A00,188874,Staff,38,0,50,12
1683367716393,POLI 143,A00,188940,Gartzke; Erik,16,0,30,14
1683367717420,POLI 153,A00,188943,Staff,3,0,20,17
1683367718448,POLI 160AA,A00,188944,Staff,11,0,40,29
1683367719473,POLI 170A,A00,188945,Staff,11,0,30,19
1683367721522,PSYC 1,A00,188952,Staff,37,0,90,53
1683367722544,PSYC 2,B00,188953,Staff,19,0,35,16
1683367723574,PSYC 6,A00,188970,Staff,47,0,60,13
1683367724600,PSYC 7,A00,188973,Staff,37,0,45,8
1683367725630,PSYC 60,A01,188980,Rickard; Timothy C.,43,0,60,17
1683367726658,PSYC 70,A01,189001,Steiner; Eric Tomas,23,0,45,22
1683367727686,PSYC 100,A00,189005,Lacefield; Katharine I,0,98,120,120
1683367728709,PSYC 102,A00,189008,Staff,9,0,30,21
1683367729733,PSYC 106,B00,189026,Gorman; Michael R.,34,0,60,26
1683367730759,PSYC 114,B01,189033,Winkielman; Piotr,0,32,30,30
1683367731783,PSYC 131,A00,189036,Anagnostaras; Stephan,0,43,60,60
1683367732808,PSYC 136,A00,189041,Lowe; Angela Beth,0,7,25,25
1683367733833,PSYC 137,A00,189057,Winkielman; Piotr,0,34,25,25
1683367734857,PSYC 144,A00,189107,Wixted; John T,0,7,50,50
1683367736913,PSYC 162,A00,189142,Staff,0,8,85,85
1683367737938,PSYC 172,A00,189144,Gorman; Michael R.,0,7,30,30
1683367739986,PSYC 179,A00,189146,Lacefield; Katharine I,0,84,120,120
1683367741013,PSYC 181,A00,189147,Anagnostaras; Stephan,0,44,90,90
1683367742039,PSYC 190R,A00,189148,Barner; David A.,0,22,80,80
1683367743062,PSYC 191,A00,189275,Rickard; Timothy C.,0,7,25,25
1683367744089,PSYC 193,A00,189276,Chapman; Eddie Nathaniel,0,1,0,4
1683367745117,PSYC 193L,A01,189281,Lowe; Angela Beth,12,0,20,8
1683367745117,PSYC 193L,B01,189285,Staff,28,0,35,7
1683367746142,RELI 149,A00,187137,Rahimi; Babak,7,0,40,33
1683367747170,SE 9,A01,187315,Staff,0,2,18,18
1683367748198,SE 101B,A00,187409,Staff,24,0,30,6
1683367749223,SE 110B,A00,187444,Staff,10,0,40,30
1683367750251,SE 130B,A00,187449,Staff,31,0,40,9
1683367751276,SE 150A,A00,187516,Staff,9,0,20,11
1683367752301,SE 154,A00,187528,Staff,30,0,50,20
1683367753326,SIO 3,A01,258171,Staff,35,0,40,5
1683367754350,SIO 10,A00,187144,Cook; Geoffrey W,0,3,75,75
1683367755374,SIO 45,A00,187152,Cook; Geoffrey W,1,0,100,99
1683367756400,SIO 109R,A00,194486,Staff,0,3,20,20
1683367758455,SIO 187,A01,187233,Kacev; David,12,0,40,28
1683367759485,SOCI 1,A01,258656,Thorpe; Charles Robert,28,0,30,2
1683367759485,SOCI 1,A02,258658,Thorpe; Charles Robert,30,0,30,0
1683367759485,SOCI 1,A03,258661,Thorpe; Charles Robert,25,0,25,0
1683367759485,SOCI 1,A04,258666,Thorpe; Charles Robert,22,0,25,3
1683367759485,SOCI 1,A05,258897,Thorpe; Charles Robert,23,0,25,2
1683367759485,SOCI 1,A06,258898,Thorpe; Charles Robert,25,0,25,0
1683367760508,SOCI 30,A01,258903,Pardo Guerra; Juan Pablo,15,0,30,15
1683367761533,SOCI 102,A00,258904,Staff,9,0,25,16
1683367762558,SOCI 106,A00,258905,Staff,19,0,25,6
1683367763582,SOCI 111,A00,258907,Ribas Norris; Janet Vanesa,26,0,30,4
1683367764606,SOCI 121R,A00,258908,Pardo Guerra; Juan Pablo,10,0,30,20
1683367765634,SOCI 126,A01,203330,Staff,14,0,20,6
1683367766662,SOCI 131,A00,258909,Thorpe; Charles Robert,31,0,60,29
1683367767686,SOCI 135,A00,258910,Payne; Christine Anna,0,9,30,30
1683367768711,SOCI 157,A00,258911,Staff,12,0,30,18
1683367769735,SOCI 184,A00,258912,Staff,25,0,30,5
1683367770758,SOCI 188D,A00,258913,Staff,22,0,30,8
1683367771783,SYN 2,001,187529,Staff,10,0,16,6
1683367771783,SYN 2,002,201452,Staff,0,18,16,16
1683367771783,SYN 2,003,201469,Staff,3,0,16,13
1683367772808,SYN 100,A01,187531,Staff,0,9,20,20
1683367772808,SYN 100,B01,201491,Staff,0,12,20,20
1683367773835,TDAC 1,A00,189286,Walsh; Kim C.,3,0,20,17
1683367773835,TDAC 1,B00,189287,Harting; Carla Kelso,11,0,20,9
1683367774858,TDAC 101,A00,189300,Walsh; Kim C.,16,0,20,4
1683367774858,TDAC 101,B00,189301,Harting; Carla Kelso,18,0,20,2
1683367775884,TDAC 102,A00,189304,Basso; Beatrice,14,0,20,6
1683367776910,TDAC 108,A00,189305,Staff,18,0,20,2
1683367777943,TDDE 131,A00,189310,Staff,19,0,20,1
1683367777943,TDDE 131,B00,189314,Staff,19,0,20,1
1683367777943,TDDE 131,C00,189315,Staff,48,0,50,2
1683367777943,TDDE 131,D00,189316,Staff,14,0,15,1
1683367777943,TDDE 131,E00,204841,Staff,20,0,20,0
1683367778966,TDGE 10,A00,189289,Staff,30,0,50,20
1683367778966,TDGE 10,B00,189290,Havis; Allan,1,0,50,49
1683367779992,TDGE 11,A00,189291,Fulton; Julia,0,3,50,50
1683367779992,TDGE 11,B00,189292,Staff,20,0,25,5
1683367779992,TDGE 11,C00,260270,Staff,0,0,0,0
1683367781016,TDGE 25,A00,189294,Staff,3,0,20,17
1683367782040,TDGE 124,A00,189318,Fulton; Julia,0,8,50,50
1683367783064,TDGE 125,A00,189319,Staff,13,0,25,12
1683367783064,TDGE 125,B00,189320,Staff,23,0,25,2
1683367784089,TDGE 127,A00,189322,Havis; Allan,0,0,50,50
1683367785117,TDHT 101,A00,189323,Staff,18,0,25,7
1683367785117,TDHT 101,B00,189324,Staff,25,0,25,0
1683367786141,TDHT 102,A00,189325,Staff,49,0,50,1
1683367787166,TDMV 1,A00,189295,Arcidiacono; Kristin,19,0,30,11
1683367787166,TDMV 1,B00,189296,Caligagan; Maria T.,24,0,30,6
1683367788190,TDMV 2,A00,189297,Sammartano; Tonnie,28,0,30,2
1683367788190,TDMV 2,B00,189299,Arcidiacono; Kristin,24,0,30,6
1683367789215,TDMV 3,A00,204998,Rincon; Alicia,22,0,30,8
1683367790239,TDMV 120,A00,189458,Sammartano; Tonnie,28,0,30,2
1683367791264,TDMV 138,A00,189541,Jun; Grace Shin Hae,22,0,40,18
1683367792288,TDMV 142,A00,189717,Caligagan; Tony,24,0,30,6
1683367792288,TDMV 142,B00,189718,Caligagan; Maria T.,25,0,30,5
1683367793313,TMC 2,A01,187533,Staff,25,0,25,0
1683367793313,TMC 2,A02,187534,Staff,25,0,25,0
1683367794341,USP 1,A01,187536,Kwak; Nancy,0,16,25,25
1683367795369,USP 5,A01,187538,Staff,10,0,25,15
1683367796396,USP 101,A00,199253,Staff,0,4,0,0
1683367797421,USP 124,A00,187562,Boomhower; Matthew Charles,1,0,30,29
1683367798444,USP 138,A00,187582,Staff,20,0,25,5
1683367799468,USP 152,A01,187597,Staff,4,0,25,21
1683367800492,USP 153,A00,187598,Staff,19,0,25,6
1683367801519,USP 168,A00,187607,Kwak; Nancy,2,0,5,3
1683367802544,USP 173,A00,187619,Staff,4,0,25,21
1683367803568,USP 181,A00,187638,Staff,0,3,25,25
1683367804593,VIS 103,A00,187650,Cruz; Edwin Teddy,22,0,75,53
1683367805616,VIS 110D,A00,187669,Staff,12,0,22,10
1683367806644,VIS 127C,A00,187720,Shen; Kuiyi,67,0,146,79
1683367807672,VIS 149,A00,187731,Yoldas; Pinar,0,14,22,22
1683367808699,VIS 151,A01,188091,Staff,22,0,34,12
1683367808699,VIS 151,A02,188092,Staff,11,0,34,23
1683367809730,VIS 160B,A00,188093,Stalbaum; Brett,0,0,10,10
1683367811784,WCWP 10B,A00,201720,Staff,10,0,15,5
1683367811784,WCWP 10B,B00,201722,Staff,9,0,15,6
1683367812810,WCWP 100,A00,201725,Gagnon; Jeffrey C,0,0,2,2
1683367812810,WCWP 100,B00,201727,Staff,0,4,15,15
1683367815946,ANBI 133,A00,258401,Wilder; Linnea Lorene,34,0,40,6
1683367816975,ANBI 140,A00,258395,Hrvoj Mihic; Branka,18,0,25,7
1683367818000,ANSC 120,A00,258402,Bialecki; Jon Anthony,27,0,40,13
1683367819025,ANSC 144,A00,258400,Staff,14,0,40,26
1683367821137,ANSC 166,A00,258396,Parish; Steven Martin,158,0,175,17
1683367822162,ANSC 180,A00,193533,Staff,9,0,20,11
1683367823188,ANSC 188,A00,258397,Jassal; Aftab,33,0,40,7
1683367824216,ANTH 3,A01,258316,Staff,23,0,30,7
1683367825240,ANTH 5,A00,258394,Semendeferi; Ekaterini,16,0,20,4
1683367826265,ANTH 21,A01,258331,Staff,8,0,40,32
1683367827288,ANTH 103,A00,258398,Varma; Saiba,15,0,25,10
1683367828315,AWP 10,001,202034,Staff,0,0,0,0
1683367828315,AWP 10,002,202035,Staff,0,0,0,0
1683367828315,AWP 10,003,202036,Staff,0,0,0,0
1683367828315,AWP 10,004,202037,Staff,0,0,0,0
1683367828315,AWP 10,005,202038,Staff,0,0,0,0
1683367828315,AWP 10,006,202039,Staff,0,0,0,0
1683367828315,AWP 10,007,202040,Staff,0,0,0,0
1683367828315,AWP 10,008,202041,Staff,0,0,0,0
1683367828315,AWP 10,009,202042,Staff,0,0,0,0
1683367828315,AWP 10,010,202043,Staff,0,0,0,0
1683367828315,AWP 10,011,202044,Staff,0,0,0,0
1683367828315,AWP 10,012,202045,Staff,0,0,0,0
1683367828315,AWP 10,013,202046,Staff,0,0,0,0
1683367828315,AWP 10,014,202047,Staff,0,0,0,0
1683367828315,AWP 10,015,202048,Staff,0,0,0,0
1683367828315,AWP 10,016,202049,Staff,0,0,0,0
1683367828315,AWP 10,017,202050,Staff,0,0,0,0
1683367828315,AWP 10,018,202051,Staff,0,0,0,0
1683367828315,AWP 10,019,202052,Staff,0,0,0,0
1683367828315,AWP 10,020,202053,Staff,0,0,0,0
1683367828315,AWP 10,021,202054,Staff,0,0,0,0
1683367828315,AWP 10,022,202055,Staff,0,0,0,0
1683367828315,AWP 10,023,202056,Staff,0,0,0,0
1683367828315,AWP 10,024,202057,Staff,0,0,0,0
1683367828315,AWP 10,025,202058,Staff,0,0,0,0
1683367828315,AWP 10,026,202059,Staff,0,0,0,0
1683367829339,AWP 102,001,202032,Staff,0,0,0,0
1683367829339,AWP 102,002,202033,Staff,0,0,0,0
1683367830369,BENG 100,A01,254234,Taylor Amos; Alyssa C,31,0,40,9
1683367831403,BENG 196,001,270013,Engler; Adam J.,9999,0,9999,0
1683367832436,BICD 100R,A01,202018,Smith; Laurie,0,7,32,32
1683367832436,BICD 100R,A02,202019,Smith; Laurie,0,2,32,32
1683367832436,BICD 100R,A03,202020,Smith; Laurie,0,1,32,32
1683367832436,BICD 100R,A04,202021,Smith; Laurie,9,0,32,23
1683367832436,BICD 100R,A05,202022,Smith; Laurie,12,0,32,20
1683367833462,BICD 136,A01,193242,Gustafson-Brown; Cindy,0,2,32,32
1683367833462,BICD 136,A02,193244,Gustafson-Brown; Cindy,14,0,32,18
1683367834495,BIEB 102,A01,193249,Butler; Shannon Rhey,0,2,32,32
1683367834495,BIEB 102,A02,193251,Butler; Shannon Rhey,0,0,32,32
1683367834495,BIEB 102,A03,193253,Butler; Shannon Rhey,0,1,32,32
1683367834495,BIEB 102,A04,193255,Butler; Shannon Rhey,17,0,32,15
1683367834495,BIEB 102,A05,193265,Butler; Shannon Rhey,26,0,32,6
1683367834495,BIEB 102,A06,193269,Butler; Shannon Rhey,16,0,32,16
1683367836549,BIEB 150,A01,193274,Staff,0,0,32,32
1683367836549,BIEB 150,A02,193285,Staff,23,0,32,9
1683367837575,BIEB 194,A00,193286,Kurle; Carolyn M.,22,0,32,10
1683367838609,BILD 1,A01,192291,Staff,16,0,32,16
1683367838609,BILD 1,A02,192292,Staff,30,0,32,2
1683367838609,BILD 1,B01,192520,Reuther; Keefe,0,1,0,0
1683367838609,BILD 1,B02,192532,Reuther; Keefe,0,1,0,0
1683367839640,BILD 3,A01,192556,Butler; Shannon Rhey,0,0,32,32
1683367839640,BILD 3,A02,192581,Butler; Shannon Rhey,4,0,32,28
1683367839640,BILD 3,A03,192611,Butler; Shannon Rhey,23,0,32,9
1683367839640,BILD 3,A04,192612,Butler; Shannon Rhey,25,0,32,7
1683367839640,BILD 3,A05,192613,Butler; Shannon Rhey,27,0,32,5
1683367839640,BILD 3,A06,192679,Butler; Shannon Rhey,27,0,32,5
1683367839640,BILD 3,A07,192682,Butler; Shannon Rhey,21,0,32,11
1683367840667,BILD 4,A01,192836,Reuther; Keefe,0,0,24,24
1683367840667,BILD 4,A02,193044,Reuther; Keefe,4,0,24,20
1683367841694,BILD 10,A01,193142,Gustafson-Brown; Cindy,30,0,32,2
1683367841694,BILD 10,A02,193149,Gustafson-Brown; Cindy,31,0,32,1
1683367842718,BIMM 100,A01,193301,Staff,1,6,32,31
1683367842718,BIMM 100,A02,193312,Staff,0,5,32,32
1683367842718,BIMM 100,A03,193323,Staff,0,8,32,32
1683367843744,BIMM 101,A01,193329,McDonnell; Lisa Marie,0,3,24,24
1683367843744,BIMM 101,A02,193339,McDonnell; Lisa Marie,0,3,24,24
1683367843744,BIMM 101,B01,193354,McDonnell; Lisa Marie,0,3,24,24
1683367843744,BIMM 101,B02,193357,McDonnell; Lisa Marie,0,3,24,24
1683367844772,BIMM 110,A01,193377,Tat; John,0,11,32,32
1683367844772,BIMM 110,A02,193378,Tat; John,0,9,32,32
1683367845800,BIMM 120,A01,206116,Staff,0,0,32,32
1683367845800,BIMM 120,A02,206117,Staff,8,0,32,24
1683367845800,BIMM 120,A03,206121,Staff,21,0,32,11
1683367846826,BIPN 100,A01,193393,Park; Ji Young,0,14,32,32
1683367846826,BIPN 100,A02,193402,Park; Ji Young,0,13,32,32
1683367846826,BIPN 100,A03,193413,Park; Ji Young,0,14,32,32
1683367846826,BIPN 100,A04,193414,Park; Ji Young,0,13,32,32
1683367847850,BIPN 102,A01,193429,Staff,0,0,32,32
1683367847850,BIPN 102,A02,193438,Staff,22,0,32,10
1683367848874,BIPN 106,A01,193450,Reyes Gonzalez; Catalina,0,2,40,40
1683367849900,BIPN 134,A01,193465,Cooke; James Edward,1,0,32,31
1683367849900,BIPN 134,A02,193474,Cooke; James Edward,25,0,32,7
1683367849900,BIPN 134,A03,193485,Cooke; James Edward,29,0,32,3
1683367849900,BIPN 134,A04,193486,Cooke; James Edward,21,0,32,11
1683367849900,BIPN 134,A05,193491,Cooke; James Edward,31,0,32,1
1683367849900,BIPN 134,A06,193501,Cooke; James Edward,30,0,32,2
1683367849900,BIPN 134,A07,193510,Cooke; James Edward,29,0,32,3
1683367851950,BISP 194,A00,222522,Staff,14,0,32,18
1683367852974,CAT 124,A01,202407,Staff,19,0,25,6
1683367854000,CAT 125,A00,202408,Marchisotto; Jennifer Anne,4,0,20,16
1683367855028,CAT 125R,A00,202409,Smith; Lauryn Alissa,0,11,20,20
1683367855028,CAT 125R,B00,202410,Morales; Celeste Georgianna,0,11,20,20
1683367855028,CAT 125R,C00,202411,Irwin; Matthew Joseph,0,10,20,20
1683367856053,CENG 15,A01,204712,Yang; Kesong,0,1,0,0
1683367857078,CENG 114,A00,202070,Jahed Motlagh; Zeinab,5,0,20,15
1683367858106,CGS 105,A00,185477,Wesling; Megan E.,24,0,40,16
1683367859137,CGS 106,A00,185494,Staff,13,0,22,9
1683367860162,CGS 108,A00,185495,Staff,14,0,20,6
1683367861186,CGS 114,A00,185496,Staff,13,0,18,5
1683367862214,CGS 119,A00,185501,Staff,15,0,20,5
1683367863239,CGS 120,A00,185511,Staff,13,0,20,7
1683367864265,CHEM 4,A01,184675,Bussey; Thomas J,96,0,100,4
1683367865291,CHEM 6A,A01,184677,Staff,34,0,60,26
1683367866316,CHEM 6B,A01,184679,Staff,65,0,100,35
1683367867340,CHEM 6C,A01,184681,Bussey; Thomas J,1,0,50,49
1683367867340,CHEM 6C,A02,184682,Bussey; Thomas J,34,0,50,16
1683367868367,CHEM 40A,A01,184684,Albizati; Kim F.,37,0,100,63
1683367869393,CHEM 40B,A01,184686,Albizati; Kim F.,0,20,100,100
1683367870417,CHEM 41B,A01,184690,Staff,52,0,100,48
1683367871449,COGS 3,A01,184715,Boyle; Mary E. T.,0,25,40,40
1683367872473,COGS 14B,A01,185172,Staff,0,15,38,38
1683367873498,COGS 18,A01,184736,Staff,16,0,80,64
1683367874526,COGS 100,A01,184932,Staff,0,5,73,73
1683367875550,COGS 101A,A01,184935,Staff,0,39,30,30
1683367876579,COGS 101B,A01,184944,Staff,0,2,30,30
1683367877602,COGS 101C,A01,184946,Staff,0,12,30,30
1683367878626,COGS 102A,A01,184951,Johnson; Christine M.,2,0,40,38
1683367879650,COGS 107B,A01,184953,Mooshagian; Eric Frederick,0,50,40,40
1683367880675,COGS 118B,A01,184959,Gupta; Anjum,0,48,40,40
1683367881699,COGS 153,A00,184961,Staff,0,15,30,30
1683367882724,COGS 177,A00,184962,Staff,0,20,30,30
1683367883750,COGS 187A,A01,184969,Boyle; Mary E. T.,0,17,40,40
1683367884781,COMM 10,A01,185174,Staff,0,5,25,25
1683367884781,COMM 10,A02,185189,Staff,0,5,25,25
1683367884781,COMM 10,A03,269821,Staff,0,0,0,0
1683367885813,COMM 100B,A01,185475,Staff,0,0,0,2
1683367885813,COMM 100B,A02,185476,Staff,13,0,25,12
1683367886840,COMM 100C,A01,185314,Staff,1,0,25,24
1683367886840,COMM 100C,A02,185327,Staff,19,0,25,6
1683367887867,COMM 110M,A00,185349,Staff,2,0,40,38
1683367888894,COMM 113T,A00,185352,Staff,24,0,40,16
1683367889920,COMM 114I,A00,185353,Staff,33,0,40,7
1683367890947,COMM 131,A00,185354,Staff,19,0,30,11
1683367891971,CSE 8A,A50,185358,Cao; Yingjun,0,46,10,10
1683367892999,CSE 8B,A01,185362,Staff,0,46,50,50
1683367894028,CSE 11,A01,185416,Cao; Yingjun,0,92,10,10
1683367895053,CSE 20,A01,185445,Briones; Jor-el Thomas Caparas,5,0,25,20
1683367896078,CSE 21,A01,185447,Staff,10,0,50,40
1683367897108,CSE 101,A01,185451,Staff,0,13,50,50
1683367897108,CSE 101,B01,185453,Jones; Miles E,0,11,50,50
1683367899162,CSE 141,A01,185458,Eldon; John,20,0,100,80
1683367900186,CSE 141L,A01,185461,Eldon; John,12,0,100,88
1683367901211,CSE 142,A01,185463,Staff,36,0,60,24
1683367901211,CSE 142,B01,201355,Staff,0,7,60,60
1683367902234,CSE 142L,A01,185470,Staff,36,0,60,24
1683367902234,CSE 142L,B01,201417,Staff,0,6,60,60
1683367903259,CSE 190,A00,201433,Staff,32,0,49,17
1683367904283,DOC 1,A01,259136,Strom; Megan C.,7,0,15,8
1683367904283,DOC 1,A02,259137,Strom; Megan C.,14,0,15,1
1683367904283,DOC 1,A03,259138,Strom; Megan C.,14,0,15,1
1683367904283,DOC 1,A04,259139,Strom; Megan C.,14,0,15,1
1683367905308,DOC 100D,A00,259140,Pass; Natalye Joann,16,0,25,9
1683367906332,DSGN 1,A01,184749,Rill; Bryan,0,25,30,30
1683367907358,DSGN 100,A01,185168,Staff,0,2,25,25
1683367908389,ECE 5,A01,185626,Morris; Karcher William,0,10,0,0
1683367909418,ECE 101,A01,185628,Staff,17,0,70,53
1683367910448,ECE 107,A01,185635,Baghdadchi; Saharnaz,0,0,20,20
1683367910448,ECE 107,A02,185638,Baghdadchi; Saharnaz,4,0,20,16
1683367911475,ECE 148,A01,185647,Silberman; Jack,0,0,16,16
1683367912501,ECON 1,A01,185537,Crane; Meredith Helen,54,0,70,16
1683367913527,ECON 3,A01,185549,Crane; Meredith Helen,32,0,70,38
1683367914552,ECON 4,A01,203354,Anderson; John Charles,0,4,10,10
1683367915580,ECON 100A,A01,185574,Staff,0,4,40,40
1683367916609,ECON 100B,A01,185576,Staff,0,12,50,50
1683367917637,ECON 100C,A01,185589,Newhouse; Herbert S,29,0,70,41
1683367918662,ECON 105,A00,185608,Vespa; Emanuel Ignacio,19,0,35,16
1683367919688,ECON 109,A01,185610,Shishkin; Denis,10,0,35,25
1683367920713,ECON 110A,A01,185612,Staff,11,0,40,29
1683367921737,ECON 120A,A01,185615,Staff,20,0,40,20
1683367922763,ECON 120C,A01,185617,Sun; Yixiao,0,21,70,70
1683367923860,ECON 144,A00,203346,Squires; Dale E,3,0,35,32
1683367924886,ECON 171,A01,203349,Newhouse; Herbert S,0,1,35,35
1683367925911,ECON 173A,A01,185621,Toda; Alexis Akira,21,0,35,14
1683367926943,EDS 25,A01,202413,Staff,0,1,0,0
1683367926943,EDS 25,A02,202414,Staff,0,1,0,0
1683367926943,EDS 25,A03,202415,Staff,0,0,0,0
1683367926943,EDS 25,A04,202416,Staff,0,1,0,0
1683367926943,EDS 25,A05,202439,Staff,0,0,0,0
1683367926943,EDS 25,A06,202440,Staff,0,0,0,0
1683367926943,EDS 25,B01,202631,Staff,0,0,0,0
1683367926943,EDS 25,B02,202632,Staff,0,0,0,0
1683367926943,EDS 25,B03,202639,Staff,0,0,0,0
1683367926943,EDS 25,B04,202640,Staff,0,0,0,0
1683367926943,EDS 25,B05,202643,Staff,0,0,0,0
1683367926943,EDS 25,B06,202644,Staff,0,0,0,0
1683367927973,EDS 38,A01,202659,Black; Alison Michelle,24,0,25,1
1683367928998,EDS 115,A00,202652,Staff,18,0,30,12
1683367930023,EDS 125,A00,202649,Staff,14,0,30,16
1683367931051,EDS 126,A01,203332,Staff,30,0,30,0
1683367932077,EDS 139,A00,202838,Staff,16,0,25,9
1683367933104,EDS 146,A01,202655,Staff,14,0,25,11
1683367934130,ENG 15,A00,185667,Staff,0,1,0,0
1683367934130,ENG 15,B00,185672,Staff,0,0,0,0
1683367934130,ENG 15,C00,185675,Staff,0,0,0,0
1683367934130,ENG 15,D00,185682,Staff,0,0,0,0
1683367934130,ENG 15,E00,185684,Staff,0,0,0,0
1683367935157,ETHN 103,A00,185710,Staff,0,4,35,35
1683367936180,ETHN 103A,A00,199228,Man; Simeon S,2,0,9,7
1683367937204,ETHN 109,A00,185711,Staff,18,0,35,17
1683367938228,ETHN 142,A00,185726,Staff,0,4,30,30
1683367939253,ETHN 163J,A00,199229,Man; Simeon S,5,0,8,3
1683367940277,ETHN 168,A00,185727,Staff,8,0,10,2
1683367941304,ETHN 182,A00,185728,Staff,0,0,35,35
1683367942328,ETHN 183,A00,185737,Staff,8,0,18,10
1683367943353,GLBH 111,A01,209361,Burgos; Jose L.,0,0,0,0
1683367945401,HIEU 104,A00,185792,Staff,16,0,20,4
1683367946430,HIEU 115,A00,185800,Staff,1,0,20,19
1683367947454,HIEU 128,A00,185801,Staff,0,7,20,20
1683367948479,HIEU 147,A00,185802,Staff,16,0,20,4
1683367949503,HIEU 154,A00,185823,Staff,12,0,20,8
1683367950528,HILA 102,A00,185826,Staff,13,0,20,7
1683367951553,HILD 2C,A01,185778,Staff,0,12,20,20
1683367952584,HILD 7B,A01,185780,Kwak; Nancy,0,15,32,32
1683367952584,HILD 7B,A02,185781,Kwak; Nancy,0,18,32,32
1683367953609,HILD 30,A01,185791,Staff,14,0,20,6
1683367954633,HISC 119,A00,185830,Golan; Tal,0,9,20,20
1683367955656,HITO 156GS,A00,185831,Patterson; Patrick H.,0,0,0,23
1683367956684,HIUS 103,A00,185832,Man; Simeon S,1,6,20,19
1683367957712,HIUS 117,A00,185836,Kwak; Nancy,2,0,20,18
1683367958742,HIUS 125,A00,185840,Man; Simeon S,0,0,23,23
1683367959766,HIUS 149,A00,185845,Staff,0,0,20,20
1683367960793,HUM 3,A01,185882,Zavodny; Tatiana Sophia,0,7,50,50
1683367960793,HUM 3,B01,185899,Caldwell; Michael Alan,0,18,50,50
1683367961817,HUM 3GS,A00,185900,Patterson; Patrick H.,0,0,0,23
1683367962844,HUM 4,A01,185938,Zroka; Amy Liane,31,0,50,19
1683367962844,HUM 4,B01,185956,Watkins; Eric,0,3,50,50
1683367962844,HUM 4,B02,202209,Watkins; Eric,0,2,50,50
1683367962844,HUM 4,B03,202210,Watkins; Eric,0,2,50,50
1683367963870,HUM 5,A01,185958,West; Geoffrey Scott,3,0,50,47
1683367963870,HUM 5,A02,202215,West; Geoffrey Scott,0,0,50,50
1683367964901,INTL 190,A00,185959,Gagnon; Jeffrey C,0,0,0,9
1683367964901,INTL 190,B00,185960,Lettieri; Michael Joseph,0,0,0,1
1683367965928,JAPN 180,A00,254509,Staff,4,0,30,26
1683367966961,LATI 10,A01,202853,Kennemore; Amy Michelle,4,0,35,31
1683367966961,LATI 10,A02,202854,Kennemore; Amy Michelle,2,0,35,33
1683367966961,LATI 10,A03,270054,Kennemore; Amy Michelle,30,0,30,0
1683367967988,LATI 180,A00,202855,Kennemore; Amy Michelle,11,0,20,9
1683367969018,LAWS 101,A00,201767,Golan; Tal,0,7,40,40
1683367970047,LIFR 1C,A00,185961,Staff,6,0,20,14
1683367971072,LIFR 1CX,A00,185962,Staff,7,0,20,13
1683367972100,LIFR 1D,A00,185963,Staff,9,0,20,11
1683367973127,LIFR 1DX,A00,185964,Staff,9,0,20,11
1683367974155,LIGN 101,A01,186039,Staff,43,0,50,7
1683367975180,LIGN 165,A00,186040,Staff,18,0,50,32
1683367976208,LTCS 108,A00,186041,Staff,6,0,10,4
1683367977233,LTCS 119,A00,186042,Staff,16,0,20,4
1683367978257,LTCS 130,A00,186043,Wesling; Megan E.,15,0,25,10
1683367980307,LTEA 138,A00,186119,Staff,14,0,40,26
1683367981331,LTEN 124,A00,186148,Staff,6,0,25,19
1683367982359,LTEN 178,A00,186149,Staff,7,0,15,8
1683367983390,LTEN 181,A00,186150,Blanco; John D,33,0,40,7
1683367984418,LTWL 120,A00,186160,Staff,20,0,25,5
1683367985443,LTWL 165,A00,186161,Staff,22,0,25,3
1683367986468,LTWR 100,A00,186162,Staff,0,5,15,15
1683367987493,LTWR 102,A00,186163,Doller; Ben,5,0,15,10
1683367988522,MAE 8,A01,186412,Staff,0,0,0,0
1683367989549,MAE 30B,A00,186445,Bahadori; Mohammad Yousef,83,0,100,17
1683367990574,MAE 40,A00,186592,Bewley; Thomas R,10,0,50,40
1683367991597,MAE 101B,A00,186593,Bahadori; Mohammad Yousef,81,0,100,19
1683367992624,MAE 105,A00,186594,Bandaru; Prabhakar,12,0,50,38
1683367993654,MAE 107,A00,186599,Pham; Hieu Tan,0,7,120,120
1683367994682,MAE 148,A01,186660,Silberman; Jack,3,0,16,13
1683367995708,MATH 10A,A01,188095,Staff,0,5,35,35
1683367996733,MATH 10B,A01,188097,Bowers; Adam R.,0,11,30,30
1683367996733,MATH 10B,A02,188099,Bowers; Adam R.,0,11,30,30
1683367996733,MATH 10B,B01,188104,Bowers; Adam R.,0,10,30,30
1683367996733,MATH 10B,B02,188106,Bowers; Adam R.,0,10,30,30
1683367997759,MATH 10C,A01,188111,Staff,0,18,30,30
1683367997759,MATH 10C,A02,188127,Staff,0,17,30,30
1683367997759,MATH 10C,A03,188131,Staff,0,18,30,30
1683367997759,MATH 10C,B01,188218,Staff,18,0,30,12
1683367997759,MATH 10C,B02,188244,Staff,13,0,30,17
1683367997759,MATH 10C,B03,188277,Staff,16,0,30,14
1683367998785,MATH 18,A01,188344,Bach; Quang Tran,18,0,30,12
1683367998785,MATH 18,A02,188345,Bach; Quang Tran,11,0,30,19
1683367998785,MATH 18,B01,188353,Bach; Quang Tran,10,0,30,20
1683367998785,MATH 18,B02,188354,Bach; Quang Tran,20,0,30,10
1683367999810,MATH 20A,A01,188374,Staff,12,0,35,23
1683368000851,MATH 20B,A01,188382,Ohm; Ko Woon,6,0,30,24
1683368000851,MATH 20B,A02,188383,Ohm; Ko Woon,21,0,30,9
1683368000851,MATH 20B,B01,188385,Ohm; Ko Woon,7,0,30,23
1683368000851,MATH 20B,B02,188392,Ohm; Ko Woon,22,0,30,8
1683368001881,MATH 20C,A01,188394,Harel; Guershon,10,0,30,20
1683368001881,MATH 20C,A02,188395,Harel; Guershon,15,0,30,15
1683368001881,MATH 20C,B01,188404,Harel; Guershon,4,0,30,26
1683368001881,MATH 20C,B02,188405,Harel; Guershon,19,0,30,11
1683368002909,MATH 20D,A01,188414,Hammock; Frances H,0,1,30,30
1683368002909,MATH 20D,A02,188415,Hammock; Frances H,3,0,30,27
1683368002909,MATH 20D,B01,188447,Hammock; Frances H,1,0,30,29
1683368002909,MATH 20D,B02,188486,Hammock; Frances H,8,0,30,22
1683368003939,MATH 20E,A01,188649,Staff,21,0,30,9
1683368003939,MATH 20E,A02,188650,Staff,23,0,30,7
1683368003939,MATH 20E,A03,188673,Staff,0,0,30,30
1683368004967,MATH 102,A01,188675,Staff,0,35,35,35
1683368005997,MATH 103B,A01,188681,Staff,3,0,35,32
1683368005997,MATH 103B,B01,188692,Staff,5,0,35,30
1683368007027,MATH 109,A01,188695,Salehi Golsefidy; Alireza,25,0,35,10
1683368007027,MATH 109,A02,188696,Salehi Golsefidy; Alireza,25,0,35,10
1683368008053,MATH 120A,A01,188698,Eggers; John Dietrich,7,0,35,28
1683368009080,MATH 142B,A01,188736,Ioana; Adrian,0,2,30,30
1683368009080,MATH 142B,A02,188741,Ioana; Adrian,0,0,30,30
1683368009080,MATH 142B,A03,188743,Ioana; Adrian,0,1,30,30
1683368010103,MATH 168A,A01,188790,Staff,0,9,35,35
1683368011130,MATH 170A,A01,188803,Nie; Jiawang,0,2,35,35
1683368011130,MATH 170A,A02,188811,Nie; Jiawang,0,0,35,35
1683368011130,MATH 170A,A03,188814,Nie; Jiawang,1,0,35,34
1683368011130,MATH 170A,A04,188815,Nie; Jiawang,13,0,35,22
1683368012154,MATH 193B,A01,188817,Staff,0,0,35,35
1683368012154,MATH 193B,A02,188818,Staff,5,0,35,30
1683368013184,MGT 4,A01,202857,Anderson; John Charles,61,0,80,19
1683368014208,MGT 12,A00,202858,Lindenberger; Wade Douglas,41,0,90,49
1683368015231,MGT 18,A00,202859,Staff,74,0,90,16
1683368016256,MGT 18GS,A00,202860,McKay; Michael J,13,0,28,15
1683368017281,MGT 45,A00,202861,Pecore; Joseph P.,15,0,90,75
1683368018307,MGT 100,A00,202863,Yavorsky; Daniel Ryan,28,0,90,62
1683368019336,MGT 103,A00,202864,Ehrich; Kristine R,0,17,90,90
1683368020366,MGT 112,A00,202865,Ehrich; Kristine R,15,0,90,75
1683368021398,MGT 121A,A00,202868,Staff,0,20,0,0
1683368022428,MGT 131B,A00,202869,Anderson; John Charles,59,0,90,31
1683368023453,MGT 136,A00,202871,Lindenberger; Wade Douglas,84,0,90,6
1683368024478,MGT 164,A00,202873,Staff,0,68,90,91
1683368025503,MGT 164GS,A00,202874,McKay; Mary A,13,0,28,15
1683368026528,MGT 180,A00,202875,Staff,0,50,90,91
1683368027627,MMW 11R,A01,205019,Herbst; Matthew,3,0,30,27
1683368027627,MMW 11R,A02,205026,Herbst; Matthew,29,0,30,1
1683368028653,MMW 15,A01,193512,Chang; Edmond Yi-Teh,0,9,28,28
1683368028653,MMW 15,A02,193513,Chang; Edmond Yi-Teh,0,5,28,28
1683368028653,MMW 15,A03,193514,Chang; Edmond Yi-Teh,0,5,28,28
1683368028653,MMW 15,A04,193515,Chang; Edmond Yi-Teh,0,5,28,28
1683368028653,MMW 15,A05,193516,Chang; Edmond Yi-Teh,0,4,28,28
1683368028653,MMW 15,A06,193517,Chang; Edmond Yi-Teh,0,5,28,28
1683368028653,MMW 15,B01,193519,Chang; Edmond Yi-Teh,0,5,28,28
1683368028653,MMW 15,B02,193520,Chang; Edmond Yi-Teh,0,5,28,28
1683368028653,MMW 15,B03,193521,Chang; Edmond Yi-Teh,0,5,28,28
1683368028653,MMW 15,B04,193522,Chang; Edmond Yi-Teh,0,4,28,28
1683368028653,MMW 15,B05,193523,Chang; Edmond Yi-Teh,0,5,28,28
1683368028653,MMW 15,B06,193524,Chang; Edmond Yi-Teh,0,4,28,28
1683368029678,MMW 122,A01,193526,Rahimi; Babak,0,15,28,28
1683368029678,MMW 122,A02,193527,Rahimi; Babak,0,14,28,28
1683368029678,MMW 122,A03,193528,Rahimi; Babak,0,0,0,0
1683368029678,MMW 122,A04,193529,Rahimi; Babak,0,0,0,0
1683368030702,MUS 1A,A01,186663,Staff,0,20,35,35
1683368031730,MUS 4,A01,186715,Staff,0,12,35,35
1683368032758,MUS 5R,A01,186796,Dubnov; Shlomo,0,17,35,35
1683368033785,MUS 6,A01,186798,Staff,0,4,25,25
1683368034813,MUS 7,A01,186830,Staff,13,0,35,22
1683368035843,MUS 8,A01,186930,Staff,0,26,35,35
1683368036871,MUS 15,A01,186932,Staff,0,16,35,35
1683368036871,MUS 15,B01,186934,Staff,0,15,35,35
1683368037894,MUS 80,A00,186935,Staff,0,0,20,20
1683368037894,MUS 80,B00,186936,Staff,25,0,25,0
1683368038920,NANO 11,A00,204702,Lipomi; Darren John,0,0,0,0
1683368039944,NANO 15,A01,204709,Yang; Kesong,0,1,0,0
1683368040970,NANO 114,A00,202069,Jahed Motlagh; Zeinab,3,0,10,7
1683368042007,PHIL 1,A00,186955,Grush; Rick Scott,32,0,40,8
1683368043038,PHIL 10,A01,186973,Grush; Rick Scott,28,0,35,7
1683368043038,PHIL 10,A02,186974,Grush; Rick Scott,33,0,35,2
1683368044064,PHIL 13,A01,186976,Staff,7,0,35,28
1683368044064,PHIL 13,A02,186977,Staff,16,0,35,19
1683368045088,PHIL 14,A01,186979,Staff,31,0,35,4
1683368045088,PHIL 14,A02,186986,Staff,32,0,35,3
1683368046113,PHIL 28,A01,186988,Staff,16,0,30,14
1683368046113,PHIL 28,A02,186989,Staff,1,0,30,29
1683368046113,PHIL 28,A03,186990,Staff,9,0,30,21
1683368046113,PHIL 28,A04,186991,Staff,26,0,30,4
1683368047138,PHIL 120,A00,186997,Staff,23,0,40,17
1683368048164,PHIL 137,A00,187003,Staff,9,0,40,31
1683368049188,PHIL 150,A00,187015,Staff,47,0,70,23
1683368050216,PHIL 167,A00,187021,Lamey; Andy M.,35,0,40,5
1683368051246,PHIL 174,A01,202226,Staff,17,0,20,3
1683368051246,PHIL 174,A02,202235,Staff,20,0,20,0
1683368052269,PHIL 191A,A00,258918,Staff,0,0,1,1
1683368053293,PHYS 1A,A00,187028,Staff,27,0,60,33
1683368054319,PHYS 1AL,001,187036,Staff,2,0,30,28
1683368054319,PHYS 1AL,002,187049,Staff,18,0,30,12
1683368055342,PHYS 1B,A00,187058,Staff,22,0,60,38
1683368056368,PHYS 1BL,001,187064,Staff,0,0,30,30
1683368056368,PHYS 1BL,002,187070,Staff,5,0,30,25
1683368057397,PHYS 1C,A00,187082,Staff,31,0,120,89
1683368058424,PHYS 1CL,001,187088,Staff,0,9,30,30
1683368058424,PHYS 1CL,002,187089,Staff,0,2,30,30
1683368058424,PHYS 1CL,009,262693,Staff,11,0,30,19
1683368059451,PHYS 2B,A01,187097,Staff,54,0,115,61
1683368060477,PHYS 2C,A01,187099,Staff,67,0,115,48
1683368061500,PHYS 2CL,A01,187101,Staff,5,0,28,23
1683368061500,PHYS 2CL,A02,187102,Staff,15,0,28,13
1683368062528,PHYS 2D,A01,187123,Shotwell; Brian,95,0,115,20
1683368063553,PHYS 4B,A01,187133,Grinstein; Benjamin,35,0,50,15
1683368064578,POLI 10,A00,188819,Staff,0,4,50,50
1683368065604,POLI 11,A00,188827,Staff,43,0,50,7
1683368066631,POLI 13R,A00,188828,Staff,0,1,20,20
1683368067656,POLI 27,A01,188830,Elgin; Samuel Zincke,0,1,70,70
1683368068680,POLI 30,A00,188832,Desposato; Scott,31,0,50,19
1683368069704,POLI 102F,A00,188834,Staff,2,0,40,38
1683368070728,POLI 104A,A00,188852,Staff,14,0,30,16
1683368071753,POLI 104I,A00,188853,Staff,0,6,20,20
1683368072782,POLI 110B,A00,188854,Wiens; David,7,0,20,13
1683368073807,POLI 112A,A00,188855,Wiens; David,5,0,30,25
1683368074832,POLI 117R,A00,188856,Forman; Fonna,0,11,20,20
1683368075856,POLI 118,A00,188857,Ingham; Sean,8,0,20,12
1683368076885,POLI 120G,A00,188858,Staff,9,0,30,21
1683368077914,POLI 131CR,A00,188863,Hoston; Germaine,23,0,50,27
1683368078942,POLI 133,A00,188864,Nellis; Gareth Hb,44,0,50,6
1683368079966,POLI 134D,A00,188865,Desposato; Scott,27,0,30,3
1683368080992,POLI 142A,A00,188871,Gartzke; Erik,22,0,50,28
1683368082017,POLI 142K,A00,188874,Staff,38,0,50,12
1683368083042,POLI 143,A00,188940,Gartzke; Erik,16,0,30,14
1683368084065,POLI 153,A00,188943,Staff,3,0,20,17
1683368085092,POLI 160AA,A00,188944,Staff,11,0,40,29
1683368086117,POLI 170A,A00,188945,Staff,11,0,30,19
1683368088170,PSYC 1,A00,188952,Staff,37,0,90,53
1683368089196,PSYC 2,B00,188953,Staff,19,0,35,16
1683368090224,PSYC 6,A00,188970,Staff,47,0,60,13
1683368091250,PSYC 7,A00,188973,Staff,37,0,45,8
1683368092277,PSYC 60,A01,188980,Rickard; Timothy C.,43,0,60,17
1683368093301,PSYC 70,A01,189001,Steiner; Eric Tomas,23,0,45,22
1683368094333,PSYC 100,A00,189005,Lacefield; Katharine I,0,98,120,120
1683368095359,PSYC 102,A00,189008,Staff,9,0,30,21
1683368096384,PSYC 106,B00,189026,Gorman; Michael R.,34,0,60,26
1683368097410,PSYC 114,B01,189033,Winkielman; Piotr,0,32,30,30
1683368098437,PSYC 131,A00,189036,Anagnostaras; Stephan,0,43,60,60
1683368099461,PSYC 136,A00,189041,Lowe; Angela Beth,0,7,25,25
1683368100488,PSYC 137,A00,189057,Winkielman; Piotr,0,34,25,25
1683368101518,PSYC 144,A00,189107,Wixted; John T,0,7,50,50
1683368103575,PSYC 162,A00,189142,Staff,0,8,85,85
1683368104600,PSYC 172,A00,189144,Gorman; Michael R.,0,7,30,30
1683368106650,PSYC 179,A00,189146,Lacefield; Katharine I,0,84,120,120
1683368107674,PSYC 181,A00,189147,Anagnostaras; Stephan,0,44,90,90
1683368108698,PSYC 190R,A00,189148,Barner; David A.,0,22,80,80
1683368109725,PSYC 191,A00,189275,Rickard; Timothy C.,0,7,25,25
1683368110753,PSYC 193,A00,189276,Chapman; Eddie Nathaniel,0,1,0,4
1683368111781,PSYC 193L,A01,189281,Lowe; Angela Beth,12,0,20,8
1683368111781,PSYC 193L,B01,189285,Staff,28,0,35,7
1683368112811,RELI 149,A00,187137,Rahimi; Babak,7,0,40,33
1683368113841,SE 9,A01,187315,Staff,0,2,18,18
1683368114868,SE 101B,A00,187409,Staff,24,0,30,6
1683368115899,SE 110B,A00,187444,Staff,10,0,40,30
1683368116927,SE 130B,A00,187449,Staff,31,0,40,9
1683368117951,SE 150A,A00,187516,Staff,9,0,20,11
1683368118976,SE 154,A00,187528,Staff,30,0,50,20
1683368120004,SIO 3,A01,258171,Staff,35,0,40,5
1683368121035,SIO 10,A00,187144,Cook; Geoffrey W,0,3,75,75
1683368122063,SIO 45,A00,187152,Cook; Geoffrey W,1,0,100,99
1683368123091,SIO 109R,A00,194486,Staff,0,3,20,20
1683368125141,SIO 187,A01,187233,Kacev; David,12,0,40,28
1683368126169,SOCI 1,A01,258656,Thorpe; Charles Robert,28,0,30,2
1683368126169,SOCI 1,A02,258658,Thorpe; Charles Robert,30,0,30,0
1683368126169,SOCI 1,A03,258661,Thorpe; Charles Robert,25,0,25,0
1683368126169,SOCI 1,A04,258666,Thorpe; Charles Robert,22,0,25,3
1683368126169,SOCI 1,A05,258897,Thorpe; Charles Robert,23,0,25,2
1683368126169,SOCI 1,A06,258898,Thorpe; Charles Robert,25,0,25,0
1683368127194,SOCI 30,A01,258903,Pardo Guerra; Juan Pablo,15,0,30,15
1683368128217,SOCI 102,A00,258904,Staff,9,0,25,16
1683368129245,SOCI 106,A00,258905,Staff,19,0,25,6
1683368130276,SOCI 111,A00,258907,Ribas Norris; Janet Vanesa,26,0,30,4
1683368131358,SOCI 121R,A00,258908,Pardo Guerra; Juan Pablo,10,0,30,20
1683368132386,SOCI 126,A01,203330,Staff,14,0,20,6
1683368133410,SOCI 131,A00,258909,Thorpe; Charles Robert,31,0,60,29
1683368134440,SOCI 135,A00,258910,Payne; Christine Anna,0,9,30,30
1683368135466,SOCI 157,A00,258911,Staff,12,0,30,18
1683368136501,SOCI 184,A00,258912,Staff,25,0,30,5
1683368137528,SOCI 188D,A00,258913,Staff,22,0,30,8
1683368138553,SYN 2,001,187529,Staff,10,0,16,6
1683368138553,SYN 2,002,201452,Staff,0,18,16,16
1683368138553,SYN 2,003,201469,Staff,3,0,16,13
1683368139578,SYN 100,A01,187531,Staff,0,9,20,20
1683368139578,SYN 100,B01,201491,Staff,0,12,20,20
1683368140605,TDAC 1,A00,189286,Walsh; Kim C.,3,0,20,17
1683368140605,TDAC 1,B00,189287,Harting; Carla Kelso,11,0,20,9
1683368141631,TDAC 101,A00,189300,Walsh; Kim C.,16,0,20,4
1683368141631,TDAC 101,B00,189301,Harting; Carla Kelso,18,0,20,2
1683368142654,TDAC 102,A00,189304,Basso; Beatrice,14,0,20,6
1683368143681,TDAC 108,A00,189305,Staff,18,0,20,2
1683368144713,TDDE 131,A00,189310,Staff,19,0,20,1
1683368144713,TDDE 131,B00,189314,Staff,19,0,20,1
1683368144713,TDDE 131,C00,189315,Staff,48,0,50,2
1683368144713,TDDE 131,D00,189316,Staff,14,0,15,1
1683368144713,TDDE 131,E00,204841,Staff,20,0,20,0
1683368145740,TDGE 10,A00,189289,Staff,30,0,50,20
1683368145740,TDGE 10,B00,189290,Havis; Allan,1,0,50,49
1683368146768,TDGE 11,A00,189291,Fulton; Julia,0,3,50,50
1683368146768,TDGE 11,B00,189292,Staff,20,0,25,5
1683368146768,TDGE 11,C00,260270,Staff,0,0,0,0
1683368147790,TDGE 25,A00,189294,Staff,3,0,20,17
1683368148815,TDGE 124,A00,189318,Fulton; Julia,0,8,50,50
1683368149839,TDGE 125,A00,189319,Staff,13,0,25,12
1683368149839,TDGE 125,B00,189320,Staff,23,0,25,2
1683368150863,TDGE 127,A00,189322,Havis; Allan,0,0,50,50
1683368151887,TDHT 101,A00,189323,Staff,18,0,25,7
1683368151887,TDHT 101,B00,189324,Staff,25,0,25,0
1683368152911,TDHT 102,A00,189325,Staff,49,0,50,1
1683368153938,TDMV 1,A00,189295,Arcidiacono; Kristin,19,0,30,11
1683368153938,TDMV 1,B00,189296,Caligagan; Maria T.,24,0,30,6
1683368154963,TDMV 2,A00,189297,Sammartano; Tonnie,28,0,30,2
1683368154963,TDMV 2,B00,189299,Arcidiacono; Kristin,24,0,30,6
1683368155988,TDMV 3,A00,204998,Rincon; Alicia,22,0,30,8
1683368157013,TDMV 120,A00,189458,Sammartano; Tonnie,28,0,30,2
1683368158038,TDMV 138,A00,189541,Jun; Grace Shin Hae,22,0,40,18
1683368159064,TDMV 142,A00,189717,Caligagan; Tony,24,0,30,6
1683368159064,TDMV 142,B00,189718,Caligagan; Maria T.,25,0,30,5
1683368160090,TMC 2,A01,187533,Staff,25,0,25,0
1683368160090,TMC 2,A02,187534,Staff,25,0,25,0
1683368161116,USP 1,A01,187536,Kwak; Nancy,0,16,25,25
1683368162146,USP 5,A01,187538,Staff,10,0,25,15
1683368163176,USP 101,A00,199253,Staff,0,4,0,0
1683368164201,USP 124,A00,187562,Boomhower; Matthew Charles,1,0,30,29
1683368165228,USP 138,A00,187582,Staff,20,0,25,5
1683368166254,USP 152,A01,187597,Staff,4,0,25,21
1683368167279,USP 153,A00,187598,Staff,19,0,25,6
1683368168303,USP 168,A00,187607,Kwak; Nancy,2,0,5,3
1683368169328,USP 173,A00,187619,Staff,4,0,25,21
1683368170353,USP 181,A00,187638,Staff,0,3,25,25
1683368171379,VIS 103,A00,187650,Cruz; Edwin Teddy,22,0,75,53
1683368172404,VIS 110D,A00,187669,Staff,12,0,22,10
1683368173433,VIS 127C,A00,187720,Shen; Kuiyi,67,0,146,79
1683368174462,VIS 149,A00,187731,Yoldas; Pinar,0,14,22,22
1683368175489,VIS 151,A01,188091,Staff,22,0,34,12
1683368175489,VIS 151,A02,188092,Staff,11,0,34,23
1683368176517,VIS 160B,A00,188093,Stalbaum; Brett,0,0,10,10
1683368178569,WCWP 10B,A00,201720,Staff,10,0,15,5
1683368178569,WCWP 10B,B00,201722,Staff,9,0,15,6
1683368179594,WCWP 100,A00,201725,Gagnon; Jeffrey C,0,0,2,2
1683368179594,WCWP 100,B00,201727,Staff,0,4,15,15
1683368182791,ANBI 133,A00,258401,Wilder; Linnea Lorene,34,0,40,6
1683368183820,ANBI 140,A00,258395,Hrvoj Mihic; Branka,18,0,25,7
1683368184850,ANSC 120,A00,258402,Bialecki; Jon Anthony,27,0,40,13
1683368185877,ANSC 144,A00,258400,Staff,14,0,40,26
1683368187928,ANSC 166,A00,258396,Parish; Steven Martin,158,0,175,17
1683368188952,ANSC 180,A00,193533,Staff,9,0,20,11
1683368189981,ANSC 188,A00,258397,Jassal; Aftab,33,0,40,7
1683368191006,ANTH 3,A01,258316,Staff,23,0,30,7
1683368192033,ANTH 5,A00,258394,Semendeferi; Ekaterini,16,0,20,4
1683368193057,ANTH 21,A01,258331,Staff,8,0,40,32
1683368194083,ANTH 103,A00,258398,Varma; Saiba,15,0,25,10
1683368195111,AWP 10,001,202034,Staff,0,0,0,0
1683368195111,AWP 10,002,202035,Staff,0,0,0,0
1683368195111,AWP 10,003,202036,Staff,0,0,0,0
1683368195111,AWP 10,004,202037,Staff,0,0,0,0
1683368195111,AWP 10,005,202038,Staff,0,0,0,0
1683368195111,AWP 10,006,202039,Staff,0,0,0,0
1683368195111,AWP 10,007,202040,Staff,0,0,0,0
1683368195111,AWP 10,008,202041,Staff,0,0,0,0
1683368195111,AWP 10,009,202042,Staff,0,0,0,0
1683368195111,AWP 10,010,202043,Staff,0,0,0,0
1683368195111,AWP 10,011,202044,Staff,0,0,0,0
1683368195111,AWP 10,012,202045,Staff,0,0,0,0
1683368195111,AWP 10,013,202046,Staff,0,0,0,0
1683368195111,AWP 10,014,202047,Staff,0,0,0,0
1683368195111,AWP 10,015,202048,Staff,0,0,0,0
1683368195111,AWP 10,016,202049,Staff,0,0,0,0
1683368195111,AWP 10,017,202050,Staff,0,0,0,0
1683368195111,AWP 10,018,202051,Staff,0,0,0,0
1683368195111,AWP 10,019,202052,Staff,0,0,0,0
1683368195111,AWP 10,020,202053,Staff,0,0,0,0
1683368195111,AWP 10,021,202054,Staff,0,0,0,0
1683368195111,AWP 10,022,202055,Staff,0,0,0,0
1683368195111,AWP 10,023,202056,Staff,0,0,0,0
1683368195111,AWP 10,024,202057,Staff,0,0,0,0
1683368195111,AWP 10,025,202058,Staff,0,0,0,0
1683368195111,AWP 10,026,202059,Staff,0,0,0,0
1683368196138,AWP 102,001,202032,Staff,0,0,0,0
1683368196138,AWP 102,002,202033,Staff,0,0,0,0
1683368197165,BENG 100,A01,254234,Taylor Amos; Alyssa C,31,0,40,9
1683368198191,BENG 196,001,270013,Engler; Adam J.,9999,0,9999,0
1683368199222,BICD 100R,A01,202018,Smith; Laurie,0,7,32,32
1683368199222,BICD 100R,A02,202019,Smith; Laurie,0,2,32,32
1683368199222,BICD 100R,A03,202020,Smith; Laurie,0,1,32,32
1683368199222,BICD 100R,A04,202021,Smith; Laurie,9,0,32,23
1683368199222,BICD 100R,A05,202022,Smith; Laurie,12,0,32,20
1683368200250,BICD 136,A01,193242,Gustafson-Brown; Cindy,0,2,32,32
1683368200250,BICD 136,A02,193244,Gustafson-Brown; Cindy,14,0,32,18
1683368201283,BIEB 102,A01,193249,Butler; Shannon Rhey,0,2,32,32
1683368201283,BIEB 102,A02,193251,Butler; Shannon Rhey,0,0,32,32
1683368201283,BIEB 102,A03,193253,Butler; Shannon Rhey,0,1,32,32
1683368201283,BIEB 102,A04,193255,Butler; Shannon Rhey,17,0,32,15
1683368201283,BIEB 102,A05,193265,Butler; Shannon Rhey,26,0,32,6
1683368201283,BIEB 102,A06,193269,Butler; Shannon Rhey,16,0,32,16
1683368203335,BIEB 150,A01,193274,Staff,0,0,32,32
1683368203335,BIEB 150,A02,193285,Staff,23,0,32,9
1683368204359,BIEB 194,A00,193286,Kurle; Carolyn M.,22,0,32,10
1683368205387,BILD 1,A01,192291,Staff,16,0,32,16
1683368205387,BILD 1,A02,192292,Staff,30,0,32,2
1683368205387,BILD 1,B01,192520,Reuther; Keefe,0,1,0,0
1683368205387,BILD 1,B02,192532,Reuther; Keefe,0,1,0,0
1683368206414,BILD 3,A01,192556,Butler; Shannon Rhey,0,0,32,32
1683368206414,BILD 3,A02,192581,Butler; Shannon Rhey,4,0,32,28
1683368206414,BILD 3,A03,192611,Butler; Shannon Rhey,23,0,32,9
1683368206414,BILD 3,A04,192612,Butler; Shannon Rhey,25,0,32,7
1683368206414,BILD 3,A05,192613,Butler; Shannon Rhey,27,0,32,5
1683368206414,BILD 3,A06,192679,Butler; Shannon Rhey,27,0,32,5
1683368206414,BILD 3,A07,192682,Butler; Shannon Rhey,21,0,32,11
1683368207440,BILD 4,A01,192836,Reuther; Keefe,0,0,24,24
1683368207440,BILD 4,A02,193044,Reuther; Keefe,4,0,24,20
1683368208470,BILD 10,A01,193142,Gustafson-Brown; Cindy,30,0,32,2
1683368208470,BILD 10,A02,193149,Gustafson-Brown; Cindy,31,0,32,1
1683368209499,BIMM 100,A01,193301,Staff,1,6,32,31
1683368209499,BIMM 100,A02,193312,Staff,0,5,32,32
1683368209499,BIMM 100,A03,193323,Staff,0,8,32,32
1683368210529,BIMM 101,A01,193329,McDonnell; Lisa Marie,0,3,24,24
1683368210529,BIMM 101,A02,193339,McDonnell; Lisa Marie,0,3,24,24
1683368210529,BIMM 101,B01,193354,McDonnell; Lisa Marie,0,3,24,24
1683368210529,BIMM 101,B02,193357,McDonnell; Lisa Marie,0,3,24,24
1683368211558,BIMM 110,A01,193377,Tat; John,0,11,32,32
1683368211558,BIMM 110,A02,193378,Tat; John,0,9,32,32
1683368212591,BIMM 120,A01,206116,Staff,0,0,32,32
1683368212591,BIMM 120,A02,206117,Staff,8,0,32,24
1683368212591,BIMM 120,A03,206121,Staff,21,0,32,11
1683368213621,BIPN 100,A01,193393,Park; Ji Young,0,14,32,32
1683368213621,BIPN 100,A02,193402,Park; Ji Young,0,13,32,32
1683368213621,BIPN 100,A03,193413,Park; Ji Young,0,14,32,32
1683368213621,BIPN 100,A04,193414,Park; Ji Young,0,13,32,32
1683368214647,BIPN 102,A01,193429,Staff,0,0,32,32
1683368214647,BIPN 102,A02,193438,Staff,22,0,32,10
1683368215673,BIPN 106,A01,193450,Reyes Gonzalez; Catalina,0,2,40,40
1683368216698,BIPN 134,A01,193465,Cooke; James Edward,1,0,32,31
1683368216698,BIPN 134,A02,193474,Cooke; James Edward,25,0,32,7
1683368216698,BIPN 134,A03,193485,Cooke; James Edward,29,0,32,3
1683368216698,BIPN 134,A04,193486,Cooke; James Edward,21,0,32,11
1683368216698,BIPN 134,A05,193491,Cooke; James Edward,31,0,32,1
1683368216698,BIPN 134,A06,193501,Cooke; James Edward,30,0,32,2
1683368216698,BIPN 134,A07,193510,Cooke; James Edward,29,0,32,3
1683368218754,BISP 194,A00,222522,Staff,14,0,32,18
1683368219779,CAT 124,A01,202407,Staff,19,0,25,6
1683368220805,CAT 125,A00,202408,Marchisotto; Jennifer Anne,4,0,20,16
1683368221833,CAT 125R,A00,202409,Smith; Lauryn Alissa,0,11,20,20
1683368221833,CAT 125R,B00,202410,Morales; Celeste Georgianna,0,11,20,20
1683368221833,CAT 125R,C00,202411,Irwin; Matthew Joseph,0,10,20,20
1683368222860,CENG 15,A01,204712,Yang; Kesong,0,1,0,0
1683368223885,CENG 114,A00,202070,Jahed Motlagh; Zeinab,5,0,20,15
1683368224911,CGS 105,A00,185477,Wesling; Megan E.,24,0,40,16
1683368225936,CGS 106,A00,185494,Staff,13,0,22,9
1683368226960,CGS 108,A00,185495,Staff,14,0,20,6
1683368227984,CGS 114,A00,185496,Staff,13,0,18,5
1683368229012,CGS 119,A00,185501,Staff,15,0,20,5
1683368230043,CGS 120,A00,185511,Staff,13,0,20,7
1683368231075,CHEM 4,A01,184675,Bussey; Thomas J,96,0,100,4
1683368232102,CHEM 6A,A01,184677,Staff,34,0,60,26
1683368233125,CHEM 6B,A01,184679,Staff,65,0,100,35
1683368234151,CHEM 6C,A01,184681,Bussey; Thomas J,1,0,50,49
1683368234151,CHEM 6C,A02,184682,Bussey; Thomas J,34,0,50,16
1683368235232,CHEM 40A,A01,184684,Albizati; Kim F.,37,0,100,63
1683368236260,CHEM 40B,A01,184686,Albizati; Kim F.,0,20,100,100
1683368237285,CHEM 41B,A01,184690,Staff,52,0,100,48
1683368238307,COGS 3,A01,184715,Boyle; Mary E. T.,0,25,40,40
1683368239336,COGS 14B,A01,185172,Staff,0,15,38,38
1683368240362,COGS 18,A01,184736,Staff,16,0,80,64
1683368241388,COGS 100,A01,184932,Staff,0,5,73,73
1683368242412,COGS 101A,A01,184935,Staff,0,39,30,30
1683368243442,COGS 101B,A01,184944,Staff,0,2,30,30
1683368244468,COGS 101C,A01,184946,Staff,0,12,30,30
1683368245496,COGS 102A,A01,184951,Johnson; Christine M.,2,0,40,38
1683368246528,COGS 107B,A01,184953,Mooshagian; Eric Frederick,0,50,40,40
1683368247554,COGS 118B,A01,184959,Gupta; Anjum,0,48,40,40
1683368248579,COGS 153,A00,184961,Staff,0,15,30,30
1683368249603,COGS 177,A00,184962,Staff,0,20,30,30
1683368250628,COGS 187A,A01,184969,Boyle; Mary E. T.,0,17,40,40
1683368251654,COMM 10,A01,185174,Staff,0,5,25,25
1683368251654,COMM 10,A02,185189,Staff,0,5,25,25
1683368251654,COMM 10,A03,269821,Staff,0,0,0,0
1683368252683,COMM 100B,A01,185475,Staff,0,0,0,2
1683368252683,COMM 100B,A02,185476,Staff,13,0,25,12
1683368253707,COMM 100C,A01,185314,Staff,1,0,25,24
1683368253707,COMM 100C,A02,185327,Staff,19,0,25,6
1683368254732,COMM 110M,A00,185349,Staff,2,0,40,38
1683368255760,COMM 113T,A00,185352,Staff,24,0,40,16
1683368256785,COMM 114I,A00,185353,Staff,33,0,40,7
1683368257809,COMM 131,A00,185354,Staff,19,0,30,11
1683368258834,CSE 8A,A50,185358,Cao; Yingjun,0,46,10,10
1683368259858,CSE 8B,A01,185362,Staff,0,46,50,50
1683368260883,CSE 11,A01,185416,Cao; Yingjun,0,92,10,10
1683368261908,CSE 20,A01,185445,Briones; Jor-el Thomas Caparas,5,0,25,20
1683368262934,CSE 21,A01,185447,Staff,10,0,50,40
1683368263964,CSE 101,A01,185451,Staff,0,13,50,50
1683368263964,CSE 101,B01,185453,Jones; Miles E,0,11,50,50
1683368266018,CSE 141,A01,185458,Eldon; John,20,0,100,80
1683368267045,CSE 141L,A01,185461,Eldon; John,12,0,100,88
1683368268074,CSE 142,A01,185463,Staff,36,0,60,24
1683368268074,CSE 142,B01,201355,Staff,0,7,60,60
1683368269099,CSE 142L,A01,185470,Staff,36,0,60,24
1683368269099,CSE 142L,B01,201417,Staff,0,6,60,60
1683368270124,CSE 190,A00,201433,Staff,32,0,49,17
1683368271150,DOC 1,A01,259136,Strom; Megan C.,7,0,15,8
1683368271150,DOC 1,A02,259137,Strom; Megan C.,14,0,15,1
1683368271150,DOC 1,A03,259138,Strom; Megan C.,14,0,15,1
1683368271150,DOC 1,A04,259139,Strom; Megan C.,14,0,15,1
1683368272174,DOC 100D,A00,259140,Pass; Natalye Joann,16,0,25,9
1683368273205,DSGN 1,A01,184749,Rill; Bryan,0,25,30,30
1683368274231,DSGN 100,A01,185168,Staff,0,2,25,25
1683368275258,ECE 5,A01,185626,Morris; Karcher William,0,10,0,0
1683368276284,ECE 101,A01,185628,Staff,17,0,70,53
1683368277314,ECE 107,A01,185635,Baghdadchi; Saharnaz,0,0,20,20
1683368277314,ECE 107,A02,185638,Baghdadchi; Saharnaz,4,0,20,16
1683368278341,ECE 148,A01,185647,Silberman; Jack,0,0,16,16
1683368279369,ECON 1,A01,185537,Crane; Meredith Helen,54,0,70,16
1683368280397,ECON 3,A01,185549,Crane; Meredith Helen,32,0,70,38
1683368281426,ECON 4,A01,203354,Anderson; John Charles,0,4,10,10
1683368282456,ECON 100A,A01,185574,Staff,0,4,40,40
1683368283485,ECON 100B,A01,185576,Staff,0,12,50,50
1683368284515,ECON 100C,A01,185589,Newhouse; Herbert S,29,0,70,41
1683368285545,ECON 105,A00,185608,Vespa; Emanuel Ignacio,19,0,35,16
1683368286573,ECON 109,A01,185610,Shishkin; Denis,10,0,35,25
1683368287602,ECON 110A,A01,185612,Staff,11,0,40,29
1683368288630,ECON 120A,A01,185615,Staff,20,0,40,20
1683368289660,ECON 120C,A01,185617,Sun; Yixiao,0,21,70,70
1683368290691,ECON 144,A00,203346,Squires; Dale E,3,0,35,32
1683368291720,ECON 171,A01,203349,Newhouse; Herbert S,0,1,35,35
1683368292750,ECON 173A,A01,185621,Toda; Alexis Akira,21,0,35,14
1683368293779,EDS 25,A01,202413,Staff,0,1,0,0
1683368293779,EDS 25,A02,202414,Staff,0,1,0,0
1683368293779,EDS 25,A03,202415,Staff,0,0,0,0
1683368293779,EDS 25,A04,202416,Staff,0,1,0,0
1683368293779,EDS 25,A05,202439,Staff,0,0,0,0
1683368293779,EDS 25,A06,202440,Staff,0,0,0,0
1683368293779,EDS 25,B01,202631,Staff,0,0,0,0
1683368293779,EDS 25,B02,202632,Staff,0,0,0,0
1683368293779,EDS 25,B03,202639,Staff,0,0,0,0
1683368293779,EDS 25,B04,202640,Staff,0,0,0,0
1683368293779,EDS 25,B05,202643,Staff,0,0,0,0
1683368293779,EDS 25,B06,202644,Staff,0,0,0,0
1683368294805,EDS 38,A01,202659,Black; Alison Michelle,24,0,25,1
1683368295828,EDS 115,A00,202652,Staff,18,0,30,12
1683368296854,EDS 125,A00,202649,Staff,14,0,30,16
1683368297880,EDS 126,A01,203332,Staff,30,0,30,0
1683368298904,EDS 139,A00,202838,Staff,16,0,25,9
1683368299932,EDS 146,A01,202655,Staff,14,0,25,11
1683368300958,ENG 15,A00,185667,Staff,0,1,0,0
1683368300958,ENG 15,B00,185672,Staff,0,0,0,0
1683368300958,ENG 15,C00,185675,Staff,0,0,0,0
1683368300958,ENG 15,D00,185682,Staff,0,0,0,0
1683368300958,ENG 15,E00,185684,Staff,0,0,0,0
1683368301988,ETHN 103,A00,185710,Staff,0,4,35,35
1683368303013,ETHN 103A,A00,199228,Man; Simeon S,2,0,9,7
1683368304038,ETHN 109,A00,185711,Staff,18,0,35,17
1683368305064,ETHN 142,A00,185726,Staff,0,4,30,30
1683368306087,ETHN 163J,A00,199229,Man; Simeon S,5,0,8,3
1683368307116,ETHN 168,A00,185727,Staff,8,0,10,2
1683368308141,ETHN 182,A00,185728,Staff,0,0,35,35
1683368309168,ETHN 183,A00,185737,Staff,8,0,18,10
1683368310193,GLBH 111,A01,209361,Burgos; Jose L.,0,0,0,0
1683368312245,HIEU 104,A00,185792,Staff,16,0,20,4
1683368313274,HIEU 115,A00,185800,Staff,1,0,20,19
1683368314301,HIEU 128,A00,185801,Staff,0,7,20,20
1683368315325,HIEU 147,A00,185802,Staff,16,0,20,4
1683368316349,HIEU 154,A00,185823,Staff,12,0,20,8
1683368317377,HILA 102,A00,185826,Staff,13,0,20,7
1683368318401,HILD 2C,A01,185778,Staff,0,12,20,20
1683368319427,HILD 7B,A01,185780,Kwak; Nancy,0,15,32,32
1683368319427,HILD 7B,A02,185781,Kwak; Nancy,0,18,32,32
1683368320452,HILD 30,A01,185791,Staff,14,0,20,6
1683368321478,HISC 119,A00,185830,Golan; Tal,0,9,20,20
1683368322505,HITO 156GS,A00,185831,Patterson; Patrick H.,0,0,0,23
1683368323532,HIUS 103,A00,185832,Man; Simeon S,1,6,20,19
1683368324560,HIUS 117,A00,185836,Kwak; Nancy,2,0,20,18
1683368325585,HIUS 125,A00,185840,Man; Simeon S,0,0,23,23
1683368326610,HIUS 149,A00,185845,Staff,0,0,20,20
1683368327637,HUM 3,A01,185882,Zavodny; Tatiana Sophia,0,7,50,50
1683368327637,HUM 3,B01,185899,Caldwell; Michael Alan,0,18,50,50
1683368328663,HUM 3GS,A00,185900,Patterson; Patrick H.,0,0,0,23
1683368329690,HUM 4,A01,185938,Zroka; Amy Liane,31,0,50,19
1683368329690,HUM 4,B01,185956,Watkins; Eric,0,3,50,50
1683368329690,HUM 4,B02,202209,Watkins; Eric,0,2,50,50
1683368329690,HUM 4,B03,202210,Watkins; Eric,0,2,50,50
1683368330716,HUM 5,A01,185958,West; Geoffrey Scott,3,0,50,47
1683368330716,HUM 5,A02,202215,West; Geoffrey Scott,0,0,50,50
1683368331742,INTL 190,A00,185959,Gagnon; Jeffrey C,0,0,0,9
1683368331742,INTL 190,B00,185960,Lettieri; Michael Joseph,0,0,0,1
1683368332768,JAPN 180,A00,254509,Staff,4,0,30,26
1683368333794,LATI 10,A01,202853,Kennemore; Amy Michelle,4,0,35,31
1683368333794,LATI 10,A02,202854,Kennemore; Amy Michelle,2,0,35,33
1683368333794,LATI 10,A03,270054,Kennemore; Amy Michelle,30,0,30,0
1683368334819,LATI 180,A00,202855,Kennemore; Amy Michelle,11,0,20,9
1683368335847,LAWS 101,A00,201767,Golan; Tal,0,7,40,40
1683368336871,LIFR 1C,A00,185961,Staff,6,0,20,14
1683368337897,LIFR 1CX,A00,185962,Staff,7,0,20,13
1683368338980,LIFR 1D,A00,185963,Staff,9,0,20,11
1683368340007,LIFR 1DX,A00,185964,Staff,9,0,20,11
1683368341033,LIGN 101,A01,186039,Staff,43,0,50,7
1683368342063,LIGN 165,A00,186040,Staff,18,0,50,32
1683368343090,LTCS 108,A00,186041,Staff,6,0,10,4
1683368344115,LTCS 119,A00,186042,Staff,16,0,20,4
1683368345140,LTCS 130,A00,186043,Wesling; Megan E.,15,0,25,10
1683368347196,LTEA 138,A00,186119,Staff,14,0,40,26
1683368348219,LTEN 124,A00,186148,Staff,6,0,25,19
1683368349243,LTEN 178,A00,186149,Staff,7,0,15,8
1683368350272,LTEN 181,A00,186150,Blanco; John D,33,0,40,7
1683368351299,LTWL 120,A00,186160,Staff,20,0,25,5
1683368352328,LTWL 165,A00,186161,Staff,22,0,25,3
1683368353352,LTWR 100,A00,186162,Staff,0,5,15,15
1683368354376,LTWR 102,A00,186163,Doller; Ben,5,0,15,10
1683368355402,MAE 8,A01,186412,Staff,0,0,0,0
1683368356430,MAE 30B,A00,186445,Bahadori; Mohammad Yousef,83,0,100,17
1683368357456,MAE 40,A00,186592,Bewley; Thomas R,10,0,50,40
1683368358479,MAE 101B,A00,186593,Bahadori; Mohammad Yousef,81,0,100,19
1683368359502,MAE 105,A00,186594,Bandaru; Prabhakar,12,0,50,38
1683368360528,MAE 107,A00,186599,Pham; Hieu Tan,0,7,120,120
1683368361553,MAE 148,A01,186660,Silberman; Jack,3,0,16,13
1683368362578,MATH 10A,A01,188095,Staff,0,5,35,35
1683368363604,MATH 10B,A01,188097,Bowers; Adam R.,0,11,30,30
1683368363604,MATH 10B,A02,188099,Bowers; Adam R.,0,11,30,30
1683368363604,MATH 10B,B01,188104,Bowers; Adam R.,0,10,30,30
1683368363604,MATH 10B,B02,188106,Bowers; Adam R.,0,10,30,30
1683368364630,MATH 10C,A01,188111,Staff,0,18,30,30
1683368364630,MATH 10C,A02,188127,Staff,0,17,30,30
1683368364630,MATH 10C,A03,188131,Staff,0,18,30,30
1683368364630,MATH 10C,B01,188218,Staff,18,0,30,12
1683368364630,MATH 10C,B02,188244,Staff,13,0,30,17
1683368364630,MATH 10C,B03,188277,Staff,16,0,30,14
1683368365656,MATH 18,A01,188344,Bach; Quang Tran,18,0,30,12
1683368365656,MATH 18,A02,188345,Bach; Quang Tran,11,0,30,19
1683368365656,MATH 18,B01,188353,Bach; Quang Tran,10,0,30,20
1683368365656,MATH 18,B02,188354,Bach; Quang Tran,20,0,30,10
1683368366684,MATH 20A,A01,188374,Staff,12,0,35,23
1683368367714,MATH 20B,A01,188382,Ohm; Ko Woon,6,0,30,24
1683368367714,MATH 20B,A02,188383,Ohm; Ko Woon,21,0,30,9
1683368367714,MATH 20B,B01,188385,Ohm; Ko Woon,7,0,30,23
1683368367714,MATH 20B,B02,188392,Ohm; Ko Woon,22,0,30,8
1683368368743,MATH 20C,A01,188394,Harel; Guershon,10,0,30,20
1683368368743,MATH 20C,A02,188395,Harel; Guershon,15,0,30,15
1683368368743,MATH 20C,B01,188404,Harel; Guershon,4,0,30,26
1683368368743,MATH 20C,B02,188405,Harel; Guershon,19,0,30,11
1683368369769,MATH 20D,A01,188414,Hammock; Frances H,0,1,30,30
1683368369769,MATH 20D,A02,188415,Hammock; Frances H,3,0,30,27
1683368369769,MATH 20D,B01,188447,Hammock; Frances H,1,0,30,29
1683368369769,MATH 20D,B02,188486,Hammock; Frances H,8,0,30,22
1683368370797,MATH 20E,A01,188649,Staff,21,0,30,9
1683368370797,MATH 20E,A02,188650,Staff,23,0,30,7
1683368370797,MATH 20E,A03,188673,Staff,0,0,30,30
1683368371822,MATH 102,A01,188675,Staff,0,35,35,35
1683368372847,MATH 103B,A01,188681,Staff,3,0,35,32
1683368372847,MATH 103B,B01,188692,Staff,5,0,35,30
1683368373871,MATH 109,A01,188695,Salehi Golsefidy; Alireza,25,0,35,10
1683368373871,MATH 109,A02,188696,Salehi Golsefidy; Alireza,25,0,35,10
1683368374896,MATH 120A,A01,188698,Eggers; John Dietrich,7,0,35,28
1683368375921,MATH 142B,A01,188736,Ioana; Adrian,0,2,30,30
1683368375921,MATH 142B,A02,188741,Ioana; Adrian,0,0,30,30
1683368375921,MATH 142B,A03,188743,Ioana; Adrian,0,1,30,30
1683368376946,MATH 168A,A01,188790,Staff,0,9,35,35
1683368377972,MATH 170A,A01,188803,Nie; Jiawang,0,2,35,35
1683368377972,MATH 170A,A02,188811,Nie; Jiawang,0,0,35,35
1683368377972,MATH 170A,A03,188814,Nie; Jiawang,1,0,35,34
1683368377972,MATH 170A,A04,188815,Nie; Jiawang,13,0,35,22
1683368379000,MATH 193B,A01,188817,Staff,0,0,35,35
1683368379000,MATH 193B,A02,188818,Staff,5,0,35,30
1683368380028,MGT 4,A01,202857,Anderson; John Charles,61,0,80,19
1683368381056,MGT 12,A00,202858,Lindenberger; Wade Douglas,41,0,90,49
1683368382083,MGT 18,A00,202859,Staff,74,0,90,16
1683368383106,MGT 18GS,A00,202860,McKay; Michael J,13,0,28,15
1683368384130,MGT 45,A00,202861,Pecore; Joseph P.,15,0,90,75
1683368385154,MGT 100,A00,202863,Yavorsky; Daniel Ryan,28,0,90,62
1683368386178,MGT 103,A00,202864,Ehrich; Kristine R,0,17,90,90
1683368387202,MGT 112,A00,202865,Ehrich; Kristine R,15,0,90,75
1683368388227,MGT 121A,A00,202868,Staff,0,20,0,0
1683368389251,MGT 131B,A00,202869,Anderson; John Charles,59,0,90,31
1683368390280,MGT 136,A00,202871,Lindenberger; Wade Douglas,84,0,90,6
1683368391303,MGT 164,A00,202873,Staff,0,68,90,91
1683368392330,MGT 164GS,A00,202874,McKay; Mary A,13,0,28,15
1683368393354,MGT 180,A00,202875,Staff,0,50,90,91
1683368394380,MMW 11R,A01,205019,Herbst; Matthew,3,0,30,27
1683368394380,MMW 11R,A02,205026,Herbst; Matthew,29,0,30,1
1683368395406,MMW 15,A01,193512,Chang; Edmond Yi-Teh,0,9,28,28
1683368395406,MMW 15,A02,193513,Chang; Edmond Yi-Teh,0,5,28,28
1683368395406,MMW 15,A03,193514,Chang; Edmond Yi-Teh,0,5,28,28
1683368395406,MMW 15,A04,193515,Chang; Edmond Yi-Teh,0,5,28,28
1683368395406,MMW 15,A05,193516,Chang; Edmond Yi-Teh,0,4,28,28
1683368395406,MMW 15,A06,193517,Chang; Edmond Yi-Teh,0,5,28,28
1683368395406,MMW 15,B01,193519,Chang; Edmond Yi-Teh,0,5,28,28
1683368395406,MMW 15,B02,193520,Chang; Edmond Yi-Teh,0,5,28,28
1683368395406,MMW 15,B03,193521,Chang; Edmond Yi-Teh,0,5,28,28
1683368395406,MMW 15,B04,193522,Chang; Edmond Yi-Teh,0,4,28,28
1683368395406,MMW 15,B05,193523,Chang; Edmond Yi-Teh,0,5,28,28
1683368395406,MMW 15,B06,193524,Chang; Edmond Yi-Teh,0,4,28,28
1683368396430,MMW 122,A01,193526,Rahimi; Babak,0,15,28,28
1683368396430,MMW 122,A02,193527,Rahimi; Babak,0,14,28,28
1683368396430,MMW 122,A03,193528,Rahimi; Babak,0,0,0,0
1683368396430,MMW 122,A04,193529,Rahimi; Babak,0,0,0,0
1683368397455,MUS 1A,A01,186663,Staff,0,20,35,35
1683368398479,MUS 4,A01,186715,Staff,0,12,35,35
1683368399503,MUS 5R,A01,186796,Dubnov; Shlomo,0,17,35,35
1683368400526,MUS 6,A01,186798,Staff,0,4,25,25
1683368401550,MUS 7,A01,186830,Staff,13,0,35,22
1683368402573,MUS 8,A01,186930,Staff,0,26,35,35
1683368403602,MUS 15,A01,186932,Staff,0,16,35,35
1683368403602,MUS 15,B01,186934,Staff,0,15,35,35
1683368404630,MUS 80,A00,186935,Staff,0,0,20,20
1683368404630,MUS 80,B00,186936,Staff,25,0,25,0
1683368405654,NANO 11,A00,204702,Lipomi; Darren John,0,0,0,0
1683368406683,NANO 15,A01,204709,Yang; Kesong,0,1,0,0
1683368407708,NANO 114,A00,202069,Jahed Motlagh; Zeinab,3,0,10,7
1683368408736,PHIL 1,A00,186955,Grush; Rick Scott,32,0,40,8
1683368409761,PHIL 10,A01,186973,Grush; Rick Scott,28,0,35,7
1683368409761,PHIL 10,A02,186974,Grush; Rick Scott,33,0,35,2
1683368410784,PHIL 13,A01,186976,Staff,7,0,35,28
1683368410784,PHIL 13,A02,186977,Staff,16,0,35,19
1683368411808,PHIL 14,A01,186979,Staff,31,0,35,4
1683368411808,PHIL 14,A02,186986,Staff,32,0,35,3
1683368412837,PHIL 28,A01,186988,Staff,16,0,30,14
1683368412837,PHIL 28,A02,186989,Staff,1,0,30,29
1683368412837,PHIL 28,A03,186990,Staff,9,0,30,21
1683368412837,PHIL 28,A04,186991,Staff,26,0,30,4
1683368413864,PHIL 120,A00,186997,Staff,23,0,40,17
1683368414891,PHIL 137,A00,187003,Staff,9,0,40,31
1683368415915,PHIL 150,A00,187015,Staff,47,0,70,23
1683368416942,PHIL 167,A00,187021,Lamey; Andy M.,35,0,40,5
1683368417970,PHIL 174,A01,202226,Staff,17,0,20,3
1683368417970,PHIL 174,A02,202235,Staff,20,0,20,0
1683368418995,PHIL 191A,A00,258918,Staff,0,0,1,1
1683368420022,PHYS 1A,A00,187028,Staff,27,0,60,33
1683368421050,PHYS 1AL,001,187036,Staff,2,0,30,28
1683368421050,PHYS 1AL,002,187049,Staff,18,0,30,12
1683368422074,PHYS 1B,A00,187058,Staff,22,0,60,38
1683368423098,PHYS 1BL,001,187064,Staff,0,0,30,30
1683368423098,PHYS 1BL,002,187070,Staff,5,0,30,25
1683368424124,PHYS 1C,A00,187082,Staff,31,0,120,89
1683368425152,PHYS 1CL,001,187088,Staff,0,9,30,30
1683368425152,PHYS 1CL,002,187089,Staff,0,2,30,30
1683368425152,PHYS 1CL,009,262693,Staff,11,0,30,19
1683368426181,PHYS 2B,A01,187097,Staff,54,0,115,61
1683368427207,PHYS 2C,A01,187099,Staff,67,0,115,48
1683368428231,PHYS 2CL,A01,187101,Staff,5,0,28,23
1683368428231,PHYS 2CL,A02,187102,Staff,15,0,28,13
1683368429256,PHYS 2D,A01,187123,Shotwell; Brian,95,0,115,20
1683368430279,PHYS 4B,A01,187133,Grinstein; Benjamin,35,0,50,15
1683368431302,POLI 10,A00,188819,Staff,0,4,50,50
1683368432328,POLI 11,A00,188827,Staff,43,0,50,7
1683368433357,POLI 13R,A00,188828,Staff,0,1,20,20
1683368434383,POLI 27,A01,188830,Elgin; Samuel Zincke,0,1,70,70
1683368435409,POLI 30,A00,188832,Desposato; Scott,31,0,50,19
1683368436433,POLI 102F,A00,188834,Staff,2,0,40,38
1683368437457,POLI 104A,A00,188852,Staff,14,0,30,16
1683368438481,POLI 104I,A00,188853,Staff,0,6,20,20
1683368439504,POLI 110B,A00,188854,Wiens; David,7,0,20,13
1683368440528,POLI 112A,A00,188855,Wiens; David,5,0,30,25
1683368441552,POLI 117R,A00,188856,Forman; Fonna,0,11,20,20
1683368442647,POLI 118,A00,188857,Ingham; Sean,8,0,20,12
1683368443671,POLI 120G,A00,188858,Staff,9,0,30,21
1683368444694,POLI 131CR,A00,188863,Hoston; Germaine,23,0,50,27
1683368445718,POLI 133,A00,188864,Nellis; Gareth Hb,44,0,50,6
1683368446746,POLI 134D,A00,188865,Desposato; Scott,27,0,30,3
1683368447774,POLI 142A,A00,188871,Gartzke; Erik,22,0,50,28
1683368448801,POLI 142K,A00,188874,Staff,38,0,50,12
1683368449828,POLI 143,A00,188940,Gartzke; Erik,16,0,30,14
1683368450856,POLI 153,A00,188943,Staff,3,0,20,17
1683368451880,POLI 160AA,A00,188944,Staff,11,0,40,29
1683368452905,POLI 170A,A00,188945,Staff,11,0,30,19
1683368454956,PSYC 1,A00,188952,Staff,37,0,90,53
1683368455982,PSYC 2,B00,188953,Staff,19,0,35,16
1683368457008,PSYC 6,A00,188970,Staff,47,0,60,13
1683368458033,PSYC 7,A00,188973,Staff,37,0,45,8
1683368459059,PSYC 60,A01,188980,Rickard; Timothy C.,43,0,60,17
1683368460086,PSYC 70,A01,189001,Steiner; Eric Tomas,23,0,45,22
1683368461118,PSYC 100,A00,189005,Lacefield; Katharine I,0,98,120,120
1683368462146,PSYC 102,A00,189008,Staff,9,0,30,21
1683368463171,PSYC 106,B00,189026,Gorman; Michael R.,34,0,60,26
1683368464194,PSYC 114,B01,189033,Winkielman; Piotr,0,32,30,30
1683368465220,PSYC 131,A00,189036,Anagnostaras; Stephan,0,43,60,60
1683368466245,PSYC 136,A00,189041,Lowe; Angela Beth,0,7,25,25
1683368467269,PSYC 137,A00,189057,Winkielman; Piotr,0,34,25,25
1683368468292,PSYC 144,A00,189107,Wixted; John T,0,7,50,50
1683368470347,PSYC 162,A00,189142,Staff,0,8,85,85
1683368471373,PSYC 172,A00,189144,Gorman; Michael R.,0,7,30,30
1683368473424,PSYC 179,A00,189146,Lacefield; Katharine I,0,84,120,120
1683368474452,PSYC 181,A00,189147,Anagnostaras; Stephan,0,44,90,90
1683368475479,PSYC 190R,A00,189148,Barner; David A.,0,22,80,80
1683368476506,PSYC 191,A00,189275,Rickard; Timothy C.,0,7,25,25
1683368477537,PSYC 193,A00,189276,Chapman; Eddie Nathaniel,0,1,0,4
1683368478562,PSYC 193L,A01,189281,Lowe; Angela Beth,12,0,20,8
1683368478562,PSYC 193L,B01,189285,Staff,28,0,35,7
1683368479588,RELI 149,A00,187137,Rahimi; Babak,7,0,40,33
1683368480613,SE 9,A01,187315,Staff,0,2,18,18
1683368481637,SE 101B,A00,187409,Staff,24,0,30,6
1683368482659,SE 110B,A00,187444,Staff,10,0,40,30
1683368483683,SE 130B,A00,187449,Staff,31,0,40,9
1683368484708,SE 150A,A00,187516,Staff,9,0,20,11
1683368485734,SE 154,A00,187528,Staff,30,0,50,20
1683368486762,SIO 3,A01,258171,Staff,35,0,40,5
1683368487792,SIO 10,A00,187144,Cook; Geoffrey W,0,3,75,75
1683368488817,SIO 45,A00,187152,Cook; Geoffrey W,1,0,100,99
1683368489840,SIO 109R,A00,194486,Staff,0,3,20,20
1683368491888,SIO 187,A01,187233,Kacev; David,12,0,40,28
1683368492913,SOCI 1,A01,258656,Thorpe; Charles Robert,28,0,30,2
1683368492913,SOCI 1,A02,258658,Thorpe; Charles Robert,30,0,30,0
1683368492913,SOCI 1,A03,258661,Thorpe; Charles Robert,25,0,25,0
1683368492913,SOCI 1,A04,258666,Thorpe; Charles Robert,22,0,25,3
1683368492913,SOCI 1,A05,258897,Thorpe; Charles Robert,23,0,25,2
1683368492913,SOCI 1,A06,258898,Thorpe; Charles Robert,25,0,25,0
1683368493939,SOCI 30,A01,258903,Pardo Guerra; Juan Pablo,15,0,30,15
1683368494964,SOCI 102,A00,258904,Staff,9,0,25,16
1683368495988,SOCI 106,A00,258905,Staff,19,0,25,6
1683368497017,SOCI 111,A00,258907,Ribas Norris; Janet Vanesa,26,0,30,4
1683368498046,SOCI 121R,A00,258908,Pardo Guerra; Juan Pablo,10,0,30,20
1683368499072,SOCI 126,A01,203330,Staff,14,0,20,6
1683368500096,SOCI 131,A00,258909,Thorpe; Charles Robert,31,0,60,29
1683368501120,SOCI 135,A00,258910,Payne; Christine Anna,0,9,30,30
1683368502144,SOCI 157,A00,258911,Staff,12,0,30,18
1683368503168,SOCI 184,A00,258912,Staff,25,0,30,5
1683368504198,SOCI 188D,A00,258913,Staff,22,0,30,8
1683368505223,SYN 2,001,187529,Staff,10,0,16,6
1683368505223,SYN 2,002,201452,Staff,0,18,16,16
1683368505223,SYN 2,003,201469,Staff,3,0,16,13
1683368506247,SYN 100,A01,187531,Staff,0,9,20,20
1683368506247,SYN 100,B01,201491,Staff,0,12,20,20
1683368507274,TDAC 1,A00,189286,Walsh; Kim C.,3,0,20,17
1683368507274,TDAC 1,B00,189287,Harting; Carla Kelso,11,0,20,9
1683368508299,TDAC 101,A00,189300,Walsh; Kim C.,16,0,20,4
1683368508299,TDAC 101,B00,189301,Harting; Carla Kelso,18,0,20,2
1683368509325,TDAC 102,A00,189304,Basso; Beatrice,14,0,20,6
1683368510350,TDAC 108,A00,189305,Staff,18,0,20,2
1683368511375,TDDE 131,A00,189310,Staff,19,0,20,1
1683368511375,TDDE 131,B00,189314,Staff,19,0,20,1
1683368511375,TDDE 131,C00,189315,Staff,48,0,50,2
1683368511375,TDDE 131,D00,189316,Staff,14,0,15,1
1683368511375,TDDE 131,E00,204841,Staff,20,0,20,0
1683368512403,TDGE 10,A00,189289,Staff,30,0,50,20
1683368512403,TDGE 10,B00,189290,Havis; Allan,1,0,50,49
1683368513428,TDGE 11,A00,189291,Fulton; Julia,0,3,50,50
1683368513428,TDGE 11,B00,189292,Staff,20,0,25,5
1683368513428,TDGE 11,C00,260270,Staff,0,0,0,0
1683368514456,TDGE 25,A00,189294,Staff,3,0,20,17
1683368515486,TDGE 124,A00,189318,Fulton; Julia,0,8,50,50
1683368516513,TDGE 125,A00,189319,Staff,13,0,25,12
1683368516513,TDGE 125,B00,189320,Staff,23,0,25,2
1683368517537,TDGE 127,A00,189322,Havis; Allan,0,0,50,50
1683368518562,TDHT 101,A00,189323,Staff,18,0,25,7
1683368518562,TDHT 101,B00,189324,Staff,25,0,25,0
1683368519586,TDHT 102,A00,189325,Staff,49,0,50,1
1683368520612,TDMV 1,A00,189295,Arcidiacono; Kristin,19,0,30,11
1683368520612,TDMV 1,B00,189296,Caligagan; Maria T.,24,0,30,6
1683368521638,TDMV 2,A00,189297,Sammartano; Tonnie,28,0,30,2
1683368521638,TDMV 2,B00,189299,Arcidiacono; Kristin,24,0,30,6
1683368522667,TDMV 3,A00,204998,Rincon; Alicia,22,0,30,8
1683368523695,TDMV 120,A00,189458,Sammartano; Tonnie,28,0,30,2
1683368524720,TDMV 138,A00,189541,Jun; Grace Shin Hae,22,0,40,18
1683368525746,TDMV 142,A00,189717,Caligagan; Tony,24,0,30,6
1683368525746,TDMV 142,B00,189718,Caligagan; Maria T.,25,0,30,5
1683368526772,TMC 2,A01,187533,Staff,25,0,25,0
1683368526772,TMC 2,A02,187534,Staff,25,0,25,0
1683368527797,USP 1,A01,187536,Kwak; Nancy,0,16,25,25
1683368528822,USP 5,A01,187538,Staff,10,0,25,15
1683368529850,USP 101,A00,199253,Staff,0,4,0,0
1683368530879,USP 124,A00,187562,Boomhower; Matthew Charles,1,0,30,29
1683368531904,USP 138,A00,187582,Staff,20,0,25,5
1683368532928,USP 152,A01,187597,Staff,4,0,25,21
1683368533955,USP 153,A00,187598,Staff,19,0,25,6
1683368534983,USP 168,A00,187607,Kwak; Nancy,2,0,5,3
1683368536010,USP 173,A00,187619,Staff,4,0,25,21
1683368537037,USP 181,A00,187638,Staff,0,3,25,25
1683368538065,VIS 103,A00,187650,Cruz; Edwin Teddy,22,0,75,53
1683368539088,VIS 110D,A00,187669,Staff,12,0,22,10
1683368540122,VIS 127C,A00,187720,Shen; Kuiyi,67,0,146,79
1683368541147,VIS 149,A00,187731,Yoldas; Pinar,0,14,22,22
1683368542171,VIS 151,A01,188091,Staff,22,0,34,12
1683368542171,VIS 151,A02,188092,Staff,11,0,34,23
1683368543196,VIS 160B,A00,188093,Stalbaum; Brett,0,0,10,10
1683368545249,WCWP 10B,A00,201720,Staff,10,0,15,5
1683368545249,WCWP 10B,B00,201722,Staff,9,0,15,6
1683368546332,WCWP 100,A00,201725,Gagnon; Jeffrey C,0,0,2,2
1683368546332,WCWP 100,B00,201727,Staff,0,4,15,15
1683368549489,ANBI 133,A00,258401,Wilder; Linnea Lorene,34,0,40,6
1683368550517,ANBI 140,A00,258395,Hrvoj Mihic; Branka,18,0,25,7
1683368551545,ANSC 120,A00,258402,Bialecki; Jon Anthony,27,0,40,13
1683368552568,ANSC 144,A00,258400,Staff,14,0,40,26
1683368554624,ANSC 166,A00,258396,Parish; Steven Martin,158,0,175,17
1683368555651,ANSC 180,A00,193533,Staff,9,0,20,11
1683368556676,ANSC 188,A00,258397,Jassal; Aftab,33,0,40,7
1683368557701,ANTH 3,A01,258316,Staff,23,0,30,7
1683368558727,ANTH 5,A00,258394,Semendeferi; Ekaterini,16,0,20,4
1683368559750,ANTH 21,A01,258331,Staff,8,0,40,32
1683368560774,ANTH 103,A00,258398,Varma; Saiba,15,0,25,10
1683368561802,AWP 10,001,202034,Staff,0,0,0,0
1683368561802,AWP 10,002,202035,Staff,0,0,0,0
1683368561802,AWP 10,003,202036,Staff,0,0,0,0
1683368561802,AWP 10,004,202037,Staff,0,0,0,0
1683368561802,AWP 10,005,202038,Staff,0,0,0,0
1683368561802,AWP 10,006,202039,Staff,0,0,0,0
1683368561802,AWP 10,007,202040,Staff,0,0,0,0
1683368561802,AWP 10,008,202041,Staff,0,0,0,0
1683368561802,AWP 10,009,202042,Staff,0,0,0,0
1683368561802,AWP 10,010,202043,Staff,0,0,0,0
1683368561802,AWP 10,011,202044,Staff,0,0,0,0
1683368561802,AWP 10,012,202045,Staff,0,0,0,0
1683368561802,AWP 10,013,202046,Staff,0,0,0,0
1683368561802,AWP 10,014,202047,Staff,0,0,0,0
1683368561802,AWP 10,015,202048,Staff,0,0,0,0
1683368561802,AWP 10,016,202049,Staff,0,0,0,0
1683368561802,AWP 10,017,202050,Staff,0,0,0,0
1683368561802,AWP 10,018,202051,Staff,0,0,0,0
1683368561802,AWP 10,019,202052,Staff,0,0,0,0
1683368561802,AWP 10,020,202053,Staff,0,0,0,0
1683368561802,AWP 10,021,202054,Staff,0,0,0,0
1683368561802,AWP 10,022,202055,Staff,0,0,0,0
1683368561802,AWP 10,023,202056,Staff,0,0,0,0
1683368561802,AWP 10,024,202057,Staff,0,0,0,0
1683368561802,AWP 10,025,202058,Staff,0,0,0,0
1683368561802,AWP 10,026,202059,Staff,0,0,0,0
1683368562829,AWP 102,001,202032,Staff,0,0,0,0
1683368562829,AWP 102,002,202033,Staff,0,0,0,0
1683368563857,BENG 100,A01,254234,Taylor Amos; Alyssa C,31,0,40,9
1683368564884,BENG 196,001,270013,Engler; Adam J.,9999,0,9999,0
1683368565911,BICD 100R,A01,202018,Smith; Laurie,0,7,32,32
1683368565911,BICD 100R,A02,202019,Smith; Laurie,0,2,32,32
1683368565911,BICD 100R,A03,202020,Smith; Laurie,0,1,32,32
1683368565911,BICD 100R,A04,202021,Smith; Laurie,9,0,32,23
1683368565911,BICD 100R,A05,202022,Smith; Laurie,12,0,32,20
1683368566935,BICD 136,A01,193242,Gustafson-Brown; Cindy,0,2,32,32
1683368566935,BICD 136,A02,193244,Gustafson-Brown; Cindy,14,0,32,18
1683368567965,BIEB 102,A01,193249,Butler; Shannon Rhey,0,2,32,32
1683368567965,BIEB 102,A02,193251,Butler; Shannon Rhey,0,0,32,32
1683368567965,BIEB 102,A03,193253,Butler; Shannon Rhey,0,1,32,32
1683368567965,BIEB 102,A04,193255,Butler; Shannon Rhey,17,0,32,15
1683368567965,BIEB 102,A05,193265,Butler; Shannon Rhey,26,0,32,6
1683368567965,BIEB 102,A06,193269,Butler; Shannon Rhey,16,0,32,16
1683368570020,BIEB 150,A01,193274,Staff,0,0,32,32
1683368570020,BIEB 150,A02,193285,Staff,23,0,32,9
1683368571044,BIEB 194,A00,193286,Kurle; Carolyn M.,22,0,32,10
1683368572074,BILD 1,A01,192291,Staff,16,0,32,16
1683368572074,BILD 1,A02,192292,Staff,30,0,32,2
1683368572074,BILD 1,B01,192520,Reuther; Keefe,0,1,0,0
1683368572074,BILD 1,B02,192532,Reuther; Keefe,0,1,0,0
1683368573098,BILD 3,A01,192556,Butler; Shannon Rhey,0,0,32,32
1683368573098,BILD 3,A02,192581,Butler; Shannon Rhey,4,0,32,28
1683368573098,BILD 3,A03,192611,Butler; Shannon Rhey,23,0,32,9
1683368573098,BILD 3,A04,192612,Butler; Shannon Rhey,25,0,32,7
1683368573098,BILD 3,A05,192613,Butler; Shannon Rhey,27,0,32,5
1683368573098,BILD 3,A06,192679,Butler; Shannon Rhey,27,0,32,5
1683368573098,BILD 3,A07,192682,Butler; Shannon Rhey,21,0,32,11
1683368574122,BILD 4,A01,192836,Reuther; Keefe,0,0,24,24
1683368574122,BILD 4,A02,193044,Reuther; Keefe,4,0,24,20
1683368575147,BILD 10,A01,193142,Gustafson-Brown; Cindy,30,0,32,2
1683368575147,BILD 10,A02,193149,Gustafson-Brown; Cindy,31,0,32,1
1683368576178,BIMM 100,A01,193301,Staff,1,6,32,31
1683368576178,BIMM 100,A02,193312,Staff,0,5,32,32
1683368576178,BIMM 100,A03,193323,Staff,0,8,32,32
1683368577209,BIMM 101,A01,193329,McDonnell; Lisa Marie,0,3,24,24
1683368577209,BIMM 101,A02,193339,McDonnell; Lisa Marie,0,3,24,24
1683368577209,BIMM 101,B01,193354,McDonnell; Lisa Marie,0,3,24,24
1683368577209,BIMM 101,B02,193357,McDonnell; Lisa Marie,0,3,24,24
1683368578233,BIMM 110,A01,193377,Tat; John,0,11,32,32
1683368578233,BIMM 110,A02,193378,Tat; John,0,9,32,32
1683368579260,BIMM 120,A01,206116,Staff,0,0,32,32
1683368579260,BIMM 120,A02,206117,Staff,8,0,32,24
1683368579260,BIMM 120,A03,206121,Staff,21,0,32,11
1683368580290,BIPN 100,A01,193393,Park; Ji Young,0,14,32,32
1683368580290,BIPN 100,A02,193402,Park; Ji Young,0,13,32,32
1683368580290,BIPN 100,A03,193413,Park; Ji Young,0,14,32,32
1683368580290,BIPN 100,A04,193414,Park; Ji Young,0,13,32,32
1683368581315,BIPN 102,A01,193429,Staff,0,0,32,32
1683368581315,BIPN 102,A02,193438,Staff,22,0,32,10
1683368582340,BIPN 106,A01,193450,Reyes Gonzalez; Catalina,0,2,40,40
1683368583367,BIPN 134,A01,193465,Cooke; James Edward,1,0,32,31
1683368583367,BIPN 134,A02,193474,Cooke; James Edward,25,0,32,7
1683368583367,BIPN 134,A03,193485,Cooke; James Edward,29,0,32,3
1683368583367,BIPN 134,A04,193486,Cooke; James Edward,21,0,32,11
1683368583367,BIPN 134,A05,193491,Cooke; James Edward,31,0,32,1
1683368583367,BIPN 134,A06,193501,Cooke; James Edward,30,0,32,2
1683368583367,BIPN 134,A07,193510,Cooke; James Edward,29,0,32,3
1683368585419,BISP 194,A00,222522,Staff,14,0,32,18
1683368586447,CAT 124,A01,202407,Staff,19,0,25,6
1683368587476,CAT 125,A00,202408,Marchisotto; Jennifer Anne,4,0,20,16
1683368588504,CAT 125R,A00,202409,Smith; Lauryn Alissa,0,11,20,20
1683368588504,CAT 125R,B00,202410,Morales; Celeste Georgianna,0,11,20,20
1683368588504,CAT 125R,C00,202411,Irwin; Matthew Joseph,0,10,20,20
1683368589530,CENG 15,A01,204712,Yang; Kesong,0,1,0,0
1683368590554,CENG 114,A00,202070,Jahed Motlagh; Zeinab,5,0,20,15
1683368591583,CGS 105,A00,185477,Wesling; Megan E.,24,0,40,16
1683368592609,CGS 106,A00,185494,Staff,13,0,22,9
1683368593636,CGS 108,A00,185495,Staff,14,0,20,6
1683368594660,CGS 114,A00,185496,Staff,13,0,18,5
1683368595684,CGS 119,A00,185501,Staff,15,0,20,5
1683368596712,CGS 120,A00,185511,Staff,13,0,20,7
1683368597738,CHEM 4,A01,184675,Bussey; Thomas J,96,0,100,4
1683368598764,CHEM 6A,A01,184677,Staff,34,0,60,26
1683368599792,CHEM 6B,A01,184679,Staff,65,0,100,35
1683368600818,CHEM 6C,A01,184681,Bussey; Thomas J,1,0,50,49
1683368600818,CHEM 6C,A02,184682,Bussey; Thomas J,34,0,50,16
1683368601843,CHEM 40A,A01,184684,Albizati; Kim F.,37,0,100,63
1683368602867,CHEM 40B,A01,184686,Albizati; Kim F.,0,20,100,100
1683368603890,CHEM 41B,A01,184690,Staff,52,0,100,48
1683368604919,COGS 3,A01,184715,Boyle; Mary E. T.,0,25,40,40
1683368605947,COGS 14B,A01,185172,Staff,0,15,38,38
1683368606971,COGS 18,A01,184736,Staff,16,0,80,64
1683368607997,COGS 100,A01,184932,Staff,0,5,73,73
1683368609021,COGS 101A,A01,184935,Staff,0,39,30,30
1683368610047,COGS 101B,A01,184944,Staff,0,2,30,30
1683368611071,COGS 101C,A01,184946,Staff,0,12,30,30
1683368612095,COGS 102A,A01,184951,Johnson; Christine M.,2,0,40,38
1683368613122,COGS 107B,A01,184953,Mooshagian; Eric Frederick,0,50,40,40
1683368614146,COGS 118B,A01,184959,Gupta; Anjum,0,48,40,40
1683368615170,COGS 153,A00,184961,Staff,0,15,30,30
1683368616194,COGS 177,A00,184962,Staff,0,20,30,30
1683368617223,COGS 187A,A01,184969,Boyle; Mary E. T.,0,17,40,40
1683368618252,COMM 10,A01,185174,Staff,0,5,25,25
1683368618252,COMM 10,A02,185189,Staff,0,5,25,25
1683368618252,COMM 10,A03,269821,Staff,0,0,0,0
1683368619278,COMM 100B,A01,185475,Staff,0,0,0,2
1683368619278,COMM 100B,A02,185476,Staff,13,0,25,12
1683368620303,COMM 100C,A01,185314,Staff,1,0,25,24
1683368620303,COMM 100C,A02,185327,Staff,19,0,25,6
1683368621328,COMM 110M,A00,185349,Staff,2,0,40,38
1683368622355,COMM 113T,A00,185352,Staff,24,0,40,16
1683368623381,COMM 114I,A00,185353,Staff,33,0,40,7
1683368624408,COMM 131,A00,185354,Staff,19,0,30,11
1683368625437,CSE 8A,A50,185358,Cao; Yingjun,0,46,10,10
1683368626465,CSE 8B,A01,185362,Staff,0,46,50,50
1683368627493,CSE 11,A01,185416,Cao; Yingjun,0,92,10,10
1683368628521,CSE 20,A01,185445,Briones; Jor-el Thomas Caparas,5,0,25,20
1683368629548,CSE 21,A01,185447,Staff,10,0,50,40
1683368630573,CSE 101,A01,185451,Staff,0,13,50,50
1683368630573,CSE 101,B01,185453,Jones; Miles E,0,11,50,50
1683368632621,CSE 141,A01,185458,Eldon; John,20,0,100,80
1683368633648,CSE 141L,A01,185461,Eldon; John,12,0,100,88
1683368634677,CSE 142,A01,185463,Staff,36,0,60,24
1683368634677,CSE 142,B01,201355,Staff,0,7,60,60
1683368635702,CSE 142L,A01,185470,Staff,36,0,60,24
1683368635702,CSE 142L,B01,201417,Staff,0,6,60,60
1683368636726,CSE 190,A00,201433,Staff,32,0,49,17
1683368637752,DOC 1,A01,259136,Strom; Megan C.,7,0,15,8
1683368637752,DOC 1,A02,259137,Strom; Megan C.,14,0,15,1
1683368637752,DOC 1,A03,259138,Strom; Megan C.,14,0,15,1
1683368637752,DOC 1,A04,259139,Strom; Megan C.,14,0,15,1
1683368638776,DOC 100D,A00,259140,Pass; Natalye Joann,16,0,25,9
1683368639799,DSGN 1,A01,184749,Rill; Bryan,0,25,30,30
1683368640824,DSGN 100,A01,185168,Staff,0,2,25,25
1683368641850,ECE 5,A01,185626,Morris; Karcher William,0,10,0,0
1683368642878,ECE 101,A01,185628,Staff,17,0,70,53
1683368643909,ECE 107,A01,185635,Baghdadchi; Saharnaz,0,0,20,20
1683368643909,ECE 107,A02,185638,Baghdadchi; Saharnaz,4,0,20,16
1683368644936,ECE 148,A01,185647,Silberman; Jack,0,0,16,16
1683368645962,ECON 1,A01,185537,Crane; Meredith Helen,54,0,70,16
1683368646987,ECON 3,A01,185549,Crane; Meredith Helen,32,0,70,38
1683368648012,ECON 4,A01,203354,Anderson; John Charles,0,4,10,10
1683368649038,ECON 100A,A01,185574,Staff,0,4,40,40
1683368650118,ECON 100B,A01,185576,Staff,0,12,50,50
1683368651142,ECON 100C,A01,185589,Newhouse; Herbert S,29,0,70,41
1683368652167,ECON 105,A00,185608,Vespa; Emanuel Ignacio,19,0,35,16
1683368653192,ECON 109,A01,185610,Shishkin; Denis,10,0,35,25
1683368654218,ECON 110A,A01,185612,Staff,11,0,40,29
1683368655243,ECON 120A,A01,185615,Staff,20,0,40,20
1683368656272,ECON 120C,A01,185617,Sun; Yixiao,0,21,70,70
1683368657302,ECON 144,A00,203346,Squires; Dale E,3,0,35,32
1683368658330,ECON 171,A01,203349,Newhouse; Herbert S,0,1,35,35
1683368659360,ECON 173A,A01,185621,Toda; Alexis Akira,21,0,35,14
1683368660395,EDS 25,A01,202413,Staff,0,1,0,0
1683368660395,EDS 25,A02,202414,Staff,0,1,0,0
1683368660395,EDS 25,A03,202415,Staff,0,0,0,0
1683368660395,EDS 25,A04,202416,Staff,0,1,0,0
1683368660395,EDS 25,A05,202439,Staff,0,0,0,0
1683368660395,EDS 25,A06,202440,Staff,0,0,0,0
1683368660395,EDS 25,B01,202631,Staff,0,0,0,0
1683368660395,EDS 25,B02,202632,Staff,0,0,0,0
1683368660395,EDS 25,B03,202639,Staff,0,0,0,0
1683368660395,EDS 25,B04,202640,Staff,0,0,0,0
1683368660395,EDS 25,B05,202643,Staff,0,0,0,0
1683368660395,EDS 25,B06,202644,Staff,0,0,0,0
1683368661420,EDS 38,A01,202659,Black; Alison Michelle,24,0,25,1
1683368662443,EDS 115,A00,202652,Staff,18,0,30,12
1683368663471,EDS 125,A00,202649,Staff,14,0,30,16
1683368664497,EDS 126,A01,203332,Staff,30,0,30,0
1683368665523,EDS 139,A00,202838,Staff,16,0,25,9
1683368666548,EDS 146,A01,202655,Staff,14,0,25,11
1683368667573,ENG 15,A00,185667,Staff,0,1,0,0
1683368667573,ENG 15,B00,185672,Staff,0,0,0,0
1683368667573,ENG 15,C00,185675,Staff,0,0,0,0
1683368667573,ENG 15,D00,185682,Staff,0,0,0,0
1683368667573,ENG 15,E00,185684,Staff,0,0,0,0
1683368668598,ETHN 103,A00,185710,Staff,0,4,35,35
1683368669623,ETHN 103A,A00,199228,Man; Simeon S,2,0,9,7
1683368670648,ETHN 109,A00,185711,Staff,18,0,35,17
1683368671672,ETHN 142,A00,185726,Staff,0,4,30,30
1683368672699,ETHN 163J,A00,199229,Man; Simeon S,5,0,8,3
1683368673726,ETHN 168,A00,185727,Staff,8,0,10,2
1683368674751,ETHN 182,A00,185728,Staff,0,0,35,35
1683368675775,ETHN 183,A00,185737,Staff,8,0,18,10
1683368676800,GLBH 111,A01,209361,Burgos; Jose L.,0,0,0,0
1683368678853,HIEU 104,A00,185792,Staff,16,0,20,4
1683368679881,HIEU 115,A00,185800,Staff,1,0,20,19
1683368680909,HIEU 128,A00,185801,Staff,0,7,20,20
1683368681934,HIEU 147,A00,185802,Staff,16,0,20,4
1683368682959,HIEU 154,A00,185823,Staff,12,0,20,8
1683368683984,HILA 102,A00,185826,Staff,13,0,20,7
1683368685012,HILD 2C,A01,185778,Staff,0,12,20,20
1683368686037,HILD 7B,A01,185780,Kwak; Nancy,0,15,32,32
1683368686037,HILD 7B,A02,185781,Kwak; Nancy,0,18,32,32
1683368687062,HILD 30,A01,185791,Staff,14,0,20,6
1683368688086,HISC 119,A00,185830,Golan; Tal,0,9,20,20
1683368689110,HITO 156GS,A00,185831,Patterson; Patrick H.,0,0,0,23
1683368690135,HIUS 103,A00,185832,Man; Simeon S,1,6,20,19
1683368691158,HIUS 117,A00,185836,Kwak; Nancy,2,0,20,18
1683368692184,HIUS 125,A00,185840,Man; Simeon S,0,0,23,23
1683368693208,HIUS 149,A00,185845,Staff,0,0,20,20
1683368694236,HUM 3,A01,185882,Zavodny; Tatiana Sophia,0,7,50,50
1683368694236,HUM 3,B01,185899,Caldwell; Michael Alan,0,18,50,50
1683368695259,HUM 3GS,A00,185900,Patterson; Patrick H.,0,0,0,23
1683368696283,HUM 4,A01,185938,Zroka; Amy Liane,31,0,50,19
1683368696283,HUM 4,B01,185956,Watkins; Eric,0,3,50,50
1683368696283,HUM 4,B02,202209,Watkins; Eric,0,2,50,50
1683368696283,HUM 4,B03,202210,Watkins; Eric,0,2,50,50
1683368697307,HUM 5,A01,185958,West; Geoffrey Scott,3,0,50,47
1683368697307,HUM 5,A02,202215,West; Geoffrey Scott,0,0,50,50
1683368698330,INTL 190,A00,185959,Gagnon; Jeffrey C,0,0,0,9
1683368698330,INTL 190,B00,185960,Lettieri; Michael Joseph,0,0,0,1
1683368699356,JAPN 180,A00,254509,Staff,4,0,30,26
1683368700388,LATI 10,A01,202853,Kennemore; Amy Michelle,4,0,35,31
1683368700388,LATI 10,A02,202854,Kennemore; Amy Michelle,2,0,35,33
1683368700388,LATI 10,A03,270054,Kennemore; Amy Michelle,30,0,30,0
1683368701416,LATI 180,A00,202855,Kennemore; Amy Michelle,11,0,20,9
1683368702446,LAWS 101,A00,201767,Golan; Tal,0,7,40,40
1683368703474,LIFR 1C,A00,185961,Staff,6,0,20,14
1683368704504,LIFR 1CX,A00,185962,Staff,7,0,20,13
1683368705528,LIFR 1D,A00,185963,Staff,9,0,20,11
1683368706552,LIFR 1DX,A00,185964,Staff,9,0,20,11
1683368707579,LIGN 101,A01,186039,Staff,43,0,50,7
1683368708603,LIGN 165,A00,186040,Staff,18,0,50,32
1683368709626,LTCS 108,A00,186041,Staff,6,0,10,4
1683368710654,LTCS 119,A00,186042,Staff,16,0,20,4
1683368711682,LTCS 130,A00,186043,Wesling; Megan E.,15,0,25,10
1683368713730,LTEA 138,A00,186119,Staff,14,0,40,26
1683368714754,LTEN 124,A00,186148,Staff,6,0,25,19
1683368715778,LTEN 178,A00,186149,Staff,7,0,15,8
1683368716805,LTEN 181,A00,186150,Blanco; John D,33,0,40,7
1683368717832,LTWL 120,A00,186160,Staff,20,0,25,5
1683368718861,LTWL 165,A00,186161,Staff,22,0,25,3
1683368719885,LTWR 100,A00,186162,Staff,0,5,15,15
1683368720909,LTWR 102,A00,186163,Doller; Ben,5,0,15,10
1683368721937,MAE 8,A01,186412,Staff,0,0,0,0
1683368722962,MAE 30B,A00,186445,Bahadori; Mohammad Yousef,83,0,100,17
1683368723987,MAE 40,A00,186592,Bewley; Thomas R,10,0,50,40
1683368725012,MAE 101B,A00,186593,Bahadori; Mohammad Yousef,81,0,100,19
1683368726038,MAE 105,A00,186594,Bandaru; Prabhakar,12,0,50,38
1683368727063,MAE 107,A00,186599,Pham; Hieu Tan,0,7,120,120
1683368728089,MAE 148,A01,186660,Silberman; Jack,3,0,16,13
1683368729118,MATH 10A,A01,188095,Staff,0,5,35,35
1683368730149,MATH 10B,A01,188097,Bowers; Adam R.,0,11,30,30
1683368730149,MATH 10B,A02,188099,Bowers; Adam R.,0,11,30,30
1683368730149,MATH 10B,B01,188104,Bowers; Adam R.,0,10,30,30
1683368730149,MATH 10B,B02,188106,Bowers; Adam R.,0,10,30,30
1683368731174,MATH 10C,A01,188111,Staff,0,18,30,30
1683368731174,MATH 10C,A02,188127,Staff,0,17,30,30
1683368731174,MATH 10C,A03,188131,Staff,0,18,30,30
1683368731174,MATH 10C,B01,188218,Staff,18,0,30,12
1683368731174,MATH 10C,B02,188244,Staff,13,0,30,17
1683368731174,MATH 10C,B03,188277,Staff,16,0,30,14
1683368732198,MATH 18,A01,188344,Bach; Quang Tran,18,0,30,12
1683368732198,MATH 18,A02,188345,Bach; Quang Tran,11,0,30,19
1683368732198,MATH 18,B01,188353,Bach; Quang Tran,10,0,30,20
1683368732198,MATH 18,B02,188354,Bach; Quang Tran,20,0,30,10
1683368733225,MATH 20A,A01,188374,Staff,12,0,35,23
1683368734249,MATH 20B,A01,188382,Ohm; Ko Woon,6,0,30,24
1683368734249,MATH 20B,A02,188383,Ohm; Ko Woon,21,0,30,9
1683368734249,MATH 20B,B01,188385,Ohm; Ko Woon,7,0,30,23
1683368734249,MATH 20B,B02,188392,Ohm; Ko Woon,22,0,30,8
1683368735274,MATH 20C,A01,188394,Harel; Guershon,10,0,30,20
1683368735274,MATH 20C,A02,188395,Harel; Guershon,15,0,30,15
1683368735274,MATH 20C,B01,188404,Harel; Guershon,4,0,30,26
1683368735274,MATH 20C,B02,188405,Harel; Guershon,19,0,30,11
1683368736300,MATH 20D,A01,188414,Hammock; Frances H,0,1,30,30
1683368736300,MATH 20D,A02,188415,Hammock; Frances H,3,0,30,27
1683368736300,MATH 20D,B01,188447,Hammock; Frances H,1,0,30,29
1683368736300,MATH 20D,B02,188486,Hammock; Frances H,8,0,30,22
1683368737329,MATH 20E,A01,188649,Staff,21,0,30,9
1683368737329,MATH 20E,A02,188650,Staff,23,0,30,7
1683368737329,MATH 20E,A03,188673,Staff,0,0,30,30
1683368738353,MATH 102,A01,188675,Staff,0,35,35,35
1683368739378,MATH 103B,A01,188681,Staff,3,0,35,32
1683368739378,MATH 103B,B01,188692,Staff,5,0,35,30
1683368740403,MATH 109,A01,188695,Salehi Golsefidy; Alireza,25,0,35,10
1683368740403,MATH 109,A02,188696,Salehi Golsefidy; Alireza,25,0,35,10
1683368741430,MATH 120A,A01,188698,Eggers; John Dietrich,7,0,35,28
1683368742455,MATH 142B,A01,188736,Ioana; Adrian,0,2,30,30
1683368742455,MATH 142B,A02,188741,Ioana; Adrian,0,0,30,30
1683368742455,MATH 142B,A03,188743,Ioana; Adrian,0,1,30,30
1683368743482,MATH 168A,A01,188790,Staff,0,9,35,35
1683368744514,MATH 170A,A01,188803,Nie; Jiawang,0,2,35,35
1683368744514,MATH 170A,A02,188811,Nie; Jiawang,0,0,35,35
1683368744514,MATH 170A,A03,188814,Nie; Jiawang,1,0,35,34
1683368744514,MATH 170A,A04,188815,Nie; Jiawang,13,0,35,22
1683368745542,MATH 193B,A01,188817,Staff,0,0,35,35
1683368745542,MATH 193B,A02,188818,Staff,5,0,35,30
1683368746568,MGT 4,A01,202857,Anderson; John Charles,61,0,80,19
1683368747594,MGT 12,A00,202858,Lindenberger; Wade Douglas,41,0,90,49
1683368748619,MGT 18,A00,202859,Staff,74,0,90,16
1683368749643,MGT 18GS,A00,202860,McKay; Michael J,13,0,28,15
1683368750669,MGT 45,A00,202861,Pecore; Joseph P.,15,0,90,75
1683368751694,MGT 100,A00,202863,Yavorsky; Daniel Ryan,28,0,90,62
1683368752722,MGT 103,A00,202864,Ehrich; Kristine R,0,17,90,90
1683368753801,MGT 112,A00,202865,Ehrich; Kristine R,15,0,90,75
1683368754825,MGT 121A,A00,202868,Staff,0,20,0,0
1683368755849,MGT 131B,A00,202869,Anderson; John Charles,59,0,90,31
1683368756877,MGT 136,A00,202871,Lindenberger; Wade Douglas,84,0,90,6
1683368757906,MGT 164,A00,202873,Staff,0,68,90,91
1683368758933,MGT 164GS,A00,202874,McKay; Mary A,13,0,28,15
1683368759958,MGT 180,A00,202875,Staff,0,50,90,91
1683368760984,MMW 11R,A01,205019,Herbst; Matthew,3,0,30,27
1683368760984,MMW 11R,A02,205026,Herbst; Matthew,29,0,30,1
1683368762014,MMW 15,A01,193512,Chang; Edmond Yi-Teh,0,9,28,28
1683368762014,MMW 15,A02,193513,Chang; Edmond Yi-Teh,0,5,28,28
1683368762014,MMW 15,A03,193514,Chang; Edmond Yi-Teh,0,5,28,28
1683368762014,MMW 15,A04,193515,Chang; Edmond Yi-Teh,0,5,28,28
1683368762014,MMW 15,A05,193516,Chang; Edmond Yi-Teh,0,4,28,28
1683368762014,MMW 15,A06,193517,Chang; Edmond Yi-Teh,0,5,28,28
1683368762014,MMW 15,B01,193519,Chang; Edmond Yi-Teh,0,5,28,28
1683368762014,MMW 15,B02,193520,Chang; Edmond Yi-Teh,0,5,28,28
1683368762014,MMW 15,B03,193521,Chang; Edmond Yi-Teh,0,5,28,28
1683368762014,MMW 15,B04,193522,Chang; Edmond Yi-Teh,0,4,28,28
1683368762014,MMW 15,B05,193523,Chang; Edmond Yi-Teh,0,5,28,28
1683368762014,MMW 15,B06,193524,Chang; Edmond Yi-Teh,0,4,28,28
1683368763041,MMW 122,A01,193526,Rahimi; Babak,0,15,28,28
1683368763041,MMW 122,A02,193527,Rahimi; Babak,0,14,28,28
1683368763041,MMW 122,A03,193528,Rahimi; Babak,0,0,0,0
1683368763041,MMW 122,A04,193529,Rahimi; Babak,0,0,0,0
1683368764066,MUS 1A,A01,186663,Staff,0,20,35,35
1683368765091,MUS 4,A01,186715,Staff,0,12,35,35
1683368766119,MUS 5R,A01,186796,Dubnov; Shlomo,0,17,35,35
1683368767141,MUS 6,A01,186798,Staff,0,4,25,25
1683368768166,MUS 7,A01,186830,Staff,13,0,35,22
1683368769196,MUS 8,A01,186930,Staff,0,26,35,35
1683368770219,MUS 15,A01,186932,Staff,0,16,35,35
1683368770219,MUS 15,B01,186934,Staff,0,15,35,35
1683368771243,MUS 80,A00,186935,Staff,0,0,20,20
1683368771243,MUS 80,B00,186936,Staff,25,0,25,0
1683368772266,NANO 11,A00,204702,Lipomi; Darren John,0,0,0,0
1683368773292,NANO 15,A01,204709,Yang; Kesong,0,1,0,0
1683368774318,NANO 114,A00,202069,Jahed Motlagh; Zeinab,3,0,10,7
1683368775349,PHIL 1,A00,186955,Grush; Rick Scott,32,0,40,8
1683368776377,PHIL 10,A01,186973,Grush; Rick Scott,28,0,35,7
1683368776377,PHIL 10,A02,186974,Grush; Rick Scott,33,0,35,2
1683368777405,PHIL 13,A01,186976,Staff,7,0,35,28
1683368777405,PHIL 13,A02,186977,Staff,16,0,35,19
1683368778434,PHIL 14,A01,186979,Staff,31,0,35,4
1683368778434,PHIL 14,A02,186986,Staff,32,0,35,3
1683368779460,PHIL 28,A01,186988,Staff,16,0,30,14
1683368779460,PHIL 28,A02,186989,Staff,1,0,30,29
1683368779460,PHIL 28,A03,186990,Staff,9,0,30,21
1683368779460,PHIL 28,A04,186991,Staff,26,0,30,4
1683368780487,PHIL 120,A00,186997,Staff,23,0,40,17
1683368781514,PHIL 137,A00,187003,Staff,9,0,40,31
1683368782539,PHIL 150,A00,187015,Staff,47,0,70,23
1683368783568,PHIL 167,A00,187021,Lamey; Andy M.,35,0,40,5
1683368784596,PHIL 174,A01,202226,Staff,17,0,20,3
1683368784596,PHIL 174,A02,202235,Staff,20,0,20,0
1683368785620,PHIL 191A,A00,258918,Staff,0,0,1,1
1683368786643,PHYS 1A,A00,187028,Staff,27,0,60,33
1683368787670,PHYS 1AL,001,187036,Staff,2,0,30,28
1683368787670,PHYS 1AL,002,187049,Staff,18,0,30,12
1683368788697,PHYS 1B,A00,187058,Staff,22,0,60,38
1683368789722,PHYS 1BL,001,187064,Staff,0,0,30,30
1683368789722,PHYS 1BL,002,187070,Staff,5,0,30,25
1683368790748,PHYS 1C,A00,187082,Staff,31,0,120,89
1683368791776,PHYS 1CL,001,187088,Staff,0,9,30,30
1683368791776,PHYS 1CL,002,187089,Staff,0,2,30,30
1683368791776,PHYS 1CL,009,262693,Staff,11,0,30,19
1683368792803,PHYS 2B,A01,187097,Staff,54,0,115,61
1683368793830,PHYS 2C,A01,187099,Staff,67,0,115,48
1683368794857,PHYS 2CL,A01,187101,Staff,5,0,28,23
1683368794857,PHYS 2CL,A02,187102,Staff,15,0,28,13
1683368795885,PHYS 2D,A01,187123,Shotwell; Brian,95,0,115,20
1683368796915,PHYS 4B,A01,187133,Grinstein; Benjamin,35,0,50,15
1683368797940,POLI 10,A00,188819,Staff,0,4,50,50
1683368798963,POLI 11,A00,188827,Staff,43,0,50,7
1683368799987,POLI 13R,A00,188828,Staff,0,1,20,20
1683368801012,POLI 27,A01,188830,Elgin; Samuel Zincke,0,1,70,70
1683368802037,POLI 30,A00,188832,Desposato; Scott,31,0,50,19
1683368803065,POLI 102F,A00,188834,Staff,2,0,40,38
1683368804091,POLI 104A,A00,188852,Staff,14,0,30,16
1683368805118,POLI 104I,A00,188853,Staff,0,6,20,20
1683368806144,POLI 110B,A00,188854,Wiens; David,7,0,20,13
1683368807168,POLI 112A,A00,188855,Wiens; David,5,0,30,25
1683368808192,POLI 117R,A00,188856,Forman; Fonna,0,11,20,20
1683368809216,POLI 118,A00,188857,Ingham; Sean,8,0,20,12
1683368810241,POLI 120G,A00,188858,Staff,9,0,30,21
1683368811266,POLI 131CR,A00,188863,Hoston; Germaine,23,0,50,27
1683368812294,POLI 133,A00,188864,Nellis; Gareth Hb,44,0,50,6
1683368813319,POLI 134D,A00,188865,Desposato; Scott,27,0,30,3
1683368814347,POLI 142A,A00,188871,Gartzke; Erik,22,0,50,28
1683368815374,POLI 142K,A00,188874,Staff,38,0,50,12
1683368816401,POLI 143,A00,188940,Gartzke; Erik,16,0,30,14
1683368817426,POLI 153,A00,188943,Staff,3,0,20,17
1683368818450,POLI 160AA,A00,188944,Staff,11,0,40,29
1683368819475,POLI 170A,A00,188945,Staff,11,0,30,19
1683368821526,PSYC 1,A00,188952,Staff,37,0,90,53
1683368822554,PSYC 2,B00,188953,Staff,19,0,35,16
1683368823580,PSYC 6,A00,188970,Staff,47,0,60,13
1683368824607,PSYC 7,A00,188973,Staff,37,0,45,8
1683368825635,PSYC 60,A01,188980,Rickard; Timothy C.,43,0,60,17
1683368826659,PSYC 70,A01,189001,Steiner; Eric Tomas,23,0,45,22
1683368827683,PSYC 100,A00,189005,Lacefield; Katharine I,0,98,120,120
1683368828707,PSYC 102,A00,189008,Staff,9,0,30,21
1683368829732,PSYC 106,B00,189026,Gorman; Michael R.,34,0,60,26
1683368830756,PSYC 114,B01,189033,Winkielman; Piotr,0,32,30,30
1683368831780,PSYC 131,A00,189036,Anagnostaras; Stephan,0,43,60,60
1683368832806,PSYC 136,A00,189041,Lowe; Angela Beth,0,7,25,25
1683368833834,PSYC 137,A00,189057,Winkielman; Piotr,0,34,25,25
1683368834859,PSYC 144,A00,189107,Wixted; John T,0,7,50,50
1683368836909,PSYC 162,A00,189142,Staff,0,8,85,85
1683368837933,PSYC 172,A00,189144,Gorman; Michael R.,0,7,30,30
1683368839983,PSYC 179,A00,189146,Lacefield; Katharine I,0,84,120,120
1683368841008,PSYC 181,A00,189147,Anagnostaras; Stephan,0,44,90,90
1683368842033,PSYC 190R,A00,189148,Barner; David A.,0,22,80,80
1683368843059,PSYC 191,A00,189275,Rickard; Timothy C.,0,7,25,25
1683368844085,PSYC 193,A00,189276,Chapman; Eddie Nathaniel,0,1,0,4
1683368845111,PSYC 193L,A01,189281,Lowe; Angela Beth,12,0,20,8
1683368845111,PSYC 193L,B01,189285,Staff,28,0,35,7
1683368846135,RELI 149,A00,187137,Rahimi; Babak,7,0,40,33
1683368847160,SE 9,A01,187315,Staff,0,2,18,18
1683368848184,SE 101B,A00,187409,Staff,24,0,30,6
1683368849210,SE 110B,A00,187444,Staff,10,0,40,30
1683368850236,SE 130B,A00,187449,Staff,31,0,40,9
1683368851265,SE 150A,A00,187516,Staff,9,0,20,11
1683368852293,SE 154,A00,187528,Staff,30,0,50,20
1683368853318,SIO 3,A01,258171,Staff,35,0,40,5
1683368854344,SIO 10,A00,187144,Cook; Geoffrey W,0,3,75,75
1683368855369,SIO 45,A00,187152,Cook; Geoffrey W,1,0,100,99
1683368856394,SIO 109R,A00,194486,Staff,0,3,20,20
1683368858525,SIO 187,A01,187233,Kacev; David,12,0,40,28
1683368859553,SOCI 1,A01,258656,Thorpe; Charles Robert,28,0,30,2
1683368859553,SOCI 1,A02,258658,Thorpe; Charles Robert,30,0,30,0
1683368859553,SOCI 1,A03,258661,Thorpe; Charles Robert,25,0,25,0
1683368859553,SOCI 1,A04,258666,Thorpe; Charles Robert,22,0,25,3
1683368859553,SOCI 1,A05,258897,Thorpe; Charles Robert,23,0,25,2
1683368859553,SOCI 1,A06,258898,Thorpe; Charles Robert,25,0,25,0
1683368860583,SOCI 30,A01,258903,Pardo Guerra; Juan Pablo,15,0,30,15
1683368861612,SOCI 102,A00,258904,Staff,9,0,25,16
1683368862637,SOCI 106,A00,258905,Staff,19,0,25,6
1683368863663,SOCI 111,A00,258907,Ribas Norris; Janet Vanesa,26,0,30,4
1683368864689,SOCI 121R,A00,258908,Pardo Guerra; Juan Pablo,10,0,30,20
1683368865713,SOCI 126,A01,203330,Staff,14,0,20,6
1683368866738,SOCI 131,A00,258909,Thorpe; Charles Robert,31,0,60,29
1683368867766,SOCI 135,A00,258910,Payne; Christine Anna,0,9,30,30
1683368868791,SOCI 157,A00,258911,Staff,12,0,30,18
1683368869817,SOCI 184,A00,258912,Staff,25,0,30,5
1683368870842,SOCI 188D,A00,258913,Staff,22,0,30,8
1683368871867,SYN 2,001,187529,Staff,10,0,16,6
1683368871867,SYN 2,002,201452,Staff,0,18,16,16
1683368871867,SYN 2,003,201469,Staff,3,0,16,13
1683368872893,SYN 100,A01,187531,Staff,0,9,20,20
1683368872893,SYN 100,B01,201491,Staff,0,12,20,20
1683368873919,TDAC 1,A00,189286,Walsh; Kim C.,3,0,20,17
1683368873919,TDAC 1,B00,189287,Harting; Carla Kelso,11,0,20,9
1683368874944,TDAC 101,A00,189300,Walsh; Kim C.,16,0,20,4
1683368874944,TDAC 101,B00,189301,Harting; Carla Kelso,18,0,20,2
1683368875973,TDAC 102,A00,189304,Basso; Beatrice,14,0,20,6
1683368876997,TDAC 108,A00,189305,Staff,18,0,20,2
1683368878023,TDDE 131,A00,189310,Staff,19,0,20,1
1683368878023,TDDE 131,B00,189314,Staff,19,0,20,1
1683368878023,TDDE 131,C00,189315,Staff,48,0,50,2
1683368878023,TDDE 131,D00,189316,Staff,14,0,15,1
1683368878023,TDDE 131,E00,204841,Staff,20,0,20,0
1683368879048,TDGE 10,A00,189289,Staff,30,0,50,20
1683368879048,TDGE 10,B00,189290,Havis; Allan,1,0,50,49
1683368880075,TDGE 11,A00,189291,Fulton; Julia,0,3,50,50
1683368880075,TDGE 11,B00,189292,Staff,20,0,25,5
1683368880075,TDGE 11,C00,260270,Staff,0,0,0,0
1683368881105,TDGE 25,A00,189294,Staff,3,0,20,17
1683368882131,TDGE 124,A00,189318,Fulton; Julia,0,8,50,50
1683368883156,TDGE 125,A00,189319,Staff,13,0,25,12
1683368883156,TDGE 125,B00,189320,Staff,23,0,25,2
1683368884182,TDGE 127,A00,189322,Havis; Allan,0,0,50,50
1683368885206,TDHT 101,A00,189323,Staff,18,0,25,7
1683368885206,TDHT 101,B00,189324,Staff,25,0,25,0
1683368886235,TDHT 102,A00,189325,Staff,49,0,50,1
1683368887265,TDMV 1,A00,189295,Arcidiacono; Kristin,19,0,30,11
1683368887265,TDMV 1,B00,189296,Caligagan; Maria T.,24,0,30,6
1683368888296,TDMV 2,A00,189297,Sammartano; Tonnie,28,0,30,2
1683368888296,TDMV 2,B00,189299,Arcidiacono; Kristin,24,0,30,6
1683368889325,TDMV 3,A00,204998,Rincon; Alicia,22,0,30,8
1683368890350,TDMV 120,A00,189458,Sammartano; Tonnie,28,0,30,2
1683368891376,TDMV 138,A00,189541,Jun; Grace Shin Hae,22,0,40,18
1683368892401,TDMV 142,A00,189717,Caligagan; Tony,24,0,30,6
1683368892401,TDMV 142,B00,189718,Caligagan; Maria T.,25,0,30,5
1683368893430,TMC 2,A01,187533,Staff,25,0,25,0
1683368893430,TMC 2,A02,187534,Staff,25,0,25,0
1683368894460,USP 1,A01,187536,Kwak; Nancy,0,16,25,25
1683368895488,USP 5,A01,187538,Staff,10,0,25,15
1683368896512,USP 101,A00,199253,Staff,0,4,0,0
1683368897538,USP 124,A00,187562,Boomhower; Matthew Charles,1,0,30,29
1683368898563,USP 138,A00,187582,Staff,20,0,25,5
1683368899587,USP 152,A01,187597,Staff,4,0,25,21
1683368900614,USP 153,A00,187598,Staff,19,0,25,6
1683368901641,USP 168,A00,187607,Kwak; Nancy,2,0,5,3
1683368902669,USP 173,A00,187619,Staff,4,0,25,21
1683368903695,USP 181,A00,187638,Staff,0,3,25,25
1683368904720,VIS 103,A00,187650,Cruz; Edwin Teddy,22,0,75,53
1683368905744,VIS 110D,A00,187669,Staff,12,0,22,10
1683368906769,VIS 127C,A00,187720,Shen; Kuiyi,67,0,146,79
1683368907795,VIS 149,A00,187731,Yoldas; Pinar,0,14,22,22
1683368908822,VIS 151,A01,188091,Staff,22,0,34,12
1683368908822,VIS 151,A02,188092,Staff,11,0,34,23
1683368909852,VIS 160B,A00,188093,Stalbaum; Brett,0,0,10,10
1683368911902,WCWP 10B,A00,201720,Staff,10,0,15,5
1683368911902,WCWP 10B,B00,201722,Staff,9,0,15,6
1683368912932,WCWP 100,A00,201725,Gagnon; Jeffrey C,0,0,2,2
1683368912932,WCWP 100,B00,201727,Staff,0,4,15,15
1683368916114,ANBI 133,A00,258401,Wilder; Linnea Lorene,34,0,40,6
1683368917140,ANBI 140,A00,258395,Hrvoj Mihic; Branka,18,0,25,7
1683368918166,ANSC 120,A00,258402,Bialecki; Jon Anthony,27,0,40,13
1683368919191,ANSC 144,A00,258400,Staff,14,0,40,26
1683368921243,ANSC 166,A00,258396,Parish; Steven Martin,158,0,175,17
1683368922270,ANSC 180,A00,193533,Staff,9,0,20,11
1683368923298,ANSC 188,A00,258397,Jassal; Aftab,33,0,40,7
1683368924322,ANTH 3,A01,258316,Staff,23,0,30,7
1683368925347,ANTH 5,A00,258394,Semendeferi; Ekaterini,16,0,20,4
1683368926370,ANTH 21,A01,258331,Staff,8,0,40,32
1683368927395,ANTH 103,A00,258398,Varma; Saiba,15,0,25,10
1683368928424,AWP 10,001,202034,Staff,0,0,0,0
1683368928424,AWP 10,002,202035,Staff,0,0,0,0
1683368928424,AWP 10,003,202036,Staff,0,0,0,0
1683368928424,AWP 10,004,202037,Staff,0,0,0,0
1683368928424,AWP 10,005,202038,Staff,0,0,0,0
1683368928424,AWP 10,006,202039,Staff,0,0,0,0
1683368928424,AWP 10,007,202040,Staff,0,0,0,0
1683368928424,AWP 10,008,202041,Staff,0,0,0,0
1683368928424,AWP 10,009,202042,Staff,0,0,0,0
1683368928424,AWP 10,010,202043,Staff,0,0,0,0
1683368928424,AWP 10,011,202044,Staff,0,0,0,0
1683368928424,AWP 10,012,202045,Staff,0,0,0,0
1683368928424,AWP 10,013,202046,Staff,0,0,0,0
1683368928424,AWP 10,014,202047,Staff,0,0,0,0
1683368928424,AWP 10,015,202048,Staff,0,0,0,0
1683368928424,AWP 10,016,202049,Staff,0,0,0,0
1683368928424,AWP 10,017,202050,Staff,0,0,0,0
1683368928424,AWP 10,018,202051,Staff,0,0,0,0
1683368928424,AWP 10,019,202052,Staff,0,0,0,0
1683368928424,AWP 10,020,202053,Staff,0,0,0,0
1683368928424,AWP 10,021,202054,Staff,0,0,0,0
1683368928424,AWP 10,022,202055,Staff,0,0,0,0
1683368928424,AWP 10,023,202056,Staff,0,0,0,0
1683368928424,AWP 10,024,202057,Staff,0,0,0,0
1683368928424,AWP 10,025,202058,Staff,0,0,0,0
1683368928424,AWP 10,026,202059,Staff,0,0,0,0
1683368929451,AWP 102,001,202032,Staff,0,0,0,0
1683368929451,AWP 102,002,202033,Staff,0,0,0,0
1683368930477,BENG 100,A01,254234,Taylor Amos; Alyssa C,31,0,40,9
1683368931506,BENG 196,001,270013,Engler; Adam J.,9999,0,9999,0
1683368932538,BICD 100R,A01,202018,Smith; Laurie,0,7,32,32
1683368932538,BICD 100R,A02,202019,Smith; Laurie,0,2,32,32
1683368932538,BICD 100R,A03,202020,Smith; Laurie,0,1,32,32
1683368932538,BICD 100R,A04,202021,Smith; Laurie,9,0,32,23
1683368932538,BICD 100R,A05,202022,Smith; Laurie,12,0,32,20
1683368933571,BICD 136,A01,193242,Gustafson-Brown; Cindy,0,2,32,32
1683368933571,BICD 136,A02,193244,Gustafson-Brown; Cindy,14,0,32,18
1683368934602,BIEB 102,A01,193249,Butler; Shannon Rhey,0,2,32,32
1683368934602,BIEB 102,A02,193251,Butler; Shannon Rhey,0,0,32,32
1683368934602,BIEB 102,A03,193253,Butler; Shannon Rhey,0,1,32,32
1683368934602,BIEB 102,A04,193255,Butler; Shannon Rhey,17,0,32,15
1683368934602,BIEB 102,A05,193265,Butler; Shannon Rhey,26,0,32,6
1683368934602,BIEB 102,A06,193269,Butler; Shannon Rhey,16,0,32,16
1683368936653,BIEB 150,A01,193274,Staff,0,0,32,32
1683368936653,BIEB 150,A02,193285,Staff,23,0,32,9
1683368937679,BIEB 194,A00,193286,Kurle; Carolyn M.,22,0,32,10
1683368938730,BILD 1,A01,192291,Staff,16,0,32,16
1683368938730,BILD 1,A02,192292,Staff,30,0,32,2
1683368938730,BILD 1,B01,192520,Reuther; Keefe,0,1,0,0
1683368938730,BILD 1,B02,192532,Reuther; Keefe,0,1,0,0
1683368939757,BILD 3,A01,192556,Butler; Shannon Rhey,0,0,32,32
1683368939757,BILD 3,A02,192581,Butler; Shannon Rhey,4,0,32,28
1683368939757,BILD 3,A03,192611,Butler; Shannon Rhey,23,0,32,9
1683368939757,BILD 3,A04,192612,Butler; Shannon Rhey,25,0,32,7
1683368939757,BILD 3,A05,192613,Butler; Shannon Rhey,27,0,32,5
1683368939757,BILD 3,A06,192679,Butler; Shannon Rhey,27,0,32,5
1683368939757,BILD 3,A07,192682,Butler; Shannon Rhey,21,0,32,11
1683368940782,BILD 4,A01,192836,Reuther; Keefe,0,0,24,24
1683368940782,BILD 4,A02,193044,Reuther; Keefe,4,0,24,20
1683368941808,BILD 10,A01,193142,Gustafson-Brown; Cindy,30,0,32,2
1683368941808,BILD 10,A02,193149,Gustafson-Brown; Cindy,31,0,32,1
1683368942837,BIMM 100,A01,193301,Staff,1,6,32,31
1683368942837,BIMM 100,A02,193312,Staff,0,5,32,32
1683368942837,BIMM 100,A03,193323,Staff,0,8,32,32
1683368943869,BIMM 101,A01,193329,McDonnell; Lisa Marie,0,3,24,24
1683368943869,BIMM 101,A02,193339,McDonnell; Lisa Marie,0,3,24,24
1683368943869,BIMM 101,B01,193354,McDonnell; Lisa Marie,0,3,24,24
1683368943869,BIMM 101,B02,193357,McDonnell; Lisa Marie,0,3,24,24
1683368944900,BIMM 110,A01,193377,Tat; John,0,11,32,32
1683368944900,BIMM 110,A02,193378,Tat; John,0,9,32,32
1683368945927,BIMM 120,A01,206116,Staff,0,0,32,32
1683368945927,BIMM 120,A02,206117,Staff,8,0,32,24
1683368945927,BIMM 120,A03,206121,Staff,21,0,32,11
1683368946952,BIPN 100,A01,193393,Park; Ji Young,0,14,32,32
1683368946952,BIPN 100,A02,193402,Park; Ji Young,0,13,32,32
1683368946952,BIPN 100,A03,193413,Park; Ji Young,0,14,32,32
1683368946952,BIPN 100,A04,193414,Park; Ji Young,0,13,32,32
1683368947976,BIPN 102,A01,193429,Staff,0,0,32,32
1683368947976,BIPN 102,A02,193438,Staff,22,0,32,10
1683368949002,BIPN 106,A01,193450,Reyes Gonzalez; Catalina,0,2,40,40
1683368950026,BIPN 134,A01,193465,Cooke; James Edward,1,0,32,31
1683368950026,BIPN 134,A02,193474,Cooke; James Edward,25,0,32,7
1683368950026,BIPN 134,A03,193485,Cooke; James Edward,29,0,32,3
1683368950026,BIPN 134,A04,193486,Cooke; James Edward,21,0,32,11
1683368950026,BIPN 134,A05,193491,Cooke; James Edward,31,0,32,1
1683368950026,BIPN 134,A06,193501,Cooke; James Edward,30,0,32,2
1683368950026,BIPN 134,A07,193510,Cooke; James Edward,29,0,32,3
1683368952074,BISP 194,A00,222522,Staff,14,0,32,18
1683368953098,CAT 124,A01,202407,Staff,19,0,25,6
1683368954128,CAT 125,A00,202408,Marchisotto; Jennifer Anne,4,0,20,16
1683368955168,CAT 125R,A00,202409,Smith; Lauryn Alissa,0,11,20,20
1683368955168,CAT 125R,B00,202410,Morales; Celeste Georgianna,0,11,20,20
1683368955168,CAT 125R,C00,202411,Irwin; Matthew Joseph,0,10,20,20
1683368956196,CENG 15,A01,204712,Yang; Kesong,0,1,0,0
1683368957220,CENG 114,A00,202070,Jahed Motlagh; Zeinab,5,0,20,15
1683368958246,CGS 105,A00,185477,Wesling; Megan E.,24,0,40,16
1683368959271,CGS 106,A00,185494,Staff,13,0,22,9
1683368960298,CGS 108,A00,185495,Staff,14,0,20,6
1683368961398,CGS 114,A00,185496,Staff,13,0,18,5
1683368962425,CGS 119,A00,185501,Staff,15,0,20,5
1683368963452,CGS 120,A00,185511,Staff,13,0,20,7
1683368964484,CHEM 4,A01,184675,Bussey; Thomas J,96,0,100,4
1683368965510,CHEM 6A,A01,184677,Staff,34,0,60,26
1683368966536,CHEM 6B,A01,184679,Staff,65,0,100,35
1683368967562,CHEM 6C,A01,184681,Bussey; Thomas J,1,0,50,49
1683368967562,CHEM 6C,A02,184682,Bussey; Thomas J,34,0,50,16
1683368968588,CHEM 40A,A01,184684,Albizati; Kim F.,37,0,100,63
1683368969613,CHEM 40B,A01,184686,Albizati; Kim F.,0,20,100,100
1683368970643,CHEM 41B,A01,184690,Staff,52,0,100,48
1683368971668,COGS 3,A01,184715,Boyle; Mary E. T.,0,25,40,40
1683368972692,COGS 14B,A01,185172,Staff,0,15,38,38
1683368973716,COGS 18,A01,184736,Staff,16,0,80,64
1683368974740,COGS 100,A01,184932,Staff,0,5,73,73
1683368975764,COGS 101A,A01,184935,Staff,0,39,30,30
1683368976789,COGS 101B,A01,184944,Staff,0,2,30,30
1683368977819,COGS 101C,A01,184946,Staff,0,12,30,30
1683368978847,COGS 102A,A01,184951,Johnson; Christine M.,2,0,40,38
1683368979873,COGS 107B,A01,184953,Mooshagian; Eric Frederick,0,50,40,40
1683368980898,COGS 118B,A01,184959,Gupta; Anjum,0,48,40,40
1683368981922,COGS 153,A00,184961,Staff,0,15,30,30
1683368982948,COGS 177,A00,184962,Staff,0,20,30,30
1683368983971,COGS 187A,A01,184969,Boyle; Mary E. T.,0,17,40,40
1683368984996,COMM 10,A01,185174,Staff,0,5,25,25
1683368984996,COMM 10,A02,185189,Staff,0,5,25,25
1683368984996,COMM 10,A03,269821,Staff,0,0,0,0
1683368986025,COMM 100B,A01,185475,Staff,0,0,0,2
1683368986025,COMM 100B,A02,185476,Staff,13,0,25,12
1683368987055,COMM 100C,A01,185314,Staff,1,0,25,24
1683368987055,COMM 100C,A02,185327,Staff,19,0,25,6
1683368988082,COMM 110M,A00,185349,Staff,2,0,40,38
1683368989108,COMM 113T,A00,185352,Staff,24,0,40,16
1683368990135,COMM 114I,A00,185353,Staff,33,0,40,7
1683368991163,COMM 131,A00,185354,Staff,19,0,30,11
1683368992193,CSE 8A,A50,185358,Cao; Yingjun,0,46,10,10
1683368993221,CSE 8B,A01,185362,Staff,0,46,50,50
1683368994251,CSE 11,A01,185416,Cao; Yingjun,0,92,10,10
1683368995275,CSE 20,A01,185445,Briones; Jor-el Thomas Caparas,5,0,25,20
1683368996299,CSE 21,A01,185447,Staff,10,0,50,40
1683368997326,CSE 101,A01,185451,Staff,0,13,50,50
1683368997326,CSE 101,B01,185453,Jones; Miles E,0,11,50,50
1683368999378,CSE 141,A01,185458,Eldon; John,20,0,100,80
1683369000408,CSE 141L,A01,185461,Eldon; John,12,0,100,88
1683369001436,CSE 142,A01,185463,Staff,36,0,60,24
1683369001436,CSE 142,B01,201355,Staff,0,7,60,60
1683369002463,CSE 142L,A01,185470,Staff,36,0,60,24
1683369002463,CSE 142L,B01,201417,Staff,0,6,60,60
1683369003491,CSE 190,A00,201433,Staff,32,0,49,17
1683369004517,DOC 1,A01,259136,Strom; Megan C.,7,0,15,8
1683369004517,DOC 1,A02,259137,Strom; Megan C.,14,0,15,1
1683369004517,DOC 1,A03,259138,Strom; Megan C.,14,0,15,1
1683369004517,DOC 1,A04,259139,Strom; Megan C.,14,0,15,1
1683369005542,DOC 100D,A00,259140,Pass; Natalye Joann,16,0,25,9
1683369006566,DSGN 1,A01,184749,Rill; Bryan,0,25,30,30
1683369007588,DSGN 100,A01,185168,Staff,0,2,25,25
1683369008612,ECE 5,A01,185626,Morris; Karcher William,0,10,0,0
1683369009640,ECE 101,A01,185628,Staff,17,0,70,53
1683369010664,ECE 107,A01,185635,Baghdadchi; Saharnaz,0,0,20,20
1683369010664,ECE 107,A02,185638,Baghdadchi; Saharnaz,4,0,20,16
1683369011696,ECE 148,A01,185647,Silberman; Jack,0,0,16,16
1683369012722,ECON 1,A01,185537,Crane; Meredith Helen,54,0,70,16
1683369013745,ECON 3,A01,185549,Crane; Meredith Helen,32,0,70,38
1683369014772,ECON 4,A01,203354,Anderson; John Charles,0,4,10,10
1683369015795,ECON 100A,A01,185574,Staff,0,4,40,40
1683369016820,ECON 100B,A01,185576,Staff,0,12,50,50
1683369017848,ECON 100C,A01,185589,Newhouse; Herbert S,29,0,70,41
1683369018876,ECON 105,A00,185608,Vespa; Emanuel Ignacio,19,0,35,16
1683369019905,ECON 109,A01,185610,Shishkin; Denis,10,0,35,25
1683369020930,ECON 110A,A01,185612,Staff,11,0,40,29
1683369021953,ECON 120A,A01,185615,Staff,20,0,40,20
1683369022977,ECON 120C,A01,185617,Sun; Yixiao,0,21,70,70
1683369024004,ECON 144,A00,203346,Squires; Dale E,3,0,35,32
1683369025029,ECON 171,A01,203349,Newhouse; Herbert S,0,1,35,35
1683369026054,ECON 173A,A01,185621,Toda; Alexis Akira,21,0,35,14
1683369027086,EDS 25,A01,202413,Staff,0,1,0,0
1683369027086,EDS 25,A02,202414,Staff,0,1,0,0
1683369027086,EDS 25,A03,202415,Staff,0,0,0,0
1683369027086,EDS 25,A04,202416,Staff,0,1,0,0
1683369027086,EDS 25,A05,202439,Staff,0,0,0,0
1683369027086,EDS 25,A06,202440,Staff,0,0,0,0
1683369027086,EDS 25,B01,202631,Staff,0,0,0,0
1683369027086,EDS 25,B02,202632,Staff,0,0,0,0
1683369027086,EDS 25,B03,202639,Staff,0,0,0,0
1683369027086,EDS 25,B04,202640,Staff,0,0,0,0
1683369027086,EDS 25,B05,202643,Staff,0,0,0,0
1683369027086,EDS 25,B06,202644,Staff,0,0,0,0
1683369028111,EDS 38,A01,202659,Black; Alison Michelle,24,0,25,1
1683369029137,EDS 115,A00,202652,Staff,18,0,30,12
1683369030162,EDS 125,A00,202649,Staff,14,0,30,16
1683369031188,EDS 126,A01,203332,Staff,30,0,30,0
1683369032212,EDS 139,A00,202838,Staff,16,0,25,9
1683369033236,EDS 146,A01,202655,Staff,14,0,25,11
1683369034262,ENG 15,A00,185667,Staff,0,1,0,0
1683369034262,ENG 15,B00,185672,Staff,0,0,0,0
1683369034262,ENG 15,C00,185675,Staff,0,0,0,0
1683369034262,ENG 15,D00,185682,Staff,0,0,0,0
1683369034262,ENG 15,E00,185684,Staff,0,0,0,0
1683369035284,ETHN 103,A00,185710,Staff,0,4,35,35
1683369036314,ETHN 103A,A00,199228,Man; Simeon S,2,0,9,7
1683369037341,ETHN 109,A00,185711,Staff,18,0,35,17
1683369038368,ETHN 142,A00,185726,Staff,0,4,30,30
1683369039390,ETHN 163J,A00,199229,Man; Simeon S,5,0,8,3
1683369040414,ETHN 168,A00,185727,Staff,8,0,10,2
1683369041438,ETHN 182,A00,185728,Staff,0,0,35,35
1683369042463,ETHN 183,A00,185737,Staff,8,0,18,10
1683369043487,GLBH 111,A01,209361,Burgos; Jose L.,0,0,0,0
1683369045539,HIEU 104,A00,185792,Staff,16,0,20,4
1683369046563,HIEU 115,A00,185800,Staff,1,0,20,19
1683369047590,HIEU 128,A00,185801,Staff,0,7,20,20
1683369048618,HIEU 147,A00,185802,Staff,16,0,20,4
1683369049644,HIEU 154,A00,185823,Staff,12,0,20,8
1683369050671,HILA 102,A00,185826,Staff,13,0,20,7
1683369051697,HILD 2C,A01,185778,Staff,0,12,20,20
1683369052722,HILD 7B,A01,185780,Kwak; Nancy,0,15,32,32
1683369052722,HILD 7B,A02,185781,Kwak; Nancy,0,18,32,32
1683369053749,HILD 30,A01,185791,Staff,14,0,20,6
1683369054776,HISC 119,A00,185830,Golan; Tal,0,9,20,20
1683369055800,HITO 156GS,A00,185831,Patterson; Patrick H.,0,0,0,23
1683369056826,HIUS 103,A00,185832,Man; Simeon S,1,6,20,19
1683369057851,HIUS 117,A00,185836,Kwak; Nancy,2,0,20,18
1683369058876,HIUS 125,A00,185840,Man; Simeon S,0,0,23,23
1683369059900,HIUS 149,A00,185845,Staff,0,0,20,20
1683369060925,HUM 3,A01,185882,Zavodny; Tatiana Sophia,0,7,50,50
1683369060925,HUM 3,B01,185899,Caldwell; Michael Alan,0,18,50,50
1683369061947,HUM 3GS,A00,185900,Patterson; Patrick H.,0,0,0,23
1683369062974,HUM 4,A01,185938,Zroka; Amy Liane,31,0,50,19
1683369062974,HUM 4,B01,185956,Watkins; Eric,0,3,50,50
1683369062974,HUM 4,B02,202209,Watkins; Eric,0,2,50,50
1683369062974,HUM 4,B03,202210,Watkins; Eric,0,2,50,50
1683369064000,HUM 5,A01,185958,West; Geoffrey Scott,3,0,50,47
1683369064000,HUM 5,A02,202215,West; Geoffrey Scott,0,0,50,50
1683369065086,INTL 190,A00,185959,Gagnon; Jeffrey C,0,0,0,9
1683369065086,INTL 190,B00,185960,Lettieri; Michael Joseph,0,0,0,1
1683369066116,JAPN 180,A00,254509,Staff,4,0,30,26
1683369067145,LATI 10,A01,202853,Kennemore; Amy Michelle,4,0,35,31
1683369067145,LATI 10,A02,202854,Kennemore; Amy Michelle,2,0,35,33
1683369067145,LATI 10,A03,270054,Kennemore; Amy Michelle,30,0,30,0
1683369068170,LATI 180,A00,202855,Kennemore; Amy Michelle,11,0,20,9
1683369069194,LAWS 101,A00,201767,Golan; Tal,0,7,40,40
1683369070222,LIFR 1C,A00,185961,Staff,6,0,20,14
1683369071250,LIFR 1CX,A00,185962,Staff,7,0,20,13
1683369072278,LIFR 1D,A00,185963,Staff,9,0,20,11
1683369073302,LIFR 1DX,A00,185964,Staff,9,0,20,11
1683369074326,LIGN 101,A01,186039,Staff,43,0,50,7
1683369075350,LIGN 165,A00,186040,Staff,18,0,50,32
1683369076374,LTCS 108,A00,186041,Staff,6,0,10,4
1683369077398,LTCS 119,A00,186042,Staff,16,0,20,4
1683369078422,LTCS 130,A00,186043,Wesling; Megan E.,15,0,25,10
1683369080472,LTEA 138,A00,186119,Staff,14,0,40,26
1683369081496,LTEN 124,A00,186148,Staff,6,0,25,19
1683369082523,LTEN 178,A00,186149,Staff,7,0,15,8
1683369083548,LTEN 181,A00,186150,Blanco; John D,33,0,40,7
1683369084572,LTWL 120,A00,186160,Staff,20,0,25,5
1683369085601,LTWL 165,A00,186161,Staff,22,0,25,3
1683369086627,LTWR 100,A00,186162,Staff,0,5,15,15
1683369087655,LTWR 102,A00,186163,Doller; Ben,5,0,15,10
1683369088682,MAE 8,A01,186412,Staff,0,0,0,0
1683369089709,MAE 30B,A00,186445,Bahadori; Mohammad Yousef,83,0,100,17
1683369090736,MAE 40,A00,186592,Bewley; Thomas R,10,0,50,40
1683369091765,MAE 101B,A00,186593,Bahadori; Mohammad Yousef,81,0,100,19
1683369092793,MAE 105,A00,186594,Bandaru; Prabhakar,12,0,50,38
1683369093818,MAE 107,A00,186599,Pham; Hieu Tan,0,7,120,120
1683369094842,MAE 148,A01,186660,Silberman; Jack,3,0,16,13
1683369095866,MATH 10A,A01,188095,Staff,0,5,35,35
1683369096892,MATH 10B,A01,188097,Bowers; Adam R.,0,11,30,30
1683369096892,MATH 10B,A02,188099,Bowers; Adam R.,0,11,30,30
1683369096892,MATH 10B,B01,188104,Bowers; Adam R.,0,10,30,30
1683369096892,MATH 10B,B02,188106,Bowers; Adam R.,0,10,30,30
1683369097918,MATH 10C,A01,188111,Staff,0,18,30,30
1683369097918,MATH 10C,A02,188127,Staff,0,17,30,30
1683369097918,MATH 10C,A03,188131,Staff,0,18,30,30
1683369097918,MATH 10C,B01,188218,Staff,18,0,30,12
1683369097918,MATH 10C,B02,188244,Staff,13,0,30,17
1683369097918,MATH 10C,B03,188277,Staff,16,0,30,14
1683369098943,MATH 18,A01,188344,Bach; Quang Tran,18,0,30,12
1683369098943,MATH 18,A02,188345,Bach; Quang Tran,11,0,30,19
1683369098943,MATH 18,B01,188353,Bach; Quang Tran,10,0,30,20
1683369098943,MATH 18,B02,188354,Bach; Quang Tran,20,0,30,10
1683369099967,MATH 20A,A01,188374,Staff,12,0,35,23
1683369100996,MATH 20B,A01,188382,Ohm; Ko Woon,6,0,30,24
1683369100996,MATH 20B,A02,188383,Ohm; Ko Woon,21,0,30,9
1683369100996,MATH 20B,B01,188385,Ohm; Ko Woon,7,0,30,23
1683369100996,MATH 20B,B02,188392,Ohm; Ko Woon,22,0,30,8
1683369102020,MATH 20C,A01,188394,Harel; Guershon,10,0,30,20
1683369102020,MATH 20C,A02,188395,Harel; Guershon,15,0,30,15
1683369102020,MATH 20C,B01,188404,Harel; Guershon,4,0,30,26
1683369102020,MATH 20C,B02,188405,Harel; Guershon,19,0,30,11
1683369103049,MATH 20D,A01,188414,Hammock; Frances H,0,1,30,30
1683369103049,MATH 20D,A02,188415,Hammock; Frances H,3,0,30,27
1683369103049,MATH 20D,B01,188447,Hammock; Frances H,1,0,30,29
1683369103049,MATH 20D,B02,188486,Hammock; Frances H,8,0,30,22
1683369104077,MATH 20E,A01,188649,Staff,21,0,30,9
1683369104077,MATH 20E,A02,188650,Staff,23,0,30,7
1683369104077,MATH 20E,A03,188673,Staff,0,0,30,30
1683369105105,MATH 102,A01,188675,Staff,0,35,35,35
1683369106133,MATH 103B,A01,188681,Staff,3,0,35,32
1683369106133,MATH 103B,B01,188692,Staff,5,0,35,30
1683369107157,MATH 109,A01,188695,Salehi Golsefidy; Alireza,25,0,35,10
1683369107157,MATH 109,A02,188696,Salehi Golsefidy; Alireza,25,0,35,10
1683369108186,MATH 120A,A01,188698,Eggers; John Dietrich,7,0,35,28
1683369109214,MATH 142B,A01,188736,Ioana; Adrian,0,2,30,30
1683369109214,MATH 142B,A02,188741,Ioana; Adrian,0,0,30,30
1683369109214,MATH 142B,A03,188743,Ioana; Adrian,0,1,30,30
1683369110242,MATH 168A,A01,188790,Staff,0,9,35,35
1683369111272,MATH 170A,A01,188803,Nie; Jiawang,0,2,35,35
1683369111272,MATH 170A,A02,188811,Nie; Jiawang,0,0,35,35
1683369111272,MATH 170A,A03,188814,Nie; Jiawang,1,0,35,34
1683369111272,MATH 170A,A04,188815,Nie; Jiawang,13,0,35,22
1683369112300,MATH 193B,A01,188817,Staff,0,0,35,35
1683369112300,MATH 193B,A02,188818,Staff,5,0,35,30
1683369113330,MGT 4,A01,202857,Anderson; John Charles,61,0,80,19
1683369114360,MGT 12,A00,202858,Lindenberger; Wade Douglas,41,0,90,49
1683369115383,MGT 18,A00,202859,Staff,74,0,90,16
1683369116408,MGT 18GS,A00,202860,McKay; Michael J,13,0,28,15
1683369117433,MGT 45,A00,202861,Pecore; Joseph P.,15,0,90,75
1683369118459,MGT 100,A00,202863,Yavorsky; Daniel Ryan,28,0,90,62
1683369119484,MGT 103,A00,202864,Ehrich; Kristine R,0,17,90,90
1683369120508,MGT 112,A00,202865,Ehrich; Kristine R,15,0,90,75
1683369121533,MGT 121A,A00,202868,Staff,0,20,0,0
1683369122558,MGT 131B,A00,202869,Anderson; John Charles,59,0,90,31
1683369123585,MGT 136,A00,202871,Lindenberger; Wade Douglas,84,0,90,6
1683369124614,MGT 164,A00,202873,Staff,0,68,90,91
1683369125640,MGT 164GS,A00,202874,McKay; Mary A,13,0,28,15
1683369126667,MGT 180,A00,202875,Staff,0,50,90,91
1683369127695,MMW 11R,A01,205019,Herbst; Matthew,3,0,30,27
1683369127695,MMW 11R,A02,205026,Herbst; Matthew,29,0,30,1
1683369128720,MMW 15,A01,193512,Chang; Edmond Yi-Teh,0,9,28,28
1683369128720,MMW 15,A02,193513,Chang; Edmond Yi-Teh,0,5,28,28
1683369128720,MMW 15,A03,193514,Chang; Edmond Yi-Teh,0,5,28,28
1683369128720,MMW 15,A04,193515,Chang; Edmond Yi-Teh,0,5,28,28
1683369128720,MMW 15,A05,193516,Chang; Edmond Yi-Teh,0,4,28,28
1683369128720,MMW 15,A06,193517,Chang; Edmond Yi-Teh,0,5,28,28
1683369128720,MMW 15,B01,193519,Chang; Edmond Yi-Teh,0,5,28,28
1683369128720,MMW 15,B02,193520,Chang; Edmond Yi-Teh,0,5,28,28
1683369128720,MMW 15,B03,193521,Chang; Edmond Yi-Teh,0,5,28,28
1683369128720,MMW 15,B04,193522,Chang; Edmond Yi-Teh,0,4,28,28
1683369128720,MMW 15,B05,193523,Chang; Edmond Yi-Teh,0,5,28,28
1683369128720,MMW 15,B06,193524,Chang; Edmond Yi-Teh,0,4,28,28
1683369129751,MMW 122,A01,193526,Rahimi; Babak,0,15,28,28
1683369129751,MMW 122,A02,193527,Rahimi; Babak,0,14,28,28
1683369129751,MMW 122,A03,193528,Rahimi; Babak,0,0,0,0
1683369129751,MMW 122,A04,193529,Rahimi; Babak,0,0,0,0
1683369130781,MUS 1A,A01,186663,Staff,0,20,35,35
1683369131806,MUS 4,A01,186715,Staff,0,12,35,35
1683369132830,MUS 5R,A01,186796,Dubnov; Shlomo,0,17,35,35
1683369133854,MUS 6,A01,186798,Staff,0,4,25,25
1683369134879,MUS 7,A01,186830,Staff,13,0,35,22
1683369135904,MUS 8,A01,186930,Staff,0,26,35,35
1683369136933,MUS 15,A01,186932,Staff,0,16,35,35
1683369136933,MUS 15,B01,186934,Staff,0,15,35,35
1683369137962,MUS 80,A00,186935,Staff,0,0,20,20
1683369137962,MUS 80,B00,186936,Staff,25,0,25,0
1683369138992,NANO 11,A00,204702,Lipomi; Darren John,0,0,0,0
1683369140020,NANO 15,A01,204709,Yang; Kesong,0,1,0,0
1683369141044,NANO 114,A00,202069,Jahed Motlagh; Zeinab,3,0,10,7
1683369142069,PHIL 1,A00,186955,Grush; Rick Scott,32,0,40,8
1683369143094,PHIL 10,A01,186973,Grush; Rick Scott,28,0,35,7
1683369143094,PHIL 10,A02,186974,Grush; Rick Scott,33,0,35,2
1683369144123,PHIL 13,A01,186976,Staff,7,0,35,28
1683369144123,PHIL 13,A02,186977,Staff,16,0,35,19
1683369145150,PHIL 14,A01,186979,Staff,31,0,35,4
1683369145150,PHIL 14,A02,186986,Staff,32,0,35,3
1683369146182,PHIL 28,A01,186988,Staff,16,0,30,14
1683369146182,PHIL 28,A02,186989,Staff,1,0,30,29
1683369146182,PHIL 28,A03,186990,Staff,9,0,30,21
1683369146182,PHIL 28,A04,186991,Staff,26,0,30,4
1683369147207,PHIL 120,A00,186997,Staff,23,0,40,17
1683369148229,PHIL 137,A00,187003,Staff,9,0,40,31
1683369149254,PHIL 150,A00,187015,Staff,47,0,70,23
1683369150280,PHIL 167,A00,187021,Lamey; Andy M.,35,0,40,5
1683369151304,PHIL 174,A01,202226,Staff,17,0,20,3
1683369151304,PHIL 174,A02,202235,Staff,20,0,20,0
1683369152330,PHIL 191A,A00,258918,Staff,0,0,1,1
1683369153356,PHYS 1A,A00,187028,Staff,27,0,60,33
1683369154380,PHYS 1AL,001,187036,Staff,2,0,30,28
1683369154380,PHYS 1AL,002,187049,Staff,18,0,30,12
1683369155406,PHYS 1B,A00,187058,Staff,22,0,60,38
1683369156435,PHYS 1BL,001,187064,Staff,0,0,30,30
1683369156435,PHYS 1BL,002,187070,Staff,5,0,30,25
1683369157463,PHYS 1C,A00,187082,Staff,31,0,120,89
1683369158492,PHYS 1CL,001,187088,Staff,0,9,30,30
1683369158492,PHYS 1CL,002,187089,Staff,0,2,30,30
1683369158492,PHYS 1CL,009,262693,Staff,11,0,30,19
1683369159520,PHYS 2B,A01,187097,Staff,54,0,115,61
1683369160550,PHYS 2C,A01,187099,Staff,67,0,115,48
1683369161575,PHYS 2CL,A01,187101,Staff,5,0,28,23
1683369161575,PHYS 2CL,A02,187102,Staff,15,0,28,13
1683369162601,PHYS 2D,A01,187123,Shotwell; Brian,95,0,115,20
1683369163625,PHYS 4B,A01,187133,Grinstein; Benjamin,35,0,50,15
1683369164651,POLI 10,A00,188819,Staff,0,4,50,50
1683369165675,POLI 11,A00,188827,Staff,43,0,50,7
1683369166703,POLI 13R,A00,188828,Staff,0,1,20,20
1683369167736,POLI 27,A01,188830,Elgin; Samuel Zincke,0,1,70,70
1683369168818,POLI 30,A00,188832,Desposato; Scott,31,0,50,19
1683369169842,POLI 102F,A00,188834,Staff,2,0,40,38
1683369170870,POLI 104A,A00,188852,Staff,14,0,30,16
1683369171894,POLI 104I,A00,188853,Staff,0,6,20,20
1683369172920,POLI 110B,A00,188854,Wiens; David,7,0,20,13
1683369173944,POLI 112A,A00,188855,Wiens; David,5,0,30,25
1683369174968,POLI 117R,A00,188856,Forman; Fonna,0,11,20,20
1683369175994,POLI 118,A00,188857,Ingham; Sean,8,0,20,12
1683369177019,POLI 120G,A00,188858,Staff,9,0,30,21
1683369178044,POLI 131CR,A00,188863,Hoston; Germaine,23,0,50,27
1683369179069,POLI 133,A00,188864,Nellis; Gareth Hb,44,0,50,6
1683369180094,POLI 134D,A00,188865,Desposato; Scott,27,0,30,3
1683369181117,POLI 142A,A00,188871,Gartzke; Erik,22,0,50,28
1683369182145,POLI 142K,A00,188874,Staff,38,0,50,12
1683369183173,POLI 143,A00,188940,Gartzke; Erik,16,0,30,14
1683369184200,POLI 153,A00,188943,Staff,3,0,20,17
1683369185224,POLI 160AA,A00,188944,Staff,11,0,40,29
1683369186247,POLI 170A,A00,188945,Staff,11,0,30,19
1683369188295,PSYC 1,A00,188952,Staff,37,0,90,53
1683369189321,PSYC 2,B00,188953,Staff,19,0,35,16
1683369190345,PSYC 6,A00,188970,Staff,47,0,60,13
1683369191373,PSYC 7,A00,188973,Staff,37,0,45,8
1683369192398,PSYC 60,A01,188980,Rickard; Timothy C.,43,0,60,17
1683369193422,PSYC 70,A01,189001,Steiner; Eric Tomas,23,0,45,22
1683369194447,PSYC 100,A00,189005,Lacefield; Katharine I,0,98,120,120
1683369195474,PSYC 102,A00,189008,Staff,9,0,30,21
1683369196499,PSYC 106,B00,189026,Gorman; Michael R.,34,0,60,26
1683369197527,PSYC 114,B01,189033,Winkielman; Piotr,0,32,30,30
1683369198559,PSYC 131,A00,189036,Anagnostaras; Stephan,0,43,60,60
1683369199586,PSYC 136,A00,189041,Lowe; Angela Beth,0,7,25,25
1683369200614,PSYC 137,A00,189057,Winkielman; Piotr,0,34,25,25
1683369201639,PSYC 144,A00,189107,Wixted; John T,0,7,50,50
1683369203687,PSYC 162,A00,189142,Staff,0,8,85,85
1683369204711,PSYC 172,A00,189144,Gorman; Michael R.,0,7,30,30
1683369206765,PSYC 179,A00,189146,Lacefield; Katharine I,0,84,120,120
1683369207794,PSYC 181,A00,189147,Anagnostaras; Stephan,0,44,90,90
1683369208819,PSYC 190R,A00,189148,Barner; David A.,0,22,80,80
1683369209843,PSYC 191,A00,189275,Rickard; Timothy C.,0,7,25,25
1683369210868,PSYC 193,A00,189276,Chapman; Eddie Nathaniel,0,1,0,4
1683369211893,PSYC 193L,A01,189281,Lowe; Angela Beth,12,0,20,8
1683369211893,PSYC 193L,B01,189285,Staff,28,0,35,7
1683369212917,RELI 149,A00,187137,Rahimi; Babak,7,0,40,33
1683369213942,SE 9,A01,187315,Staff,0,2,18,18
1683369214966,SE 101B,A00,187409,Staff,24,0,30,6
1683369215991,SE 110B,A00,187444,Staff,10,0,40,30
1683369217018,SE 130B,A00,187449,Staff,31,0,40,9
1683369218042,SE 150A,A00,187516,Staff,9,0,20,11
1683369219070,SE 154,A00,187528,Staff,30,0,50,20
1683369220097,SIO 3,A01,258171,Staff,35,0,40,5
1683369221124,SIO 10,A00,187144,Cook; Geoffrey W,0,3,75,75
1683369222151,SIO 45,A00,187152,Cook; Geoffrey W,1,0,100,99
1683369223174,SIO 109R,A00,194486,Staff,0,3,20,20
1683369225222,SIO 187,A01,187233,Kacev; David,12,0,40,28
1683369226245,SOCI 1,A01,258656,Thorpe; Charles Robert,28,0,30,2
1683369226245,SOCI 1,A02,258658,Thorpe; Charles Robert,30,0,30,0
1683369226245,SOCI 1,A03,258661,Thorpe; Charles Robert,25,0,25,0
1683369226245,SOCI 1,A04,258666,Thorpe; Charles Robert,22,0,25,3
1683369226245,SOCI 1,A05,258897,Thorpe; Charles Robert,23,0,25,2
1683369226245,SOCI 1,A06,258898,Thorpe; Charles Robert,25,0,25,0
1683369227270,SOCI 30,A01,258903,Pardo Guerra; Juan Pablo,15,0,30,15
1683369228294,SOCI 102,A00,258904,Staff,9,0,25,16
1683369229321,SOCI 106,A00,258905,Staff,19,0,25,6
1683369230346,SOCI 111,A00,258907,Ribas Norris; Janet Vanesa,26,0,30,4
1683369231373,SOCI 121R,A00,258908,Pardo Guerra; Juan Pablo,10,0,30,20
1683369232402,SOCI 126,A01,203330,Staff,14,0,20,6
1683369233427,SOCI 131,A00,258909,Thorpe; Charles Robert,31,0,60,29
1683369234450,SOCI 135,A00,258910,Payne; Christine Anna,0,9,30,30
1683369235475,SOCI 157,A00,258911,Staff,12,0,30,18
1683369236503,SOCI 184,A00,258912,Staff,25,0,30,5
1683369237530,SOCI 188D,A00,258913,Staff,22,0,30,8
1683369238557,SYN 2,001,187529,Staff,10,0,16,6
1683369238557,SYN 2,002,201452,Staff,0,18,16,16
1683369238557,SYN 2,003,201469,Staff,3,0,16,13
1683369239582,SYN 100,A01,187531,Staff,0,9,20,20
1683369239582,SYN 100,B01,201491,Staff,0,12,20,20
1683369240607,TDAC 1,A00,189286,Walsh; Kim C.,3,0,20,17
1683369240607,TDAC 1,B00,189287,Harting; Carla Kelso,11,0,20,9
1683369241631,TDAC 101,A00,189300,Walsh; Kim C.,16,0,20,4
1683369241631,TDAC 101,B00,189301,Harting; Carla Kelso,18,0,20,2
1683369242655,TDAC 102,A00,189304,Basso; Beatrice,14,0,20,6
1683369243679,TDAC 108,A00,189305,Staff,18,0,20,2
1683369244704,TDDE 131,A00,189310,Staff,19,0,20,1
1683369244704,TDDE 131,B00,189314,Staff,19,0,20,1
1683369244704,TDDE 131,C00,189315,Staff,48,0,50,2
1683369244704,TDDE 131,D00,189316,Staff,14,0,15,1
1683369244704,TDDE 131,E00,204841,Staff,20,0,20,0
1683369245728,TDGE 10,A00,189289,Staff,30,0,50,20
1683369245728,TDGE 10,B00,189290,Havis; Allan,1,0,50,49
1683369246753,TDGE 11,A00,189291,Fulton; Julia,0,3,50,50
1683369246753,TDGE 11,B00,189292,Staff,20,0,25,5
1683369246753,TDGE 11,C00,260270,Staff,0,0,0,0
1683369247778,TDGE 25,A00,189294,Staff,3,0,20,17
1683369248808,TDGE 124,A00,189318,Fulton; Julia,0,8,50,50
1683369249834,TDGE 125,A00,189319,Staff,13,0,25,12
1683369249834,TDGE 125,B00,189320,Staff,23,0,25,2
1683369250862,TDGE 127,A00,189322,Havis; Allan,0,0,50,50
1683369251889,TDHT 101,A00,189323,Staff,18,0,25,7
1683369251889,TDHT 101,B00,189324,Staff,25,0,25,0
1683369252916,TDHT 102,A00,189325,Staff,49,0,50,1
1683369253948,TDMV 1,A00,189295,Arcidiacono; Kristin,19,0,30,11
1683369253948,TDMV 1,B00,189296,Caligagan; Maria T.,24,0,30,6
1683369254972,TDMV 2,A00,189297,Sammartano; Tonnie,28,0,30,2
1683369254972,TDMV 2,B00,189299,Arcidiacono; Kristin,24,0,30,6
1683369255998,TDMV 3,A00,204998,Rincon; Alicia,22,0,30,8
1683369257023,TDMV 120,A00,189458,Sammartano; Tonnie,28,0,30,2
1683369258047,TDMV 138,A00,189541,Jun; Grace Shin Hae,22,0,40,18
1683369259071,TDMV 142,A00,189717,Caligagan; Tony,24,0,30,6
1683369259071,TDMV 142,B00,189718,Caligagan; Maria T.,25,0,30,5
1683369260098,TMC 2,A01,187533,Staff,25,0,25,0
1683369260098,TMC 2,A02,187534,Staff,25,0,25,0
1683369261125,USP 1,A01,187536,Kwak; Nancy,0,16,25,25
1683369262154,USP 5,A01,187538,Staff,10,0,25,15
1683369263182,USP 101,A00,199253,Staff,0,4,0,0
1683369264209,USP 124,A00,187562,Boomhower; Matthew Charles,1,0,30,29
1683369265234,USP 138,A00,187582,Staff,20,0,25,5
1683369266263,USP 152,A01,187597,Staff,4,0,25,21
1683369267291,USP 153,A00,187598,Staff,19,0,25,6
1683369268315,USP 168,A00,187607,Kwak; Nancy,2,0,5,3
1683369269337,USP 173,A00,187619,Staff,4,0,25,21
1683369270365,USP 181,A00,187638,Staff,0,3,25,25
1683369271391,VIS 103,A00,187650,Cruz; Edwin Teddy,22,0,75,53
1683369272471,VIS 110D,A00,187669,Staff,12,0,22,10
1683369273494,VIS 127C,A00,187720,Shen; Kuiyi,67,0,146,79
1683369274521,VIS 149,A00,187731,Yoldas; Pinar,0,14,22,22
1683369275547,VIS 151,A01,188091,Staff,22,0,34,12
1683369275547,VIS 151,A02,188092,Staff,11,0,34,23
1683369276574,VIS 160B,A00,188093,Stalbaum; Brett,0,0,10,10
1683369278623,WCWP 10B,A00,201720,Staff,10,0,15,5
1683369278623,WCWP 10B,B00,201722,Staff,9,0,15,6
1683369279647,WCWP 100,A00,201725,Gagnon; Jeffrey C,0,0,2,2
1683369279647,WCWP 100,B00,201727,Staff,0,4,15,15
1683369282772,ANBI 133,A00,258401,Wilder; Linnea Lorene,34,0,40,6
1683369283796,ANBI 140,A00,258395,Hrvoj Mihic; Branka,18,0,25,7
1683369284823,ANSC 120,A00,258402,Bialecki; Jon Anthony,27,0,40,13
1683369285847,ANSC 144,A00,258400,Staff,14,0,40,26
1683369287900,ANSC 166,A00,258396,Parish; Steven Martin,158,0,175,17
1683369288927,ANSC 180,A00,193533,Staff,9,0,20,11
1683369289955,ANSC 188,A00,258397,Jassal; Aftab,33,0,40,7
1683369290981,ANTH 3,A01,258316,Staff,23,0,30,7
1683369292010,ANTH 5,A00,258394,Semendeferi; Ekaterini,16,0,20,4
1683369293034,ANTH 21,A01,258331,Staff,8,0,40,32
1683369294058,ANTH 103,A00,258398,Varma; Saiba,15,0,25,10
1683369295082,AWP 10,001,202034,Staff,0,0,0,0
1683369295082,AWP 10,002,202035,Staff,0,0,0,0
1683369295082,AWP 10,003,202036,Staff,0,0,0,0
1683369295082,AWP 10,004,202037,Staff,0,0,0,0
1683369295082,AWP 10,005,202038,Staff,0,0,0,0
1683369295082,AWP 10,006,202039,Staff,0,0,0,0
1683369295082,AWP 10,007,202040,Staff,0,0,0,0
1683369295082,AWP 10,008,202041,Staff,0,0,0,0
1683369295082,AWP 10,009,202042,Staff,0,0,0,0
1683369295082,AWP 10,010,202043,Staff,0,0,0,0
1683369295082,AWP 10,011,202044,Staff,0,0,0,0
1683369295082,AWP 10,012,202045,Staff,0,0,0,0
1683369295082,AWP 10,013,202046,Staff,0,0,0,0
1683369295082,AWP 10,014,202047,Staff,0,0,0,0
1683369295082,AWP 10,015,202048,Staff,0,0,0,0
1683369295082,AWP 10,016,202049,Staff,0,0,0,0
1683369295082,AWP 10,017,202050,Staff,0,0,0,0
1683369295082,AWP 10,018,202051,Staff,0,0,0,0
1683369295082,AWP 10,019,202052,Staff,0,0,0,0
1683369295082,AWP 10,020,202053,Staff,0,0,0,0
1683369295082,AWP 10,021,202054,Staff,0,0,0,0
1683369295082,AWP 10,022,202055,Staff,0,0,0,0
1683369295082,AWP 10,023,202056,Staff,0,0,0,0
1683369295082,AWP 10,024,202057,Staff,0,0,0,0
1683369295082,AWP 10,025,202058,Staff,0,0,0,0
1683369295082,AWP 10,026,202059,Staff,0,0,0,0
1683369296106,AWP 102,001,202032,Staff,0,0,0,0
1683369296106,AWP 102,002,202033,Staff,0,0,0,0
1683369297136,BENG 100,A01,254234,Taylor Amos; Alyssa C,31,0,40,9
1683369298162,BENG 196,001,270013,Engler; Adam J.,9999,0,9999,0
1683369299194,BICD 100R,A01,202018,Smith; Laurie,0,7,32,32
1683369299194,BICD 100R,A02,202019,Smith; Laurie,0,2,32,32
1683369299194,BICD 100R,A03,202020,Smith; Laurie,0,1,32,32
1683369299194,BICD 100R,A04,202021,Smith; Laurie,9,0,32,23
1683369299194,BICD 100R,A05,202022,Smith; Laurie,12,0,32,20
1683369300218,BICD 136,A01,193242,Gustafson-Brown; Cindy,0,2,32,32
1683369300218,BICD 136,A02,193244,Gustafson-Brown; Cindy,14,0,32,18
1683369301242,BIEB 102,A01,193249,Butler; Shannon Rhey,0,2,32,32
1683369301242,BIEB 102,A02,193251,Butler; Shannon Rhey,0,0,32,32
1683369301242,BIEB 102,A03,193253,Butler; Shannon Rhey,0,1,32,32
1683369301242,BIEB 102,A04,193255,Butler; Shannon Rhey,17,0,32,15
1683369301242,BIEB 102,A05,193265,Butler; Shannon Rhey,26,0,32,6
1683369301242,BIEB 102,A06,193269,Butler; Shannon Rhey,16,0,32,16
1683369303291,BIEB 150,A01,193274,Staff,0,0,32,32
1683369303291,BIEB 150,A02,193285,Staff,23,0,32,9
1683369304316,BIEB 194,A00,193286,Kurle; Carolyn M.,22,0,32,10
1683369305348,BILD 1,A01,192291,Staff,16,0,32,16
1683369305348,BILD 1,A02,192292,Staff,30,0,32,2
1683369305348,BILD 1,B01,192520,Reuther; Keefe,0,1,0,0
1683369305348,BILD 1,B02,192532,Reuther; Keefe,0,1,0,0
1683369306378,BILD 3,A01,192556,Butler; Shannon Rhey,0,0,32,32
1683369306378,BILD 3,A02,192581,Butler; Shannon Rhey,4,0,32,28
1683369306378,BILD 3,A03,192611,Butler; Shannon Rhey,23,0,32,9
1683369306378,BILD 3,A04,192612,Butler; Shannon Rhey,25,0,32,7
1683369306378,BILD 3,A05,192613,Butler; Shannon Rhey,27,0,32,5
1683369306378,BILD 3,A06,192679,Butler; Shannon Rhey,27,0,32,5
1683369306378,BILD 3,A07,192682,Butler; Shannon Rhey,21,0,32,11
1683369307404,BILD 4,A01,192836,Reuther; Keefe,0,0,24,24
1683369307404,BILD 4,A02,193044,Reuther; Keefe,4,0,24,20
1683369308427,BILD 10,A01,193142,Gustafson-Brown; Cindy,30,0,32,2
1683369308427,BILD 10,A02,193149,Gustafson-Brown; Cindy,31,0,32,1
1683369309451,BIMM 100,A01,193301,Staff,1,6,32,31
1683369309451,BIMM 100,A02,193312,Staff,0,5,32,32
1683369309451,BIMM 100,A03,193323,Staff,0,8,32,32
1683369310478,BIMM 101,A01,193329,McDonnell; Lisa Marie,0,3,24,24
1683369310478,BIMM 101,A02,193339,McDonnell; Lisa Marie,0,3,24,24
1683369310478,BIMM 101,B01,193354,McDonnell; Lisa Marie,0,3,24,24
1683369310478,BIMM 101,B02,193357,McDonnell; Lisa Marie,0,3,24,24
1683369311502,BIMM 110,A01,193377,Tat; John,0,11,32,32
1683369311502,BIMM 110,A02,193378,Tat; John,0,9,32,32
1683369312527,BIMM 120,A01,206116,Staff,0,0,32,32
1683369312527,BIMM 120,A02,206117,Staff,8,0,32,24
1683369312527,BIMM 120,A03,206121,Staff,21,0,32,11
1683369313550,BIPN 100,A01,193393,Park; Ji Young,0,14,32,32
1683369313550,BIPN 100,A02,193402,Park; Ji Young,0,13,32,32
1683369313550,BIPN 100,A03,193413,Park; Ji Young,0,14,32,32
1683369313550,BIPN 100,A04,193414,Park; Ji Young,0,13,32,32
1683369314579,BIPN 102,A01,193429,Staff,0,0,32,32
1683369314579,BIPN 102,A02,193438,Staff,22,0,32,10
1683369315603,BIPN 106,A01,193450,Reyes Gonzalez; Catalina,0,2,40,40
1683369316628,BIPN 134,A01,193465,Cooke; James Edward,1,0,32,31
1683369316628,BIPN 134,A02,193474,Cooke; James Edward,25,0,32,7
1683369316628,BIPN 134,A03,193485,Cooke; James Edward,29,0,32,3
1683369316628,BIPN 134,A04,193486,Cooke; James Edward,21,0,32,11
1683369316628,BIPN 134,A05,193491,Cooke; James Edward,31,0,32,1
1683369316628,BIPN 134,A06,193501,Cooke; James Edward,30,0,32,2
1683369316628,BIPN 134,A07,193510,Cooke; James Edward,29,0,32,3
1683369318678,BISP 194,A00,222522,Staff,14,0,32,18
1683369319705,CAT 124,A01,202407,Staff,19,0,25,6
1683369320730,CAT 125,A00,202408,Marchisotto; Jennifer Anne,4,0,20,16
1683369321764,CAT 125R,A00,202409,Smith; Lauryn Alissa,0,11,20,20
1683369321764,CAT 125R,B00,202410,Morales; Celeste Georgianna,0,11,20,20
1683369321764,CAT 125R,C00,202411,Irwin; Matthew Joseph,0,10,20,20
1683369322791,CENG 15,A01,204712,Yang; Kesong,0,1,0,0
1683369323816,CENG 114,A00,202070,Jahed Motlagh; Zeinab,5,0,20,15
1683369324839,CGS 105,A00,185477,Wesling; Megan E.,24,0,40,16
1683369325863,CGS 106,A00,185494,Staff,13,0,22,9
1683369326886,CGS 108,A00,185495,Staff,14,0,20,6
1683369327913,CGS 114,A00,185496,Staff,13,0,18,5
1683369328940,CGS 119,A00,185501,Staff,15,0,20,5
1683369329966,CGS 120,A00,185511,Staff,13,0,20,7
1683369330994,CHEM 4,A01,184675,Bussey; Thomas J,96,0,100,4
1683369332022,CHEM 6A,A01,184677,Staff,34,0,60,26
1683369333048,CHEM 6B,A01,184679,Staff,65,0,100,35
1683369334074,CHEM 6C,A01,184681,Bussey; Thomas J,1,0,50,49
1683369334074,CHEM 6C,A02,184682,Bussey; Thomas J,34,0,50,16
1683369335102,CHEM 40A,A01,184684,Albizati; Kim F.,37,0,100,63
1683369336126,CHEM 40B,A01,184686,Albizati; Kim F.,0,20,100,100
1683369337149,CHEM 41B,A01,184690,Staff,52,0,100,48
1683369338178,COGS 3,A01,184715,Boyle; Mary E. T.,0,25,40,40
1683369339203,COGS 14B,A01,185172,Staff,0,15,38,38
1683369340227,COGS 18,A01,184736,Staff,16,0,80,64
1683369341252,COGS 100,A01,184932,Staff,0,5,73,73
1683369342276,COGS 101A,A01,184935,Staff,0,39,30,30
1683369343303,COGS 101B,A01,184944,Staff,0,2,30,30
1683369344331,COGS 101C,A01,184946,Staff,0,12,30,30
1683369345360,COGS 102A,A01,184951,Johnson; Christine M.,2,0,40,38
1683369346388,COGS 107B,A01,184953,Mooshagian; Eric Frederick,0,50,40,40
1683369347417,COGS 118B,A01,184959,Gupta; Anjum,0,48,40,40
1683369348441,COGS 153,A00,184961,Staff,0,15,30,30
1683369349465,COGS 177,A00,184962,Staff,0,20,30,30
1683369350489,COGS 187A,A01,184969,Boyle; Mary E. T.,0,17,40,40
1683369351519,COMM 10,A01,185174,Staff,0,5,25,25
1683369351519,COMM 10,A02,185189,Staff,0,5,25,25
1683369351519,COMM 10,A03,269821,Staff,0,0,0,0
1683369352543,COMM 100B,A01,185475,Staff,0,0,0,2
1683369352543,COMM 100B,A02,185476,Staff,13,0,25,12
1683369353567,COMM 100C,A01,185314,Staff,1,0,25,24
1683369353567,COMM 100C,A02,185327,Staff,19,0,25,6
1683369354591,COMM 110M,A00,185349,Staff,2,0,40,38
1683369355617,COMM 113T,A00,185352,Staff,24,0,40,16
1683369356640,COMM 114I,A00,185353,Staff,33,0,40,7
1683369357664,COMM 131,A00,185354,Staff,19,0,30,11
1683369358690,CSE 8A,A50,185358,Cao; Yingjun,0,46,10,10
1683369359714,CSE 8B,A01,185362,Staff,0,46,50,50
1683369360738,CSE 11,A01,185416,Cao; Yingjun,0,92,10,10
1683369361767,CSE 20,A01,185445,Briones; Jor-el Thomas Caparas,5,0,25,20
1683369362791,CSE 21,A01,185447,Staff,10,0,50,40
1683369363819,CSE 101,A01,185451,Staff,0,13,50,50
1683369363819,CSE 101,B01,185453,Jones; Miles E,0,11,50,50
1683369365869,CSE 141,A01,185458,Eldon; John,20,0,100,80
1683369366898,CSE 141L,A01,185461,Eldon; John,12,0,100,88
1683369367926,CSE 142,A01,185463,Staff,36,0,60,24
1683369367926,CSE 142,B01,201355,Staff,0,7,60,60
1683369368953,CSE 142L,A01,185470,Staff,36,0,60,24
1683369368953,CSE 142L,B01,201417,Staff,0,6,60,60
1683369369980,CSE 190,A00,201433,Staff,32,0,49,17
1683369371010,DOC 1,A01,259136,Strom; Megan C.,7,0,15,8
1683369371010,DOC 1,A02,259137,Strom; Megan C.,14,0,15,1
1683369371010,DOC 1,A03,259138,Strom; Megan C.,14,0,15,1
1683369371010,DOC 1,A04,259139,Strom; Megan C.,14,0,15,1
1683369372038,DOC 100D,A00,259140,Pass; Natalye Joann,16,0,25,9
1683369373067,DSGN 1,A01,184749,Rill; Bryan,0,25,30,30
1683369374092,DSGN 100,A01,185168,Staff,0,2,25,25
1683369375118,ECE 5,A01,185626,Morris; Karcher William,0,10,0,0
1683369376197,ECE 101,A01,185628,Staff,17,0,70,53
1683369377222,ECE 107,A01,185635,Baghdadchi; Saharnaz,0,0,20,20
1683369377222,ECE 107,A02,185638,Baghdadchi; Saharnaz,4,0,20,16
1683369378244,ECE 148,A01,185647,Silberman; Jack,0,0,16,16
1683369379272,ECON 1,A01,185537,Crane; Meredith Helen,54,0,70,16
1683369380300,ECON 3,A01,185549,Crane; Meredith Helen,32,0,70,38
1683369381329,ECON 4,A01,203354,Anderson; John Charles,0,4,10,10
1683369382351,ECON 100A,A01,185574,Staff,0,4,40,40
1683369383378,ECON 100B,A01,185576,Staff,0,12,50,50
1683369384405,ECON 100C,A01,185589,Newhouse; Herbert S,29,0,70,41
1683369385434,ECON 105,A00,185608,Vespa; Emanuel Ignacio,19,0,35,16
1683369386462,ECON 109,A01,185610,Shishkin; Denis,10,0,35,25
1683369387486,ECON 110A,A01,185612,Staff,11,0,40,29
1683369388511,ECON 120A,A01,185615,Staff,20,0,40,20
1683369389535,ECON 120C,A01,185617,Sun; Yixiao,0,21,70,70
1683369390561,ECON 144,A00,203346,Squires; Dale E,3,0,35,32
1683369391589,ECON 171,A01,203349,Newhouse; Herbert S,0,1,35,35
1683369392617,ECON 173A,A01,185621,Toda; Alexis Akira,21,0,35,14
1683369393643,EDS 25,A01,202413,Staff,0,1,0,0
1683369393643,EDS 25,A02,202414,Staff,0,1,0,0
1683369393643,EDS 25,A03,202415,Staff,0,0,0,0
1683369393643,EDS 25,A04,202416,Staff,0,1,0,0
1683369393643,EDS 25,A05,202439,Staff,0,0,0,0
1683369393643,EDS 25,A06,202440,Staff,0,0,0,0
1683369393643,EDS 25,B01,202631,Staff,0,0,0,0
1683369393643,EDS 25,B02,202632,Staff,0,0,0,0
1683369393643,EDS 25,B03,202639,Staff,0,0,0,0
1683369393643,EDS 25,B04,202640,Staff,0,0,0,0
1683369393643,EDS 25,B05,202643,Staff,0,0,0,0
1683369393643,EDS 25,B06,202644,Staff,0,0,0,0
1683369394671,EDS 38,A01,202659,Black; Alison Michelle,24,0,25,1
1683369395698,EDS 115,A00,202652,Staff,18,0,30,12
1683369396724,EDS 125,A00,202649,Staff,14,0,30,16
1683369397753,EDS 126,A01,203332,Staff,30,0,30,0
1683369398780,EDS 139,A00,202838,Staff,16,0,25,9
1683369399807,EDS 146,A01,202655,Staff,14,0,25,11
1683369400835,ENG 15,A00,185667,Staff,0,1,0,0
1683369400835,ENG 15,B00,185672,Staff,0,0,0,0
1683369400835,ENG 15,C00,185675,Staff,0,0,0,0
1683369400835,ENG 15,D00,185682,Staff,0,0,0,0
1683369400835,ENG 15,E00,185684,Staff,0,0,0,0
1683369401862,ETHN 103,A00,185710,Staff,0,4,35,35
1683369402887,ETHN 103A,A00,199228,Man; Simeon S,2,0,9,7
1683369403910,ETHN 109,A00,185711,Staff,18,0,35,17
1683369404935,ETHN 142,A00,185726,Staff,0,4,30,30
1683369405958,ETHN 163J,A00,199229,Man; Simeon S,5,0,8,3
1683369406983,ETHN 168,A00,185727,Staff,8,0,10,2
1683369408006,ETHN 182,A00,185728,Staff,0,0,35,35
1683369409029,ETHN 183,A00,185737,Staff,8,0,18,10
1683369410058,GLBH 111,A01,209361,Burgos; Jose L.,0,0,0,0
1683369412108,HIEU 104,A00,185792,Staff,16,0,20,4
1683369413132,HIEU 115,A00,185800,Staff,1,0,20,19
1683369414157,HIEU 128,A00,185801,Staff,0,7,20,20
1683369415179,HIEU 147,A00,185802,Staff,16,0,20,4
1683369416207,HIEU 154,A00,185823,Staff,12,0,20,8
1683369417230,HILA 102,A00,185826,Staff,13,0,20,7
1683369418255,HILD 2C,A01,185778,Staff,0,12,20,20
1683369419283,HILD 7B,A01,185780,Kwak; Nancy,0,15,32,32
1683369419283,HILD 7B,A02,185781,Kwak; Nancy,0,18,32,32
1683369420312,HILD 30,A01,185791,Staff,14,0,20,6
1683369421346,HISC 119,A00,185830,Golan; Tal,0,9,20,20
1683369422375,HITO 156GS,A00,185831,Patterson; Patrick H.,0,0,0,23
1683369423399,HIUS 103,A00,185832,Man; Simeon S,1,6,20,19
1683369424422,HIUS 117,A00,185836,Kwak; Nancy,2,0,20,18
1683369425446,HIUS 125,A00,185840,Man; Simeon S,0,0,23,23
1683369426470,HIUS 149,A00,185845,Staff,0,0,20,20
1683369427496,HUM 3,A01,185882,Zavodny; Tatiana Sophia,0,7,50,50
1683369427496,HUM 3,B01,185899,Caldwell; Michael Alan,0,18,50,50
1683369428519,HUM 3GS,A00,185900,Patterson; Patrick H.,0,0,0,23
1683369429548,HUM 4,A01,185938,Zroka; Amy Liane,31,0,50,19
1683369429548,HUM 4,B01,185956,Watkins; Eric,0,3,50,50
1683369429548,HUM 4,B02,202209,Watkins; Eric,0,2,50,50
1683369429548,HUM 4,B03,202210,Watkins; Eric,0,2,50,50
1683369430573,HUM 5,A01,185958,West; Geoffrey Scott,3,0,50,47
1683369430573,HUM 5,A02,202215,West; Geoffrey Scott,0,0,50,50
1683369431597,INTL 190,A00,185959,Gagnon; Jeffrey C,0,0,0,9
1683369431597,INTL 190,B00,185960,Lettieri; Michael Joseph,0,0,0,1
1683369432621,JAPN 180,A00,254509,Staff,4,0,30,26
1683369433647,LATI 10,A01,202853,Kennemore; Amy Michelle,4,0,35,31
1683369433647,LATI 10,A02,202854,Kennemore; Amy Michelle,2,0,35,33
1683369433647,LATI 10,A03,270054,Kennemore; Amy Michelle,30,0,30,0
1683369434671,LATI 180,A00,202855,Kennemore; Amy Michelle,11,0,20,9
1683369435698,LAWS 101,A00,201767,Golan; Tal,0,7,40,40
1683369436724,LIFR 1C,A00,185961,Staff,6,0,20,14
1683369437751,LIFR 1CX,A00,185962,Staff,7,0,20,13
1683369438775,LIFR 1D,A00,185963,Staff,9,0,20,11
1683369439799,LIFR 1DX,A00,185964,Staff,9,0,20,11
1683369440829,LIGN 101,A01,186039,Staff,43,0,50,7
1683369441853,LIGN 165,A00,186040,Staff,18,0,50,32
1683369442881,LTCS 108,A00,186041,Staff,6,0,10,4
1683369443908,LTCS 119,A00,186042,Staff,16,0,20,4
1683369444937,LTCS 130,A00,186043,Wesling; Megan E.,15,0,25,10
1683369446986,LTEA 138,A00,186119,Staff,14,0,40,26
1683369448011,LTEN 124,A00,186148,Staff,6,0,25,19
1683369449035,LTEN 178,A00,186149,Staff,7,0,15,8
1683369450060,LTEN 181,A00,186150,Blanco; John D,33,0,40,7
1683369451084,LTWL 120,A00,186160,Staff,20,0,25,5
1683369452107,LTWL 165,A00,186161,Staff,22,0,25,3
1683369453132,LTWR 100,A00,186162,Staff,0,5,15,15
1683369454156,LTWR 102,A00,186163,Doller; Ben,5,0,15,10
1683369455181,MAE 8,A01,186412,Staff,0,0,0,0
1683369456206,MAE 30B,A00,186445,Bahadori; Mohammad Yousef,83,0,100,17
1683369457230,MAE 40,A00,186592,Bewley; Thomas R,10,0,50,40
1683369458255,MAE 101B,A00,186593,Bahadori; Mohammad Yousef,81,0,100,19
1683369459281,MAE 105,A00,186594,Bandaru; Prabhakar,12,0,50,38
1683369460310,MAE 107,A00,186599,Pham; Hieu Tan,0,7,120,120
1683369461339,MAE 148,A01,186660,Silberman; Jack,3,0,16,13
1683369462369,MATH 10A,A01,188095,Staff,0,5,35,35
1683369463398,MATH 10B,A01,188097,Bowers; Adam R.,0,11,30,30
1683369463398,MATH 10B,A02,188099,Bowers; Adam R.,0,11,30,30
1683369463398,MATH 10B,B01,188104,Bowers; Adam R.,0,10,30,30
1683369463398,MATH 10B,B02,188106,Bowers; Adam R.,0,10,30,30
1683369464426,MATH 10C,A01,188111,Staff,0,18,30,30
1683369464426,MATH 10C,A02,188127,Staff,0,17,30,30
1683369464426,MATH 10C,A03,188131,Staff,0,18,30,30
1683369464426,MATH 10C,B01,188218,Staff,18,0,30,12
1683369464426,MATH 10C,B02,188244,Staff,13,0,30,17
1683369464426,MATH 10C,B03,188277,Staff,16,0,30,14
1683369465450,MATH 18,A01,188344,Bach; Quang Tran,18,0,30,12
1683369465450,MATH 18,A02,188345,Bach; Quang Tran,11,0,30,19
1683369465450,MATH 18,B01,188353,Bach; Quang Tran,10,0,30,20
1683369465450,MATH 18,B02,188354,Bach; Quang Tran,20,0,30,10
1683369466476,MATH 20A,A01,188374,Staff,12,0,35,23
1683369467504,MATH 20B,A01,188382,Ohm; Ko Woon,6,0,30,24
1683369467504,MATH 20B,A02,188383,Ohm; Ko Woon,21,0,30,9
1683369467504,MATH 20B,B01,188385,Ohm; Ko Woon,7,0,30,23
1683369467504,MATH 20B,B02,188392,Ohm; Ko Woon,22,0,30,8
1683369468530,MATH 20C,A01,188394,Harel; Guershon,10,0,30,20
1683369468530,MATH 20C,A02,188395,Harel; Guershon,15,0,30,15
1683369468530,MATH 20C,B01,188404,Harel; Guershon,4,0,30,26
1683369468530,MATH 20C,B02,188405,Harel; Guershon,19,0,30,11
1683369469561,MATH 20D,A01,188414,Hammock; Frances H,0,1,30,30
1683369469561,MATH 20D,A02,188415,Hammock; Frances H,3,0,30,27
1683369469561,MATH 20D,B01,188447,Hammock; Frances H,1,0,30,29
1683369469561,MATH 20D,B02,188486,Hammock; Frances H,8,0,30,22
1683369470587,MATH 20E,A01,188649,Staff,21,0,30,9
1683369470587,MATH 20E,A02,188650,Staff,23,0,30,7
1683369470587,MATH 20E,A03,188673,Staff,0,0,30,30
1683369471616,MATH 102,A01,188675,Staff,0,35,35,35
1683369472647,MATH 103B,A01,188681,Staff,3,0,35,32
1683369472647,MATH 103B,B01,188692,Staff,5,0,35,30
1683369473679,MATH 109,A01,188695,Salehi Golsefidy; Alireza,25,0,35,10
1683369473679,MATH 109,A02,188696,Salehi Golsefidy; Alireza,25,0,35,10
1683369474709,MATH 120A,A01,188698,Eggers; John Dietrich,7,0,35,28
1683369475742,MATH 142B,A01,188736,Ioana; Adrian,0,2,30,30
1683369475742,MATH 142B,A02,188741,Ioana; Adrian,0,0,30,30
1683369475742,MATH 142B,A03,188743,Ioana; Adrian,0,1,30,30
1683369476769,MATH 168A,A01,188790,Staff,0,9,35,35
1683369477800,MATH 170A,A01,188803,Nie; Jiawang,0,2,35,35
1683369477800,MATH 170A,A02,188811,Nie; Jiawang,0,0,35,35
1683369477800,MATH 170A,A03,188814,Nie; Jiawang,1,0,35,34
1683369477800,MATH 170A,A04,188815,Nie; Jiawang,13,0,35,22
1683369478825,MATH 193B,A01,188817,Staff,0,0,35,35
1683369478825,MATH 193B,A02,188818,Staff,5,0,35,30
1683369479906,MGT 4,A01,202857,Anderson; John Charles,61,0,80,19
1683369480932,MGT 12,A00,202858,Lindenberger; Wade Douglas,41,0,90,49
1683369481957,MGT 18,A00,202859,Staff,74,0,90,16
1683369482982,MGT 18GS,A00,202860,McKay; Michael J,13,0,28,15
1683369484010,MGT 45,A00,202861,Pecore; Joseph P.,15,0,90,75
1683369485035,MGT 100,A00,202863,Yavorsky; Daniel Ryan,28,0,90,62
1683369486060,MGT 103,A00,202864,Ehrich; Kristine R,0,17,90,90
1683369487088,MGT 112,A00,202865,Ehrich; Kristine R,15,0,90,75
1683369488117,MGT 121A,A00,202868,Staff,0,20,0,0
1683369489146,MGT 131B,A00,202869,Anderson; John Charles,59,0,90,31
1683369490176,MGT 136,A00,202871,Lindenberger; Wade Douglas,84,0,90,6
1683369491201,MGT 164,A00,202873,Staff,0,68,90,91
1683369492228,MGT 164GS,A00,202874,McKay; Mary A,13,0,28,15
1683369493252,MGT 180,A00,202875,Staff,0,50,90,91
1683369494277,MMW 11R,A01,205019,Herbst; Matthew,3,0,30,27
1683369494277,MMW 11R,A02,205026,Herbst; Matthew,29,0,30,1
1683369495311,MMW 15,A01,193512,Chang; Edmond Yi-Teh,0,9,28,28
1683369495311,MMW 15,A02,193513,Chang; Edmond Yi-Teh,0,5,28,28
1683369495311,MMW 15,A03,193514,Chang; Edmond Yi-Teh,0,5,28,28
1683369495311,MMW 15,A04,193515,Chang; Edmond Yi-Teh,0,5,28,28
1683369495311,MMW 15,A05,193516,Chang; Edmond Yi-Teh,0,4,28,28
1683369495311,MMW 15,A06,193517,Chang; Edmond Yi-Teh,0,5,28,28
1683369495311,MMW 15,B01,193519,Chang; Edmond Yi-Teh,0,5,28,28
1683369495311,MMW 15,B02,193520,Chang; Edmond Yi-Teh,0,5,28,28
1683369495311,MMW 15,B03,193521,Chang; Edmond Yi-Teh,0,5,28,28
1683369495311,MMW 15,B04,193522,Chang; Edmond Yi-Teh,0,4,28,28
1683369495311,MMW 15,B05,193523,Chang; Edmond Yi-Teh,0,5,28,28
1683369495311,MMW 15,B06,193524,Chang; Edmond Yi-Teh,0,4,28,28
1683369496338,MMW 122,A01,193526,Rahimi; Babak,0,15,28,28
1683369496338,MMW 122,A02,193527,Rahimi; Babak,0,14,28,28
1683369496338,MMW 122,A03,193528,Rahimi; Babak,0,0,0,0
1683369496338,MMW 122,A04,193529,Rahimi; Babak,0,0,0,0
1683369497369,MUS 1A,A01,186663,Staff,0,20,35,35
1683369498398,MUS 4,A01,186715,Staff,0,12,35,35
1683369499422,MUS 5R,A01,186796,Dubnov; Shlomo,0,17,35,35
1683369500448,MUS 6,A01,186798,Staff,0,4,25,25
1683369501472,MUS 7,A01,186830,Staff,13,0,35,22
1683369502498,MUS 8,A01,186930,Staff,0,26,35,35
1683369503520,MUS 15,A01,186932,Staff,0,16,35,35
1683369503520,MUS 15,B01,186934,Staff,0,15,35,35
1683369504549,MUS 80,A00,186935,Staff,0,0,20,20
1683369504549,MUS 80,B00,186936,Staff,25,0,25,0
1683369505578,NANO 11,A00,204702,Lipomi; Darren John,0,0,0,0
1683369506608,NANO 15,A01,204709,Yang; Kesong,0,1,0,0
1683369507631,NANO 114,A00,202069,Jahed Motlagh; Zeinab,3,0,10,7
1683369508656,PHIL 1,A00,186955,Grush; Rick Scott,32,0,40,8
1683369509682,PHIL 10,A01,186973,Grush; Rick Scott,28,0,35,7
1683369509682,PHIL 10,A02,186974,Grush; Rick Scott,33,0,35,2
1683369510707,PHIL 13,A01,186976,Staff,7,0,35,28
1683369510707,PHIL 13,A02,186977,Staff,16,0,35,19
1683369511734,PHIL 14,A01,186979,Staff,31,0,35,4
1683369511734,PHIL 14,A02,186986,Staff,32,0,35,3
1683369512763,PHIL 28,A01,186988,Staff,16,0,30,14
1683369512763,PHIL 28,A02,186989,Staff,1,0,30,29
1683369512763,PHIL 28,A03,186990,Staff,9,0,30,21
1683369512763,PHIL 28,A04,186991,Staff,26,0,30,4
1683369513787,PHIL 120,A00,186997,Staff,23,0,40,17
1683369514816,PHIL 137,A00,187003,Staff,9,0,40,31
1683369515842,PHIL 150,A00,187015,Staff,47,0,70,23
1683369516871,PHIL 167,A00,187021,Lamey; Andy M.,35,0,40,5
1683369517896,PHIL 174,A01,202226,Staff,17,0,20,3
1683369517896,PHIL 174,A02,202235,Staff,20,0,20,0
1683369518922,PHIL 191A,A00,258918,Staff,0,0,1,1
1683369519948,PHYS 1A,A00,187028,Staff,27,0,60,33
1683369520972,PHYS 1AL,001,187036,Staff,2,0,30,28
1683369520972,PHYS 1AL,002,187049,Staff,18,0,30,12
1683369522001,PHYS 1B,A00,187058,Staff,22,0,60,38
1683369523028,PHYS 1BL,001,187064,Staff,0,0,30,30
1683369523028,PHYS 1BL,002,187070,Staff,5,0,30,25
1683369524053,PHYS 1C,A00,187082,Staff,31,0,120,89
1683369525079,PHYS 1CL,001,187088,Staff,0,9,30,30
1683369525079,PHYS 1CL,002,187089,Staff,0,2,30,30
1683369525079,PHYS 1CL,009,262693,Staff,11,0,30,19
1683369526103,PHYS 2B,A01,187097,Staff,54,0,115,61
1683369527130,PHYS 2C,A01,187099,Staff,67,0,115,48
1683369528156,PHYS 2CL,A01,187101,Staff,5,0,28,23
1683369528156,PHYS 2CL,A02,187102,Staff,15,0,28,13
1683369529182,PHYS 2D,A01,187123,Shotwell; Brian,95,0,115,20
1683369530206,PHYS 4B,A01,187133,Grinstein; Benjamin,35,0,50,15
1683369531233,POLI 10,A00,188819,Staff,0,4,50,50
1683369532256,POLI 11,A00,188827,Staff,43,0,50,7
1683369533281,POLI 13R,A00,188828,Staff,0,1,20,20
1683369534306,POLI 27,A01,188830,Elgin; Samuel Zincke,0,1,70,70
1683369535332,POLI 30,A00,188832,Desposato; Scott,31,0,50,19
1683369536361,POLI 102F,A00,188834,Staff,2,0,40,38
1683369537389,POLI 104A,A00,188852,Staff,14,0,30,16
1683369538417,POLI 104I,A00,188853,Staff,0,6,20,20
1683369539447,POLI 110B,A00,188854,Wiens; David,7,0,20,13
1683369540474,POLI 112A,A00,188855,Wiens; David,5,0,30,25
1683369541500,POLI 117R,A00,188856,Forman; Fonna,0,11,20,20
1683369542528,POLI 118,A00,188857,Ingham; Sean,8,0,20,12
1683369543557,POLI 120G,A00,188858,Staff,9,0,30,21
1683369544585,POLI 131CR,A00,188863,Hoston; Germaine,23,0,50,27
1683369545609,POLI 133,A00,188864,Nellis; Gareth Hb,44,0,50,6
1683369546633,POLI 134D,A00,188865,Desposato; Scott,27,0,30,3
1683369547657,POLI 142A,A00,188871,Gartzke; Erik,22,0,50,28
1683369548682,POLI 142K,A00,188874,Staff,38,0,50,12
1683369549706,POLI 143,A00,188940,Gartzke; Erik,16,0,30,14
1683369550731,POLI 153,A00,188943,Staff,3,0,20,17
1683369551756,POLI 160AA,A00,188944,Staff,11,0,40,29
1683369552780,POLI 170A,A00,188945,Staff,11,0,30,19
1683369554830,PSYC 1,A00,188952,Staff,37,0,90,53
1683369555856,PSYC 2,B00,188953,Staff,19,0,35,16
1683369556882,PSYC 6,A00,188970,Staff,47,0,60,13
1683369557909,PSYC 7,A00,188973,Staff,37,0,45,8
1683369558935,PSYC 60,A01,188980,Rickard; Timothy C.,43,0,60,17
1683369559959,PSYC 70,A01,189001,Steiner; Eric Tomas,23,0,45,22
1683369560982,PSYC 100,A00,189005,Lacefield; Katharine I,0,98,120,120
1683369562007,PSYC 102,A00,189008,Staff,9,0,30,21
1683369563032,PSYC 106,B00,189026,Gorman; Michael R.,34,0,60,26
1683369564057,PSYC 114,B01,189033,Winkielman; Piotr,0,32,30,30
1683369565086,PSYC 131,A00,189036,Anagnostaras; Stephan,0,43,60,60
1683369566114,PSYC 136,A00,189041,Lowe; Angela Beth,0,7,25,25
1683369567142,PSYC 137,A00,189057,Winkielman; Piotr,0,34,25,25
1683369568166,PSYC 144,A00,189107,Wixted; John T,0,7,50,50
1683369570215,PSYC 162,A00,189142,Staff,0,8,85,85
1683369571240,PSYC 172,A00,189144,Gorman; Michael R.,0,7,30,30
1683369573293,PSYC 179,A00,189146,Lacefield; Katharine I,0,84,120,120
1683369574318,PSYC 181,A00,189147,Anagnostaras; Stephan,0,44,90,90
1683369575343,PSYC 190R,A00,189148,Barner; David A.,0,22,80,80
1683369576368,PSYC 191,A00,189275,Rickard; Timothy C.,0,7,25,25
1683369577396,PSYC 193,A00,189276,Chapman; Eddie Nathaniel,0,1,0,4
1683369578422,PSYC 193L,A01,189281,Lowe; Angela Beth,12,0,20,8
1683369578422,PSYC 193L,B01,189285,Staff,28,0,35,7
1683369579445,RELI 149,A00,187137,Rahimi; Babak,7,0,40,33
1683369580470,SE 9,A01,187315,Staff,0,2,18,18
1683369581495,SE 101B,A00,187409,Staff,24,0,30,6
1683369582522,SE 110B,A00,187444,Staff,10,0,40,30
1683369583608,SE 130B,A00,187449,Staff,31,0,40,9
1683369584632,SE 150A,A00,187516,Staff,9,0,20,11
1683369585657,SE 154,A00,187528,Staff,30,0,50,20
1683369586682,SIO 3,A01,258171,Staff,35,0,40,5
1683369587706,SIO 10,A00,187144,Cook; Geoffrey W,0,3,75,75
1683369588734,SIO 45,A00,187152,Cook; Geoffrey W,1,0,100,99
1683369589762,SIO 109R,A00,194486,Staff,0,3,20,20
1683369591816,SIO 187,A01,187233,Kacev; David,12,0,40,28
1683369592846,SOCI 1,A01,258656,Thorpe; Charles Robert,28,0,30,2
1683369592846,SOCI 1,A02,258658,Thorpe; Charles Robert,30,0,30,0
1683369592846,SOCI 1,A03,258661,Thorpe; Charles Robert,25,0,25,0
1683369592846,SOCI 1,A04,258666,Thorpe; Charles Robert,22,0,25,3
1683369592846,SOCI 1,A05,258897,Thorpe; Charles Robert,23,0,25,2
1683369592846,SOCI 1,A06,258898,Thorpe; Charles Robert,25,0,25,0
1683369593874,SOCI 30,A01,258903,Pardo Guerra; Juan Pablo,15,0,30,15
1683369594902,SOCI 102,A00,258904,Staff,9,0,25,16
1683369595930,SOCI 106,A00,258905,Staff,19,0,25,6
1683369596959,SOCI 111,A00,258907,Ribas Norris; Janet Vanesa,26,0,30,4
1683369597983,SOCI 121R,A00,258908,Pardo Guerra; Juan Pablo,10,0,30,20
1683369599007,SOCI 126,A01,203330,Staff,14,0,20,6
1683369600033,SOCI 131,A00,258909,Thorpe; Charles Robert,31,0,60,29
1683369601059,SOCI 135,A00,258910,Payne; Christine Anna,0,9,30,30
1683369602086,SOCI 157,A00,258911,Staff,12,0,30,18
1683369603109,SOCI 184,A00,258912,Staff,25,0,30,5
1683369604134,SOCI 188D,A00,258913,Staff,22,0,30,8
1683369605162,SYN 2,001,187529,Staff,10,0,16,6
1683369605162,SYN 2,002,201452,Staff,0,18,16,16
1683369605162,SYN 2,003,201469,Staff,3,0,16,13
1683369606186,SYN 100,A01,187531,Staff,0,9,20,20
1683369606186,SYN 100,B01,201491,Staff,0,12,20,20
1683369607211,TDAC 1,A00,189286,Walsh; Kim C.,3,0,20,17
1683369607211,TDAC 1,B00,189287,Harting; Carla Kelso,11,0,20,9
1683369608236,TDAC 101,A00,189300,Walsh; Kim C.,16,0,20,4
1683369608236,TDAC 101,B00,189301,Harting; Carla Kelso,18,0,20,2
1683369609259,TDAC 102,A00,189304,Basso; Beatrice,14,0,20,6
1683369610283,TDAC 108,A00,189305,Staff,18,0,20,2
1683369611310,TDDE 131,A00,189310,Staff,19,0,20,1
1683369611310,TDDE 131,B00,189314,Staff,19,0,20,1
1683369611310,TDDE 131,C00,189315,Staff,48,0,50,2
1683369611310,TDDE 131,D00,189316,Staff,14,0,15,1
1683369611310,TDDE 131,E00,204841,Staff,20,0,20,0
1683369612334,TDGE 10,A00,189289,Staff,30,0,50,20
1683369612334,TDGE 10,B00,189290,Havis; Allan,1,0,50,49
1683369613358,TDGE 11,A00,189291,Fulton; Julia,0,3,50,50
1683369613358,TDGE 11,B00,189292,Staff,20,0,25,5
1683369613358,TDGE 11,C00,260270,Staff,0,0,0,0
1683369614382,TDGE 25,A00,189294,Staff,3,0,20,17
1683369615410,TDGE 124,A00,189318,Fulton; Julia,0,8,50,50
1683369616436,TDGE 125,A00,189319,Staff,13,0,25,12
1683369616436,TDGE 125,B00,189320,Staff,23,0,25,2
1683369617460,TDGE 127,A00,189322,Havis; Allan,0,0,50,50
1683369618484,TDHT 101,A00,189323,Staff,18,0,25,7
1683369618484,TDHT 101,B00,189324,Staff,25,0,25,0
1683369619509,TDHT 102,A00,189325,Staff,49,0,50,1
1683369620538,TDMV 1,A00,189295,Arcidiacono; Kristin,19,0,30,11
1683369620538,TDMV 1,B00,189296,Caligagan; Maria T.,24,0,30,6
1683369621567,TDMV 2,A00,189297,Sammartano; Tonnie,28,0,30,2
1683369621567,TDMV 2,B00,189299,Arcidiacono; Kristin,24,0,30,6
1683369622600,TDMV 3,A00,204998,Rincon; Alicia,22,0,30,8
1683369623626,TDMV 120,A00,189458,Sammartano; Tonnie,28,0,30,2
1683369624650,TDMV 138,A00,189541,Jun; Grace Shin Hae,22,0,40,18
1683369625678,TDMV 142,A00,189717,Caligagan; Tony,24,0,30,6
1683369625678,TDMV 142,B00,189718,Caligagan; Maria T.,25,0,30,5
1683369626707,TMC 2,A01,187533,Staff,25,0,25,0
1683369626707,TMC 2,A02,187534,Staff,25,0,25,0
1683369627731,USP 1,A01,187536,Kwak; Nancy,0,16,25,25
1683369628756,USP 5,A01,187538,Staff,10,0,25,15
1683369629781,USP 101,A00,199253,Staff,0,4,0,0
1683369630806,USP 124,A00,187562,Boomhower; Matthew Charles,1,0,30,29
1683369631831,USP 138,A00,187582,Staff,20,0,25,5
1683369632854,USP 152,A01,187597,Staff,4,0,25,21
1683369633881,USP 153,A00,187598,Staff,19,0,25,6
1683369634906,USP 168,A00,187607,Kwak; Nancy,2,0,5,3
1683369635933,USP 173,A00,187619,Staff,4,0,25,21
1683369636957,USP 181,A00,187638,Staff,0,3,25,25
1683369637982,VIS 103,A00,187650,Cruz; Edwin Teddy,22,0,75,53
1683369639006,VIS 110D,A00,187669,Staff,12,0,22,10
1683369640034,VIS 127C,A00,187720,Shen; Kuiyi,67,0,146,79
1683369641063,VIS 149,A00,187731,Yoldas; Pinar,0,14,22,22
1683369642091,VIS 151,A01,188091,Staff,22,0,34,12
1683369642091,VIS 151,A02,188092,Staff,11,0,34,23
1683369643115,VIS 160B,A00,188093,Stalbaum; Brett,0,0,10,10
1683369645165,WCWP 10B,A00,201720,Staff,10,0,15,5
1683369645165,WCWP 10B,B00,201722,Staff,9,0,15,6
1683369646189,WCWP 100,A00,201725,Gagnon; Jeffrey C,0,0,2,2
1683369646189,WCWP 100,B00,201727,Staff,0,4,15,15
1683369649312,ANBI 133,A00,258401,Wilder; Linnea Lorene,34,0,40,6
1683369650337,ANBI 140,A00,258395,Hrvoj Mihic; Branka,18,0,25,7
1683369651362,ANSC 120,A00,258402,Bialecki; Jon Anthony,27,0,40,13
1683369652388,ANSC 144,A00,258400,Staff,14,0,40,26
1683369654445,ANSC 166,A00,258396,Parish; Steven Martin,158,0,175,17
1683369655475,ANSC 180,A00,193533,Staff,9,0,20,11
1683369656504,ANSC 188,A00,258397,Jassal; Aftab,33,0,40,7
1683369657531,ANTH 3,A01,258316,Staff,23,0,30,7
1683369658560,ANTH 5,A00,258394,Semendeferi; Ekaterini,16,0,20,4
1683369659587,ANTH 21,A01,258331,Staff,8,0,40,32
1683369660615,ANTH 103,A00,258398,Varma; Saiba,15,0,25,10
1683369661650,AWP 10,001,202034,Staff,0,0,0,0
1683369661650,AWP 10,002,202035,Staff,0,0,0,0
1683369661650,AWP 10,003,202036,Staff,0,0,0,0
1683369661650,AWP 10,004,202037,Staff,0,0,0,0
1683369661650,AWP 10,005,202038,Staff,0,0,0,0
1683369661650,AWP 10,006,202039,Staff,0,0,0,0
1683369661650,AWP 10,007,202040,Staff,0,0,0,0
1683369661650,AWP 10,008,202041,Staff,0,0,0,0
1683369661650,AWP 10,009,202042,Staff,0,0,0,0
1683369661650,AWP 10,010,202043,Staff,0,0,0,0
1683369661650,AWP 10,011,202044,Staff,0,0,0,0
1683369661650,AWP 10,012,202045,Staff,0,0,0,0
1683369661650,AWP 10,013,202046,Staff,0,0,0,0
1683369661650,AWP 10,014,202047,Staff,0,0,0,0
1683369661650,AWP 10,015,202048,Staff,0,0,0,0
1683369661650,AWP 10,016,202049,Staff,0,0,0,0
1683369661650,AWP 10,017,202050,Staff,0,0,0,0
1683369661650,AWP 10,018,202051,Staff,0,0,0,0
1683369661650,AWP 10,019,202052,Staff,0,0,0,0
1683369661650,AWP 10,020,202053,Staff,0,0,0,0
1683369661650,AWP 10,021,202054,Staff,0,0,0,0
1683369661650,AWP 10,022,202055,Staff,0,0,0,0
1683369661650,AWP 10,023,202056,Staff,0,0,0,0
1683369661650,AWP 10,024,202057,Staff,0,0,0,0
1683369661650,AWP 10,025,202058,Staff,0,0,0,0
1683369661650,AWP 10,026,202059,Staff,0,0,0,0
1683369662676,AWP 102,001,202032,Staff,0,0,0,0
1683369662676,AWP 102,002,202033,Staff,0,0,0,0
1683369663701,BENG 100,A01,254234,Taylor Amos; Alyssa C,31,0,40,9
1683369664726,BENG 196,001,270013,Engler; Adam J.,9999,0,9999,0
1683369665752,BICD 100R,A01,202018,Smith; Laurie,0,7,32,32
1683369665752,BICD 100R,A02,202019,Smith; Laurie,0,2,32,32
1683369665752,BICD 100R,A03,202020,Smith; Laurie,0,1,32,32
1683369665752,BICD 100R,A04,202021,Smith; Laurie,9,0,32,23
1683369665752,BICD 100R,A05,202022,Smith; Laurie,12,0,32,20
1683369666778,BICD 136,A01,193242,Gustafson-Brown; Cindy,0,2,32,32
1683369666778,BICD 136,A02,193244,Gustafson-Brown; Cindy,14,0,32,18
1683369667814,BIEB 102,A01,193249,Butler; Shannon Rhey,0,2,32,32
1683369667814,BIEB 102,A02,193251,Butler; Shannon Rhey,0,0,32,32
1683369667814,BIEB 102,A03,193253,Butler; Shannon Rhey,0,1,32,32
1683369667814,BIEB 102,A04,193255,Butler; Shannon Rhey,17,0,32,15
1683369667814,BIEB 102,A05,193265,Butler; Shannon Rhey,26,0,32,6
1683369667814,BIEB 102,A06,193269,Butler; Shannon Rhey,16,0,32,16
1683369669866,BIEB 150,A01,193274,Staff,0,0,32,32
1683369669866,BIEB 150,A02,193285,Staff,23,0,32,9
1683369670893,BIEB 194,A00,193286,Kurle; Carolyn M.,22,0,32,10
1683369671925,BILD 1,A01,192291,Staff,16,0,32,16
1683369671925,BILD 1,A02,192292,Staff,30,0,32,2
1683369671925,BILD 1,B01,192520,Reuther; Keefe,0,1,0,0
1683369671925,BILD 1,B02,192532,Reuther; Keefe,0,1,0,0
1683369672956,BILD 3,A01,192556,Butler; Shannon Rhey,0,0,32,32
1683369672956,BILD 3,A02,192581,Butler; Shannon Rhey,4,0,32,28
1683369672956,BILD 3,A03,192611,Butler; Shannon Rhey,23,0,32,9
1683369672956,BILD 3,A04,192612,Butler; Shannon Rhey,25,0,32,7
1683369672956,BILD 3,A05,192613,Butler; Shannon Rhey,27,0,32,5
1683369672956,BILD 3,A06,192679,Butler; Shannon Rhey,27,0,32,5
1683369672956,BILD 3,A07,192682,Butler; Shannon Rhey,21,0,32,11
1683369673982,BILD 4,A01,192836,Reuther; Keefe,0,0,24,24
1683369673982,BILD 4,A02,193044,Reuther; Keefe,4,0,24,20
1683369675007,BILD 10,A01,193142,Gustafson-Brown; Cindy,30,0,32,2
1683369675007,BILD 10,A02,193149,Gustafson-Brown; Cindy,31,0,32,1
1683369676031,BIMM 100,A01,193301,Staff,1,6,32,31
1683369676031,BIMM 100,A02,193312,Staff,0,5,32,32
1683369676031,BIMM 100,A03,193323,Staff,0,8,32,32
1683369677057,BIMM 101,A01,193329,McDonnell; Lisa Marie,0,3,24,24
1683369677057,BIMM 101,A02,193339,McDonnell; Lisa Marie,0,3,24,24
1683369677057,BIMM 101,B01,193354,McDonnell; Lisa Marie,0,3,24,24
1683369677057,BIMM 101,B02,193357,McDonnell; Lisa Marie,0,3,24,24
1683369678082,BIMM 110,A01,193377,Tat; John,0,11,32,32
1683369678082,BIMM 110,A02,193378,Tat; John,0,9,32,32
1683369679109,BIMM 120,A01,206116,Staff,0,0,32,32
1683369679109,BIMM 120,A02,206117,Staff,8,0,32,24
1683369679109,BIMM 120,A03,206121,Staff,21,0,32,11
1683369680135,BIPN 100,A01,193393,Park; Ji Young,0,14,32,32
1683369680135,BIPN 100,A02,193402,Park; Ji Young,0,13,32,32
1683369680135,BIPN 100,A03,193413,Park; Ji Young,0,14,32,32
1683369680135,BIPN 100,A04,193414,Park; Ji Young,0,13,32,32
1683369681159,BIPN 102,A01,193429,Staff,0,0,32,32
1683369681159,BIPN 102,A02,193438,Staff,22,0,32,10
1683369682183,BIPN 106,A01,193450,Reyes Gonzalez; Catalina,0,2,40,40
1683369683212,BIPN 134,A01,193465,Cooke; James Edward,1,0,32,31
1683369683212,BIPN 134,A02,193474,Cooke; James Edward,25,0,32,7
1683369683212,BIPN 134,A03,193485,Cooke; James Edward,29,0,32,3
1683369683212,BIPN 134,A04,193486,Cooke; James Edward,21,0,32,11
1683369683212,BIPN 134,A05,193491,Cooke; James Edward,31,0,32,1
1683369683212,BIPN 134,A06,193501,Cooke; James Edward,30,0,32,2
1683369683212,BIPN 134,A07,193510,Cooke; James Edward,29,0,32,3
1683369685270,BISP 194,A00,222522,Staff,14,0,32,18
1683369686295,CAT 124,A01,202407,Staff,19,0,25,6
1683369687375,CAT 125,A00,202408,Marchisotto; Jennifer Anne,4,0,20,16
1683369688400,CAT 125R,A00,202409,Smith; Lauryn Alissa,0,11,20,20
1683369688400,CAT 125R,B00,202410,Morales; Celeste Georgianna,0,11,20,20
1683369688400,CAT 125R,C00,202411,Irwin; Matthew Joseph,0,10,20,20
1683369689425,CENG 15,A01,204712,Yang; Kesong,0,1,0,0
1683369690450,CENG 114,A00,202070,Jahed Motlagh; Zeinab,5,0,20,15
1683369691480,CGS 105,A00,185477,Wesling; Megan E.,24,0,40,16
1683369692507,CGS 106,A00,185494,Staff,13,0,22,9
1683369693531,CGS 108,A00,185495,Staff,14,0,20,6
1683369694555,CGS 114,A00,185496,Staff,13,0,18,5
1683369695581,CGS 119,A00,185501,Staff,15,0,20,5
1683369696606,CGS 120,A00,185511,Staff,13,0,20,7
1683369697637,CHEM 4,A01,184675,Bussey; Thomas J,96,0,100,4
1683369698663,CHEM 6A,A01,184677,Staff,34,0,60,26
1683369699687,CHEM 6B,A01,184679,Staff,65,0,100,35
1683369700712,CHEM 6C,A01,184681,Bussey; Thomas J,1,0,50,49
1683369700712,CHEM 6C,A02,184682,Bussey; Thomas J,34,0,50,16
1683369701742,CHEM 40A,A01,184684,Albizati; Kim F.,37,0,100,63
1683369702772,CHEM 40B,A01,184686,Albizati; Kim F.,0,20,100,100
1683369703797,CHEM 41B,A01,184690,Staff,52,0,100,48
1683369704821,COGS 3,A01,184715,Boyle; Mary E. T.,0,25,40,40
1683369705845,COGS 14B,A01,185172,Staff,0,15,38,38
1683369706870,COGS 18,A01,184736,Staff,16,0,80,64
1683369707896,COGS 100,A01,184932,Staff,0,5,73,73
1683369708923,COGS 101A,A01,184935,Staff,0,39,30,30
1683369709951,COGS 101B,A01,184944,Staff,0,2,30,30
1683369710978,COGS 101C,A01,184946,Staff,0,12,30,30
1683369712006,COGS 102A,A01,184951,Johnson; Christine M.,2,0,40,38
1683369713035,COGS 107B,A01,184953,Mooshagian; Eric Frederick,0,50,40,40
1683369714062,COGS 118B,A01,184959,Gupta; Anjum,0,48,40,40
1683369715089,COGS 153,A00,184961,Staff,0,15,30,30
1683369716114,COGS 177,A00,184962,Staff,0,20,30,30
1683369717144,COGS 187A,A01,184969,Boyle; Mary E. T.,0,17,40,40
1683369718168,COMM 10,A01,185174,Staff,0,5,25,25
1683369718168,COMM 10,A02,185189,Staff,0,5,25,25
1683369718168,COMM 10,A03,269821,Staff,0,0,0,0
1683369719194,COMM 100B,A01,185475,Staff,0,0,0,2
1683369719194,COMM 100B,A02,185476,Staff,13,0,25,12
1683369720218,COMM 100C,A01,185314,Staff,1,0,25,24
1683369720218,COMM 100C,A02,185327,Staff,19,0,25,6
1683369721242,COMM 110M,A00,185349,Staff,2,0,40,38
1683369722269,COMM 113T,A00,185352,Staff,24,0,40,16
1683369723294,COMM 114I,A00,185353,Staff,33,0,40,7
1683369724323,COMM 131,A00,185354,Staff,19,0,30,11
1683369725353,CSE 8A,A50,185358,Cao; Yingjun,0,46,10,10
1683369726382,CSE 8B,A01,185362,Staff,0,46,50,50
1683369727408,CSE 11,A01,185416,Cao; Yingjun,0,92,10,10
1683369728437,CSE 20,A01,185445,Briones; Jor-el Thomas Caparas,5,0,25,20
1683369729466,CSE 21,A01,185447,Staff,10,0,50,40
1683369730498,CSE 101,A01,185451,Staff,0,13,50,50
1683369730498,CSE 101,B01,185453,Jones; Miles E,0,11,50,50
1683369732550,CSE 141,A01,185458,Eldon; John,20,0,100,80
1683369733578,CSE 141L,A01,185461,Eldon; John,12,0,100,88
1683369734606,CSE 142,A01,185463,Staff,36,0,60,24
1683369734606,CSE 142,B01,201355,Staff,0,7,60,60
1683369735634,CSE 142L,A01,185470,Staff,36,0,60,24
1683369735634,CSE 142L,B01,201417,Staff,0,6,60,60
1683369736660,CSE 190,A00,201433,Staff,32,0,49,17
1683369737685,DOC 1,A01,259136,Strom; Megan C.,7,0,15,8
1683369737685,DOC 1,A02,259137,Strom; Megan C.,14,0,15,1
1683369737685,DOC 1,A03,259138,Strom; Megan C.,14,0,15,1
1683369737685,DOC 1,A04,259139,Strom; Megan C.,14,0,15,1
1683369738711,DOC 100D,A00,259140,Pass; Natalye Joann,16,0,25,9
1683369739738,DSGN 1,A01,184749,Rill; Bryan,0,25,30,30
1683369740766,DSGN 100,A01,185168,Staff,0,2,25,25
1683369741790,ECE 5,A01,185626,Morris; Karcher William,0,10,0,0
1683369742815,ECE 101,A01,185628,Staff,17,0,70,53
1683369743840,ECE 107,A01,185635,Baghdadchi; Saharnaz,0,0,20,20
1683369743840,ECE 107,A02,185638,Baghdadchi; Saharnaz,4,0,20,16
1683369744868,ECE 148,A01,185647,Silberman; Jack,0,0,16,16
1683369745895,ECON 1,A01,185537,Crane; Meredith Helen,54,0,70,16
1683369746922,ECON 3,A01,185549,Crane; Meredith Helen,32,0,70,38
1683369747949,ECON 4,A01,203354,Anderson; John Charles,0,4,10,10
1683369748979,ECON 100A,A01,185574,Staff,0,4,40,40
1683369750004,ECON 100B,A01,185576,Staff,0,12,50,50
1683369751030,ECON 100C,A01,185589,Newhouse; Herbert S,29,0,70,41
1683369752072,ECON 105,A00,185608,Vespa; Emanuel Ignacio,19,0,35,16
1683369753100,ECON 109,A01,185610,Shishkin; Denis,10,0,35,25
1683369754124,ECON 110A,A01,185612,Staff,11,0,40,29
1683369755147,ECON 120A,A01,185615,Staff,20,0,40,20
1683369756170,ECON 120C,A01,185617,Sun; Yixiao,0,21,70,70
1683369757200,ECON 144,A00,203346,Squires; Dale E,3,0,35,32
1683369758228,ECON 171,A01,203349,Newhouse; Herbert S,0,1,35,35
1683369759253,ECON 173A,A01,185621,Toda; Alexis Akira,21,0,35,14
1683369760287,EDS 25,A01,202413,Staff,0,1,0,0
1683369760287,EDS 25,A02,202414,Staff,0,1,0,0
1683369760287,EDS 25,A03,202415,Staff,0,0,0,0
1683369760287,EDS 25,A04,202416,Staff,0,1,0,0
1683369760287,EDS 25,A05,202439,Staff,0,0,0,0
1683369760287,EDS 25,A06,202440,Staff,0,0,0,0
1683369760287,EDS 25,B01,202631,Staff,0,0,0,0
1683369760287,EDS 25,B02,202632,Staff,0,0,0,0
1683369760287,EDS 25,B03,202639,Staff,0,0,0,0
1683369760287,EDS 25,B04,202640,Staff,0,0,0,0
1683369760287,EDS 25,B05,202643,Staff,0,0,0,0
1683369760287,EDS 25,B06,202644,Staff,0,0,0,0
1683369761315,EDS 38,A01,202659,Black; Alison Michelle,24,0,25,1
1683369762339,EDS 115,A00,202652,Staff,18,0,30,12
1683369763362,EDS 125,A00,202649,Staff,14,0,30,16
1683369764387,EDS 126,A01,203332,Staff,30,0,30,0
1683369765412,EDS 139,A00,202838,Staff,16,0,25,9
1683369766437,EDS 146,A01,202655,Staff,14,0,25,11
1683369767465,ENG 15,A00,185667,Staff,0,1,0,0
1683369767465,ENG 15,B00,185672,Staff,0,0,0,0
1683369767465,ENG 15,C00,185675,Staff,0,0,0,0
1683369767465,ENG 15,D00,185682,Staff,0,0,0,0
1683369767465,ENG 15,E00,185684,Staff,0,0,0,0
1683369768492,ETHN 103,A00,185710,Staff,0,4,35,35
1683369769527,ETHN 103A,A00,199228,Man; Simeon S,2,0,9,7
1683369770555,ETHN 109,A00,185711,Staff,18,0,35,17
1683369771582,ETHN 142,A00,185726,Staff,0,4,30,30
1683369772606,ETHN 163J,A00,199229,Man; Simeon S,5,0,8,3
1683369773633,ETHN 168,A00,185727,Staff,8,0,10,2
1683369774656,ETHN 182,A00,185728,Staff,0,0,35,35
1683369775680,ETHN 183,A00,185737,Staff,8,0,18,10
1683369776703,GLBH 111,A01,209361,Burgos; Jose L.,0,0,0,0
1683369778749,HIEU 104,A00,185792,Staff,16,0,20,4
1683369779777,HIEU 115,A00,185800,Staff,1,0,20,19
1683369780803,HIEU 128,A00,185801,Staff,0,7,20,20
1683369781828,HIEU 147,A00,185802,Staff,16,0,20,4
1683369782854,HIEU 154,A00,185823,Staff,12,0,20,8
1683369783878,HILA 102,A00,185826,Staff,13,0,20,7
1683369784903,HILD 2C,A01,185778,Staff,0,12,20,20
1683369785930,HILD 7B,A01,185780,Kwak; Nancy,0,15,32,32
1683369785930,HILD 7B,A02,185781,Kwak; Nancy,0,18,32,32
1683369786954,HILD 30,A01,185791,Staff,14,0,20,6
1683369787978,HISC 119,A00,185830,Golan; Tal,0,9,20,20
1683369789003,HITO 156GS,A00,185831,Patterson; Patrick H.,0,0,0,23
1683369790027,HIUS 103,A00,185832,Man; Simeon S,1,6,20,19
1683369791103,HIUS 117,A00,185836,Kwak; Nancy,2,0,20,18
1683369792150,HIUS 125,A00,185840,Man; Simeon S,0,0,23,23
1683369793173,HIUS 149,A00,185845,Staff,0,0,20,20
1683369794204,HUM 3,A01,185882,Zavodny; Tatiana Sophia,0,7,50,50
1683369794204,HUM 3,B01,185899,Caldwell; Michael Alan,0,18,50,50
1683369795229,HUM 3GS,A00,185900,Patterson; Patrick H.,0,0,0,23
1683369796254,HUM 4,A01,185938,Zroka; Amy Liane,31,0,50,19
1683369796254,HUM 4,B01,185956,Watkins; Eric,0,3,50,50
1683369796254,HUM 4,B02,202209,Watkins; Eric,0,2,50,50
1683369796254,HUM 4,B03,202210,Watkins; Eric,0,2,50,50
1683369797289,HUM 5,A01,185958,West; Geoffrey Scott,3,0,50,47
1683369797289,HUM 5,A02,202215,West; Geoffrey Scott,0,0,50,50
1683369798316,INTL 190,A00,185959,Gagnon; Jeffrey C,0,0,0,9
1683369798316,INTL 190,B00,185960,Lettieri; Michael Joseph,0,0,0,1
1683369799339,JAPN 180,A00,254509,Staff,4,0,30,26
1683369800376,LATI 10,A01,202853,Kennemore; Amy Michelle,4,0,35,31
1683369800376,LATI 10,A02,202854,Kennemore; Amy Michelle,2,0,35,33
1683369800376,LATI 10,A03,270054,Kennemore; Amy Michelle,30,0,30,0
1683369801404,LATI 180,A00,202855,Kennemore; Amy Michelle,11,0,20,9
1683369802431,LAWS 101,A00,201767,Golan; Tal,0,7,40,40
1683369803457,LIFR 1C,A00,185961,Staff,6,0,20,14
1683369804484,LIFR 1CX,A00,185962,Staff,7,0,20,13
1683369805509,LIFR 1D,A00,185963,Staff,9,0,20,11
1683369806533,LIFR 1DX,A00,185964,Staff,9,0,20,11
1683369807556,LIGN 101,A01,186039,Staff,43,0,50,7
1683369808582,LIGN 165,A00,186040,Staff,18,0,50,32
1683369809609,LTCS 108,A00,186041,Staff,6,0,10,4
1683369810634,LTCS 119,A00,186042,Staff,16,0,20,4
1683369811658,LTCS 130,A00,186043,Wesling; Megan E.,15,0,25,10
1683369813714,LTEA 138,A00,186119,Staff,14,0,40,26
1683369814739,LTEN 124,A00,186148,Staff,6,0,25,19
1683369815765,LTEN 178,A00,186149,Staff,7,0,15,8
1683369816791,LTEN 181,A00,186150,Blanco; John D,33,0,40,7
1683369817816,LTWL 120,A00,186160,Staff,20,0,25,5
1683369818844,LTWL 165,A00,186161,Staff,22,0,25,3
1683369819869,LTWR 100,A00,186162,Staff,0,5,15,15
1683369820894,LTWR 102,A00,186163,Doller; Ben,5,0,15,10
1683369821923,MAE 8,A01,186412,Staff,0,0,0,0
1683369822947,MAE 30B,A00,186445,Bahadori; Mohammad Yousef,83,0,100,17
1683369823976,MAE 40,A00,186592,Bewley; Thomas R,10,0,50,40
1683369825014,MAE 101B,A00,186593,Bahadori; Mohammad Yousef,81,0,100,19
1683369826040,MAE 105,A00,186594,Bandaru; Prabhakar,12,0,50,38
1683369827064,MAE 107,A00,186599,Pham; Hieu Tan,0,7,120,120
1683369828090,MAE 148,A01,186660,Silberman; Jack,3,0,16,13
1683369829115,MATH 10A,A01,188095,Staff,0,5,35,35
1683369830142,MATH 10B,A01,188097,Bowers; Adam R.,0,11,30,30
1683369830142,MATH 10B,A02,188099,Bowers; Adam R.,0,11,30,30
1683369830142,MATH 10B,B01,188104,Bowers; Adam R.,0,10,30,30
1683369830142,MATH 10B,B02,188106,Bowers; Adam R.,0,10,30,30
1683369831167,MATH 10C,A01,188111,Staff,0,18,30,30
1683369831167,MATH 10C,A02,188127,Staff,0,17,30,30
1683369831167,MATH 10C,A03,188131,Staff,0,18,30,30
1683369831167,MATH 10C,B01,188218,Staff,18,0,30,12
1683369831167,MATH 10C,B02,188244,Staff,13,0,30,17
1683369831167,MATH 10C,B03,188277,Staff,16,0,30,14
1683369832192,MATH 18,A01,188344,Bach; Quang Tran,18,0,30,12
1683369832192,MATH 18,A02,188345,Bach; Quang Tran,11,0,30,19
1683369832192,MATH 18,B01,188353,Bach; Quang Tran,10,0,30,20
1683369832192,MATH 18,B02,188354,Bach; Quang Tran,20,0,30,10
1683369833217,MATH 20A,A01,188374,Staff,12,0,35,23
1683369834242,MATH 20B,A01,188382,Ohm; Ko Woon,6,0,30,24
1683369834242,MATH 20B,A02,188383,Ohm; Ko Woon,21,0,30,9
1683369834242,MATH 20B,B01,188385,Ohm; Ko Woon,7,0,30,23
1683369834242,MATH 20B,B02,188392,Ohm; Ko Woon,22,0,30,8
1683369835267,MATH 20C,A01,188394,Harel; Guershon,10,0,30,20
1683369835267,MATH 20C,A02,188395,Harel; Guershon,15,0,30,15
1683369835267,MATH 20C,B01,188404,Harel; Guershon,4,0,30,26
1683369835267,MATH 20C,B02,188405,Harel; Guershon,19,0,30,11
1683369836293,MATH 20D,A01,188414,Hammock; Frances H,0,1,30,30
1683369836293,MATH 20D,A02,188415,Hammock; Frances H,3,0,30,27
1683369836293,MATH 20D,B01,188447,Hammock; Frances H,1,0,30,29
1683369836293,MATH 20D,B02,188486,Hammock; Frances H,8,0,30,22
1683369837321,MATH 20E,A01,188649,Staff,21,0,30,9
1683369837321,MATH 20E,A02,188650,Staff,23,0,30,7
1683369837321,MATH 20E,A03,188673,Staff,0,0,30,30
1683369838348,MATH 102,A01,188675,Staff,0,35,35,35
1683369839377,MATH 103B,A01,188681,Staff,3,0,35,32
1683369839377,MATH 103B,B01,188692,Staff,5,0,35,30
1683369840406,MATH 109,A01,188695,Salehi Golsefidy; Alireza,25,0,35,10
1683369840406,MATH 109,A02,188696,Salehi Golsefidy; Alireza,25,0,35,10
1683369841430,MATH 120A,A01,188698,Eggers; John Dietrich,7,0,35,28
1683369842456,MATH 142B,A01,188736,Ioana; Adrian,0,2,30,30
1683369842456,MATH 142B,A02,188741,Ioana; Adrian,0,0,30,30
1683369842456,MATH 142B,A03,188743,Ioana; Adrian,0,1,30,30
1683369843486,MATH 168A,A01,188790,Staff,0,9,35,35
1683369844516,MATH 170A,A01,188803,Nie; Jiawang,0,2,35,35
1683369844516,MATH 170A,A02,188811,Nie; Jiawang,0,0,35,35
1683369844516,MATH 170A,A03,188814,Nie; Jiawang,1,0,35,34
1683369844516,MATH 170A,A04,188815,Nie; Jiawang,13,0,35,22
1683369845541,MATH 193B,A01,188817,Staff,0,0,35,35
1683369845541,MATH 193B,A02,188818,Staff,5,0,35,30
1683369846565,MGT 4,A01,202857,Anderson; John Charles,61,0,80,19
1683369847589,MGT 12,A00,202858,Lindenberger; Wade Douglas,41,0,90,49
1683369848616,MGT 18,A00,202859,Staff,74,0,90,16
1683369849639,MGT 18GS,A00,202860,McKay; Michael J,13,0,28,15
1683369850664,MGT 45,A00,202861,Pecore; Joseph P.,15,0,90,75
1683369851689,MGT 100,A00,202863,Yavorsky; Daniel Ryan,28,0,90,62
1683369852712,MGT 103,A00,202864,Ehrich; Kristine R,0,17,90,90
1683369853736,MGT 112,A00,202865,Ehrich; Kristine R,15,0,90,75
1683369854766,MGT 121A,A00,202868,Staff,0,20,0,0
1683369855793,MGT 131B,A00,202869,Anderson; John Charles,59,0,90,31
1683369856819,MGT 136,A00,202871,Lindenberger; Wade Douglas,84,0,90,6
1683369857846,MGT 164,A00,202873,Staff,0,68,90,91
1683369858870,MGT 164GS,A00,202874,McKay; Mary A,13,0,28,15
1683369859893,MGT 180,A00,202875,Staff,0,50,90,91
1683369860921,MMW 11R,A01,205019,Herbst; Matthew,3,0,30,27
1683369860921,MMW 11R,A02,205026,Herbst; Matthew,29,0,30,1
1683369861952,MMW 15,A01,193512,Chang; Edmond Yi-Teh,0,9,28,28
1683369861952,MMW 15,A02,193513,Chang; Edmond Yi-Teh,0,5,28,28
1683369861952,MMW 15,A03,193514,Chang; Edmond Yi-Teh,0,5,28,28
1683369861952,MMW 15,A04,193515,Chang; Edmond Yi-Teh,0,5,28,28
1683369861952,MMW 15,A05,193516,Chang; Edmond Yi-Teh,0,4,28,28
1683369861952,MMW 15,A06,193517,Chang; Edmond Yi-Teh,0,5,28,28
1683369861952,MMW 15,B01,193519,Chang; Edmond Yi-Teh,0,5,28,28
1683369861952,MMW 15,B02,193520,Chang; Edmond Yi-Teh,0,5,28,28
1683369861952,MMW 15,B03,193521,Chang; Edmond Yi-Teh,0,5,28,28
1683369861952,MMW 15,B04,193522,Chang; Edmond Yi-Teh,0,4,28,28
1683369861952,MMW 15,B05,193523,Chang; Edmond Yi-Teh,0,5,28,28
1683369861952,MMW 15,B06,193524,Chang; Edmond Yi-Teh,0,4,28,28
1683369862976,MMW 122,A01,193526,Rahimi; Babak,0,15,28,28
1683369862976,MMW 122,A02,193527,Rahimi; Babak,0,14,28,28
1683369862976,MMW 122,A03,193528,Rahimi; Babak,0,0,0,0
1683369862976,MMW 122,A04,193529,Rahimi; Babak,0,0,0,0
1683369864000,MUS 1A,A01,186663,Staff,0,20,35,35
1683369865026,MUS 4,A01,186715,Staff,0,12,35,35
1683369866051,MUS 5R,A01,186796,Dubnov; Shlomo,0,17,35,35
1683369867076,MUS 6,A01,186798,Staff,0,4,25,25
1683369868099,MUS 7,A01,186830,Staff,13,0,35,22
1683369869124,MUS 8,A01,186930,Staff,0,26,35,35
1683369870148,MUS 15,A01,186932,Staff,0,16,35,35
1683369870148,MUS 15,B01,186934,Staff,0,15,35,35
1683369871174,MUS 80,A00,186935,Staff,0,0,20,20
1683369871174,MUS 80,B00,186936,Staff,25,0,25,0
1683369872200,NANO 11,A00,204702,Lipomi; Darren John,0,0,0,0
1683369873226,NANO 15,A01,204709,Yang; Kesong,0,1,0,0
1683369874252,NANO 114,A00,202069,Jahed Motlagh; Zeinab,3,0,10,7
1683369875281,PHIL 1,A00,186955,Grush; Rick Scott,32,0,40,8
1683369876310,PHIL 10,A01,186973,Grush; Rick Scott,28,0,35,7
1683369876310,PHIL 10,A02,186974,Grush; Rick Scott,33,0,35,2
1683369877338,PHIL 13,A01,186976,Staff,7,0,35,28
1683369877338,PHIL 13,A02,186977,Staff,16,0,35,19
1683369878362,PHIL 14,A01,186979,Staff,31,0,35,4
1683369878362,PHIL 14,A02,186986,Staff,32,0,35,3
1683369879386,PHIL 28,A01,186988,Staff,16,0,30,14
1683369879386,PHIL 28,A02,186989,Staff,1,0,30,29
1683369879386,PHIL 28,A03,186990,Staff,9,0,30,21
1683369879386,PHIL 28,A04,186991,Staff,26,0,30,4
1683369880412,PHIL 120,A00,186997,Staff,23,0,40,17
1683369881435,PHIL 137,A00,187003,Staff,9,0,40,31
1683369882459,PHIL 150,A00,187015,Staff,47,0,70,23
1683369883488,PHIL 167,A00,187021,Lamey; Andy M.,35,0,40,5
1683369884512,PHIL 174,A01,202226,Staff,17,0,20,3
1683369884512,PHIL 174,A02,202235,Staff,20,0,20,0
1683369885536,PHIL 191A,A00,258918,Staff,0,0,1,1
1683369886560,PHYS 1A,A00,187028,Staff,27,0,60,33
1683369887584,PHYS 1AL,001,187036,Staff,2,0,30,28
1683369887584,PHYS 1AL,002,187049,Staff,18,0,30,12
1683369888609,PHYS 1B,A00,187058,Staff,22,0,60,38
1683369889634,PHYS 1BL,001,187064,Staff,0,0,30,30
1683369889634,PHYS 1BL,002,187070,Staff,5,0,30,25
1683369890659,PHYS 1C,A00,187082,Staff,31,0,120,89
1683369891684,PHYS 1CL,001,187088,Staff,0,9,30,30
1683369891684,PHYS 1CL,002,187089,Staff,0,2,30,30
1683369891684,PHYS 1CL,009,262693,Staff,11,0,30,19
1683369892708,PHYS 2B,A01,187097,Staff,54,0,115,61
1683369893733,PHYS 2C,A01,187099,Staff,67,0,115,48
1683369894810,PHYS 2CL,A01,187101,Staff,5,0,28,23
1683369894810,PHYS 2CL,A02,187102,Staff,15,0,28,13
1683369895835,PHYS 2D,A01,187123,Shotwell; Brian,95,0,115,20
1683369896862,PHYS 4B,A01,187133,Grinstein; Benjamin,35,0,50,15
1683369897889,POLI 10,A00,188819,Staff,0,4,50,50
1683369898915,POLI 11,A00,188827,Staff,43,0,50,7
1683369899941,POLI 13R,A00,188828,Staff,0,1,20,20
1683369900967,POLI 27,A01,188830,Elgin; Samuel Zincke,0,1,70,70
1683369901992,POLI 30,A00,188832,Desposato; Scott,31,0,50,19
1683369903016,POLI 102F,A00,188834,Staff,2,0,40,38
1683369904040,POLI 104A,A00,188852,Staff,14,0,30,16
1683369905062,POLI 104I,A00,188853,Staff,0,6,20,20
1683369906090,POLI 110B,A00,188854,Wiens; David,7,0,20,13
1683369907118,POLI 112A,A00,188855,Wiens; David,5,0,30,25
1683369908145,POLI 117R,A00,188856,Forman; Fonna,0,11,20,20
1683369909168,POLI 118,A00,188857,Ingham; Sean,8,0,20,12
1683369910193,POLI 120G,A00,188858,Staff,9,0,30,21
1683369911218,POLI 131CR,A00,188863,Hoston; Germaine,23,0,50,27
1683369912242,POLI 133,A00,188864,Nellis; Gareth Hb,44,0,50,6
1683369913264,POLI 134D,A00,188865,Desposato; Scott,27,0,30,3
1683369914290,POLI 142A,A00,188871,Gartzke; Erik,22,0,50,28
1683369915312,POLI 142K,A00,188874,Staff,38,0,50,12
1683369916335,POLI 143,A00,188940,Gartzke; Erik,16,0,30,14
1683369917362,POLI 153,A00,188943,Staff,3,0,20,17
1683369918389,POLI 160AA,A00,188944,Staff,11,0,40,29
1683369919413,POLI 170A,A00,188945,Staff,11,0,30,19
1683369921460,PSYC 1,A00,188952,Staff,37,0,90,53
1683369922484,PSYC 2,B00,188953,Staff,19,0,35,16
1683369923510,PSYC 6,A00,188970,Staff,47,0,60,13
1683369924539,PSYC 7,A00,188973,Staff,37,0,45,8
1683369925568,PSYC 60,A01,188980,Rickard; Timothy C.,43,0,60,17
1683369926597,PSYC 70,A01,189001,Steiner; Eric Tomas,23,0,45,22
1683369927625,PSYC 100,A00,189005,Lacefield; Katharine I,0,98,120,120
1683369928648,PSYC 102,A00,189008,Staff,9,0,30,21
1683369929675,PSYC 106,B00,189026,Gorman; Michael R.,34,0,60,26
1683369930702,PSYC 114,B01,189033,Winkielman; Piotr,0,32,30,30
1683369931729,PSYC 131,A00,189036,Anagnostaras; Stephan,0,43,60,60
1683369932756,PSYC 136,A00,189041,Lowe; Angela Beth,0,7,25,25
1683369933783,PSYC 137,A00,189057,Winkielman; Piotr,0,34,25,25
1683369934811,PSYC 144,A00,189107,Wixted; John T,0,7,50,50
1683369936866,PSYC 162,A00,189142,Staff,0,8,85,85
1683369937890,PSYC 172,A00,189144,Gorman; Michael R.,0,7,30,30
1683369939937,PSYC 179,A00,189146,Lacefield; Katharine I,0,84,120,120
1683369940961,PSYC 181,A00,189147,Anagnostaras; Stephan,0,44,90,90
1683369941985,PSYC 190R,A00,189148,Barner; David A.,0,22,80,80
1683369943009,PSYC 191,A00,189275,Rickard; Timothy C.,0,7,25,25
1683369944038,PSYC 193,A00,189276,Chapman; Eddie Nathaniel,0,1,0,4
1683369945063,PSYC 193L,A01,189281,Lowe; Angela Beth,12,0,20,8
1683369945063,PSYC 193L,B01,189285,Staff,28,0,35,7
1683369946086,RELI 149,A00,187137,Rahimi; Babak,7,0,40,33
1683369947110,SE 9,A01,187315,Staff,0,2,18,18
1683369948134,SE 101B,A00,187409,Staff,24,0,30,6
1683369949159,SE 110B,A00,187444,Staff,10,0,40,30
1683369950183,SE 130B,A00,187449,Staff,31,0,40,9
1683369951207,SE 150A,A00,187516,Staff,9,0,20,11
1683369952233,SE 154,A00,187528,Staff,30,0,50,20
1683369953260,SIO 3,A01,258171,Staff,35,0,40,5
1683369954286,SIO 10,A00,187144,Cook; Geoffrey W,0,3,75,75
1683369955313,SIO 45,A00,187152,Cook; Geoffrey W,1,0,100,99
1683369956341,SIO 109R,A00,194486,Staff,0,3,20,20
1683369958394,SIO 187,A01,187233,Kacev; David,12,0,40,28
1683369959422,SOCI 1,A01,258656,Thorpe; Charles Robert,28,0,30,2
1683369959422,SOCI 1,A02,258658,Thorpe; Charles Robert,30,0,30,0
1683369959422,SOCI 1,A03,258661,Thorpe; Charles Robert,25,0,25,0
1683369959422,SOCI 1,A04,258666,Thorpe; Charles Robert,22,0,25,3
1683369959422,SOCI 1,A05,258897,Thorpe; Charles Robert,23,0,25,2
1683369959422,SOCI 1,A06,258898,Thorpe; Charles Robert,25,0,25,0
1683369960446,SOCI 30,A01,258903,Pardo Guerra; Juan Pablo,15,0,30,15
1683369961469,SOCI 102,A00,258904,Staff,9,0,25,16
1683369962493,SOCI 106,A00,258905,Staff,19,0,25,6
1683369963521,SOCI 111,A00,258907,Ribas Norris; Janet Vanesa,26,0,30,4
1683369964548,SOCI 121R,A00,258908,Pardo Guerra; Juan Pablo,10,0,30,20
1683369965576,SOCI 126,A01,203330,Staff,14,0,20,6
1683369966601,SOCI 131,A00,258909,Thorpe; Charles Robert,31,0,60,29
1683369967624,SOCI 135,A00,258910,Payne; Christine Anna,0,9,30,30
1683369968648,SOCI 157,A00,258911,Staff,12,0,30,18
1683369969673,SOCI 184,A00,258912,Staff,25,0,30,5
1683369970695,SOCI 188D,A00,258913,Staff,22,0,30,8
1683369971720,SYN 2,001,187529,Staff,10,0,16,6
1683369971720,SYN 2,002,201452,Staff,0,18,16,16
1683369971720,SYN 2,003,201469,Staff,3,0,16,13
1683369972744,SYN 100,A01,187531,Staff,0,9,20,20
1683369972744,SYN 100,B01,201491,Staff,0,12,20,20
1683369973768,TDAC 1,A00,189286,Walsh; Kim C.,3,0,20,17
1683369973768,TDAC 1,B00,189287,Harting; Carla Kelso,11,0,20,9
1683369974796,TDAC 101,A00,189300,Walsh; Kim C.,16,0,20,4
1683369974796,TDAC 101,B00,189301,Harting; Carla Kelso,18,0,20,2
1683369975823,TDAC 102,A00,189304,Basso; Beatrice,14,0,20,6
1683369976849,TDAC 108,A00,189305,Staff,18,0,20,2
1683369977876,TDDE 131,A00,189310,Staff,19,0,20,1
1683369977876,TDDE 131,B00,189314,Staff,19,0,20,1
1683369977876,TDDE 131,C00,189315,Staff,48,0,50,2
1683369977876,TDDE 131,D00,189316,Staff,14,0,15,1
1683369977876,TDDE 131,E00,204841,Staff,20,0,20,0
1683369978899,TDGE 10,A00,189289,Staff,30,0,50,20
1683369978899,TDGE 10,B00,189290,Havis; Allan,1,0,50,49
1683369979925,TDGE 11,A00,189291,Fulton; Julia,0,3,50,50
1683369979925,TDGE 11,B00,189292,Staff,20,0,25,5
1683369979925,TDGE 11,C00,260270,Staff,0,0,0,0
1683369980950,TDGE 25,A00,189294,Staff,3,0,20,17
1683369981975,TDGE 124,A00,189318,Fulton; Julia,0,8,50,50
1683369983006,TDGE 125,A00,189319,Staff,13,0,25,12
1683369983006,TDGE 125,B00,189320,Staff,23,0,25,2
1683369984033,TDGE 127,A00,189322,Havis; Allan,0,0,50,50
1683369985061,TDHT 101,A00,189323,Staff,18,0,25,7
1683369985061,TDHT 101,B00,189324,Staff,25,0,25,0
1683369986089,TDHT 102,A00,189325,Staff,49,0,50,1
1683369987114,TDMV 1,A00,189295,Arcidiacono; Kristin,19,0,30,11
1683369987114,TDMV 1,B00,189296,Caligagan; Maria T.,24,0,30,6
1683369988138,TDMV 2,A00,189297,Sammartano; Tonnie,28,0,30,2
1683369988138,TDMV 2,B00,189299,Arcidiacono; Kristin,24,0,30,6
1683369989162,TDMV 3,A00,204998,Rincon; Alicia,22,0,30,8
1683369990186,TDMV 120,A00,189458,Sammartano; Tonnie,28,0,30,2
1683369991215,TDMV 138,A00,189541,Jun; Grace Shin Hae,22,0,40,18
1683369992244,TDMV 142,A00,189717,Caligagan; Tony,24,0,30,6
1683369992244,TDMV 142,B00,189718,Caligagan; Maria T.,25,0,30,5
1683369993268,TMC 2,A01,187533,Staff,25,0,25,0
1683369993268,TMC 2,A02,187534,Staff,25,0,25,0
1683369994296,USP 1,A01,187536,Kwak; Nancy,0,16,25,25
1683369995324,USP 5,A01,187538,Staff,10,0,25,15
1683369996351,USP 101,A00,199253,Staff,0,4,0,0
1683369997379,USP 124,A00,187562,Boomhower; Matthew Charles,1,0,30,29
1683369998463,USP 138,A00,187582,Staff,20,0,25,5
1683369999492,USP 152,A01,187597,Staff,4,0,25,21
1683370000521,USP 153,A00,187598,Staff,19,0,25,6
1683370001547,USP 168,A00,187607,Kwak; Nancy,2,0,5,3
1683370002570,USP 173,A00,187619,Staff,4,0,25,21
1683370003595,USP 181,A00,187638,Staff,0,3,25,25
1683370004621,VIS 103,A00,187650,Cruz; Edwin Teddy,22,0,75,53
1683370005646,VIS 110D,A00,187669,Staff,12,0,22,10
1683370006675,VIS 127C,A00,187720,Shen; Kuiyi,67,0,146,79
1683370007706,VIS 149,A00,187731,Yoldas; Pinar,0,14,22,22
1683370008733,VIS 151,A01,188091,Staff,22,0,34,12
1683370008733,VIS 151,A02,188092,Staff,11,0,34,23
1683370009757,VIS 160B,A00,188093,Stalbaum; Brett,0,0,10,10
1683370011810,WCWP 10B,A00,201720,Staff,10,0,15,5
1683370011810,WCWP 10B,B00,201722,Staff,9,0,15,6
1683370012839,WCWP 100,A00,201725,Gagnon; Jeffrey C,0,0,2,2
1683370012839,WCWP 100,B00,201727,Staff,0,4,15,15
1683370016016,ANBI 133,A00,258401,Wilder; Linnea Lorene,34,0,40,6
1683370017040,ANBI 140,A00,258395,Hrvoj Mihic; Branka,18,0,25,7
1683370018063,ANSC 120,A00,258402,Bialecki; Jon Anthony,27,0,40,13
1683370019086,ANSC 144,A00,258400,Staff,14,0,40,26
1683370021136,ANSC 166,A00,258396,Parish; Steven Martin,158,0,175,17
1683370022163,ANSC 180,A00,193533,Staff,9,0,20,11
1683370023193,ANSC 188,A00,258397,Jassal; Aftab,33,0,40,7
1683370024220,ANTH 3,A01,258316,Staff,23,0,30,7
1683370025244,ANTH 5,A00,258394,Semendeferi; Ekaterini,16,0,20,4
1683370026268,ANTH 21,A01,258331,Staff,8,0,40,32
1683370027293,ANTH 103,A00,258398,Varma; Saiba,15,0,25,10
1683370028321,AWP 10,001,202034,Staff,0,0,0,0
1683370028321,AWP 10,002,202035,Staff,0,0,0,0
1683370028321,AWP 10,003,202036,Staff,0,0,0,0
1683370028321,AWP 10,004,202037,Staff,0,0,0,0
1683370028321,AWP 10,005,202038,Staff,0,0,0,0
1683370028321,AWP 10,006,202039,Staff,0,0,0,0
1683370028321,AWP 10,007,202040,Staff,0,0,0,0
1683370028321,AWP 10,008,202041,Staff,0,0,0,0
1683370028321,AWP 10,009,202042,Staff,0,0,0,0
1683370028321,AWP 10,010,202043,Staff,0,0,0,0
1683370028321,AWP 10,011,202044,Staff,0,0,0,0
1683370028321,AWP 10,012,202045,Staff,0,0,0,0
1683370028321,AWP 10,013,202046,Staff,0,0,0,0
1683370028321,AWP 10,014,202047,Staff,0,0,0,0
1683370028321,AWP 10,015,202048,Staff,0,0,0,0
1683370028321,AWP 10,016,202049,Staff,0,0,0,0
1683370028321,AWP 10,017,202050,Staff,0,0,0,0
1683370028321,AWP 10,018,202051,Staff,0,0,0,0
1683370028321,AWP 10,019,202052,Staff,0,0,0,0
1683370028321,AWP 10,020,202053,Staff,0,0,0,0
1683370028321,AWP 10,021,202054,Staff,0,0,0,0
1683370028321,AWP 10,022,202055,Staff,0,0,0,0
1683370028321,AWP 10,023,202056,Staff,0,0,0,0
1683370028321,AWP 10,024,202057,Staff,0,0,0,0
1683370028321,AWP 10,025,202058,Staff,0,0,0,0
1683370028321,AWP 10,026,202059,Staff,0,0,0,0
1683370029346,AWP 102,001,202032,Staff,0,0,0,0
1683370029346,AWP 102,002,202033,Staff,0,0,0,0
1683370030370,BENG 100,A01,254234,Taylor Amos; Alyssa C,31,0,40,9
1683370031396,BENG 196,001,270013,Engler; Adam J.,9999,0,9999,0
1683370032430,BICD 100R,A01,202018,Smith; Laurie,0,7,32,32
1683370032430,BICD 100R,A02,202019,Smith; Laurie,0,2,32,32
1683370032430,BICD 100R,A03,202020,Smith; Laurie,0,1,32,32
1683370032430,BICD 100R,A04,202021,Smith; Laurie,9,0,32,23
1683370032430,BICD 100R,A05,202022,Smith; Laurie,12,0,32,20
1683370033459,BICD 136,A01,193242,Gustafson-Brown; Cindy,0,2,32,32
1683370033459,BICD 136,A02,193244,Gustafson-Brown; Cindy,14,0,32,18
1683370034492,BIEB 102,A01,193249,Butler; Shannon Rhey,0,2,32,32
1683370034492,BIEB 102,A02,193251,Butler; Shannon Rhey,0,0,32,32
1683370034492,BIEB 102,A03,193253,Butler; Shannon Rhey,0,1,32,32
1683370034492,BIEB 102,A04,193255,Butler; Shannon Rhey,17,0,32,15
1683370034492,BIEB 102,A05,193265,Butler; Shannon Rhey,26,0,32,6
1683370034492,BIEB 102,A06,193269,Butler; Shannon Rhey,16,0,32,16
1683370036539,BIEB 150,A01,193274,Staff,0,0,32,32
1683370036539,BIEB 150,A02,193285,Staff,23,0,32,9
1683370037564,BIEB 194,A00,193286,Kurle; Carolyn M.,22,0,32,10
1683370038592,BILD 1,A01,192291,Staff,16,0,32,16
1683370038592,BILD 1,A02,192292,Staff,30,0,32,2
1683370038592,BILD 1,B01,192520,Reuther; Keefe,0,1,0,0
1683370038592,BILD 1,B02,192532,Reuther; Keefe,0,1,0,0
1683370039618,BILD 3,A01,192556,Butler; Shannon Rhey,0,0,32,32
1683370039618,BILD 3,A02,192581,Butler; Shannon Rhey,4,0,32,28
1683370039618,BILD 3,A03,192611,Butler; Shannon Rhey,23,0,32,9
1683370039618,BILD 3,A04,192612,Butler; Shannon Rhey,25,0,32,7
1683370039618,BILD 3,A05,192613,Butler; Shannon Rhey,27,0,32,5
1683370039618,BILD 3,A06,192679,Butler; Shannon Rhey,27,0,32,5
1683370039618,BILD 3,A07,192682,Butler; Shannon Rhey,21,0,32,11
1683370040647,BILD 4,A01,192836,Reuther; Keefe,0,0,24,24
1683370040647,BILD 4,A02,193044,Reuther; Keefe,4,0,24,20
1683370041671,BILD 10,A01,193142,Gustafson-Brown; Cindy,30,0,32,2
1683370041671,BILD 10,A02,193149,Gustafson-Brown; Cindy,31,0,32,1
1683370042696,BIMM 100,A01,193301,Staff,1,6,32,31
1683370042696,BIMM 100,A02,193312,Staff,0,5,32,32
1683370042696,BIMM 100,A03,193323,Staff,0,8,32,32
1683370043722,BIMM 101,A01,193329,McDonnell; Lisa Marie,0,3,24,24
1683370043722,BIMM 101,A02,193339,McDonnell; Lisa Marie,0,3,24,24
1683370043722,BIMM 101,B01,193354,McDonnell; Lisa Marie,0,3,24,24
1683370043722,BIMM 101,B02,193357,McDonnell; Lisa Marie,0,3,24,24
1683370044747,BIMM 110,A01,193377,Tat; John,0,11,32,32
1683370044747,BIMM 110,A02,193378,Tat; John,0,9,32,32
1683370045774,BIMM 120,A01,206116,Staff,0,0,32,32
1683370045774,BIMM 120,A02,206117,Staff,8,0,32,24
1683370045774,BIMM 120,A03,206121,Staff,21,0,32,11
1683370046798,BIPN 100,A01,193393,Park; Ji Young,0,14,32,32
1683370046798,BIPN 100,A02,193402,Park; Ji Young,0,13,32,32
1683370046798,BIPN 100,A03,193413,Park; Ji Young,0,14,32,32
1683370046798,BIPN 100,A04,193414,Park; Ji Young,0,13,32,32
1683370047823,BIPN 102,A01,193429,Staff,0,0,32,32
1683370047823,BIPN 102,A02,193438,Staff,22,0,32,10
1683370048851,BIPN 106,A01,193450,Reyes Gonzalez; Catalina,0,2,40,40
1683370049875,BIPN 134,A01,193465,Cooke; James Edward,1,0,32,31
1683370049875,BIPN 134,A02,193474,Cooke; James Edward,25,0,32,7
1683370049875,BIPN 134,A03,193485,Cooke; James Edward,29,0,32,3
1683370049875,BIPN 134,A04,193486,Cooke; James Edward,21,0,32,11
1683370049875,BIPN 134,A05,193491,Cooke; James Edward,31,0,32,1
1683370049875,BIPN 134,A06,193501,Cooke; James Edward,30,0,32,2
1683370049875,BIPN 134,A07,193510,Cooke; James Edward,29,0,32,3
1683370051922,BISP 194,A00,222522,Staff,14,0,32,18
1683370052948,CAT 124,A01,202407,Staff,19,0,25,6
1683370053972,CAT 125,A00,202408,Marchisotto; Jennifer Anne,4,0,20,16
1683370054998,CAT 125R,A00,202409,Smith; Lauryn Alissa,0,11,20,20
1683370054998,CAT 125R,B00,202410,Morales; Celeste Georgianna,0,11,20,20
1683370054998,CAT 125R,C00,202411,Irwin; Matthew Joseph,0,10,20,20
1683370056025,CENG 15,A01,204712,Yang; Kesong,0,1,0,0
1683370057049,CENG 114,A00,202070,Jahed Motlagh; Zeinab,5,0,20,15
1683370058078,CGS 105,A00,185477,Wesling; Megan E.,24,0,40,16
1683370059104,CGS 106,A00,185494,Staff,13,0,22,9
1683370060127,CGS 108,A00,185495,Staff,14,0,20,6
1683370061151,CGS 114,A00,185496,Staff,13,0,18,5
1683370062175,CGS 119,A00,185501,Staff,15,0,20,5
1683370063199,CGS 120,A00,185511,Staff,13,0,20,7
1683370064225,CHEM 4,A01,184675,Bussey; Thomas J,96,0,100,4
1683370065249,CHEM 6A,A01,184677,Staff,34,0,60,26
1683370066275,CHEM 6B,A01,184679,Staff,65,0,100,35
1683370067304,CHEM 6C,A01,184681,Bussey; Thomas J,1,0,50,49
1683370067304,CHEM 6C,A02,184682,Bussey; Thomas J,34,0,50,16
1683370068333,CHEM 40A,A01,184684,Albizati; Kim F.,37,0,100,63
1683370069359,CHEM 40B,A01,184686,Albizati; Kim F.,0,20,100,100
1683370070389,CHEM 41B,A01,184690,Staff,52,0,100,48
1683370071416,COGS 3,A01,184715,Boyle; Mary E. T.,0,25,40,40
1683370072441,COGS 14B,A01,185172,Staff,0,15,38,38
1683370073469,COGS 18,A01,184736,Staff,16,0,80,64
1683370074498,COGS 100,A01,184932,Staff,0,5,73,73
1683370075526,COGS 101A,A01,184935,Staff,0,39,30,30
1683370076554,COGS 101B,A01,184944,Staff,0,2,30,30
1683370077577,COGS 101C,A01,184946,Staff,0,12,30,30
1683370078600,COGS 102A,A01,184951,Johnson; Christine M.,2,0,40,38
1683370079628,COGS 107B,A01,184953,Mooshagian; Eric Frederick,0,50,40,40
1683370080652,COGS 118B,A01,184959,Gupta; Anjum,0,48,40,40
1683370081675,COGS 153,A00,184961,Staff,0,15,30,30
1683370082700,COGS 177,A00,184962,Staff,0,20,30,30
1683370083728,COGS 187A,A01,184969,Boyle; Mary E. T.,0,17,40,40
1683370084760,COMM 10,A01,185174,Staff,0,5,25,25
1683370084760,COMM 10,A02,185189,Staff,0,5,25,25
1683370084760,COMM 10,A03,269821,Staff,0,0,0,0
1683370085787,COMM 100B,A01,185475,Staff,0,0,0,2
1683370085787,COMM 100B,A02,185476,Staff,13,0,25,12
1683370086815,COMM 100C,A01,185314,Staff,1,0,25,24
1683370086815,COMM 100C,A02,185327,Staff,19,0,25,6
1683370087838,COMM 110M,A00,185349,Staff,2,0,40,38
1683370088865,COMM 113T,A00,185352,Staff,24,0,40,16
1683370089890,COMM 114I,A00,185353,Staff,33,0,40,7
1683370090915,COMM 131,A00,185354,Staff,19,0,30,11
1683370091945,CSE 8A,A50,185358,Cao; Yingjun,0,46,10,10
1683370092973,CSE 8B,A01,185362,Staff,0,46,50,50
1683370094001,CSE 11,A01,185416,Cao; Yingjun,0,92,10,10
1683370095028,CSE 20,A01,185445,Briones; Jor-el Thomas Caparas,5,0,25,20
1683370096058,CSE 21,A01,185447,Staff,10,0,50,40
1683370097084,CSE 101,A01,185451,Staff,0,13,50,50
1683370097084,CSE 101,B01,185453,Jones; Miles E,0,11,50,50
1683370099136,CSE 141,A01,185458,Eldon; John,20,0,100,80
1683370100162,CSE 141L,A01,185461,Eldon; John,12,0,100,88
1683370101190,CSE 142,A01,185463,Staff,36,0,60,24
1683370101190,CSE 142,B01,201355,Staff,0,7,60,60
1683370102276,CSE 142L,A01,185470,Staff,36,0,60,24
1683370102276,CSE 142L,B01,201417,Staff,0,6,60,60
1683370103303,CSE 190,A00,201433,Staff,32,0,49,17
1683370104331,DOC 1,A01,259136,Strom; Megan C.,7,0,15,8
1683370104331,DOC 1,A02,259137,Strom; Megan C.,14,0,15,1
1683370104331,DOC 1,A03,259138,Strom; Megan C.,14,0,15,1
1683370104331,DOC 1,A04,259139,Strom; Megan C.,14,0,15,1
1683370105354,DOC 100D,A00,259140,Pass; Natalye Joann,16,0,25,9
1683370106378,DSGN 1,A01,184749,Rill; Bryan,0,25,30,30
1683370107402,DSGN 100,A01,185168,Staff,0,2,25,25
1683370108427,ECE 5,A01,185626,Morris; Karcher William,0,10,0,0
1683370109453,ECE 101,A01,185628,Staff,17,0,70,53
1683370110478,ECE 107,A01,185635,Baghdadchi; Saharnaz,0,0,20,20
1683370110478,ECE 107,A02,185638,Baghdadchi; Saharnaz,4,0,20,16
1683370111503,ECE 148,A01,185647,Silberman; Jack,0,0,16,16
1683370112527,ECON 1,A01,185537,Crane; Meredith Helen,54,0,70,16
1683370113552,ECON 3,A01,185549,Crane; Meredith Helen,32,0,70,38
1683370114578,ECON 4,A01,203354,Anderson; John Charles,0,4,10,10
1683370115604,ECON 100A,A01,185574,Staff,0,4,40,40
1683370116628,ECON 100B,A01,185576,Staff,0,12,50,50
1683370117653,ECON 100C,A01,185589,Newhouse; Herbert S,29,0,70,41
1683370118678,ECON 105,A00,185608,Vespa; Emanuel Ignacio,19,0,35,16
1683370119708,ECON 109,A01,185610,Shishkin; Denis,10,0,35,25
1683370120734,ECON 110A,A01,185612,Staff,11,0,40,29
1683370121758,ECON 120A,A01,185615,Staff,20,0,40,20
1683370122783,ECON 120C,A01,185617,Sun; Yixiao,0,21,70,70
1683370123807,ECON 144,A00,203346,Squires; Dale E,3,0,35,32
1683370124833,ECON 171,A01,203349,Newhouse; Herbert S,0,1,35,35
1683370125861,ECON 173A,A01,185621,Toda; Alexis Akira,21,0,35,14
1683370126894,EDS 25,A01,202413,Staff,0,1,0,0
1683370126894,EDS 25,A02,202414,Staff,0,1,0,0
1683370126894,EDS 25,A03,202415,Staff,0,0,0,0
1683370126894,EDS 25,A04,202416,Staff,0,1,0,0
1683370126894,EDS 25,A05,202439,Staff,0,0,0,0
1683370126894,EDS 25,A06,202440,Staff,0,0,0,0
1683370126894,EDS 25,B01,202631,Staff,0,0,0,0
1683370126894,EDS 25,B02,202632,Staff,0,0,0,0
1683370126894,EDS 25,B03,202639,Staff,0,0,0,0
1683370126894,EDS 25,B04,202640,Staff,0,0,0,0
1683370126894,EDS 25,B05,202643,Staff,0,0,0,0
1683370126894,EDS 25,B06,202644,Staff,0,0,0,0
1683370127923,EDS 38,A01,202659,Black; Alison Michelle,24,0,25,1
1683370128947,EDS 115,A00,202652,Staff,18,0,30,12
1683370129975,EDS 125,A00,202649,Staff,14,0,30,16
1683370131002,EDS 126,A01,203332,Staff,30,0,30,0
1683370132029,EDS 139,A00,202838,Staff,16,0,25,9
1683370133053,EDS 146,A01,202655,Staff,14,0,25,11
1683370134079,ENG 15,A00,185667,Staff,0,1,0,0
1683370134079,ENG 15,B00,185672,Staff,0,0,0,0
1683370134079,ENG 15,C00,185675,Staff,0,0,0,0
1683370134079,ENG 15,D00,185682,Staff,0,0,0,0
1683370134079,ENG 15,E00,185684,Staff,0,0,0,0
1683370135103,ETHN 103,A00,185710,Staff,0,4,35,35
1683370136127,ETHN 103A,A00,199228,Man; Simeon S,2,0,9,7
1683370137151,ETHN 109,A00,185711,Staff,18,0,35,17
1683370138174,ETHN 142,A00,185726,Staff,0,4,30,30
1683370139198,ETHN 163J,A00,199229,Man; Simeon S,5,0,8,3
1683370140222,ETHN 168,A00,185727,Staff,8,0,10,2
1683370141246,ETHN 182,A00,185728,Staff,0,0,35,35
1683370142270,ETHN 183,A00,185737,Staff,8,0,18,10
1683370143299,GLBH 111,A01,209361,Burgos; Jose L.,0,0,0,0
1683370145365,HIEU 104,A00,185792,Staff,16,0,20,4
1683370146390,HIEU 115,A00,185800,Staff,1,0,20,19
1683370147415,HIEU 128,A00,185801,Staff,0,7,20,20
1683370148440,HIEU 147,A00,185802,Staff,16,0,20,4
1683370149466,HIEU 154,A00,185823,Staff,12,0,20,8
1683370150494,HILA 102,A00,185826,Staff,13,0,20,7
1683370151522,HILD 2C,A01,185778,Staff,0,12,20,20
1683370152551,HILD 7B,A01,185780,Kwak; Nancy,0,15,32,32
1683370152551,HILD 7B,A02,185781,Kwak; Nancy,0,18,32,32
1683370153580,HILD 30,A01,185791,Staff,14,0,20,6
1683370154604,HISC 119,A00,185830,Golan; Tal,0,9,20,20
1683370155629,HITO 156GS,A00,185831,Patterson; Patrick H.,0,0,0,23
1683370156653,HIUS 103,A00,185832,Man; Simeon S,1,6,20,19
1683370157676,HIUS 117,A00,185836,Kwak; Nancy,2,0,20,18
1683370158700,HIUS 125,A00,185840,Man; Simeon S,0,0,23,23
1683370159727,HIUS 149,A00,185845,Staff,0,0,20,20
1683370160757,HUM 3,A01,185882,Zavodny; Tatiana Sophia,0,7,50,50
1683370160757,HUM 3,B01,185899,Caldwell; Michael Alan,0,18,50,50
1683370161783,HUM 3GS,A00,185900,Patterson; Patrick H.,0,0,0,23
1683370162810,HUM 4,A01,185938,Zroka; Amy Liane,31,0,50,19
1683370162810,HUM 4,B01,185956,Watkins; Eric,0,3,50,50
1683370162810,HUM 4,B02,202209,Watkins; Eric,0,2,50,50
1683370162810,HUM 4,B03,202210,Watkins; Eric,0,2,50,50
1683370163836,HUM 5,A01,185958,West; Geoffrey Scott,3,0,50,47
1683370163836,HUM 5,A02,202215,West; Geoffrey Scott,0,0,50,50
1683370164859,INTL 190,A00,185959,Gagnon; Jeffrey C,0,0,0,9
1683370164859,INTL 190,B00,185960,Lettieri; Michael Joseph,0,0,0,1
1683370165883,JAPN 180,A00,254509,Staff,4,0,30,26
1683370166908,LATI 10,A01,202853,Kennemore; Amy Michelle,4,0,35,31
1683370166908,LATI 10,A02,202854,Kennemore; Amy Michelle,2,0,35,33
1683370166908,LATI 10,A03,270054,Kennemore; Amy Michelle,30,0,30,0
1683370167935,LATI 180,A00,202855,Kennemore; Amy Michelle,11,0,20,9
1683370168964,LAWS 101,A00,201767,Golan; Tal,0,7,40,40
1683370169991,LIFR 1C,A00,185961,Staff,6,0,20,14
1683370171020,LIFR 1CX,A00,185962,Staff,7,0,20,13
1683370172044,LIFR 1D,A00,185963,Staff,9,0,20,11
1683370173069,LIFR 1DX,A00,185964,Staff,9,0,20,11
1683370174098,LIGN 101,A01,186039,Staff,43,0,50,7
1683370175123,LIGN 165,A00,186040,Staff,18,0,50,32
1683370176146,LTCS 108,A00,186041,Staff,6,0,10,4
1683370177170,LTCS 119,A00,186042,Staff,16,0,20,4
1683370178195,LTCS 130,A00,186043,Wesling; Megan E.,15,0,25,10
1683370180245,LTEA 138,A00,186119,Staff,14,0,40,26
1683370181270,LTEN 124,A00,186148,Staff,6,0,25,19
1683370182293,LTEN 178,A00,186149,Staff,7,0,15,8
1683370183320,LTEN 181,A00,186150,Blanco; John D,33,0,40,7
1683370184343,LTWL 120,A00,186160,Staff,20,0,25,5
1683370185370,LTWL 165,A00,186161,Staff,22,0,25,3
1683370186394,LTWR 100,A00,186162,Staff,0,5,15,15
1683370187419,LTWR 102,A00,186163,Doller; Ben,5,0,15,10
1683370188444,MAE 8,A01,186412,Staff,0,0,0,0
1683370189470,MAE 30B,A00,186445,Bahadori; Mohammad Yousef,83,0,100,17
1683370190495,MAE 40,A00,186592,Bewley; Thomas R,10,0,50,40
1683370191518,MAE 101B,A00,186593,Bahadori; Mohammad Yousef,81,0,100,19
1683370192546,MAE 105,A00,186594,Bandaru; Prabhakar,12,0,50,38
1683370193570,MAE 107,A00,186599,Pham; Hieu Tan,0,7,120,120
1683370194598,MAE 148,A01,186660,Silberman; Jack,3,0,16,13
1683370195626,MATH 10A,A01,188095,Staff,0,5,35,35
1683370196656,MATH 10B,A01,188097,Bowers; Adam R.,0,11,30,30
1683370196656,MATH 10B,A02,188099,Bowers; Adam R.,0,11,30,30
1683370196656,MATH 10B,B01,188104,Bowers; Adam R.,0,10,30,30
1683370196656,MATH 10B,B02,188106,Bowers; Adam R.,0,10,30,30
1683370197681,MATH 10C,A01,188111,Staff,0,18,30,30
1683370197681,MATH 10C,A02,188127,Staff,0,17,30,30
1683370197681,MATH 10C,A03,188131,Staff,0,18,30,30
1683370197681,MATH 10C,B01,188218,Staff,18,0,30,12
1683370197681,MATH 10C,B02,188244,Staff,13,0,30,17
1683370197681,MATH 10C,B03,188277,Staff,16,0,30,14
1683370198706,MATH 18,A01,188344,Bach; Quang Tran,18,0,30,12
1683370198706,MATH 18,A02,188345,Bach; Quang Tran,11,0,30,19
1683370198706,MATH 18,B01,188353,Bach; Quang Tran,10,0,30,20
1683370198706,MATH 18,B02,188354,Bach; Quang Tran,20,0,30,10
1683370199730,MATH 20A,A01,188374,Staff,12,0,35,23
1683370200756,MATH 20B,A01,188382,Ohm; Ko Woon,6,0,30,24
1683370200756,MATH 20B,A02,188383,Ohm; Ko Woon,21,0,30,9
1683370200756,MATH 20B,B01,188385,Ohm; Ko Woon,7,0,30,23
1683370200756,MATH 20B,B02,188392,Ohm; Ko Woon,22,0,30,8
1683370201782,MATH 20C,A01,188394,Harel; Guershon,10,0,30,20
1683370201782,MATH 20C,A02,188395,Harel; Guershon,15,0,30,15
1683370201782,MATH 20C,B01,188404,Harel; Guershon,4,0,30,26
1683370201782,MATH 20C,B02,188405,Harel; Guershon,19,0,30,11
1683370202812,MATH 20D,A01,188414,Hammock; Frances H,0,1,30,30
1683370202812,MATH 20D,A02,188415,Hammock; Frances H,3,0,30,27
1683370202812,MATH 20D,B01,188447,Hammock; Frances H,1,0,30,29
1683370202812,MATH 20D,B02,188486,Hammock; Frances H,8,0,30,22
1683370203839,MATH 20E,A01,188649,Staff,21,0,30,9
1683370203839,MATH 20E,A02,188650,Staff,23,0,30,7
1683370203839,MATH 20E,A03,188673,Staff,0,0,30,30
1683370204866,MATH 102,A01,188675,Staff,0,35,35,35
1683370205946,MATH 103B,A01,188681,Staff,3,0,35,32
1683370205946,MATH 103B,B01,188692,Staff,5,0,35,30
1683370206969,MATH 109,A01,188695,Salehi Golsefidy; Alireza,25,0,35,10
1683370206969,MATH 109,A02,188696,Salehi Golsefidy; Alireza,25,0,35,10
1683370207993,MATH 120A,A01,188698,Eggers; John Dietrich,7,0,35,28
1683370209022,MATH 142B,A01,188736,Ioana; Adrian,0,2,30,30
1683370209022,MATH 142B,A02,188741,Ioana; Adrian,0,0,30,30
1683370209022,MATH 142B,A03,188743,Ioana; Adrian,0,1,30,30
1683370210047,MATH 168A,A01,188790,Staff,0,9,35,35
1683370211074,MATH 170A,A01,188803,Nie; Jiawang,0,2,35,35
1683370211074,MATH 170A,A02,188811,Nie; Jiawang,0,0,35,35
1683370211074,MATH 170A,A03,188814,Nie; Jiawang,1,0,35,34
1683370211074,MATH 170A,A04,188815,Nie; Jiawang,13,0,35,22
1683370212097,MATH 193B,A01,188817,Staff,0,0,35,35
1683370212097,MATH 193B,A02,188818,Staff,5,0,35,30
1683370213121,MGT 4,A01,202857,Anderson; John Charles,61,0,80,19
1683370214145,MGT 12,A00,202858,Lindenberger; Wade Douglas,41,0,90,49
1683370215169,MGT 18,A00,202859,Staff,74,0,90,16
1683370216193,MGT 18GS,A00,202860,McKay; Michael J,13,0,28,15
1683370217220,MGT 45,A00,202861,Pecore; Joseph P.,15,0,90,75
1683370218248,MGT 100,A00,202863,Yavorsky; Daniel Ryan,28,0,90,62
1683370219276,MGT 103,A00,202864,Ehrich; Kristine R,0,17,90,90
1683370220300,MGT 112,A00,202865,Ehrich; Kristine R,15,0,90,75
1683370221327,MGT 121A,A00,202868,Staff,0,20,0,0
1683370222351,MGT 131B,A00,202869,Anderson; John Charles,59,0,90,31
1683370223375,MGT 136,A00,202871,Lindenberger; Wade Douglas,84,0,90,6
1683370224399,MGT 164,A00,202873,Staff,0,68,90,91
1683370225426,MGT 164GS,A00,202874,McKay; Mary A,13,0,28,15
1683370226452,MGT 180,A00,202875,Staff,0,50,90,91
1683370227481,MMW 11R,A01,205019,Herbst; Matthew,3,0,30,27
1683370227481,MMW 11R,A02,205026,Herbst; Matthew,29,0,30,1
1683370228509,MMW 15,A01,193512,Chang; Edmond Yi-Teh,0,9,28,28
1683370228509,MMW 15,A02,193513,Chang; Edmond Yi-Teh,0,5,28,28
1683370228509,MMW 15,A03,193514,Chang; Edmond Yi-Teh,0,5,28,28
1683370228509,MMW 15,A04,193515,Chang; Edmond Yi-Teh,0,5,28,28
1683370228509,MMW 15,A05,193516,Chang; Edmond Yi-Teh,0,4,28,28
1683370228509,MMW 15,A06,193517,Chang; Edmond Yi-Teh,0,5,28,28
1683370228509,MMW 15,B01,193519,Chang; Edmond Yi-Teh,0,5,28,28
1683370228509,MMW 15,B02,193520,Chang; Edmond Yi-Teh,0,5,28,28
1683370228509,MMW 15,B03,193521,Chang; Edmond Yi-Teh,0,5,28,28
1683370228509,MMW 15,B04,193522,Chang; Edmond Yi-Teh,0,4,28,28
1683370228509,MMW 15,B05,193523,Chang; Edmond Yi-Teh,0,5,28,28
1683370228509,MMW 15,B06,193524,Chang; Edmond Yi-Teh,0,4,28,28
1683370229534,MMW 122,A01,193526,Rahimi; Babak,0,15,28,28
1683370229534,MMW 122,A02,193527,Rahimi; Babak,0,14,28,28
1683370229534,MMW 122,A03,193528,Rahimi; Babak,0,0,0,0
1683370229534,MMW 122,A04,193529,Rahimi; Babak,0,0,0,0
1683370230560,MUS 1A,A01,186663,Staff,0,20,35,35
1683370231583,MUS 4,A01,186715,Staff,0,12,35,35
1683370232614,MUS 5R,A01,186796,Dubnov; Shlomo,0,17,35,35
1683370233637,MUS 6,A01,186798,Staff,0,4,25,25
1683370234661,MUS 7,A01,186830,Staff,13,0,35,22
1683370235689,MUS 8,A01,186930,Staff,0,26,35,35
1683370236717,MUS 15,A01,186932,Staff,0,16,35,35
1683370236717,MUS 15,B01,186934,Staff,0,15,35,35
1683370237746,MUS 80,A00,186935,Staff,0,0,20,20
1683370237746,MUS 80,B00,186936,Staff,25,0,25,0
1683370238776,NANO 11,A00,204702,Lipomi; Darren John,0,0,0,0
1683370239802,NANO 15,A01,204709,Yang; Kesong,0,1,0,0
1683370240828,NANO 114,A00,202069,Jahed Motlagh; Zeinab,3,0,10,7
1683370241854,PHIL 1,A00,186955,Grush; Rick Scott,32,0,40,8
1683370242878,PHIL 10,A01,186973,Grush; Rick Scott,28,0,35,7
1683370242878,PHIL 10,A02,186974,Grush; Rick Scott,33,0,35,2
1683370243905,PHIL 13,A01,186976,Staff,7,0,35,28
1683370243905,PHIL 13,A02,186977,Staff,16,0,35,19
1683370244933,PHIL 14,A01,186979,Staff,31,0,35,4
1683370244933,PHIL 14,A02,186986,Staff,32,0,35,3
1683370245959,PHIL 28,A01,186988,Staff,16,0,30,14
1683370245959,PHIL 28,A02,186989,Staff,1,0,30,29
1683370245959,PHIL 28,A03,186990,Staff,9,0,30,21
1683370245959,PHIL 28,A04,186991,Staff,26,0,30,4
1683370246984,PHIL 120,A00,186997,Staff,23,0,40,17
1683370248009,PHIL 137,A00,187003,Staff,9,0,40,31
1683370249032,PHIL 150,A00,187015,Staff,47,0,70,23
1683370250055,PHIL 167,A00,187021,Lamey; Andy M.,35,0,40,5
1683370251080,PHIL 174,A01,202226,Staff,17,0,20,3
1683370251080,PHIL 174,A02,202235,Staff,20,0,20,0
1683370252103,PHIL 191A,A00,258918,Staff,0,0,1,1
1683370253131,PHYS 1A,A00,187028,Staff,27,0,60,33
1683370254156,PHYS 1AL,001,187036,Staff,2,0,30,28
1683370254156,PHYS 1AL,002,187049,Staff,18,0,30,12
1683370255183,PHYS 1B,A00,187058,Staff,22,0,60,38
1683370256211,PHYS 1BL,001,187064,Staff,0,0,30,30
1683370256211,PHYS 1BL,002,187070,Staff,5,0,30,25
1683370257239,PHYS 1C,A00,187082,Staff,31,0,120,89
1683370258264,PHYS 1CL,001,187088,Staff,0,9,30,30
1683370258264,PHYS 1CL,002,187089,Staff,0,2,30,30
1683370258264,PHYS 1CL,009,262693,Staff,11,0,30,19
1683370259289,PHYS 2B,A01,187097,Staff,54,0,115,61
1683370260314,PHYS 2C,A01,187099,Staff,67,0,115,48
1683370261340,PHYS 2CL,A01,187101,Staff,5,0,28,23
1683370261340,PHYS 2CL,A02,187102,Staff,15,0,28,13
1683370262366,PHYS 2D,A01,187123,Shotwell; Brian,95,0,115,20
1683370263394,PHYS 4B,A01,187133,Grinstein; Benjamin,35,0,50,15
1683370264421,POLI 10,A00,188819,Staff,0,4,50,50
1683370265447,POLI 11,A00,188827,Staff,43,0,50,7
1683370266470,POLI 13R,A00,188828,Staff,0,1,20,20
1683370267494,POLI 27,A01,188830,Elgin; Samuel Zincke,0,1,70,70
1683370268520,POLI 30,A00,188832,Desposato; Scott,31,0,50,19
1683370269544,POLI 102F,A00,188834,Staff,2,0,40,38
1683370270567,POLI 104A,A00,188852,Staff,14,0,30,16
1683370271591,POLI 104I,A00,188853,Staff,0,6,20,20
1683370272617,POLI 110B,A00,188854,Wiens; David,7,0,20,13
1683370273642,POLI 112A,A00,188855,Wiens; David,5,0,30,25
1683370274667,POLI 117R,A00,188856,Forman; Fonna,0,11,20,20
1683370275692,POLI 118,A00,188857,Ingham; Sean,8,0,20,12
1683370276715,POLI 120G,A00,188858,Staff,9,0,30,21
1683370277739,POLI 131CR,A00,188863,Hoston; Germaine,23,0,50,27
1683370278767,POLI 133,A00,188864,Nellis; Gareth Hb,44,0,50,6
1683370279791,POLI 134D,A00,188865,Desposato; Scott,27,0,30,3
1683370280817,POLI 142A,A00,188871,Gartzke; Erik,22,0,50,28
1683370281842,POLI 142K,A00,188874,Staff,38,0,50,12
1683370282865,POLI 143,A00,188940,Gartzke; Erik,16,0,30,14
1683370283890,POLI 153,A00,188943,Staff,3,0,20,17
1683370284917,POLI 160AA,A00,188944,Staff,11,0,40,29
1683370285946,POLI 170A,A00,188945,Staff,11,0,30,19
1683370288000,PSYC 1,A00,188952,Staff,37,0,90,53
1683370289025,PSYC 2,B00,188953,Staff,19,0,35,16
1683370290049,PSYC 6,A00,188970,Staff,47,0,60,13
1683370291074,PSYC 7,A00,188973,Staff,37,0,45,8
1683370292098,PSYC 60,A01,188980,Rickard; Timothy C.,43,0,60,17
1683370293127,PSYC 70,A01,189001,Steiner; Eric Tomas,23,0,45,22
1683370294151,PSYC 100,A00,189005,Lacefield; Katharine I,0,98,120,120
1683370295178,PSYC 102,A00,189008,Staff,9,0,30,21
1683370296209,PSYC 106,B00,189026,Gorman; Michael R.,34,0,60,26
1683370297237,PSYC 114,B01,189033,Winkielman; Piotr,0,32,30,30
1683370298267,PSYC 131,A00,189036,Anagnostaras; Stephan,0,43,60,60
1683370299291,PSYC 136,A00,189041,Lowe; Angela Beth,0,7,25,25
1683370300316,PSYC 137,A00,189057,Winkielman; Piotr,0,34,25,25
1683370301344,PSYC 144,A00,189107,Wixted; John T,0,7,50,50
1683370303394,PSYC 162,A00,189142,Staff,0,8,85,85
1683370304423,PSYC 172,A00,189144,Gorman; Michael R.,0,7,30,30
1683370306473,PSYC 179,A00,189146,Lacefield; Katharine I,0,84,120,120
1683370307498,PSYC 181,A00,189147,Anagnostaras; Stephan,0,44,90,90
1683370308524,PSYC 190R,A00,189148,Barner; David A.,0,22,80,80
1683370309623,PSYC 191,A00,189275,Rickard; Timothy C.,0,7,25,25
1683370310649,PSYC 193,A00,189276,Chapman; Eddie Nathaniel,0,1,0,4
1683370311677,PSYC 193L,A01,189281,Lowe; Angela Beth,12,0,20,8
1683370311677,PSYC 193L,B01,189285,Staff,28,0,35,7
1683370312705,RELI 149,A00,187137,Rahimi; Babak,7,0,40,33
1683370313728,SE 9,A01,187315,Staff,0,2,18,18
1683370314752,SE 101B,A00,187409,Staff,24,0,30,6
1683370315776,SE 110B,A00,187444,Staff,10,0,40,30
1683370316802,SE 130B,A00,187449,Staff,31,0,40,9
1683370317831,SE 150A,A00,187516,Staff,9,0,20,11
1683370318860,SE 154,A00,187528,Staff,30,0,50,20
1683370319890,SIO 3,A01,258171,Staff,35,0,40,5
1683370320920,SIO 10,A00,187144,Cook; Geoffrey W,0,3,75,75
1683370321943,SIO 45,A00,187152,Cook; Geoffrey W,1,0,100,99
1683370322968,SIO 109R,A00,194486,Staff,0,3,20,20
1683370325017,SIO 187,A01,187233,Kacev; David,12,0,40,28
1683370326043,SOCI 1,A01,258656,Thorpe; Charles Robert,28,0,30,2
1683370326043,SOCI 1,A02,258658,Thorpe; Charles Robert,30,0,30,0
1683370326043,SOCI 1,A03,258661,Thorpe; Charles Robert,25,0,25,0
1683370326043,SOCI 1,A04,258666,Thorpe; Charles Robert,22,0,25,3
1683370326043,SOCI 1,A05,258897,Thorpe; Charles Robert,23,0,25,2
1683370326043,SOCI 1,A06,258898,Thorpe; Charles Robert,25,0,25,0
1683370327069,SOCI 30,A01,258903,Pardo Guerra; Juan Pablo,15,0,30,15
1683370328095,SOCI 102,A00,258904,Staff,9,0,25,16
1683370329121,SOCI 106,A00,258905,Staff,19,0,25,6
1683370330145,SOCI 111,A00,258907,Ribas Norris; Janet Vanesa,26,0,30,4
1683370331169,SOCI 121R,A00,258908,Pardo Guerra; Juan Pablo,10,0,30,20
1683370332197,SOCI 126,A01,203330,Staff,14,0,20,6
1683370333221,SOCI 131,A00,258909,Thorpe; Charles Robert,31,0,60,29
1683370334245,SOCI 135,A00,258910,Payne; Christine Anna,0,9,30,30
1683370335269,SOCI 157,A00,258911,Staff,12,0,30,18
1683370336294,SOCI 184,A00,258912,Staff,25,0,30,5
1683370337319,SOCI 188D,A00,258913,Staff,22,0,30,8
1683370338347,SYN 2,001,187529,Staff,10,0,16,6
1683370338347,SYN 2,002,201452,Staff,0,18,16,16
1683370338347,SYN 2,003,201469,Staff,3,0,16,13
1683370339375,SYN 100,A01,187531,Staff,0,9,20,20
1683370339375,SYN 100,B01,201491,Staff,0,12,20,20
1683370340408,TDAC 1,A00,189286,Walsh; Kim C.,3,0,20,17
1683370340408,TDAC 1,B00,189287,Harting; Carla Kelso,11,0,20,9
1683370341437,TDAC 101,A00,189300,Walsh; Kim C.,16,0,20,4
1683370341437,TDAC 101,B00,189301,Harting; Carla Kelso,18,0,20,2
1683370342472,TDAC 102,A00,189304,Basso; Beatrice,14,0,20,6
1683370343496,TDAC 108,A00,189305,Staff,18,0,20,2
1683370344522,TDDE 131,A00,189310,Staff,19,0,20,1
1683370344522,TDDE 131,B00,189314,Staff,19,0,20,1
1683370344522,TDDE 131,C00,189315,Staff,48,0,50,2
1683370344522,TDDE 131,D00,189316,Staff,14,0,15,1
1683370344522,TDDE 131,E00,204841,Staff,20,0,20,0
1683370345547,TDGE 10,A00,189289,Staff,30,0,50,20
1683370345547,TDGE 10,B00,189290,Havis; Allan,1,0,50,49
1683370346574,TDGE 11,A00,189291,Fulton; Julia,0,3,50,50
1683370346574,TDGE 11,B00,189292,Staff,20,0,25,5
1683370346574,TDGE 11,C00,260270,Staff,0,0,0,0
1683370347601,TDGE 25,A00,189294,Staff,3,0,20,17
1683370348628,TDGE 124,A00,189318,Fulton; Julia,0,8,50,50
1683370349657,TDGE 125,A00,189319,Staff,13,0,25,12
1683370349657,TDGE 125,B00,189320,Staff,23,0,25,2
1683370350682,TDGE 127,A00,189322,Havis; Allan,0,0,50,50
1683370351706,TDHT 101,A00,189323,Staff,18,0,25,7
1683370351706,TDHT 101,B00,189324,Staff,25,0,25,0
1683370352732,TDHT 102,A00,189325,Staff,49,0,50,1
1683370353764,TDMV 1,A00,189295,Arcidiacono; Kristin,19,0,30,11
1683370353764,TDMV 1,B00,189296,Caligagan; Maria T.,24,0,30,6
1683370354788,TDMV 2,A00,189297,Sammartano; Tonnie,28,0,30,2
1683370354788,TDMV 2,B00,189299,Arcidiacono; Kristin,24,0,30,6
1683370355813,TDMV 3,A00,204998,Rincon; Alicia,22,0,30,8
1683370356837,TDMV 120,A00,189458,Sammartano; Tonnie,28,0,30,2
1683370357861,TDMV 138,A00,189541,Jun; Grace Shin Hae,22,0,40,18
1683370358887,TDMV 142,A00,189717,Caligagan; Tony,24,0,30,6
1683370358887,TDMV 142,B00,189718,Caligagan; Maria T.,25,0,30,5
1683370359910,TMC 2,A01,187533,Staff,25,0,25,0
1683370359910,TMC 2,A02,187534,Staff,25,0,25,0
1683370360936,USP 1,A01,187536,Kwak; Nancy,0,16,25,25
1683370361961,USP 5,A01,187538,Staff,10,0,25,15
1683370362986,USP 101,A00,199253,Staff,0,4,0,0
1683370364015,USP 124,A00,187562,Boomhower; Matthew Charles,1,0,30,29
1683370365041,USP 138,A00,187582,Staff,20,0,25,5
1683370366069,USP 152,A01,187597,Staff,4,0,25,21
1683370367097,USP 153,A00,187598,Staff,19,0,25,6
1683370368127,USP 168,A00,187607,Kwak; Nancy,2,0,5,3
1683370369154,USP 173,A00,187619,Staff,4,0,25,21
1683370370179,USP 181,A00,187638,Staff,0,3,25,25
1683370371203,VIS 103,A00,187650,Cruz; Edwin Teddy,22,0,75,53
1683370372229,VIS 110D,A00,187669,Staff,12,0,22,10
1683370373254,VIS 127C,A00,187720,Shen; Kuiyi,67,0,146,79
1683370374283,VIS 149,A00,187731,Yoldas; Pinar,0,14,22,22
1683370375311,VIS 151,A01,188091,Staff,22,0,34,12
1683370375311,VIS 151,A02,188092,Staff,11,0,34,23
1683370376336,VIS 160B,A00,188093,Stalbaum; Brett,0,0,10,10
1683370378386,WCWP 10B,A00,201720,Staff,10,0,15,5
1683370378386,WCWP 10B,B00,201722,Staff,9,0,15,6
1683370379411,WCWP 100,A00,201725,Gagnon; Jeffrey C,0,0,2,2
1683370379411,WCWP 100,B00,201727,Staff,0,4,15,15
1683370382539,ANBI 133,A00,258401,Wilder; Linnea Lorene,34,0,40,6
1683370383572,ANBI 140,A00,258395,Hrvoj Mihic; Branka,18,0,25,7
1683370384600,ANSC 120,A00,258402,Bialecki; Jon Anthony,27,0,40,13
1683370385629,ANSC 144,A00,258400,Staff,14,0,40,26
1683370387679,ANSC 166,A00,258396,Parish; Steven Martin,158,0,175,17
1683370388704,ANSC 180,A00,193533,Staff,9,0,20,11
1683370389729,ANSC 188,A00,258397,Jassal; Aftab,33,0,40,7
1683370390754,ANTH 3,A01,258316,Staff,23,0,30,7
1683370391779,ANTH 5,A00,258394,Semendeferi; Ekaterini,16,0,20,4
1683370392802,ANTH 21,A01,258331,Staff,8,0,40,32
1683370393827,ANTH 103,A00,258398,Varma; Saiba,15,0,25,10
1683370394864,AWP 10,001,202034,Staff,0,0,0,0
1683370394864,AWP 10,002,202035,Staff,0,0,0,0
1683370394864,AWP 10,003,202036,Staff,0,0,0,0
1683370394864,AWP 10,004,202037,Staff,0,0,0,0
1683370394864,AWP 10,005,202038,Staff,0,0,0,0
1683370394864,AWP 10,006,202039,Staff,0,0,0,0
1683370394864,AWP 10,007,202040,Staff,0,0,0,0
1683370394864,AWP 10,008,202041,Staff,0,0,0,0
1683370394864,AWP 10,009,202042,Staff,0,0,0,0
1683370394864,AWP 10,010,202043,Staff,0,0,0,0
1683370394864,AWP 10,011,202044,Staff,0,0,0,0
1683370394864,AWP 10,012,202045,Staff,0,0,0,0
1683370394864,AWP 10,013,202046,Staff,0,0,0,0
1683370394864,AWP 10,014,202047,Staff,0,0,0,0
1683370394864,AWP 10,015,202048,Staff,0,0,0,0
1683370394864,AWP 10,016,202049,Staff,0,0,0,0
1683370394864,AWP 10,017,202050,Staff,0,0,0,0
1683370394864,AWP 10,018,202051,Staff,0,0,0,0
1683370394864,AWP 10,019,202052,Staff,0,0,0,0
1683370394864,AWP 10,020,202053,Staff,0,0,0,0
1683370394864,AWP 10,021,202054,Staff,0,0,0,0
1683370394864,AWP 10,022,202055,Staff,0,0,0,0
1683370394864,AWP 10,023,202056,Staff,0,0,0,0
1683370394864,AWP 10,024,202057,Staff,0,0,0,0
1683370394864,AWP 10,025,202058,Staff,0,0,0,0
1683370394864,AWP 10,026,202059,Staff,0,0,0,0
1683370395891,AWP 102,001,202032,Staff,0,0,0,0
1683370395891,AWP 102,002,202033,Staff,0,0,0,0
1683370396921,BENG 100,A01,254234,Taylor Amos; Alyssa C,31,0,40,9
1683370397947,BENG 196,001,270013,Engler; Adam J.,9999,0,9999,0
1683370398975,BICD 100R,A01,202018,Smith; Laurie,0,7,32,32
1683370398975,BICD 100R,A02,202019,Smith; Laurie,0,2,32,32
1683370398975,BICD 100R,A03,202020,Smith; Laurie,0,1,32,32
1683370398975,BICD 100R,A04,202021,Smith; Laurie,9,0,32,23
1683370398975,BICD 100R,A05,202022,Smith; Laurie,12,0,32,20
1683370400001,BICD 136,A01,193242,Gustafson-Brown; Cindy,0,2,32,32
1683370400001,BICD 136,A02,193244,Gustafson-Brown; Cindy,14,0,32,18
1683370401080,BIEB 102,A01,193249,Butler; Shannon Rhey,0,2,32,32
1683370401080,BIEB 102,A02,193251,Butler; Shannon Rhey,0,0,32,32
1683370401080,BIEB 102,A03,193253,Butler; Shannon Rhey,0,1,32,32
1683370401080,BIEB 102,A04,193255,Butler; Shannon Rhey,17,0,32,15
1683370401080,BIEB 102,A05,193265,Butler; Shannon Rhey,26,0,32,6
1683370401080,BIEB 102,A06,193269,Butler; Shannon Rhey,16,0,32,16
1683370403129,BIEB 150,A01,193274,Staff,0,0,32,32
1683370403129,BIEB 150,A02,193285,Staff,23,0,32,9
1683370404159,BIEB 194,A00,193286,Kurle; Carolyn M.,22,0,32,10
1683370405280,BILD 1,A01,192291,Staff,16,0,32,16
1683370405280,BILD 1,A02,192292,Staff,30,0,32,2
1683370405280,BILD 1,B01,192520,Reuther; Keefe,0,1,0,0
1683370405280,BILD 1,B02,192532,Reuther; Keefe,0,1,0,0
1683370406310,BILD 3,A01,192556,Butler; Shannon Rhey,0,0,32,32
1683370406310,BILD 3,A02,192581,Butler; Shannon Rhey,4,0,32,28
1683370406310,BILD 3,A03,192611,Butler; Shannon Rhey,23,0,32,9
1683370406310,BILD 3,A04,192612,Butler; Shannon Rhey,25,0,32,7
1683370406310,BILD 3,A05,192613,Butler; Shannon Rhey,27,0,32,5
1683370406310,BILD 3,A06,192679,Butler; Shannon Rhey,27,0,32,5
1683370406310,BILD 3,A07,192682,Butler; Shannon Rhey,21,0,32,11
1683370407337,BILD 4,A01,192836,Reuther; Keefe,0,0,24,24
1683370407337,BILD 4,A02,193044,Reuther; Keefe,4,0,24,20
1683370408360,BILD 10,A01,193142,Gustafson-Brown; Cindy,30,0,32,2
1683370408360,BILD 10,A02,193149,Gustafson-Brown; Cindy,31,0,32,1
1683370409386,BIMM 100,A01,193301,Staff,1,6,32,31
1683370409386,BIMM 100,A02,193312,Staff,0,5,32,32
1683370409386,BIMM 100,A03,193323,Staff,0,8,32,32
1683370410413,BIMM 101,A01,193329,McDonnell; Lisa Marie,0,3,24,24
1683370410413,BIMM 101,A02,193339,McDonnell; Lisa Marie,0,3,24,24
1683370410413,BIMM 101,B01,193354,McDonnell; Lisa Marie,0,3,24,24
1683370410413,BIMM 101,B02,193357,McDonnell; Lisa Marie,0,3,24,24
1683370411438,BIMM 110,A01,193377,Tat; John,0,11,32,32
1683370411438,BIMM 110,A02,193378,Tat; John,0,9,32,32
1683370412465,BIMM 120,A01,206116,Staff,0,0,32,32
1683370412465,BIMM 120,A02,206117,Staff,8,0,32,24
1683370412465,BIMM 120,A03,206121,Staff,21,0,32,11
1683370413557,BIPN 100,A01,193393,Park; Ji Young,0,14,32,32
1683370413557,BIPN 100,A02,193402,Park; Ji Young,0,13,32,32
1683370413557,BIPN 100,A03,193413,Park; Ji Young,0,14,32,32
1683370413557,BIPN 100,A04,193414,Park; Ji Young,0,13,32,32
1683370414581,BIPN 102,A01,193429,Staff,0,0,32,32
1683370414581,BIPN 102,A02,193438,Staff,22,0,32,10
1683370415607,BIPN 106,A01,193450,Reyes Gonzalez; Catalina,0,2,40,40
1683370416638,BIPN 134,A01,193465,Cooke; James Edward,1,0,32,31
1683370416638,BIPN 134,A02,193474,Cooke; James Edward,25,0,32,7
1683370416638,BIPN 134,A03,193485,Cooke; James Edward,29,0,32,3
1683370416638,BIPN 134,A04,193486,Cooke; James Edward,21,0,32,11
1683370416638,BIPN 134,A05,193491,Cooke; James Edward,31,0,32,1
1683370416638,BIPN 134,A06,193501,Cooke; James Edward,30,0,32,2
1683370416638,BIPN 134,A07,193510,Cooke; James Edward,29,0,32,3
1683370418695,BISP 194,A00,222522,Staff,14,0,32,18
1683370419718,CAT 124,A01,202407,Staff,19,0,25,6
1683370420743,CAT 125,A00,202408,Marchisotto; Jennifer Anne,4,0,20,16
1683370421770,CAT 125R,A00,202409,Smith; Lauryn Alissa,0,11,20,20
1683370421770,CAT 125R,B00,202410,Morales; Celeste Georgianna,0,11,20,20
1683370421770,CAT 125R,C00,202411,Irwin; Matthew Joseph,0,10,20,20
1683370422795,CENG 15,A01,204712,Yang; Kesong,0,1,0,0
1683370423820,CENG 114,A00,202070,Jahed Motlagh; Zeinab,5,0,20,15
1683370424849,CGS 105,A00,185477,Wesling; Megan E.,24,0,40,16
1683370425876,CGS 106,A00,185494,Staff,13,0,22,9
1683370426903,CGS 108,A00,185495,Staff,14,0,20,6
1683370427930,CGS 114,A00,185496,Staff,13,0,18,5
1683370428955,CGS 119,A00,185501,Staff,15,0,20,5
1683370429978,CGS 120,A00,185511,Staff,13,0,20,7
1683370431004,CHEM 4,A01,184675,Bussey; Thomas J,96,0,100,4
1683370432030,CHEM 6A,A01,184677,Staff,34,0,60,26
1683370433055,CHEM 6B,A01,184679,Staff,65,0,100,35
1683370434081,CHEM 6C,A01,184681,Bussey; Thomas J,1,0,50,49
1683370434081,CHEM 6C,A02,184682,Bussey; Thomas J,34,0,50,16
1683370435113,CHEM 40A,A01,184684,Albizati; Kim F.,37,0,100,63
1683370436138,CHEM 40B,A01,184686,Albizati; Kim F.,0,20,100,100
1683370437163,CHEM 41B,A01,184690,Staff,52,0,100,48
1683370438187,COGS 3,A01,184715,Boyle; Mary E. T.,0,25,40,40
1683370439211,COGS 14B,A01,185172,Staff,0,15,38,38
1683370440245,COGS 18,A01,184736,Staff,16,0,80,64
1683370441270,COGS 100,A01,184932,Staff,0,5,73,73
1683370442295,COGS 101A,A01,184935,Staff,0,39,30,30
1683370443319,COGS 101B,A01,184944,Staff,0,2,30,30
1683370444348,COGS 101C,A01,184946,Staff,0,12,30,30
1683370445374,COGS 102A,A01,184951,Johnson; Christine M.,2,0,40,38
1683370446399,COGS 107B,A01,184953,Mooshagian; Eric Frederick,0,50,40,40
1683370447423,COGS 118B,A01,184959,Gupta; Anjum,0,48,40,40
1683370448451,COGS 153,A00,184961,Staff,0,15,30,30
1683370449475,COGS 177,A00,184962,Staff,0,20,30,30
1683370450499,COGS 187A,A01,184969,Boyle; Mary E. T.,0,17,40,40
1683370451524,COMM 10,A01,185174,Staff,0,5,25,25
1683370451524,COMM 10,A02,185189,Staff,0,5,25,25
1683370451524,COMM 10,A03,269821,Staff,0,0,0,0
1683370452550,COMM 100B,A01,185475,Staff,0,0,0,2
1683370452550,COMM 100B,A02,185476,Staff,13,0,25,12
1683370453574,COMM 100C,A01,185314,Staff,1,0,25,24
1683370453574,COMM 100C,A02,185327,Staff,19,0,25,6
1683370454601,COMM 110M,A00,185349,Staff,2,0,40,38
1683370455628,COMM 113T,A00,185352,Staff,24,0,40,16
1683370456652,COMM 114I,A00,185353,Staff,33,0,40,7
1683370457679,COMM 131,A00,185354,Staff,19,0,30,11
1683370458708,CSE 8A,A50,185358,Cao; Yingjun,0,46,10,10
1683370459737,CSE 8B,A01,185362,Staff,0,46,50,50
1683370460762,CSE 11,A01,185416,Cao; Yingjun,0,92,10,10
1683370461788,CSE 20,A01,185445,Briones; Jor-el Thomas Caparas,5,0,25,20
1683370462814,CSE 21,A01,185447,Staff,10,0,50,40
1683370463840,CSE 101,A01,185451,Staff,0,13,50,50
1683370463840,CSE 101,B01,185453,Jones; Miles E,0,11,50,50
1683370465891,CSE 141,A01,185458,Eldon; John,20,0,100,80
1683370466918,CSE 141L,A01,185461,Eldon; John,12,0,100,88
1683370467943,CSE 142,A01,185463,Staff,36,0,60,24
1683370467943,CSE 142,B01,201355,Staff,0,7,60,60
1683370468972,CSE 142L,A01,185470,Staff,36,0,60,24
1683370468972,CSE 142L,B01,201417,Staff,0,6,60,60
1683370469999,CSE 190,A00,201433,Staff,32,0,49,17
1683370471028,DOC 1,A01,259136,Strom; Megan C.,7,0,15,8
1683370471028,DOC 1,A02,259137,Strom; Megan C.,14,0,15,1
1683370471028,DOC 1,A03,259138,Strom; Megan C.,14,0,15,1
1683370471028,DOC 1,A04,259139,Strom; Megan C.,14,0,15,1
1683370472053,DOC 100D,A00,259140,Pass; Natalye Joann,16,0,25,9
1683370473082,DSGN 1,A01,184749,Rill; Bryan,0,25,30,30
1683370474106,DSGN 100,A01,185168,Staff,0,2,25,25
1683370475132,ECE 5,A01,185626,Morris; Karcher William,0,10,0,0
1683370476159,ECE 101,A01,185628,Staff,17,0,70,53
1683370477185,ECE 107,A01,185635,Baghdadchi; Saharnaz,0,0,20,20
1683370477185,ECE 107,A02,185638,Baghdadchi; Saharnaz,4,0,20,16
1683370478210,ECE 148,A01,185647,Silberman; Jack,0,0,16,16
1683370479238,ECON 1,A01,185537,Crane; Meredith Helen,54,0,70,16
1683370480261,ECON 3,A01,185549,Crane; Meredith Helen,32,0,70,38
1683370481286,ECON 4,A01,203354,Anderson; John Charles,0,4,10,10
1683370482311,ECON 100A,A01,185574,Staff,0,4,40,40
1683370483334,ECON 100B,A01,185576,Staff,0,12,50,50
1683370484365,ECON 100C,A01,185589,Newhouse; Herbert S,29,0,70,41
1683370485463,ECON 105,A00,185608,Vespa; Emanuel Ignacio,19,0,35,16
1683370486493,ECON 109,A01,185610,Shishkin; Denis,10,0,35,25
1683370487516,ECON 110A,A01,185612,Staff,11,0,40,29
1683370488541,ECON 120A,A01,185615,Staff,20,0,40,20
1683370489565,ECON 120C,A01,185617,Sun; Yixiao,0,21,70,70
1683370490646,ECON 144,A00,203346,Squires; Dale E,3,0,35,32
1683370491669,ECON 171,A01,203349,Newhouse; Herbert S,0,1,35,35
1683370492694,ECON 173A,A01,185621,Toda; Alexis Akira,21,0,35,14
1683370493722,EDS 25,A01,202413,Staff,0,1,0,0
1683370493722,EDS 25,A02,202414,Staff,0,1,0,0
1683370493722,EDS 25,A03,202415,Staff,0,0,0,0
1683370493722,EDS 25,A04,202416,Staff,0,1,0,0
1683370493722,EDS 25,A05,202439,Staff,0,0,0,0
1683370493722,EDS 25,A06,202440,Staff,0,0,0,0
1683370493722,EDS 25,B01,202631,Staff,0,0,0,0
1683370493722,EDS 25,B02,202632,Staff,0,0,0,0
1683370493722,EDS 25,B03,202639,Staff,0,0,0,0
1683370493722,EDS 25,B04,202640,Staff,0,0,0,0
1683370493722,EDS 25,B05,202643,Staff,0,0,0,0
1683370493722,EDS 25,B06,202644,Staff,0,0,0,0
1683370494747,EDS 38,A01,202659,Black; Alison Michelle,24,0,25,1
1683370495773,EDS 115,A00,202652,Staff,18,0,30,12
1683370496796,EDS 125,A00,202649,Staff,14,0,30,16
1683370497824,EDS 126,A01,203332,Staff,30,0,30,0
1683370498847,EDS 139,A00,202838,Staff,16,0,25,9
1683370499926,EDS 146,A01,202655,Staff,14,0,25,11
1683370501007,ENG 15,A00,185667,Staff,0,1,0,0
1683370501007,ENG 15,B00,185672,Staff,0,0,0,0
1683370501007,ENG 15,C00,185675,Staff,0,0,0,0
1683370501007,ENG 15,D00,185682,Staff,0,0,0,0
1683370501007,ENG 15,E00,185684,Staff,0,0,0,0
1683370502035,ETHN 103,A00,185710,Staff,0,4,35,35
1683370503063,ETHN 103A,A00,199228,Man; Simeon S,2,0,9,7
1683370504091,ETHN 109,A00,185711,Staff,18,0,35,17
1683370505118,ETHN 142,A00,185726,Staff,0,4,30,30
1683370506146,ETHN 163J,A00,199229,Man; Simeon S,5,0,8,3
1683370507176,ETHN 168,A00,185727,Staff,8,0,10,2
1683370508198,ETHN 182,A00,185728,Staff,0,0,35,35
1683370509225,ETHN 183,A00,185737,Staff,8,0,18,10
1683370510264,GLBH 111,A01,209361,Burgos; Jose L.,0,0,0,0
1683370512313,HIEU 104,A00,185792,Staff,16,0,20,4
1683370513338,HIEU 115,A00,185800,Staff,1,0,20,19
1683370514361,HIEU 128,A00,185801,Staff,0,7,20,20
1683370515387,HIEU 147,A00,185802,Staff,16,0,20,4
1683370516414,HIEU 154,A00,185823,Staff,12,0,20,8
1683370517497,HILA 102,A00,185826,Staff,13,0,20,7
1683370518521,HILD 2C,A01,185778,Staff,0,12,20,20
1683370519545,HILD 7B,A01,185780,Kwak; Nancy,0,15,32,32
1683370519545,HILD 7B,A02,185781,Kwak; Nancy,0,18,32,32
1683370520569,HILD 30,A01,185791,Staff,14,0,20,6
1683370521597,HISC 119,A00,185830,Golan; Tal,0,9,20,20
1683370522622,HITO 156GS,A00,185831,Patterson; Patrick H.,0,0,0,23
1683370523647,HIUS 103,A00,185832,Man; Simeon S,1,6,20,19
1683370524671,HIUS 117,A00,185836,Kwak; Nancy,2,0,20,18
1683370525697,HIUS 125,A00,185840,Man; Simeon S,0,0,23,23
1683370526725,HIUS 149,A00,185845,Staff,0,0,20,20
1683370527755,HUM 3,A01,185882,Zavodny; Tatiana Sophia,0,7,50,50
1683370527755,HUM 3,B01,185899,Caldwell; Michael Alan,0,18,50,50
1683370528782,HUM 3GS,A00,185900,Patterson; Patrick H.,0,0,0,23
1683370529815,HUM 4,A01,185938,Zroka; Amy Liane,31,0,50,19
1683370529815,HUM 4,B01,185956,Watkins; Eric,0,3,50,50
1683370529815,HUM 4,B02,202209,Watkins; Eric,0,2,50,50
1683370529815,HUM 4,B03,202210,Watkins; Eric,0,2,50,50
1683370530846,HUM 5,A01,185958,West; Geoffrey Scott,3,0,50,47
1683370530846,HUM 5,A02,202215,West; Geoffrey Scott,0,0,50,50
1683370531873,INTL 190,A00,185959,Gagnon; Jeffrey C,0,0,0,9
1683370531873,INTL 190,B00,185960,Lettieri; Michael Joseph,0,0,0,1
1683370532901,JAPN 180,A00,254509,Staff,4,0,30,26
1683370533934,LATI 10,A01,202853,Kennemore; Amy Michelle,4,0,35,31
1683370533934,LATI 10,A02,202854,Kennemore; Amy Michelle,2,0,35,33
1683370533934,LATI 10,A03,270054,Kennemore; Amy Michelle,30,0,30,0
1683370534962,LATI 180,A00,202855,Kennemore; Amy Michelle,11,0,20,9
1683370535988,LAWS 101,A00,201767,Golan; Tal,0,7,40,40
1683370537012,LIFR 1C,A00,185961,Staff,6,0,20,14
1683370538037,LIFR 1CX,A00,185962,Staff,7,0,20,13
1683370539061,LIFR 1D,A00,185963,Staff,9,0,20,11
1683370540085,LIFR 1DX,A00,185964,Staff,9,0,20,11
1683370541112,LIGN 101,A01,186039,Staff,43,0,50,7
1683370542140,LIGN 165,A00,186040,Staff,18,0,50,32
1683370543169,LTCS 108,A00,186041,Staff,6,0,10,4
1683370544193,LTCS 119,A00,186042,Staff,16,0,20,4
1683370545218,LTCS 130,A00,186043,Wesling; Megan E.,15,0,25,10
1683370547267,LTEA 138,A00,186119,Staff,14,0,40,26
1683370548291,LTEN 124,A00,186148,Staff,6,0,25,19
1683370549320,LTEN 178,A00,186149,Staff,7,0,15,8
1683370550346,LTEN 181,A00,186150,Blanco; John D,33,0,40,7
1683370551373,LTWL 120,A00,186160,Staff,20,0,25,5
1683370552401,LTWL 165,A00,186161,Staff,22,0,25,3
1683370553428,LTWR 100,A00,186162,Staff,0,5,15,15
1683370554457,LTWR 102,A00,186163,Doller; Ben,5,0,15,10
1683370555489,MAE 8,A01,186412,Staff,0,0,0,0
1683370556515,MAE 30B,A00,186445,Bahadori; Mohammad Yousef,83,0,100,17
1683370557538,MAE 40,A00,186592,Bewley; Thomas R,10,0,50,40
1683370558564,MAE 101B,A00,186593,Bahadori; Mohammad Yousef,81,0,100,19
1683370559590,MAE 105,A00,186594,Bandaru; Prabhakar,12,0,50,38
1683370560615,MAE 107,A00,186599,Pham; Hieu Tan,0,7,120,120
1683370561643,MAE 148,A01,186660,Silberman; Jack,3,0,16,13
1683370562668,MATH 10A,A01,188095,Staff,0,5,35,35
1683370563701,MATH 10B,A01,188097,Bowers; Adam R.,0,11,30,30
1683370563701,MATH 10B,A02,188099,Bowers; Adam R.,0,11,30,30
1683370563701,MATH 10B,B01,188104,Bowers; Adam R.,0,10,30,30
1683370563701,MATH 10B,B02,188106,Bowers; Adam R.,0,10,30,30
1683370564734,MATH 10C,A01,188111,Staff,0,18,30,30
1683370564734,MATH 10C,A02,188127,Staff,0,17,30,30
1683370564734,MATH 10C,A03,188131,Staff,0,18,30,30
1683370564734,MATH 10C,B01,188218,Staff,18,0,30,12
1683370564734,MATH 10C,B02,188244,Staff,13,0,30,17
1683370564734,MATH 10C,B03,188277,Staff,16,0,30,14
1683370565764,MATH 18,A01,188344,Bach; Quang Tran,18,0,30,12
1683370565764,MATH 18,A02,188345,Bach; Quang Tran,11,0,30,19
1683370565764,MATH 18,B01,188353,Bach; Quang Tran,10,0,30,20
1683370565764,MATH 18,B02,188354,Bach; Quang Tran,20,0,30,10
1683370566789,MATH 20A,A01,188374,Staff,12,0,35,23
1683370567817,MATH 20B,A01,188382,Ohm; Ko Woon,6,0,30,24
1683370567817,MATH 20B,A02,188383,Ohm; Ko Woon,21,0,30,9
1683370567817,MATH 20B,B01,188385,Ohm; Ko Woon,7,0,30,23
1683370567817,MATH 20B,B02,188392,Ohm; Ko Woon,22,0,30,8
1683370568843,MATH 20C,A01,188394,Harel; Guershon,10,0,30,20
1683370568843,MATH 20C,A02,188395,Harel; Guershon,15,0,30,15
1683370568843,MATH 20C,B01,188404,Harel; Guershon,4,0,30,26
1683370568843,MATH 20C,B02,188405,Harel; Guershon,19,0,30,11
1683370569871,MATH 20D,A01,188414,Hammock; Frances H,0,1,30,30
1683370569871,MATH 20D,A02,188415,Hammock; Frances H,3,0,30,27
1683370569871,MATH 20D,B01,188447,Hammock; Frances H,1,0,30,29
1683370569871,MATH 20D,B02,188486,Hammock; Frances H,8,0,30,22
1683370570898,MATH 20E,A01,188649,Staff,21,0,30,9
1683370570898,MATH 20E,A02,188650,Staff,23,0,30,7
1683370570898,MATH 20E,A03,188673,Staff,0,0,30,30
1683370571924,MATH 102,A01,188675,Staff,0,35,35,35
1683370572950,MATH 103B,A01,188681,Staff,3,0,35,32
1683370572950,MATH 103B,B01,188692,Staff,5,0,35,30
1683370573975,MATH 109,A01,188695,Salehi Golsefidy; Alireza,25,0,35,10
1683370573975,MATH 109,A02,188696,Salehi Golsefidy; Alireza,25,0,35,10
1683370575002,MATH 120A,A01,188698,Eggers; John Dietrich,7,0,35,28
1683370576026,MATH 142B,A01,188736,Ioana; Adrian,0,2,30,30
1683370576026,MATH 142B,A02,188741,Ioana; Adrian,0,0,30,30
1683370576026,MATH 142B,A03,188743,Ioana; Adrian,0,1,30,30
1683370577055,MATH 168A,A01,188790,Staff,0,9,35,35
1683370578087,MATH 170A,A01,188803,Nie; Jiawang,0,2,35,35
1683370578087,MATH 170A,A02,188811,Nie; Jiawang,0,0,35,35
1683370578087,MATH 170A,A03,188814,Nie; Jiawang,1,0,35,34
1683370578087,MATH 170A,A04,188815,Nie; Jiawang,13,0,35,22
1683370579115,MATH 193B,A01,188817,Staff,0,0,35,35
1683370579115,MATH 193B,A02,188818,Staff,5,0,35,30
1683370580141,MGT 4,A01,202857,Anderson; John Charles,61,0,80,19
1683370581164,MGT 12,A00,202858,Lindenberger; Wade Douglas,41,0,90,49
1683370582188,MGT 18,A00,202859,Staff,74,0,90,16
1683370583212,MGT 18GS,A00,202860,McKay; Michael J,13,0,28,15
1683370584238,MGT 45,A00,202861,Pecore; Joseph P.,15,0,90,75
1683370585266,MGT 100,A00,202863,Yavorsky; Daniel Ryan,28,0,90,62
1683370586294,MGT 103,A00,202864,Ehrich; Kristine R,0,17,90,90
1683370587324,MGT 112,A00,202865,Ehrich; Kristine R,15,0,90,75
1683370588349,MGT 121A,A00,202868,Staff,0,20,0,0
1683370589372,MGT 131B,A00,202869,Anderson; John Charles,59,0,90,31
1683370590400,MGT 136,A00,202871,Lindenberger; Wade Douglas,84,0,90,6
1683370591423,MGT 164,A00,202873,Staff,0,68,90,91
1683370592448,MGT 164GS,A00,202874,McKay; Mary A,13,0,28,15
1683370593471,MGT 180,A00,202875,Staff,0,50,90,91
1683370594497,MMW 11R,A01,205019,Herbst; Matthew,3,0,30,27
1683370594497,MMW 11R,A02,205026,Herbst; Matthew,29,0,30,1
1683370595532,MMW 15,A01,193512,Chang; Edmond Yi-Teh,0,9,28,28
1683370595532,MMW 15,A02,193513,Chang; Edmond Yi-Teh,0,5,28,28
1683370595532,MMW 15,A03,193514,Chang; Edmond Yi-Teh,0,5,28,28
1683370595532,MMW 15,A04,193515,Chang; Edmond Yi-Teh,0,5,28,28
1683370595532,MMW 15,A05,193516,Chang; Edmond Yi-Teh,0,4,28,28
1683370595532,MMW 15,A06,193517,Chang; Edmond Yi-Teh,0,5,28,28
1683370595532,MMW 15,B01,193519,Chang; Edmond Yi-Teh,0,5,28,28
1683370595532,MMW 15,B02,193520,Chang; Edmond Yi-Teh,0,5,28,28
1683370595532,MMW 15,B03,193521,Chang; Edmond Yi-Teh,0,5,28,28
1683370595532,MMW 15,B04,193522,Chang; Edmond Yi-Teh,0,4,28,28
1683370595532,MMW 15,B05,193523,Chang; Edmond Yi-Teh,0,5,28,28
1683370595532,MMW 15,B06,193524,Chang; Edmond Yi-Teh,0,4,28,28
1683370596556,MMW 122,A01,193526,Rahimi; Babak,0,15,28,28
1683370596556,MMW 122,A02,193527,Rahimi; Babak,0,14,28,28
1683370596556,MMW 122,A03,193528,Rahimi; Babak,0,0,0,0
1683370596556,MMW 122,A04,193529,Rahimi; Babak,0,0,0,0
1683370597579,MUS 1A,A01,186663,Staff,0,20,35,35
1683370598603,MUS 4,A01,186715,Staff,0,12,35,35
1683370599627,MUS 5R,A01,186796,Dubnov; Shlomo,0,17,35,35
1683370600652,MUS 6,A01,186798,Staff,0,4,25,25
1683370601682,MUS 7,A01,186830,Staff,13,0,35,22
1683370602711,MUS 8,A01,186930,Staff,0,26,35,35
1683370603741,MUS 15,A01,186932,Staff,0,16,35,35
1683370603741,MUS 15,B01,186934,Staff,0,15,35,35
1683370604771,MUS 80,A00,186935,Staff,0,0,20,20
1683370604771,MUS 80,B00,186936,Staff,25,0,25,0
1683370605798,NANO 11,A00,204702,Lipomi; Darren John,0,0,0,0
1683370606825,NANO 15,A01,204709,Yang; Kesong,0,1,0,0
1683370607851,NANO 114,A00,202069,Jahed Motlagh; Zeinab,3,0,10,7
1683370608876,PHIL 1,A00,186955,Grush; Rick Scott,32,0,40,8
1683370609901,PHIL 10,A01,186973,Grush; Rick Scott,28,0,35,7
1683370609901,PHIL 10,A02,186974,Grush; Rick Scott,33,0,35,2
1683370610926,PHIL 13,A01,186976,Staff,7,0,35,28
1683370610926,PHIL 13,A02,186977,Staff,16,0,35,19
1683370611952,PHIL 14,A01,186979,Staff,31,0,35,4
1683370611952,PHIL 14,A02,186986,Staff,32,0,35,3
1683370612981,PHIL 28,A01,186988,Staff,16,0,30,14
1683370612981,PHIL 28,A02,186989,Staff,1,0,30,29
1683370612981,PHIL 28,A03,186990,Staff,9,0,30,21
1683370612981,PHIL 28,A04,186991,Staff,26,0,30,4
1683370614008,PHIL 120,A00,186997,Staff,23,0,40,17
1683370615039,PHIL 137,A00,187003,Staff,9,0,40,31
1683370616068,PHIL 150,A00,187015,Staff,47,0,70,23
1683370617092,PHIL 167,A00,187021,Lamey; Andy M.,35,0,40,5
1683370618123,PHIL 174,A01,202226,Staff,17,0,20,3
1683370618123,PHIL 174,A02,202235,Staff,20,0,20,0
1683370619151,PHIL 191A,A00,258918,Staff,0,0,1,1
1683370620183,PHYS 1A,A00,187028,Staff,27,0,60,33
1683370621285,PHYS 1AL,001,187036,Staff,2,0,30,28
1683370621285,PHYS 1AL,002,187049,Staff,18,0,30,12
1683370622314,PHYS 1B,A00,187058,Staff,22,0,60,38
1683370623339,PHYS 1BL,001,187064,Staff,0,0,30,30
1683370623339,PHYS 1BL,002,187070,Staff,5,0,30,25
1683370624365,PHYS 1C,A00,187082,Staff,31,0,120,89
1683370625393,PHYS 1CL,001,187088,Staff,0,9,30,30
1683370625393,PHYS 1CL,002,187089,Staff,0,2,30,30
1683370625393,PHYS 1CL,009,262693,Staff,11,0,30,19
1683370626425,PHYS 2B,A01,187097,Staff,54,0,115,61
1683370627455,PHYS 2C,A01,187099,Staff,67,0,115,48
1683370628486,PHYS 2CL,A01,187101,Staff,5,0,28,23
1683370628486,PHYS 2CL,A02,187102,Staff,15,0,28,13
1683370629516,PHYS 2D,A01,187123,Shotwell; Brian,95,0,115,20
1683370630546,PHYS 4B,A01,187133,Grinstein; Benjamin,35,0,50,15
1683370631575,POLI 10,A00,188819,Staff,0,4,50,50
1683370632604,POLI 11,A00,188827,Staff,43,0,50,7
1683370633628,POLI 13R,A00,188828,Staff,0,1,20,20
1683370634653,POLI 27,A01,188830,Elgin; Samuel Zincke,0,1,70,70
1683370635676,POLI 30,A00,188832,Desposato; Scott,31,0,50,19
1683370636702,POLI 102F,A00,188834,Staff,2,0,40,38
1683370637727,POLI 104A,A00,188852,Staff,14,0,30,16
1683370638758,POLI 104I,A00,188853,Staff,0,6,20,20
1683370639788,POLI 110B,A00,188854,Wiens; David,7,0,20,13
1683370640817,POLI 112A,A00,188855,Wiens; David,5,0,30,25
1683370641843,POLI 117R,A00,188856,Forman; Fonna,0,11,20,20
1683370642867,POLI 118,A00,188857,Ingham; Sean,8,0,20,12
1683370643893,POLI 120G,A00,188858,Staff,9,0,30,21
1683370644919,POLI 131CR,A00,188863,Hoston; Germaine,23,0,50,27
1683370645945,POLI 133,A00,188864,Nellis; Gareth Hb,44,0,50,6
1683370646974,POLI 134D,A00,188865,Desposato; Scott,27,0,30,3
1683370648003,POLI 142A,A00,188871,Gartzke; Erik,22,0,50,28
1683370649032,POLI 142K,A00,188874,Staff,38,0,50,12
1683370650058,POLI 143,A00,188940,Gartzke; Erik,16,0,30,14
1683370651083,POLI 153,A00,188943,Staff,3,0,20,17
1683370652107,POLI 160AA,A00,188944,Staff,11,0,40,29
1683370653132,POLI 170A,A00,188945,Staff,11,0,30,19
1683370655181,PSYC 1,A00,188952,Staff,37,0,90,53
1683370656205,PSYC 2,B00,188953,Staff,19,0,35,16
1683370657231,PSYC 6,A00,188970,Staff,47,0,60,13
1683370658260,PSYC 7,A00,188973,Staff,37,0,45,8
1683370659291,PSYC 60,A01,188980,Rickard; Timothy C.,43,0,60,17
1683370660323,PSYC 70,A01,189001,Steiner; Eric Tomas,23,0,45,22
1683370661353,PSYC 100,A00,189005,Lacefield; Katharine I,0,98,120,120
1683370662378,PSYC 102,A00,189008,Staff,9,0,30,21
1683370663403,PSYC 106,B00,189026,Gorman; Michael R.,34,0,60,26
1683370664428,PSYC 114,B01,189033,Winkielman; Piotr,0,32,30,30
1683370665453,PSYC 131,A00,189036,Anagnostaras; Stephan,0,43,60,60
1683370666483,PSYC 136,A00,189041,Lowe; Angela Beth,0,7,25,25
1683370667508,PSYC 137,A00,189057,Winkielman; Piotr,0,34,25,25
1683370668536,PSYC 144,A00,189107,Wixted; John T,0,7,50,50
1683370670584,PSYC 162,A00,189142,Staff,0,8,85,85
1683370671610,PSYC 172,A00,189144,Gorman; Michael R.,0,7,30,30
1683370673661,PSYC 179,A00,189146,Lacefield; Katharine I,0,84,120,120
1683370674686,PSYC 181,A00,189147,Anagnostaras; Stephan,0,44,90,90
1683370675711,PSYC 190R,A00,189148,Barner; David A.,0,22,80,80
1683370676739,PSYC 191,A00,189275,Rickard; Timothy C.,0,7,25,25
1683370677765,PSYC 193,A00,189276,Chapman; Eddie Nathaniel,0,1,0,4
1683370678790,PSYC 193L,A01,189281,Lowe; Angela Beth,12,0,20,8
1683370678790,PSYC 193L,B01,189285,Staff,28,0,35,7
1683370679816,RELI 149,A00,187137,Rahimi; Babak,7,0,40,33
1683370680842,SE 9,A01,187315,Staff,0,2,18,18
1683370681869,SE 101B,A00,187409,Staff,24,0,30,6
1683370682895,SE 110B,A00,187444,Staff,10,0,40,30
1683370683921,SE 130B,A00,187449,Staff,31,0,40,9
1683370684947,SE 150A,A00,187516,Staff,9,0,20,11
1683370685972,SE 154,A00,187528,Staff,30,0,50,20
1683370686998,SIO 3,A01,258171,Staff,35,0,40,5
1683370688023,SIO 10,A00,187144,Cook; Geoffrey W,0,3,75,75
1683370689053,SIO 45,A00,187152,Cook; Geoffrey W,1,0,100,99
1683370690079,SIO 109R,A00,194486,Staff,0,3,20,20
1683370692132,SIO 187,A01,187233,Kacev; David,12,0,40,28
1683370693160,SOCI 1,A01,258656,Thorpe; Charles Robert,28,0,30,2
1683370693160,SOCI 1,A02,258658,Thorpe; Charles Robert,30,0,30,0
1683370693160,SOCI 1,A03,258661,Thorpe; Charles Robert,25,0,25,0
1683370693160,SOCI 1,A04,258666,Thorpe; Charles Robert,22,0,25,3
1683370693160,SOCI 1,A05,258897,Thorpe; Charles Robert,23,0,25,2
1683370693160,SOCI 1,A06,258898,Thorpe; Charles Robert,25,0,25,0
1683370694186,SOCI 30,A01,258903,Pardo Guerra; Juan Pablo,15,0,30,15
1683370695212,SOCI 102,A00,258904,Staff,9,0,25,16
1683370696237,SOCI 106,A00,258905,Staff,19,0,25,6
1683370697266,SOCI 111,A00,258907,Ribas Norris; Janet Vanesa,26,0,30,4
1683370698296,SOCI 121R,A00,258908,Pardo Guerra; Juan Pablo,10,0,30,20
1683370699326,SOCI 126,A01,203330,Staff,14,0,20,6
1683370700354,SOCI 131,A00,258909,Thorpe; Charles Robert,31,0,60,29
1683370701379,SOCI 135,A00,258910,Payne; Christine Anna,0,9,30,30
1683370702407,SOCI 157,A00,258911,Staff,12,0,30,18
1683370703439,SOCI 184,A00,258912,Staff,25,0,30,5
1683370704464,SOCI 188D,A00,258913,Staff,22,0,30,8
1683370705491,SYN 2,001,187529,Staff,10,0,16,6
1683370705491,SYN 2,002,201452,Staff,0,18,16,16
1683370705491,SYN 2,003,201469,Staff,3,0,16,13
1683370706515,SYN 100,A01,187531,Staff,0,9,20,20
1683370706515,SYN 100,B01,201491,Staff,0,12,20,20
1683370707542,TDAC 1,A00,189286,Walsh; Kim C.,3,0,20,17
1683370707542,TDAC 1,B00,189287,Harting; Carla Kelso,11,0,20,9
1683370708569,TDAC 101,A00,189300,Walsh; Kim C.,16,0,20,4
1683370708569,TDAC 101,B00,189301,Harting; Carla Kelso,18,0,20,2
1683370709601,TDAC 102,A00,189304,Basso; Beatrice,14,0,20,6
1683370710628,TDAC 108,A00,189305,Staff,18,0,20,2
1683370711662,TDDE 131,A00,189310,Staff,19,0,20,1
1683370711662,TDDE 131,B00,189314,Staff,19,0,20,1
1683370711662,TDDE 131,C00,189315,Staff,48,0,50,2
1683370711662,TDDE 131,D00,189316,Staff,14,0,15,1
1683370711662,TDDE 131,E00,204841,Staff,20,0,20,0
1683370712692,TDGE 10,A00,189289,Staff,30,0,50,20
1683370712692,TDGE 10,B00,189290,Havis; Allan,1,0,50,49
1683370713726,TDGE 11,A00,189291,Fulton; Julia,0,3,50,50
1683370713726,TDGE 11,B00,189292,Staff,20,0,25,5
1683370713726,TDGE 11,C00,260270,Staff,0,0,0,0
1683370714755,TDGE 25,A00,189294,Staff,3,0,20,17
1683370715779,TDGE 124,A00,189318,Fulton; Julia,0,8,50,50
1683370716804,TDGE 125,A00,189319,Staff,13,0,25,12
1683370716804,TDGE 125,B00,189320,Staff,23,0,25,2
1683370717826,TDGE 127,A00,189322,Havis; Allan,0,0,50,50
1683370718856,TDHT 101,A00,189323,Staff,18,0,25,7
1683370718856,TDHT 101,B00,189324,Staff,25,0,25,0
1683370719886,TDHT 102,A00,189325,Staff,49,0,50,1
1683370720919,TDMV 1,A00,189295,Arcidiacono; Kristin,19,0,30,11
1683370720919,TDMV 1,B00,189296,Caligagan; Maria T.,24,0,30,6
1683370721951,TDMV 2,A00,189297,Sammartano; Tonnie,28,0,30,2
1683370721951,TDMV 2,B00,189299,Arcidiacono; Kristin,24,0,30,6
1683370722979,TDMV 3,A00,204998,Rincon; Alicia,22,0,30,8
1683370724004,TDMV 120,A00,189458,Sammartano; Tonnie,28,0,30,2
1683370725085,TDMV 138,A00,189541,Jun; Grace Shin Hae,22,0,40,18
1683370726109,TDMV 142,A00,189717,Caligagan; Tony,24,0,30,6
1683370726109,TDMV 142,B00,189718,Caligagan; Maria T.,25,0,30,5
1683370727133,TMC 2,A01,187533,Staff,25,0,25,0
1683370727133,TMC 2,A02,187534,Staff,25,0,25,0
1683370728163,USP 1,A01,187536,Kwak; Nancy,0,16,25,25
1683370729192,USP 5,A01,187538,Staff,10,0,25,15
1683370730221,USP 101,A00,199253,Staff,0,4,0,0
1683370731253,USP 124,A00,187562,Boomhower; Matthew Charles,1,0,30,29
1683370732280,USP 138,A00,187582,Staff,20,0,25,5
1683370733305,USP 152,A01,187597,Staff,4,0,25,21
1683370734334,USP 153,A00,187598,Staff,19,0,25,6
1683370735360,USP 168,A00,187607,Kwak; Nancy,2,0,5,3
1683370736385,USP 173,A00,187619,Staff,4,0,25,21
1683370737408,USP 181,A00,187638,Staff,0,3,25,25
1683370738434,VIS 103,A00,187650,Cruz; Edwin Teddy,22,0,75,53
1683370739459,VIS 110D,A00,187669,Staff,12,0,22,10
1683370740487,VIS 127C,A00,187720,Shen; Kuiyi,67,0,146,79
1683370741518,VIS 149,A00,187731,Yoldas; Pinar,0,14,22,22
1683370742543,VIS 151,A01,188091,Staff,22,0,34,12
1683370742543,VIS 151,A02,188092,Staff,11,0,34,23
1683370743568,VIS 160B,A00,188093,Stalbaum; Brett,0,0,10,10
1683370745619,WCWP 10B,A00,201720,Staff,10,0,15,5
1683370745619,WCWP 10B,B00,201722,Staff,9,0,15,6
1683370746646,WCWP 100,A00,201725,Gagnon; Jeffrey C,0,0,2,2
1683370746646,WCWP 100,B00,201727,Staff,0,4,15,15
1683370749791,ANBI 133,A00,258401,Wilder; Linnea Lorene,34,0,40,6
1683370750821,ANBI 140,A00,258395,Hrvoj Mihic; Branka,18,0,25,7
1683370751846,ANSC 120,A00,258402,Bialecki; Jon Anthony,27,0,40,13
1683370752870,ANSC 144,A00,258400,Staff,14,0,40,26
1683370754918,ANSC 166,A00,258396,Parish; Steven Martin,158,0,175,17
1683370755943,ANSC 180,A00,193533,Staff,9,0,20,11
1683370756970,ANSC 188,A00,258397,Jassal; Aftab,33,0,40,7
1683370757995,ANTH 3,A01,258316,Staff,23,0,30,7
1683370759023,ANTH 5,A00,258394,Semendeferi; Ekaterini,16,0,20,4
1683370760052,ANTH 21,A01,258331,Staff,8,0,40,32
1683370761079,ANTH 103,A00,258398,Varma; Saiba,15,0,25,10
1683370762129,AWP 10,001,202034,Staff,0,0,0,0
1683370762129,AWP 10,002,202035,Staff,0,0,0,0
1683370762129,AWP 10,003,202036,Staff,0,0,0,0
1683370762129,AWP 10,004,202037,Staff,0,0,0,0
1683370762129,AWP 10,005,202038,Staff,0,0,0,0
1683370762129,AWP 10,006,202039,Staff,0,0,0,0
1683370762129,AWP 10,007,202040,Staff,0,0,0,0
1683370762129,AWP 10,008,202041,Staff,0,0,0,0
1683370762129,AWP 10,009,202042,Staff,0,0,0,0
1683370762129,AWP 10,010,202043,Staff,0,0,0,0
1683370762129,AWP 10,011,202044,Staff,0,0,0,0
1683370762129,AWP 10,012,202045,Staff,0,0,0,0
1683370762129,AWP 10,013,202046,Staff,0,0,0,0
1683370762129,AWP 10,014,202047,Staff,0,0,0,0
1683370762129,AWP 10,015,202048,Staff,0,0,0,0
1683370762129,AWP 10,016,202049,Staff,0,0,0,0
1683370762129,AWP 10,017,202050,Staff,0,0,0,0
1683370762129,AWP 10,018,202051,Staff,0,0,0,0
1683370762129,AWP 10,019,202052,Staff,0,0,0,0
1683370762129,AWP 10,020,202053,Staff,0,0,0,0
1683370762129,AWP 10,021,202054,Staff,0,0,0,0
1683370762129,AWP 10,022,202055,Staff,0,0,0,0
1683370762129,AWP 10,023,202056,Staff,0,0,0,0
1683370762129,AWP 10,024,202057,Staff,0,0,0,0
1683370762129,AWP 10,025,202058,Staff,0,0,0,0
1683370762129,AWP 10,026,202059,Staff,0,0,0,0
1683370763154,AWP 102,001,202032,Staff,0,0,0,0
1683370763154,AWP 102,002,202033,Staff,0,0,0,0
1683370764180,BENG 100,A01,254234,Taylor Amos; Alyssa C,31,0,40,9
1683370765205,BENG 196,001,270013,Engler; Adam J.,9999,0,9999,0
1683370766232,BICD 100R,A01,202018,Smith; Laurie,0,7,32,32
1683370766232,BICD 100R,A02,202019,Smith; Laurie,0,2,32,32
1683370766232,BICD 100R,A03,202020,Smith; Laurie,0,1,32,32
1683370766232,BICD 100R,A04,202021,Smith; Laurie,9,0,32,23
1683370766232,BICD 100R,A05,202022,Smith; Laurie,12,0,32,20
1683370767271,BICD 136,A01,193242,Gustafson-Brown; Cindy,0,2,32,32
1683370767271,BICD 136,A02,193244,Gustafson-Brown; Cindy,14,0,32,18
1683370768298,BIEB 102,A01,193249,Butler; Shannon Rhey,0,2,32,32
1683370768298,BIEB 102,A02,193251,Butler; Shannon Rhey,0,0,32,32
1683370768298,BIEB 102,A03,193253,Butler; Shannon Rhey,0,1,32,32
1683370768298,BIEB 102,A04,193255,Butler; Shannon Rhey,17,0,32,15
1683370768298,BIEB 102,A05,193265,Butler; Shannon Rhey,26,0,32,6
1683370768298,BIEB 102,A06,193269,Butler; Shannon Rhey,16,0,32,16
1683370770358,BIEB 150,A01,193274,Staff,0,0,32,32
1683370770358,BIEB 150,A02,193285,Staff,23,0,32,9
1683370771387,BIEB 194,A00,193286,Kurle; Carolyn M.,22,0,32,10
1683370772421,BILD 1,A01,192291,Staff,16,0,32,16
1683370772421,BILD 1,A02,192292,Staff,30,0,32,2
1683370772421,BILD 1,B01,192520,Reuther; Keefe,0,1,0,0
1683370772421,BILD 1,B02,192532,Reuther; Keefe,0,1,0,0
1683370773447,BILD 3,A01,192556,Butler; Shannon Rhey,0,0,32,32
1683370773447,BILD 3,A02,192581,Butler; Shannon Rhey,4,0,32,28
1683370773447,BILD 3,A03,192611,Butler; Shannon Rhey,23,0,32,9
1683370773447,BILD 3,A04,192612,Butler; Shannon Rhey,25,0,32,7
1683370773447,BILD 3,A05,192613,Butler; Shannon Rhey,27,0,32,5
1683370773447,BILD 3,A06,192679,Butler; Shannon Rhey,27,0,32,5
1683370773447,BILD 3,A07,192682,Butler; Shannon Rhey,21,0,32,11
1683370774473,BILD 4,A01,192836,Reuther; Keefe,0,0,24,24
1683370774473,BILD 4,A02,193044,Reuther; Keefe,4,0,24,20
1683370775497,BILD 10,A01,193142,Gustafson-Brown; Cindy,30,0,32,2
1683370775497,BILD 10,A02,193149,Gustafson-Brown; Cindy,31,0,32,1
1683370776526,BIMM 100,A01,193301,Staff,1,6,32,31
1683370776526,BIMM 100,A02,193312,Staff,0,5,32,32
1683370776526,BIMM 100,A03,193323,Staff,0,8,32,32
1683370777558,BIMM 101,A01,193329,McDonnell; Lisa Marie,0,3,24,24
1683370777558,BIMM 101,A02,193339,McDonnell; Lisa Marie,0,3,24,24
1683370777558,BIMM 101,B01,193354,McDonnell; Lisa Marie,0,3,24,24
1683370777558,BIMM 101,B02,193357,McDonnell; Lisa Marie,0,3,24,24
1683370778590,BIMM 110,A01,193377,Tat; John,0,11,32,32
1683370778590,BIMM 110,A02,193378,Tat; John,0,9,32,32
1683370779625,BIMM 120,A01,206116,Staff,0,0,32,32
1683370779625,BIMM 120,A02,206117,Staff,8,0,32,24
1683370779625,BIMM 120,A03,206121,Staff,21,0,32,11
1683370780649,BIPN 100,A01,193393,Park; Ji Young,0,14,32,32
1683370780649,BIPN 100,A02,193402,Park; Ji Young,0,13,32,32
1683370780649,BIPN 100,A03,193413,Park; Ji Young,0,14,32,32
1683370780649,BIPN 100,A04,193414,Park; Ji Young,0,13,32,32
1683370781680,BIPN 102,A01,193429,Staff,0,0,32,32
1683370781680,BIPN 102,A02,193438,Staff,22,0,32,10
1683370782719,BIPN 106,A01,193450,Reyes Gonzalez; Catalina,0,2,40,40
1683370783748,BIPN 134,A01,193465,Cooke; James Edward,1,0,32,31
1683370783748,BIPN 134,A02,193474,Cooke; James Edward,25,0,32,7
1683370783748,BIPN 134,A03,193485,Cooke; James Edward,29,0,32,3
1683370783748,BIPN 134,A04,193486,Cooke; James Edward,21,0,32,11
1683370783748,BIPN 134,A05,193491,Cooke; James Edward,31,0,32,1
1683370783748,BIPN 134,A06,193501,Cooke; James Edward,30,0,32,2
1683370783748,BIPN 134,A07,193510,Cooke; James Edward,29,0,32,3
1683370785799,BISP 194,A00,222522,Staff,14,0,32,18
1683370786830,CAT 124,A01,202407,Staff,19,0,25,6
1683370787859,CAT 125,A00,202408,Marchisotto; Jennifer Anne,4,0,20,16
1683370788886,CAT 125R,A00,202409,Smith; Lauryn Alissa,0,11,20,20
1683370788886,CAT 125R,B00,202410,Morales; Celeste Georgianna,0,11,20,20
1683370788886,CAT 125R,C00,202411,Irwin; Matthew Joseph,0,10,20,20
1683370789912,CENG 15,A01,204712,Yang; Kesong,0,1,0,0
1683370790944,CENG 114,A00,202070,Jahed Motlagh; Zeinab,5,0,20,15
1683370791977,CGS 105,A00,185477,Wesling; Megan E.,24,0,40,16
1683370793006,CGS 106,A00,185494,Staff,13,0,22,9
1683370794036,CGS 108,A00,185495,Staff,14,0,20,6
1683370795063,CGS 114,A00,185496,Staff,13,0,18,5
1683370796090,CGS 119,A00,185501,Staff,15,0,20,5
1683370797112,CGS 120,A00,185511,Staff,13,0,20,7
1683370798144,CHEM 4,A01,184675,Bussey; Thomas J,96,0,100,4
1683370799174,CHEM 6A,A01,184677,Staff,34,0,60,26
1683370800200,CHEM 6B,A01,184679,Staff,65,0,100,35
1683370801226,CHEM 6C,A01,184681,Bussey; Thomas J,1,0,50,49
1683370801226,CHEM 6C,A02,184682,Bussey; Thomas J,34,0,50,16
1683370802255,CHEM 40A,A01,184684,Albizati; Kim F.,37,0,100,63
1683370803281,CHEM 40B,A01,184686,Albizati; Kim F.,0,20,100,100
1683370804306,CHEM 41B,A01,184690,Staff,52,0,100,48
1683370805330,COGS 3,A01,184715,Boyle; Mary E. T.,0,25,40,40
1683370806357,COGS 14B,A01,185172,Staff,0,15,38,38
1683370807382,COGS 18,A01,184736,Staff,16,0,80,64
1683370808407,COGS 100,A01,184932,Staff,0,5,73,73
1683370809435,COGS 101A,A01,184935,Staff,0,39,30,30
1683370810460,COGS 101B,A01,184944,Staff,0,2,30,30
1683370811488,COGS 101C,A01,184946,Staff,0,12,30,30
1683370812515,COGS 102A,A01,184951,Johnson; Christine M.,2,0,40,38
1683370813546,COGS 107B,A01,184953,Mooshagian; Eric Frederick,0,50,40,40
1683370814572,COGS 118B,A01,184959,Gupta; Anjum,0,48,40,40
1683370815600,COGS 153,A00,184961,Staff,0,15,30,30
1683370816624,COGS 177,A00,184962,Staff,0,20,30,30
1683370817649,COGS 187A,A01,184969,Boyle; Mary E. T.,0,17,40,40
1683370818686,COMM 10,A01,185174,Staff,0,5,25,25
1683370818686,COMM 10,A02,185189,Staff,0,5,25,25
1683370818686,COMM 10,A03,269821,Staff,0,0,0,0
1683370819710,COMM 100B,A01,185475,Staff,0,0,0,2
1683370819710,COMM 100B,A02,185476,Staff,13,0,25,12
1683370820735,COMM 100C,A01,185314,Staff,1,0,25,24
1683370820735,COMM 100C,A02,185327,Staff,19,0,25,6
1683370821760,COMM 110M,A00,185349,Staff,2,0,40,38
1683370822784,COMM 113T,A00,185352,Staff,24,0,40,16
1683370823808,COMM 114I,A00,185353,Staff,33,0,40,7
1683370824833,COMM 131,A00,185354,Staff,19,0,30,11
1683370825858,CSE 8A,A50,185358,Cao; Yingjun,0,46,10,10
1683370826887,CSE 8B,A01,185362,Staff,0,46,50,50
1683370827916,CSE 11,A01,185416,Cao; Yingjun,0,92,10,10
1683370829012,CSE 20,A01,185445,Briones; Jor-el Thomas Caparas,5,0,25,20
1683370830042,CSE 21,A01,185447,Staff,10,0,50,40
1683370831079,CSE 101,A01,185451,Staff,0,13,50,50
1683370831079,CSE 101,B01,185453,Jones; Miles E,0,11,50,50
1683370833138,CSE 141,A01,185458,Eldon; John,20,0,100,80
1683370834163,CSE 141L,A01,185461,Eldon; John,12,0,100,88
1683370835190,CSE 142,A01,185463,Staff,36,0,60,24
1683370835190,CSE 142,B01,201355,Staff,0,7,60,60
1683370836219,CSE 142L,A01,185470,Staff,36,0,60,24
1683370836219,CSE 142L,B01,201417,Staff,0,6,60,60
1683370837242,CSE 190,A00,201433,Staff,32,0,49,17
1683370838281,DOC 1,A01,259136,Strom; Megan C.,7,0,15,8
1683370838281,DOC 1,A02,259137,Strom; Megan C.,14,0,15,1
1683370838281,DOC 1,A03,259138,Strom; Megan C.,14,0,15,1
1683370838281,DOC 1,A04,259139,Strom; Megan C.,14,0,15,1
1683370839310,DOC 100D,A00,259140,Pass; Natalye Joann,16,0,25,9
1683370840335,DSGN 1,A01,184749,Rill; Bryan,0,25,30,30
1683370841365,DSGN 100,A01,185168,Staff,0,2,25,25
1683370842391,ECE 5,A01,185626,Morris; Karcher William,0,10,0,0
1683370843414,ECE 101,A01,185628,Staff,17,0,70,53
1683370844438,ECE 107,A01,185635,Baghdadchi; Saharnaz,0,0,20,20
1683370844438,ECE 107,A02,185638,Baghdadchi; Saharnaz,4,0,20,16
1683370845462,ECE 148,A01,185647,Silberman; Jack,0,0,16,16
1683370846486,ECON 1,A01,185537,Crane; Meredith Helen,54,0,70,16
1683370847513,ECON 3,A01,185549,Crane; Meredith Helen,32,0,70,38
1683370848539,ECON 4,A01,203354,Anderson; John Charles,0,4,10,10
1683370849567,ECON 100A,A01,185574,Staff,0,4,40,40
1683370850595,ECON 100B,A01,185576,Staff,0,12,50,50
1683370851620,ECON 100C,A01,185589,Newhouse; Herbert S,29,0,70,41
1683370852646,ECON 105,A00,185608,Vespa; Emanuel Ignacio,19,0,35,16
1683370853670,ECON 109,A01,185610,Shishkin; Denis,10,0,35,25
1683370854695,ECON 110A,A01,185612,Staff,11,0,40,29
1683370855721,ECON 120A,A01,185615,Staff,20,0,40,20
1683370856751,ECON 120C,A01,185617,Sun; Yixiao,0,21,70,70
1683370857777,ECON 144,A00,203346,Squires; Dale E,3,0,35,32
1683370858809,ECON 171,A01,203349,Newhouse; Herbert S,0,1,35,35
1683370859839,ECON 173A,A01,185621,Toda; Alexis Akira,21,0,35,14
1683370860870,EDS 25,A01,202413,Staff,0,1,0,0
1683370860870,EDS 25,A02,202414,Staff,0,1,0,0
1683370860870,EDS 25,A03,202415,Staff,0,0,0,0
1683370860870,EDS 25,A04,202416,Staff,0,1,0,0
1683370860870,EDS 25,A05,202439,Staff,0,0,0,0
1683370860870,EDS 25,A06,202440,Staff,0,0,0,0
1683370860870,EDS 25,B01,202631,Staff,0,0,0,0
1683370860870,EDS 25,B02,202632,Staff,0,0,0,0
1683370860870,EDS 25,B03,202639,Staff,0,0,0,0
1683370860870,EDS 25,B04,202640,Staff,0,0,0,0
1683370860870,EDS 25,B05,202643,Staff,0,0,0,0
1683370860870,EDS 25,B06,202644,Staff,0,0,0,0
1683370861904,EDS 38,A01,202659,Black; Alison Michelle,24,0,25,1
1683370862930,EDS 115,A00,202652,Staff,18,0,30,12
1683370863955,EDS 125,A00,202649,Staff,14,0,30,16
1683370864981,EDS 126,A01,203332,Staff,30,0,30,0
1683370866004,EDS 139,A00,202838,Staff,16,0,25,9
1683370867043,EDS 146,A01,202655,Staff,14,0,25,11
1683370868072,ENG 15,A00,185667,Staff,0,1,0,0
1683370868072,ENG 15,B00,185672,Staff,0,0,0,0
1683370868072,ENG 15,C00,185675,Staff,0,0,0,0
1683370868072,ENG 15,D00,185682,Staff,0,0,0,0
1683370868072,ENG 15,E00,185684,Staff,0,0,0,0
1683370869098,ETHN 103,A00,185710,Staff,0,4,35,35
1683370870124,ETHN 103A,A00,199228,Man; Simeon S,2,0,9,7
1683370871149,ETHN 109,A00,185711,Staff,18,0,35,17
1683370872178,ETHN 142,A00,185726,Staff,0,4,30,30
1683370873203,ETHN 163J,A00,199229,Man; Simeon S,5,0,8,3
1683370874227,ETHN 168,A00,185727,Staff,8,0,10,2
1683370875251,ETHN 182,A00,185728,Staff,0,0,35,35
1683370876278,ETHN 183,A00,185737,Staff,8,0,18,10
1683370877305,GLBH 111,A01,209361,Burgos; Jose L.,0,0,0,0
1683370879358,HIEU 104,A00,185792,Staff,16,0,20,4
1683370880395,HIEU 115,A00,185800,Staff,1,0,20,19
1683370881422,HIEU 128,A00,185801,Staff,0,7,20,20
1683370882449,HIEU 147,A00,185802,Staff,16,0,20,4
1683370883472,HIEU 154,A00,185823,Staff,12,0,20,8
1683370884496,HILA 102,A00,185826,Staff,13,0,20,7
1683370885525,HILD 2C,A01,185778,Staff,0,12,20,20
1683370886550,HILD 7B,A01,185780,Kwak; Nancy,0,15,32,32
1683370886550,HILD 7B,A02,185781,Kwak; Nancy,0,18,32,32
1683370887585,HILD 30,A01,185791,Staff,14,0,20,6
1683370888610,HISC 119,A00,185830,Golan; Tal,0,9,20,20
1683370889635,HITO 156GS,A00,185831,Patterson; Patrick H.,0,0,0,23
1683370890663,HIUS 103,A00,185832,Man; Simeon S,1,6,20,19
1683370891687,HIUS 117,A00,185836,Kwak; Nancy,2,0,20,18
1683370892711,HIUS 125,A00,185840,Man; Simeon S,0,0,23,23
1683370893736,HIUS 149,A00,185845,Staff,0,0,20,20
1683370894764,HUM 3,A01,185882,Zavodny; Tatiana Sophia,0,7,50,50
1683370894764,HUM 3,B01,185899,Caldwell; Michael Alan,0,18,50,50
1683370895791,HUM 3GS,A00,185900,Patterson; Patrick H.,0,0,0,23
1683370896837,HUM 4,A01,185938,Zroka; Amy Liane,31,0,50,19
1683370896837,HUM 4,B01,185956,Watkins; Eric,0,3,50,50
1683370896837,HUM 4,B02,202209,Watkins; Eric,0,2,50,50
1683370896837,HUM 4,B03,202210,Watkins; Eric,0,2,50,50
1683370897861,HUM 5,A01,185958,West; Geoffrey Scott,3,0,50,47
1683370897861,HUM 5,A02,202215,West; Geoffrey Scott,0,0,50,50
1683370898896,INTL 190,A00,185959,Gagnon; Jeffrey C,0,0,0,9
1683370898896,INTL 190,B00,185960,Lettieri; Michael Joseph,0,0,0,1
1683370899923,JAPN 180,A00,254509,Staff,4,0,30,26
1683370900950,LATI 10,A01,202853,Kennemore; Amy Michelle,4,0,35,31
1683370900950,LATI 10,A02,202854,Kennemore; Amy Michelle,2,0,35,33
1683370900950,LATI 10,A03,270054,Kennemore; Amy Michelle,30,0,30,0
1683370901974,LATI 180,A00,202855,Kennemore; Amy Michelle,11,0,20,9
1683370903000,LAWS 101,A00,201767,Golan; Tal,0,7,40,40
1683370904026,LIFR 1C,A00,185961,Staff,6,0,20,14
1683370905052,LIFR 1CX,A00,185962,Staff,7,0,20,13
1683370906078,LIFR 1D,A00,185963,Staff,9,0,20,11
1683370907103,LIFR 1DX,A00,185964,Staff,9,0,20,11
1683370908128,LIGN 101,A01,186039,Staff,43,0,50,7
1683370909156,LIGN 165,A00,186040,Staff,18,0,50,32
1683370910180,LTCS 108,A00,186041,Staff,6,0,10,4
1683370911203,LTCS 119,A00,186042,Staff,16,0,20,4
1683370912234,LTCS 130,A00,186043,Wesling; Megan E.,15,0,25,10
1683370914282,LTEA 138,A00,186119,Staff,14,0,40,26
1683370915310,LTEN 124,A00,186148,Staff,6,0,25,19
1683370916334,LTEN 178,A00,186149,Staff,7,0,15,8
1683370917360,LTEN 181,A00,186150,Blanco; John D,33,0,40,7
1683370918384,LTWL 120,A00,186160,Staff,20,0,25,5
1683370919409,LTWL 165,A00,186161,Staff,22,0,25,3
1683370920437,LTWR 100,A00,186162,Staff,0,5,15,15
1683370921466,LTWR 102,A00,186163,Doller; Ben,5,0,15,10
1683370922491,MAE 8,A01,186412,Staff,0,0,0,0
1683370923516,MAE 30B,A00,186445,Bahadori; Mohammad Yousef,83,0,100,17
1683370924539,MAE 40,A00,186592,Bewley; Thomas R,10,0,50,40
1683370925564,MAE 101B,A00,186593,Bahadori; Mohammad Yousef,81,0,100,19
1683370926593,MAE 105,A00,186594,Bandaru; Prabhakar,12,0,50,38
1683370927619,MAE 107,A00,186599,Pham; Hieu Tan,0,7,120,120
1683370928649,MAE 148,A01,186660,Silberman; Jack,3,0,16,13
1683370929675,MATH 10A,A01,188095,Staff,0,5,35,35
1683370930701,MATH 10B,A01,188097,Bowers; Adam R.,0,11,30,30
1683370930701,MATH 10B,A02,188099,Bowers; Adam R.,0,11,30,30
1683370930701,MATH 10B,B01,188104,Bowers; Adam R.,0,10,30,30
1683370930701,MATH 10B,B02,188106,Bowers; Adam R.,0,10,30,30
1683370931729,MATH 10C,A01,188111,Staff,0,18,30,30
1683370931729,MATH 10C,A02,188127,Staff,0,17,30,30
1683370931729,MATH 10C,A03,188131,Staff,0,18,30,30
1683370931729,MATH 10C,B01,188218,Staff,18,0,30,12
1683370931729,MATH 10C,B02,188244,Staff,13,0,30,17
1683370931729,MATH 10C,B03,188277,Staff,16,0,30,14
1683370932815,MATH 18,A01,188344,Bach; Quang Tran,18,0,30,12
1683370932815,MATH 18,A02,188345,Bach; Quang Tran,11,0,30,19
1683370932815,MATH 18,B01,188353,Bach; Quang Tran,10,0,30,20
1683370932815,MATH 18,B02,188354,Bach; Quang Tran,20,0,30,10
1683370933840,MATH 20A,A01,188374,Staff,12,0,35,23
1683370934872,MATH 20B,A01,188382,Ohm; Ko Woon,6,0,30,24
1683370934872,MATH 20B,A02,188383,Ohm; Ko Woon,21,0,30,9
1683370934872,MATH 20B,B01,188385,Ohm; Ko Woon,7,0,30,23
1683370934872,MATH 20B,B02,188392,Ohm; Ko Woon,22,0,30,8
1683370935904,MATH 20C,A01,188394,Harel; Guershon,10,0,30,20
1683370935904,MATH 20C,A02,188395,Harel; Guershon,15,0,30,15
1683370935904,MATH 20C,B01,188404,Harel; Guershon,4,0,30,26
1683370935904,MATH 20C,B02,188405,Harel; Guershon,19,0,30,11
1683370936931,MATH 20D,A01,188414,Hammock; Frances H,0,1,30,30
1683370936931,MATH 20D,A02,188415,Hammock; Frances H,3,0,30,27
1683370936931,MATH 20D,B01,188447,Hammock; Frances H,1,0,30,29
1683370936931,MATH 20D,B02,188486,Hammock; Frances H,8,0,30,22
1683370937957,MATH 20E,A01,188649,Staff,21,0,30,9
1683370937957,MATH 20E,A02,188650,Staff,23,0,30,7
1683370937957,MATH 20E,A03,188673,Staff,0,0,30,30
1683370938980,MATH 102,A01,188675,Staff,0,35,35,35
1683370940006,MATH 103B,A01,188681,Staff,3,0,35,32
1683370940006,MATH 103B,B01,188692,Staff,5,0,35,30
1683370941029,MATH 109,A01,188695,Salehi Golsefidy; Alireza,25,0,35,10
1683370941029,MATH 109,A02,188696,Salehi Golsefidy; Alireza,25,0,35,10
1683370942061,MATH 120A,A01,188698,Eggers; John Dietrich,7,0,35,28
1683370943090,MATH 142B,A01,188736,Ioana; Adrian,0,2,30,30
1683370943090,MATH 142B,A02,188741,Ioana; Adrian,0,0,30,30
1683370943090,MATH 142B,A03,188743,Ioana; Adrian,0,1,30,30
1683370944115,MATH 168A,A01,188790,Staff,0,9,35,35
1683370945489,MATH 170A,A01,188803,Nie; Jiawang,0,2,35,35
1683370945489,MATH 170A,A02,188811,Nie; Jiawang,0,0,35,35
1683370945489,MATH 170A,A03,188814,Nie; Jiawang,1,0,35,34
1683370945489,MATH 170A,A04,188815,Nie; Jiawang,13,0,35,22
1683370946514,MATH 193B,A01,188817,Staff,0,0,35,35
1683370946514,MATH 193B,A02,188818,Staff,5,0,35,30
1683370947543,MGT 4,A01,202857,Anderson; John Charles,61,0,80,19
1683370948573,MGT 12,A00,202858,Lindenberger; Wade Douglas,41,0,90,49
1683370949601,MGT 18,A00,202859,Staff,74,0,90,16
1683370950630,MGT 18GS,A00,202860,McKay; Michael J,13,0,28,15
1683370951656,MGT 45,A00,202861,Pecore; Joseph P.,15,0,90,75
1683370952681,MGT 100,A00,202863,Yavorsky; Daniel Ryan,28,0,90,62
1683370953711,MGT 103,A00,202864,Ehrich; Kristine R,0,17,90,90
1683370954736,MGT 112,A00,202865,Ehrich; Kristine R,15,0,90,75
1683370955762,MGT 121A,A00,202868,Staff,0,20,0,0
1683370956786,MGT 131B,A00,202869,Anderson; John Charles,59,0,90,31
1683370957812,MGT 136,A00,202871,Lindenberger; Wade Douglas,84,0,90,6
1683370958845,MGT 164,A00,202873,Staff,0,68,90,91
1683370959873,MGT 164GS,A00,202874,McKay; Mary A,13,0,28,15
1683370960901,MGT 180,A00,202875,Staff,0,50,90,91
1683370961931,MMW 11R,A01,205019,Herbst; Matthew,3,0,30,27
1683370961931,MMW 11R,A02,205026,Herbst; Matthew,29,0,30,1
1683370962961,MMW 15,A01,193512,Chang; Edmond Yi-Teh,0,9,28,28
1683370962961,MMW 15,A02,193513,Chang; Edmond Yi-Teh,0,5,28,28
1683370962961,MMW 15,A03,193514,Chang; Edmond Yi-Teh,0,5,28,28
1683370962961,MMW 15,A04,193515,Chang; Edmond Yi-Teh,0,5,28,28
1683370962961,MMW 15,A05,193516,Chang; Edmond Yi-Teh,0,4,28,28
1683370962961,MMW 15,A06,193517,Chang; Edmond Yi-Teh,0,5,28,28
1683370962961,MMW 15,B01,193519,Chang; Edmond Yi-Teh,0,5,28,28
1683370962961,MMW 15,B02,193520,Chang; Edmond Yi-Teh,0,5,28,28
1683370962961,MMW 15,B03,193521,Chang; Edmond Yi-Teh,0,5,28,28
1683370962961,MMW 15,B04,193522,Chang; Edmond Yi-Teh,0,4,28,28
1683370962961,MMW 15,B05,193523,Chang; Edmond Yi-Teh,0,5,28,28
1683370962961,MMW 15,B06,193524,Chang; Edmond Yi-Teh,0,4,28,28
1683370963987,MMW 122,A01,193526,Rahimi; Babak,0,15,28,28
1683370963987,MMW 122,A02,193527,Rahimi; Babak,0,14,28,28
1683370963987,MMW 122,A03,193528,Rahimi; Babak,0,0,0,0
1683370963987,MMW 122,A04,193529,Rahimi; Babak,0,0,0,0
1683370965011,MUS 1A,A01,186663,Staff,0,20,35,35
1683370966041,MUS 4,A01,186715,Staff,0,12,35,35
1683370967069,MUS 5R,A01,186796,Dubnov; Shlomo,0,17,35,35
1683370968098,MUS 6,A01,186798,Staff,0,4,25,25
1683370969126,MUS 7,A01,186830,Staff,13,0,35,22
1683370970150,MUS 8,A01,186930,Staff,0,26,35,35
1683370971178,MUS 15,A01,186932,Staff,0,16,35,35
1683370971178,MUS 15,B01,186934,Staff,0,15,35,35
1683370972205,MUS 80,A00,186935,Staff,0,0,20,20
1683370972205,MUS 80,B00,186936,Staff,25,0,25,0
1683370973231,NANO 11,A00,204702,Lipomi; Darren John,0,0,0,0
1683370974264,NANO 15,A01,204709,Yang; Kesong,0,1,0,0
1683370975288,NANO 114,A00,202069,Jahed Motlagh; Zeinab,3,0,10,7
1683370976314,PHIL 1,A00,186955,Grush; Rick Scott,32,0,40,8
1683370977339,PHIL 10,A01,186973,Grush; Rick Scott,28,0,35,7
1683370977339,PHIL 10,A02,186974,Grush; Rick Scott,33,0,35,2
1683370978363,PHIL 13,A01,186976,Staff,7,0,35,28
1683370978363,PHIL 13,A02,186977,Staff,16,0,35,19
1683370979387,PHIL 14,A01,186979,Staff,31,0,35,4
1683370979387,PHIL 14,A02,186986,Staff,32,0,35,3
1683370980414,PHIL 28,A01,186988,Staff,16,0,30,14
1683370980414,PHIL 28,A02,186989,Staff,1,0,30,29
1683370980414,PHIL 28,A03,186990,Staff,9,0,30,21
1683370980414,PHIL 28,A04,186991,Staff,26,0,30,4
1683370981443,PHIL 120,A00,186997,Staff,23,0,40,17
1683370982482,PHIL 137,A00,187003,Staff,9,0,40,31
1683370983506,PHIL 150,A00,187015,Staff,47,0,70,23
1683370984530,PHIL 167,A00,187021,Lamey; Andy M.,35,0,40,5
1683370985556,PHIL 174,A01,202226,Staff,17,0,20,3
1683370985556,PHIL 174,A02,202235,Staff,20,0,20,0
1683370986579,PHIL 191A,A00,258918,Staff,0,0,1,1
1683370987610,PHYS 1A,A00,187028,Staff,27,0,60,33
1683370988638,PHYS 1AL,001,187036,Staff,2,0,30,28
1683370988638,PHYS 1AL,002,187049,Staff,18,0,30,12
1683370989662,PHYS 1B,A00,187058,Staff,22,0,60,38
1683370990686,PHYS 1BL,001,187064,Staff,0,0,30,30
1683370990686,PHYS 1BL,002,187070,Staff,5,0,30,25
1683370991711,PHYS 1C,A00,187082,Staff,31,0,120,89
1683370992742,PHYS 1CL,001,187088,Staff,0,9,30,30
1683370992742,PHYS 1CL,002,187089,Staff,0,2,30,30
1683370992742,PHYS 1CL,009,262693,Staff,11,0,30,19
1683370993770,PHYS 2B,A01,187097,Staff,54,0,115,61
1683370994795,PHYS 2C,A01,187099,Staff,67,0,115,48
1683370995824,PHYS 2CL,A01,187101,Staff,5,0,28,23
1683370995824,PHYS 2CL,A02,187102,Staff,15,0,28,13
1683370996855,PHYS 2D,A01,187123,Shotwell; Brian,95,0,115,20
1683370997887,PHYS 4B,A01,187133,Grinstein; Benjamin,35,0,50,15
1683370998917,POLI 10,A00,188819,Staff,0,4,50,50
1683370999941,POLI 11,A00,188827,Staff,43,0,50,7
1683371000968,POLI 13R,A00,188828,Staff,0,1,20,20
1683371001993,POLI 27,A01,188830,Elgin; Samuel Zincke,0,1,70,70
1683371003019,POLI 30,A00,188832,Desposato; Scott,31,0,50,19
1683371004047,POLI 102F,A00,188834,Staff,2,0,40,38
1683371005074,POLI 104A,A00,188852,Staff,14,0,30,16
1683371006101,POLI 104I,A00,188853,Staff,0,6,20,20
1683371007124,POLI 110B,A00,188854,Wiens; David,7,0,20,13
1683371008151,POLI 112A,A00,188855,Wiens; David,5,0,30,25
1683371009175,POLI 117R,A00,188856,Forman; Fonna,0,11,20,20
1683371010199,POLI 118,A00,188857,Ingham; Sean,8,0,20,12
1683371011220,POLI 120G,A00,188858,Staff,9,0,30,21
1683371012250,POLI 131CR,A00,188863,Hoston; Germaine,23,0,50,27
1683371013273,POLI 133,A00,188864,Nellis; Gareth Hb,44,0,50,6
1683371014297,POLI 134D,A00,188865,Desposato; Scott,27,0,30,3
1683371015320,POLI 142A,A00,188871,Gartzke; Erik,22,0,50,28
1683371016344,POLI 142K,A00,188874,Staff,38,0,50,12
1683371017368,POLI 143,A00,188940,Gartzke; Erik,16,0,30,14
1683371018392,POLI 153,A00,188943,Staff,3,0,20,17
1683371019418,POLI 160AA,A00,188944,Staff,11,0,40,29
1683371020444,POLI 170A,A00,188945,Staff,11,0,30,19
1683371022494,PSYC 1,A00,188952,Staff,37,0,90,53
1683371023518,PSYC 2,B00,188953,Staff,19,0,35,16
1683371024542,PSYC 6,A00,188970,Staff,47,0,60,13
1683371025571,PSYC 7,A00,188973,Staff,37,0,45,8
1683371026607,PSYC 60,A01,188980,Rickard; Timothy C.,43,0,60,17
1683371027637,PSYC 70,A01,189001,Steiner; Eric Tomas,23,0,45,22
1683371028667,PSYC 100,A00,189005,Lacefield; Katharine I,0,98,120,120
1683371029694,PSYC 102,A00,189008,Staff,9,0,30,21
1683371030719,PSYC 106,B00,189026,Gorman; Michael R.,34,0,60,26
1683371031747,PSYC 114,B01,189033,Winkielman; Piotr,0,32,30,30
1683371032772,PSYC 131,A00,189036,Anagnostaras; Stephan,0,43,60,60
1683371033795,PSYC 136,A00,189041,Lowe; Angela Beth,0,7,25,25
1683371034819,PSYC 137,A00,189057,Winkielman; Piotr,0,34,25,25
1683371035842,PSYC 144,A00,189107,Wixted; John T,0,7,50,50
1683371037948,PSYC 162,A00,189142,Staff,0,8,85,85
1683371038973,PSYC 172,A00,189144,Gorman; Michael R.,0,7,30,30
1683371041024,PSYC 179,A00,189146,Lacefield; Katharine I,0,84,120,120
1683371042054,PSYC 181,A00,189147,Anagnostaras; Stephan,0,44,90,90
1683371043084,PSYC 190R,A00,189148,Barner; David A.,0,22,80,80
1683371044166,PSYC 191,A00,189275,Rickard; Timothy C.,0,7,25,25
1683371045206,PSYC 193,A00,189276,Chapman; Eddie Nathaniel,0,1,0,4
1683371046232,PSYC 193L,A01,189281,Lowe; Angela Beth,12,0,20,8
1683371046232,PSYC 193L,B01,189285,Staff,28,0,35,7
1683371047263,RELI 149,A00,187137,Rahimi; Babak,7,0,40,33
1683371048299,SE 9,A01,187315,Staff,0,2,18,18
1683371049327,SE 101B,A00,187409,Staff,24,0,30,6
1683371050353,SE 110B,A00,187444,Staff,10,0,40,30
1683371051382,SE 130B,A00,187449,Staff,31,0,40,9
1683371052406,SE 150A,A00,187516,Staff,9,0,20,11
1683371053430,SE 154,A00,187528,Staff,30,0,50,20
1683371054460,SIO 3,A01,258171,Staff,35,0,40,5
1683371055487,SIO 10,A00,187144,Cook; Geoffrey W,0,3,75,75
1683371056517,SIO 45,A00,187152,Cook; Geoffrey W,1,0,100,99
1683371057545,SIO 109R,A00,194486,Staff,0,3,20,20
1683371059597,SIO 187,A01,187233,Kacev; David,12,0,40,28
