time,subj_course_id,sec_code,sec_id,prof,available,waitlist,total,enrolled_ct
1683717262085,ANBI 133,A00,258401,Wilder; Linnea Lorene,34,0,40,6
1683717263117,ANBI 140,A00,258395,Hrvoj Mihic; Branka,18,0,25,7
1683717264149,ANSC 120,A00,258402,Bialecki; Jon Anthony,26,0,40,14
1683717265180,ANSC 144,A00,258400,Staff,12,0,40,28
1683717267241,ANSC 166,A00,258396,Parish; Steven Martin,156,0,175,19
1683717268269,ANSC 180,A00,193533,Staff,8,0,20,12
1683717269303,ANSC 188,A00,258397,Jassal; Aftab,34,0,40,6
1683717270340,ANTH 3,A01,258316,Staff,23,0,30,7
1683717271371,ANTH 5,A00,258394,Semendeferi; Ekaterini,16,0,20,4
1683717272402,ANTH 21,A01,258331,Staff,4,0,40,36
1683717273434,ANTH 103,A00,258398,Varma; Saiba,15,0,25,10
1683717274471,AWP 10,001,202034,Staff,0,0,0,0
1683717274471,AWP 10,002,202035,Staff,0,0,0,0
1683717274471,AWP 10,003,202036,Staff,0,0,0,0
1683717274471,AWP 10,004,202037,Staff,0,0,0,0
1683717274471,AWP 10,005,202038,Staff,0,0,0,0
1683717274471,AWP 10,006,202039,Staff,0,0,0,0
1683717274471,AWP 10,007,202040,Staff,0,0,0,0
1683717274471,AWP 10,008,202041,Staff,0,0,0,0
1683717274471,AWP 10,009,202042,Staff,0,0,0,0
1683717274471,AWP 10,010,202043,Staff,0,0,0,0
1683717274471,AWP 10,011,202044,Staff,0,0,0,0
1683717274471,AWP 10,012,202045,Staff,0,0,0,0
1683717274471,AWP 10,013,202046,Staff,0,0,0,0
1683717274471,AWP 10,014,202047,Staff,0,0,0,0
1683717274471,AWP 10,015,202048,Staff,0,0,0,0
1683717274471,AWP 10,016,202049,Staff,0,0,0,0
1683717274471,AWP 10,017,202050,Staff,0,0,0,0
1683717274471,AWP 10,018,202051,Staff,0,0,0,0
1683717274471,AWP 10,019,202052,Staff,0,0,0,0
1683717274471,AWP 10,020,202053,Staff,0,0,0,0
1683717274471,AWP 10,021,202054,Staff,0,0,0,0
1683717274471,AWP 10,022,202055,Staff,0,0,0,0
1683717274471,AWP 10,023,202056,Staff,0,0,0,0
1683717274471,AWP 10,024,202057,Staff,0,0,0,0
1683717274471,AWP 10,025,202058,Staff,0,0,0,0
1683717274471,AWP 10,026,202059,Staff,0,0,0,0
1683717275500,AWP 102,001,202032,Staff,0,0,0,0
1683717275500,AWP 102,002,202033,Staff,0,0,0,0
1683717276540,BENG 100,A01,254234,Taylor Amos; Alyssa C,31,0,40,9
1683717277579,BENG 196,001,270013,Engler; Adam J.,9999,0,9999,0
1683717278621,BICD 100R,A01,202018,Smith; Laurie,0,7,32,32
1683717278621,BICD 100R,A02,202019,Smith; Laurie,0,3,32,32
1683717278621,BICD 100R,A03,202020,Smith; Laurie,0,1,32,32
1683717278621,BICD 100R,A04,202021,Smith; Laurie,6,0,32,26
1683717278621,BICD 100R,A05,202022,Smith; Laurie,10,0,32,22
1683717279656,BICD 136,A01,193242,Gustafson-Brown; Cindy,0,2,32,32
1683717279656,BICD 136,A02,193244,Gustafson-Brown; Cindy,13,0,32,19
1683717280693,BIEB 102,A01,193249,Butler; Shannon Rhey,0,0,32,32
1683717280693,BIEB 102,A02,193251,Butler; Shannon Rhey,0,0,32,32
1683717280693,BIEB 102,A03,193253,Butler; Shannon Rhey,0,0,32,32
1683717280693,BIEB 102,A04,193255,Butler; Shannon Rhey,13,0,32,19
1683717280693,BIEB 102,A05,193265,Butler; Shannon Rhey,25,0,32,7
1683717280693,BIEB 102,A06,193269,Butler; Shannon Rhey,12,0,32,20
1683717282758,BIEB 150,A01,193274,Staff,0,0,32,32
1683717282758,BIEB 150,A02,193285,Staff,24,0,32,8
1683717283790,BIEB 194,A00,193286,Kurle; Carolyn M.,19,0,32,13
1683717284823,BILD 1,A01,192291,Staff,15,0,32,17
1683717284823,BILD 1,A02,192292,Staff,30,0,32,2
1683717284823,BILD 1,B01,192520,Reuther; Keefe,0,1,0,0
1683717284823,BILD 1,B02,192532,Reuther; Keefe,0,1,0,0
1683717285863,BILD 3,A01,192556,Butler; Shannon Rhey,0,0,32,32
1683717285863,BILD 3,A02,192581,Butler; Shannon Rhey,0,1,32,32
1683717285863,BILD 3,A03,192611,Butler; Shannon Rhey,19,0,32,13
1683717285863,BILD 3,A04,192612,Butler; Shannon Rhey,23,0,32,9
1683717285863,BILD 3,A05,192613,Butler; Shannon Rhey,26,0,32,6
1683717285863,BILD 3,A06,192679,Butler; Shannon Rhey,27,0,32,5
1683717285863,BILD 3,A07,192682,Butler; Shannon Rhey,20,0,32,12
1683717286900,BILD 4,A01,192836,Reuther; Keefe,1,0,24,23
1683717286900,BILD 4,A02,193044,Reuther; Keefe,4,0,24,20
1683717287934,BILD 10,A01,193142,Gustafson-Brown; Cindy,29,0,32,3
1683717287934,BILD 10,A02,193149,Gustafson-Brown; Cindy,31,0,32,1
1683717288968,BIMM 100,A01,193301,Staff,0,6,32,32
1683717288968,BIMM 100,A02,193312,Staff,0,7,32,32
1683717288968,BIMM 100,A03,193323,Staff,0,10,32,32
1683717290001,BIMM 101,A01,193329,McDonnell; Lisa Marie,0,3,24,24
1683717290001,BIMM 101,A02,193339,McDonnell; Lisa Marie,0,3,24,24
1683717290001,BIMM 101,B01,193354,McDonnell; Lisa Marie,0,4,24,24
1683717290001,BIMM 101,B02,193357,McDonnell; Lisa Marie,0,3,24,24
1683717291032,BIMM 110,A01,193377,Tat; John,0,11,32,32
1683717291032,BIMM 110,A02,193378,Tat; John,0,11,32,32
1683717292064,BIMM 120,A01,206116,Staff,0,0,32,32
1683717292064,BIMM 120,A02,206117,Staff,7,0,32,25
1683717292064,BIMM 120,A03,206121,Staff,21,0,32,11
1683717293096,BIPN 100,A01,193393,Park; Ji Young,0,15,32,32
1683717293096,BIPN 100,A02,193402,Park; Ji Young,0,14,32,32
1683717293096,BIPN 100,A03,193413,Park; Ji Young,0,14,32,32
1683717293096,BIPN 100,A04,193414,Park; Ji Young,0,13,32,32
1683717294127,BIPN 102,A01,193429,Staff,0,0,32,32
1683717294127,BIPN 102,A02,193438,Staff,18,0,32,14
1683717295165,BIPN 106,A01,193450,Reyes Gonzalez; Catalina,0,2,40,40
1683717296202,BIPN 134,A01,193465,Cooke; James Edward,0,0,32,32
1683717296202,BIPN 134,A02,193474,Cooke; James Edward,25,0,32,7
1683717296202,BIPN 134,A03,193485,Cooke; James Edward,29,0,32,3
1683717296202,BIPN 134,A04,193486,Cooke; James Edward,20,0,32,12
1683717296202,BIPN 134,A05,193491,Cooke; James Edward,31,0,32,1
1683717296202,BIPN 134,A06,193501,Cooke; James Edward,30,0,32,2
1683717296202,BIPN 134,A07,193510,Cooke; James Edward,29,0,32,3
1683717298259,BISP 194,A00,222522,Staff,14,0,32,18
1683717299288,CAT 124,A01,202407,Staff,19,0,25,6
1683717300318,CAT 125,A00,202408,Marchisotto; Jennifer Anne,2,0,20,18
1683717301349,CAT 125R,A00,202409,Smith; Lauryn Alissa,0,11,20,20
1683717301349,CAT 125R,B00,202410,Morales; Celeste Georgianna,0,11,20,20
1683717301349,CAT 125R,C00,202411,Irwin; Matthew Joseph,0,12,20,20
1683717302391,CENG 15,A01,204712,Yang; Kesong,0,1,0,0
1683717303429,CENG 114,A00,202070,Jahed Motlagh; Zeinab,5,0,20,15
1683717304468,CGS 105,A00,185477,Wesling; Megan E.,24,0,40,16
1683717305495,CGS 106,A00,185494,Staff,11,0,22,11
1683717306525,CGS 108,A00,185495,Staff,14,0,20,6
1683717307555,CGS 114,A00,185496,Staff,13,0,18,5
1683717308584,CGS 119,A00,185501,Staff,15,0,20,5
1683717309615,CGS 120,A00,185511,Staff,11,0,20,9
1683717310647,CHEM 4,A01,184675,Bussey; Thomas J,97,0,100,3
1683717311677,CHEM 6A,A01,184677,Staff,32,0,60,28
1683717312711,CHEM 6B,A01,184679,Staff,63,0,100,37
1683717313741,CHEM 6C,A01,184681,Bussey; Thomas J,0,0,50,50
1683717313741,CHEM 6C,A02,184682,Bussey; Thomas J,32,0,50,18
1683717314772,CHEM 40A,A01,184684,Albizati; Kim F.,33,0,100,67
1683717315803,CHEM 40B,A01,184686,Albizati; Kim F.,0,22,100,100
1683717316833,CHEM 41B,A01,184690,Staff,51,0,100,49
1683717317865,COGS 3,A01,184715,Boyle; Mary E. T.,0,27,40,40
1683717318895,COGS 14B,A01,185172,Staff,0,14,38,38
1683717319930,COGS 18,A01,184736,Staff,14,0,80,66
1683717320962,COGS 100,A01,184932,Staff,0,8,73,73
1683717321995,COGS 101A,A01,184935,Staff,0,40,30,30
1683717323027,COGS 101B,A01,184944,Staff,0,2,30,30
1683717324059,COGS 101C,A01,184946,Staff,0,10,30,30
1683717325094,COGS 102A,A01,184951,Johnson; Christine M.,1,0,40,39
1683717326126,COGS 107B,A01,184953,Mooshagian; Eric Frederick,0,52,40,40
1683717327161,COGS 118B,A01,184959,Gupta; Anjum,0,50,40,40
1683717328188,COGS 153,A00,184961,Staff,1,16,30,29
1683717329224,COGS 177,A00,184962,Staff,0,20,30,30
1683717330253,COGS 187A,A01,184969,Boyle; Mary E. T.,0,19,40,40
1683717331281,COMM 10,A01,185174,Staff,0,5,25,25
1683717331281,COMM 10,A02,185189,Staff,0,2,25,25
1683717331281,COMM 10,A03,269821,Staff,0,1,0,0
1683717332317,COMM 100B,A02,185476,Staff,10,0,25,15
1683717332317,COMM 100B,A03,277340,Staff,25,0,25,0
1683717333348,COMM 100C,A01,185314,Staff,2,0,25,23
1683717333348,COMM 100C,A02,185327,Staff,17,0,25,8
1683717334381,COMM 110M,A00,185349,Staff,0,0,40,40
1683717335411,COMM 113T,A00,185352,Staff,25,0,40,15
1683717336441,COMM 114I,A00,185353,Staff,31,0,40,9
1683717337471,COMM 131,A00,185354,Staff,17,0,30,13
1683717338504,CSE 8A,A50,185358,Cao; Yingjun,0,46,10,10
1683717339534,CSE 8B,A01,185362,Staff,0,48,50,50
1683717340573,CSE 11,A01,185416,Cao; Yingjun,0,91,10,10
1683717341615,CSE 20,A01,185445,Briones; Jor-el Thomas Caparas,3,0,25,22
1683717342642,CSE 21,A01,185447,Staff,9,0,50,41
1683717343679,CSE 101,A01,185451,Staff,0,13,50,50
1683717343679,CSE 101,B01,185453,Jones; Miles E,0,15,50,50
1683717345751,CSE 141,A01,185458,Eldon; John,16,0,100,84
1683717346780,CSE 141L,A01,185461,Eldon; John,8,0,100,92
1683717347810,CSE 142,A01,185463,Staff,34,0,60,26
1683717347810,CSE 142,B01,201355,Staff,0,7,60,60
1683717348842,CSE 142L,A01,185470,Staff,34,0,60,26
1683717348842,CSE 142L,B01,201417,Staff,0,6,60,60
1683717349875,CSE 190,A00,201433,Staff,32,0,49,17
1683717350915,DOC 1,A01,259136,Strom; Megan C.,7,0,15,8
1683717350915,DOC 1,A02,259137,Strom; Megan C.,15,0,15,0
1683717350915,DOC 1,A03,259138,Strom; Megan C.,14,0,15,1
1683717350915,DOC 1,A04,259139,Strom; Megan C.,13,0,15,2
1683717351946,DOC 100D,A00,259140,Pass; Natalye Joann,14,0,25,11
1683717352984,DSGN 1,A01,184749,Rill; Bryan,0,26,30,30
1683717354016,DSGN 100,A01,185168,Staff,0,2,25,25
1683717355051,ECE 5,A01,185626,Morris; Karcher William,0,12,0,0
1683717356083,ECE 101,A01,185628,Staff,14,0,70,56
1683717357114,ECE 107,A01,185635,Baghdadchi; Saharnaz,0,0,20,20
1683717357114,ECE 107,A02,185638,Baghdadchi; Saharnaz,1,0,20,19
1683717358149,ECE 148,A01,185647,Silberman; Jack,0,0,16,16
1683717359181,ECON 1,A01,185537,Crane; Meredith Helen,54,0,70,16
1683717360210,ECON 3,A01,185549,Crane; Meredith Helen,30,0,70,40
1683717361314,ECON 4,A01,203354,Anderson; John Charles,0,5,10,10
1683717362343,ECON 100A,A01,185574,Staff,0,5,40,40
1683717363376,ECON 100B,A01,185576,Staff,0,12,50,50
1683717364405,ECON 100C,A01,185589,Newhouse; Herbert S,30,0,70,40
1683717365438,ECON 105,A00,185608,Vespa; Emanuel Ignacio,19,0,35,16
1683717366474,ECON 109,A01,185610,Shishkin; Denis,9,0,35,26
1683717367507,ECON 110A,A01,185612,Staff,8,0,40,32
1683717368539,ECON 120A,A01,185615,Staff,19,0,40,21
1683717369570,ECON 120C,A01,185617,Sun; Yixiao,0,21,70,70
1683717370603,ECON 144,A00,203346,Squires; Dale E,2,0,35,33
1683717371632,ECON 171,A01,203349,Newhouse; Herbert S,0,1,35,35
1683717372669,ECON 173A,A01,185621,Toda; Alexis Akira,21,0,35,14
1683717373714,EDS 25,A01,202413,Staff,0,1,0,0
1683717373714,EDS 25,A02,202414,Staff,0,1,0,0
1683717373714,EDS 25,A03,202415,Staff,0,0,0,0
1683717373714,EDS 25,A04,202416,Staff,0,1,0,0
1683717373714,EDS 25,A05,202439,Staff,0,0,0,0
1683717373714,EDS 25,A06,202440,Staff,0,0,0,0
1683717373714,EDS 25,B01,202631,Staff,0,0,0,0
1683717373714,EDS 25,B02,202632,Staff,0,0,0,0
1683717373714,EDS 25,B03,202639,Staff,0,0,0,0
1683717373714,EDS 25,B04,202640,Staff,0,0,0,0
1683717373714,EDS 25,B05,202643,Staff,0,0,0,0
1683717373714,EDS 25,B06,202644,Staff,0,0,0,0
1683717374751,EDS 38,A01,202659,Black; Alison Michelle,25,0,25,0
1683717375781,EDS 115,A00,202652,Staff,18,0,30,12
1683717376811,EDS 125,A00,202649,Staff,13,0,30,17
1683717377843,EDS 126,A01,203332,Staff,30,0,30,0
1683717378872,EDS 139,A00,202838,Staff,16,0,25,9
1683717379902,EDS 146,A01,202655,Staff,14,0,25,11
1683717380933,ENG 15,A00,185667,Staff,0,1,0,0
1683717380933,ENG 15,B00,185672,Staff,0,0,0,0
1683717380933,ENG 15,C00,185675,Staff,0,0,0,0
1683717380933,ENG 15,D00,185682,Staff,0,0,0,0
1683717380933,ENG 15,E00,185684,Staff,0,0,0,0
1683717381967,ETHN 103,A00,185710,Staff,0,8,35,35
1683717382996,ETHN 103A,A00,199228,Man; Simeon S,0,0,9,9
1683717384036,ETHN 109,A00,185711,Staff,15,0,35,20
1683717385062,ETHN 142,A00,185726,Staff,0,4,30,30
1683717386093,ETHN 163J,A00,199229,Man; Simeon S,5,0,8,3
1683717387126,ETHN 168,A00,185727,Staff,7,0,10,3
1683717388154,ETHN 182,A00,185728,Staff,0,0,35,35
1683717389185,ETHN 183,A00,185737,Staff,10,0,18,8
1683717390215,GLBH 111,A01,209361,Burgos; Jose L.,0,0,0,0
1683717392281,HIEU 104,A00,185792,Staff,14,0,20,6
1683717393314,HIEU 115,A00,185800,Staff,0,0,20,20
1683717394349,HIEU 128,A00,185801,Staff,0,9,20,20
1683717395377,HIEU 147,A00,185802,Staff,15,0,20,5
1683717396406,HIEU 154,A00,185823,Staff,11,0,20,9
1683717397433,HILA 102,A00,185826,Staff,14,0,20,6
1683717398462,HILD 2C,A01,185778,Staff,0,13,20,20
1683717399499,HILD 7B,A01,185780,Kwak; Nancy,0,17,32,32
1683717399499,HILD 7B,A02,185781,Kwak; Nancy,0,18,32,32
1683717400533,HILD 30,A01,185791,Staff,12,0,20,8
1683717401564,HISC 119,A00,185830,Golan; Tal,0,10,20,20
1683717402590,HITO 156GS,A00,185831,Patterson; Patrick H.,0,0,0,23
1683717403620,HIUS 103,A00,185832,Man; Simeon S,0,4,20,20
1683717404651,HIUS 117,A00,185836,Kwak; Nancy,2,0,20,18
1683717405680,HIUS 125,A00,185840,Man; Simeon S,0,2,23,23
1683717406713,HIUS 149,A00,185845,Staff,1,0,20,19
1683717407743,HUM 3,A01,185882,Zavodny; Tatiana Sophia,0,8,50,50
1683717407743,HUM 3,B01,185899,Caldwell; Michael Alan,0,18,50,50
1683717408775,HUM 3GS,A00,185900,Patterson; Patrick H.,0,0,0,23
1683717409808,HUM 4,A01,185938,Zroka; Amy Liane,28,0,50,22
1683717409808,HUM 4,B01,185956,Watkins; Eric,0,6,50,50
1683717409808,HUM 4,B02,202209,Watkins; Eric,0,6,50,50
1683717409808,HUM 4,B03,202210,Watkins; Eric,0,5,50,50
1683717410840,HUM 5,A01,185958,West; Geoffrey Scott,0,0,50,50
1683717410840,HUM 5,A02,202215,West; Geoffrey Scott,0,1,50,50
1683717411872,INTL 190,A00,185959,Gagnon; Jeffrey C,0,0,0,9
1683717411872,INTL 190,B00,185960,Lettieri; Michael Joseph,0,0,0,2
1683717412907,JAPN 180,A00,254509,Staff,5,0,30,25
1683717413940,LATI 10,A01,202853,Kennemore; Amy Michelle,4,0,35,31
1683717413940,LATI 10,A02,202854,Kennemore; Amy Michelle,3,0,35,32
1683717413940,LATI 10,A03,270054,Kennemore; Amy Michelle,30,0,30,0
1683717414969,LATI 180,A00,202855,Kennemore; Amy Michelle,11,0,20,9
1683717416000,LAWS 101,A00,201767,Golan; Tal,0,7,40,40
1683717417034,LIFR 1C,A00,185961,Staff,6,0,20,14
1683717418063,LIFR 1CX,A00,185962,Staff,7,0,20,13
1683717419094,LIFR 1D,A00,185963,Staff,7,0,20,13
1683717420123,LIFR 1DX,A00,185964,Staff,7,0,20,13
1683717421156,LIGN 101,A01,186039,Staff,43,0,50,7
1683717422187,LIGN 165,A00,186040,Staff,14,0,50,36
1683717423227,LTCS 108,A00,186041,Staff,5,0,10,5
1683717424254,LTCS 119,A00,186042,Staff,15,0,20,5
1683717425325,LTCS 130,A00,186043,Wesling; Megan E.,15,0,25,10
1683717427387,LTEA 138,A00,186119,Staff,14,0,40,26
1683717428420,LTEN 124,A00,186148,Staff,5,0,25,20
1683717429450,LTEN 178,A00,186149,Staff,6,0,15,9
1683717430479,LTEN 181,A00,186150,Blanco; John D,34,0,40,6
1683717431507,LTWL 120,A00,186160,Staff,19,0,25,6
1683717432536,LTWL 165,A00,186161,Staff,22,0,25,3
1683717433564,LTWR 100,A00,186162,Staff,0,5,15,15
1683717434597,LTWR 102,A00,186163,Doller; Ben,5,0,15,10
1683717435633,MAE 8,A01,186412,Staff,0,1,0,0
1683717436664,MAE 30B,A00,186445,Bahadori; Mohammad Yousef,81,0,100,19
1683717437698,MAE 40,A00,186592,Bewley; Thomas R,10,0,50,40
1683717438730,MAE 101B,A00,186593,Bahadori; Mohammad Yousef,80,0,100,20
1683717439775,MAE 105,A00,186594,Bandaru; Prabhakar,10,0,50,40
1683717440807,MAE 107,A00,186599,Pham; Hieu Tan,0,8,120,120
1683717441838,MAE 148,A01,186660,Silberman; Jack,3,0,16,13
1683717442872,MATH 10A,A01,188095,Staff,0,6,35,35
1683717443903,MATH 10B,A01,188097,Bowers; Adam R.,0,12,30,30
1683717443903,MATH 10B,A02,188099,Bowers; Adam R.,0,11,30,30
1683717443903,MATH 10B,B01,188104,Bowers; Adam R.,0,10,30,30
1683717443903,MATH 10B,B02,188106,Bowers; Adam R.,0,9,30,30
1683717444940,MATH 10C,A01,188111,Staff,0,20,30,30
1683717444940,MATH 10C,A02,188127,Staff,0,19,30,30
1683717444940,MATH 10C,A03,188131,Staff,0,19,30,30
1683717444940,MATH 10C,B01,188218,Staff,17,0,30,13
1683717444940,MATH 10C,B02,188244,Staff,13,0,30,17
1683717444940,MATH 10C,B03,188277,Staff,14,0,30,16
1683717445973,MATH 18,A01,188344,Bach; Quang Tran,18,0,30,12
1683717445973,MATH 18,A02,188345,Bach; Quang Tran,11,0,30,19
1683717445973,MATH 18,B01,188353,Bach; Quang Tran,11,0,30,19
1683717445973,MATH 18,B02,188354,Bach; Quang Tran,19,0,30,11
1683717447002,MATH 20A,A01,188374,Staff,11,0,35,24
1683717448039,MATH 20B,A01,188382,Ohm; Ko Woon,7,0,30,23
1683717448039,MATH 20B,A02,188383,Ohm; Ko Woon,22,0,30,8
1683717448039,MATH 20B,B01,188385,Ohm; Ko Woon,7,0,30,23
1683717448039,MATH 20B,B02,188392,Ohm; Ko Woon,22,0,30,8
1683717449067,MATH 20C,A01,188394,Harel; Guershon,10,0,30,20
1683717449067,MATH 20C,A02,188395,Harel; Guershon,13,0,30,17
1683717449067,MATH 20C,B01,188404,Harel; Guershon,5,0,30,25
1683717449067,MATH 20C,B02,188405,Harel; Guershon,18,0,30,12
1683717450107,MATH 20D,A01,188414,Hammock; Frances H,0,1,30,30
1683717450107,MATH 20D,A02,188415,Hammock; Frances H,0,1,30,30
1683717450107,MATH 20D,B01,188447,Hammock; Frances H,0,1,30,30
1683717450107,MATH 20D,B02,188486,Hammock; Frances H,2,0,30,28
1683717451135,MATH 20E,A01,188649,Staff,21,0,30,9
1683717451135,MATH 20E,A02,188650,Staff,20,0,30,10
1683717451135,MATH 20E,A03,188673,Staff,0,0,30,30
1683717452166,MATH 102,A01,188675,Staff,0,40,35,35
1683717453200,MATH 103B,A01,188681,Staff,3,0,35,32
1683717453200,MATH 103B,B01,188692,Staff,5,0,35,30
1683717454227,MATH 109,A01,188695,Salehi Golsefidy; Alireza,24,0,35,11
1683717454227,MATH 109,A02,188696,Salehi Golsefidy; Alireza,24,0,35,11
1683717455260,MATH 120A,A01,188698,Eggers; John Dietrich,7,0,35,28
1683717456289,MATH 142B,A01,188736,Ioana; Adrian,0,0,30,30
1683717456289,MATH 142B,A02,188741,Ioana; Adrian,0,1,30,30
1683717456289,MATH 142B,A03,188743,Ioana; Adrian,0,2,30,30
1683717457321,MATH 168A,A01,188790,Staff,0,11,35,35
1683717458353,MATH 170A,A01,188803,Nie; Jiawang,0,2,35,35
1683717458353,MATH 170A,A02,188811,Nie; Jiawang,0,1,35,35
1683717458353,MATH 170A,A03,188814,Nie; Jiawang,1,0,35,34
1683717458353,MATH 170A,A04,188815,Nie; Jiawang,5,0,35,30
1683717459386,MATH 193B,A01,188817,Staff,0,0,35,35
1683717459386,MATH 193B,A02,188818,Staff,6,0,35,29
1683717460416,MGT 4,A01,202857,Anderson; John Charles,59,0,80,21
1683717461451,MGT 12,A00,202858,Lindenberger; Wade Douglas,40,0,90,50
1683717462480,MGT 18,A00,202859,Staff,73,0,90,17
1683717463512,MGT 18GS,A00,202860,McKay; Michael J,13,0,28,15
1683717464542,MGT 45,A00,202861,Pecore; Joseph P.,8,0,90,82
1683717465628,MGT 100,A00,202863,Yavorsky; Daniel Ryan,27,0,90,63
1683717466665,MGT 103,A00,202864,Ehrich; Kristine R,0,19,90,90
1683717467696,MGT 112,A00,202865,Ehrich; Kristine R,15,0,90,75
1683717468733,MGT 121A,A00,202868,Staff,70,0,90,20
1683717469767,MGT 131B,A00,202869,Anderson; John Charles,58,0,90,32
1683717470800,MGT 136,A00,202871,Lindenberger; Wade Douglas,83,0,90,7
1683717471829,MGT 164,A00,202873,Staff,0,67,90,91
1683717472859,MGT 164GS,A00,202874,McKay; Mary A,13,0,28,15
1683717473889,MGT 180,A00,202875,Staff,0,51,90,91
1683717474919,MMW 11R,A01,205019,Herbst; Matthew,0,0,30,30
1683717474919,MMW 11R,A02,205026,Herbst; Matthew,29,0,30,1
1683717475949,MMW 15,A01,193512,Chang; Edmond Yi-Teh,0,8,28,28
1683717475949,MMW 15,A02,193513,Chang; Edmond Yi-Teh,0,5,28,28
1683717475949,MMW 15,A03,193514,Chang; Edmond Yi-Teh,0,5,28,28
1683717475949,MMW 15,A04,193515,Chang; Edmond Yi-Teh,0,5,28,28
1683717475949,MMW 15,A05,193516,Chang; Edmond Yi-Teh,0,5,28,28
1683717475949,MMW 15,A06,193517,Chang; Edmond Yi-Teh,0,6,28,28
1683717475949,MMW 15,B01,193519,Chang; Edmond Yi-Teh,0,5,28,28
1683717475949,MMW 15,B02,193520,Chang; Edmond Yi-Teh,0,5,28,28
1683717475949,MMW 15,B03,193521,Chang; Edmond Yi-Teh,0,5,28,28
1683717475949,MMW 15,B04,193522,Chang; Edmond Yi-Teh,0,6,28,28
1683717475949,MMW 15,B05,193523,Chang; Edmond Yi-Teh,0,5,28,28
1683717475949,MMW 15,B06,193524,Chang; Edmond Yi-Teh,0,5,28,28
1683717476978,MMW 122,A01,193526,Rahimi; Babak,0,16,28,28
1683717476978,MMW 122,A02,193527,Rahimi; Babak,0,15,28,28
1683717476978,MMW 122,A03,193528,Rahimi; Babak,0,0,0,0
1683717476978,MMW 122,A04,193529,Rahimi; Babak,0,0,0,0
1683717478009,MUS 1A,A01,186663,Staff,0,18,35,35
1683717479035,MUS 4,A01,186715,Staff,0,12,35,35
1683717480065,MUS 5R,A01,186796,Dubnov; Shlomo,0,17,35,35
1683717481103,MUS 6,A01,186798,Staff,0,4,25,25
1683717482136,MUS 7,A01,186830,Staff,11,0,35,24
1683717483165,MUS 8,A01,186930,Staff,0,27,35,35
1683717484202,MUS 15,A01,186932,Staff,0,15,35,35
1683717484202,MUS 15,B01,186934,Staff,0,16,35,35
1683717485236,MUS 80,A00,186935,Staff,0,0,20,20
1683717485236,MUS 80,B00,186936,Staff,24,0,25,1
1683717486271,NANO 11,A00,204702,Lipomi; Darren John,0,0,0,0
1683717487306,NANO 15,A01,204709,Yang; Kesong,0,1,0,0
1683717488331,NANO 114,A00,202069,Jahed Motlagh; Zeinab,2,0,10,8
1683717489361,PHIL 1,A00,186955,Grush; Rick Scott,31,0,40,9
1683717490390,PHIL 10,A01,186973,Grush; Rick Scott,27,0,35,8
1683717490390,PHIL 10,A02,186974,Grush; Rick Scott,33,0,35,2
1683717491421,PHIL 13,A01,186976,Staff,1,0,35,34
1683717491421,PHIL 13,A02,186977,Staff,16,0,35,19
1683717492445,PHIL 14,A01,186979,Staff,30,0,35,5
1683717492445,PHIL 14,A02,186986,Staff,32,0,35,3
1683717493485,PHIL 28,A01,186988,Staff,16,0,30,14
1683717493485,PHIL 28,A02,186989,Staff,0,0,30,30
1683717493485,PHIL 28,A03,186990,Staff,10,0,30,20
1683717493485,PHIL 28,A04,186991,Staff,26,0,30,4
1683717494516,PHIL 120,A00,186997,Staff,23,0,40,17
1683717495547,PHIL 137,A00,187003,Staff,8,0,40,32
1683717496576,PHIL 150,A00,187015,Staff,47,0,70,23
1683717497605,PHIL 167,A00,187021,Lamey; Andy M.,34,0,40,6
1683717498639,PHIL 174,A01,202226,Staff,17,0,20,3
1683717498639,PHIL 174,A02,202235,Staff,20,0,20,0
1683717499667,PHIL 191A,A00,258918,Staff,0,0,1,1
1683717500695,PHYS 1A,A00,187028,Staff,26,0,60,34
1683717501727,PHYS 1AL,001,187036,Staff,3,0,30,27
1683717501727,PHYS 1AL,002,187049,Staff,18,0,30,12
1683717502760,PHYS 1B,A00,187058,Staff,21,0,60,39
1683717503793,PHYS 1BL,001,187064,Staff,0,1,30,30
1683717503793,PHYS 1BL,002,187070,Staff,4,0,30,26
1683717504825,PHYS 1C,A00,187082,Staff,30,0,120,90
1683717505855,PHYS 1CL,001,187088,Staff,0,9,30,30
1683717505855,PHYS 1CL,002,187089,Staff,0,1,30,30
1683717505855,PHYS 1CL,009,262693,Staff,9,0,30,21
1683717506889,PHYS 2B,A01,187097,Staff,55,0,115,60
1683717507917,PHYS 2C,A01,187099,Staff,63,0,115,52
1683717508950,PHYS 2CL,A01,187101,Staff,5,0,28,23
1683717508950,PHYS 2CL,A02,187102,Staff,15,0,28,13
1683717509976,PHYS 2D,A01,187123,Shotwell; Brian,95,0,115,20
1683717511010,PHYS 4B,A01,187133,Grinstein; Benjamin,35,0,50,15
1683717512042,POLI 10,A00,188819,Staff,0,4,50,50
1683717513073,POLI 11,A00,188827,Staff,43,0,50,7
1683717514098,POLI 13R,A00,188828,Staff,0,2,20,20
1683717515126,POLI 27,A01,188830,Elgin; Samuel Zincke,0,2,70,70
1683717516159,POLI 30,A00,188832,Desposato; Scott,30,0,50,20
1683717517190,POLI 102F,A00,188834,Staff,1,0,40,39
1683717518219,POLI 104A,A00,188852,Staff,12,0,30,18
1683717519256,POLI 104I,A00,188853,Staff,0,8,20,20
1683717520289,POLI 110B,A00,188854,Wiens; David,6,0,20,14
1683717521317,POLI 112A,A00,188855,Wiens; David,3,0,30,27
1683717522349,POLI 117R,A00,188856,Forman; Fonna,0,12,20,20
1683717523378,POLI 118,A00,188857,Ingham; Sean,8,0,20,12
1683717524410,POLI 120G,A00,188858,Staff,7,0,30,23
1683717525438,POLI 131CR,A00,188863,Hoston; Germaine,20,0,50,30
1683717526463,POLI 133,A00,188864,Nellis; Gareth Hb,44,0,50,6
1683717527492,POLI 134D,A00,188865,Desposato; Scott,27,0,30,3
1683717528521,POLI 142A,A00,188871,Gartzke; Erik,21,0,50,29
1683717529550,POLI 142K,A00,188874,Staff,38,0,50,12
1683717530575,POLI 143,A00,188940,Gartzke; Erik,15,0,30,15
1683717531607,POLI 153,A00,188943,Staff,1,0,20,19
1683717532636,POLI 160AA,A00,188944,Staff,10,0,40,30
1683717533666,POLI 170A,A00,188945,Staff,10,0,30,20
1683717535726,PSYC 1,A00,188952,Staff,36,0,90,54
1683717536754,PSYC 2,B00,188953,Staff,19,0,35,16
1683717537782,PSYC 6,A00,188970,Staff,47,0,60,13
1683717538812,PSYC 7,A00,188973,Staff,35,0,45,10
1683717539845,PSYC 60,A01,188980,Rickard; Timothy C.,42,0,60,18
1683717540874,PSYC 70,A01,189001,Steiner; Eric Tomas,22,0,45,23
1683717541907,PSYC 100,A00,189005,Lacefield; Katharine I,1,98,120,119
1683717542936,PSYC 102,A00,189008,Staff,6,0,30,24
1683717543965,PSYC 106,B00,189026,Gorman; Michael R.,27,0,60,33
1683717544999,PSYC 114,B01,189033,Winkielman; Piotr,0,31,30,30
1683717546033,PSYC 131,A00,189036,Anagnostaras; Stephan,0,44,60,60
1683717547061,PSYC 136,A00,189041,Lowe; Angela Beth,0,7,25,25
1683717548091,PSYC 137,A00,189057,Winkielman; Piotr,0,36,25,25
1683717549120,PSYC 144,A00,189107,Wixted; John T,0,11,50,50
1683717551178,PSYC 162,A00,189142,Staff,0,9,85,85
1683717552205,PSYC 172,A00,189144,Gorman; Michael R.,0,6,30,30
1683717554262,PSYC 179,A00,189146,Lacefield; Katharine I,0,88,120,120
1683717555294,PSYC 181,A00,189147,Anagnostaras; Stephan,0,45,90,90
1683717556320,PSYC 190R,A00,189148,Barner; David A.,0,23,80,80
1683717557352,PSYC 191,A00,189275,Rickard; Timothy C.,0,11,25,25
1683717558385,PSYC 193,A00,189276,Chapman; Eddie Nathaniel,0,1,0,4
1683717559415,PSYC 193L,A01,189281,Lowe; Angela Beth,8,0,20,12
1683717559415,PSYC 193L,B01,189285,Staff,28,0,35,7
1683717560448,RELI 149,A00,187137,Rahimi; Babak,6,0,40,34
1683717561481,SE 9,A01,187315,Staff,0,2,18,18
1683717562508,SE 101B,A00,187409,Staff,24,0,30,6
1683717563542,SE 110B,A00,187444,Staff,10,0,40,30
1683717564569,SE 130B,A00,187449,Staff,31,0,40,9
1683717565596,SE 150A,A00,187516,Staff,8,0,20,12
1683717566624,SE 154,A00,187528,Staff,29,0,50,21
1683717567658,SIO 3,A01,258171,Staff,35,0,40,5
1683717568690,SIO 10,A00,187144,Cook; Geoffrey W,0,6,75,75
1683717569774,SIO 45,A00,187152,Cook; Geoffrey W,1,7,100,99
1683717570806,SIO 109R,A00,194486,Staff,0,4,20,20
1683717572869,SIO 187,A01,187233,Kacev; David,12,0,40,28
1683717573899,SOCI 1,A01,258656,Thorpe; Charles Robert,28,0,30,2
1683717573899,SOCI 1,A02,258658,Thorpe; Charles Robert,30,0,30,0
1683717573899,SOCI 1,A03,258661,Thorpe; Charles Robert,25,0,25,0
1683717573899,SOCI 1,A04,258666,Thorpe; Charles Robert,22,0,25,3
1683717573899,SOCI 1,A05,258897,Thorpe; Charles Robert,22,0,25,3
1683717573899,SOCI 1,A06,258898,Thorpe; Charles Robert,25,0,25,0
1683717574929,SOCI 30,A01,258903,Pardo Guerra; Juan Pablo,14,0,30,16
1683717575960,SOCI 102,A00,258904,Staff,9,0,25,16
1683717576991,SOCI 106,A00,258905,Staff,19,0,25,6
1683717578022,SOCI 111,A00,258907,Ribas Norris; Janet Vanesa,26,0,30,4
1683717579055,SOCI 121R,A00,258908,Pardo Guerra; Juan Pablo,7,0,30,23
1683717580085,SOCI 126,A01,203330,Staff,14,0,20,6
1683717581113,SOCI 131,A00,258909,Thorpe; Charles Robert,30,0,60,30
1683717582139,SOCI 135,A00,258910,Payne; Christine Anna,0,13,30,30
1683717583170,SOCI 157,A00,258911,Staff,10,0,30,20
1683717584194,SOCI 184,A00,258912,Staff,25,0,30,5
1683717585225,SOCI 188D,A00,258913,Staff,22,0,30,8
1683717586253,SYN 2,001,187529,Staff,9,0,16,7
1683717586253,SYN 2,002,201452,Staff,0,20,16,16
1683717586253,SYN 2,003,201469,Staff,1,0,16,15
1683717587281,SYN 100,A01,187531,Staff,0,9,20,20
1683717587281,SYN 100,B01,201491,Staff,0,10,20,20
1683717588319,TDAC 1,A00,189286,Walsh; Kim C.,3,0,20,17
1683717588319,TDAC 1,B00,189287,Harting; Carla Kelso,10,0,20,10
1683717589351,TDAC 101,A00,189300,Walsh; Kim C.,16,0,20,4
1683717589351,TDAC 101,B00,189301,Harting; Carla Kelso,18,0,20,2
1683717590384,TDAC 102,A00,189304,Basso; Beatrice,14,0,20,6
1683717591415,TDAC 108,A00,189305,Staff,18,0,20,2
1683717592459,TDDE 131,A00,189310,Staff,19,0,20,1
1683717592459,TDDE 131,B00,189314,Staff,19,0,20,1
1683717592459,TDDE 131,C00,189315,Staff,48,0,50,2
1683717592459,TDDE 131,D00,189316,Staff,14,0,15,1
1683717592459,TDDE 131,E00,204841,Staff,20,0,20,0
1683717593492,TDGE 10,A00,189289,Staff,26,0,50,24
1683717593492,TDGE 10,B00,189290,Havis; Allan,0,1,50,50
1683717594521,TDGE 11,A00,189291,Fulton; Julia,0,4,50,50
1683717594521,TDGE 11,B00,189292,Staff,20,0,25,5
1683717594521,TDGE 11,C00,260270,Staff,0,0,0,0
1683717595549,TDGE 25,A00,189294,Staff,1,0,20,19
1683717596581,TDGE 124,A00,189318,Fulton; Julia,0,7,50,50
1683717597613,TDGE 125,A00,189319,Staff,13,0,25,12
1683717597613,TDGE 125,B00,189320,Staff,23,0,25,2
1683717598639,TDGE 127,A00,189322,Havis; Allan,1,0,50,49
1683717599667,TDHT 101,A00,189323,Staff,18,0,25,7
1683717599667,TDHT 101,B00,189324,Staff,25,0,25,0
1683717600698,TDHT 102,A00,189325,Staff,49,0,50,1
1683717601726,TDMV 1,A00,189295,Arcidiacono; Kristin,20,0,30,10
1683717601726,TDMV 1,B00,189296,Caligagan; Maria T.,23,0,30,7
1683717602759,TDMV 2,A00,189297,Sammartano; Tonnie,27,0,30,3
1683717602759,TDMV 2,B00,189299,Arcidiacono; Kristin,23,0,30,7
1683717603790,TDMV 3,A00,204998,Rincon; Alicia,22,0,30,8
1683717604819,TDMV 120,A00,189458,Sammartano; Tonnie,28,0,30,2
1683717605849,TDMV 138,A00,189541,Jun; Grace Shin Hae,20,0,40,20
1683717606878,TDMV 142,A00,189717,Caligagan; Tony,25,0,30,5
1683717606878,TDMV 142,B00,189718,Caligagan; Maria T.,25,0,30,5
1683717607907,TMC 2,A01,187533,Staff,25,0,25,0
1683717607907,TMC 2,A02,187534,Staff,25,0,25,0
1683717608935,USP 1,A01,187536,Kwak; Nancy,0,16,25,25
1683717609962,USP 5,A01,187538,Staff,8,0,25,17
1683717610993,USP 101,A00,199253,Staff,0,4,0,0
1683717612020,USP 124,A00,187562,Boomhower; Matthew Charles,0,0,30,30
1683717613049,USP 138,A00,187582,Staff,19,0,25,6
1683717614076,USP 152,A01,187597,Staff,3,0,25,22
1683717615100,USP 153,A00,187598,Staff,18,0,25,7
1683717616130,USP 168,A00,187607,Kwak; Nancy,2,0,5,3
1683717617160,USP 173,A00,187619,Staff,4,0,25,21
1683717618190,USP 181,A00,187638,Staff,0,4,25,25
1683717619223,VIS 103,A00,187650,Cruz; Edwin Teddy,17,0,75,58
1683717620249,VIS 110D,A00,187669,Staff,13,0,22,9
1683717621278,VIS 127C,A00,187720,Shen; Kuiyi,67,0,146,79
1683717622309,VIS 149,A00,187731,Yoldas; Pinar,0,12,22,22
1683717623338,VIS 151,A01,188091,Staff,22,0,34,12
1683717623338,VIS 151,A02,188092,Staff,11,0,34,23
1683717624366,VIS 160B,A00,188093,Stalbaum; Brett,0,1,10,10
1683717626431,WCWP 10B,A00,201720,Staff,0,0,5,5
1683717626431,WCWP 10B,B00,201722,Staff,0,0,6,6
1683717627460,WCWP 100,A00,201725,Gagnon; Jeffrey C,0,0,2,2
1683717627460,WCWP 100,B00,201727,Staff,0,4,15,15
1683717630616,ANBI 133,A00,258401,Wilder; Linnea Lorene,34,0,40,6
1683717631646,ANBI 140,A00,258395,Hrvoj Mihic; Branka,18,0,25,7
1683717632673,ANSC 120,A00,258402,Bialecki; Jon Anthony,26,0,40,14
1683717633704,ANSC 144,A00,258400,Staff,12,0,40,28
1683717635765,ANSC 166,A00,258396,Parish; Steven Martin,156,0,175,19
1683717636790,ANSC 180,A00,193533,Staff,8,0,20,12
1683717637821,ANSC 188,A00,258397,Jassal; Aftab,34,0,40,6
1683717638846,ANTH 3,A01,258316,Staff,23,0,30,7
1683717639873,ANTH 5,A00,258394,Semendeferi; Ekaterini,16,0,20,4
1683717640902,ANTH 21,A01,258331,Staff,4,0,40,36
1683717641933,ANTH 103,A00,258398,Varma; Saiba,15,0,25,10
1683717642965,AWP 10,001,202034,Staff,0,0,0,0
1683717642965,AWP 10,002,202035,Staff,0,0,0,0
1683717642965,AWP 10,003,202036,Staff,0,0,0,0
1683717642965,AWP 10,004,202037,Staff,0,0,0,0
1683717642965,AWP 10,005,202038,Staff,0,0,0,0
1683717642965,AWP 10,006,202039,Staff,0,0,0,0
1683717642965,AWP 10,007,202040,Staff,0,0,0,0
1683717642965,AWP 10,008,202041,Staff,0,0,0,0
1683717642965,AWP 10,009,202042,Staff,0,0,0,0
1683717642965,AWP 10,010,202043,Staff,0,0,0,0
1683717642965,AWP 10,011,202044,Staff,0,0,0,0
1683717642965,AWP 10,012,202045,Staff,0,0,0,0
1683717642965,AWP 10,013,202046,Staff,0,0,0,0
1683717642965,AWP 10,014,202047,Staff,0,0,0,0
1683717642965,AWP 10,015,202048,Staff,0,0,0,0
1683717642965,AWP 10,016,202049,Staff,0,0,0,0
1683717642965,AWP 10,017,202050,Staff,0,0,0,0
1683717642965,AWP 10,018,202051,Staff,0,0,0,0
1683717642965,AWP 10,019,202052,Staff,0,0,0,0
1683717642965,AWP 10,020,202053,Staff,0,0,0,0
1683717642965,AWP 10,021,202054,Staff,0,0,0,0
1683717642965,AWP 10,022,202055,Staff,0,0,0,0
1683717642965,AWP 10,023,202056,Staff,0,0,0,0
1683717642965,AWP 10,024,202057,Staff,0,0,0,0
1683717642965,AWP 10,025,202058,Staff,0,0,0,0
1683717642965,AWP 10,026,202059,Staff,0,0,0,0
1683717643994,AWP 102,001,202032,Staff,0,0,0,0
1683717643994,AWP 102,002,202033,Staff,0,0,0,0
1683717645023,BENG 100,A01,254234,Taylor Amos; Alyssa C,31,0,40,9
1683717646051,BENG 196,001,270013,Engler; Adam J.,9999,0,9999,0
1683717647082,BICD 100R,A01,202018,Smith; Laurie,0,7,32,32
1683717647082,BICD 100R,A02,202019,Smith; Laurie,0,3,32,32
1683717647082,BICD 100R,A03,202020,Smith; Laurie,0,1,32,32
1683717647082,BICD 100R,A04,202021,Smith; Laurie,6,0,32,26
1683717647082,BICD 100R,A05,202022,Smith; Laurie,10,0,32,22
1683717648110,BICD 136,A01,193242,Gustafson-Brown; Cindy,0,2,32,32
1683717648110,BICD 136,A02,193244,Gustafson-Brown; Cindy,13,0,32,19
1683717649137,BIEB 102,A01,193249,Butler; Shannon Rhey,0,0,32,32
1683717649137,BIEB 102,A02,193251,Butler; Shannon Rhey,0,0,32,32
1683717649137,BIEB 102,A03,193253,Butler; Shannon Rhey,0,0,32,32
1683717649137,BIEB 102,A04,193255,Butler; Shannon Rhey,13,0,32,19
1683717649137,BIEB 102,A05,193265,Butler; Shannon Rhey,25,0,32,7
1683717649137,BIEB 102,A06,193269,Butler; Shannon Rhey,12,0,32,20
1683717651190,BIEB 150,A01,193274,Staff,0,0,32,32
1683717651190,BIEB 150,A02,193285,Staff,24,0,32,8
1683717652215,BIEB 194,A00,193286,Kurle; Carolyn M.,19,0,32,13
1683717653250,BILD 1,A01,192291,Staff,15,0,32,17
1683717653250,BILD 1,A02,192292,Staff,30,0,32,2
1683717653250,BILD 1,B01,192520,Reuther; Keefe,0,1,0,0
1683717653250,BILD 1,B02,192532,Reuther; Keefe,0,1,0,0
1683717654279,BILD 3,A01,192556,Butler; Shannon Rhey,0,0,32,32
1683717654279,BILD 3,A02,192581,Butler; Shannon Rhey,0,1,32,32
1683717654279,BILD 3,A03,192611,Butler; Shannon Rhey,19,0,32,13
1683717654279,BILD 3,A04,192612,Butler; Shannon Rhey,23,0,32,9
1683717654279,BILD 3,A05,192613,Butler; Shannon Rhey,26,0,32,6
1683717654279,BILD 3,A06,192679,Butler; Shannon Rhey,27,0,32,5
1683717654279,BILD 3,A07,192682,Butler; Shannon Rhey,20,0,32,12
1683717655308,BILD 4,A01,192836,Reuther; Keefe,1,0,24,23
1683717655308,BILD 4,A02,193044,Reuther; Keefe,4,0,24,20
1683717656334,BILD 10,A01,193142,Gustafson-Brown; Cindy,29,0,32,3
1683717656334,BILD 10,A02,193149,Gustafson-Brown; Cindy,31,0,32,1
1683717657363,BIMM 100,A01,193301,Staff,0,6,32,32
1683717657363,BIMM 100,A02,193312,Staff,0,7,32,32
1683717657363,BIMM 100,A03,193323,Staff,0,10,32,32
1683717658390,BIMM 101,A01,193329,McDonnell; Lisa Marie,0,3,24,24
1683717658390,BIMM 101,A02,193339,McDonnell; Lisa Marie,0,3,24,24
1683717658390,BIMM 101,B01,193354,McDonnell; Lisa Marie,0,4,24,24
1683717658390,BIMM 101,B02,193357,McDonnell; Lisa Marie,0,3,24,24
1683717659419,BIMM 110,A01,193377,Tat; John,0,11,32,32
1683717659419,BIMM 110,A02,193378,Tat; John,0,11,32,32
1683717660448,BIMM 120,A01,206116,Staff,0,0,32,32
1683717660448,BIMM 120,A02,206117,Staff,7,0,32,25
1683717660448,BIMM 120,A03,206121,Staff,21,0,32,11
1683717661477,BIPN 100,A01,193393,Park; Ji Young,0,15,32,32
1683717661477,BIPN 100,A02,193402,Park; Ji Young,0,14,32,32
1683717661477,BIPN 100,A03,193413,Park; Ji Young,0,14,32,32
1683717661477,BIPN 100,A04,193414,Park; Ji Young,0,13,32,32
1683717662508,BIPN 102,A01,193429,Staff,0,0,32,32
1683717662508,BIPN 102,A02,193438,Staff,18,0,32,14
1683717663542,BIPN 106,A01,193450,Reyes Gonzalez; Catalina,0,2,40,40
1683717664583,BIPN 134,A01,193465,Cooke; James Edward,0,0,32,32
1683717664583,BIPN 134,A02,193474,Cooke; James Edward,25,0,32,7
1683717664583,BIPN 134,A03,193485,Cooke; James Edward,29,0,32,3
1683717664583,BIPN 134,A04,193486,Cooke; James Edward,20,0,32,12
1683717664583,BIPN 134,A05,193491,Cooke; James Edward,31,0,32,1
1683717664583,BIPN 134,A06,193501,Cooke; James Edward,30,0,32,2
1683717664583,BIPN 134,A07,193510,Cooke; James Edward,29,0,32,3
1683717666642,BISP 194,A00,222522,Staff,14,0,32,18
1683717667676,CAT 124,A01,202407,Staff,19,0,25,6
1683717668709,CAT 125,A00,202408,Marchisotto; Jennifer Anne,2,0,20,18
1683717669745,CAT 125R,A00,202409,Smith; Lauryn Alissa,0,11,20,20
1683717669745,CAT 125R,B00,202410,Morales; Celeste Georgianna,0,11,20,20
1683717669745,CAT 125R,C00,202411,Irwin; Matthew Joseph,0,12,20,20
1683717670773,CENG 15,A01,204712,Yang; Kesong,0,1,0,0
1683717671801,CENG 114,A00,202070,Jahed Motlagh; Zeinab,5,0,20,15
1683717672831,CGS 105,A00,185477,Wesling; Megan E.,24,0,40,16
1683717673914,CGS 106,A00,185494,Staff,11,0,22,11
1683717674947,CGS 108,A00,185495,Staff,14,0,20,6
1683717675977,CGS 114,A00,185496,Staff,13,0,18,5
1683717677004,CGS 119,A00,185501,Staff,15,0,20,5
1683717678035,CGS 120,A00,185511,Staff,11,0,20,9
1683717679070,CHEM 4,A01,184675,Bussey; Thomas J,97,0,100,3
1683717680101,CHEM 6A,A01,184677,Staff,32,0,60,28
1683717681127,CHEM 6B,A01,184679,Staff,63,0,100,37
1683717682156,CHEM 6C,A01,184681,Bussey; Thomas J,0,0,50,50
1683717682156,CHEM 6C,A02,184682,Bussey; Thomas J,32,0,50,18
1683717683182,CHEM 40A,A01,184684,Albizati; Kim F.,33,0,100,67
1683717684211,CHEM 40B,A01,184686,Albizati; Kim F.,0,22,100,100
1683717685243,CHEM 41B,A01,184690,Staff,51,0,100,49
1683717686272,COGS 3,A01,184715,Boyle; Mary E. T.,0,27,40,40
1683717687307,COGS 14B,A01,185172,Staff,0,14,38,38
1683717688341,COGS 18,A01,184736,Staff,14,0,80,66
1683717689370,COGS 100,A01,184932,Staff,0,8,73,73
1683717690399,COGS 101A,A01,184935,Staff,0,40,30,30
1683717691425,COGS 101B,A01,184944,Staff,0,2,30,30
1683717692456,COGS 101C,A01,184946,Staff,0,10,30,30
1683717693487,COGS 102A,A01,184951,Johnson; Christine M.,1,0,40,39
1683717694518,COGS 107B,A01,184953,Mooshagian; Eric Frederick,0,52,40,40
1683717695549,COGS 118B,A01,184959,Gupta; Anjum,0,50,40,40
1683717696576,COGS 153,A00,184961,Staff,1,16,30,29
1683717697606,COGS 177,A00,184962,Staff,0,20,30,30
1683717698637,COGS 187A,A01,184969,Boyle; Mary E. T.,0,19,40,40
1683717699665,COMM 10,A01,185174,Staff,0,5,25,25
1683717699665,COMM 10,A02,185189,Staff,0,2,25,25
1683717699665,COMM 10,A03,269821,Staff,0,1,0,0
1683717700697,COMM 100B,A02,185476,Staff,10,0,25,15
1683717700697,COMM 100B,A03,277340,Staff,25,0,25,0
1683717701728,COMM 100C,A01,185314,Staff,2,0,25,23
1683717701728,COMM 100C,A02,185327,Staff,17,0,25,8
1683717702758,COMM 110M,A00,185349,Staff,0,0,40,40
1683717703790,COMM 113T,A00,185352,Staff,25,0,40,15
1683717704818,COMM 114I,A00,185353,Staff,31,0,40,9
1683717705845,COMM 131,A00,185354,Staff,17,0,30,13
1683717706874,CSE 8A,A50,185358,Cao; Yingjun,0,46,10,10
1683717707906,CSE 8B,A01,185362,Staff,0,48,50,50
1683717708936,CSE 11,A01,185416,Cao; Yingjun,0,91,10,10
1683717709965,CSE 20,A01,185445,Briones; Jor-el Thomas Caparas,3,0,25,22
1683717710992,CSE 21,A01,185447,Staff,9,0,50,41
1683717712021,CSE 101,A01,185451,Staff,0,13,50,50
1683717712021,CSE 101,B01,185453,Jones; Miles E,0,15,50,50
1683717714080,CSE 141,A01,185458,Eldon; John,16,0,100,84
1683717715109,CSE 141L,A01,185461,Eldon; John,8,0,100,92
1683717716138,CSE 142,A01,185463,Staff,34,0,60,26
1683717716138,CSE 142,B01,201355,Staff,0,7,60,60
1683717717165,CSE 142L,A01,185470,Staff,34,0,60,26
1683717717165,CSE 142L,B01,201417,Staff,0,6,60,60
1683717718193,CSE 190,A00,201433,Staff,32,0,49,17
1683717719220,DOC 1,A01,259136,Strom; Megan C.,7,0,15,8
1683717719220,DOC 1,A02,259137,Strom; Megan C.,15,0,15,0
1683717719220,DOC 1,A03,259138,Strom; Megan C.,14,0,15,1
1683717719220,DOC 1,A04,259139,Strom; Megan C.,13,0,15,2
1683717720247,DOC 100D,A00,259140,Pass; Natalye Joann,14,0,25,11
1683717721275,DSGN 1,A01,184749,Rill; Bryan,0,26,30,30
1683717722306,DSGN 100,A01,185168,Staff,0,2,25,25
1683717723335,ECE 5,A01,185626,Morris; Karcher William,0,12,0,0
1683717724365,ECE 101,A01,185628,Staff,14,0,70,56
1683717725392,ECE 107,A01,185635,Baghdadchi; Saharnaz,0,0,20,20
1683717725392,ECE 107,A02,185638,Baghdadchi; Saharnaz,1,0,20,19
1683717726419,ECE 148,A01,185647,Silberman; Jack,0,0,16,16
1683717727445,ECON 1,A01,185537,Crane; Meredith Helen,54,0,70,16
1683717728476,ECON 3,A01,185549,Crane; Meredith Helen,30,0,70,40
1683717729510,ECON 4,A01,203354,Anderson; John Charles,0,5,10,10
1683717730537,ECON 100A,A01,185574,Staff,0,5,40,40
1683717731566,ECON 100B,A01,185576,Staff,0,12,50,50
1683717732597,ECON 100C,A01,185589,Newhouse; Herbert S,30,0,70,40
1683717733625,ECON 105,A00,185608,Vespa; Emanuel Ignacio,19,0,35,16
1683717734650,ECON 109,A01,185610,Shishkin; Denis,9,0,35,26
1683717735680,ECON 110A,A01,185612,Staff,8,0,40,32
1683717736707,ECON 120A,A01,185615,Staff,19,0,40,21
1683717737735,ECON 120C,A01,185617,Sun; Yixiao,0,21,70,70
1683717738769,ECON 144,A00,203346,Squires; Dale E,2,0,35,33
1683717739799,ECON 171,A01,203349,Newhouse; Herbert S,0,1,35,35
1683717740826,ECON 173A,A01,185621,Toda; Alexis Akira,21,0,35,14
1683717741855,EDS 25,A01,202413,Staff,0,1,0,0
1683717741855,EDS 25,A02,202414,Staff,0,1,0,0
1683717741855,EDS 25,A03,202415,Staff,0,0,0,0
1683717741855,EDS 25,A04,202416,Staff,0,1,0,0
1683717741855,EDS 25,A05,202439,Staff,0,0,0,0
1683717741855,EDS 25,A06,202440,Staff,0,0,0,0
1683717741855,EDS 25,B01,202631,Staff,0,0,0,0
1683717741855,EDS 25,B02,202632,Staff,0,0,0,0
1683717741855,EDS 25,B03,202639,Staff,0,0,0,0
1683717741855,EDS 25,B04,202640,Staff,0,0,0,0
1683717741855,EDS 25,B05,202643,Staff,0,0,0,0
1683717741855,EDS 25,B06,202644,Staff,0,0,0,0
1683717742883,EDS 38,A01,202659,Black; Alison Michelle,25,0,25,0
1683717743911,EDS 115,A00,202652,Staff,18,0,30,12
1683717744938,EDS 125,A00,202649,Staff,13,0,30,17
1683717745964,EDS 126,A01,203332,Staff,30,0,30,0
1683717746991,EDS 139,A00,202838,Staff,16,0,25,9
1683717748018,EDS 146,A01,202655,Staff,14,0,25,11
1683717749050,ENG 15,A00,185667,Staff,0,1,0,0
1683717749050,ENG 15,B00,185672,Staff,0,0,0,0
1683717749050,ENG 15,C00,185675,Staff,0,0,0,0
1683717749050,ENG 15,D00,185682,Staff,0,0,0,0
1683717749050,ENG 15,E00,185684,Staff,0,0,0,0
1683717750086,ETHN 103,A00,185710,Staff,0,8,35,35
1683717751120,ETHN 103A,A00,199228,Man; Simeon S,0,0,9,9
1683717752149,ETHN 109,A00,185711,Staff,15,0,35,20
1683717753176,ETHN 142,A00,185726,Staff,0,4,30,30
1683717754199,ETHN 163J,A00,199229,Man; Simeon S,5,0,8,3
1683717755230,ETHN 168,A00,185727,Staff,7,0,10,3
1683717756261,ETHN 182,A00,185728,Staff,0,0,35,35
1683717757287,ETHN 183,A00,185737,Staff,10,0,18,8
1683717758317,GLBH 111,A01,209361,Burgos; Jose L.,0,0,0,0
1683717760374,HIEU 104,A00,185792,Staff,14,0,20,6
1683717761404,HIEU 115,A00,185800,Staff,0,0,20,20
1683717762436,HIEU 128,A00,185801,Staff,0,9,20,20
1683717763462,HIEU 147,A00,185802,Staff,15,0,20,5
1683717764491,HIEU 154,A00,185823,Staff,11,0,20,9
1683717765517,HILA 102,A00,185826,Staff,14,0,20,6
1683717766548,HILD 2C,A01,185778,Staff,0,13,20,20
1683717767577,HILD 7B,A01,185780,Kwak; Nancy,0,17,32,32
1683717767577,HILD 7B,A02,185781,Kwak; Nancy,0,18,32,32
1683717768609,HILD 30,A01,185791,Staff,12,0,20,8
1683717769641,HISC 119,A00,185830,Golan; Tal,0,10,20,20
1683717770668,HITO 156GS,A00,185831,Patterson; Patrick H.,0,0,0,23
1683717771699,HIUS 103,A00,185832,Man; Simeon S,0,4,20,20
1683717772729,HIUS 117,A00,185836,Kwak; Nancy,2,0,20,18
1683717773757,HIUS 125,A00,185840,Man; Simeon S,0,2,23,23
1683717774787,HIUS 149,A00,185845,Staff,1,0,20,19
1683717775821,HUM 3,A01,185882,Zavodny; Tatiana Sophia,0,8,50,50
1683717775821,HUM 3,B01,185899,Caldwell; Michael Alan,0,18,50,50
1683717776852,HUM 3GS,A00,185900,Patterson; Patrick H.,0,0,0,23
1683717777940,HUM 4,A01,185938,Zroka; Amy Liane,28,0,50,22
1683717777940,HUM 4,B01,185956,Watkins; Eric,0,6,50,50
1683717777940,HUM 4,B02,202209,Watkins; Eric,0,6,50,50
1683717777940,HUM 4,B03,202210,Watkins; Eric,0,5,50,50
1683717778970,HUM 5,A01,185958,West; Geoffrey Scott,0,0,50,50
1683717778970,HUM 5,A02,202215,West; Geoffrey Scott,0,1,50,50
1683717779996,INTL 190,A00,185959,Gagnon; Jeffrey C,0,0,0,9
1683717779996,INTL 190,B00,185960,Lettieri; Michael Joseph,0,0,0,2
1683717781026,JAPN 180,A00,254509,Staff,5,0,30,25
1683717782059,LATI 10,A01,202853,Kennemore; Amy Michelle,4,0,35,31
1683717782059,LATI 10,A02,202854,Kennemore; Amy Michelle,3,0,35,32
1683717782059,LATI 10,A03,270054,Kennemore; Amy Michelle,30,0,30,0
1683717783088,LATI 180,A00,202855,Kennemore; Amy Michelle,11,0,20,9
1683717784113,LAWS 101,A00,201767,Golan; Tal,0,7,40,40
1683717785139,LIFR 1C,A00,185961,Staff,6,0,20,14
1683717786166,LIFR 1CX,A00,185962,Staff,7,0,20,13
1683717787195,LIFR 1D,A00,185963,Staff,7,0,20,13
1683717788225,LIFR 1DX,A00,185964,Staff,7,0,20,13
1683717789256,LIGN 101,A01,186039,Staff,43,0,50,7
1683717790281,LIGN 165,A00,186040,Staff,14,0,50,36
1683717791306,LTCS 108,A00,186041,Staff,5,0,10,5
1683717792336,LTCS 119,A00,186042,Staff,15,0,20,5
1683717793362,LTCS 130,A00,186043,Wesling; Megan E.,15,0,25,10
1683717795417,LTEA 138,A00,186119,Staff,14,0,40,26
1683717796445,LTEN 124,A00,186148,Staff,5,0,25,20
1683717797475,LTEN 178,A00,186149,Staff,6,0,15,9
1683717798503,LTEN 181,A00,186150,Blanco; John D,34,0,40,6
1683717799533,LTWL 120,A00,186160,Staff,19,0,25,6
1683717800559,LTWL 165,A00,186161,Staff,22,0,25,3
1683717801592,LTWR 100,A00,186162,Staff,0,5,15,15
1683717802619,LTWR 102,A00,186163,Doller; Ben,5,0,15,10
1683717803651,MAE 8,A01,186412,Staff,0,1,0,0
1683717804683,MAE 30B,A00,186445,Bahadori; Mohammad Yousef,81,0,100,19
1683717805711,MAE 40,A00,186592,Bewley; Thomas R,10,0,50,40
1683717806742,MAE 101B,A00,186593,Bahadori; Mohammad Yousef,80,0,100,20
1683717807775,MAE 105,A00,186594,Bandaru; Prabhakar,10,0,50,40
1683717808802,MAE 107,A00,186599,Pham; Hieu Tan,0,8,120,120
1683717809828,MAE 148,A01,186660,Silberman; Jack,3,0,16,13
1683717810861,MATH 10A,A01,188095,Staff,0,6,35,35
1683717811887,MATH 10B,A01,188097,Bowers; Adam R.,0,12,30,30
1683717811887,MATH 10B,A02,188099,Bowers; Adam R.,0,11,30,30
1683717811887,MATH 10B,B01,188104,Bowers; Adam R.,0,10,30,30
1683717811887,MATH 10B,B02,188106,Bowers; Adam R.,0,9,30,30
1683717812921,MATH 10C,A01,188111,Staff,0,20,30,30
1683717812921,MATH 10C,A02,188127,Staff,0,19,30,30
1683717812921,MATH 10C,A03,188131,Staff,0,19,30,30
1683717812921,MATH 10C,B01,188218,Staff,17,0,30,13
1683717812921,MATH 10C,B02,188244,Staff,13,0,30,17
1683717812921,MATH 10C,B03,188277,Staff,14,0,30,16
1683717813953,MATH 18,A01,188344,Bach; Quang Tran,18,0,30,12
1683717813953,MATH 18,A02,188345,Bach; Quang Tran,11,0,30,19
1683717813953,MATH 18,B01,188353,Bach; Quang Tran,11,0,30,19
1683717813953,MATH 18,B02,188354,Bach; Quang Tran,19,0,30,11
1683717814983,MATH 20A,A01,188374,Staff,11,0,35,24
1683717816016,MATH 20B,A01,188382,Ohm; Ko Woon,7,0,30,23
1683717816016,MATH 20B,A02,188383,Ohm; Ko Woon,22,0,30,8
1683717816016,MATH 20B,B01,188385,Ohm; Ko Woon,7,0,30,23
1683717816016,MATH 20B,B02,188392,Ohm; Ko Woon,22,0,30,8
1683717817052,MATH 20C,A01,188394,Harel; Guershon,10,0,30,20
1683717817052,MATH 20C,A02,188395,Harel; Guershon,13,0,30,17
1683717817052,MATH 20C,B01,188404,Harel; Guershon,5,0,30,25
1683717817052,MATH 20C,B02,188405,Harel; Guershon,18,0,30,12
1683717818087,MATH 20D,A01,188414,Hammock; Frances H,0,1,30,30
1683717818087,MATH 20D,A02,188415,Hammock; Frances H,0,1,30,30
1683717818087,MATH 20D,B01,188447,Hammock; Frances H,0,1,30,30
1683717818087,MATH 20D,B02,188486,Hammock; Frances H,2,0,30,28
1683717819119,MATH 20E,A01,188649,Staff,21,0,30,9
1683717819119,MATH 20E,A02,188650,Staff,20,0,30,10
1683717819119,MATH 20E,A03,188673,Staff,0,0,30,30
1683717820151,MATH 102,A01,188675,Staff,0,40,35,35
1683717821183,MATH 103B,A01,188681,Staff,3,0,35,32
1683717821183,MATH 103B,B01,188692,Staff,5,0,35,30
1683717822213,MATH 109,A01,188695,Salehi Golsefidy; Alireza,24,0,35,11
1683717822213,MATH 109,A02,188696,Salehi Golsefidy; Alireza,24,0,35,11
1683717823241,MATH 120A,A01,188698,Eggers; John Dietrich,7,0,35,28
1683717824271,MATH 142B,A01,188736,Ioana; Adrian,0,0,30,30
1683717824271,MATH 142B,A02,188741,Ioana; Adrian,0,1,30,30
1683717824271,MATH 142B,A03,188743,Ioana; Adrian,0,2,30,30
1683717825299,MATH 168A,A01,188790,Staff,0,11,35,35
1683717826334,MATH 170A,A01,188803,Nie; Jiawang,0,2,35,35
1683717826334,MATH 170A,A02,188811,Nie; Jiawang,0,1,35,35
1683717826334,MATH 170A,A03,188814,Nie; Jiawang,1,0,35,34
1683717826334,MATH 170A,A04,188815,Nie; Jiawang,5,0,35,30
1683717827362,MATH 193B,A01,188817,Staff,0,0,35,35
1683717827362,MATH 193B,A02,188818,Staff,6,0,35,29
1683717828391,MGT 4,A01,202857,Anderson; John Charles,59,0,80,21
1683717829422,MGT 12,A00,202858,Lindenberger; Wade Douglas,40,0,90,50
1683717830447,MGT 18,A00,202859,Staff,73,0,90,17
1683717831474,MGT 18GS,A00,202860,McKay; Michael J,13,0,28,15
1683717832505,MGT 45,A00,202861,Pecore; Joseph P.,8,0,90,82
1683717833538,MGT 100,A00,202863,Yavorsky; Daniel Ryan,27,0,90,63
1683717834568,MGT 103,A00,202864,Ehrich; Kristine R,0,19,90,90
1683717835597,MGT 112,A00,202865,Ehrich; Kristine R,15,0,90,75
1683717836630,MGT 121A,A00,202868,Staff,70,0,90,20
1683717837659,MGT 131B,A00,202869,Anderson; John Charles,58,0,90,32
1683717838686,MGT 136,A00,202871,Lindenberger; Wade Douglas,83,0,90,7
1683717839717,MGT 164,A00,202873,Staff,0,67,90,91
1683717840746,MGT 164GS,A00,202874,McKay; Mary A,13,0,28,15
1683717841777,MGT 180,A00,202875,Staff,0,51,90,91
1683717842806,MMW 11R,A01,205019,Herbst; Matthew,0,0,30,30
1683717842806,MMW 11R,A02,205026,Herbst; Matthew,29,0,30,1
1683717843833,MMW 15,A01,193512,Chang; Edmond Yi-Teh,0,8,28,28
1683717843833,MMW 15,A02,193513,Chang; Edmond Yi-Teh,0,5,28,28
1683717843833,MMW 15,A03,193514,Chang; Edmond Yi-Teh,0,5,28,28
1683717843833,MMW 15,A04,193515,Chang; Edmond Yi-Teh,0,5,28,28
1683717843833,MMW 15,A05,193516,Chang; Edmond Yi-Teh,0,5,28,28
1683717843833,MMW 15,A06,193517,Chang; Edmond Yi-Teh,0,6,28,28
1683717843833,MMW 15,B01,193519,Chang; Edmond Yi-Teh,0,5,28,28
1683717843833,MMW 15,B02,193520,Chang; Edmond Yi-Teh,0,5,28,28
1683717843833,MMW 15,B03,193521,Chang; Edmond Yi-Teh,0,5,28,28
1683717843833,MMW 15,B04,193522,Chang; Edmond Yi-Teh,0,6,28,28
1683717843833,MMW 15,B05,193523,Chang; Edmond Yi-Teh,0,5,28,28
1683717843833,MMW 15,B06,193524,Chang; Edmond Yi-Teh,0,5,28,28
1683717844865,MMW 122,A01,193526,Rahimi; Babak,0,16,28,28
1683717844865,MMW 122,A02,193527,Rahimi; Babak,0,15,28,28
1683717844865,MMW 122,A03,193528,Rahimi; Babak,0,0,0,0
1683717844865,MMW 122,A04,193529,Rahimi; Babak,0,0,0,0
1683717845893,MUS 1A,A01,186663,Staff,0,18,35,35
1683717846920,MUS 4,A01,186715,Staff,0,12,35,35
1683717847948,MUS 5R,A01,186796,Dubnov; Shlomo,0,17,35,35
1683717848979,MUS 6,A01,186798,Staff,0,4,25,25
1683717850008,MUS 7,A01,186830,Staff,11,0,35,24
1683717851036,MUS 8,A01,186930,Staff,0,27,35,35
1683717852062,MUS 15,A01,186932,Staff,0,15,35,35
1683717852062,MUS 15,B01,186934,Staff,0,16,35,35
1683717853090,MUS 80,A00,186935,Staff,0,0,20,20
1683717853090,MUS 80,B00,186936,Staff,24,0,25,1
1683717854118,NANO 11,A00,204702,Lipomi; Darren John,0,0,0,0
1683717855153,NANO 15,A01,204709,Yang; Kesong,0,1,0,0
1683717856186,NANO 114,A00,202069,Jahed Motlagh; Zeinab,2,0,10,8
1683717857214,PHIL 1,A00,186955,Grush; Rick Scott,31,0,40,9
1683717858241,PHIL 10,A01,186973,Grush; Rick Scott,27,0,35,8
1683717858241,PHIL 10,A02,186974,Grush; Rick Scott,33,0,35,2
1683717859268,PHIL 13,A01,186976,Staff,1,0,35,34
1683717859268,PHIL 13,A02,186977,Staff,16,0,35,19
1683717860299,PHIL 14,A01,186979,Staff,30,0,35,5
1683717860299,PHIL 14,A02,186986,Staff,32,0,35,3
1683717861328,PHIL 28,A01,186988,Staff,16,0,30,14
1683717861328,PHIL 28,A02,186989,Staff,0,0,30,30
1683717861328,PHIL 28,A03,186990,Staff,10,0,30,20
1683717861328,PHIL 28,A04,186991,Staff,26,0,30,4
1683717862353,PHIL 120,A00,186997,Staff,23,0,40,17
1683717863382,PHIL 137,A00,187003,Staff,8,0,40,32
1683717864412,PHIL 150,A00,187015,Staff,47,0,70,23
1683717865443,PHIL 167,A00,187021,Lamey; Andy M.,34,0,40,6
1683717866470,PHIL 174,A01,202226,Staff,17,0,20,3
1683717866470,PHIL 174,A02,202235,Staff,20,0,20,0
1683717867499,PHIL 191A,A00,258918,Staff,0,0,1,1
1683717868529,PHYS 1A,A00,187028,Staff,26,0,60,34
1683717869561,PHYS 1AL,001,187036,Staff,3,0,30,27
1683717869561,PHYS 1AL,002,187049,Staff,18,0,30,12
1683717870588,PHYS 1B,A00,187058,Staff,21,0,60,39
1683717871620,PHYS 1BL,001,187064,Staff,0,1,30,30
1683717871620,PHYS 1BL,002,187070,Staff,4,0,30,26
1683717872652,PHYS 1C,A00,187082,Staff,30,0,120,90
1683717873680,PHYS 1CL,001,187088,Staff,0,9,30,30
1683717873680,PHYS 1CL,002,187089,Staff,0,1,30,30
1683717873680,PHYS 1CL,009,262693,Staff,9,0,30,21
1683717874706,PHYS 2B,A01,187097,Staff,55,0,115,60
1683717875735,PHYS 2C,A01,187099,Staff,63,0,115,52
1683717876769,PHYS 2CL,A01,187101,Staff,5,0,28,23
1683717876769,PHYS 2CL,A02,187102,Staff,15,0,28,13
1683717877799,PHYS 2D,A01,187123,Shotwell; Brian,95,0,115,20
1683717878828,PHYS 4B,A01,187133,Grinstein; Benjamin,35,0,50,15
1683717879856,POLI 10,A00,188819,Staff,0,4,50,50
1683717880890,POLI 11,A00,188827,Staff,43,0,50,7
1683717881972,POLI 13R,A00,188828,Staff,0,2,20,20
1683717883001,POLI 27,A01,188830,Elgin; Samuel Zincke,0,2,70,70
1683717884033,POLI 30,A00,188832,Desposato; Scott,30,0,50,20
1683717885062,POLI 102F,A00,188834,Staff,1,0,40,39
1683717886087,POLI 104A,A00,188852,Staff,12,0,30,18
1683717887115,POLI 104I,A00,188853,Staff,0,8,20,20
1683717888143,POLI 110B,A00,188854,Wiens; David,6,0,20,14
1683717889170,POLI 112A,A00,188855,Wiens; David,3,0,30,27
1683717890199,POLI 117R,A00,188856,Forman; Fonna,0,12,20,20
1683717891226,POLI 118,A00,188857,Ingham; Sean,8,0,20,12
1683717892254,POLI 120G,A00,188858,Staff,7,0,30,23
1683717893282,POLI 131CR,A00,188863,Hoston; Germaine,20,0,50,30
1683717894313,POLI 133,A00,188864,Nellis; Gareth Hb,44,0,50,6
1683717895340,POLI 134D,A00,188865,Desposato; Scott,27,0,30,3
1683717896372,POLI 142A,A00,188871,Gartzke; Erik,21,0,50,29
1683717897397,POLI 142K,A00,188874,Staff,38,0,50,12
1683717898425,POLI 143,A00,188940,Gartzke; Erik,15,0,30,15
1683717899455,POLI 153,A00,188943,Staff,1,0,20,19
1683717900485,POLI 160AA,A00,188944,Staff,10,0,40,30
1683717901519,POLI 170A,A00,188945,Staff,10,0,30,20
1683717903582,PSYC 1,A00,188952,Staff,36,0,90,54
1683717904613,PSYC 2,B00,188953,Staff,19,0,35,16
1683717905642,PSYC 6,A00,188970,Staff,47,0,60,13
1683717906673,PSYC 7,A00,188973,Staff,35,0,45,10
1683717907701,PSYC 60,A01,188980,Rickard; Timothy C.,42,0,60,18
1683717908734,PSYC 70,A01,189001,Steiner; Eric Tomas,22,0,45,23
1683717909762,PSYC 100,A00,189005,Lacefield; Katharine I,1,98,120,119
1683717910791,PSYC 102,A00,189008,Staff,6,0,30,24
1683717911818,PSYC 106,B00,189026,Gorman; Michael R.,27,0,60,33
1683717912845,PSYC 114,B01,189033,Winkielman; Piotr,0,31,30,30
1683717913873,PSYC 131,A00,189036,Anagnostaras; Stephan,0,44,60,60
1683717914900,PSYC 136,A00,189041,Lowe; Angela Beth,0,7,25,25
1683717915925,PSYC 137,A00,189057,Winkielman; Piotr,0,36,25,25
1683717916953,PSYC 144,A00,189107,Wixted; John T,0,11,50,50
1683717919013,PSYC 162,A00,189142,Staff,0,9,85,85
1683717920042,PSYC 172,A00,189144,Gorman; Michael R.,0,6,30,30
1683717922098,PSYC 179,A00,189146,Lacefield; Katharine I,0,88,120,120
1683717923129,PSYC 181,A00,189147,Anagnostaras; Stephan,0,45,90,90
1683717924157,PSYC 190R,A00,189148,Barner; David A.,0,23,80,80
1683717925189,PSYC 191,A00,189275,Rickard; Timothy C.,0,11,25,25
1683717926217,PSYC 193,A00,189276,Chapman; Eddie Nathaniel,0,1,0,4
1683717927247,PSYC 193L,A01,189281,Lowe; Angela Beth,8,0,20,12
1683717927247,PSYC 193L,B01,189285,Staff,28,0,35,7
1683717928275,RELI 149,A00,187137,Rahimi; Babak,6,0,40,34
1683717929307,SE 9,A01,187315,Staff,0,2,18,18
1683717930336,SE 101B,A00,187409,Staff,24,0,30,6
1683717931363,SE 110B,A00,187444,Staff,10,0,40,30
1683717932394,SE 130B,A00,187449,Staff,31,0,40,9
1683717933424,SE 150A,A00,187516,Staff,8,0,20,12
1683717934450,SE 154,A00,187528,Staff,29,0,50,21
1683717935477,SIO 3,A01,258171,Staff,35,0,40,5
1683717936505,SIO 10,A00,187144,Cook; Geoffrey W,0,6,75,75
1683717937534,SIO 45,A00,187152,Cook; Geoffrey W,1,7,100,99
1683717938565,SIO 109R,A00,194486,Staff,0,4,20,20
1683717940619,SIO 187,A01,187233,Kacev; David,12,0,40,28
1683717941654,SOCI 1,A01,258656,Thorpe; Charles Robert,28,0,30,2
1683717941654,SOCI 1,A02,258658,Thorpe; Charles Robert,30,0,30,0
1683717941654,SOCI 1,A03,258661,Thorpe; Charles Robert,25,0,25,0
1683717941654,SOCI 1,A04,258666,Thorpe; Charles Robert,22,0,25,3
1683717941654,SOCI 1,A05,258897,Thorpe; Charles Robert,22,0,25,3
1683717941654,SOCI 1,A06,258898,Thorpe; Charles Robert,25,0,25,0
1683717942682,SOCI 30,A01,258903,Pardo Guerra; Juan Pablo,14,0,30,16
1683717943707,SOCI 102,A00,258904,Staff,9,0,25,16
1683717944732,SOCI 106,A00,258905,Staff,19,0,25,6
1683717945763,SOCI 111,A00,258907,Ribas Norris; Janet Vanesa,26,0,30,4
1683717946793,SOCI 121R,A00,258908,Pardo Guerra; Juan Pablo,7,0,30,23
1683717947819,SOCI 126,A01,203330,Staff,14,0,20,6
1683717948850,SOCI 131,A00,258909,Thorpe; Charles Robert,30,0,60,30
1683717949880,SOCI 135,A00,258910,Payne; Christine Anna,0,13,30,30
1683717950906,SOCI 157,A00,258911,Staff,10,0,30,20
1683717951931,SOCI 184,A00,258912,Staff,25,0,30,5
1683717952961,SOCI 188D,A00,258913,Staff,22,0,30,8
1683717953993,SYN 2,001,187529,Staff,9,0,16,7
1683717953993,SYN 2,002,201452,Staff,0,20,16,16
1683717953993,SYN 2,003,201469,Staff,1,0,16,15
1683717955020,SYN 100,A01,187531,Staff,0,9,20,20
1683717955020,SYN 100,B01,201491,Staff,0,10,20,20
1683717956047,TDAC 1,A00,189286,Walsh; Kim C.,3,0,20,17
1683717956047,TDAC 1,B00,189287,Harting; Carla Kelso,10,0,20,10
1683717957074,TDAC 101,A00,189300,Walsh; Kim C.,16,0,20,4
1683717957074,TDAC 101,B00,189301,Harting; Carla Kelso,18,0,20,2
1683717958104,TDAC 102,A00,189304,Basso; Beatrice,14,0,20,6
1683717959133,TDAC 108,A00,189305,Staff,18,0,20,2
1683717960173,TDDE 131,A00,189310,Staff,19,0,20,1
1683717960173,TDDE 131,B00,189314,Staff,19,0,20,1
1683717960173,TDDE 131,C00,189315,Staff,48,0,50,2
1683717960173,TDDE 131,D00,189316,Staff,14,0,15,1
1683717960173,TDDE 131,E00,204841,Staff,20,0,20,0
1683717961203,TDGE 10,A00,189289,Staff,26,0,50,24
1683717961203,TDGE 10,B00,189290,Havis; Allan,0,1,50,50
1683717962230,TDGE 11,A00,189291,Fulton; Julia,0,4,50,50
1683717962230,TDGE 11,B00,189292,Staff,20,0,25,5
1683717962230,TDGE 11,C00,260270,Staff,0,0,0,0
1683717963257,TDGE 25,A00,189294,Staff,1,0,20,19
1683717964285,TDGE 124,A00,189318,Fulton; Julia,0,7,50,50
1683717965315,TDGE 125,A00,189319,Staff,13,0,25,12
1683717965315,TDGE 125,B00,189320,Staff,23,0,25,2
1683717966344,TDGE 127,A00,189322,Havis; Allan,1,0,50,49
1683717967370,TDHT 101,A00,189323,Staff,18,0,25,7
1683717967370,TDHT 101,B00,189324,Staff,25,0,25,0
1683717968397,TDHT 102,A00,189325,Staff,49,0,50,1
1683717969428,TDMV 1,A00,189295,Arcidiacono; Kristin,20,0,30,10
1683717969428,TDMV 1,B00,189296,Caligagan; Maria T.,23,0,30,7
1683717970458,TDMV 2,A00,189297,Sammartano; Tonnie,27,0,30,3
1683717970458,TDMV 2,B00,189299,Arcidiacono; Kristin,23,0,30,7
1683717971490,TDMV 3,A00,204998,Rincon; Alicia,22,0,30,8
1683717972517,TDMV 120,A00,189458,Sammartano; Tonnie,28,0,30,2
1683717973544,TDMV 138,A00,189541,Jun; Grace Shin Hae,20,0,40,20
1683717974574,TDMV 142,A00,189717,Caligagan; Tony,25,0,30,5
1683717974574,TDMV 142,B00,189718,Caligagan; Maria T.,25,0,30,5
1683717975604,TMC 2,A01,187533,Staff,25,0,25,0
1683717975604,TMC 2,A02,187534,Staff,25,0,25,0
1683717976634,USP 1,A01,187536,Kwak; Nancy,0,16,25,25
1683717977666,USP 5,A01,187538,Staff,8,0,25,17
1683717978697,USP 101,A00,199253,Staff,0,4,0,0
1683717979724,USP 124,A00,187562,Boomhower; Matthew Charles,0,0,30,30
1683717980749,USP 138,A00,187582,Staff,19,0,25,6
1683717981781,USP 152,A01,187597,Staff,3,0,25,22
1683717982810,USP 153,A00,187598,Staff,18,0,25,7
1683717983837,USP 168,A00,187607,Kwak; Nancy,2,0,5,3
1683717984867,USP 173,A00,187619,Staff,4,0,25,21
1683717985951,USP 181,A00,187638,Staff,0,4,25,25
1683717986978,VIS 103,A00,187650,Cruz; Edwin Teddy,17,0,75,58
1683717988004,VIS 110D,A00,187669,Staff,13,0,22,9
1683717989030,VIS 127C,A00,187720,Shen; Kuiyi,67,0,146,79
1683717990056,VIS 149,A00,187731,Yoldas; Pinar,0,12,22,22
1683717991081,VIS 151,A01,188091,Staff,22,0,34,12
1683717991081,VIS 151,A02,188092,Staff,11,0,34,23
1683717992111,VIS 160B,A00,188093,Stalbaum; Brett,0,1,10,10
1683717994165,WCWP 10B,A00,201720,Staff,0,0,5,5
1683717994165,WCWP 10B,B00,201722,Staff,0,0,6,6
1683717995197,WCWP 100,A00,201725,Gagnon; Jeffrey C,0,0,2,2
1683717995197,WCWP 100,B00,201727,Staff,0,4,15,15
1683717998375,ANBI 133,A00,258401,Wilder; Linnea Lorene,34,0,40,6
1683717999403,ANBI 140,A00,258395,Hrvoj Mihic; Branka,18,0,25,7
1683718000435,ANSC 120,A00,258402,Bialecki; Jon Anthony,26,0,40,14
1683718001465,ANSC 144,A00,258400,Staff,12,0,40,28
1683718003520,ANSC 166,A00,258396,Parish; Steven Martin,156,0,175,19
1683718004549,ANSC 180,A00,193533,Staff,8,0,20,12
1683718005582,ANSC 188,A00,258397,Jassal; Aftab,34,0,40,6
1683718006612,ANTH 3,A01,258316,Staff,23,0,30,7
1683718007644,ANTH 5,A00,258394,Semendeferi; Ekaterini,16,0,20,4
1683718008673,ANTH 21,A01,258331,Staff,4,0,40,36
1683718009699,ANTH 103,A00,258398,Varma; Saiba,15,0,25,10
1683718010729,AWP 10,001,202034,Staff,0,0,0,0
1683718010729,AWP 10,002,202035,Staff,0,0,0,0
1683718010729,AWP 10,003,202036,Staff,0,0,0,0
1683718010729,AWP 10,004,202037,Staff,0,0,0,0
1683718010729,AWP 10,005,202038,Staff,0,0,0,0
1683718010729,AWP 10,006,202039,Staff,0,0,0,0
1683718010729,AWP 10,007,202040,Staff,0,0,0,0
1683718010729,AWP 10,008,202041,Staff,0,0,0,0
1683718010729,AWP 10,009,202042,Staff,0,0,0,0
1683718010729,AWP 10,010,202043,Staff,0,0,0,0
1683718010729,AWP 10,011,202044,Staff,0,0,0,0
1683718010729,AWP 10,012,202045,Staff,0,0,0,0
1683718010729,AWP 10,013,202046,Staff,0,0,0,0
1683718010729,AWP 10,014,202047,Staff,0,0,0,0
1683718010729,AWP 10,015,202048,Staff,0,0,0,0
1683718010729,AWP 10,016,202049,Staff,0,0,0,0
1683718010729,AWP 10,017,202050,Staff,0,0,0,0
1683718010729,AWP 10,018,202051,Staff,0,0,0,0
1683718010729,AWP 10,019,202052,Staff,0,0,0,0
1683718010729,AWP 10,020,202053,Staff,0,0,0,0
1683718010729,AWP 10,021,202054,Staff,0,0,0,0
1683718010729,AWP 10,022,202055,Staff,0,0,0,0
1683718010729,AWP 10,023,202056,Staff,0,0,0,0
1683718010729,AWP 10,024,202057,Staff,0,0,0,0
1683718010729,AWP 10,025,202058,Staff,0,0,0,0
1683718010729,AWP 10,026,202059,Staff,0,0,0,0
1683718011758,AWP 102,001,202032,Staff,0,0,0,0
1683718011758,AWP 102,002,202033,Staff,0,0,0,0
1683718012792,BENG 100,A01,254234,Taylor Amos; Alyssa C,31,0,40,9
1683718013821,BENG 196,001,270013,Engler; Adam J.,9999,0,9999,0
1683718014851,BICD 100R,A01,202018,Smith; Laurie,0,7,32,32
1683718014851,BICD 100R,A02,202019,Smith; Laurie,0,3,32,32
1683718014851,BICD 100R,A03,202020,Smith; Laurie,0,1,32,32
1683718014851,BICD 100R,A04,202021,Smith; Laurie,6,0,32,26
1683718014851,BICD 100R,A05,202022,Smith; Laurie,10,0,32,22
1683718015884,BICD 136,A01,193242,Gustafson-Brown; Cindy,0,2,32,32
1683718015884,BICD 136,A02,193244,Gustafson-Brown; Cindy,13,0,32,19
1683718016921,BIEB 102,A01,193249,Butler; Shannon Rhey,0,0,32,32
1683718016921,BIEB 102,A02,193251,Butler; Shannon Rhey,0,0,32,32
1683718016921,BIEB 102,A03,193253,Butler; Shannon Rhey,0,0,32,32
1683718016921,BIEB 102,A04,193255,Butler; Shannon Rhey,13,0,32,19
1683718016921,BIEB 102,A05,193265,Butler; Shannon Rhey,25,0,32,7
1683718016921,BIEB 102,A06,193269,Butler; Shannon Rhey,12,0,32,20
1683718018972,BIEB 150,A01,193274,Staff,0,0,32,32
1683718018972,BIEB 150,A02,193285,Staff,24,0,32,8
1683718019999,BIEB 194,A00,193286,Kurle; Carolyn M.,19,0,32,13
1683718021039,BILD 1,A01,192291,Staff,15,0,32,17
1683718021039,BILD 1,A02,192292,Staff,30,0,32,2
1683718021039,BILD 1,B01,192520,Reuther; Keefe,0,1,0,0
1683718021039,BILD 1,B02,192532,Reuther; Keefe,0,1,0,0
1683718022067,BILD 3,A01,192556,Butler; Shannon Rhey,0,0,32,32
1683718022067,BILD 3,A02,192581,Butler; Shannon Rhey,0,1,32,32
1683718022067,BILD 3,A03,192611,Butler; Shannon Rhey,19,0,32,13
1683718022067,BILD 3,A04,192612,Butler; Shannon Rhey,23,0,32,9
1683718022067,BILD 3,A05,192613,Butler; Shannon Rhey,26,0,32,6
1683718022067,BILD 3,A06,192679,Butler; Shannon Rhey,27,0,32,5
1683718022067,BILD 3,A07,192682,Butler; Shannon Rhey,20,0,32,12
1683718023095,BILD 4,A01,192836,Reuther; Keefe,1,0,24,23
1683718023095,BILD 4,A02,193044,Reuther; Keefe,4,0,24,20
1683718024121,BILD 10,A01,193142,Gustafson-Brown; Cindy,29,0,32,3
1683718024121,BILD 10,A02,193149,Gustafson-Brown; Cindy,31,0,32,1
1683718025150,BIMM 100,A01,193301,Staff,0,6,32,32
1683718025150,BIMM 100,A02,193312,Staff,0,7,32,32
1683718025150,BIMM 100,A03,193323,Staff,0,10,32,32
1683718026180,BIMM 101,A01,193329,McDonnell; Lisa Marie,0,3,24,24
1683718026180,BIMM 101,A02,193339,McDonnell; Lisa Marie,0,3,24,24
1683718026180,BIMM 101,B01,193354,McDonnell; Lisa Marie,0,4,24,24
1683718026180,BIMM 101,B02,193357,McDonnell; Lisa Marie,0,3,24,24
1683718027209,BIMM 110,A01,193377,Tat; John,0,11,32,32
1683718027209,BIMM 110,A02,193378,Tat; John,0,11,32,32
1683718028239,BIMM 120,A01,206116,Staff,0,0,32,32
1683718028239,BIMM 120,A02,206117,Staff,7,0,32,25
1683718028239,BIMM 120,A03,206121,Staff,21,0,32,11
1683718029267,BIPN 100,A01,193393,Park; Ji Young,0,15,32,32
1683718029267,BIPN 100,A02,193402,Park; Ji Young,0,14,32,32
1683718029267,BIPN 100,A03,193413,Park; Ji Young,0,14,32,32
1683718029267,BIPN 100,A04,193414,Park; Ji Young,0,13,32,32
1683718030293,BIPN 102,A01,193429,Staff,0,0,32,32
1683718030293,BIPN 102,A02,193438,Staff,18,0,32,14
1683718031320,BIPN 106,A01,193450,Reyes Gonzalez; Catalina,0,2,40,40
1683718032346,BIPN 134,A01,193465,Cooke; James Edward,0,0,32,32
1683718032346,BIPN 134,A02,193474,Cooke; James Edward,25,0,32,7
1683718032346,BIPN 134,A03,193485,Cooke; James Edward,29,0,32,3
1683718032346,BIPN 134,A04,193486,Cooke; James Edward,20,0,32,12
1683718032346,BIPN 134,A05,193491,Cooke; James Edward,31,0,32,1
1683718032346,BIPN 134,A06,193501,Cooke; James Edward,30,0,32,2
1683718032346,BIPN 134,A07,193510,Cooke; James Edward,29,0,32,3
1683718034402,BISP 194,A00,222522,Staff,14,0,32,18
1683718035431,CAT 124,A01,202407,Staff,19,0,25,6
1683718036460,CAT 125,A00,202408,Marchisotto; Jennifer Anne,2,0,20,18
1683718037489,CAT 125R,A00,202409,Smith; Lauryn Alissa,0,11,20,20
1683718037489,CAT 125R,B00,202410,Morales; Celeste Georgianna,0,11,20,20
1683718037489,CAT 125R,C00,202411,Irwin; Matthew Joseph,0,12,20,20
1683718038524,CENG 15,A01,204712,Yang; Kesong,0,1,0,0
1683718039551,CENG 114,A00,202070,Jahed Motlagh; Zeinab,5,0,20,15
1683718040579,CGS 105,A00,185477,Wesling; Megan E.,24,0,40,16
1683718041605,CGS 106,A00,185494,Staff,11,0,22,11
1683718042633,CGS 108,A00,185495,Staff,14,0,20,6
1683718043659,CGS 114,A00,185496,Staff,13,0,18,5
1683718054415,CGS 119,A00,185501,Staff,15,0,20,5
1683718055443,CGS 120,A00,185511,Staff,11,0,20,9
1683718056559,CHEM 4,A01,184675,Bussey; Thomas J,97,0,100,3
1683718057599,CHEM 6A,A01,184677,Staff,32,0,60,28
1683718058627,CHEM 6B,A01,184679,Staff,63,0,100,37
1683718059657,CHEM 6C,A01,184681,Bussey; Thomas J,0,0,50,50
1683718059657,CHEM 6C,A02,184682,Bussey; Thomas J,32,0,50,18
1683718060688,CHEM 40A,A01,184684,Albizati; Kim F.,33,0,100,67
1683718061722,CHEM 40B,A01,184686,Albizati; Kim F.,0,22,100,100
1683718062751,CHEM 41B,A01,184690,Staff,51,0,100,49
1683718063780,COGS 3,A01,184715,Boyle; Mary E. T.,0,27,40,40
1683718075043,COGS 14B,A01,185172,Staff,0,14,38,38
1683718076070,COGS 18,A01,184736,Staff,14,0,80,66
1683718077098,COGS 100,A01,184932,Staff,0,8,73,73
1683718078130,COGS 101A,A01,184935,Staff,0,40,30,30
1683718079162,COGS 101B,A01,184944,Staff,0,2,30,30
1683718080192,COGS 101C,A01,184946,Staff,0,10,30,30
1683718081219,COGS 102A,A01,184951,Johnson; Christine M.,1,0,40,39
1683718082253,COGS 107B,A01,184953,Mooshagian; Eric Frederick,0,52,40,40
1683718083281,COGS 118B,A01,184959,Gupta; Anjum,0,50,40,40
1683718084312,COGS 153,A00,184961,Staff,1,16,30,29
1683718095586,COGS 177,A00,184962,Staff,0,20,30,30
1683718096622,COGS 187A,A01,184969,Boyle; Mary E. T.,0,19,40,40
1683718097653,COMM 10,A01,185174,Staff,0,5,25,25
1683718097653,COMM 10,A02,185189,Staff,0,2,25,25
1683718097653,COMM 10,A03,269821,Staff,0,1,0,0
1683718098690,COMM 100B,A02,185476,Staff,10,0,25,15
1683718098690,COMM 100B,A03,277340,Staff,25,0,25,0
1683718099721,COMM 100C,A01,185314,Staff,2,0,25,23
1683718099721,COMM 100C,A02,185327,Staff,17,0,25,8
1683718100754,COMM 110M,A00,185349,Staff,0,0,40,40
1683718101783,COMM 113T,A00,185352,Staff,25,0,40,15
1683718102809,COMM 114I,A00,185353,Staff,31,0,40,9
1683718103839,COMM 131,A00,185354,Staff,17,0,30,13
1683718104874,CSE 8A,A50,185358,Cao; Yingjun,0,46,10,10
1683718116206,CSE 8B,A01,185362,Staff,0,48,50,50
1683718117236,CSE 11,A01,185416,Cao; Yingjun,0,91,10,10
1683718118267,CSE 20,A01,185445,Briones; Jor-el Thomas Caparas,3,0,25,22
1683718119302,CSE 21,A01,185447,Staff,9,0,50,41
1683718120333,CSE 101,A01,185451,Staff,0,13,50,50
1683718120333,CSE 101,B01,185453,Jones; Miles E,0,15,50,50
1683718122389,CSE 141,A01,185458,Eldon; John,16,0,100,84
1683718123415,CSE 141L,A01,185461,Eldon; John,8,0,100,92
1683718124448,CSE 142,A01,185463,Staff,34,0,60,26
1683718124448,CSE 142,B01,201355,Staff,0,7,60,60
1683718125477,CSE 142L,A01,185470,Staff,34,0,60,26
1683718125477,CSE 142L,B01,201417,Staff,0,6,60,60
1683718136778,CSE 190,A00,201433,Staff,32,0,49,17
1683718137814,DOC 1,A01,259136,Strom; Megan C.,7,0,15,8
1683718137814,DOC 1,A02,259137,Strom; Megan C.,15,0,15,0
1683718137814,DOC 1,A03,259138,Strom; Megan C.,14,0,15,1
1683718137814,DOC 1,A04,259139,Strom; Megan C.,13,0,15,2
1683718138845,DOC 100D,A00,259140,Pass; Natalye Joann,14,0,25,11
1683718139881,DSGN 1,A01,184749,Rill; Bryan,0,26,30,30
1683718140967,DSGN 100,A01,185168,Staff,0,2,25,25
1683718142002,ECE 5,A01,185626,Morris; Karcher William,0,12,0,0
1683718143032,ECE 101,A01,185628,Staff,14,0,70,56
1683718144061,ECE 107,A01,185635,Baghdadchi; Saharnaz,0,0,20,20
1683718144061,ECE 107,A02,185638,Baghdadchi; Saharnaz,1,0,20,19
1683718145092,ECE 148,A01,185647,Silberman; Jack,0,0,16,16
1683718146127,ECON 1,A01,185537,Crane; Meredith Helen,54,0,70,16
1683718147160,ECON 3,A01,185549,Crane; Meredith Helen,30,0,70,40
1683718158121,ECON 4,A01,203354,Anderson; John Charles,0,5,10,10
1683718159150,ECON 100A,A01,185574,Staff,0,5,40,40
1683718160178,ECON 100B,A01,185576,Staff,0,12,50,50
1683718161211,ECON 100C,A01,185589,Newhouse; Herbert S,30,0,70,40
1683718162242,ECON 105,A00,185608,Vespa; Emanuel Ignacio,19,0,35,16
1683718163276,ECON 109,A01,185610,Shishkin; Denis,9,0,35,26
1683718164309,ECON 110A,A01,185612,Staff,8,0,40,32
1683718165337,ECON 120A,A01,185615,Staff,19,0,40,21
1683718166370,ECON 120C,A01,185617,Sun; Yixiao,0,21,70,70
1683718167404,ECON 144,A00,203346,Squires; Dale E,2,0,35,33
1683718178289,ECON 171,A01,203349,Newhouse; Herbert S,0,1,35,35
1683718179327,ECON 173A,A01,185621,Toda; Alexis Akira,21,0,35,14
1683718180358,EDS 25,A01,202413,Staff,0,1,0,0
1683718180358,EDS 25,A02,202414,Staff,0,1,0,0
1683718180358,EDS 25,A03,202415,Staff,0,0,0,0
1683718180358,EDS 25,A04,202416,Staff,0,1,0,0
1683718180358,EDS 25,A05,202439,Staff,0,0,0,0
1683718180358,EDS 25,A06,202440,Staff,0,0,0,0
1683718180358,EDS 25,B01,202631,Staff,0,0,0,0
1683718180358,EDS 25,B02,202632,Staff,0,0,0,0
1683718180358,EDS 25,B03,202639,Staff,0,0,0,0
1683718180358,EDS 25,B04,202640,Staff,0,0,0,0
1683718180358,EDS 25,B05,202643,Staff,0,0,0,0
1683718180358,EDS 25,B06,202644,Staff,0,0,0,0
1683718181394,EDS 38,A01,202659,Black; Alison Michelle,25,0,25,0
1683718182423,EDS 115,A00,202652,Staff,18,0,30,12
1683718183451,EDS 125,A00,202649,Staff,13,0,30,17
1683718184479,EDS 126,A01,203332,Staff,30,0,30,0
1683718185506,EDS 139,A00,202838,Staff,16,0,25,9
1683718186534,EDS 146,A01,202655,Staff,14,0,25,11
1683718187567,ENG 15,A00,185667,Staff,0,1,0,0
1683718187567,ENG 15,B00,185672,Staff,0,0,0,0
1683718187567,ENG 15,C00,185675,Staff,0,0,0,0
1683718187567,ENG 15,D00,185682,Staff,0,0,0,0
1683718187567,ENG 15,E00,185684,Staff,0,0,0,0
1683718188597,ETHN 103,A00,185710,Staff,0,8,35,35
1683718189634,ETHN 103A,A00,199228,Man; Simeon S,0,0,9,9
1683718190667,ETHN 109,A00,185711,Staff,15,0,35,20
1683718191695,ETHN 142,A00,185726,Staff,0,4,30,30
1683718192723,ETHN 163J,A00,199229,Man; Simeon S,5,0,8,3
1683718193752,ETHN 168,A00,185727,Staff,7,0,10,3
1683718194781,ETHN 182,A00,185728,Staff,0,0,35,35
1683718195812,ETHN 183,A00,185737,Staff,10,0,18,8
1683718196843,GLBH 111,A01,209361,Burgos; Jose L.,0,0,0,0
1683718198902,HIEU 104,A00,185792,Staff,14,0,20,6
1683718199930,HIEU 115,A00,185800,Staff,0,0,20,20
1683718200958,HIEU 128,A00,185801,Staff,0,9,20,20
1683718201986,HIEU 147,A00,185802,Staff,15,0,20,5
1683718203021,HIEU 154,A00,185823,Staff,11,0,20,9
1683718204051,HILA 102,A00,185826,Staff,14,0,20,6
1683718205081,HILD 2C,A01,185778,Staff,0,13,20,20
1683718206114,HILD 7B,A01,185780,Kwak; Nancy,0,17,32,32
1683718206114,HILD 7B,A02,185781,Kwak; Nancy,0,18,32,32
1683718207140,HILD 30,A01,185791,Staff,12,0,20,8
1683718208169,HISC 119,A00,185830,Golan; Tal,0,10,20,20
1683718209198,HITO 156GS,A00,185831,Patterson; Patrick H.,0,0,0,23
1683718210227,HIUS 103,A00,185832,Man; Simeon S,0,4,20,20
1683718211257,HIUS 117,A00,185836,Kwak; Nancy,2,0,20,18
1683718212285,HIUS 125,A00,185840,Man; Simeon S,0,2,23,23
1683718213314,HIUS 149,A00,185845,Staff,1,0,20,19
1683718214351,HUM 3,A01,185882,Zavodny; Tatiana Sophia,0,8,50,50
1683718214351,HUM 3,B01,185899,Caldwell; Michael Alan,0,18,50,50
1683718215378,HUM 3GS,A00,185900,Patterson; Patrick H.,0,0,0,23
1683718216406,HUM 4,A01,185938,Zroka; Amy Liane,28,0,50,22
1683718216406,HUM 4,B01,185956,Watkins; Eric,0,6,50,50
1683718216406,HUM 4,B02,202209,Watkins; Eric,0,6,50,50
1683718216406,HUM 4,B03,202210,Watkins; Eric,0,5,50,50
1683718217436,HUM 5,A01,185958,West; Geoffrey Scott,0,0,50,50
1683718217436,HUM 5,A02,202215,West; Geoffrey Scott,0,1,50,50
1683718218466,INTL 190,A00,185959,Gagnon; Jeffrey C,0,0,0,9
1683718218466,INTL 190,B00,185960,Lettieri; Michael Joseph,0,0,0,2
1683718219496,JAPN 180,A00,254509,Staff,5,0,30,25
1683718220528,LATI 10,A01,202853,Kennemore; Amy Michelle,4,0,35,31
1683718220528,LATI 10,A02,202854,Kennemore; Amy Michelle,3,0,35,32
1683718220528,LATI 10,A03,270054,Kennemore; Amy Michelle,30,0,30,0
1683718221555,LATI 180,A00,202855,Kennemore; Amy Michelle,11,0,20,9
1683718222591,LAWS 101,A00,201767,Golan; Tal,0,7,40,40
1683718223619,LIFR 1C,A00,185961,Staff,6,0,20,14
1683718224650,LIFR 1CX,A00,185962,Staff,7,0,20,13
1683718225679,LIFR 1D,A00,185963,Staff,7,0,20,13
1683718226706,LIFR 1DX,A00,185964,Staff,7,0,20,13
1683718227736,LIGN 101,A01,186039,Staff,43,0,50,7
1683718228762,LIGN 165,A00,186040,Staff,14,0,50,36
1683718229791,LTCS 108,A00,186041,Staff,5,0,10,5
1683718230823,LTCS 119,A00,186042,Staff,15,0,20,5
1683718231858,LTCS 130,A00,186043,Wesling; Megan E.,15,0,25,10
1683718233918,LTEA 138,A00,186119,Staff,14,0,40,26
1683718234945,LTEN 124,A00,186148,Staff,5,0,25,20
1683718235974,LTEN 178,A00,186149,Staff,6,0,15,9
1683718237001,LTEN 181,A00,186150,Blanco; John D,34,0,40,6
1683718238028,LTWL 120,A00,186160,Staff,19,0,25,6
1683718239059,LTWL 165,A00,186161,Staff,22,0,25,3
1683718240086,LTWR 100,A00,186162,Staff,0,5,15,15
1683718241115,LTWR 102,A00,186163,Doller; Ben,5,0,15,10
1683718242149,MAE 8,A01,186412,Staff,0,1,0,0
1683718243183,MAE 30B,A00,186445,Bahadori; Mohammad Yousef,81,0,100,19
1683718244262,MAE 40,A00,186592,Bewley; Thomas R,10,0,50,40
1683718245289,MAE 101B,A00,186593,Bahadori; Mohammad Yousef,80,0,100,20
1683718246317,MAE 105,A00,186594,Bandaru; Prabhakar,10,0,50,40
1683718247351,MAE 107,A00,186599,Pham; Hieu Tan,0,8,120,120
1683718248383,MAE 148,A01,186660,Silberman; Jack,3,0,16,13
1683718249412,MATH 10A,A01,188095,Staff,0,6,35,35
1683718250442,MATH 10B,A01,188097,Bowers; Adam R.,0,12,30,30
1683718250442,MATH 10B,A02,188099,Bowers; Adam R.,0,11,30,30
1683718250442,MATH 10B,B01,188104,Bowers; Adam R.,0,10,30,30
1683718250442,MATH 10B,B02,188106,Bowers; Adam R.,0,9,30,30
1683718251476,MATH 10C,A01,188111,Staff,0,20,30,30
1683718251476,MATH 10C,A02,188127,Staff,0,19,30,30
1683718251476,MATH 10C,A03,188131,Staff,0,19,30,30
1683718251476,MATH 10C,B01,188218,Staff,17,0,30,13
1683718251476,MATH 10C,B02,188244,Staff,13,0,30,17
1683718251476,MATH 10C,B03,188277,Staff,14,0,30,16
1683718252509,MATH 18,A01,188344,Bach; Quang Tran,18,0,30,12
1683718252509,MATH 18,A02,188345,Bach; Quang Tran,11,0,30,19
1683718252509,MATH 18,B01,188353,Bach; Quang Tran,11,0,30,19
1683718252509,MATH 18,B02,188354,Bach; Quang Tran,19,0,30,11
1683718253537,MATH 20A,A01,188374,Staff,11,0,35,24
1683718254572,MATH 20B,A01,188382,Ohm; Ko Woon,7,0,30,23
1683718254572,MATH 20B,A02,188383,Ohm; Ko Woon,22,0,30,8
1683718254572,MATH 20B,B01,188385,Ohm; Ko Woon,7,0,30,23
1683718254572,MATH 20B,B02,188392,Ohm; Ko Woon,22,0,30,8
1683718255607,MATH 20C,A01,188394,Harel; Guershon,10,0,30,20
1683718255607,MATH 20C,A02,188395,Harel; Guershon,13,0,30,17
1683718255607,MATH 20C,B01,188404,Harel; Guershon,5,0,30,25
1683718255607,MATH 20C,B02,188405,Harel; Guershon,18,0,30,12
1683718256643,MATH 20D,A01,188414,Hammock; Frances H,0,1,30,30
1683718256643,MATH 20D,A02,188415,Hammock; Frances H,0,1,30,30
1683718256643,MATH 20D,B01,188447,Hammock; Frances H,0,1,30,30
1683718256643,MATH 20D,B02,188486,Hammock; Frances H,2,0,30,28
1683718257674,MATH 20E,A01,188649,Staff,21,0,30,9
1683718257674,MATH 20E,A02,188650,Staff,20,0,30,10
1683718257674,MATH 20E,A03,188673,Staff,0,0,30,30
1683718258701,MATH 102,A01,188675,Staff,0,40,35,35
1683718259734,MATH 103B,A01,188681,Staff,3,0,35,32
1683718259734,MATH 103B,B01,188692,Staff,5,0,35,30
1683718260763,MATH 109,A01,188695,Salehi Golsefidy; Alireza,24,0,35,11
1683718260763,MATH 109,A02,188696,Salehi Golsefidy; Alireza,24,0,35,11
1683718261791,MATH 120A,A01,188698,Eggers; John Dietrich,7,0,35,28
1683718262821,MATH 142B,A01,188736,Ioana; Adrian,0,0,30,30
1683718262821,MATH 142B,A02,188741,Ioana; Adrian,0,1,30,30
1683718262821,MATH 142B,A03,188743,Ioana; Adrian,0,2,30,30
1683718263853,MATH 168A,A01,188790,Staff,0,11,35,35
1683718264946,MATH 170A,A01,188803,Nie; Jiawang,0,2,35,35
1683718264946,MATH 170A,A02,188811,Nie; Jiawang,0,1,35,35
1683718264946,MATH 170A,A03,188814,Nie; Jiawang,1,0,35,34
1683718264946,MATH 170A,A04,188815,Nie; Jiawang,5,0,35,30
1683718265975,MATH 193B,A01,188817,Staff,0,0,35,35
1683718265975,MATH 193B,A02,188818,Staff,6,0,35,29
1683718267004,MGT 4,A01,202857,Anderson; John Charles,59,0,80,21
1683718268033,MGT 12,A00,202858,Lindenberger; Wade Douglas,40,0,90,50
1683718269061,MGT 18,A00,202859,Staff,73,0,90,17
1683718270092,MGT 18GS,A00,202860,McKay; Michael J,13,0,28,15
1683718271120,MGT 45,A00,202861,Pecore; Joseph P.,8,0,90,82
1683718272149,MGT 100,A00,202863,Yavorsky; Daniel Ryan,27,0,90,63
1683718273179,MGT 103,A00,202864,Ehrich; Kristine R,0,19,90,90
1683718274218,MGT 112,A00,202865,Ehrich; Kristine R,15,0,90,75
1683718275246,MGT 121A,A00,202868,Staff,70,0,90,20
1683718276273,MGT 131B,A00,202869,Anderson; John Charles,58,0,90,32
1683718277299,MGT 136,A00,202871,Lindenberger; Wade Douglas,83,0,90,7
1683718278335,MGT 164,A00,202873,Staff,0,67,90,91
1683718279365,MGT 164GS,A00,202874,McKay; Mary A,13,0,28,15
1683718280393,MGT 180,A00,202875,Staff,0,51,90,91
1683718281429,MMW 11R,A01,205019,Herbst; Matthew,0,0,30,30
1683718281429,MMW 11R,A02,205026,Herbst; Matthew,29,0,30,1
1683718282458,MMW 15,A01,193512,Chang; Edmond Yi-Teh,0,8,28,28
1683718282458,MMW 15,A02,193513,Chang; Edmond Yi-Teh,0,5,28,28
1683718282458,MMW 15,A03,193514,Chang; Edmond Yi-Teh,0,5,28,28
1683718282458,MMW 15,A04,193515,Chang; Edmond Yi-Teh,0,5,28,28
1683718282458,MMW 15,A05,193516,Chang; Edmond Yi-Teh,0,5,28,28
1683718282458,MMW 15,A06,193517,Chang; Edmond Yi-Teh,0,6,28,28
1683718282458,MMW 15,B01,193519,Chang; Edmond Yi-Teh,0,5,28,28
1683718282458,MMW 15,B02,193520,Chang; Edmond Yi-Teh,0,5,28,28
1683718282458,MMW 15,B03,193521,Chang; Edmond Yi-Teh,0,5,28,28
1683718282458,MMW 15,B04,193522,Chang; Edmond Yi-Teh,0,6,28,28
1683718282458,MMW 15,B05,193523,Chang; Edmond Yi-Teh,0,5,28,28
1683718282458,MMW 15,B06,193524,Chang; Edmond Yi-Teh,0,5,28,28
1683718283486,MMW 122,A01,193526,Rahimi; Babak,0,16,28,28
1683718283486,MMW 122,A02,193527,Rahimi; Babak,0,15,28,28
1683718283486,MMW 122,A03,193528,Rahimi; Babak,0,0,0,0
1683718283486,MMW 122,A04,193529,Rahimi; Babak,0,0,0,0
1683718284513,MUS 1A,A01,186663,Staff,0,18,35,35
1683718285541,MUS 4,A01,186715,Staff,0,12,35,35
1683718286569,MUS 5R,A01,186796,Dubnov; Shlomo,0,17,35,35
1683718287600,MUS 6,A01,186798,Staff,0,4,25,25
1683718288630,MUS 7,A01,186830,Staff,11,0,35,24
1683718289658,MUS 8,A01,186930,Staff,0,27,35,35
1683718290686,MUS 15,A01,186932,Staff,0,15,35,35
1683718290686,MUS 15,B01,186934,Staff,0,16,35,35
1683718291713,MUS 80,A00,186935,Staff,0,0,20,20
1683718291713,MUS 80,B00,186936,Staff,24,0,25,1
1683718292755,NANO 11,A00,204702,Lipomi; Darren John,0,0,0,0
1683718293784,NANO 15,A01,204709,Yang; Kesong,0,1,0,0
1683718294813,NANO 114,A00,202069,Jahed Motlagh; Zeinab,2,0,10,8
1683718295842,PHIL 1,A00,186955,Grush; Rick Scott,31,0,40,9
1683718296874,PHIL 10,A01,186973,Grush; Rick Scott,27,0,35,8
1683718296874,PHIL 10,A02,186974,Grush; Rick Scott,33,0,35,2
1683718297902,PHIL 13,A01,186976,Staff,1,0,35,34
1683718297902,PHIL 13,A02,186977,Staff,16,0,35,19
1683718298928,PHIL 14,A01,186979,Staff,30,0,35,5
1683718298928,PHIL 14,A02,186986,Staff,32,0,35,3
1683718299958,PHIL 28,A01,186988,Staff,16,0,30,14
1683718299958,PHIL 28,A02,186989,Staff,0,0,30,30
1683718299958,PHIL 28,A03,186990,Staff,10,0,30,20
1683718299958,PHIL 28,A04,186991,Staff,26,0,30,4
1683718300987,PHIL 120,A00,186997,Staff,23,0,40,17
1683718302014,PHIL 137,A00,187003,Staff,8,0,40,32
1683718303044,PHIL 150,A00,187015,Staff,47,0,70,23
1683718304075,PHIL 167,A00,187021,Lamey; Andy M.,34,0,40,6
1683718305103,PHIL 174,A01,202226,Staff,17,0,20,3
1683718305103,PHIL 174,A02,202235,Staff,20,0,20,0
1683718306128,PHIL 191A,A00,258918,Staff,0,0,1,1
1683718307156,PHYS 1A,A00,187028,Staff,26,0,60,34
1683718308184,PHYS 1AL,001,187036,Staff,3,0,30,27
1683718308184,PHYS 1AL,002,187049,Staff,18,0,30,12
1683718309211,PHYS 1B,A00,187058,Staff,21,0,60,39
1683718310243,PHYS 1BL,001,187064,Staff,0,1,30,30
1683718310243,PHYS 1BL,002,187070,Staff,4,0,30,26
1683718311276,PHYS 1C,A00,187082,Staff,30,0,120,90
1683718312310,PHYS 1CL,001,187088,Staff,0,9,30,30
1683718312310,PHYS 1CL,002,187089,Staff,0,1,30,30
1683718312310,PHYS 1CL,009,262693,Staff,9,0,30,21
1683718313338,PHYS 2B,A01,187097,Staff,55,0,115,60
1683718314369,PHYS 2C,A01,187099,Staff,63,0,115,52
1683718315396,PHYS 2CL,A01,187101,Staff,5,0,28,23
1683718315396,PHYS 2CL,A02,187102,Staff,15,0,28,13
1683718316424,PHYS 2D,A01,187123,Shotwell; Brian,95,0,115,20
1683718317452,PHYS 4B,A01,187133,Grinstein; Benjamin,35,0,50,15
1683718318477,POLI 10,A00,188819,Staff,0,4,50,50
1683718319505,POLI 11,A00,188827,Staff,43,0,50,7
1683718320532,POLI 13R,A00,188828,Staff,0,2,20,20
1683718321571,POLI 27,A01,188830,Elgin; Samuel Zincke,0,2,70,70
1683718322598,POLI 30,A00,188832,Desposato; Scott,30,0,50,20
1683718323629,POLI 102F,A00,188834,Staff,1,0,40,39
1683718324657,POLI 104A,A00,188852,Staff,12,0,30,18
1683718325685,POLI 104I,A00,188853,Staff,0,8,20,20
1683718326712,POLI 110B,A00,188854,Wiens; David,6,0,20,14
1683718327739,POLI 112A,A00,188855,Wiens; David,3,0,30,27
1683718328766,POLI 117R,A00,188856,Forman; Fonna,0,12,20,20
1683718329794,POLI 118,A00,188857,Ingham; Sean,8,0,20,12
1683718330821,POLI 120G,A00,188858,Staff,7,0,30,23
1683718331849,POLI 131CR,A00,188863,Hoston; Germaine,20,0,50,30
1683718332876,POLI 133,A00,188864,Nellis; Gareth Hb,44,0,50,6
1683718333908,POLI 134D,A00,188865,Desposato; Scott,27,0,30,3
1683718334939,POLI 142A,A00,188871,Gartzke; Erik,21,0,50,29
1683718335970,POLI 142K,A00,188874,Staff,38,0,50,12
1683718336999,POLI 143,A00,188940,Gartzke; Erik,15,0,30,15
1683718338027,POLI 153,A00,188943,Staff,1,0,20,19
1683718339054,POLI 160AA,A00,188944,Staff,10,0,40,30
1683718340083,POLI 170A,A00,188945,Staff,10,0,30,20
1683718342142,PSYC 1,A00,188952,Staff,36,0,90,54
1683718343174,PSYC 2,B00,188953,Staff,19,0,35,16
1683718344204,PSYC 6,A00,188970,Staff,47,0,60,13
1683718345233,PSYC 7,A00,188973,Staff,35,0,45,10
1683718346262,PSYC 60,A01,188980,Rickard; Timothy C.,42,0,60,18
1683718347294,PSYC 70,A01,189001,Steiner; Eric Tomas,22,0,45,23
1683718348320,PSYC 100,A00,189005,Lacefield; Katharine I,1,98,120,119
1683718349350,PSYC 102,A00,189008,Staff,6,0,30,24
1683718350378,PSYC 106,B00,189026,Gorman; Michael R.,27,0,60,33
1683718351405,PSYC 114,B01,189033,Winkielman; Piotr,0,31,30,30
1683718352437,PSYC 131,A00,189036,Anagnostaras; Stephan,0,44,60,60
1683718353469,PSYC 136,A00,189041,Lowe; Angela Beth,0,7,25,25
1683718354496,PSYC 137,A00,189057,Winkielman; Piotr,0,36,25,25
1683718355524,PSYC 144,A00,189107,Wixted; John T,0,11,50,50
1683718357584,PSYC 162,A00,189142,Staff,0,9,85,85
1683718358611,PSYC 172,A00,189144,Gorman; Michael R.,0,6,30,30
1683718360668,PSYC 179,A00,189146,Lacefield; Katharine I,0,88,120,120
1683718361701,PSYC 181,A00,189147,Anagnostaras; Stephan,0,45,90,90
1683718362729,PSYC 190R,A00,189148,Barner; David A.,0,23,80,80
1683718363755,PSYC 191,A00,189275,Rickard; Timothy C.,0,11,25,25
1683718364786,PSYC 193,A00,189276,Chapman; Eddie Nathaniel,0,1,0,4
1683718365821,PSYC 193L,A01,189281,Lowe; Angela Beth,8,0,20,12
1683718365821,PSYC 193L,B01,189285,Staff,28,0,35,7
1683718366849,RELI 149,A00,187137,Rahimi; Babak,6,0,40,34
1683718367876,SE 9,A01,187315,Staff,0,2,18,18
1683718368965,SE 101B,A00,187409,Staff,24,0,30,6
1683718369995,SE 110B,A00,187444,Staff,10,0,40,30
1683718371023,SE 130B,A00,187449,Staff,31,0,40,9
1683718372051,SE 150A,A00,187516,Staff,8,0,20,12
1683718373081,SE 154,A00,187528,Staff,29,0,50,21
1683718374109,SIO 3,A01,258171,Staff,35,0,40,5
1683718375138,SIO 10,A00,187144,Cook; Geoffrey W,0,6,75,75
1683718376166,SIO 45,A00,187152,Cook; Geoffrey W,1,7,100,99
1683718377194,SIO 109R,A00,194486,Staff,0,4,20,20
1683718379255,SIO 187,A01,187233,Kacev; David,12,0,40,28
1683718380284,SOCI 1,A01,258656,Thorpe; Charles Robert,28,0,30,2
1683718380284,SOCI 1,A02,258658,Thorpe; Charles Robert,30,0,30,0
1683718380284,SOCI 1,A03,258661,Thorpe; Charles Robert,25,0,25,0
1683718380284,SOCI 1,A04,258666,Thorpe; Charles Robert,22,0,25,3
1683718380284,SOCI 1,A05,258897,Thorpe; Charles Robert,22,0,25,3
1683718380284,SOCI 1,A06,258898,Thorpe; Charles Robert,25,0,25,0
1683718381312,SOCI 30,A01,258903,Pardo Guerra; Juan Pablo,14,0,30,16
1683718382343,SOCI 102,A00,258904,Staff,9,0,25,16
1683718383370,SOCI 106,A00,258905,Staff,19,0,25,6
1683718384396,SOCI 111,A00,258907,Ribas Norris; Janet Vanesa,26,0,30,4
1683718385425,SOCI 121R,A00,258908,Pardo Guerra; Juan Pablo,7,0,30,23
1683718386454,SOCI 126,A01,203330,Staff,14,0,20,6
1683718387484,SOCI 131,A00,258909,Thorpe; Charles Robert,30,0,60,30
1683718388513,SOCI 135,A00,258910,Payne; Christine Anna,0,13,30,30
1683718389542,SOCI 157,A00,258911,Staff,10,0,30,20
1683718390569,SOCI 184,A00,258912,Staff,25,0,30,5
1683718391600,SOCI 188D,A00,258913,Staff,22,0,30,8
1683718392628,SYN 2,001,187529,Staff,9,0,16,7
1683718392628,SYN 2,002,201452,Staff,0,20,16,16
1683718392628,SYN 2,003,201469,Staff,1,0,16,15
1683718393658,SYN 100,A01,187531,Staff,0,9,20,20
1683718393658,SYN 100,B01,201491,Staff,0,10,20,20
1683718394687,TDAC 1,A00,189286,Walsh; Kim C.,3,0,20,17
1683718394687,TDAC 1,B00,189287,Harting; Carla Kelso,10,0,20,10
1683718395718,TDAC 101,A00,189300,Walsh; Kim C.,16,0,20,4
1683718395718,TDAC 101,B00,189301,Harting; Carla Kelso,18,0,20,2
1683718396747,TDAC 102,A00,189304,Basso; Beatrice,14,0,20,6
1683718397773,TDAC 108,A00,189305,Staff,18,0,20,2
1683718398809,TDDE 131,A00,189310,Staff,19,0,20,1
1683718398809,TDDE 131,B00,189314,Staff,19,0,20,1
1683718398809,TDDE 131,C00,189315,Staff,48,0,50,2
1683718398809,TDDE 131,D00,189316,Staff,14,0,15,1
1683718398809,TDDE 131,E00,204841,Staff,20,0,20,0
1683718399840,TDGE 10,A00,189289,Staff,26,0,50,24
1683718399840,TDGE 10,B00,189290,Havis; Allan,0,1,50,50
1683718400870,TDGE 11,A00,189291,Fulton; Julia,0,4,50,50
1683718400870,TDGE 11,B00,189292,Staff,20,0,25,5
1683718400870,TDGE 11,C00,260270,Staff,0,0,0,0
1683718401897,TDGE 25,A00,189294,Staff,1,0,20,19
1683718402928,TDGE 124,A00,189318,Fulton; Julia,0,7,50,50
1683718403960,TDGE 125,A00,189319,Staff,13,0,25,12
1683718403960,TDGE 125,B00,189320,Staff,23,0,25,2
1683718404991,TDGE 127,A00,189322,Havis; Allan,1,0,50,49
1683718406018,TDHT 101,A00,189323,Staff,18,0,25,7
1683718406018,TDHT 101,B00,189324,Staff,25,0,25,0
1683718407050,TDHT 102,A00,189325,Staff,49,0,50,1
1683718408082,TDMV 1,A00,189295,Arcidiacono; Kristin,20,0,30,10
1683718408082,TDMV 1,B00,189296,Caligagan; Maria T.,23,0,30,7
1683718409111,TDMV 2,A00,189297,Sammartano; Tonnie,27,0,30,3
1683718409111,TDMV 2,B00,189299,Arcidiacono; Kristin,23,0,30,7
1683718410139,TDMV 3,A00,204998,Rincon; Alicia,22,0,30,8
1683718411167,TDMV 120,A00,189458,Sammartano; Tonnie,28,0,30,2
1683718412195,TDMV 138,A00,189541,Jun; Grace Shin Hae,20,0,40,20
1683718413228,TDMV 142,A00,189717,Caligagan; Tony,25,0,30,5
1683718413228,TDMV 142,B00,189718,Caligagan; Maria T.,25,0,30,5
1683718414254,TMC 2,A01,187533,Staff,25,0,25,0
1683718414254,TMC 2,A02,187534,Staff,25,0,25,0
1683718415287,USP 1,A01,187536,Kwak; Nancy,0,16,25,25
1683718416313,USP 5,A01,187538,Staff,8,0,25,17
1683718417345,USP 101,A00,199253,Staff,0,4,0,0
1683718418379,USP 124,A00,187562,Boomhower; Matthew Charles,0,0,30,30
1683718419406,USP 138,A00,187582,Staff,19,0,25,6
1683718420435,USP 152,A01,187597,Staff,3,0,25,22
1683718421462,USP 153,A00,187598,Staff,18,0,25,7
1683718422491,USP 168,A00,187607,Kwak; Nancy,2,0,5,3
1683718423518,USP 173,A00,187619,Staff,4,0,25,21
1683718424548,USP 181,A00,187638,Staff,0,4,25,25
1683718425581,VIS 103,A00,187650,Cruz; Edwin Teddy,17,0,75,58
1683718426611,VIS 110D,A00,187669,Staff,13,0,22,9
1683718427638,VIS 127C,A00,187720,Shen; Kuiyi,67,0,146,79
1683718428670,VIS 149,A00,187731,Yoldas; Pinar,0,12,22,22
1683718429698,VIS 151,A01,188091,Staff,22,0,34,12
1683718429698,VIS 151,A02,188092,Staff,11,0,34,23
1683718430734,VIS 160B,A00,188093,Stalbaum; Brett,0,1,10,10
1683718432793,WCWP 10B,A00,201720,Staff,0,0,5,5
1683718432793,WCWP 10B,B00,201722,Staff,0,0,6,6
1683718433825,WCWP 100,A00,201725,Gagnon; Jeffrey C,0,0,2,2
1683718433825,WCWP 100,B00,201727,Staff,0,4,15,15
1683718437022,ANBI 133,A00,258401,Wilder; Linnea Lorene,34,0,40,6
1683718438053,ANBI 140,A00,258395,Hrvoj Mihic; Branka,18,0,25,7
1683718439082,ANSC 120,A00,258402,Bialecki; Jon Anthony,26,0,40,14
1683718440107,ANSC 144,A00,258400,Staff,12,0,40,28
1683718442164,ANSC 166,A00,258396,Parish; Steven Martin,156,0,175,19
1683718443190,ANSC 180,A00,193533,Staff,8,0,20,12
1683718444216,ANSC 188,A00,258397,Jassal; Aftab,34,0,40,6
1683718445242,ANTH 3,A01,258316,Staff,23,0,30,7
1683718446269,ANTH 5,A00,258394,Semendeferi; Ekaterini,16,0,20,4
1683718447294,ANTH 21,A01,258331,Staff,4,0,40,36
1683718448325,ANTH 103,A00,258398,Varma; Saiba,15,0,25,10
1683718449361,AWP 10,001,202034,Staff,0,0,0,0
1683718449361,AWP 10,002,202035,Staff,0,0,0,0
1683718449361,AWP 10,003,202036,Staff,0,0,0,0
1683718449361,AWP 10,004,202037,Staff,0,0,0,0
1683718449361,AWP 10,005,202038,Staff,0,0,0,0
1683718449361,AWP 10,006,202039,Staff,0,0,0,0
1683718449361,AWP 10,007,202040,Staff,0,0,0,0
1683718449361,AWP 10,008,202041,Staff,0,0,0,0
1683718449361,AWP 10,009,202042,Staff,0,0,0,0
1683718449361,AWP 10,010,202043,Staff,0,0,0,0
1683718449361,AWP 10,011,202044,Staff,0,0,0,0
1683718449361,AWP 10,012,202045,Staff,0,0,0,0
1683718449361,AWP 10,013,202046,Staff,0,0,0,0
1683718449361,AWP 10,014,202047,Staff,0,0,0,0
1683718449361,AWP 10,015,202048,Staff,0,0,0,0
1683718449361,AWP 10,016,202049,Staff,0,0,0,0
1683718449361,AWP 10,017,202050,Staff,0,0,0,0
1683718449361,AWP 10,018,202051,Staff,0,0,0,0
1683718449361,AWP 10,019,202052,Staff,0,0,0,0
1683718449361,AWP 10,020,202053,Staff,0,0,0,0
1683718449361,AWP 10,021,202054,Staff,0,0,0,0
1683718449361,AWP 10,022,202055,Staff,0,0,0,0
1683718449361,AWP 10,023,202056,Staff,0,0,0,0
1683718449361,AWP 10,024,202057,Staff,0,0,0,0
1683718449361,AWP 10,025,202058,Staff,0,0,0,0
1683718449361,AWP 10,026,202059,Staff,0,0,0,0
1683718450390,AWP 102,001,202032,Staff,0,0,0,0
1683718450390,AWP 102,002,202033,Staff,0,0,0,0
1683718451420,BENG 100,A01,254234,Taylor Amos; Alyssa C,31,0,40,9
1683718452447,BENG 196,001,270013,Engler; Adam J.,9999,0,9999,0
1683718453483,BICD 100R,A01,202018,Smith; Laurie,0,7,32,32
1683718453483,BICD 100R,A02,202019,Smith; Laurie,0,3,32,32
1683718453483,BICD 100R,A03,202020,Smith; Laurie,0,1,32,32
1683718453483,BICD 100R,A04,202021,Smith; Laurie,6,0,32,26
1683718453483,BICD 100R,A05,202022,Smith; Laurie,10,0,32,22
1683718454512,BICD 136,A01,193242,Gustafson-Brown; Cindy,0,2,32,32
1683718454512,BICD 136,A02,193244,Gustafson-Brown; Cindy,13,0,32,19
1683718455544,BIEB 102,A01,193249,Butler; Shannon Rhey,0,0,32,32
1683718455544,BIEB 102,A02,193251,Butler; Shannon Rhey,0,0,32,32
1683718455544,BIEB 102,A03,193253,Butler; Shannon Rhey,0,0,32,32
1683718455544,BIEB 102,A04,193255,Butler; Shannon Rhey,13,0,32,19
1683718455544,BIEB 102,A05,193265,Butler; Shannon Rhey,25,0,32,7
1683718455544,BIEB 102,A06,193269,Butler; Shannon Rhey,12,0,32,20
1683718457600,BIEB 150,A01,193274,Staff,0,0,32,32
1683718457600,BIEB 150,A02,193285,Staff,24,0,32,8
1683718458638,BIEB 194,A00,193286,Kurle; Carolyn M.,19,0,32,13
1683718459673,BILD 1,A01,192291,Staff,15,0,32,17
1683718459673,BILD 1,A02,192292,Staff,30,0,32,2
1683718459673,BILD 1,B01,192520,Reuther; Keefe,0,1,0,0
1683718459673,BILD 1,B02,192532,Reuther; Keefe,0,1,0,0
1683718460700,BILD 3,A01,192556,Butler; Shannon Rhey,0,0,32,32
1683718460700,BILD 3,A02,192581,Butler; Shannon Rhey,0,1,32,32
1683718460700,BILD 3,A03,192611,Butler; Shannon Rhey,19,0,32,13
1683718460700,BILD 3,A04,192612,Butler; Shannon Rhey,23,0,32,9
1683718460700,BILD 3,A05,192613,Butler; Shannon Rhey,26,0,32,6
1683718460700,BILD 3,A06,192679,Butler; Shannon Rhey,27,0,32,5
1683718460700,BILD 3,A07,192682,Butler; Shannon Rhey,20,0,32,12
1683718461726,BILD 4,A01,192836,Reuther; Keefe,1,0,24,23
1683718461726,BILD 4,A02,193044,Reuther; Keefe,4,0,24,20
1683718462758,BILD 10,A01,193142,Gustafson-Brown; Cindy,29,0,32,3
1683718462758,BILD 10,A02,193149,Gustafson-Brown; Cindy,31,0,32,1
1683718463791,BIMM 100,A01,193301,Staff,0,6,32,32
1683718463791,BIMM 100,A02,193312,Staff,0,7,32,32
1683718463791,BIMM 100,A03,193323,Staff,0,10,32,32
1683718464819,BIMM 101,A01,193329,McDonnell; Lisa Marie,0,3,24,24
1683718464819,BIMM 101,A02,193339,McDonnell; Lisa Marie,0,3,24,24
1683718464819,BIMM 101,B01,193354,McDonnell; Lisa Marie,0,4,24,24
1683718464819,BIMM 101,B02,193357,McDonnell; Lisa Marie,0,3,24,24
1683718465849,BIMM 110,A01,193377,Tat; John,0,11,32,32
1683718465849,BIMM 110,A02,193378,Tat; John,0,11,32,32
1683718466878,BIMM 120,A01,206116,Staff,0,0,32,32
1683718466878,BIMM 120,A02,206117,Staff,7,0,32,25
1683718466878,BIMM 120,A03,206121,Staff,21,0,32,11
1683718467911,BIPN 100,A01,193393,Park; Ji Young,0,15,32,32
1683718467911,BIPN 100,A02,193402,Park; Ji Young,0,14,32,32
1683718467911,BIPN 100,A03,193413,Park; Ji Young,0,14,32,32
1683718467911,BIPN 100,A04,193414,Park; Ji Young,0,13,32,32
1683718468937,BIPN 102,A01,193429,Staff,0,0,32,32
1683718468937,BIPN 102,A02,193438,Staff,18,0,32,14
1683718469970,BIPN 106,A01,193450,Reyes Gonzalez; Catalina,0,2,40,40
1683718471001,BIPN 134,A01,193465,Cooke; James Edward,0,0,32,32
1683718471001,BIPN 134,A02,193474,Cooke; James Edward,25,0,32,7
1683718471001,BIPN 134,A03,193485,Cooke; James Edward,29,0,32,3
1683718471001,BIPN 134,A04,193486,Cooke; James Edward,20,0,32,12
1683718471001,BIPN 134,A05,193491,Cooke; James Edward,31,0,32,1
1683718471001,BIPN 134,A06,193501,Cooke; James Edward,30,0,32,2
1683718471001,BIPN 134,A07,193510,Cooke; James Edward,29,0,32,3
1683718473117,BISP 194,A00,222522,Staff,14,0,32,18
1683718474148,CAT 124,A01,202407,Staff,19,0,25,6
1683718475180,CAT 125,A00,202408,Marchisotto; Jennifer Anne,2,0,20,18
1683718476211,CAT 125R,A00,202409,Smith; Lauryn Alissa,0,11,20,20
1683718476211,CAT 125R,B00,202410,Morales; Celeste Georgianna,0,11,20,20
1683718476211,CAT 125R,C00,202411,Irwin; Matthew Joseph,0,12,20,20
1683718477236,CENG 15,A01,204712,Yang; Kesong,0,1,0,0
1683718478265,CENG 114,A00,202070,Jahed Motlagh; Zeinab,5,0,20,15
1683718479292,CGS 105,A00,185477,Wesling; Megan E.,24,0,40,16
1683718480323,CGS 106,A00,185494,Staff,11,0,22,11
1683718481353,CGS 108,A00,185495,Staff,14,0,20,6
1683718482381,CGS 114,A00,185496,Staff,13,0,18,5
1683718483406,CGS 119,A00,185501,Staff,15,0,20,5
1683718484431,CGS 120,A00,185511,Staff,11,0,20,9
1683718485461,CHEM 4,A01,184675,Bussey; Thomas J,97,0,100,3
1683718486489,CHEM 6A,A01,184677,Staff,32,0,60,28
1683718487520,CHEM 6B,A01,184679,Staff,63,0,100,37
1683718488552,CHEM 6C,A01,184681,Bussey; Thomas J,0,0,50,50
1683718488552,CHEM 6C,A02,184682,Bussey; Thomas J,32,0,50,18
1683718489585,CHEM 40A,A01,184684,Albizati; Kim F.,33,0,100,67
1683718501029,CHEM 40B,A01,184686,Albizati; Kim F.,0,22,100,100
1683718502058,CHEM 41B,A01,184690,Staff,51,0,100,49
1683718503086,COGS 3,A01,184715,Boyle; Mary E. T.,0,27,40,40
1683718504113,COGS 14B,A01,185172,Staff,0,14,38,38
1683718505142,COGS 18,A01,184736,Staff,14,0,80,66
1683718506169,COGS 100,A01,184932,Staff,0,8,73,73
1683718507195,COGS 101A,A01,184935,Staff,0,40,30,30
1683718508226,COGS 101B,A01,184944,Staff,0,2,30,30
1683718509256,COGS 101C,A01,184946,Staff,0,10,30,30
1683718510286,COGS 102A,A01,184951,Johnson; Christine M.,1,0,40,39
1683718516527,COGS 107B,A01,184953,Mooshagian; Eric Frederick,0,52,40,40
1683718517553,COGS 118B,A01,184959,Gupta; Anjum,0,50,40,40
1683718518580,COGS 153,A00,184961,Staff,1,16,30,29
1683718519612,COGS 177,A00,184962,Staff,0,20,30,30
1683718520643,COGS 187A,A01,184969,Boyle; Mary E. T.,0,19,40,40
1683718521671,COMM 10,A01,185174,Staff,0,5,25,25
1683718521671,COMM 10,A02,185189,Staff,0,2,25,25
1683718521671,COMM 10,A03,269821,Staff,0,1,0,0
1683718522701,COMM 100B,A02,185476,Staff,10,0,25,15
1683718522701,COMM 100B,A03,277340,Staff,25,0,25,0
1683718523729,COMM 100C,A01,185314,Staff,2,0,25,23
1683718523729,COMM 100C,A02,185327,Staff,17,0,25,8
1683718524757,COMM 110M,A00,185349,Staff,0,0,40,40
1683718525789,COMM 113T,A00,185352,Staff,25,0,40,15
1683718526818,COMM 114I,A00,185353,Staff,31,0,40,9
1683718527849,COMM 131,A00,185354,Staff,17,0,30,13
1683718528880,CSE 8A,A50,185358,Cao; Yingjun,0,46,10,10
1683718529907,CSE 8B,A01,185362,Staff,0,48,50,50
1683718530933,CSE 11,A01,185416,Cao; Yingjun,0,91,10,10
1683718531964,CSE 20,A01,185445,Briones; Jor-el Thomas Caparas,3,0,25,22
1683718532992,CSE 21,A01,185447,Staff,9,0,50,41
1683718534024,CSE 101,A01,185451,Staff,0,13,50,50
1683718534024,CSE 101,B01,185453,Jones; Miles E,0,15,50,50
1683718536081,CSE 141,A01,185458,Eldon; John,16,0,100,84
1683718537108,CSE 141L,A01,185461,Eldon; John,8,0,100,92
1683718538135,CSE 142,A01,185463,Staff,34,0,60,26
1683718538135,CSE 142,B01,201355,Staff,0,7,60,60
1683718539167,CSE 142L,A01,185470,Staff,34,0,60,26
1683718539167,CSE 142L,B01,201417,Staff,0,6,60,60
1683718540199,CSE 190,A00,201433,Staff,32,0,49,17
1683718541232,DOC 1,A01,259136,Strom; Megan C.,7,0,15,8
1683718541232,DOC 1,A02,259137,Strom; Megan C.,15,0,15,0
1683718541232,DOC 1,A03,259138,Strom; Megan C.,14,0,15,1
1683718541232,DOC 1,A04,259139,Strom; Megan C.,13,0,15,2
1683718542264,DOC 100D,A00,259140,Pass; Natalye Joann,14,0,25,11
1683718543296,DSGN 1,A01,184749,Rill; Bryan,0,26,30,30
1683718544321,DSGN 100,A01,185168,Staff,0,2,25,25
1683718545358,ECE 5,A01,185626,Morris; Karcher William,0,12,0,0
1683718546392,ECE 101,A01,185628,Staff,14,0,70,56
1683718547420,ECE 107,A01,185635,Baghdadchi; Saharnaz,0,0,20,20
1683718547420,ECE 107,A02,185638,Baghdadchi; Saharnaz,1,0,20,19
1683718548448,ECE 148,A01,185647,Silberman; Jack,0,0,16,16
1683718549476,ECON 1,A01,185537,Crane; Meredith Helen,54,0,70,16
1683718550507,ECON 3,A01,185549,Crane; Meredith Helen,30,0,70,40
1683718551541,ECON 4,A01,203354,Anderson; John Charles,0,5,10,10
1683718552571,ECON 100A,A01,185574,Staff,0,5,40,40
1683718553601,ECON 100B,A01,185576,Staff,0,12,50,50
1683718554629,ECON 100C,A01,185589,Newhouse; Herbert S,30,0,70,40
1683718555661,ECON 105,A00,185608,Vespa; Emanuel Ignacio,19,0,35,16
1683718556689,ECON 109,A01,185610,Shishkin; Denis,9,0,35,26
1683718557717,ECON 110A,A01,185612,Staff,8,0,40,32
1683718558745,ECON 120A,A01,185615,Staff,19,0,40,21
1683718559777,ECON 120C,A01,185617,Sun; Yixiao,0,21,70,70
1683718560809,ECON 144,A00,203346,Squires; Dale E,2,0,35,33
1683718561834,ECON 171,A01,203349,Newhouse; Herbert S,0,1,35,35
1683718562865,ECON 173A,A01,185621,Toda; Alexis Akira,21,0,35,14
1683718563901,EDS 25,A01,202413,Staff,0,1,0,0
1683718563901,EDS 25,A02,202414,Staff,0,1,0,0
1683718563901,EDS 25,A03,202415,Staff,0,0,0,0
1683718563901,EDS 25,A04,202416,Staff,0,1,0,0
1683718563901,EDS 25,A05,202439,Staff,0,0,0,0
1683718563901,EDS 25,A06,202440,Staff,0,0,0,0
1683718563901,EDS 25,B01,202631,Staff,0,0,0,0
1683718563901,EDS 25,B02,202632,Staff,0,0,0,0
1683718563901,EDS 25,B03,202639,Staff,0,0,0,0
1683718563901,EDS 25,B04,202640,Staff,0,0,0,0
1683718563901,EDS 25,B05,202643,Staff,0,0,0,0
1683718563901,EDS 25,B06,202644,Staff,0,0,0,0
1683718564930,EDS 38,A01,202659,Black; Alison Michelle,25,0,25,0
1683718565957,EDS 115,A00,202652,Staff,18,0,30,12
1683718566983,EDS 125,A00,202649,Staff,13,0,30,17
1683718568016,EDS 126,A01,203332,Staff,30,0,30,0
1683718569053,EDS 139,A00,202838,Staff,16,0,25,9
1683718570081,EDS 146,A01,202655,Staff,14,0,25,11
1683718571111,ENG 15,A00,185667,Staff,0,1,0,0
1683718571111,ENG 15,B00,185672,Staff,0,0,0,0
1683718571111,ENG 15,C00,185675,Staff,0,0,0,0
1683718571111,ENG 15,D00,185682,Staff,0,0,0,0
1683718571111,ENG 15,E00,185684,Staff,0,0,0,0
1683718572142,ETHN 103,A00,185710,Staff,0,8,35,35
1683718573172,ETHN 103A,A00,199228,Man; Simeon S,0,0,9,9
1683718574197,ETHN 109,A00,185711,Staff,15,0,35,20
1683718575226,ETHN 142,A00,185726,Staff,0,4,30,30
1683718576254,ETHN 163J,A00,199229,Man; Simeon S,5,0,8,3
1683718577282,ETHN 168,A00,185727,Staff,7,0,10,3
1683718578310,ETHN 182,A00,185728,Staff,0,0,35,35
1683718579339,ETHN 183,A00,185737,Staff,10,0,18,8
1683718580367,GLBH 111,A01,209361,Burgos; Jose L.,0,0,0,0
1683718582424,HIEU 104,A00,185792,Staff,14,0,20,6
1683718583450,HIEU 115,A00,185800,Staff,0,0,20,20
1683718584477,HIEU 128,A00,185801,Staff,0,9,20,20
1683718585508,HIEU 147,A00,185802,Staff,15,0,20,5
1683718586533,HIEU 154,A00,185823,Staff,11,0,20,9
1683718587562,HILA 102,A00,185826,Staff,14,0,20,6
1683718588589,HILD 2C,A01,185778,Staff,0,13,20,20
1683718589615,HILD 7B,A01,185780,Kwak; Nancy,0,17,32,32
1683718589615,HILD 7B,A02,185781,Kwak; Nancy,0,18,32,32
1683718590645,HILD 30,A01,185791,Staff,12,0,20,8
1683718591680,HISC 119,A00,185830,Golan; Tal,0,10,20,20
1683718592781,HITO 156GS,A00,185831,Patterson; Patrick H.,0,0,0,23
1683718593811,HIUS 103,A00,185832,Man; Simeon S,0,4,20,20
1683718594838,HIUS 117,A00,185836,Kwak; Nancy,2,0,20,18
1683718595863,HIUS 125,A00,185840,Man; Simeon S,0,2,23,23
1683718596894,HIUS 149,A00,185845,Staff,1,0,20,19
1683718597923,HUM 3,A01,185882,Zavodny; Tatiana Sophia,0,8,50,50
1683718597923,HUM 3,B01,185899,Caldwell; Michael Alan,0,18,50,50
1683718598950,HUM 3GS,A00,185900,Patterson; Patrick H.,0,0,0,23
1683718599981,HUM 4,A01,185938,Zroka; Amy Liane,28,0,50,22
1683718599981,HUM 4,B01,185956,Watkins; Eric,0,6,50,50
1683718599981,HUM 4,B02,202209,Watkins; Eric,0,6,50,50
1683718599981,HUM 4,B03,202210,Watkins; Eric,0,5,50,50
1683718601010,HUM 5,A01,185958,West; Geoffrey Scott,0,0,50,50
1683718601010,HUM 5,A02,202215,West; Geoffrey Scott,0,1,50,50
1683718602038,INTL 190,A00,185959,Gagnon; Jeffrey C,0,0,0,9
1683718602038,INTL 190,B00,185960,Lettieri; Michael Joseph,0,0,0,2
1683718603069,JAPN 180,A00,254509,Staff,5,0,30,25
1683718604097,LATI 10,A01,202853,Kennemore; Amy Michelle,4,0,35,31
1683718604097,LATI 10,A02,202854,Kennemore; Amy Michelle,3,0,35,32
1683718604097,LATI 10,A03,270054,Kennemore; Amy Michelle,30,0,30,0
1683718605124,LATI 180,A00,202855,Kennemore; Amy Michelle,11,0,20,9
1683718606155,LAWS 101,A00,201767,Golan; Tal,0,7,40,40
1683718607182,LIFR 1C,A00,185961,Staff,6,0,20,14
1683718608209,LIFR 1CX,A00,185962,Staff,7,0,20,13
1683718609236,LIFR 1D,A00,185963,Staff,7,0,20,13
1683718610265,LIFR 1DX,A00,185964,Staff,7,0,20,13
1683718611290,LIGN 101,A01,186039,Staff,43,0,50,7
1683718612317,LIGN 165,A00,186040,Staff,14,0,50,36
1683718613345,LTCS 108,A00,186041,Staff,5,0,10,5
1683718614373,LTCS 119,A00,186042,Staff,15,0,20,5
1683718615402,LTCS 130,A00,186043,Wesling; Megan E.,15,0,25,10
1683718617459,LTEA 138,A00,186119,Staff,14,0,40,26
1683718618489,LTEN 124,A00,186148,Staff,5,0,25,20
1683718619516,LTEN 178,A00,186149,Staff,6,0,15,9
1683718620544,LTEN 181,A00,186150,Blanco; John D,34,0,40,6
1683718621574,LTWL 120,A00,186160,Staff,19,0,25,6
1683718622599,LTWL 165,A00,186161,Staff,22,0,25,3
1683718623625,LTWR 100,A00,186162,Staff,0,5,15,15
1683718624652,LTWR 102,A00,186163,Doller; Ben,5,0,15,10
1683718625680,MAE 8,A01,186412,Staff,0,1,0,0
1683718626708,MAE 30B,A00,186445,Bahadori; Mohammad Yousef,81,0,100,19
1683718627739,MAE 40,A00,186592,Bewley; Thomas R,10,0,50,40
1683718628767,MAE 101B,A00,186593,Bahadori; Mohammad Yousef,80,0,100,20
1683718629801,MAE 105,A00,186594,Bandaru; Prabhakar,10,0,50,40
1683718630830,MAE 107,A00,186599,Pham; Hieu Tan,0,8,120,120
1683718631858,MAE 148,A01,186660,Silberman; Jack,3,0,16,13
1683718632887,MATH 10A,A01,188095,Staff,0,6,35,35
1683718633917,MATH 10B,A01,188097,Bowers; Adam R.,0,12,30,30
1683718633917,MATH 10B,A02,188099,Bowers; Adam R.,0,11,30,30
1683718633917,MATH 10B,B01,188104,Bowers; Adam R.,0,10,30,30
1683718633917,MATH 10B,B02,188106,Bowers; Adam R.,0,9,30,30
1683718634947,MATH 10C,A01,188111,Staff,0,20,30,30
1683718634947,MATH 10C,A02,188127,Staff,0,19,30,30
1683718634947,MATH 10C,A03,188131,Staff,0,19,30,30
1683718634947,MATH 10C,B01,188218,Staff,17,0,30,13
1683718634947,MATH 10C,B02,188244,Staff,13,0,30,17
1683718634947,MATH 10C,B03,188277,Staff,14,0,30,16
1683718635983,MATH 18,A01,188344,Bach; Quang Tran,18,0,30,12
1683718635983,MATH 18,A02,188345,Bach; Quang Tran,11,0,30,19
1683718635983,MATH 18,B01,188353,Bach; Quang Tran,11,0,30,19
1683718635983,MATH 18,B02,188354,Bach; Quang Tran,19,0,30,11
1683718637011,MATH 20A,A01,188374,Staff,11,0,35,24
1683718638040,MATH 20B,A01,188382,Ohm; Ko Woon,7,0,30,23
1683718638040,MATH 20B,A02,188383,Ohm; Ko Woon,22,0,30,8
1683718638040,MATH 20B,B01,188385,Ohm; Ko Woon,7,0,30,23
1683718638040,MATH 20B,B02,188392,Ohm; Ko Woon,22,0,30,8
1683718639068,MATH 20C,A01,188394,Harel; Guershon,10,0,30,20
1683718639068,MATH 20C,A02,188395,Harel; Guershon,13,0,30,17
1683718639068,MATH 20C,B01,188404,Harel; Guershon,5,0,30,25
1683718639068,MATH 20C,B02,188405,Harel; Guershon,18,0,30,12
1683718640102,MATH 20D,A01,188414,Hammock; Frances H,0,1,30,30
1683718640102,MATH 20D,A02,188415,Hammock; Frances H,0,1,30,30
1683718640102,MATH 20D,B01,188447,Hammock; Frances H,0,1,30,30
1683718640102,MATH 20D,B02,188486,Hammock; Frances H,2,0,30,28
1683718641131,MATH 20E,A01,188649,Staff,21,0,30,9
1683718641131,MATH 20E,A02,188650,Staff,20,0,30,10
1683718641131,MATH 20E,A03,188673,Staff,0,0,30,30
1683718642159,MATH 102,A01,188675,Staff,0,40,35,35
1683718643193,MATH 103B,A01,188681,Staff,3,0,35,32
1683718643193,MATH 103B,B01,188692,Staff,5,0,35,30
1683718644225,MATH 109,A01,188695,Salehi Golsefidy; Alireza,24,0,35,11
1683718644225,MATH 109,A02,188696,Salehi Golsefidy; Alireza,24,0,35,11
1683718645257,MATH 120A,A01,188698,Eggers; John Dietrich,7,0,35,28
1683718646285,MATH 142B,A01,188736,Ioana; Adrian,0,0,30,30
1683718646285,MATH 142B,A02,188741,Ioana; Adrian,0,1,30,30
1683718646285,MATH 142B,A03,188743,Ioana; Adrian,0,2,30,30
1683718647312,MATH 168A,A01,188790,Staff,0,11,35,35
1683718648337,MATH 170A,A01,188803,Nie; Jiawang,0,2,35,35
1683718648337,MATH 170A,A02,188811,Nie; Jiawang,0,1,35,35
1683718648337,MATH 170A,A03,188814,Nie; Jiawang,1,0,35,34
1683718648337,MATH 170A,A04,188815,Nie; Jiawang,5,0,35,30
1683718649363,MATH 193B,A01,188817,Staff,0,0,35,35
1683718649363,MATH 193B,A02,188818,Staff,6,0,35,29
1683718650395,MGT 4,A01,202857,Anderson; John Charles,59,0,80,21
1683718651427,MGT 12,A00,202858,Lindenberger; Wade Douglas,40,0,90,50
1683718652457,MGT 18,A00,202859,Staff,73,0,90,17
1683718653485,MGT 18GS,A00,202860,McKay; Michael J,13,0,28,15
1683718654511,MGT 45,A00,202861,Pecore; Joseph P.,8,0,90,82
1683718655543,MGT 100,A00,202863,Yavorsky; Daniel Ryan,27,0,90,63
1683718656574,MGT 103,A00,202864,Ehrich; Kristine R,0,19,90,90
1683718657605,MGT 112,A00,202865,Ehrich; Kristine R,15,0,90,75
1683718658633,MGT 121A,A00,202868,Staff,70,0,90,20
1683718659660,MGT 131B,A00,202869,Anderson; John Charles,58,0,90,32
1683718660687,MGT 136,A00,202871,Lindenberger; Wade Douglas,83,0,90,7
1683718661715,MGT 164,A00,202873,Staff,0,67,90,91
1683718662746,MGT 164GS,A00,202874,McKay; Mary A,13,0,28,15
1683718663772,MGT 180,A00,202875,Staff,0,51,90,91
1683718664801,MMW 11R,A01,205019,Herbst; Matthew,0,0,30,30
1683718664801,MMW 11R,A02,205026,Herbst; Matthew,29,0,30,1
1683718665829,MMW 15,A01,193512,Chang; Edmond Yi-Teh,0,8,28,28
1683718665829,MMW 15,A02,193513,Chang; Edmond Yi-Teh,0,5,28,28
1683718665829,MMW 15,A03,193514,Chang; Edmond Yi-Teh,0,5,28,28
1683718665829,MMW 15,A04,193515,Chang; Edmond Yi-Teh,0,5,28,28
1683718665829,MMW 15,A05,193516,Chang; Edmond Yi-Teh,0,5,28,28
1683718665829,MMW 15,A06,193517,Chang; Edmond Yi-Teh,0,6,28,28
1683718665829,MMW 15,B01,193519,Chang; Edmond Yi-Teh,0,5,28,28
1683718665829,MMW 15,B02,193520,Chang; Edmond Yi-Teh,0,5,28,28
1683718665829,MMW 15,B03,193521,Chang; Edmond Yi-Teh,0,5,28,28
1683718665829,MMW 15,B04,193522,Chang; Edmond Yi-Teh,0,6,28,28
1683718665829,MMW 15,B05,193523,Chang; Edmond Yi-Teh,0,5,28,28
1683718665829,MMW 15,B06,193524,Chang; Edmond Yi-Teh,0,5,28,28
1683718666857,MMW 122,A01,193526,Rahimi; Babak,0,16,28,28
1683718666857,MMW 122,A02,193527,Rahimi; Babak,0,15,28,28
1683718666857,MMW 122,A03,193528,Rahimi; Babak,0,0,0,0
1683718666857,MMW 122,A04,193529,Rahimi; Babak,0,0,0,0
1683718667887,MUS 1A,A01,186663,Staff,0,18,35,35
1683718668915,MUS 4,A01,186715,Staff,0,12,35,35
1683718669947,MUS 5R,A01,186796,Dubnov; Shlomo,0,17,35,35
1683718670973,MUS 6,A01,186798,Staff,0,4,25,25
1683718672001,MUS 7,A01,186830,Staff,11,0,35,24
1683718673033,MUS 8,A01,186930,Staff,0,27,35,35
1683718674060,MUS 15,A01,186932,Staff,0,15,35,35
1683718674060,MUS 15,B01,186934,Staff,0,16,35,35
1683718675091,MUS 80,A00,186935,Staff,0,0,20,20
1683718675091,MUS 80,B00,186936,Staff,24,0,25,1
1683718676119,NANO 11,A00,204702,Lipomi; Darren John,0,0,0,0
1683718677147,NANO 15,A01,204709,Yang; Kesong,0,1,0,0
1683718678174,NANO 114,A00,202069,Jahed Motlagh; Zeinab,2,0,10,8
1683718679203,PHIL 1,A00,186955,Grush; Rick Scott,31,0,40,9
1683718680230,PHIL 10,A01,186973,Grush; Rick Scott,27,0,35,8
1683718680230,PHIL 10,A02,186974,Grush; Rick Scott,33,0,35,2
1683718681254,PHIL 13,A01,186976,Staff,1,0,35,34
1683718681254,PHIL 13,A02,186977,Staff,16,0,35,19
1683718682281,PHIL 14,A01,186979,Staff,30,0,35,5
1683718682281,PHIL 14,A02,186986,Staff,32,0,35,3
1683718683309,PHIL 28,A01,186988,Staff,16,0,30,14
1683718683309,PHIL 28,A02,186989,Staff,0,0,30,30
1683718683309,PHIL 28,A03,186990,Staff,10,0,30,20
1683718683309,PHIL 28,A04,186991,Staff,26,0,30,4
1683718684337,PHIL 120,A00,186997,Staff,23,0,40,17
1683718685366,PHIL 137,A00,187003,Staff,8,0,40,32
1683718686393,PHIL 150,A00,187015,Staff,47,0,70,23
1683718687423,PHIL 167,A00,187021,Lamey; Andy M.,34,0,40,6
1683718688451,PHIL 174,A01,202226,Staff,17,0,20,3
1683718688451,PHIL 174,A02,202235,Staff,20,0,20,0
1683718689475,PHIL 191A,A00,258918,Staff,0,0,1,1
1683718690507,PHYS 1A,A00,187028,Staff,26,0,60,34
1683718691535,PHYS 1AL,001,187036,Staff,3,0,30,27
1683718691535,PHYS 1AL,002,187049,Staff,18,0,30,12
1683718692565,PHYS 1B,A00,187058,Staff,21,0,60,39
1683718693596,PHYS 1BL,001,187064,Staff,0,1,30,30
1683718693596,PHYS 1BL,002,187070,Staff,4,0,30,26
1683718694623,PHYS 1C,A00,187082,Staff,30,0,120,90
1683718695653,PHYS 1CL,001,187088,Staff,0,9,30,30
1683718695653,PHYS 1CL,002,187089,Staff,0,1,30,30
1683718695653,PHYS 1CL,009,262693,Staff,9,0,30,21
1683718696758,PHYS 2B,A01,187097,Staff,55,0,115,60
1683718697788,PHYS 2C,A01,187099,Staff,63,0,115,52
1683718698821,PHYS 2CL,A01,187101,Staff,5,0,28,23
1683718698821,PHYS 2CL,A02,187102,Staff,15,0,28,13
1683718699849,PHYS 2D,A01,187123,Shotwell; Brian,95,0,115,20
1683718700883,PHYS 4B,A01,187133,Grinstein; Benjamin,35,0,50,15
1683718701909,POLI 10,A00,188819,Staff,0,4,50,50
1683718702936,POLI 11,A00,188827,Staff,43,0,50,7
1683718703963,POLI 13R,A00,188828,Staff,0,2,20,20
1683718705005,POLI 27,A01,188830,Elgin; Samuel Zincke,0,2,70,70
1683718706039,POLI 30,A00,188832,Desposato; Scott,30,0,50,20
1683718707071,POLI 102F,A00,188834,Staff,1,0,40,39
1683718708096,POLI 104A,A00,188852,Staff,12,0,30,18
1683718709124,POLI 104I,A00,188853,Staff,0,8,20,20
1683718710152,POLI 110B,A00,188854,Wiens; David,6,0,20,14
1683718711179,POLI 112A,A00,188855,Wiens; David,3,0,30,27
1683718712211,POLI 117R,A00,188856,Forman; Fonna,0,12,20,20
1683718713241,POLI 118,A00,188857,Ingham; Sean,8,0,20,12
1683718714269,POLI 120G,A00,188858,Staff,7,0,30,23
1683718715300,POLI 131CR,A00,188863,Hoston; Germaine,20,0,50,30
1683718716331,POLI 133,A00,188864,Nellis; Gareth Hb,44,0,50,6
1683718717362,POLI 134D,A00,188865,Desposato; Scott,27,0,30,3
1683718718388,POLI 142A,A00,188871,Gartzke; Erik,21,0,50,29
1683718719414,POLI 142K,A00,188874,Staff,38,0,50,12
1683718720440,POLI 143,A00,188940,Gartzke; Erik,15,0,30,15
1683718721469,POLI 153,A00,188943,Staff,1,0,20,19
1683718722497,POLI 160AA,A00,188944,Staff,10,0,40,30
1683718723528,POLI 170A,A00,188945,Staff,10,0,30,20
1683718725583,PSYC 1,A00,188952,Staff,36,0,90,54
1683718726614,PSYC 2,B00,188953,Staff,19,0,35,16
1683718727642,PSYC 6,A00,188970,Staff,47,0,60,13
1683718728672,PSYC 7,A00,188973,Staff,35,0,45,10
1683718729701,PSYC 60,A01,188980,Rickard; Timothy C.,42,0,60,18
1683718730733,PSYC 70,A01,189001,Steiner; Eric Tomas,22,0,45,23
1683718731766,PSYC 100,A00,189005,Lacefield; Katharine I,1,98,120,119
1683718732794,PSYC 102,A00,189008,Staff,6,0,30,24
1683718733822,PSYC 106,B00,189026,Gorman; Michael R.,27,0,60,33
1683718734853,PSYC 114,B01,189033,Winkielman; Piotr,0,31,30,30
1683718735881,PSYC 131,A00,189036,Anagnostaras; Stephan,0,44,60,60
1683718736909,PSYC 136,A00,189041,Lowe; Angela Beth,0,7,25,25
1683718737936,PSYC 137,A00,189057,Winkielman; Piotr,0,36,25,25
1683718738965,PSYC 144,A00,189107,Wixted; John T,0,11,50,50
1683718741019,PSYC 162,A00,189142,Staff,0,9,85,85
1683718742061,PSYC 172,A00,189144,Gorman; Michael R.,0,6,30,30
1683718744118,PSYC 179,A00,189146,Lacefield; Katharine I,0,88,120,120
1683718745145,PSYC 181,A00,189147,Anagnostaras; Stephan,0,45,90,90
1683718746173,PSYC 190R,A00,189148,Barner; David A.,0,23,80,80
1683718747198,PSYC 191,A00,189275,Rickard; Timothy C.,0,11,25,25
1683718748227,PSYC 193,A00,189276,Chapman; Eddie Nathaniel,0,1,0,4
1683718749256,PSYC 193L,A01,189281,Lowe; Angela Beth,8,0,20,12
1683718749256,PSYC 193L,B01,189285,Staff,28,0,35,7
1683718750282,RELI 149,A00,187137,Rahimi; Babak,6,0,40,34
1683718751315,SE 9,A01,187315,Staff,0,2,18,18
1683718752346,SE 101B,A00,187409,Staff,24,0,30,6
1683718753377,SE 110B,A00,187444,Staff,10,0,40,30
1683718754404,SE 130B,A00,187449,Staff,31,0,40,9
1683718755431,SE 150A,A00,187516,Staff,8,0,20,12
1683718756458,SE 154,A00,187528,Staff,29,0,50,21
1683718757485,SIO 3,A01,258171,Staff,35,0,40,5
1683718758512,SIO 10,A00,187144,Cook; Geoffrey W,0,6,75,75
1683718759542,SIO 45,A00,187152,Cook; Geoffrey W,1,7,100,99
1683718760573,SIO 109R,A00,194486,Staff,0,4,20,20
1683718762626,SIO 187,A01,187233,Kacev; David,12,0,40,28
1683718763653,SOCI 1,A01,258656,Thorpe; Charles Robert,28,0,30,2
1683718763653,SOCI 1,A02,258658,Thorpe; Charles Robert,30,0,30,0
1683718763653,SOCI 1,A03,258661,Thorpe; Charles Robert,25,0,25,0
1683718763653,SOCI 1,A04,258666,Thorpe; Charles Robert,22,0,25,3
1683718763653,SOCI 1,A05,258897,Thorpe; Charles Robert,22,0,25,3
1683718763653,SOCI 1,A06,258898,Thorpe; Charles Robert,25,0,25,0
1683718764681,SOCI 30,A01,258903,Pardo Guerra; Juan Pablo,14,0,30,16
1683718765708,SOCI 102,A00,258904,Staff,9,0,25,16
1683718766735,SOCI 106,A00,258905,Staff,19,0,25,6
1683718767762,SOCI 111,A00,258907,Ribas Norris; Janet Vanesa,26,0,30,4
1683718768788,SOCI 121R,A00,258908,Pardo Guerra; Juan Pablo,7,0,30,23
1683718769815,SOCI 126,A01,203330,Staff,14,0,20,6
1683718770848,SOCI 131,A00,258909,Thorpe; Charles Robert,30,0,60,30
1683718771885,SOCI 135,A00,258910,Payne; Christine Anna,0,13,30,30
1683718772915,SOCI 157,A00,258911,Staff,10,0,30,20
1683718773941,SOCI 184,A00,258912,Staff,25,0,30,5
1683718774973,SOCI 188D,A00,258913,Staff,22,0,30,8
1683718776001,SYN 2,001,187529,Staff,9,0,16,7
1683718776001,SYN 2,002,201452,Staff,0,20,16,16
1683718776001,SYN 2,003,201469,Staff,1,0,16,15
1683718777034,SYN 100,A01,187531,Staff,0,9,20,20
1683718777034,SYN 100,B01,201491,Staff,0,10,20,20
1683718778071,TDAC 1,A00,189286,Walsh; Kim C.,3,0,20,17
1683718778071,TDAC 1,B00,189287,Harting; Carla Kelso,10,0,20,10
1683718779100,TDAC 101,A00,189300,Walsh; Kim C.,16,0,20,4
1683718779100,TDAC 101,B00,189301,Harting; Carla Kelso,18,0,20,2
1683718780126,TDAC 102,A00,189304,Basso; Beatrice,14,0,20,6
1683718781154,TDAC 108,A00,189305,Staff,18,0,20,2
1683718782184,TDDE 131,A00,189310,Staff,19,0,20,1
1683718782184,TDDE 131,B00,189314,Staff,19,0,20,1
1683718782184,TDDE 131,C00,189315,Staff,48,0,50,2
1683718782184,TDDE 131,D00,189316,Staff,14,0,15,1
1683718782184,TDDE 131,E00,204841,Staff,20,0,20,0
1683718783213,TDGE 10,A00,189289,Staff,26,0,50,24
1683718783213,TDGE 10,B00,189290,Havis; Allan,0,1,50,50
1683718784241,TDGE 11,A00,189291,Fulton; Julia,0,4,50,50
1683718784241,TDGE 11,B00,189292,Staff,20,0,25,5
1683718784241,TDGE 11,C00,260270,Staff,0,0,0,0
1683718785271,TDGE 25,A00,189294,Staff,1,0,20,19
1683718786299,TDGE 124,A00,189318,Fulton; Julia,0,7,50,50
1683718787325,TDGE 125,A00,189319,Staff,13,0,25,12
1683718787325,TDGE 125,B00,189320,Staff,23,0,25,2
1683718788357,TDGE 127,A00,189322,Havis; Allan,1,0,50,49
1683718789381,TDHT 101,A00,189323,Staff,18,0,25,7
1683718789381,TDHT 101,B00,189324,Staff,25,0,25,0
1683718790409,TDHT 102,A00,189325,Staff,49,0,50,1
1683718791442,TDMV 1,A00,189295,Arcidiacono; Kristin,20,0,30,10
1683718791442,TDMV 1,B00,189296,Caligagan; Maria T.,23,0,30,7
1683718792475,TDMV 2,A00,189297,Sammartano; Tonnie,27,0,30,3
1683718792475,TDMV 2,B00,189299,Arcidiacono; Kristin,23,0,30,7
1683718793504,TDMV 3,A00,204998,Rincon; Alicia,22,0,30,8
1683718794531,TDMV 120,A00,189458,Sammartano; Tonnie,28,0,30,2
1683718795565,TDMV 138,A00,189541,Jun; Grace Shin Hae,20,0,40,20
1683718796597,TDMV 142,A00,189717,Caligagan; Tony,25,0,30,5
1683718796597,TDMV 142,B00,189718,Caligagan; Maria T.,25,0,30,5
1683718797628,TMC 2,A01,187533,Staff,25,0,25,0
1683718797628,TMC 2,A02,187534,Staff,25,0,25,0
1683718798655,USP 1,A01,187536,Kwak; Nancy,0,16,25,25
1683718799686,USP 5,A01,187538,Staff,8,0,25,17
1683718800773,USP 101,A00,199253,Staff,0,4,0,0
1683718801801,USP 124,A00,187562,Boomhower; Matthew Charles,0,0,30,30
1683718802827,USP 138,A00,187582,Staff,19,0,25,6
1683718803858,USP 152,A01,187597,Staff,3,0,25,22
1683718804890,USP 153,A00,187598,Staff,18,0,25,7
1683718805916,USP 168,A00,187607,Kwak; Nancy,2,0,5,3
1683718806941,USP 173,A00,187619,Staff,4,0,25,21
1683718807967,USP 181,A00,187638,Staff,0,4,25,25
1683718808996,VIS 103,A00,187650,Cruz; Edwin Teddy,17,0,75,58
1683718810026,VIS 110D,A00,187669,Staff,13,0,22,9
1683718811053,VIS 127C,A00,187720,Shen; Kuiyi,67,0,146,79
1683718812080,VIS 149,A00,187731,Yoldas; Pinar,0,12,22,22
1683718813113,VIS 151,A01,188091,Staff,22,0,34,12
1683718813113,VIS 151,A02,188092,Staff,11,0,34,23
1683718814141,VIS 160B,A00,188093,Stalbaum; Brett,0,1,10,10
1683718816203,WCWP 10B,A00,201720,Staff,0,0,5,5
1683718816203,WCWP 10B,B00,201722,Staff,0,0,6,6
1683718817236,WCWP 100,A00,201725,Gagnon; Jeffrey C,0,0,2,2
1683718817236,WCWP 100,B00,201727,Staff,0,4,15,15
1683718820469,ANBI 133,A00,258401,Wilder; Linnea Lorene,34,0,40,6
1683718821494,ANBI 140,A00,258395,Hrvoj Mihic; Branka,18,0,25,7
1683718822522,ANSC 120,A00,258402,Bialecki; Jon Anthony,26,0,40,14
1683718823553,ANSC 144,A00,258400,Staff,12,0,40,28
1683718825609,ANSC 166,A00,258396,Parish; Steven Martin,156,0,175,19
1683718826635,ANSC 180,A00,193533,Staff,8,0,20,12
1683718827663,ANSC 188,A00,258397,Jassal; Aftab,34,0,40,6
1683718828689,ANTH 3,A01,258316,Staff,23,0,30,7
1683718829717,ANTH 5,A00,258394,Semendeferi; Ekaterini,16,0,20,4
1683718830746,ANTH 21,A01,258331,Staff,4,0,40,36
1683718831775,ANTH 103,A00,258398,Varma; Saiba,15,0,25,10
1683718832806,AWP 10,001,202034,Staff,0,0,0,0
1683718832806,AWP 10,002,202035,Staff,0,0,0,0
1683718832806,AWP 10,003,202036,Staff,0,0,0,0
1683718832806,AWP 10,004,202037,Staff,0,0,0,0
1683718832806,AWP 10,005,202038,Staff,0,0,0,0
1683718832806,AWP 10,006,202039,Staff,0,0,0,0
1683718832806,AWP 10,007,202040,Staff,0,0,0,0
1683718832806,AWP 10,008,202041,Staff,0,0,0,0
1683718832806,AWP 10,009,202042,Staff,0,0,0,0
1683718832806,AWP 10,010,202043,Staff,0,0,0,0
1683718832806,AWP 10,011,202044,Staff,0,0,0,0
1683718832806,AWP 10,012,202045,Staff,0,0,0,0
1683718832806,AWP 10,013,202046,Staff,0,0,0,0
1683718832806,AWP 10,014,202047,Staff,0,0,0,0
1683718832806,AWP 10,015,202048,Staff,0,0,0,0
1683718832806,AWP 10,016,202049,Staff,0,0,0,0
1683718832806,AWP 10,017,202050,Staff,0,0,0,0
1683718832806,AWP 10,018,202051,Staff,0,0,0,0
1683718832806,AWP 10,019,202052,Staff,0,0,0,0
1683718832806,AWP 10,020,202053,Staff,0,0,0,0
1683718832806,AWP 10,021,202054,Staff,0,0,0,0
1683718832806,AWP 10,022,202055,Staff,0,0,0,0
1683718832806,AWP 10,023,202056,Staff,0,0,0,0
1683718832806,AWP 10,024,202057,Staff,0,0,0,0
1683718832806,AWP 10,025,202058,Staff,0,0,0,0
1683718832806,AWP 10,026,202059,Staff,0,0,0,0
1683718833833,AWP 102,001,202032,Staff,0,0,0,0
1683718833833,AWP 102,002,202033,Staff,0,0,0,0
1683718834865,BENG 100,A01,254234,Taylor Amos; Alyssa C,31,0,40,9
1683718835891,BENG 196,001,270013,Engler; Adam J.,9999,0,9999,0
1683718836922,BICD 100R,A01,202018,Smith; Laurie,0,7,32,32
1683718836922,BICD 100R,A02,202019,Smith; Laurie,0,3,32,32
1683718836922,BICD 100R,A03,202020,Smith; Laurie,0,1,32,32
1683718836922,BICD 100R,A04,202021,Smith; Laurie,6,0,32,26
1683718836922,BICD 100R,A05,202022,Smith; Laurie,10,0,32,22
1683718837957,BICD 136,A01,193242,Gustafson-Brown; Cindy,0,2,32,32
1683718837957,BICD 136,A02,193244,Gustafson-Brown; Cindy,13,0,32,19
1683718838996,BIEB 102,A01,193249,Butler; Shannon Rhey,0,0,32,32
1683718838996,BIEB 102,A02,193251,Butler; Shannon Rhey,0,0,32,32
1683718838996,BIEB 102,A03,193253,Butler; Shannon Rhey,0,0,32,32
1683718838996,BIEB 102,A04,193255,Butler; Shannon Rhey,13,0,32,19
1683718838996,BIEB 102,A05,193265,Butler; Shannon Rhey,25,0,32,7
1683718838996,BIEB 102,A06,193269,Butler; Shannon Rhey,12,0,32,20
1683718841049,BIEB 150,A01,193274,Staff,0,0,32,32
1683718841049,BIEB 150,A02,193285,Staff,24,0,32,8
1683718842081,BIEB 194,A00,193286,Kurle; Carolyn M.,19,0,32,13
1683718843120,BILD 1,A01,192291,Staff,15,0,32,17
1683718843120,BILD 1,A02,192292,Staff,30,0,32,2
1683718843120,BILD 1,B01,192520,Reuther; Keefe,0,1,0,0
1683718843120,BILD 1,B02,192532,Reuther; Keefe,0,1,0,0
1683718844155,BILD 3,A01,192556,Butler; Shannon Rhey,0,0,32,32
1683718844155,BILD 3,A02,192581,Butler; Shannon Rhey,0,1,32,32
1683718844155,BILD 3,A03,192611,Butler; Shannon Rhey,19,0,32,13
1683718844155,BILD 3,A04,192612,Butler; Shannon Rhey,23,0,32,9
1683718844155,BILD 3,A05,192613,Butler; Shannon Rhey,26,0,32,6
1683718844155,BILD 3,A06,192679,Butler; Shannon Rhey,27,0,32,5
1683718844155,BILD 3,A07,192682,Butler; Shannon Rhey,20,0,32,12
1683718845192,BILD 4,A01,192836,Reuther; Keefe,1,0,24,23
1683718845192,BILD 4,A02,193044,Reuther; Keefe,4,0,24,20
1683718846222,BILD 10,A01,193142,Gustafson-Brown; Cindy,29,0,32,3
1683718846222,BILD 10,A02,193149,Gustafson-Brown; Cindy,31,0,32,1
1683718847252,BIMM 100,A01,193301,Staff,0,6,32,32
1683718847252,BIMM 100,A02,193312,Staff,0,7,32,32
1683718847252,BIMM 100,A03,193323,Staff,0,10,32,32
1683718848285,BIMM 101,A01,193329,McDonnell; Lisa Marie,0,3,24,24
1683718848285,BIMM 101,A02,193339,McDonnell; Lisa Marie,0,3,24,24
1683718848285,BIMM 101,B01,193354,McDonnell; Lisa Marie,0,4,24,24
1683718848285,BIMM 101,B02,193357,McDonnell; Lisa Marie,0,3,24,24
1683718849317,BIMM 110,A01,193377,Tat; John,0,11,32,32
1683718849317,BIMM 110,A02,193378,Tat; John,0,11,32,32
1683718850348,BIMM 120,A01,206116,Staff,0,0,32,32
1683718850348,BIMM 120,A02,206117,Staff,7,0,32,25
1683718850348,BIMM 120,A03,206121,Staff,21,0,32,11
1683718851378,BIPN 100,A01,193393,Park; Ji Young,0,15,32,32
1683718851378,BIPN 100,A02,193402,Park; Ji Young,0,14,32,32
1683718851378,BIPN 100,A03,193413,Park; Ji Young,0,14,32,32
1683718851378,BIPN 100,A04,193414,Park; Ji Young,0,13,32,32
1683718852406,BIPN 102,A01,193429,Staff,0,0,32,32
1683718852406,BIPN 102,A02,193438,Staff,18,0,32,14
1683718853439,BIPN 106,A01,193450,Reyes Gonzalez; Catalina,0,2,40,40
1683718854473,BIPN 134,A01,193465,Cooke; James Edward,0,0,32,32
1683718854473,BIPN 134,A02,193474,Cooke; James Edward,25,0,32,7
1683718854473,BIPN 134,A03,193485,Cooke; James Edward,29,0,32,3
1683718854473,BIPN 134,A04,193486,Cooke; James Edward,20,0,32,12
1683718854473,BIPN 134,A05,193491,Cooke; James Edward,31,0,32,1
1683718854473,BIPN 134,A06,193501,Cooke; James Edward,30,0,32,2
1683718854473,BIPN 134,A07,193510,Cooke; James Edward,29,0,32,3
1683718856527,BISP 194,A00,222522,Staff,14,0,32,18
1683718857559,CAT 124,A01,202407,Staff,19,0,25,6
1683718858586,CAT 125,A00,202408,Marchisotto; Jennifer Anne,2,0,20,18
1683718859617,CAT 125R,A00,202409,Smith; Lauryn Alissa,0,11,20,20
1683718859617,CAT 125R,B00,202410,Morales; Celeste Georgianna,0,11,20,20
1683718859617,CAT 125R,C00,202411,Irwin; Matthew Joseph,0,12,20,20
1683718860644,CENG 15,A01,204712,Yang; Kesong,0,1,0,0
1683718861673,CENG 114,A00,202070,Jahed Motlagh; Zeinab,5,0,20,15
1683718862705,CGS 105,A00,185477,Wesling; Megan E.,24,0,40,16
1683718863732,CGS 106,A00,185494,Staff,11,0,22,11
1683718864759,CGS 108,A00,185495,Staff,14,0,20,6
1683718865786,CGS 114,A00,185496,Staff,13,0,18,5
1683718866812,CGS 119,A00,185501,Staff,15,0,20,5
1683718867839,CGS 120,A00,185511,Staff,11,0,20,9
1683718868879,CHEM 4,A01,184675,Bussey; Thomas J,97,0,100,3
1683718869907,CHEM 6A,A01,184677,Staff,32,0,60,28
1683718870933,CHEM 6B,A01,184679,Staff,63,0,100,37
1683718871960,CHEM 6C,A01,184681,Bussey; Thomas J,0,0,50,50
1683718871960,CHEM 6C,A02,184682,Bussey; Thomas J,32,0,50,18
1683718872989,CHEM 40A,A01,184684,Albizati; Kim F.,33,0,100,67
1683718874015,CHEM 40B,A01,184686,Albizati; Kim F.,0,22,100,100
1683718875041,CHEM 41B,A01,184690,Staff,51,0,100,49
1683718876070,COGS 3,A01,184715,Boyle; Mary E. T.,0,27,40,40
1683718877102,COGS 14B,A01,185172,Staff,0,14,38,38
1683718878130,COGS 18,A01,184736,Staff,14,0,80,66
1683718879157,COGS 100,A01,184932,Staff,0,8,73,73
1683718880188,COGS 101A,A01,184935,Staff,0,40,30,30
1683718881214,COGS 101B,A01,184944,Staff,0,2,30,30
1683718882246,COGS 101C,A01,184946,Staff,0,10,30,30
1683718883279,COGS 102A,A01,184951,Johnson; Christine M.,1,0,40,39
1683718884304,COGS 107B,A01,184953,Mooshagian; Eric Frederick,0,52,40,40
1683718885331,COGS 118B,A01,184959,Gupta; Anjum,0,50,40,40
1683718886361,COGS 153,A00,184961,Staff,1,16,30,29
1683718887390,COGS 177,A00,184962,Staff,0,20,30,30
1683718888418,COGS 187A,A01,184969,Boyle; Mary E. T.,0,19,40,40
1683718889446,COMM 10,A01,185174,Staff,0,5,25,25
1683718889446,COMM 10,A02,185189,Staff,0,2,25,25
1683718889446,COMM 10,A03,269821,Staff,0,1,0,0
1683718890473,COMM 100B,A02,185476,Staff,10,0,25,15
1683718890473,COMM 100B,A03,277340,Staff,25,0,25,0
1683718891504,COMM 100C,A01,185314,Staff,2,0,25,23
1683718891504,COMM 100C,A02,185327,Staff,17,0,25,8
1683718892530,COMM 110M,A00,185349,Staff,0,0,40,40
1683718893557,COMM 113T,A00,185352,Staff,25,0,40,15
1683718894583,COMM 114I,A00,185353,Staff,31,0,40,9
1683718895611,COMM 131,A00,185354,Staff,17,0,30,13
1683718896638,CSE 8A,A50,185358,Cao; Yingjun,0,46,10,10
1683718897667,CSE 8B,A01,185362,Staff,0,48,50,50
1683718898698,CSE 11,A01,185416,Cao; Yingjun,0,91,10,10
1683718899727,CSE 20,A01,185445,Briones; Jor-el Thomas Caparas,3,0,25,22
1683718900756,CSE 21,A01,185447,Staff,9,0,50,41
1683718901787,CSE 101,A01,185451,Staff,0,13,50,50
1683718901787,CSE 101,B01,185453,Jones; Miles E,0,15,50,50
1683718903846,CSE 141,A01,185458,Eldon; John,16,0,100,84
1683718904930,CSE 141L,A01,185461,Eldon; John,8,0,100,92
1683718905962,CSE 142,A01,185463,Staff,34,0,60,26
1683718905962,CSE 142,B01,201355,Staff,0,7,60,60
1683718906991,CSE 142L,A01,185470,Staff,34,0,60,26
1683718906991,CSE 142L,B01,201417,Staff,0,6,60,60
1683718908106,CSE 190,A00,201433,Staff,32,0,49,17
1683718909135,DOC 1,A01,259136,Strom; Megan C.,7,0,15,8
1683718909135,DOC 1,A02,259137,Strom; Megan C.,15,0,15,0
1683718909135,DOC 1,A03,259138,Strom; Megan C.,14,0,15,1
1683718909135,DOC 1,A04,259139,Strom; Megan C.,13,0,15,2
1683718910166,DOC 100D,A00,259140,Pass; Natalye Joann,14,0,25,11
1683718911198,DSGN 1,A01,184749,Rill; Bryan,0,26,30,30
1683718912227,DSGN 100,A01,185168,Staff,0,2,25,25
1683718913255,ECE 5,A01,185626,Morris; Karcher William,0,12,0,0
1683718914286,ECE 101,A01,185628,Staff,14,0,70,56
1683718915313,ECE 107,A01,185635,Baghdadchi; Saharnaz,0,0,20,20
1683718915313,ECE 107,A02,185638,Baghdadchi; Saharnaz,1,0,20,19
1683718916341,ECE 148,A01,185647,Silberman; Jack,0,0,16,16
1683718917366,ECON 1,A01,185537,Crane; Meredith Helen,54,0,70,16
1683718918393,ECON 3,A01,185549,Crane; Meredith Helen,30,0,70,40
1683718919421,ECON 4,A01,203354,Anderson; John Charles,0,5,10,10
1683718920451,ECON 100A,A01,185574,Staff,0,5,40,40
1683718921477,ECON 100B,A01,185576,Staff,0,12,50,50
1683718922505,ECON 100C,A01,185589,Newhouse; Herbert S,30,0,70,40
1683718923533,ECON 105,A00,185608,Vespa; Emanuel Ignacio,19,0,35,16
1683718924566,ECON 109,A01,185610,Shishkin; Denis,9,0,35,26
1683718925600,ECON 110A,A01,185612,Staff,8,0,40,32
1683718926629,ECON 120A,A01,185615,Staff,19,0,40,21
1683718927656,ECON 120C,A01,185617,Sun; Yixiao,0,21,70,70
1683718928685,ECON 144,A00,203346,Squires; Dale E,2,0,35,33
1683718929717,ECON 171,A01,203349,Newhouse; Herbert S,0,1,35,35
1683718930745,ECON 173A,A01,185621,Toda; Alexis Akira,21,0,35,14
1683718931776,EDS 25,A01,202413,Staff,0,1,0,0
1683718931776,EDS 25,A02,202414,Staff,0,1,0,0
1683718931776,EDS 25,A03,202415,Staff,0,0,0,0
1683718931776,EDS 25,A04,202416,Staff,0,1,0,0
1683718931776,EDS 25,A05,202439,Staff,0,0,0,0
1683718931776,EDS 25,A06,202440,Staff,0,0,0,0
1683718931776,EDS 25,B01,202631,Staff,0,0,0,0
1683718931776,EDS 25,B02,202632,Staff,0,0,0,0
1683718931776,EDS 25,B03,202639,Staff,0,0,0,0
1683718931776,EDS 25,B04,202640,Staff,0,0,0,0
1683718931776,EDS 25,B05,202643,Staff,0,0,0,0
1683718931776,EDS 25,B06,202644,Staff,0,0,0,0
1683718932810,EDS 38,A01,202659,Black; Alison Michelle,25,0,25,0
1683718933837,EDS 115,A00,202652,Staff,18,0,30,12
1683718934864,EDS 125,A00,202649,Staff,13,0,30,17
1683718935891,EDS 126,A01,203332,Staff,30,0,30,0
1683718936917,EDS 139,A00,202838,Staff,16,0,25,9
1683718937947,EDS 146,A01,202655,Staff,14,0,25,11
1683718938977,ENG 15,A00,185667,Staff,0,1,0,0
1683718938977,ENG 15,B00,185672,Staff,0,0,0,0
1683718938977,ENG 15,C00,185675,Staff,0,0,0,0
1683718938977,ENG 15,D00,185682,Staff,0,0,0,0
1683718938977,ENG 15,E00,185684,Staff,0,0,0,0
1683718940007,ETHN 103,A00,185710,Staff,0,8,35,35
1683718941036,ETHN 103A,A00,199228,Man; Simeon S,0,0,9,9
1683718942065,ETHN 109,A00,185711,Staff,15,0,35,20
1683718943096,ETHN 142,A00,185726,Staff,0,4,30,30
1683718944123,ETHN 163J,A00,199229,Man; Simeon S,5,0,8,3
1683718945150,ETHN 168,A00,185727,Staff,7,0,10,3
1683718946177,ETHN 182,A00,185728,Staff,0,0,35,35
1683718947206,ETHN 183,A00,185737,Staff,10,0,18,8
1683718948233,GLBH 111,A01,209361,Burgos; Jose L.,0,0,0,0
1683718950295,HIEU 104,A00,185792,Staff,14,0,20,6
1683718951323,HIEU 115,A00,185800,Staff,0,0,20,20
1683718952350,HIEU 128,A00,185801,Staff,0,9,20,20
1683718953380,HIEU 147,A00,185802,Staff,15,0,20,5
1683718954407,HIEU 154,A00,185823,Staff,11,0,20,9
1683718955435,HILA 102,A00,185826,Staff,14,0,20,6
1683718956462,HILD 2C,A01,185778,Staff,0,13,20,20
1683718957493,HILD 7B,A01,185780,Kwak; Nancy,0,17,32,32
1683718957493,HILD 7B,A02,185781,Kwak; Nancy,0,18,32,32
1683718958523,HILD 30,A01,185791,Staff,12,0,20,8
1683718959549,HISC 119,A00,185830,Golan; Tal,0,10,20,20
1683718960576,HITO 156GS,A00,185831,Patterson; Patrick H.,0,0,0,23
1683718961603,HIUS 103,A00,185832,Man; Simeon S,0,4,20,20
1683718962636,HIUS 117,A00,185836,Kwak; Nancy,2,0,20,18
1683718963665,HIUS 125,A00,185840,Man; Simeon S,0,2,23,23
1683718964692,HIUS 149,A00,185845,Staff,1,0,20,19
1683718965721,HUM 3,A01,185882,Zavodny; Tatiana Sophia,0,8,50,50
1683718965721,HUM 3,B01,185899,Caldwell; Michael Alan,0,18,50,50
1683718966751,HUM 3GS,A00,185900,Patterson; Patrick H.,0,0,0,23
1683718967781,HUM 4,A01,185938,Zroka; Amy Liane,28,0,50,22
1683718967781,HUM 4,B01,185956,Watkins; Eric,0,6,50,50
1683718967781,HUM 4,B02,202209,Watkins; Eric,0,6,50,50
1683718967781,HUM 4,B03,202210,Watkins; Eric,0,5,50,50
1683718968807,HUM 5,A01,185958,West; Geoffrey Scott,0,0,50,50
1683718968807,HUM 5,A02,202215,West; Geoffrey Scott,0,1,50,50
1683718969839,INTL 190,A00,185959,Gagnon; Jeffrey C,0,0,0,9
1683718969839,INTL 190,B00,185960,Lettieri; Michael Joseph,0,0,0,2
1683718970865,JAPN 180,A00,254509,Staff,5,0,30,25
1683718971893,LATI 10,A01,202853,Kennemore; Amy Michelle,4,0,35,31
1683718971893,LATI 10,A02,202854,Kennemore; Amy Michelle,3,0,35,32
1683718971893,LATI 10,A03,270054,Kennemore; Amy Michelle,30,0,30,0
1683718972919,LATI 180,A00,202855,Kennemore; Amy Michelle,11,0,20,9
1683718973946,LAWS 101,A00,201767,Golan; Tal,0,7,40,40
1683718974975,LIFR 1C,A00,185961,Staff,6,0,20,14
1683718976008,LIFR 1CX,A00,185962,Staff,7,0,20,13
1683718977035,LIFR 1D,A00,185963,Staff,7,0,20,13
1683718978069,LIFR 1DX,A00,185964,Staff,7,0,20,13
1683718979094,LIGN 101,A01,186039,Staff,43,0,50,7
1683718980120,LIGN 165,A00,186040,Staff,14,0,50,36
1683718981146,LTCS 108,A00,186041,Staff,5,0,10,5
1683718982173,LTCS 119,A00,186042,Staff,15,0,20,5
1683718983216,LTCS 130,A00,186043,Wesling; Megan E.,15,0,25,10
1683718985270,LTEA 138,A00,186119,Staff,14,0,40,26
1683718986297,LTEN 124,A00,186148,Staff,5,0,25,20
1683718987324,LTEN 178,A00,186149,Staff,6,0,15,9
1683718988355,LTEN 181,A00,186150,Blanco; John D,34,0,40,6
1683718989382,LTWL 120,A00,186160,Staff,19,0,25,6
1683718990410,LTWL 165,A00,186161,Staff,22,0,25,3
1683718991438,LTWR 100,A00,186162,Staff,0,5,15,15
1683718992468,LTWR 102,A00,186163,Doller; Ben,5,0,15,10
1683718993495,MAE 8,A01,186412,Staff,0,1,0,0
1683718994523,MAE 30B,A00,186445,Bahadori; Mohammad Yousef,81,0,100,19
1683718995550,MAE 40,A00,186592,Bewley; Thomas R,10,0,50,40
1683718996577,MAE 101B,A00,186593,Bahadori; Mohammad Yousef,80,0,100,20
1683718997602,MAE 105,A00,186594,Bandaru; Prabhakar,10,0,50,40
1683718998629,MAE 107,A00,186599,Pham; Hieu Tan,0,8,120,120
1683718999657,MAE 148,A01,186660,Silberman; Jack,3,0,16,13
1683719000685,MATH 10A,A01,188095,Staff,0,6,35,35
1683719001713,MATH 10B,A01,188097,Bowers; Adam R.,0,12,30,30
1683719001713,MATH 10B,A02,188099,Bowers; Adam R.,0,11,30,30
1683719001713,MATH 10B,B01,188104,Bowers; Adam R.,0,10,30,30
1683719001713,MATH 10B,B02,188106,Bowers; Adam R.,0,9,30,30
1683719002743,MATH 10C,A01,188111,Staff,0,20,30,30
1683719002743,MATH 10C,A02,188127,Staff,0,19,30,30
1683719002743,MATH 10C,A03,188131,Staff,0,19,30,30
1683719002743,MATH 10C,B01,188218,Staff,17,0,30,13
1683719002743,MATH 10C,B02,188244,Staff,13,0,30,17
1683719002743,MATH 10C,B03,188277,Staff,14,0,30,16
1683719003780,MATH 18,A01,188344,Bach; Quang Tran,18,0,30,12
1683719003780,MATH 18,A02,188345,Bach; Quang Tran,11,0,30,19
1683719003780,MATH 18,B01,188353,Bach; Quang Tran,11,0,30,19
1683719003780,MATH 18,B02,188354,Bach; Quang Tran,19,0,30,11
1683719004811,MATH 20A,A01,188374,Staff,11,0,35,24
1683719005840,MATH 20B,A01,188382,Ohm; Ko Woon,7,0,30,23
1683719005840,MATH 20B,A02,188383,Ohm; Ko Woon,22,0,30,8
1683719005840,MATH 20B,B01,188385,Ohm; Ko Woon,7,0,30,23
1683719005840,MATH 20B,B02,188392,Ohm; Ko Woon,22,0,30,8
1683719006867,MATH 20C,A01,188394,Harel; Guershon,10,0,30,20
1683719006867,MATH 20C,A02,188395,Harel; Guershon,13,0,30,17
1683719006867,MATH 20C,B01,188404,Harel; Guershon,5,0,30,25
1683719006867,MATH 20C,B02,188405,Harel; Guershon,18,0,30,12
1683719007895,MATH 20D,A01,188414,Hammock; Frances H,0,1,30,30
1683719007895,MATH 20D,A02,188415,Hammock; Frances H,0,1,30,30
1683719007895,MATH 20D,B01,188447,Hammock; Frances H,0,1,30,30
1683719007895,MATH 20D,B02,188486,Hammock; Frances H,2,0,30,28
1683719008982,MATH 20E,A01,188649,Staff,21,0,30,9
1683719008982,MATH 20E,A02,188650,Staff,20,0,30,10
1683719008982,MATH 20E,A03,188673,Staff,0,0,30,30
1683719010011,MATH 102,A01,188675,Staff,0,40,35,35
1683719011036,MATH 103B,A01,188681,Staff,3,0,35,32
1683719011036,MATH 103B,B01,188692,Staff,5,0,35,30
1683719012063,MATH 109,A01,188695,Salehi Golsefidy; Alireza,24,0,35,11
1683719012063,MATH 109,A02,188696,Salehi Golsefidy; Alireza,24,0,35,11
1683719013089,MATH 120A,A01,188698,Eggers; John Dietrich,7,0,35,28
1683719014116,MATH 142B,A01,188736,Ioana; Adrian,0,0,30,30
1683719014116,MATH 142B,A02,188741,Ioana; Adrian,0,1,30,30
1683719014116,MATH 142B,A03,188743,Ioana; Adrian,0,2,30,30
1683719015147,MATH 168A,A01,188790,Staff,0,11,35,35
1683719016176,MATH 170A,A01,188803,Nie; Jiawang,0,2,35,35
1683719016176,MATH 170A,A02,188811,Nie; Jiawang,0,1,35,35
1683719016176,MATH 170A,A03,188814,Nie; Jiawang,1,0,35,34
1683719016176,MATH 170A,A04,188815,Nie; Jiawang,5,0,35,30
1683719017204,MATH 193B,A01,188817,Staff,0,0,35,35
1683719017204,MATH 193B,A02,188818,Staff,6,0,35,29
1683719018230,MGT 4,A01,202857,Anderson; John Charles,59,0,80,21
1683719019257,MGT 12,A00,202858,Lindenberger; Wade Douglas,40,0,90,50
1683719020284,MGT 18,A00,202859,Staff,73,0,90,17
1683719021311,MGT 18GS,A00,202860,McKay; Michael J,13,0,28,15
1683719022338,MGT 45,A00,202861,Pecore; Joseph P.,8,0,90,82
1683719023364,MGT 100,A00,202863,Yavorsky; Daniel Ryan,27,0,90,63
1683719024390,MGT 103,A00,202864,Ehrich; Kristine R,0,19,90,90
1683719025418,MGT 112,A00,202865,Ehrich; Kristine R,15,0,90,75
1683719026450,MGT 121A,A00,202868,Staff,70,0,90,20
1683719027478,MGT 131B,A00,202869,Anderson; John Charles,58,0,90,32
1683719028507,MGT 136,A00,202871,Lindenberger; Wade Douglas,83,0,90,7
1683719029535,MGT 164,A00,202873,Staff,0,67,90,91
1683719030561,MGT 164GS,A00,202874,McKay; Mary A,13,0,28,15
1683719031589,MGT 180,A00,202875,Staff,0,51,90,91
1683719032616,MMW 11R,A01,205019,Herbst; Matthew,0,0,30,30
1683719032616,MMW 11R,A02,205026,Herbst; Matthew,29,0,30,1
1683719033643,MMW 15,A01,193512,Chang; Edmond Yi-Teh,0,8,28,28
1683719033643,MMW 15,A02,193513,Chang; Edmond Yi-Teh,0,5,28,28
1683719033643,MMW 15,A03,193514,Chang; Edmond Yi-Teh,0,5,28,28
1683719033643,MMW 15,A04,193515,Chang; Edmond Yi-Teh,0,5,28,28
1683719033643,MMW 15,A05,193516,Chang; Edmond Yi-Teh,0,5,28,28
1683719033643,MMW 15,A06,193517,Chang; Edmond Yi-Teh,0,6,28,28
1683719033643,MMW 15,B01,193519,Chang; Edmond Yi-Teh,0,5,28,28
1683719033643,MMW 15,B02,193520,Chang; Edmond Yi-Teh,0,5,28,28
1683719033643,MMW 15,B03,193521,Chang; Edmond Yi-Teh,0,5,28,28
1683719033643,MMW 15,B04,193522,Chang; Edmond Yi-Teh,0,6,28,28
1683719033643,MMW 15,B05,193523,Chang; Edmond Yi-Teh,0,5,28,28
1683719033643,MMW 15,B06,193524,Chang; Edmond Yi-Teh,0,5,28,28
1683719034670,MMW 122,A01,193526,Rahimi; Babak,0,16,28,28
1683719034670,MMW 122,A02,193527,Rahimi; Babak,0,15,28,28
1683719034670,MMW 122,A03,193528,Rahimi; Babak,0,0,0,0
1683719034670,MMW 122,A04,193529,Rahimi; Babak,0,0,0,0
1683719035697,MUS 1A,A01,186663,Staff,0,18,35,35
1683719036724,MUS 4,A01,186715,Staff,0,12,35,35
1683719037751,MUS 5R,A01,186796,Dubnov; Shlomo,0,17,35,35
1683719038782,MUS 6,A01,186798,Staff,0,4,25,25
1683719039810,MUS 7,A01,186830,Staff,11,0,35,24
1683719040839,MUS 8,A01,186930,Staff,0,27,35,35
1683719041871,MUS 15,A01,186932,Staff,0,15,35,35
1683719041871,MUS 15,B01,186934,Staff,0,16,35,35
1683719042901,MUS 80,A00,186935,Staff,0,0,20,20
1683719042901,MUS 80,B00,186936,Staff,24,0,25,1
1683719043935,NANO 11,A00,204702,Lipomi; Darren John,0,0,0,0
1683719044967,NANO 15,A01,204709,Yang; Kesong,0,1,0,0
1683719045994,NANO 114,A00,202069,Jahed Motlagh; Zeinab,2,0,10,8
1683719047019,PHIL 1,A00,186955,Grush; Rick Scott,31,0,40,9
1683719048052,PHIL 10,A01,186973,Grush; Rick Scott,27,0,35,8
1683719048052,PHIL 10,A02,186974,Grush; Rick Scott,33,0,35,2
1683719049079,PHIL 13,A01,186976,Staff,1,0,35,34
1683719049079,PHIL 13,A02,186977,Staff,16,0,35,19
1683719050105,PHIL 14,A01,186979,Staff,30,0,35,5
1683719050105,PHIL 14,A02,186986,Staff,32,0,35,3
1683719051136,PHIL 28,A01,186988,Staff,16,0,30,14
1683719051136,PHIL 28,A02,186989,Staff,0,0,30,30
1683719051136,PHIL 28,A03,186990,Staff,10,0,30,20
1683719051136,PHIL 28,A04,186991,Staff,26,0,30,4
1683719052164,PHIL 120,A00,186997,Staff,23,0,40,17
1683719053189,PHIL 137,A00,187003,Staff,8,0,40,32
1683719054217,PHIL 150,A00,187015,Staff,47,0,70,23
1683719055245,PHIL 167,A00,187021,Lamey; Andy M.,34,0,40,6
1683719056275,PHIL 174,A01,202226,Staff,17,0,20,3
1683719056275,PHIL 174,A02,202235,Staff,20,0,20,0
1683719057302,PHIL 191A,A00,258918,Staff,0,0,1,1
1683719058327,PHYS 1A,A00,187028,Staff,26,0,60,34
1683719059354,PHYS 1AL,001,187036,Staff,3,0,30,27
1683719059354,PHYS 1AL,002,187049,Staff,18,0,30,12
1683719060380,PHYS 1B,A00,187058,Staff,21,0,60,39
1683719061408,PHYS 1BL,001,187064,Staff,0,1,30,30
1683719061408,PHYS 1BL,002,187070,Staff,4,0,30,26
1683719062437,PHYS 1C,A00,187082,Staff,30,0,120,90
1683719063471,PHYS 1CL,001,187088,Staff,0,9,30,30
1683719063471,PHYS 1CL,002,187089,Staff,0,1,30,30
1683719063471,PHYS 1CL,009,262693,Staff,9,0,30,21
1683719064502,PHYS 2B,A01,187097,Staff,55,0,115,60
1683719065532,PHYS 2C,A01,187099,Staff,63,0,115,52
1683719066560,PHYS 2CL,A01,187101,Staff,5,0,28,23
1683719066560,PHYS 2CL,A02,187102,Staff,15,0,28,13
1683719067587,PHYS 2D,A01,187123,Shotwell; Brian,95,0,115,20
1683719068618,PHYS 4B,A01,187133,Grinstein; Benjamin,35,0,50,15
1683719069645,POLI 10,A00,188819,Staff,0,4,50,50
1683719070672,POLI 11,A00,188827,Staff,43,0,50,7
1683719071702,POLI 13R,A00,188828,Staff,0,2,20,20
1683719072736,POLI 27,A01,188830,Elgin; Samuel Zincke,0,2,70,70
1683719073761,POLI 30,A00,188832,Desposato; Scott,30,0,50,20
1683719074787,POLI 102F,A00,188834,Staff,1,0,40,39
1683719075818,POLI 104A,A00,188852,Staff,12,0,30,18
1683719076848,POLI 104I,A00,188853,Staff,0,8,20,20
1683719077874,POLI 110B,A00,188854,Wiens; David,6,0,20,14
1683719078901,POLI 112A,A00,188855,Wiens; David,3,0,30,27
1683719079932,POLI 117R,A00,188856,Forman; Fonna,0,12,20,20
1683719080962,POLI 118,A00,188857,Ingham; Sean,8,0,20,12
1683719081991,POLI 120G,A00,188858,Staff,7,0,30,23
1683719083022,POLI 131CR,A00,188863,Hoston; Germaine,20,0,50,30
1683719084054,POLI 133,A00,188864,Nellis; Gareth Hb,44,0,50,6
1683719085081,POLI 134D,A00,188865,Desposato; Scott,27,0,30,3
1683719086112,POLI 142A,A00,188871,Gartzke; Erik,21,0,50,29
1683719087136,POLI 142K,A00,188874,Staff,38,0,50,12
1683719088164,POLI 143,A00,188940,Gartzke; Erik,15,0,30,15
1683719089190,POLI 153,A00,188943,Staff,1,0,20,19
1683719090213,POLI 160AA,A00,188944,Staff,10,0,40,30
1683719091239,POLI 170A,A00,188945,Staff,10,0,30,20
1683719093301,PSYC 1,A00,188952,Staff,36,0,90,54
1683719094337,PSYC 2,B00,188953,Staff,19,0,35,16
1683719095364,PSYC 6,A00,188970,Staff,47,0,60,13
1683719096390,PSYC 7,A00,188973,Staff,35,0,45,10
1683719097424,PSYC 60,A01,188980,Rickard; Timothy C.,42,0,60,18
1683719098452,PSYC 70,A01,189001,Steiner; Eric Tomas,22,0,45,23
1683719099479,PSYC 100,A00,189005,Lacefield; Katharine I,1,98,120,119
1683719100505,PSYC 102,A00,189008,Staff,6,0,30,24
1683719101534,PSYC 106,B00,189026,Gorman; Michael R.,27,0,60,33
1683719102562,PSYC 114,B01,189033,Winkielman; Piotr,0,31,30,30
1683719103587,PSYC 131,A00,189036,Anagnostaras; Stephan,0,44,60,60
1683719104616,PSYC 136,A00,189041,Lowe; Angela Beth,0,7,25,25
1683719105642,PSYC 137,A00,189057,Winkielman; Piotr,0,36,25,25
1683719106668,PSYC 144,A00,189107,Wixted; John T,0,11,50,50
1683719108726,PSYC 162,A00,189142,Staff,0,9,85,85
1683719109756,PSYC 172,A00,189144,Gorman; Michael R.,0,6,30,30
1683719111815,PSYC 179,A00,189146,Lacefield; Katharine I,0,88,120,120
1683719112915,PSYC 181,A00,189147,Anagnostaras; Stephan,0,45,90,90
1683719113942,PSYC 190R,A00,189148,Barner; David A.,0,23,80,80
1683719114969,PSYC 191,A00,189275,Rickard; Timothy C.,0,11,25,25
1683719115997,PSYC 193,A00,189276,Chapman; Eddie Nathaniel,0,1,0,4
1683719117025,PSYC 193L,A01,189281,Lowe; Angela Beth,8,0,20,12
1683719117025,PSYC 193L,B01,189285,Staff,28,0,35,7
1683719118055,RELI 149,A00,187137,Rahimi; Babak,6,0,40,34
1683719119087,SE 9,A01,187315,Staff,0,2,18,18
1683719120125,SE 101B,A00,187409,Staff,24,0,30,6
1683719121152,SE 110B,A00,187444,Staff,10,0,40,30
1683719122179,SE 130B,A00,187449,Staff,31,0,40,9
1683719123215,SE 150A,A00,187516,Staff,8,0,20,12
1683719124241,SE 154,A00,187528,Staff,29,0,50,21
1683719125268,SIO 3,A01,258171,Staff,35,0,40,5
1683719126298,SIO 10,A00,187144,Cook; Geoffrey W,0,6,75,75
1683719127325,SIO 45,A00,187152,Cook; Geoffrey W,1,7,100,99
1683719128355,SIO 109R,A00,194486,Staff,0,4,20,20
1683719130416,SIO 187,A01,187233,Kacev; David,12,0,40,28
1683719131451,SOCI 1,A01,258656,Thorpe; Charles Robert,28,0,30,2
1683719131451,SOCI 1,A02,258658,Thorpe; Charles Robert,30,0,30,0
1683719131451,SOCI 1,A03,258661,Thorpe; Charles Robert,25,0,25,0
1683719131451,SOCI 1,A04,258666,Thorpe; Charles Robert,22,0,25,3
1683719131451,SOCI 1,A05,258897,Thorpe; Charles Robert,22,0,25,3
1683719131451,SOCI 1,A06,258898,Thorpe; Charles Robert,25,0,25,0
1683719132481,SOCI 30,A01,258903,Pardo Guerra; Juan Pablo,14,0,30,16
1683719133507,SOCI 102,A00,258904,Staff,9,0,25,16
1683719134533,SOCI 106,A00,258905,Staff,19,0,25,6
1683719135561,SOCI 111,A00,258907,Ribas Norris; Janet Vanesa,26,0,30,4
1683719136588,SOCI 121R,A00,258908,Pardo Guerra; Juan Pablo,7,0,30,23
1683719137615,SOCI 126,A01,203330,Staff,14,0,20,6
1683719138645,SOCI 131,A00,258909,Thorpe; Charles Robert,30,0,60,30
1683719139677,SOCI 135,A00,258910,Payne; Christine Anna,0,13,30,30
1683719140705,SOCI 157,A00,258911,Staff,10,0,30,20
1683719141731,SOCI 184,A00,258912,Staff,25,0,30,5
1683719142757,SOCI 188D,A00,258913,Staff,22,0,30,8
1683719143785,SYN 2,001,187529,Staff,9,0,16,7
1683719143785,SYN 2,002,201452,Staff,0,20,16,16
1683719143785,SYN 2,003,201469,Staff,1,0,16,15
1683719144811,SYN 100,A01,187531,Staff,0,9,20,20
1683719144811,SYN 100,B01,201491,Staff,0,10,20,20
1683719145840,TDAC 1,A00,189286,Walsh; Kim C.,3,0,20,17
1683719145840,TDAC 1,B00,189287,Harting; Carla Kelso,10,0,20,10
1683719146867,TDAC 101,A00,189300,Walsh; Kim C.,16,0,20,4
1683719146867,TDAC 101,B00,189301,Harting; Carla Kelso,18,0,20,2
1683719147894,TDAC 102,A00,189304,Basso; Beatrice,14,0,20,6
1683719148925,TDAC 108,A00,189305,Staff,18,0,20,2
1683719149959,TDDE 131,A00,189310,Staff,19,0,20,1
1683719149959,TDDE 131,B00,189314,Staff,19,0,20,1
1683719149959,TDDE 131,C00,189315,Staff,48,0,50,2
1683719149959,TDDE 131,D00,189316,Staff,14,0,15,1
1683719149959,TDDE 131,E00,204841,Staff,20,0,20,0
1683719150989,TDGE 10,A00,189289,Staff,26,0,50,24
1683719150989,TDGE 10,B00,189290,Havis; Allan,0,1,50,50
1683719152017,TDGE 11,A00,189291,Fulton; Julia,0,4,50,50
1683719152017,TDGE 11,B00,189292,Staff,20,0,25,5
1683719152017,TDGE 11,C00,260270,Staff,0,0,0,0
1683719153046,TDGE 25,A00,189294,Staff,1,0,20,19
1683719154073,TDGE 124,A00,189318,Fulton; Julia,0,7,50,50
1683719155099,TDGE 125,A00,189319,Staff,13,0,25,12
1683719155099,TDGE 125,B00,189320,Staff,23,0,25,2
1683719156126,TDGE 127,A00,189322,Havis; Allan,1,0,50,49
1683719157156,TDHT 101,A00,189323,Staff,18,0,25,7
1683719157156,TDHT 101,B00,189324,Staff,25,0,25,0
1683719158182,TDHT 102,A00,189325,Staff,49,0,50,1
1683719159210,TDMV 1,A00,189295,Arcidiacono; Kristin,20,0,30,10
1683719159210,TDMV 1,B00,189296,Caligagan; Maria T.,23,0,30,7
1683719160241,TDMV 2,A00,189297,Sammartano; Tonnie,27,0,30,3
1683719160241,TDMV 2,B00,189299,Arcidiacono; Kristin,23,0,30,7
1683719161274,TDMV 3,A00,204998,Rincon; Alicia,22,0,30,8
1683719162301,TDMV 120,A00,189458,Sammartano; Tonnie,28,0,30,2
1683719163331,TDMV 138,A00,189541,Jun; Grace Shin Hae,20,0,40,20
1683719164360,TDMV 142,A00,189717,Caligagan; Tony,25,0,30,5
1683719164360,TDMV 142,B00,189718,Caligagan; Maria T.,25,0,30,5
1683719165386,TMC 2,A01,187533,Staff,25,0,25,0
1683719165386,TMC 2,A02,187534,Staff,25,0,25,0
1683719166413,USP 1,A01,187536,Kwak; Nancy,0,16,25,25
1683719167439,USP 5,A01,187538,Staff,8,0,25,17
1683719168470,USP 101,A00,199253,Staff,0,4,0,0
1683719169501,USP 124,A00,187562,Boomhower; Matthew Charles,0,0,30,30
1683719170542,USP 138,A00,187582,Staff,19,0,25,6
1683719171572,USP 152,A01,187597,Staff,3,0,25,22
1683719172597,USP 153,A00,187598,Staff,18,0,25,7
1683719173625,USP 168,A00,187607,Kwak; Nancy,2,0,5,3
1683719174652,USP 173,A00,187619,Staff,4,0,25,21
1683719175678,USP 181,A00,187638,Staff,0,4,25,25
1683719176706,VIS 103,A00,187650,Cruz; Edwin Teddy,17,0,75,58
1683719177735,VIS 110D,A00,187669,Staff,13,0,22,9
1683719178765,VIS 127C,A00,187720,Shen; Kuiyi,67,0,146,79
1683719179798,VIS 149,A00,187731,Yoldas; Pinar,0,12,22,22
1683719180824,VIS 151,A01,188091,Staff,22,0,34,12
1683719180824,VIS 151,A02,188092,Staff,11,0,34,23
1683719181850,VIS 160B,A00,188093,Stalbaum; Brett,0,1,10,10
1683719183909,WCWP 10B,A00,201720,Staff,0,0,5,5
1683719183909,WCWP 10B,B00,201722,Staff,0,0,6,6
1683719184942,WCWP 100,A00,201725,Gagnon; Jeffrey C,0,0,2,2
1683719184942,WCWP 100,B00,201727,Staff,0,4,15,15
1683719188153,ANBI 133,A00,258401,Wilder; Linnea Lorene,34,0,40,6
1683719189182,ANBI 140,A00,258395,Hrvoj Mihic; Branka,18,0,25,7
1683719190211,ANSC 120,A00,258402,Bialecki; Jon Anthony,26,0,40,14
1683719191239,ANSC 144,A00,258400,Staff,12,0,40,28
1683719193298,ANSC 166,A00,258396,Parish; Steven Martin,156,0,175,19
1683719194325,ANSC 180,A00,193533,Staff,8,0,20,12
1683719195352,ANSC 188,A00,258397,Jassal; Aftab,34,0,40,6
1683719196382,ANTH 3,A01,258316,Staff,23,0,30,7
1683719197410,ANTH 5,A00,258394,Semendeferi; Ekaterini,16,0,20,4
1683719198441,ANTH 21,A01,258331,Staff,4,0,40,36
1683719199469,ANTH 103,A00,258398,Varma; Saiba,15,0,25,10
1683719200501,AWP 10,001,202034,Staff,0,0,0,0
1683719200501,AWP 10,002,202035,Staff,0,0,0,0
1683719200501,AWP 10,003,202036,Staff,0,0,0,0
1683719200501,AWP 10,004,202037,Staff,0,0,0,0
1683719200501,AWP 10,005,202038,Staff,0,0,0,0
1683719200501,AWP 10,006,202039,Staff,0,0,0,0
1683719200501,AWP 10,007,202040,Staff,0,0,0,0
1683719200501,AWP 10,008,202041,Staff,0,0,0,0
1683719200501,AWP 10,009,202042,Staff,0,0,0,0
1683719200501,AWP 10,010,202043,Staff,0,0,0,0
1683719200501,AWP 10,011,202044,Staff,0,0,0,0
1683719200501,AWP 10,012,202045,Staff,0,0,0,0
1683719200501,AWP 10,013,202046,Staff,0,0,0,0
1683719200501,AWP 10,014,202047,Staff,0,0,0,0
1683719200501,AWP 10,015,202048,Staff,0,0,0,0
1683719200501,AWP 10,016,202049,Staff,0,0,0,0
1683719200501,AWP 10,017,202050,Staff,0,0,0,0
1683719200501,AWP 10,018,202051,Staff,0,0,0,0
1683719200501,AWP 10,019,202052,Staff,0,0,0,0
1683719200501,AWP 10,020,202053,Staff,0,0,0,0
1683719200501,AWP 10,021,202054,Staff,0,0,0,0
1683719200501,AWP 10,022,202055,Staff,0,0,0,0
1683719200501,AWP 10,023,202056,Staff,0,0,0,0
1683719200501,AWP 10,024,202057,Staff,0,0,0,0
1683719200501,AWP 10,025,202058,Staff,0,0,0,0
1683719200501,AWP 10,026,202059,Staff,0,0,0,0
1683719201528,AWP 102,001,202032,Staff,0,0,0,0
1683719201528,AWP 102,002,202033,Staff,0,0,0,0
1683719202558,BENG 100,A01,254234,Taylor Amos; Alyssa C,31,0,40,9
1683719203586,BENG 196,001,270013,Engler; Adam J.,9999,0,9999,0
1683719204621,BICD 100R,A01,202018,Smith; Laurie,0,7,32,32
1683719204621,BICD 100R,A02,202019,Smith; Laurie,0,3,32,32
1683719204621,BICD 100R,A03,202020,Smith; Laurie,0,1,32,32
1683719204621,BICD 100R,A04,202021,Smith; Laurie,6,0,32,26
1683719204621,BICD 100R,A05,202022,Smith; Laurie,10,0,32,22
1683719205655,BICD 136,A01,193242,Gustafson-Brown; Cindy,0,2,32,32
1683719205655,BICD 136,A02,193244,Gustafson-Brown; Cindy,13,0,32,19
1683719206686,BIEB 102,A01,193249,Butler; Shannon Rhey,0,0,32,32
1683719206686,BIEB 102,A02,193251,Butler; Shannon Rhey,0,0,32,32
1683719206686,BIEB 102,A03,193253,Butler; Shannon Rhey,0,0,32,32
1683719206686,BIEB 102,A04,193255,Butler; Shannon Rhey,13,0,32,19
1683719206686,BIEB 102,A05,193265,Butler; Shannon Rhey,25,0,32,7
1683719206686,BIEB 102,A06,193269,Butler; Shannon Rhey,12,0,32,20
1683719208745,BIEB 150,A01,193274,Staff,0,0,32,32
1683719208745,BIEB 150,A02,193285,Staff,24,0,32,8
1683719209771,BIEB 194,A00,193286,Kurle; Carolyn M.,19,0,32,13
1683719210800,BILD 1,A01,192291,Staff,15,0,32,17
1683719210800,BILD 1,A02,192292,Staff,30,0,32,2
1683719210800,BILD 1,B01,192520,Reuther; Keefe,0,1,0,0
1683719210800,BILD 1,B02,192532,Reuther; Keefe,0,1,0,0
1683719211833,BILD 3,A01,192556,Butler; Shannon Rhey,0,0,32,32
1683719211833,BILD 3,A02,192581,Butler; Shannon Rhey,0,1,32,32
1683719211833,BILD 3,A03,192611,Butler; Shannon Rhey,19,0,32,13
1683719211833,BILD 3,A04,192612,Butler; Shannon Rhey,23,0,32,9
1683719211833,BILD 3,A05,192613,Butler; Shannon Rhey,26,0,32,6
1683719211833,BILD 3,A06,192679,Butler; Shannon Rhey,27,0,32,5
1683719211833,BILD 3,A07,192682,Butler; Shannon Rhey,20,0,32,12
1683719212869,BILD 4,A01,192836,Reuther; Keefe,1,0,24,23
1683719212869,BILD 4,A02,193044,Reuther; Keefe,4,0,24,20
1683719213897,BILD 10,A01,193142,Gustafson-Brown; Cindy,29,0,32,3
1683719213897,BILD 10,A02,193149,Gustafson-Brown; Cindy,31,0,32,1
1683719214927,BIMM 100,A01,193301,Staff,0,6,32,32
1683719214927,BIMM 100,A02,193312,Staff,0,7,32,32
1683719214927,BIMM 100,A03,193323,Staff,0,10,32,32
1683719215955,BIMM 101,A01,193329,McDonnell; Lisa Marie,0,3,24,24
1683719215955,BIMM 101,A02,193339,McDonnell; Lisa Marie,0,3,24,24
1683719215955,BIMM 101,B01,193354,McDonnell; Lisa Marie,0,4,24,24
1683719215955,BIMM 101,B02,193357,McDonnell; Lisa Marie,0,3,24,24
1683719217036,BIMM 110,A01,193377,Tat; John,0,11,32,32
1683719217036,BIMM 110,A02,193378,Tat; John,0,11,32,32
1683719218063,BIMM 120,A01,206116,Staff,0,0,32,32
1683719218063,BIMM 120,A02,206117,Staff,7,0,32,25
1683719218063,BIMM 120,A03,206121,Staff,21,0,32,11
1683719219099,BIPN 100,A01,193393,Park; Ji Young,0,15,32,32
1683719219099,BIPN 100,A02,193402,Park; Ji Young,0,14,32,32
1683719219099,BIPN 100,A03,193413,Park; Ji Young,0,14,32,32
1683719219099,BIPN 100,A04,193414,Park; Ji Young,0,13,32,32
1683719220124,BIPN 102,A01,193429,Staff,0,0,32,32
1683719220124,BIPN 102,A02,193438,Staff,18,0,32,14
1683719221150,BIPN 106,A01,193450,Reyes Gonzalez; Catalina,0,2,40,40
1683719222184,BIPN 134,A01,193465,Cooke; James Edward,0,0,32,32
1683719222184,BIPN 134,A02,193474,Cooke; James Edward,25,0,32,7
1683719222184,BIPN 134,A03,193485,Cooke; James Edward,29,0,32,3
1683719222184,BIPN 134,A04,193486,Cooke; James Edward,20,0,32,12
1683719222184,BIPN 134,A05,193491,Cooke; James Edward,31,0,32,1
1683719222184,BIPN 134,A06,193501,Cooke; James Edward,30,0,32,2
1683719222184,BIPN 134,A07,193510,Cooke; James Edward,29,0,32,3
1683719224240,BISP 194,A00,222522,Staff,14,0,32,18
1683719225266,CAT 124,A01,202407,Staff,19,0,25,6
1683719226291,CAT 125,A00,202408,Marchisotto; Jennifer Anne,2,0,20,18
1683719227327,CAT 125R,A00,202409,Smith; Lauryn Alissa,0,11,20,20
1683719227327,CAT 125R,B00,202410,Morales; Celeste Georgianna,0,11,20,20
1683719227327,CAT 125R,C00,202411,Irwin; Matthew Joseph,0,12,20,20
1683719228359,CENG 15,A01,204712,Yang; Kesong,0,1,0,0
1683719229393,CENG 114,A00,202070,Jahed Motlagh; Zeinab,5,0,20,15
1683719230427,CGS 105,A00,185477,Wesling; Megan E.,24,0,40,16
1683719231457,CGS 106,A00,185494,Staff,11,0,22,11
1683719232486,CGS 108,A00,185495,Staff,14,0,20,6
1683719233513,CGS 114,A00,185496,Staff,13,0,18,5
1683719234543,CGS 119,A00,185501,Staff,15,0,20,5
1683719235568,CGS 120,A00,185511,Staff,11,0,20,9
1683719236596,CHEM 4,A01,184675,Bussey; Thomas J,97,0,100,3
1683719237627,CHEM 6A,A01,184677,Staff,32,0,60,28
1683719238653,CHEM 6B,A01,184679,Staff,63,0,100,37
1683719239679,CHEM 6C,A01,184681,Bussey; Thomas J,0,0,50,50
1683719239679,CHEM 6C,A02,184682,Bussey; Thomas J,32,0,50,18
1683719240706,CHEM 40A,A01,184684,Albizati; Kim F.,33,0,100,67
1683719241734,CHEM 40B,A01,184686,Albizati; Kim F.,0,22,100,100
1683719242769,CHEM 41B,A01,184690,Staff,51,0,100,49
1683719243805,COGS 3,A01,184715,Boyle; Mary E. T.,0,27,40,40
1683719244837,COGS 14B,A01,185172,Staff,0,14,38,38
1683719245863,COGS 18,A01,184736,Staff,14,0,80,66
1683719246891,COGS 100,A01,184932,Staff,0,8,73,73
1683719247921,COGS 101A,A01,184935,Staff,0,40,30,30
1683719248952,COGS 101B,A01,184944,Staff,0,2,30,30
1683719249980,COGS 101C,A01,184946,Staff,0,10,30,30
1683719251008,COGS 102A,A01,184951,Johnson; Christine M.,1,0,40,39
1683719252037,COGS 107B,A01,184953,Mooshagian; Eric Frederick,0,52,40,40
1683719253068,COGS 118B,A01,184959,Gupta; Anjum,0,50,40,40
1683719254095,COGS 153,A00,184961,Staff,1,16,30,29
1683719255125,COGS 177,A00,184962,Staff,0,20,30,30
1683719256152,COGS 187A,A01,184969,Boyle; Mary E. T.,0,19,40,40
1683719257176,COMM 10,A01,185174,Staff,0,5,25,25
1683719257176,COMM 10,A02,185189,Staff,0,2,25,25
1683719257176,COMM 10,A03,269821,Staff,0,1,0,0
1683719258205,COMM 100B,A02,185476,Staff,10,0,25,15
1683719258205,COMM 100B,A03,277340,Staff,25,0,25,0
1683719259233,COMM 100C,A01,185314,Staff,2,0,25,23
1683719259233,COMM 100C,A02,185327,Staff,17,0,25,8
1683719260258,COMM 110M,A00,185349,Staff,0,0,40,40
1683719261285,COMM 113T,A00,185352,Staff,25,0,40,15
1683719262311,COMM 114I,A00,185353,Staff,31,0,40,9
1683719263341,COMM 131,A00,185354,Staff,17,0,30,13
1683719264368,CSE 8A,A50,185358,Cao; Yingjun,0,46,10,10
1683719265396,CSE 8B,A01,185362,Staff,0,48,50,50
1683719266426,CSE 11,A01,185416,Cao; Yingjun,0,91,10,10
1683719267455,CSE 20,A01,185445,Briones; Jor-el Thomas Caparas,3,0,25,22
1683719268481,CSE 21,A01,185447,Staff,9,0,50,41
1683719269514,CSE 101,A01,185451,Staff,0,13,50,50
1683719269514,CSE 101,B01,185453,Jones; Miles E,0,15,50,50
1683719271574,CSE 141,A01,185458,Eldon; John,16,0,100,84
1683719272603,CSE 141L,A01,185461,Eldon; John,8,0,100,92
1683719273635,CSE 142,A01,185463,Staff,34,0,60,26
1683719273635,CSE 142,B01,201355,Staff,0,7,60,60
1683719274667,CSE 142L,A01,185470,Staff,34,0,60,26
1683719274667,CSE 142L,B01,201417,Staff,0,6,60,60
1683719275695,CSE 190,A00,201433,Staff,32,0,49,17
1683719276724,DOC 1,A01,259136,Strom; Megan C.,7,0,15,8
1683719276724,DOC 1,A02,259137,Strom; Megan C.,15,0,15,0
1683719276724,DOC 1,A03,259138,Strom; Megan C.,14,0,15,1
1683719276724,DOC 1,A04,259139,Strom; Megan C.,13,0,15,2
1683719277756,DOC 100D,A00,259140,Pass; Natalye Joann,14,0,25,11
1683719278789,DSGN 1,A01,184749,Rill; Bryan,0,26,30,30
1683719279821,DSGN 100,A01,185168,Staff,0,2,25,25
1683719280854,ECE 5,A01,185626,Morris; Karcher William,0,12,0,0
1683719281882,ECE 101,A01,185628,Staff,14,0,70,56
1683719282909,ECE 107,A01,185635,Baghdadchi; Saharnaz,0,0,20,20
1683719282909,ECE 107,A02,185638,Baghdadchi; Saharnaz,1,0,20,19
1683719283936,ECE 148,A01,185647,Silberman; Jack,0,0,16,16
1683719284966,ECON 1,A01,185537,Crane; Meredith Helen,54,0,70,16
1683719285993,ECON 3,A01,185549,Crane; Meredith Helen,30,0,70,40
1683719287020,ECON 4,A01,203354,Anderson; John Charles,0,5,10,10
1683719288047,ECON 100A,A01,185574,Staff,0,5,40,40
1683719289073,ECON 100B,A01,185576,Staff,0,12,50,50
1683719290104,ECON 100C,A01,185589,Newhouse; Herbert S,30,0,70,40
1683719291131,ECON 105,A00,185608,Vespa; Emanuel Ignacio,19,0,35,16
1683719292159,ECON 109,A01,185610,Shishkin; Denis,9,0,35,26
1683719293185,ECON 110A,A01,185612,Staff,8,0,40,32
1683719294211,ECON 120A,A01,185615,Staff,19,0,40,21
1683719295243,ECON 120C,A01,185617,Sun; Yixiao,0,21,70,70
1683719296273,ECON 144,A00,203346,Squires; Dale E,2,0,35,33
1683719297299,ECON 171,A01,203349,Newhouse; Herbert S,0,1,35,35
1683719298331,ECON 173A,A01,185621,Toda; Alexis Akira,21,0,35,14
1683719299367,EDS 25,A01,202413,Staff,0,1,0,0
1683719299367,EDS 25,A02,202414,Staff,0,1,0,0
1683719299367,EDS 25,A03,202415,Staff,0,0,0,0
1683719299367,EDS 25,A04,202416,Staff,0,1,0,0
1683719299367,EDS 25,A05,202439,Staff,0,0,0,0
1683719299367,EDS 25,A06,202440,Staff,0,0,0,0
1683719299367,EDS 25,B01,202631,Staff,0,0,0,0
1683719299367,EDS 25,B02,202632,Staff,0,0,0,0
1683719299367,EDS 25,B03,202639,Staff,0,0,0,0
1683719299367,EDS 25,B04,202640,Staff,0,0,0,0
1683719299367,EDS 25,B05,202643,Staff,0,0,0,0
1683719299367,EDS 25,B06,202644,Staff,0,0,0,0
1683719300395,EDS 38,A01,202659,Black; Alison Michelle,25,0,25,0
1683719301422,EDS 115,A00,202652,Staff,18,0,30,12
1683719302453,EDS 125,A00,202649,Staff,13,0,30,17
1683719303482,EDS 126,A01,203332,Staff,30,0,30,0
1683719304513,EDS 139,A00,202838,Staff,16,0,25,9
1683719305540,EDS 146,A01,202655,Staff,14,0,25,11
1683719306572,ENG 15,A00,185667,Staff,0,1,0,0
1683719306572,ENG 15,B00,185672,Staff,0,0,0,0
1683719306572,ENG 15,C00,185675,Staff,0,0,0,0
1683719306572,ENG 15,D00,185682,Staff,0,0,0,0
1683719306572,ENG 15,E00,185684,Staff,0,0,0,0
1683719307602,ETHN 103,A00,185710,Staff,0,8,35,35
1683719308632,ETHN 103A,A00,199228,Man; Simeon S,0,0,9,9
1683719309661,ETHN 109,A00,185711,Staff,15,0,35,20
1683719310687,ETHN 142,A00,185726,Staff,0,4,30,30
1683719311717,ETHN 163J,A00,199229,Man; Simeon S,5,0,8,3
1683719312742,ETHN 168,A00,185727,Staff,7,0,10,3
1683719313770,ETHN 182,A00,185728,Staff,0,0,35,35
1683719314795,ETHN 183,A00,185737,Staff,10,0,18,8
1683719315829,GLBH 111,A01,209361,Burgos; Jose L.,0,0,0,0
1683719317886,HIEU 104,A00,185792,Staff,14,0,20,6
1683719318916,HIEU 115,A00,185800,Staff,0,0,20,20
1683719319943,HIEU 128,A00,185801,Staff,0,9,20,20
1683719321025,HIEU 147,A00,185802,Staff,15,0,20,5
1683719322050,HIEU 154,A00,185823,Staff,11,0,20,9
1683719323078,HILA 102,A00,185826,Staff,14,0,20,6
1683719324109,HILD 2C,A01,185778,Staff,0,13,20,20
1683719325139,HILD 7B,A01,185780,Kwak; Nancy,0,17,32,32
1683719325139,HILD 7B,A02,185781,Kwak; Nancy,0,18,32,32
1683719326164,HILD 30,A01,185791,Staff,12,0,20,8
1683719327196,HISC 119,A00,185830,Golan; Tal,0,10,20,20
1683719328227,HITO 156GS,A00,185831,Patterson; Patrick H.,0,0,0,23
1683719329252,HIUS 103,A00,185832,Man; Simeon S,0,4,20,20
1683719330280,HIUS 117,A00,185836,Kwak; Nancy,2,0,20,18
1683719331312,HIUS 125,A00,185840,Man; Simeon S,0,2,23,23
1683719332341,HIUS 149,A00,185845,Staff,1,0,20,19
1683719333375,HUM 3,A01,185882,Zavodny; Tatiana Sophia,0,8,50,50
1683719333375,HUM 3,B01,185899,Caldwell; Michael Alan,0,18,50,50
1683719334406,HUM 3GS,A00,185900,Patterson; Patrick H.,0,0,0,23
1683719335434,HUM 4,A01,185938,Zroka; Amy Liane,28,0,50,22
1683719335434,HUM 4,B01,185956,Watkins; Eric,0,6,50,50
1683719335434,HUM 4,B02,202209,Watkins; Eric,0,6,50,50
1683719335434,HUM 4,B03,202210,Watkins; Eric,0,5,50,50
1683719336460,HUM 5,A01,185958,West; Geoffrey Scott,0,0,50,50
1683719336460,HUM 5,A02,202215,West; Geoffrey Scott,0,1,50,50
1683719337489,INTL 190,A00,185959,Gagnon; Jeffrey C,0,0,0,9
1683719337489,INTL 190,B00,185960,Lettieri; Michael Joseph,0,0,0,2
1683719338516,JAPN 180,A00,254509,Staff,5,0,30,25
1683719339549,LATI 10,A01,202853,Kennemore; Amy Michelle,4,0,35,31
1683719339549,LATI 10,A02,202854,Kennemore; Amy Michelle,3,0,35,32
1683719339549,LATI 10,A03,270054,Kennemore; Amy Michelle,30,0,30,0
1683719340578,LATI 180,A00,202855,Kennemore; Amy Michelle,11,0,20,9
1683719341609,LAWS 101,A00,201767,Golan; Tal,0,7,40,40
1683719342636,LIFR 1C,A00,185961,Staff,6,0,20,14
1683719343663,LIFR 1CX,A00,185962,Staff,7,0,20,13
1683719344690,LIFR 1D,A00,185963,Staff,7,0,20,13
1683719345714,LIFR 1DX,A00,185964,Staff,7,0,20,13
1683719346740,LIGN 101,A01,186039,Staff,43,0,50,7
1683719347766,LIGN 165,A00,186040,Staff,14,0,50,36
1683719348794,LTCS 108,A00,186041,Staff,5,0,10,5
1683719349820,LTCS 119,A00,186042,Staff,15,0,20,5
1683719350847,LTCS 130,A00,186043,Wesling; Megan E.,15,0,25,10
1683719352903,LTEA 138,A00,186119,Staff,14,0,40,26
1683719353933,LTEN 124,A00,186148,Staff,5,0,25,20
1683719354963,LTEN 178,A00,186149,Staff,6,0,15,9
1683719355989,LTEN 181,A00,186150,Blanco; John D,34,0,40,6
1683719357018,LTWL 120,A00,186160,Staff,19,0,25,6
1683719358046,LTWL 165,A00,186161,Staff,22,0,25,3
1683719359071,LTWR 100,A00,186162,Staff,0,5,15,15
1683719360105,LTWR 102,A00,186163,Doller; Ben,5,0,15,10
1683719361136,MAE 8,A01,186412,Staff,0,1,0,0
1683719362169,MAE 30B,A00,186445,Bahadori; Mohammad Yousef,81,0,100,19
1683719363195,MAE 40,A00,186592,Bewley; Thomas R,10,0,50,40
1683719364221,MAE 101B,A00,186593,Bahadori; Mohammad Yousef,80,0,100,20
1683719365250,MAE 105,A00,186594,Bandaru; Prabhakar,10,0,50,40
1683719366279,MAE 107,A00,186599,Pham; Hieu Tan,0,8,120,120
1683719367305,MAE 148,A01,186660,Silberman; Jack,3,0,16,13
1683719368331,MATH 10A,A01,188095,Staff,0,6,35,35
1683719369363,MATH 10B,A01,188097,Bowers; Adam R.,0,12,30,30
1683719369363,MATH 10B,A02,188099,Bowers; Adam R.,0,11,30,30
1683719369363,MATH 10B,B01,188104,Bowers; Adam R.,0,10,30,30
1683719369363,MATH 10B,B02,188106,Bowers; Adam R.,0,9,30,30
1683719370391,MATH 10C,A01,188111,Staff,0,20,30,30
1683719370391,MATH 10C,A02,188127,Staff,0,19,30,30
1683719370391,MATH 10C,A03,188131,Staff,0,19,30,30
1683719370391,MATH 10C,B01,188218,Staff,17,0,30,13
1683719370391,MATH 10C,B02,188244,Staff,13,0,30,17
1683719370391,MATH 10C,B03,188277,Staff,14,0,30,16
1683719371417,MATH 18,A01,188344,Bach; Quang Tran,18,0,30,12
1683719371417,MATH 18,A02,188345,Bach; Quang Tran,11,0,30,19
1683719371417,MATH 18,B01,188353,Bach; Quang Tran,11,0,30,19
1683719371417,MATH 18,B02,188354,Bach; Quang Tran,19,0,30,11
1683719372443,MATH 20A,A01,188374,Staff,11,0,35,24
1683719373522,MATH 20B,A01,188382,Ohm; Ko Woon,7,0,30,23
1683719373522,MATH 20B,A02,188383,Ohm; Ko Woon,22,0,30,8
1683719373522,MATH 20B,B01,188385,Ohm; Ko Woon,7,0,30,23
1683719373522,MATH 20B,B02,188392,Ohm; Ko Woon,22,0,30,8
1683719374555,MATH 20C,A01,188394,Harel; Guershon,10,0,30,20
1683719374555,MATH 20C,A02,188395,Harel; Guershon,13,0,30,17
1683719374555,MATH 20C,B01,188404,Harel; Guershon,5,0,30,25
1683719374555,MATH 20C,B02,188405,Harel; Guershon,18,0,30,12
1683719375585,MATH 20D,A01,188414,Hammock; Frances H,0,1,30,30
1683719375585,MATH 20D,A02,188415,Hammock; Frances H,0,1,30,30
1683719375585,MATH 20D,B01,188447,Hammock; Frances H,0,1,30,30
1683719375585,MATH 20D,B02,188486,Hammock; Frances H,2,0,30,28
1683719376613,MATH 20E,A01,188649,Staff,21,0,30,9
1683719376613,MATH 20E,A02,188650,Staff,20,0,30,10
1683719376613,MATH 20E,A03,188673,Staff,0,0,30,30
1683719377639,MATH 102,A01,188675,Staff,0,40,35,35
1683719378666,MATH 103B,A01,188681,Staff,3,0,35,32
1683719378666,MATH 103B,B01,188692,Staff,5,0,35,30
1683719379695,MATH 109,A01,188695,Salehi Golsefidy; Alireza,24,0,35,11
1683719379695,MATH 109,A02,188696,Salehi Golsefidy; Alireza,24,0,35,11
1683719380722,MATH 120A,A01,188698,Eggers; John Dietrich,7,0,35,28
1683719381749,MATH 142B,A01,188736,Ioana; Adrian,0,0,30,30
1683719381749,MATH 142B,A02,188741,Ioana; Adrian,0,1,30,30
1683719381749,MATH 142B,A03,188743,Ioana; Adrian,0,2,30,30
1683719382777,MATH 168A,A01,188790,Staff,0,11,35,35
1683719383805,MATH 170A,A01,188803,Nie; Jiawang,0,2,35,35
1683719383805,MATH 170A,A02,188811,Nie; Jiawang,0,1,35,35
1683719383805,MATH 170A,A03,188814,Nie; Jiawang,1,0,35,34
1683719383805,MATH 170A,A04,188815,Nie; Jiawang,5,0,35,30
1683719384831,MATH 193B,A01,188817,Staff,0,0,35,35
1683719384831,MATH 193B,A02,188818,Staff,6,0,35,29
1683719385864,MGT 4,A01,202857,Anderson; John Charles,59,0,80,21
1683719386891,MGT 12,A00,202858,Lindenberger; Wade Douglas,40,0,90,50
1683719387921,MGT 18,A00,202859,Staff,73,0,90,17
1683719388948,MGT 18GS,A00,202860,McKay; Michael J,13,0,28,15
1683719389974,MGT 45,A00,202861,Pecore; Joseph P.,8,0,90,82
1683719391006,MGT 100,A00,202863,Yavorsky; Daniel Ryan,27,0,90,63
1683719392033,MGT 103,A00,202864,Ehrich; Kristine R,0,19,90,90
1683719393061,MGT 112,A00,202865,Ehrich; Kristine R,15,0,90,75
1683719394094,MGT 121A,A00,202868,Staff,70,0,90,20
1683719395125,MGT 131B,A00,202869,Anderson; John Charles,58,0,90,32
1683719396150,MGT 136,A00,202871,Lindenberger; Wade Douglas,83,0,90,7
1683719397175,MGT 164,A00,202873,Staff,0,67,90,91
1683719398200,MGT 164GS,A00,202874,McKay; Mary A,13,0,28,15
1683719399231,MGT 180,A00,202875,Staff,0,51,90,91
1683719400258,MMW 11R,A01,205019,Herbst; Matthew,0,0,30,30
1683719400258,MMW 11R,A02,205026,Herbst; Matthew,29,0,30,1
1683719401286,MMW 15,A01,193512,Chang; Edmond Yi-Teh,0,8,28,28
1683719401286,MMW 15,A02,193513,Chang; Edmond Yi-Teh,0,5,28,28
1683719401286,MMW 15,A03,193514,Chang; Edmond Yi-Teh,0,5,28,28
1683719401286,MMW 15,A04,193515,Chang; Edmond Yi-Teh,0,5,28,28
1683719401286,MMW 15,A05,193516,Chang; Edmond Yi-Teh,0,5,28,28
1683719401286,MMW 15,A06,193517,Chang; Edmond Yi-Teh,0,6,28,28
1683719401286,MMW 15,B01,193519,Chang; Edmond Yi-Teh,0,5,28,28
1683719401286,MMW 15,B02,193520,Chang; Edmond Yi-Teh,0,5,28,28
1683719401286,MMW 15,B03,193521,Chang; Edmond Yi-Teh,0,5,28,28
1683719401286,MMW 15,B04,193522,Chang; Edmond Yi-Teh,0,6,28,28
1683719401286,MMW 15,B05,193523,Chang; Edmond Yi-Teh,0,5,28,28
1683719401286,MMW 15,B06,193524,Chang; Edmond Yi-Teh,0,5,28,28
1683719402316,MMW 122,A01,193526,Rahimi; Babak,0,16,28,28
1683719402316,MMW 122,A02,193527,Rahimi; Babak,0,15,28,28
1683719402316,MMW 122,A03,193528,Rahimi; Babak,0,0,0,0
1683719402316,MMW 122,A04,193529,Rahimi; Babak,0,0,0,0
1683719403346,MUS 1A,A01,186663,Staff,0,18,35,35
1683719404373,MUS 4,A01,186715,Staff,0,12,35,35
1683719405406,MUS 5R,A01,186796,Dubnov; Shlomo,0,17,35,35
1683719406437,MUS 6,A01,186798,Staff,0,4,25,25
1683719407467,MUS 7,A01,186830,Staff,11,0,35,24
1683719408496,MUS 8,A01,186930,Staff,0,27,35,35
1683719409527,MUS 15,A01,186932,Staff,0,15,35,35
1683719409527,MUS 15,B01,186934,Staff,0,16,35,35
1683719410553,MUS 80,A00,186935,Staff,0,0,20,20
1683719410553,MUS 80,B00,186936,Staff,24,0,25,1
1683719411581,NANO 11,A00,204702,Lipomi; Darren John,0,0,0,0
1683719412607,NANO 15,A01,204709,Yang; Kesong,0,1,0,0
1683719413636,NANO 114,A00,202069,Jahed Motlagh; Zeinab,2,0,10,8
1683719414665,PHIL 1,A00,186955,Grush; Rick Scott,31,0,40,9
1683719415697,PHIL 10,A01,186973,Grush; Rick Scott,27,0,35,8
1683719415697,PHIL 10,A02,186974,Grush; Rick Scott,33,0,35,2
1683719416726,PHIL 13,A01,186976,Staff,1,0,35,34
1683719416726,PHIL 13,A02,186977,Staff,16,0,35,19
1683719417751,PHIL 14,A01,186979,Staff,30,0,35,5
1683719417751,PHIL 14,A02,186986,Staff,32,0,35,3
1683719418778,PHIL 28,A01,186988,Staff,16,0,30,14
1683719418778,PHIL 28,A02,186989,Staff,0,0,30,30
1683719418778,PHIL 28,A03,186990,Staff,10,0,30,20
1683719418778,PHIL 28,A04,186991,Staff,26,0,30,4
1683719419810,PHIL 120,A00,186997,Staff,23,0,40,17
1683719420837,PHIL 137,A00,187003,Staff,8,0,40,32
1683719421863,PHIL 150,A00,187015,Staff,47,0,70,23
1683719422893,PHIL 167,A00,187021,Lamey; Andy M.,34,0,40,6
1683719423925,PHIL 174,A01,202226,Staff,17,0,20,3
1683719423925,PHIL 174,A02,202235,Staff,20,0,20,0
1683719425025,PHIL 191A,A00,258918,Staff,0,0,1,1
1683719426052,PHYS 1A,A00,187028,Staff,26,0,60,34
1683719427080,PHYS 1AL,001,187036,Staff,3,0,30,27
1683719427080,PHYS 1AL,002,187049,Staff,18,0,30,12
1683719428108,PHYS 1B,A00,187058,Staff,21,0,60,39
1683719429133,PHYS 1BL,001,187064,Staff,0,1,30,30
1683719429133,PHYS 1BL,002,187070,Staff,4,0,30,26
1683719430162,PHYS 1C,A00,187082,Staff,30,0,120,90
1683719431190,PHYS 1CL,001,187088,Staff,0,9,30,30
1683719431190,PHYS 1CL,002,187089,Staff,0,1,30,30
1683719431190,PHYS 1CL,009,262693,Staff,9,0,30,21
1683719432217,PHYS 2B,A01,187097,Staff,55,0,115,60
1683719433243,PHYS 2C,A01,187099,Staff,63,0,115,52
1683719434270,PHYS 2CL,A01,187101,Staff,5,0,28,23
1683719434270,PHYS 2CL,A02,187102,Staff,15,0,28,13
1683719435301,PHYS 2D,A01,187123,Shotwell; Brian,95,0,115,20
1683719436329,PHYS 4B,A01,187133,Grinstein; Benjamin,35,0,50,15
1683719437356,POLI 10,A00,188819,Staff,0,4,50,50
1683719438384,POLI 11,A00,188827,Staff,43,0,50,7
1683719439408,POLI 13R,A00,188828,Staff,0,2,20,20
1683719440439,POLI 27,A01,188830,Elgin; Samuel Zincke,0,2,70,70
1683719441471,POLI 30,A00,188832,Desposato; Scott,30,0,50,20
1683719442500,POLI 102F,A00,188834,Staff,1,0,40,39
1683719443524,POLI 104A,A00,188852,Staff,12,0,30,18
1683719444554,POLI 104I,A00,188853,Staff,0,8,20,20
1683719445583,POLI 110B,A00,188854,Wiens; David,6,0,20,14
1683719446613,POLI 112A,A00,188855,Wiens; David,3,0,30,27
1683719447638,POLI 117R,A00,188856,Forman; Fonna,0,12,20,20
1683719448665,POLI 118,A00,188857,Ingham; Sean,8,0,20,12
1683719449695,POLI 120G,A00,188858,Staff,7,0,30,23
1683719450722,POLI 131CR,A00,188863,Hoston; Germaine,20,0,50,30
1683719451751,POLI 133,A00,188864,Nellis; Gareth Hb,44,0,50,6
1683719452782,POLI 134D,A00,188865,Desposato; Scott,27,0,30,3
1683719453815,POLI 142A,A00,188871,Gartzke; Erik,21,0,50,29
1683719454843,POLI 142K,A00,188874,Staff,38,0,50,12
1683719455873,POLI 143,A00,188940,Gartzke; Erik,15,0,30,15
1683719456899,POLI 153,A00,188943,Staff,1,0,20,19
1683719457925,POLI 160AA,A00,188944,Staff,10,0,40,30
1683719458955,POLI 170A,A00,188945,Staff,10,0,30,20
1683719461010,PSYC 1,A00,188952,Staff,36,0,90,54
1683719462038,PSYC 2,B00,188953,Staff,19,0,35,16
1683719463064,PSYC 6,A00,188970,Staff,47,0,60,13
1683719464089,PSYC 7,A00,188973,Staff,35,0,45,10
1683719465122,PSYC 60,A01,188980,Rickard; Timothy C.,42,0,60,18
1683719466153,PSYC 70,A01,189001,Steiner; Eric Tomas,22,0,45,23
1683719467181,PSYC 100,A00,189005,Lacefield; Katharine I,1,98,120,119
1683719468207,PSYC 102,A00,189008,Staff,6,0,30,24
1683719469238,PSYC 106,B00,189026,Gorman; Michael R.,27,0,60,33
1683719470267,PSYC 114,B01,189033,Winkielman; Piotr,0,31,30,30
1683719471297,PSYC 131,A00,189036,Anagnostaras; Stephan,0,44,60,60
1683719472324,PSYC 136,A00,189041,Lowe; Angela Beth,0,7,25,25
1683719473351,PSYC 137,A00,189057,Winkielman; Piotr,0,36,25,25
1683719474378,PSYC 144,A00,189107,Wixted; John T,0,11,50,50
1683719476427,PSYC 162,A00,189142,Staff,0,9,85,85
1683719477458,PSYC 172,A00,189144,Gorman; Michael R.,0,6,30,30
1683719479513,PSYC 179,A00,189146,Lacefield; Katharine I,0,88,120,120
1683719480539,PSYC 181,A00,189147,Anagnostaras; Stephan,0,45,90,90
1683719481570,PSYC 190R,A00,189148,Barner; David A.,0,23,80,80
1683719482597,PSYC 191,A00,189275,Rickard; Timothy C.,0,11,25,25
1683719483624,PSYC 193,A00,189276,Chapman; Eddie Nathaniel,0,1,0,4
1683719484655,PSYC 193L,A01,189281,Lowe; Angela Beth,8,0,20,12
1683719484655,PSYC 193L,B01,189285,Staff,28,0,35,7
1683719485684,RELI 149,A00,187137,Rahimi; Babak,6,0,40,34
1683719486715,SE 9,A01,187315,Staff,0,2,18,18
1683719487741,SE 101B,A00,187409,Staff,24,0,30,6
1683719488770,SE 110B,A00,187444,Staff,10,0,40,30
1683719489799,SE 130B,A00,187449,Staff,31,0,40,9
1683719490823,SE 150A,A00,187516,Staff,8,0,20,12
1683719491846,SE 154,A00,187528,Staff,29,0,50,21
1683719492878,SIO 3,A01,258171,Staff,35,0,40,5
1683719493905,SIO 10,A00,187144,Cook; Geoffrey W,0,6,75,75
1683719494935,SIO 45,A00,187152,Cook; Geoffrey W,1,7,100,99
1683719495967,SIO 109R,A00,194486,Staff,0,4,20,20
1683719498024,SIO 187,A01,187233,Kacev; David,12,0,40,28
1683719499060,SOCI 1,A01,258656,Thorpe; Charles Robert,28,0,30,2
1683719499060,SOCI 1,A02,258658,Thorpe; Charles Robert,30,0,30,0
1683719499060,SOCI 1,A03,258661,Thorpe; Charles Robert,25,0,25,0
1683719499060,SOCI 1,A04,258666,Thorpe; Charles Robert,22,0,25,3
1683719499060,SOCI 1,A05,258897,Thorpe; Charles Robert,22,0,25,3
1683719499060,SOCI 1,A06,258898,Thorpe; Charles Robert,25,0,25,0
1683719500091,SOCI 30,A01,258903,Pardo Guerra; Juan Pablo,14,0,30,16
1683719501121,SOCI 102,A00,258904,Staff,9,0,25,16
1683719502150,SOCI 106,A00,258905,Staff,19,0,25,6
1683719503178,SOCI 111,A00,258907,Ribas Norris; Janet Vanesa,26,0,30,4
1683719504210,SOCI 121R,A00,258908,Pardo Guerra; Juan Pablo,7,0,30,23
1683719505236,SOCI 126,A01,203330,Staff,14,0,20,6
1683719506262,SOCI 131,A00,258909,Thorpe; Charles Robert,30,0,60,30
1683719507289,SOCI 135,A00,258910,Payne; Christine Anna,0,13,30,30
1683719508316,SOCI 157,A00,258911,Staff,10,0,30,20
1683719509343,SOCI 184,A00,258912,Staff,25,0,30,5
1683719510371,SOCI 188D,A00,258913,Staff,22,0,30,8
1683719511399,SYN 2,001,187529,Staff,9,0,16,7
1683719511399,SYN 2,002,201452,Staff,0,20,16,16
1683719511399,SYN 2,003,201469,Staff,1,0,16,15
1683719512425,SYN 100,A01,187531,Staff,0,9,20,20
1683719512425,SYN 100,B01,201491,Staff,0,10,20,20
1683719513461,TDAC 1,A00,189286,Walsh; Kim C.,3,0,20,17
1683719513461,TDAC 1,B00,189287,Harting; Carla Kelso,10,0,20,10
1683719514489,TDAC 101,A00,189300,Walsh; Kim C.,16,0,20,4
1683719514489,TDAC 101,B00,189301,Harting; Carla Kelso,18,0,20,2
1683719515516,TDAC 102,A00,189304,Basso; Beatrice,14,0,20,6
1683719516543,TDAC 108,A00,189305,Staff,18,0,20,2
1683719517570,TDDE 131,A00,189310,Staff,19,0,20,1
1683719517570,TDDE 131,B00,189314,Staff,19,0,20,1
1683719517570,TDDE 131,C00,189315,Staff,48,0,50,2
1683719517570,TDDE 131,D00,189316,Staff,14,0,15,1
1683719517570,TDDE 131,E00,204841,Staff,20,0,20,0
1683719518596,TDGE 10,A00,189289,Staff,26,0,50,24
1683719518596,TDGE 10,B00,189290,Havis; Allan,0,1,50,50
1683719519625,TDGE 11,A00,189291,Fulton; Julia,0,4,50,50
1683719519625,TDGE 11,B00,189292,Staff,20,0,25,5
1683719519625,TDGE 11,C00,260270,Staff,0,0,0,0
1683719520651,TDGE 25,A00,189294,Staff,1,0,20,19
1683719521681,TDGE 124,A00,189318,Fulton; Julia,0,7,50,50
1683719522720,TDGE 125,A00,189319,Staff,13,0,25,12
1683719522720,TDGE 125,B00,189320,Staff,23,0,25,2
1683719523747,TDGE 127,A00,189322,Havis; Allan,1,0,50,49
1683719524774,TDHT 101,A00,189323,Staff,18,0,25,7
1683719524774,TDHT 101,B00,189324,Staff,25,0,25,0
1683719525803,TDHT 102,A00,189325,Staff,49,0,50,1
1683719526834,TDMV 1,A00,189295,Arcidiacono; Kristin,20,0,30,10
1683719526834,TDMV 1,B00,189296,Caligagan; Maria T.,23,0,30,7
1683719527861,TDMV 2,A00,189297,Sammartano; Tonnie,27,0,30,3
1683719527861,TDMV 2,B00,189299,Arcidiacono; Kristin,23,0,30,7
1683719528948,TDMV 3,A00,204998,Rincon; Alicia,22,0,30,8
1683719529973,TDMV 120,A00,189458,Sammartano; Tonnie,28,0,30,2
1683719530998,TDMV 138,A00,189541,Jun; Grace Shin Hae,20,0,40,20
1683719532033,TDMV 142,A00,189717,Caligagan; Tony,25,0,30,5
1683719532033,TDMV 142,B00,189718,Caligagan; Maria T.,25,0,30,5
1683719533059,TMC 2,A01,187533,Staff,25,0,25,0
1683719533059,TMC 2,A02,187534,Staff,25,0,25,0
1683719534086,USP 1,A01,187536,Kwak; Nancy,0,16,25,25
1683719535112,USP 5,A01,187538,Staff,8,0,25,17
1683719536145,USP 101,A00,199253,Staff,0,4,0,0
1683719537178,USP 124,A00,187562,Boomhower; Matthew Charles,0,0,30,30
1683719538209,USP 138,A00,187582,Staff,19,0,25,6
1683719539238,USP 152,A01,187597,Staff,3,0,25,22
1683719540271,USP 153,A00,187598,Staff,18,0,25,7
1683719541305,USP 168,A00,187607,Kwak; Nancy,2,0,5,3
1683719542332,USP 173,A00,187619,Staff,4,0,25,21
1683719543359,USP 181,A00,187638,Staff,0,4,25,25
1683719544390,VIS 103,A00,187650,Cruz; Edwin Teddy,17,0,75,58
1683719545417,VIS 110D,A00,187669,Staff,13,0,22,9
1683719546444,VIS 127C,A00,187720,Shen; Kuiyi,67,0,146,79
1683719547473,VIS 149,A00,187731,Yoldas; Pinar,0,12,22,22
1683719548502,VIS 151,A01,188091,Staff,22,0,34,12
1683719548502,VIS 151,A02,188092,Staff,11,0,34,23
1683719549534,VIS 160B,A00,188093,Stalbaum; Brett,0,1,10,10
1683719551587,WCWP 10B,A00,201720,Staff,0,0,5,5
1683719551587,WCWP 10B,B00,201722,Staff,0,0,6,6
1683719552620,WCWP 100,A00,201725,Gagnon; Jeffrey C,0,0,2,2
1683719552620,WCWP 100,B00,201727,Staff,0,4,15,15
1683719555843,ANBI 133,A00,258401,Wilder; Linnea Lorene,34,0,40,6
1683719556870,ANBI 140,A00,258395,Hrvoj Mihic; Branka,18,0,25,7
1683719557903,ANSC 120,A00,258402,Bialecki; Jon Anthony,26,0,40,14
1683719558935,ANSC 144,A00,258400,Staff,12,0,40,28
1683719560990,ANSC 166,A00,258396,Parish; Steven Martin,156,0,175,19
1683719562017,ANSC 180,A00,193533,Staff,8,0,20,12
1683719563043,ANSC 188,A00,258397,Jassal; Aftab,34,0,40,6
1683719564070,ANTH 3,A01,258316,Staff,23,0,30,7
1683719565101,ANTH 5,A00,258394,Semendeferi; Ekaterini,16,0,20,4
1683719566126,ANTH 21,A01,258331,Staff,4,0,40,36
1683719567159,ANTH 103,A00,258398,Varma; Saiba,15,0,25,10
1683719568189,AWP 10,001,202034,Staff,0,0,0,0
1683719568189,AWP 10,002,202035,Staff,0,0,0,0
1683719568189,AWP 10,003,202036,Staff,0,0,0,0
1683719568189,AWP 10,004,202037,Staff,0,0,0,0
1683719568189,AWP 10,005,202038,Staff,0,0,0,0
1683719568189,AWP 10,006,202039,Staff,0,0,0,0
1683719568189,AWP 10,007,202040,Staff,0,0,0,0
1683719568189,AWP 10,008,202041,Staff,0,0,0,0
1683719568189,AWP 10,009,202042,Staff,0,0,0,0
1683719568189,AWP 10,010,202043,Staff,0,0,0,0
1683719568189,AWP 10,011,202044,Staff,0,0,0,0
1683719568189,AWP 10,012,202045,Staff,0,0,0,0
1683719568189,AWP 10,013,202046,Staff,0,0,0,0
1683719568189,AWP 10,014,202047,Staff,0,0,0,0
1683719568189,AWP 10,015,202048,Staff,0,0,0,0
1683719568189,AWP 10,016,202049,Staff,0,0,0,0
1683719568189,AWP 10,017,202050,Staff,0,0,0,0
1683719568189,AWP 10,018,202051,Staff,0,0,0,0
1683719568189,AWP 10,019,202052,Staff,0,0,0,0
1683719568189,AWP 10,020,202053,Staff,0,0,0,0
1683719568189,AWP 10,021,202054,Staff,0,0,0,0
1683719568189,AWP 10,022,202055,Staff,0,0,0,0
1683719568189,AWP 10,023,202056,Staff,0,0,0,0
1683719568189,AWP 10,024,202057,Staff,0,0,0,0
1683719568189,AWP 10,025,202058,Staff,0,0,0,0
1683719568189,AWP 10,026,202059,Staff,0,0,0,0
1683719569216,AWP 102,001,202032,Staff,0,0,0,0
1683719569216,AWP 102,002,202033,Staff,0,0,0,0
1683719570244,BENG 100,A01,254234,Taylor Amos; Alyssa C,31,0,40,9
1683719571271,BENG 196,001,270013,Engler; Adam J.,9999,0,9999,0
1683719572300,BICD 100R,A01,202018,Smith; Laurie,0,7,32,32
1683719572300,BICD 100R,A02,202019,Smith; Laurie,0,3,32,32
1683719572300,BICD 100R,A03,202020,Smith; Laurie,0,1,32,32
1683719572300,BICD 100R,A04,202021,Smith; Laurie,6,0,32,26
1683719572300,BICD 100R,A05,202022,Smith; Laurie,10,0,32,22
1683719573331,BICD 136,A01,193242,Gustafson-Brown; Cindy,0,2,32,32
1683719573331,BICD 136,A02,193244,Gustafson-Brown; Cindy,13,0,32,19
1683719574366,BIEB 102,A01,193249,Butler; Shannon Rhey,0,0,32,32
1683719574366,BIEB 102,A02,193251,Butler; Shannon Rhey,0,0,32,32
1683719574366,BIEB 102,A03,193253,Butler; Shannon Rhey,0,0,32,32
1683719574366,BIEB 102,A04,193255,Butler; Shannon Rhey,13,0,32,19
1683719574366,BIEB 102,A05,193265,Butler; Shannon Rhey,25,0,32,7
1683719574366,BIEB 102,A06,193269,Butler; Shannon Rhey,12,0,32,20
1683719576418,BIEB 150,A01,193274,Staff,0,0,32,32
1683719576418,BIEB 150,A02,193285,Staff,24,0,32,8
1683719577445,BIEB 194,A00,193286,Kurle; Carolyn M.,19,0,32,13
1683719578472,BILD 1,A01,192291,Staff,15,0,32,17
1683719578472,BILD 1,A02,192292,Staff,30,0,32,2
1683719578472,BILD 1,B01,192520,Reuther; Keefe,0,1,0,0
1683719578472,BILD 1,B02,192532,Reuther; Keefe,0,1,0,0
1683719579502,BILD 3,A01,192556,Butler; Shannon Rhey,0,0,32,32
1683719579502,BILD 3,A02,192581,Butler; Shannon Rhey,0,1,32,32
1683719579502,BILD 3,A03,192611,Butler; Shannon Rhey,19,0,32,13
1683719579502,BILD 3,A04,192612,Butler; Shannon Rhey,23,0,32,9
1683719579502,BILD 3,A05,192613,Butler; Shannon Rhey,26,0,32,6
1683719579502,BILD 3,A06,192679,Butler; Shannon Rhey,27,0,32,5
1683719579502,BILD 3,A07,192682,Butler; Shannon Rhey,20,0,32,12
1683719580529,BILD 4,A01,192836,Reuther; Keefe,1,0,24,23
1683719580529,BILD 4,A02,193044,Reuther; Keefe,4,0,24,20
1683719581561,BILD 10,A01,193142,Gustafson-Brown; Cindy,29,0,32,3
1683719581561,BILD 10,A02,193149,Gustafson-Brown; Cindy,31,0,32,1
1683719582593,BIMM 100,A01,193301,Staff,0,6,32,32
1683719582593,BIMM 100,A02,193312,Staff,0,7,32,32
1683719582593,BIMM 100,A03,193323,Staff,0,10,32,32
1683719583644,BIMM 101,A01,193329,McDonnell; Lisa Marie,0,3,24,24
1683719583644,BIMM 101,A02,193339,McDonnell; Lisa Marie,0,3,24,24
1683719583644,BIMM 101,B01,193354,McDonnell; Lisa Marie,0,4,24,24
1683719583644,BIMM 101,B02,193357,McDonnell; Lisa Marie,0,3,24,24
1683719584671,BIMM 110,A01,193377,Tat; John,0,11,32,32
1683719584671,BIMM 110,A02,193378,Tat; John,0,11,32,32
1683719585706,BIMM 120,A01,206116,Staff,0,0,32,32
1683719585706,BIMM 120,A02,206117,Staff,7,0,32,25
1683719585706,BIMM 120,A03,206121,Staff,21,0,32,11
1683719586739,BIPN 100,A01,193393,Park; Ji Young,0,15,32,32
1683719586739,BIPN 100,A02,193402,Park; Ji Young,0,14,32,32
1683719586739,BIPN 100,A03,193413,Park; Ji Young,0,14,32,32
1683719586739,BIPN 100,A04,193414,Park; Ji Young,0,13,32,32
1683719587767,BIPN 102,A01,193429,Staff,0,0,32,32
1683719587767,BIPN 102,A02,193438,Staff,18,0,32,14
1683719588798,BIPN 106,A01,193450,Reyes Gonzalez; Catalina,0,2,40,40
1683719589826,BIPN 134,A01,193465,Cooke; James Edward,0,0,32,32
1683719589826,BIPN 134,A02,193474,Cooke; James Edward,25,0,32,7
1683719589826,BIPN 134,A03,193485,Cooke; James Edward,29,0,32,3
1683719589826,BIPN 134,A04,193486,Cooke; James Edward,20,0,32,12
1683719589826,BIPN 134,A05,193491,Cooke; James Edward,31,0,32,1
1683719589826,BIPN 134,A06,193501,Cooke; James Edward,30,0,32,2
1683719589826,BIPN 134,A07,193510,Cooke; James Edward,29,0,32,3
1683719591886,BISP 194,A00,222522,Staff,14,0,32,18
1683719592913,CAT 124,A01,202407,Staff,19,0,25,6
1683719593939,CAT 125,A00,202408,Marchisotto; Jennifer Anne,2,0,20,18
1683719594967,CAT 125R,A00,202409,Smith; Lauryn Alissa,0,11,20,20
1683719594967,CAT 125R,B00,202410,Morales; Celeste Georgianna,0,11,20,20
1683719594967,CAT 125R,C00,202411,Irwin; Matthew Joseph,0,12,20,20
1683719595995,CENG 15,A01,204712,Yang; Kesong,0,1,0,0
1683719597027,CENG 114,A00,202070,Jahed Motlagh; Zeinab,5,0,20,15
1683719598054,CGS 105,A00,185477,Wesling; Megan E.,24,0,40,16
1683719599082,CGS 106,A00,185494,Staff,11,0,22,11
1683719600109,CGS 108,A00,185495,Staff,14,0,20,6
1683719601137,CGS 114,A00,185496,Staff,13,0,18,5
1683719602164,CGS 119,A00,185501,Staff,15,0,20,5
1683719603188,CGS 120,A00,185511,Staff,11,0,20,9
1683719604215,CHEM 4,A01,184675,Bussey; Thomas J,97,0,100,3
1683719605242,CHEM 6A,A01,184677,Staff,32,0,60,28
1683719606267,CHEM 6B,A01,184679,Staff,63,0,100,37
1683719607296,CHEM 6C,A01,184681,Bussey; Thomas J,0,0,50,50
1683719607296,CHEM 6C,A02,184682,Bussey; Thomas J,32,0,50,18
1683719608329,CHEM 40A,A01,184684,Albizati; Kim F.,33,0,100,67
1683719609355,CHEM 40B,A01,184686,Albizati; Kim F.,0,22,100,100
1683719610379,CHEM 41B,A01,184690,Staff,51,0,100,49
1683719611406,COGS 3,A01,184715,Boyle; Mary E. T.,0,27,40,40
1683719612445,COGS 14B,A01,185172,Staff,0,14,38,38
1683719613476,COGS 18,A01,184736,Staff,14,0,80,66
1683719614506,COGS 100,A01,184932,Staff,0,8,73,73
1683719615533,COGS 101A,A01,184935,Staff,0,40,30,30
1683719616564,COGS 101B,A01,184944,Staff,0,2,30,30
1683719617590,COGS 101C,A01,184946,Staff,0,10,30,30
1683719618616,COGS 102A,A01,184951,Johnson; Christine M.,1,0,40,39
1683719619645,COGS 107B,A01,184953,Mooshagian; Eric Frederick,0,52,40,40
1683719620672,COGS 118B,A01,184959,Gupta; Anjum,0,50,40,40
1683719621698,COGS 153,A00,184961,Staff,1,16,30,29
1683719622724,COGS 177,A00,184962,Staff,0,20,30,30
1683719623750,COGS 187A,A01,184969,Boyle; Mary E. T.,0,19,40,40
1683719624778,COMM 10,A01,185174,Staff,0,5,25,25
1683719624778,COMM 10,A02,185189,Staff,0,2,25,25
1683719624778,COMM 10,A03,269821,Staff,0,1,0,0
1683719625813,COMM 100B,A02,185476,Staff,10,0,25,15
1683719625813,COMM 100B,A03,277340,Staff,25,0,25,0
1683719626843,COMM 100C,A01,185314,Staff,2,0,25,23
1683719626843,COMM 100C,A02,185327,Staff,17,0,25,8
1683719627869,COMM 110M,A00,185349,Staff,0,0,40,40
1683719628899,COMM 113T,A00,185352,Staff,25,0,40,15
1683719629927,COMM 114I,A00,185353,Staff,31,0,40,9
1683719630954,COMM 131,A00,185354,Staff,17,0,30,13
1683719631980,CSE 8A,A50,185358,Cao; Yingjun,0,46,10,10
1683719633066,CSE 8B,A01,185362,Staff,0,48,50,50
1683719634095,CSE 11,A01,185416,Cao; Yingjun,0,91,10,10
1683719635122,CSE 20,A01,185445,Briones; Jor-el Thomas Caparas,3,0,25,22
1683719636149,CSE 21,A01,185447,Staff,9,0,50,41
1683719637176,CSE 101,A01,185451,Staff,0,13,50,50
1683719637176,CSE 101,B01,185453,Jones; Miles E,0,15,50,50
1683719639230,CSE 141,A01,185458,Eldon; John,16,0,100,84
1683719640258,CSE 141L,A01,185461,Eldon; John,8,0,100,92
1683719641287,CSE 142,A01,185463,Staff,34,0,60,26
1683719641287,CSE 142,B01,201355,Staff,0,7,60,60
1683719642314,CSE 142L,A01,185470,Staff,34,0,60,26
1683719642314,CSE 142L,B01,201417,Staff,0,6,60,60
1683719643344,CSE 190,A00,201433,Staff,32,0,49,17
1683719644372,DOC 1,A01,259136,Strom; Megan C.,7,0,15,8
1683719644372,DOC 1,A02,259137,Strom; Megan C.,15,0,15,0
1683719644372,DOC 1,A03,259138,Strom; Megan C.,14,0,15,1
1683719644372,DOC 1,A04,259139,Strom; Megan C.,13,0,15,2
1683719645402,DOC 100D,A00,259140,Pass; Natalye Joann,14,0,25,11
1683719646430,DSGN 1,A01,184749,Rill; Bryan,0,26,30,30
1683719647454,DSGN 100,A01,185168,Staff,0,2,25,25
1683719648482,ECE 5,A01,185626,Morris; Karcher William,0,12,0,0
1683719649512,ECE 101,A01,185628,Staff,14,0,70,56
1683719650538,ECE 107,A01,185635,Baghdadchi; Saharnaz,0,0,20,20
1683719650538,ECE 107,A02,185638,Baghdadchi; Saharnaz,1,0,20,19
1683719651566,ECE 148,A01,185647,Silberman; Jack,0,0,16,16
1683719652592,ECON 1,A01,185537,Crane; Meredith Helen,54,0,70,16
1683719653623,ECON 3,A01,185549,Crane; Meredith Helen,30,0,70,40
1683719654650,ECON 4,A01,203354,Anderson; John Charles,0,5,10,10
1683719655679,ECON 100A,A01,185574,Staff,0,5,40,40
1683719656709,ECON 100B,A01,185576,Staff,0,12,50,50
1683719657740,ECON 100C,A01,185589,Newhouse; Herbert S,30,0,70,40
1683719658767,ECON 105,A00,185608,Vespa; Emanuel Ignacio,19,0,35,16
1683719659798,ECON 109,A01,185610,Shishkin; Denis,9,0,35,26
1683719660827,ECON 110A,A01,185612,Staff,8,0,40,32
1683719661850,ECON 120A,A01,185615,Staff,19,0,40,21
1683719662882,ECON 120C,A01,185617,Sun; Yixiao,0,21,70,70
1683719663909,ECON 144,A00,203346,Squires; Dale E,2,0,35,33
1683719664934,ECON 171,A01,203349,Newhouse; Herbert S,0,1,35,35
1683719665962,ECON 173A,A01,185621,Toda; Alexis Akira,21,0,35,14
1683719666993,EDS 25,A01,202413,Staff,0,1,0,0
1683719666993,EDS 25,A02,202414,Staff,0,1,0,0
1683719666993,EDS 25,A03,202415,Staff,0,0,0,0
1683719666993,EDS 25,A04,202416,Staff,0,1,0,0
1683719666993,EDS 25,A05,202439,Staff,0,0,0,0
1683719666993,EDS 25,A06,202440,Staff,0,0,0,0
1683719666993,EDS 25,B01,202631,Staff,0,0,0,0
1683719666993,EDS 25,B02,202632,Staff,0,0,0,0
1683719666993,EDS 25,B03,202639,Staff,0,0,0,0
1683719666993,EDS 25,B04,202640,Staff,0,0,0,0
1683719666993,EDS 25,B05,202643,Staff,0,0,0,0
1683719666993,EDS 25,B06,202644,Staff,0,0,0,0
1683719668020,EDS 38,A01,202659,Black; Alison Michelle,25,0,25,0
1683719669048,EDS 115,A00,202652,Staff,18,0,30,12
1683719670076,EDS 125,A00,202649,Staff,13,0,30,17
1683719671101,EDS 126,A01,203332,Staff,30,0,30,0
1683719672127,EDS 139,A00,202838,Staff,16,0,25,9
1683719673159,EDS 146,A01,202655,Staff,14,0,25,11
1683719674187,ENG 15,A00,185667,Staff,0,1,0,0
1683719674187,ENG 15,B00,185672,Staff,0,0,0,0
1683719674187,ENG 15,C00,185675,Staff,0,0,0,0
1683719674187,ENG 15,D00,185682,Staff,0,0,0,0
1683719674187,ENG 15,E00,185684,Staff,0,0,0,0
1683719675214,ETHN 103,A00,185710,Staff,0,8,35,35
1683719676241,ETHN 103A,A00,199228,Man; Simeon S,0,0,9,9
1683719677266,ETHN 109,A00,185711,Staff,15,0,35,20
1683719678295,ETHN 142,A00,185726,Staff,0,4,30,30
1683719679321,ETHN 163J,A00,199229,Man; Simeon S,5,0,8,3
1683719680349,ETHN 168,A00,185727,Staff,7,0,10,3
1683719681373,ETHN 182,A00,185728,Staff,0,0,35,35
1683719682401,ETHN 183,A00,185737,Staff,10,0,18,8
1683719683432,GLBH 111,A01,209361,Burgos; Jose L.,0,0,0,0
1683719685486,HIEU 104,A00,185792,Staff,14,0,20,6
1683719686513,HIEU 115,A00,185800,Staff,0,0,20,20
1683719687541,HIEU 128,A00,185801,Staff,0,9,20,20
1683719688566,HIEU 147,A00,185802,Staff,15,0,20,5
1683719689592,HIEU 154,A00,185823,Staff,11,0,20,9
1683719690618,HILA 102,A00,185826,Staff,14,0,20,6
1683719691643,HILD 2C,A01,185778,Staff,0,13,20,20
1683719692669,HILD 7B,A01,185780,Kwak; Nancy,0,17,32,32
1683719692669,HILD 7B,A02,185781,Kwak; Nancy,0,18,32,32
1683719693696,HILD 30,A01,185791,Staff,12,0,20,8
1683719694726,HISC 119,A00,185830,Golan; Tal,0,10,20,20
1683719695757,HITO 156GS,A00,185831,Patterson; Patrick H.,0,0,0,23
1683719696783,HIUS 103,A00,185832,Man; Simeon S,0,4,20,20
1683719697809,HIUS 117,A00,185836,Kwak; Nancy,2,0,20,18
1683719698839,HIUS 125,A00,185840,Man; Simeon S,0,2,23,23
1683719699866,HIUS 149,A00,185845,Staff,1,0,20,19
1683719700894,HUM 3,A01,185882,Zavodny; Tatiana Sophia,0,8,50,50
1683719700894,HUM 3,B01,185899,Caldwell; Michael Alan,0,18,50,50
1683719701922,HUM 3GS,A00,185900,Patterson; Patrick H.,0,0,0,23
1683719702949,HUM 4,A01,185938,Zroka; Amy Liane,28,0,50,22
1683719702949,HUM 4,B01,185956,Watkins; Eric,0,6,50,50
1683719702949,HUM 4,B02,202209,Watkins; Eric,0,6,50,50
1683719702949,HUM 4,B03,202210,Watkins; Eric,0,5,50,50
1683719703976,HUM 5,A01,185958,West; Geoffrey Scott,0,0,50,50
1683719703976,HUM 5,A02,202215,West; Geoffrey Scott,0,1,50,50
1683719705009,INTL 190,A00,185959,Gagnon; Jeffrey C,0,0,0,9
1683719705009,INTL 190,B00,185960,Lettieri; Michael Joseph,0,0,0,2
1683719706035,JAPN 180,A00,254509,Staff,5,0,30,25
1683719707069,LATI 10,A01,202853,Kennemore; Amy Michelle,4,0,35,31
1683719707069,LATI 10,A02,202854,Kennemore; Amy Michelle,3,0,35,32
1683719707069,LATI 10,A03,270054,Kennemore; Amy Michelle,30,0,30,0
1683719708095,LATI 180,A00,202855,Kennemore; Amy Michelle,11,0,20,9
1683719709126,LAWS 101,A00,201767,Golan; Tal,0,7,40,40
1683719710151,LIFR 1C,A00,185961,Staff,6,0,20,14
1683719711175,LIFR 1CX,A00,185962,Staff,7,0,20,13
1683719712199,LIFR 1D,A00,185963,Staff,7,0,20,13
1683719713226,LIFR 1DX,A00,185964,Staff,7,0,20,13
1683719714251,LIGN 101,A01,186039,Staff,43,0,50,7
1683719715277,LIGN 165,A00,186040,Staff,14,0,50,36
1683719716303,LTCS 108,A00,186041,Staff,5,0,10,5
1683719717329,LTCS 119,A00,186042,Staff,15,0,20,5
1683719718360,LTCS 130,A00,186043,Wesling; Megan E.,15,0,25,10
1683719720415,LTEA 138,A00,186119,Staff,14,0,40,26
1683719721443,LTEN 124,A00,186148,Staff,5,0,25,20
1683719722469,LTEN 178,A00,186149,Staff,6,0,15,9
1683719723498,LTEN 181,A00,186150,Blanco; John D,34,0,40,6
1683719724527,LTWL 120,A00,186160,Staff,19,0,25,6
1683719725553,LTWL 165,A00,186161,Staff,22,0,25,3
1683719726578,LTWR 100,A00,186162,Staff,0,5,15,15
1683719727609,LTWR 102,A00,186163,Doller; Ben,5,0,15,10
1683719728636,MAE 8,A01,186412,Staff,0,1,0,0
1683719729665,MAE 30B,A00,186445,Bahadori; Mohammad Yousef,81,0,100,19
1683719730693,MAE 40,A00,186592,Bewley; Thomas R,10,0,50,40
1683719731725,MAE 101B,A00,186593,Bahadori; Mohammad Yousef,80,0,100,20
1683719732755,MAE 105,A00,186594,Bandaru; Prabhakar,10,0,50,40
1683719733782,MAE 107,A00,186599,Pham; Hieu Tan,0,8,120,120
1683719734809,MAE 148,A01,186660,Silberman; Jack,3,0,16,13
1683719735841,MATH 10A,A01,188095,Staff,0,6,35,35
1683719736929,MATH 10B,A01,188097,Bowers; Adam R.,0,12,30,30
1683719736929,MATH 10B,A02,188099,Bowers; Adam R.,0,11,30,30
1683719736929,MATH 10B,B01,188104,Bowers; Adam R.,0,10,30,30
1683719736929,MATH 10B,B02,188106,Bowers; Adam R.,0,9,30,30
1683719737965,MATH 10C,A01,188111,Staff,0,20,30,30
1683719737965,MATH 10C,A02,188127,Staff,0,19,30,30
1683719737965,MATH 10C,A03,188131,Staff,0,19,30,30
1683719737965,MATH 10C,B01,188218,Staff,17,0,30,13
1683719737965,MATH 10C,B02,188244,Staff,13,0,30,17
1683719737965,MATH 10C,B03,188277,Staff,14,0,30,16
1683719738997,MATH 18,A01,188344,Bach; Quang Tran,18,0,30,12
1683719738997,MATH 18,A02,188345,Bach; Quang Tran,11,0,30,19
1683719738997,MATH 18,B01,188353,Bach; Quang Tran,11,0,30,19
1683719738997,MATH 18,B02,188354,Bach; Quang Tran,19,0,30,11
1683719740028,MATH 20A,A01,188374,Staff,11,0,35,24
1683719741055,MATH 20B,A01,188382,Ohm; Ko Woon,7,0,30,23
1683719741055,MATH 20B,A02,188383,Ohm; Ko Woon,22,0,30,8
1683719741055,MATH 20B,B01,188385,Ohm; Ko Woon,7,0,30,23
1683719741055,MATH 20B,B02,188392,Ohm; Ko Woon,22,0,30,8
1683719742082,MATH 20C,A01,188394,Harel; Guershon,10,0,30,20
1683719742082,MATH 20C,A02,188395,Harel; Guershon,13,0,30,17
1683719742082,MATH 20C,B01,188404,Harel; Guershon,5,0,30,25
1683719742082,MATH 20C,B02,188405,Harel; Guershon,18,0,30,12
1683719743113,MATH 20D,A01,188414,Hammock; Frances H,0,1,30,30
1683719743113,MATH 20D,A02,188415,Hammock; Frances H,0,1,30,30
1683719743113,MATH 20D,B01,188447,Hammock; Frances H,0,1,30,30
1683719743113,MATH 20D,B02,188486,Hammock; Frances H,2,0,30,28
1683719744142,MATH 20E,A01,188649,Staff,21,0,30,9
1683719744142,MATH 20E,A02,188650,Staff,20,0,30,10
1683719744142,MATH 20E,A03,188673,Staff,0,0,30,30
1683719745169,MATH 102,A01,188675,Staff,0,40,35,35
1683719746194,MATH 103B,A01,188681,Staff,3,0,35,32
1683719746194,MATH 103B,B01,188692,Staff,5,0,35,30
1683719747221,MATH 109,A01,188695,Salehi Golsefidy; Alireza,24,0,35,11
1683719747221,MATH 109,A02,188696,Salehi Golsefidy; Alireza,24,0,35,11
1683719748254,MATH 120A,A01,188698,Eggers; John Dietrich,7,0,35,28
1683719749280,MATH 142B,A01,188736,Ioana; Adrian,0,0,30,30
1683719749280,MATH 142B,A02,188741,Ioana; Adrian,0,1,30,30
1683719749280,MATH 142B,A03,188743,Ioana; Adrian,0,2,30,30
1683719750306,MATH 168A,A01,188790,Staff,0,11,35,35
1683719751334,MATH 170A,A01,188803,Nie; Jiawang,0,2,35,35
1683719751334,MATH 170A,A02,188811,Nie; Jiawang,0,1,35,35
1683719751334,MATH 170A,A03,188814,Nie; Jiawang,1,0,35,34
1683719751334,MATH 170A,A04,188815,Nie; Jiawang,5,0,35,30
1683719752363,MATH 193B,A01,188817,Staff,0,0,35,35
1683719752363,MATH 193B,A02,188818,Staff,6,0,35,29
1683719753389,MGT 4,A01,202857,Anderson; John Charles,59,0,80,21
1683719754427,MGT 12,A00,202858,Lindenberger; Wade Douglas,40,0,90,50
1683719755455,MGT 18,A00,202859,Staff,73,0,90,17
1683719756482,MGT 18GS,A00,202860,McKay; Michael J,13,0,28,15
1683719757509,MGT 45,A00,202861,Pecore; Joseph P.,8,0,90,82
1683719758534,MGT 100,A00,202863,Yavorsky; Daniel Ryan,27,0,90,63
1683719759564,MGT 103,A00,202864,Ehrich; Kristine R,0,19,90,90
1683719760590,MGT 112,A00,202865,Ehrich; Kristine R,15,0,90,75
1683719761618,MGT 121A,A00,202868,Staff,70,0,90,20
1683719762649,MGT 131B,A00,202869,Anderson; John Charles,58,0,90,32
1683719763675,MGT 136,A00,202871,Lindenberger; Wade Douglas,83,0,90,7
1683719764702,MGT 164,A00,202873,Staff,0,67,90,91
1683719765732,MGT 164GS,A00,202874,McKay; Mary A,13,0,28,15
1683719766757,MGT 180,A00,202875,Staff,0,51,90,91
1683719767787,MMW 11R,A01,205019,Herbst; Matthew,0,0,30,30
1683719767787,MMW 11R,A02,205026,Herbst; Matthew,29,0,30,1
1683719768813,MMW 15,A01,193512,Chang; Edmond Yi-Teh,0,8,28,28
1683719768813,MMW 15,A02,193513,Chang; Edmond Yi-Teh,0,5,28,28
1683719768813,MMW 15,A03,193514,Chang; Edmond Yi-Teh,0,5,28,28
1683719768813,MMW 15,A04,193515,Chang; Edmond Yi-Teh,0,5,28,28
1683719768813,MMW 15,A05,193516,Chang; Edmond Yi-Teh,0,5,28,28
1683719768813,MMW 15,A06,193517,Chang; Edmond Yi-Teh,0,6,28,28
1683719768813,MMW 15,B01,193519,Chang; Edmond Yi-Teh,0,5,28,28
1683719768813,MMW 15,B02,193520,Chang; Edmond Yi-Teh,0,5,28,28
1683719768813,MMW 15,B03,193521,Chang; Edmond Yi-Teh,0,5,28,28
1683719768813,MMW 15,B04,193522,Chang; Edmond Yi-Teh,0,6,28,28
1683719768813,MMW 15,B05,193523,Chang; Edmond Yi-Teh,0,5,28,28
1683719768813,MMW 15,B06,193524,Chang; Edmond Yi-Teh,0,5,28,28
1683719769839,MMW 122,A01,193526,Rahimi; Babak,0,16,28,28
1683719769839,MMW 122,A02,193527,Rahimi; Babak,0,15,28,28
1683719769839,MMW 122,A03,193528,Rahimi; Babak,0,0,0,0
1683719769839,MMW 122,A04,193529,Rahimi; Babak,0,0,0,0
1683719770866,MUS 1A,A01,186663,Staff,0,18,35,35
1683719771893,MUS 4,A01,186715,Staff,0,12,35,35
1683719772920,MUS 5R,A01,186796,Dubnov; Shlomo,0,17,35,35
1683719773950,MUS 6,A01,186798,Staff,0,4,25,25
1683719774980,MUS 7,A01,186830,Staff,11,0,35,24
1683719776010,MUS 8,A01,186930,Staff,0,27,35,35
1683719777037,MUS 15,A01,186932,Staff,0,15,35,35
1683719777037,MUS 15,B01,186934,Staff,0,16,35,35
1683719778064,MUS 80,A00,186935,Staff,0,0,20,20
1683719778064,MUS 80,B00,186936,Staff,24,0,25,1
1683719779094,NANO 11,A00,204702,Lipomi; Darren John,0,0,0,0
1683719780121,NANO 15,A01,204709,Yang; Kesong,0,1,0,0
1683719781146,NANO 114,A00,202069,Jahed Motlagh; Zeinab,2,0,10,8
1683719782175,PHIL 1,A00,186955,Grush; Rick Scott,31,0,40,9
1683719783203,PHIL 10,A01,186973,Grush; Rick Scott,27,0,35,8
1683719783203,PHIL 10,A02,186974,Grush; Rick Scott,33,0,35,2
1683719784234,PHIL 13,A01,186976,Staff,1,0,35,34
1683719784234,PHIL 13,A02,186977,Staff,16,0,35,19
1683719785263,PHIL 14,A01,186979,Staff,30,0,35,5
1683719785263,PHIL 14,A02,186986,Staff,32,0,35,3
1683719786294,PHIL 28,A01,186988,Staff,16,0,30,14
1683719786294,PHIL 28,A02,186989,Staff,0,0,30,30
1683719786294,PHIL 28,A03,186990,Staff,10,0,30,20
1683719786294,PHIL 28,A04,186991,Staff,26,0,30,4
1683719787326,PHIL 120,A00,186997,Staff,23,0,40,17
1683719788351,PHIL 137,A00,187003,Staff,8,0,40,32
1683719789378,PHIL 150,A00,187015,Staff,47,0,70,23
1683719790406,PHIL 167,A00,187021,Lamey; Andy M.,34,0,40,6
1683719791437,PHIL 174,A01,202226,Staff,17,0,20,3
1683719791437,PHIL 174,A02,202235,Staff,20,0,20,0
1683719792464,PHIL 191A,A00,258918,Staff,0,0,1,1
1683719793490,PHYS 1A,A00,187028,Staff,26,0,60,34
1683719794517,PHYS 1AL,001,187036,Staff,3,0,30,27
1683719794517,PHYS 1AL,002,187049,Staff,18,0,30,12
1683719795546,PHYS 1B,A00,187058,Staff,21,0,60,39
1683719796572,PHYS 1BL,001,187064,Staff,0,1,30,30
1683719796572,PHYS 1BL,002,187070,Staff,4,0,30,26
1683719797602,PHYS 1C,A00,187082,Staff,30,0,120,90
1683719798634,PHYS 1CL,001,187088,Staff,0,9,30,30
1683719798634,PHYS 1CL,002,187089,Staff,0,1,30,30
1683719798634,PHYS 1CL,009,262693,Staff,9,0,30,21
1683719799662,PHYS 2B,A01,187097,Staff,55,0,115,60
1683719800692,PHYS 2C,A01,187099,Staff,63,0,115,52
1683719801723,PHYS 2CL,A01,187101,Staff,5,0,28,23
1683719801723,PHYS 2CL,A02,187102,Staff,15,0,28,13
1683719802755,PHYS 2D,A01,187123,Shotwell; Brian,95,0,115,20
1683719803782,PHYS 4B,A01,187133,Grinstein; Benjamin,35,0,50,15
1683719804809,POLI 10,A00,188819,Staff,0,4,50,50
1683719805835,POLI 11,A00,188827,Staff,43,0,50,7
1683719806863,POLI 13R,A00,188828,Staff,0,2,20,20
1683719807894,POLI 27,A01,188830,Elgin; Samuel Zincke,0,2,70,70
1683719808921,POLI 30,A00,188832,Desposato; Scott,30,0,50,20
1683719809945,POLI 102F,A00,188834,Staff,1,0,40,39
1683719810975,POLI 104A,A00,188852,Staff,12,0,30,18
1683719812002,POLI 104I,A00,188853,Staff,0,8,20,20
1683719813029,POLI 110B,A00,188854,Wiens; David,6,0,20,14
1683719814059,POLI 112A,A00,188855,Wiens; David,3,0,30,27
1683719815090,POLI 117R,A00,188856,Forman; Fonna,0,12,20,20
1683719816117,POLI 118,A00,188857,Ingham; Sean,8,0,20,12
1683719817148,POLI 120G,A00,188858,Staff,7,0,30,23
1683719818179,POLI 131CR,A00,188863,Hoston; Germaine,20,0,50,30
1683719819204,POLI 133,A00,188864,Nellis; Gareth Hb,44,0,50,6
1683719820229,POLI 134D,A00,188865,Desposato; Scott,27,0,30,3
1683719821259,POLI 142A,A00,188871,Gartzke; Erik,21,0,50,29
1683719822285,POLI 142K,A00,188874,Staff,38,0,50,12
1683719823313,POLI 143,A00,188940,Gartzke; Erik,15,0,30,15
1683719824341,POLI 153,A00,188943,Staff,1,0,20,19
1683719825369,POLI 160AA,A00,188944,Staff,10,0,40,30
1683719826394,POLI 170A,A00,188945,Staff,10,0,30,20
1683719828445,PSYC 1,A00,188952,Staff,36,0,90,54
1683719829474,PSYC 2,B00,188953,Staff,19,0,35,16
1683719830500,PSYC 6,A00,188970,Staff,47,0,60,13
1683719831527,PSYC 7,A00,188973,Staff,35,0,45,10
1683719832554,PSYC 60,A01,188980,Rickard; Timothy C.,42,0,60,18
1683719833586,PSYC 70,A01,189001,Steiner; Eric Tomas,22,0,45,23
1683719834612,PSYC 100,A00,189005,Lacefield; Katharine I,1,98,120,119
1683719835639,PSYC 102,A00,189008,Staff,6,0,30,24
1683719836664,PSYC 106,B00,189026,Gorman; Michael R.,27,0,60,33
1683719837695,PSYC 114,B01,189033,Winkielman; Piotr,0,31,30,30
1683719838726,PSYC 131,A00,189036,Anagnostaras; Stephan,0,44,60,60
1683719839754,PSYC 136,A00,189041,Lowe; Angela Beth,0,7,25,25
1683719840841,PSYC 137,A00,189057,Winkielman; Piotr,0,36,25,25
1683719841870,PSYC 144,A00,189107,Wixted; John T,0,11,50,50
1683719843921,PSYC 162,A00,189142,Staff,0,9,85,85
1683719844949,PSYC 172,A00,189144,Gorman; Michael R.,0,6,30,30
1683719847008,PSYC 179,A00,189146,Lacefield; Katharine I,0,88,120,120
1683719848034,PSYC 181,A00,189147,Anagnostaras; Stephan,0,45,90,90
1683719849061,PSYC 190R,A00,189148,Barner; David A.,0,23,80,80
1683719850090,PSYC 191,A00,189275,Rickard; Timothy C.,0,11,25,25
1683719851121,PSYC 193,A00,189276,Chapman; Eddie Nathaniel,0,1,0,4
1683719852153,PSYC 193L,A01,189281,Lowe; Angela Beth,8,0,20,12
1683719852153,PSYC 193L,B01,189285,Staff,28,0,35,7
1683719853178,RELI 149,A00,187137,Rahimi; Babak,6,0,40,34
1683719854204,SE 9,A01,187315,Staff,0,2,18,18
1683719855231,SE 101B,A00,187409,Staff,24,0,30,6
1683719856261,SE 110B,A00,187444,Staff,10,0,40,30
1683719857288,SE 130B,A00,187449,Staff,31,0,40,9
1683719858314,SE 150A,A00,187516,Staff,8,0,20,12
1683719859339,SE 154,A00,187528,Staff,29,0,50,21
1683719860365,SIO 3,A01,258171,Staff,35,0,40,5
1683719861395,SIO 10,A00,187144,Cook; Geoffrey W,0,6,75,75
1683719862421,SIO 45,A00,187152,Cook; Geoffrey W,1,7,100,99
1683719863450,SIO 109R,A00,194486,Staff,0,4,20,20
1683719865505,SIO 187,A01,187233,Kacev; David,12,0,40,28
1683719866541,SOCI 1,A01,258656,Thorpe; Charles Robert,28,0,30,2
1683719866541,SOCI 1,A02,258658,Thorpe; Charles Robert,30,0,30,0
1683719866541,SOCI 1,A03,258661,Thorpe; Charles Robert,25,0,25,0
1683719866541,SOCI 1,A04,258666,Thorpe; Charles Robert,22,0,25,3
1683719866541,SOCI 1,A05,258897,Thorpe; Charles Robert,22,0,25,3
1683719866541,SOCI 1,A06,258898,Thorpe; Charles Robert,25,0,25,0
1683719867568,SOCI 30,A01,258903,Pardo Guerra; Juan Pablo,14,0,30,16
1683719868594,SOCI 102,A00,258904,Staff,9,0,25,16
1683719869623,SOCI 106,A00,258905,Staff,19,0,25,6
1683719870650,SOCI 111,A00,258907,Ribas Norris; Janet Vanesa,26,0,30,4
1683719871676,SOCI 121R,A00,258908,Pardo Guerra; Juan Pablo,7,0,30,23
1683719872703,SOCI 126,A01,203330,Staff,14,0,20,6
1683719873732,SOCI 131,A00,258909,Thorpe; Charles Robert,30,0,60,30
1683719874759,SOCI 135,A00,258910,Payne; Christine Anna,0,13,30,30
1683719875785,SOCI 157,A00,258911,Staff,10,0,30,20
1683719876814,SOCI 184,A00,258912,Staff,25,0,30,5
1683719877839,SOCI 188D,A00,258913,Staff,22,0,30,8
1683719878866,SYN 2,001,187529,Staff,9,0,16,7
1683719878866,SYN 2,002,201452,Staff,0,20,16,16
1683719878866,SYN 2,003,201469,Staff,1,0,16,15
1683719879892,SYN 100,A01,187531,Staff,0,9,20,20
1683719879892,SYN 100,B01,201491,Staff,0,10,20,20
1683719880920,TDAC 1,A00,189286,Walsh; Kim C.,3,0,20,17
1683719880920,TDAC 1,B00,189287,Harting; Carla Kelso,10,0,20,10
1683719881944,TDAC 101,A00,189300,Walsh; Kim C.,16,0,20,4
1683719881944,TDAC 101,B00,189301,Harting; Carla Kelso,18,0,20,2
1683719882975,TDAC 102,A00,189304,Basso; Beatrice,14,0,20,6
1683719884003,TDAC 108,A00,189305,Staff,18,0,20,2
1683719885031,TDDE 131,A00,189310,Staff,19,0,20,1
1683719885031,TDDE 131,B00,189314,Staff,19,0,20,1
1683719885031,TDDE 131,C00,189315,Staff,48,0,50,2
1683719885031,TDDE 131,D00,189316,Staff,14,0,15,1
1683719885031,TDDE 131,E00,204841,Staff,20,0,20,0
1683719886056,TDGE 10,A00,189289,Staff,26,0,50,24
1683719886056,TDGE 10,B00,189290,Havis; Allan,0,1,50,50
1683719887087,TDGE 11,A00,189291,Fulton; Julia,0,4,50,50
1683719887087,TDGE 11,B00,189292,Staff,20,0,25,5
1683719887087,TDGE 11,C00,260270,Staff,0,0,0,0
1683719888113,TDGE 25,A00,189294,Staff,1,0,20,19
1683719889142,TDGE 124,A00,189318,Fulton; Julia,0,7,50,50
1683719890166,TDGE 125,A00,189319,Staff,13,0,25,12
1683719890166,TDGE 125,B00,189320,Staff,23,0,25,2
1683719891191,TDGE 127,A00,189322,Havis; Allan,1,0,50,49
1683719892221,TDHT 101,A00,189323,Staff,18,0,25,7
1683719892221,TDHT 101,B00,189324,Staff,25,0,25,0
1683719893252,TDHT 102,A00,189325,Staff,49,0,50,1
1683719894280,TDMV 1,A00,189295,Arcidiacono; Kristin,20,0,30,10
1683719894280,TDMV 1,B00,189296,Caligagan; Maria T.,23,0,30,7
1683719895311,TDMV 2,A00,189297,Sammartano; Tonnie,27,0,30,3
1683719895311,TDMV 2,B00,189299,Arcidiacono; Kristin,23,0,30,7
1683719896338,TDMV 3,A00,204998,Rincon; Alicia,22,0,30,8
1683719897368,TDMV 120,A00,189458,Sammartano; Tonnie,28,0,30,2
1683719898395,TDMV 138,A00,189541,Jun; Grace Shin Hae,20,0,40,20
1683719899421,TDMV 142,A00,189717,Caligagan; Tony,25,0,30,5
1683719899421,TDMV 142,B00,189718,Caligagan; Maria T.,25,0,30,5
1683719900453,TMC 2,A01,187533,Staff,25,0,25,0
1683719900453,TMC 2,A02,187534,Staff,25,0,25,0
1683719901485,USP 1,A01,187536,Kwak; Nancy,0,16,25,25
1683719902516,USP 5,A01,187538,Staff,8,0,25,17
1683719903546,USP 101,A00,199253,Staff,0,4,0,0
1683719904576,USP 124,A00,187562,Boomhower; Matthew Charles,0,0,30,30
1683719905603,USP 138,A00,187582,Staff,19,0,25,6
1683719906632,USP 152,A01,187597,Staff,3,0,25,22
1683719907658,USP 153,A00,187598,Staff,18,0,25,7
1683719908690,USP 168,A00,187607,Kwak; Nancy,2,0,5,3
1683719909716,USP 173,A00,187619,Staff,4,0,25,21
1683719910742,USP 181,A00,187638,Staff,0,4,25,25
1683719911771,VIS 103,A00,187650,Cruz; Edwin Teddy,17,0,75,58
1683719912799,VIS 110D,A00,187669,Staff,13,0,22,9
1683719913834,VIS 127C,A00,187720,Shen; Kuiyi,67,0,146,79
1683719914863,VIS 149,A00,187731,Yoldas; Pinar,0,12,22,22
1683719915889,VIS 151,A01,188091,Staff,22,0,34,12
1683719915889,VIS 151,A02,188092,Staff,11,0,34,23
1683719916919,VIS 160B,A00,188093,Stalbaum; Brett,0,1,10,10
1683719918972,WCWP 10B,A00,201720,Staff,0,0,5,5
1683719918972,WCWP 10B,B00,201722,Staff,0,0,6,6
1683719920001,WCWP 100,A00,201725,Gagnon; Jeffrey C,0,0,2,2
1683719920001,WCWP 100,B00,201727,Staff,0,4,15,15
1683719923134,ANBI 133,A00,258401,Wilder; Linnea Lorene,34,0,40,6
1683719924161,ANBI 140,A00,258395,Hrvoj Mihic; Branka,18,0,25,7
1683719925187,ANSC 120,A00,258402,Bialecki; Jon Anthony,26,0,40,14
1683719926212,ANSC 144,A00,258400,Staff,12,0,40,28
1683719928265,ANSC 166,A00,258396,Parish; Steven Martin,156,0,175,19
1683719929296,ANSC 180,A00,193533,Staff,8,0,20,12
1683719930328,ANSC 188,A00,258397,Jassal; Aftab,34,0,40,6
1683719931355,ANTH 3,A01,258316,Staff,23,0,30,7
1683719932386,ANTH 5,A00,258394,Semendeferi; Ekaterini,16,0,20,4
1683719933411,ANTH 21,A01,258331,Staff,4,0,40,36
1683719934437,ANTH 103,A00,258398,Varma; Saiba,15,0,25,10
1683719935477,AWP 10,001,202034,Staff,0,0,0,0
1683719935477,AWP 10,002,202035,Staff,0,0,0,0
1683719935477,AWP 10,003,202036,Staff,0,0,0,0
1683719935477,AWP 10,004,202037,Staff,0,0,0,0
1683719935477,AWP 10,005,202038,Staff,0,0,0,0
1683719935477,AWP 10,006,202039,Staff,0,0,0,0
1683719935477,AWP 10,007,202040,Staff,0,0,0,0
1683719935477,AWP 10,008,202041,Staff,0,0,0,0
1683719935477,AWP 10,009,202042,Staff,0,0,0,0
1683719935477,AWP 10,010,202043,Staff,0,0,0,0
1683719935477,AWP 10,011,202044,Staff,0,0,0,0
1683719935477,AWP 10,012,202045,Staff,0,0,0,0
1683719935477,AWP 10,013,202046,Staff,0,0,0,0
1683719935477,AWP 10,014,202047,Staff,0,0,0,0
1683719935477,AWP 10,015,202048,Staff,0,0,0,0
1683719935477,AWP 10,016,202049,Staff,0,0,0,0
1683719935477,AWP 10,017,202050,Staff,0,0,0,0
1683719935477,AWP 10,018,202051,Staff,0,0,0,0
1683719935477,AWP 10,019,202052,Staff,0,0,0,0
1683719935477,AWP 10,020,202053,Staff,0,0,0,0
1683719935477,AWP 10,021,202054,Staff,0,0,0,0
1683719935477,AWP 10,022,202055,Staff,0,0,0,0
1683719935477,AWP 10,023,202056,Staff,0,0,0,0
1683719935477,AWP 10,024,202057,Staff,0,0,0,0
1683719935477,AWP 10,025,202058,Staff,0,0,0,0
1683719935477,AWP 10,026,202059,Staff,0,0,0,0
1683719936507,AWP 102,001,202032,Staff,0,0,0,0
1683719936507,AWP 102,002,202033,Staff,0,0,0,0
1683719937541,BENG 100,A01,254234,Taylor Amos; Alyssa C,31,0,40,9
1683719938569,BENG 196,001,270013,Engler; Adam J.,9999,0,9999,0
1683719939597,BICD 100R,A01,202018,Smith; Laurie,0,7,32,32
1683719939597,BICD 100R,A02,202019,Smith; Laurie,0,3,32,32
1683719939597,BICD 100R,A03,202020,Smith; Laurie,0,1,32,32
1683719939597,BICD 100R,A04,202021,Smith; Laurie,6,0,32,26
1683719939597,BICD 100R,A05,202022,Smith; Laurie,10,0,32,22
1683719940629,BICD 136,A01,193242,Gustafson-Brown; Cindy,0,2,32,32
1683719940629,BICD 136,A02,193244,Gustafson-Brown; Cindy,13,0,32,19
1683719941662,BIEB 102,A01,193249,Butler; Shannon Rhey,0,0,32,32
1683719941662,BIEB 102,A02,193251,Butler; Shannon Rhey,0,0,32,32
1683719941662,BIEB 102,A03,193253,Butler; Shannon Rhey,0,0,32,32
1683719941662,BIEB 102,A04,193255,Butler; Shannon Rhey,13,0,32,19
1683719941662,BIEB 102,A05,193265,Butler; Shannon Rhey,25,0,32,7
1683719941662,BIEB 102,A06,193269,Butler; Shannon Rhey,12,0,32,20
1683719943719,BIEB 150,A01,193274,Staff,0,0,32,32
1683719943719,BIEB 150,A02,193285,Staff,24,0,32,8
1683719944818,BIEB 194,A00,193286,Kurle; Carolyn M.,19,0,32,13
1683719945851,BILD 1,A01,192291,Staff,15,0,32,17
1683719945851,BILD 1,A02,192292,Staff,30,0,32,2
1683719945851,BILD 1,B01,192520,Reuther; Keefe,0,1,0,0
1683719945851,BILD 1,B02,192532,Reuther; Keefe,0,1,0,0
1683719946882,BILD 3,A01,192556,Butler; Shannon Rhey,0,0,32,32
1683719946882,BILD 3,A02,192581,Butler; Shannon Rhey,0,1,32,32
1683719946882,BILD 3,A03,192611,Butler; Shannon Rhey,19,0,32,13
1683719946882,BILD 3,A04,192612,Butler; Shannon Rhey,23,0,32,9
1683719946882,BILD 3,A05,192613,Butler; Shannon Rhey,26,0,32,6
1683719946882,BILD 3,A06,192679,Butler; Shannon Rhey,27,0,32,5
1683719946882,BILD 3,A07,192682,Butler; Shannon Rhey,20,0,32,12
1683719947910,BILD 4,A01,192836,Reuther; Keefe,1,0,24,23
1683719947910,BILD 4,A02,193044,Reuther; Keefe,4,0,24,20
1683719948938,BILD 10,A01,193142,Gustafson-Brown; Cindy,29,0,32,3
1683719948938,BILD 10,A02,193149,Gustafson-Brown; Cindy,31,0,32,1
1683719949966,BIMM 100,A01,193301,Staff,0,6,32,32
1683719949966,BIMM 100,A02,193312,Staff,0,7,32,32
1683719949966,BIMM 100,A03,193323,Staff,0,10,32,32
1683719950995,BIMM 101,A01,193329,McDonnell; Lisa Marie,0,3,24,24
1683719950995,BIMM 101,A02,193339,McDonnell; Lisa Marie,0,3,24,24
1683719950995,BIMM 101,B01,193354,McDonnell; Lisa Marie,0,4,24,24
1683719950995,BIMM 101,B02,193357,McDonnell; Lisa Marie,0,3,24,24
1683719952026,BIMM 110,A01,193377,Tat; John,0,11,32,32
1683719952026,BIMM 110,A02,193378,Tat; John,0,11,32,32
1683719953060,BIMM 120,A01,206116,Staff,0,0,32,32
1683719953060,BIMM 120,A02,206117,Staff,7,0,32,25
1683719953060,BIMM 120,A03,206121,Staff,21,0,32,11
1683719954087,BIPN 100,A01,193393,Park; Ji Young,0,15,32,32
1683719954087,BIPN 100,A02,193402,Park; Ji Young,0,14,32,32
1683719954087,BIPN 100,A03,193413,Park; Ji Young,0,14,32,32
1683719954087,BIPN 100,A04,193414,Park; Ji Young,0,13,32,32
1683719955113,BIPN 102,A01,193429,Staff,0,0,32,32
1683719955113,BIPN 102,A02,193438,Staff,18,0,32,14
1683719956141,BIPN 106,A01,193450,Reyes Gonzalez; Catalina,0,2,40,40
1683719957176,BIPN 134,A01,193465,Cooke; James Edward,0,0,32,32
1683719957176,BIPN 134,A02,193474,Cooke; James Edward,25,0,32,7
1683719957176,BIPN 134,A03,193485,Cooke; James Edward,29,0,32,3
1683719957176,BIPN 134,A04,193486,Cooke; James Edward,20,0,32,12
1683719957176,BIPN 134,A05,193491,Cooke; James Edward,31,0,32,1
1683719957176,BIPN 134,A06,193501,Cooke; James Edward,30,0,32,2
1683719957176,BIPN 134,A07,193510,Cooke; James Edward,29,0,32,3
1683719959232,BISP 194,A00,222522,Staff,14,0,32,18
1683719960259,CAT 124,A01,202407,Staff,19,0,25,6
1683719961287,CAT 125,A00,202408,Marchisotto; Jennifer Anne,2,0,20,18
1683719962321,CAT 125R,A00,202409,Smith; Lauryn Alissa,0,11,20,20
1683719962321,CAT 125R,B00,202410,Morales; Celeste Georgianna,0,11,20,20
1683719962321,CAT 125R,C00,202411,Irwin; Matthew Joseph,0,12,20,20
1683719963350,CENG 15,A01,204712,Yang; Kesong,0,1,0,0
1683719964377,CENG 114,A00,202070,Jahed Motlagh; Zeinab,5,0,20,15
1683719965409,CGS 105,A00,185477,Wesling; Megan E.,24,0,40,16
1683719966432,CGS 106,A00,185494,Staff,11,0,22,11
1683719967457,CGS 108,A00,185495,Staff,14,0,20,6
1683719968483,CGS 114,A00,185496,Staff,13,0,18,5
1683719969511,CGS 119,A00,185501,Staff,15,0,20,5
1683719970537,CGS 120,A00,185511,Staff,11,0,20,9
1683719971565,CHEM 4,A01,184675,Bussey; Thomas J,97,0,100,3
1683719972594,CHEM 6A,A01,184677,Staff,32,0,60,28
1683719973625,CHEM 6B,A01,184679,Staff,63,0,100,37
1683719974651,CHEM 6C,A01,184681,Bussey; Thomas J,0,0,50,50
1683719974651,CHEM 6C,A02,184682,Bussey; Thomas J,32,0,50,18
1683719975681,CHEM 40A,A01,184684,Albizati; Kim F.,33,0,100,67
1683719976707,CHEM 40B,A01,184686,Albizati; Kim F.,0,22,100,100
1683719977735,CHEM 41B,A01,184690,Staff,51,0,100,49
1683719978760,COGS 3,A01,184715,Boyle; Mary E. T.,0,27,40,40
1683719979786,COGS 14B,A01,185172,Staff,0,14,38,38
1683719980813,COGS 18,A01,184736,Staff,14,0,80,66
1683719981844,COGS 100,A01,184932,Staff,0,8,73,73
1683719982873,COGS 101A,A01,184935,Staff,0,40,30,30
1683719983903,COGS 101B,A01,184944,Staff,0,2,30,30
1683719984933,COGS 101C,A01,184946,Staff,0,10,30,30
1683719985965,COGS 102A,A01,184951,Johnson; Christine M.,1,0,40,39
1683719986998,COGS 107B,A01,184953,Mooshagian; Eric Frederick,0,52,40,40
1683719988024,COGS 118B,A01,184959,Gupta; Anjum,0,50,40,40
1683719989050,COGS 153,A00,184961,Staff,1,16,30,29
1683719990080,COGS 177,A00,184962,Staff,0,20,30,30
1683719991109,COGS 187A,A01,184969,Boyle; Mary E. T.,0,19,40,40
1683719992135,COMM 10,A01,185174,Staff,0,5,25,25
1683719992135,COMM 10,A02,185189,Staff,0,2,25,25
1683719992135,COMM 10,A03,269821,Staff,0,1,0,0
1683719993163,COMM 100B,A02,185476,Staff,10,0,25,15
1683719993163,COMM 100B,A03,277340,Staff,25,0,25,0
1683719994195,COMM 100C,A01,185314,Staff,2,0,25,23
1683719994195,COMM 100C,A02,185327,Staff,17,0,25,8
1683719995220,COMM 110M,A00,185349,Staff,0,0,40,40
1683719996247,COMM 113T,A00,185352,Staff,25,0,40,15
1683719997275,COMM 114I,A00,185353,Staff,31,0,40,9
1683719998302,COMM 131,A00,185354,Staff,17,0,30,13
1683719999336,CSE 8A,A50,185358,Cao; Yingjun,0,46,10,10
1683720000361,CSE 8B,A01,185362,Staff,0,48,50,50
1683720001389,CSE 11,A01,185416,Cao; Yingjun,0,91,10,10
1683720002419,CSE 20,A01,185445,Briones; Jor-el Thomas Caparas,3,0,25,22
1683720003453,CSE 21,A01,185447,Staff,9,0,50,41
1683720004486,CSE 101,A01,185451,Staff,0,13,50,50
1683720004486,CSE 101,B01,185453,Jones; Miles E,0,15,50,50
1683720006536,CSE 141,A01,185458,Eldon; John,16,0,100,84
1683720007560,CSE 141L,A01,185461,Eldon; John,8,0,100,92
1683720008590,CSE 142,A01,185463,Staff,34,0,60,26
1683720008590,CSE 142,B01,201355,Staff,0,7,60,60
1683720009616,CSE 142L,A01,185470,Staff,34,0,60,26
1683720009616,CSE 142L,B01,201417,Staff,0,6,60,60
1683720010643,CSE 190,A00,201433,Staff,32,0,49,17
1683720011669,DOC 1,A01,259136,Strom; Megan C.,7,0,15,8
1683720011669,DOC 1,A02,259137,Strom; Megan C.,15,0,15,0
1683720011669,DOC 1,A03,259138,Strom; Megan C.,14,0,15,1
1683720011669,DOC 1,A04,259139,Strom; Megan C.,13,0,15,2
1683720012694,DOC 100D,A00,259140,Pass; Natalye Joann,14,0,25,11
1683720013720,DSGN 1,A01,184749,Rill; Bryan,0,26,30,30
1683720014746,DSGN 100,A01,185168,Staff,0,2,25,25
1683720015774,ECE 5,A01,185626,Morris; Karcher William,0,12,0,0
1683720016799,ECE 101,A01,185628,Staff,14,0,70,56
1683720017829,ECE 107,A01,185635,Baghdadchi; Saharnaz,0,0,20,20
1683720017829,ECE 107,A02,185638,Baghdadchi; Saharnaz,1,0,20,19
1683720018858,ECE 148,A01,185647,Silberman; Jack,0,0,16,16
1683720019884,ECON 1,A01,185537,Crane; Meredith Helen,54,0,70,16
1683720020914,ECON 3,A01,185549,Crane; Meredith Helen,30,0,70,40
1683720021943,ECON 4,A01,203354,Anderson; John Charles,0,5,10,10
1683720022968,ECON 100A,A01,185574,Staff,0,5,40,40
1683720023998,ECON 100B,A01,185576,Staff,0,12,50,50
1683720025027,ECON 100C,A01,185589,Newhouse; Herbert S,30,0,70,40
1683720026056,ECON 105,A00,185608,Vespa; Emanuel Ignacio,19,0,35,16
1683720027085,ECON 109,A01,185610,Shishkin; Denis,9,0,35,26
1683720028114,ECON 110A,A01,185612,Staff,8,0,40,32
1683720029138,ECON 120A,A01,185615,Staff,19,0,40,21
1683720030168,ECON 120C,A01,185617,Sun; Yixiao,0,21,70,70
1683720031194,ECON 144,A00,203346,Squires; Dale E,2,0,35,33
1683720032221,ECON 171,A01,203349,Newhouse; Herbert S,0,1,35,35
1683720033252,ECON 173A,A01,185621,Toda; Alexis Akira,21,0,35,14
1683720034278,EDS 25,A01,202413,Staff,0,1,0,0
1683720034278,EDS 25,A02,202414,Staff,0,1,0,0
1683720034278,EDS 25,A03,202415,Staff,0,0,0,0
1683720034278,EDS 25,A04,202416,Staff,0,1,0,0
1683720034278,EDS 25,A05,202439,Staff,0,0,0,0
1683720034278,EDS 25,A06,202440,Staff,0,0,0,0
1683720034278,EDS 25,B01,202631,Staff,0,0,0,0
1683720034278,EDS 25,B02,202632,Staff,0,0,0,0
1683720034278,EDS 25,B03,202639,Staff,0,0,0,0
1683720034278,EDS 25,B04,202640,Staff,0,0,0,0
1683720034278,EDS 25,B05,202643,Staff,0,0,0,0
1683720034278,EDS 25,B06,202644,Staff,0,0,0,0
1683720035305,EDS 38,A01,202659,Black; Alison Michelle,25,0,25,0
1683720036330,EDS 115,A00,202652,Staff,18,0,30,12
1683720037358,EDS 125,A00,202649,Staff,13,0,30,17
1683720038387,EDS 126,A01,203332,Staff,30,0,30,0
1683720039416,EDS 139,A00,202838,Staff,16,0,25,9
1683720040442,EDS 146,A01,202655,Staff,14,0,25,11
1683720041467,ENG 15,A00,185667,Staff,0,1,0,0
1683720041467,ENG 15,B00,185672,Staff,0,0,0,0
1683720041467,ENG 15,C00,185675,Staff,0,0,0,0
1683720041467,ENG 15,D00,185682,Staff,0,0,0,0
1683720041467,ENG 15,E00,185684,Staff,0,0,0,0
1683720042491,ETHN 103,A00,185710,Staff,0,8,35,35
1683720043519,ETHN 103A,A00,199228,Man; Simeon S,0,0,9,9
1683720044544,ETHN 109,A00,185711,Staff,15,0,35,20
1683720045570,ETHN 142,A00,185726,Staff,0,4,30,30
1683720046602,ETHN 163J,A00,199229,Man; Simeon S,5,0,8,3
1683720047634,ETHN 168,A00,185727,Staff,7,0,10,3
1683720048717,ETHN 182,A00,185728,Staff,0,0,35,35
1683720049744,ETHN 183,A00,185737,Staff,10,0,18,8
1683720050772,GLBH 111,A01,209361,Burgos; Jose L.,0,0,0,0
1683720052827,HIEU 104,A00,185792,Staff,14,0,20,6
1683720053854,HIEU 115,A00,185800,Staff,0,0,20,20
1683720054877,HIEU 128,A00,185801,Staff,0,9,20,20
1683720055902,HIEU 147,A00,185802,Staff,15,0,20,5
1683720056927,HIEU 154,A00,185823,Staff,11,0,20,9
1683720057954,HILA 102,A00,185826,Staff,14,0,20,6
1683720058980,HILD 2C,A01,185778,Staff,0,13,20,20
1683720060010,HILD 7B,A01,185780,Kwak; Nancy,0,17,32,32
1683720060010,HILD 7B,A02,185781,Kwak; Nancy,0,18,32,32
1683720061037,HILD 30,A01,185791,Staff,12,0,20,8
1683720062065,HISC 119,A00,185830,Golan; Tal,0,10,20,20
1683720063093,HITO 156GS,A00,185831,Patterson; Patrick H.,0,0,0,23
1683720064119,HIUS 103,A00,185832,Man; Simeon S,0,4,20,20
1683720065145,HIUS 117,A00,185836,Kwak; Nancy,2,0,20,18
1683720066171,HIUS 125,A00,185840,Man; Simeon S,0,2,23,23
1683720067202,HIUS 149,A00,185845,Staff,1,0,20,19
1683720068230,HUM 3,A01,185882,Zavodny; Tatiana Sophia,0,8,50,50
1683720068230,HUM 3,B01,185899,Caldwell; Michael Alan,0,18,50,50
1683720069259,HUM 3GS,A00,185900,Patterson; Patrick H.,0,0,0,23
1683720070289,HUM 4,A01,185938,Zroka; Amy Liane,28,0,50,22
1683720070289,HUM 4,B01,185956,Watkins; Eric,0,6,50,50
1683720070289,HUM 4,B02,202209,Watkins; Eric,0,6,50,50
1683720070289,HUM 4,B03,202210,Watkins; Eric,0,5,50,50
1683720071321,HUM 5,A01,185958,West; Geoffrey Scott,0,0,50,50
1683720071321,HUM 5,A02,202215,West; Geoffrey Scott,0,1,50,50
1683720072350,INTL 190,A00,185959,Gagnon; Jeffrey C,0,0,0,9
1683720072350,INTL 190,B00,185960,Lettieri; Michael Joseph,0,0,0,2
1683720073380,JAPN 180,A00,254509,Staff,5,0,30,25
1683720074412,LATI 10,A01,202853,Kennemore; Amy Michelle,4,0,35,31
1683720074412,LATI 10,A02,202854,Kennemore; Amy Michelle,3,0,35,32
1683720074412,LATI 10,A03,270054,Kennemore; Amy Michelle,30,0,30,0
1683720075442,LATI 180,A00,202855,Kennemore; Amy Michelle,11,0,20,9
1683720076471,LAWS 101,A00,201767,Golan; Tal,0,7,40,40
1683720077498,LIFR 1C,A00,185961,Staff,6,0,20,14
1683720078533,LIFR 1CX,A00,185962,Staff,7,0,20,13
1683720079561,LIFR 1D,A00,185963,Staff,7,0,20,13
1683720080588,LIFR 1DX,A00,185964,Staff,7,0,20,13
1683720081614,LIGN 101,A01,186039,Staff,43,0,50,7
1683720082647,LIGN 165,A00,186040,Staff,14,0,50,36
1683720083674,LTCS 108,A00,186041,Staff,5,0,10,5
1683720084705,LTCS 119,A00,186042,Staff,15,0,20,5
1683720085729,LTCS 130,A00,186043,Wesling; Megan E.,15,0,25,10
1683720087784,LTEA 138,A00,186119,Staff,14,0,40,26
1683720088809,LTEN 124,A00,186148,Staff,5,0,25,20
1683720089835,LTEN 178,A00,186149,Staff,6,0,15,9
1683720090859,LTEN 181,A00,186150,Blanco; John D,34,0,40,6
1683720091885,LTWL 120,A00,186160,Staff,19,0,25,6
1683720092912,LTWL 165,A00,186161,Staff,22,0,25,3
1683720093938,LTWR 100,A00,186162,Staff,0,5,15,15
1683720094964,LTWR 102,A00,186163,Doller; Ben,5,0,15,10
1683720095992,MAE 8,A01,186412,Staff,0,1,0,0
1683720097025,MAE 30B,A00,186445,Bahadori; Mohammad Yousef,81,0,100,19
1683720098055,MAE 40,A00,186592,Bewley; Thomas R,10,0,50,40
1683720099083,MAE 101B,A00,186593,Bahadori; Mohammad Yousef,80,0,100,20
1683720100110,MAE 105,A00,186594,Bandaru; Prabhakar,10,0,50,40
1683720101135,MAE 107,A00,186599,Pham; Hieu Tan,0,8,120,120
1683720102165,MAE 148,A01,186660,Silberman; Jack,3,0,16,13
1683720103189,MATH 10A,A01,188095,Staff,0,6,35,35
1683720104216,MATH 10B,A01,188097,Bowers; Adam R.,0,12,30,30
1683720104216,MATH 10B,A02,188099,Bowers; Adam R.,0,11,30,30
1683720104216,MATH 10B,B01,188104,Bowers; Adam R.,0,10,30,30
1683720104216,MATH 10B,B02,188106,Bowers; Adam R.,0,9,30,30
1683720105251,MATH 10C,A01,188111,Staff,0,20,30,30
1683720105251,MATH 10C,A02,188127,Staff,0,19,30,30
1683720105251,MATH 10C,A03,188131,Staff,0,19,30,30
1683720105251,MATH 10C,B01,188218,Staff,17,0,30,13
1683720105251,MATH 10C,B02,188244,Staff,13,0,30,17
1683720105251,MATH 10C,B03,188277,Staff,14,0,30,16
1683720106279,MATH 18,A01,188344,Bach; Quang Tran,18,0,30,12
1683720106279,MATH 18,A02,188345,Bach; Quang Tran,11,0,30,19
1683720106279,MATH 18,B01,188353,Bach; Quang Tran,11,0,30,19
1683720106279,MATH 18,B02,188354,Bach; Quang Tran,19,0,30,11
1683720107313,MATH 20A,A01,188374,Staff,11,0,35,24
1683720108339,MATH 20B,A01,188382,Ohm; Ko Woon,7,0,30,23
1683720108339,MATH 20B,A02,188383,Ohm; Ko Woon,22,0,30,8
1683720108339,MATH 20B,B01,188385,Ohm; Ko Woon,7,0,30,23
1683720108339,MATH 20B,B02,188392,Ohm; Ko Woon,22,0,30,8
1683720109371,MATH 20C,A01,188394,Harel; Guershon,10,0,30,20
1683720109371,MATH 20C,A02,188395,Harel; Guershon,13,0,30,17
1683720109371,MATH 20C,B01,188404,Harel; Guershon,5,0,30,25
1683720109371,MATH 20C,B02,188405,Harel; Guershon,18,0,30,12
1683720110399,MATH 20D,A01,188414,Hammock; Frances H,0,1,30,30
1683720110399,MATH 20D,A02,188415,Hammock; Frances H,0,1,30,30
1683720110399,MATH 20D,B01,188447,Hammock; Frances H,0,1,30,30
1683720110399,MATH 20D,B02,188486,Hammock; Frances H,2,0,30,28
1683720111430,MATH 20E,A01,188649,Staff,21,0,30,9
1683720111430,MATH 20E,A02,188650,Staff,20,0,30,10
1683720111430,MATH 20E,A03,188673,Staff,0,0,30,30
1683720112460,MATH 102,A01,188675,Staff,0,40,35,35
1683720113490,MATH 103B,A01,188681,Staff,3,0,35,32
1683720113490,MATH 103B,B01,188692,Staff,5,0,35,30
1683720114522,MATH 109,A01,188695,Salehi Golsefidy; Alireza,24,0,35,11
1683720114522,MATH 109,A02,188696,Salehi Golsefidy; Alireza,24,0,35,11
1683720115550,MATH 120A,A01,188698,Eggers; John Dietrich,7,0,35,28
1683720116584,MATH 142B,A01,188736,Ioana; Adrian,0,0,30,30
1683720116584,MATH 142B,A02,188741,Ioana; Adrian,0,1,30,30
1683720116584,MATH 142B,A03,188743,Ioana; Adrian,0,2,30,30
1683720117610,MATH 168A,A01,188790,Staff,0,11,35,35
1683720118645,MATH 170A,A01,188803,Nie; Jiawang,0,2,35,35
1683720118645,MATH 170A,A02,188811,Nie; Jiawang,0,1,35,35
1683720118645,MATH 170A,A03,188814,Nie; Jiawang,1,0,35,34
1683720118645,MATH 170A,A04,188815,Nie; Jiawang,5,0,35,30
1683720119671,MATH 193B,A01,188817,Staff,0,0,35,35
1683720119671,MATH 193B,A02,188818,Staff,6,0,35,29
1683720120705,MGT 4,A01,202857,Anderson; John Charles,59,0,80,21
1683720121738,MGT 12,A00,202858,Lindenberger; Wade Douglas,40,0,90,50
1683720122766,MGT 18,A00,202859,Staff,73,0,90,17
1683720123801,MGT 18GS,A00,202860,McKay; Michael J,13,0,28,15
1683720124838,MGT 45,A00,202861,Pecore; Joseph P.,8,0,90,82
1683720125869,MGT 100,A00,202863,Yavorsky; Daniel Ryan,27,0,90,63
1683720126899,MGT 103,A00,202864,Ehrich; Kristine R,0,19,90,90
1683720128018,MGT 112,A00,202865,Ehrich; Kristine R,15,0,90,75
1683720129046,MGT 121A,A00,202868,Staff,70,0,90,20
1683720130076,MGT 131B,A00,202869,Anderson; John Charles,58,0,90,32
1683720131102,MGT 136,A00,202871,Lindenberger; Wade Douglas,83,0,90,7
1683720132128,MGT 164,A00,202873,Staff,0,67,90,91
1683720133158,MGT 164GS,A00,202874,McKay; Mary A,13,0,28,15
1683720134186,MGT 180,A00,202875,Staff,0,51,90,91
1683720135212,MMW 11R,A01,205019,Herbst; Matthew,0,0,30,30
1683720135212,MMW 11R,A02,205026,Herbst; Matthew,29,0,30,1
1683720136236,MMW 15,A01,193512,Chang; Edmond Yi-Teh,0,8,28,28
1683720136236,MMW 15,A02,193513,Chang; Edmond Yi-Teh,0,5,28,28
1683720136236,MMW 15,A03,193514,Chang; Edmond Yi-Teh,0,5,28,28
1683720136236,MMW 15,A04,193515,Chang; Edmond Yi-Teh,0,5,28,28
1683720136236,MMW 15,A05,193516,Chang; Edmond Yi-Teh,0,5,28,28
1683720136236,MMW 15,A06,193517,Chang; Edmond Yi-Teh,0,6,28,28
1683720136236,MMW 15,B01,193519,Chang; Edmond Yi-Teh,0,5,28,28
1683720136236,MMW 15,B02,193520,Chang; Edmond Yi-Teh,0,5,28,28
1683720136236,MMW 15,B03,193521,Chang; Edmond Yi-Teh,0,5,28,28
1683720136236,MMW 15,B04,193522,Chang; Edmond Yi-Teh,0,6,28,28
1683720136236,MMW 15,B05,193523,Chang; Edmond Yi-Teh,0,5,28,28
1683720136236,MMW 15,B06,193524,Chang; Edmond Yi-Teh,0,5,28,28
1683720137266,MMW 122,A01,193526,Rahimi; Babak,0,16,28,28
1683720137266,MMW 122,A02,193527,Rahimi; Babak,0,15,28,28
1683720137266,MMW 122,A03,193528,Rahimi; Babak,0,0,0,0
1683720137266,MMW 122,A04,193529,Rahimi; Babak,0,0,0,0
1683720138291,MUS 1A,A01,186663,Staff,0,18,35,35
1683720139349,MUS 4,A01,186715,Staff,0,12,35,35
1683720140376,MUS 5R,A01,186796,Dubnov; Shlomo,0,17,35,35
1683720141408,MUS 6,A01,186798,Staff,0,4,25,25
1683720142438,MUS 7,A01,186830,Staff,11,0,35,24
1683720143464,MUS 8,A01,186930,Staff,0,27,35,35
1683720144495,MUS 15,A01,186932,Staff,0,15,35,35
1683720144495,MUS 15,B01,186934,Staff,0,16,35,35
1683720145553,MUS 80,A00,186935,Staff,0,0,20,20
1683720145553,MUS 80,B00,186936,Staff,24,0,25,1
1683720146582,NANO 11,A00,204702,Lipomi; Darren John,0,0,0,0
1683720147608,NANO 15,A01,204709,Yang; Kesong,0,1,0,0
1683720148634,NANO 114,A00,202069,Jahed Motlagh; Zeinab,2,0,10,8
1683720149661,PHIL 1,A00,186955,Grush; Rick Scott,31,0,40,9
1683720150689,PHIL 10,A01,186973,Grush; Rick Scott,27,0,35,8
1683720150689,PHIL 10,A02,186974,Grush; Rick Scott,33,0,35,2
1683720151718,PHIL 13,A01,186976,Staff,1,0,35,34
1683720151718,PHIL 13,A02,186977,Staff,16,0,35,19
1683720152803,PHIL 14,A01,186979,Staff,30,0,35,5
1683720152803,PHIL 14,A02,186986,Staff,32,0,35,3
1683720153831,PHIL 28,A01,186988,Staff,16,0,30,14
1683720153831,PHIL 28,A02,186989,Staff,0,0,30,30
1683720153831,PHIL 28,A03,186990,Staff,10,0,30,20
1683720153831,PHIL 28,A04,186991,Staff,26,0,30,4
1683720154856,PHIL 120,A00,186997,Staff,23,0,40,17
1683720155882,PHIL 137,A00,187003,Staff,8,0,40,32
1683720156906,PHIL 150,A00,187015,Staff,47,0,70,23
1683720157932,PHIL 167,A00,187021,Lamey; Andy M.,34,0,40,6
1683720158958,PHIL 174,A01,202226,Staff,17,0,20,3
1683720158958,PHIL 174,A02,202235,Staff,20,0,20,0
1683720159987,PHIL 191A,A00,258918,Staff,0,0,1,1
1683720161013,PHYS 1A,A00,187028,Staff,26,0,60,34
1683720162045,PHYS 1AL,001,187036,Staff,3,0,30,27
1683720162045,PHYS 1AL,002,187049,Staff,18,0,30,12
1683720163075,PHYS 1B,A00,187058,Staff,21,0,60,39
1683720164102,PHYS 1BL,001,187064,Staff,0,1,30,30
1683720164102,PHYS 1BL,002,187070,Staff,4,0,30,26
1683720165134,PHYS 1C,A00,187082,Staff,30,0,120,90
1683720166160,PHYS 1CL,001,187088,Staff,0,9,30,30
1683720166160,PHYS 1CL,002,187089,Staff,0,1,30,30
1683720166160,PHYS 1CL,009,262693,Staff,9,0,30,21
1683720167189,PHYS 2B,A01,187097,Staff,55,0,115,60
1683720168270,PHYS 2C,A01,187099,Staff,63,0,115,52
1683720169296,PHYS 2CL,A01,187101,Staff,5,0,28,23
1683720169296,PHYS 2CL,A02,187102,Staff,15,0,28,13
1683720170322,PHYS 2D,A01,187123,Shotwell; Brian,95,0,115,20
1683720171352,PHYS 4B,A01,187133,Grinstein; Benjamin,35,0,50,15
1683720172442,POLI 10,A00,188819,Staff,0,4,50,50
1683720173469,POLI 11,A00,188827,Staff,43,0,50,7
1683720174501,POLI 13R,A00,188828,Staff,0,2,20,20
1683720175532,POLI 27,A01,188830,Elgin; Samuel Zincke,0,2,70,70
1683720176557,POLI 30,A00,188832,Desposato; Scott,30,0,50,20
1683720177589,POLI 102F,A00,188834,Staff,1,0,40,39
1683720178616,POLI 104A,A00,188852,Staff,12,0,30,18
1683720179646,POLI 104I,A00,188853,Staff,0,8,20,20
1683720180670,POLI 110B,A00,188854,Wiens; David,6,0,20,14
1683720181729,POLI 112A,A00,188855,Wiens; David,3,0,30,27
1683720182752,POLI 117R,A00,188856,Forman; Fonna,0,12,20,20
1683720183783,POLI 118,A00,188857,Ingham; Sean,8,0,20,12
1683720184809,POLI 120G,A00,188858,Staff,7,0,30,23
1683720185835,POLI 131CR,A00,188863,Hoston; Germaine,20,0,50,30
1683720186860,POLI 133,A00,188864,Nellis; Gareth Hb,44,0,50,6
1683720187894,POLI 134D,A00,188865,Desposato; Scott,27,0,30,3
1683720188920,POLI 142A,A00,188871,Gartzke; Erik,21,0,50,29
1683720189951,POLI 142K,A00,188874,Staff,38,0,50,12
1683720190977,POLI 143,A00,188940,Gartzke; Erik,15,0,30,15
1683720192002,POLI 153,A00,188943,Staff,1,0,20,19
1683720193031,POLI 160AA,A00,188944,Staff,10,0,40,30
1683720194057,POLI 170A,A00,188945,Staff,10,0,30,20
1683720196118,PSYC 1,A00,188952,Staff,36,0,90,54
1683720197145,PSYC 2,B00,188953,Staff,19,0,35,16
1683720198173,PSYC 6,A00,188970,Staff,47,0,60,13
1683720199200,PSYC 7,A00,188973,Staff,35,0,45,10
1683720200226,PSYC 60,A01,188980,Rickard; Timothy C.,42,0,60,18
1683720201256,PSYC 70,A01,189001,Steiner; Eric Tomas,22,0,45,23
1683720202281,PSYC 100,A00,189005,Lacefield; Katharine I,1,98,120,119
1683720203307,PSYC 102,A00,189008,Staff,6,0,30,24
1683720204398,PSYC 106,B00,189026,Gorman; Michael R.,27,0,60,33
1683720205430,PSYC 114,B01,189033,Winkielman; Piotr,0,31,30,30
1683720206459,PSYC 131,A00,189036,Anagnostaras; Stephan,0,44,60,60
1683720207485,PSYC 136,A00,189041,Lowe; Angela Beth,0,7,25,25
1683720208510,PSYC 137,A00,189057,Winkielman; Piotr,0,36,25,25
1683720209537,PSYC 144,A00,189107,Wixted; John T,0,11,50,50
1683720211677,PSYC 162,A00,189142,Staff,0,9,85,85
1683720212701,PSYC 172,A00,189144,Gorman; Michael R.,0,6,30,30
1683720214754,PSYC 179,A00,189146,Lacefield; Katharine I,0,88,120,120
1683720215788,PSYC 181,A00,189147,Anagnostaras; Stephan,0,45,90,90
1683720216813,PSYC 190R,A00,189148,Barner; David A.,0,23,80,80
1683720217846,PSYC 191,A00,189275,Rickard; Timothy C.,0,11,25,25
1683720218877,PSYC 193,A00,189276,Chapman; Eddie Nathaniel,0,1,0,4
1683720219903,PSYC 193L,A01,189281,Lowe; Angela Beth,8,0,20,12
1683720219903,PSYC 193L,B01,189285,Staff,28,0,35,7
1683720220934,RELI 149,A00,187137,Rahimi; Babak,6,0,40,34
1683720221960,SE 9,A01,187315,Staff,0,2,18,18
1683720222985,SE 101B,A00,187409,Staff,24,0,30,6
1683720224011,SE 110B,A00,187444,Staff,10,0,40,30
1683720225037,SE 130B,A00,187449,Staff,31,0,40,9
1683720226063,SE 150A,A00,187516,Staff,8,0,20,12
1683720227089,SE 154,A00,187528,Staff,29,0,50,21
1683720228116,SIO 3,A01,258171,Staff,35,0,40,5
1683720229141,SIO 10,A00,187144,Cook; Geoffrey W,0,6,75,75
1683720230166,SIO 45,A00,187152,Cook; Geoffrey W,1,7,100,99
1683720231191,SIO 109R,A00,194486,Staff,0,4,20,20
1683720233251,SIO 187,A01,187233,Kacev; David,12,0,40,28
1683720234373,SOCI 1,A01,258656,Thorpe; Charles Robert,28,0,30,2
1683720234373,SOCI 1,A02,258658,Thorpe; Charles Robert,30,0,30,0
1683720234373,SOCI 1,A03,258661,Thorpe; Charles Robert,25,0,25,0
1683720234373,SOCI 1,A04,258666,Thorpe; Charles Robert,22,0,25,3
1683720234373,SOCI 1,A05,258897,Thorpe; Charles Robert,22,0,25,3
1683720234373,SOCI 1,A06,258898,Thorpe; Charles Robert,25,0,25,0
1683720235432,SOCI 30,A01,258903,Pardo Guerra; Juan Pablo,14,0,30,16
1683720236461,SOCI 102,A00,258904,Staff,9,0,25,16
1683720237487,SOCI 106,A00,258905,Staff,19,0,25,6
1683720238513,SOCI 111,A00,258907,Ribas Norris; Janet Vanesa,26,0,30,4
1683720239538,SOCI 121R,A00,258908,Pardo Guerra; Juan Pablo,7,0,30,23
1683720240565,SOCI 126,A01,203330,Staff,14,0,20,6
1683720241594,SOCI 131,A00,258909,Thorpe; Charles Robert,30,0,60,30
1683720242620,SOCI 135,A00,258910,Payne; Christine Anna,0,13,30,30
1683720243646,SOCI 157,A00,258911,Staff,10,0,30,20
1683720244673,SOCI 184,A00,258912,Staff,25,0,30,5
1683720245699,SOCI 188D,A00,258913,Staff,22,0,30,8
1683720246733,SYN 2,001,187529,Staff,9,0,16,7
1683720246733,SYN 2,002,201452,Staff,0,20,16,16
1683720246733,SYN 2,003,201469,Staff,1,0,16,15
1683720247762,SYN 100,A01,187531,Staff,0,9,20,20
1683720247762,SYN 100,B01,201491,Staff,0,10,20,20
1683720248815,TDAC 1,A00,189286,Walsh; Kim C.,3,0,20,17
1683720248815,TDAC 1,B00,189287,Harting; Carla Kelso,10,0,20,10
1683720249842,TDAC 101,A00,189300,Walsh; Kim C.,16,0,20,4
1683720249842,TDAC 101,B00,189301,Harting; Carla Kelso,18,0,20,2
1683720250866,TDAC 102,A00,189304,Basso; Beatrice,14,0,20,6
1683720251895,TDAC 108,A00,189305,Staff,18,0,20,2
1683720252930,TDDE 131,A00,189310,Staff,19,0,20,1
1683720252930,TDDE 131,B00,189314,Staff,19,0,20,1
1683720252930,TDDE 131,C00,189315,Staff,48,0,50,2
1683720252930,TDDE 131,D00,189316,Staff,14,0,15,1
1683720252930,TDDE 131,E00,204841,Staff,20,0,20,0
1683720253958,TDGE 10,A00,189289,Staff,26,0,50,24
1683720253958,TDGE 10,B00,189290,Havis; Allan,0,1,50,50
1683720254990,TDGE 11,A00,189291,Fulton; Julia,0,4,50,50
1683720254990,TDGE 11,B00,189292,Staff,20,0,25,5
1683720254990,TDGE 11,C00,260270,Staff,0,0,0,0
1683720256023,TDGE 25,A00,189294,Staff,1,0,20,19
1683720257105,TDGE 124,A00,189318,Fulton; Julia,0,7,50,50
1683720258137,TDGE 125,A00,189319,Staff,13,0,25,12
1683720258137,TDGE 125,B00,189320,Staff,23,0,25,2
1683720259161,TDGE 127,A00,189322,Havis; Allan,1,0,50,49
1683720260186,TDHT 101,A00,189323,Staff,18,0,25,7
1683720260186,TDHT 101,B00,189324,Staff,25,0,25,0
1683720261211,TDHT 102,A00,189325,Staff,49,0,50,1
1683720262239,TDMV 1,A00,189295,Arcidiacono; Kristin,20,0,30,10
1683720262239,TDMV 1,B00,189296,Caligagan; Maria T.,23,0,30,7
1683720263269,TDMV 2,A00,189297,Sammartano; Tonnie,27,0,30,3
1683720263269,TDMV 2,B00,189299,Arcidiacono; Kristin,23,0,30,7
1683720264299,TDMV 3,A00,204998,Rincon; Alicia,22,0,30,8
1683720265323,TDMV 120,A00,189458,Sammartano; Tonnie,28,0,30,2
1683720266360,TDMV 138,A00,189541,Jun; Grace Shin Hae,20,0,40,20
1683720267391,TDMV 142,A00,189717,Caligagan; Tony,25,0,30,5
1683720267391,TDMV 142,B00,189718,Caligagan; Maria T.,25,0,30,5
1683720268422,TMC 2,A01,187533,Staff,25,0,25,0
1683720268422,TMC 2,A02,187534,Staff,25,0,25,0
1683720269448,USP 1,A01,187536,Kwak; Nancy,0,16,25,25
1683720270488,USP 5,A01,187538,Staff,8,0,25,17
1683720271520,USP 101,A00,199253,Staff,0,4,0,0
1683720272549,USP 124,A00,187562,Boomhower; Matthew Charles,0,0,30,30
1683720273579,USP 138,A00,187582,Staff,19,0,25,6
1683720274605,USP 152,A01,187597,Staff,3,0,25,22
1683720275651,USP 153,A00,187598,Staff,18,0,25,7
1683720276679,USP 168,A00,187607,Kwak; Nancy,2,0,5,3
1683720277713,USP 173,A00,187619,Staff,4,0,25,21
1683720278737,USP 181,A00,187638,Staff,0,4,25,25
1683720279766,VIS 103,A00,187650,Cruz; Edwin Teddy,17,0,75,58
1683720280791,VIS 110D,A00,187669,Staff,13,0,22,9
1683720281820,VIS 127C,A00,187720,Shen; Kuiyi,67,0,146,79
1683720282901,VIS 149,A00,187731,Yoldas; Pinar,0,12,22,22
1683720283927,VIS 151,A01,188091,Staff,22,0,34,12
1683720283927,VIS 151,A02,188092,Staff,11,0,34,23
1683720284957,VIS 160B,A00,188093,Stalbaum; Brett,0,1,10,10
1683720287018,WCWP 10B,A00,201720,Staff,0,0,5,5
1683720287018,WCWP 10B,B00,201722,Staff,0,0,6,6
1683720288068,WCWP 100,A00,201725,Gagnon; Jeffrey C,0,0,2,2
1683720288068,WCWP 100,B00,201727,Staff,0,4,15,15
1683720291226,ANBI 133,A00,258401,Wilder; Linnea Lorene,34,0,40,6
1683720292253,ANBI 140,A00,258395,Hrvoj Mihic; Branka,18,0,25,7
1683720293280,ANSC 120,A00,258402,Bialecki; Jon Anthony,26,0,40,14
1683720294307,ANSC 144,A00,258400,Staff,12,0,40,28
1683720296362,ANSC 166,A00,258396,Parish; Steven Martin,156,0,175,19
1683720297387,ANSC 180,A00,193533,Staff,8,0,20,12
1683720298416,ANSC 188,A00,258397,Jassal; Aftab,34,0,40,6
1683720299443,ANTH 3,A01,258316,Staff,23,0,30,7
1683720300474,ANTH 5,A00,258394,Semendeferi; Ekaterini,16,0,20,4
1683720301508,ANTH 21,A01,258331,Staff,4,0,40,36
1683720302534,ANTH 103,A00,258398,Varma; Saiba,15,0,25,10
1683720303571,AWP 10,001,202034,Staff,0,0,0,0
1683720303571,AWP 10,002,202035,Staff,0,0,0,0
1683720303571,AWP 10,003,202036,Staff,0,0,0,0
1683720303571,AWP 10,004,202037,Staff,0,0,0,0
1683720303571,AWP 10,005,202038,Staff,0,0,0,0
1683720303571,AWP 10,006,202039,Staff,0,0,0,0
1683720303571,AWP 10,007,202040,Staff,0,0,0,0
1683720303571,AWP 10,008,202041,Staff,0,0,0,0
1683720303571,AWP 10,009,202042,Staff,0,0,0,0
1683720303571,AWP 10,010,202043,Staff,0,0,0,0
1683720303571,AWP 10,011,202044,Staff,0,0,0,0
1683720303571,AWP 10,012,202045,Staff,0,0,0,0
1683720303571,AWP 10,013,202046,Staff,0,0,0,0
1683720303571,AWP 10,014,202047,Staff,0,0,0,0
1683720303571,AWP 10,015,202048,Staff,0,0,0,0
1683720303571,AWP 10,016,202049,Staff,0,0,0,0
1683720303571,AWP 10,017,202050,Staff,0,0,0,0
1683720303571,AWP 10,018,202051,Staff,0,0,0,0
1683720303571,AWP 10,019,202052,Staff,0,0,0,0
1683720303571,AWP 10,020,202053,Staff,0,0,0,0
1683720303571,AWP 10,021,202054,Staff,0,0,0,0
1683720303571,AWP 10,022,202055,Staff,0,0,0,0
1683720303571,AWP 10,023,202056,Staff,0,0,0,0
1683720303571,AWP 10,024,202057,Staff,0,0,0,0
1683720303571,AWP 10,025,202058,Staff,0,0,0,0
1683720303571,AWP 10,026,202059,Staff,0,0,0,0
1683720304597,AWP 102,001,202032,Staff,0,0,0,0
1683720304597,AWP 102,002,202033,Staff,0,0,0,0
1683720305626,BENG 100,A01,254234,Taylor Amos; Alyssa C,31,0,40,9
1683720306652,BENG 196,001,270013,Engler; Adam J.,9999,0,9999,0
1683720307689,BICD 100R,A01,202018,Smith; Laurie,0,7,32,32
1683720307689,BICD 100R,A02,202019,Smith; Laurie,0,3,32,32
1683720307689,BICD 100R,A03,202020,Smith; Laurie,0,1,32,32
1683720307689,BICD 100R,A04,202021,Smith; Laurie,6,0,32,26
1683720307689,BICD 100R,A05,202022,Smith; Laurie,10,0,32,22
1683720308717,BICD 136,A01,193242,Gustafson-Brown; Cindy,0,2,32,32
1683720308717,BICD 136,A02,193244,Gustafson-Brown; Cindy,13,0,32,19
1683720309753,BIEB 102,A01,193249,Butler; Shannon Rhey,0,0,32,32
1683720309753,BIEB 102,A02,193251,Butler; Shannon Rhey,0,0,32,32
1683720309753,BIEB 102,A03,193253,Butler; Shannon Rhey,0,0,32,32
1683720309753,BIEB 102,A04,193255,Butler; Shannon Rhey,13,0,32,19
1683720309753,BIEB 102,A05,193265,Butler; Shannon Rhey,25,0,32,7
1683720309753,BIEB 102,A06,193269,Butler; Shannon Rhey,12,0,32,20
1683720311809,BIEB 150,A01,193274,Staff,0,0,32,32
1683720311809,BIEB 150,A02,193285,Staff,24,0,32,8
1683720312836,BIEB 194,A00,193286,Kurle; Carolyn M.,19,0,32,13
1683720313865,BILD 1,A01,192291,Staff,15,0,32,17
1683720313865,BILD 1,A02,192292,Staff,30,0,32,2
1683720313865,BILD 1,B01,192520,Reuther; Keefe,0,1,0,0
1683720313865,BILD 1,B02,192532,Reuther; Keefe,0,1,0,0
1683720314894,BILD 3,A01,192556,Butler; Shannon Rhey,0,0,32,32
1683720314894,BILD 3,A02,192581,Butler; Shannon Rhey,0,1,32,32
1683720314894,BILD 3,A03,192611,Butler; Shannon Rhey,19,0,32,13
1683720314894,BILD 3,A04,192612,Butler; Shannon Rhey,23,0,32,9
1683720314894,BILD 3,A05,192613,Butler; Shannon Rhey,26,0,32,6
1683720314894,BILD 3,A06,192679,Butler; Shannon Rhey,27,0,32,5
1683720314894,BILD 3,A07,192682,Butler; Shannon Rhey,20,0,32,12
1683720315934,BILD 4,A01,192836,Reuther; Keefe,1,0,24,23
1683720315934,BILD 4,A02,193044,Reuther; Keefe,4,0,24,20
1683720316962,BILD 10,A01,193142,Gustafson-Brown; Cindy,29,0,32,3
1683720316962,BILD 10,A02,193149,Gustafson-Brown; Cindy,31,0,32,1
1683720317990,BIMM 100,A01,193301,Staff,0,6,32,32
1683720317990,BIMM 100,A02,193312,Staff,0,7,32,32
1683720317990,BIMM 100,A03,193323,Staff,0,10,32,32
1683720319018,BIMM 101,A01,193329,McDonnell; Lisa Marie,0,3,24,24
1683720319018,BIMM 101,A02,193339,McDonnell; Lisa Marie,0,3,24,24
1683720319018,BIMM 101,B01,193354,McDonnell; Lisa Marie,0,4,24,24
1683720319018,BIMM 101,B02,193357,McDonnell; Lisa Marie,0,3,24,24
1683720320046,BIMM 110,A01,193377,Tat; John,0,11,32,32
1683720320046,BIMM 110,A02,193378,Tat; John,0,11,32,32
1683720321086,BIMM 120,A01,206116,Staff,0,0,32,32
1683720321086,BIMM 120,A02,206117,Staff,7,0,32,25
1683720321086,BIMM 120,A03,206121,Staff,21,0,32,11
1683720322112,BIPN 100,A01,193393,Park; Ji Young,0,15,32,32
1683720322112,BIPN 100,A02,193402,Park; Ji Young,0,14,32,32
1683720322112,BIPN 100,A03,193413,Park; Ji Young,0,14,32,32
1683720322112,BIPN 100,A04,193414,Park; Ji Young,0,13,32,32
1683720323137,BIPN 102,A01,193429,Staff,0,0,32,32
1683720323137,BIPN 102,A02,193438,Staff,18,0,32,14
1683720324164,BIPN 106,A01,193450,Reyes Gonzalez; Catalina,0,2,40,40
1683720325195,BIPN 134,A01,193465,Cooke; James Edward,0,0,32,32
1683720325195,BIPN 134,A02,193474,Cooke; James Edward,25,0,32,7
1683720325195,BIPN 134,A03,193485,Cooke; James Edward,29,0,32,3
1683720325195,BIPN 134,A04,193486,Cooke; James Edward,20,0,32,12
1683720325195,BIPN 134,A05,193491,Cooke; James Edward,31,0,32,1
1683720325195,BIPN 134,A06,193501,Cooke; James Edward,30,0,32,2
1683720325195,BIPN 134,A07,193510,Cooke; James Edward,29,0,32,3
1683720327251,BISP 194,A00,222522,Staff,14,0,32,18
1683720328277,CAT 124,A01,202407,Staff,19,0,25,6
1683720329315,CAT 125,A00,202408,Marchisotto; Jennifer Anne,2,0,20,18
1683720330359,CAT 125R,A00,202409,Smith; Lauryn Alissa,0,11,20,20
1683720330359,CAT 125R,B00,202410,Morales; Celeste Georgianna,0,11,20,20
1683720330359,CAT 125R,C00,202411,Irwin; Matthew Joseph,0,12,20,20
1683720331386,CENG 15,A01,204712,Yang; Kesong,0,1,0,0
1683720332421,CENG 114,A00,202070,Jahed Motlagh; Zeinab,5,0,20,15
1683720333448,CGS 105,A00,185477,Wesling; Megan E.,24,0,40,16
1683720334481,CGS 106,A00,185494,Staff,11,0,22,11
1683720335507,CGS 108,A00,185495,Staff,14,0,20,6
1683720336533,CGS 114,A00,185496,Staff,13,0,18,5
1683720337559,CGS 119,A00,185501,Staff,15,0,20,5
1683720338585,CGS 120,A00,185511,Staff,11,0,20,9
1683720339616,CHEM 4,A01,184675,Bussey; Thomas J,97,0,100,3
1683720340649,CHEM 6A,A01,184677,Staff,32,0,60,28
1683720341675,CHEM 6B,A01,184679,Staff,63,0,100,37
1683720342701,CHEM 6C,A01,184681,Bussey; Thomas J,0,0,50,50
1683720342701,CHEM 6C,A02,184682,Bussey; Thomas J,32,0,50,18
1683720343728,CHEM 40A,A01,184684,Albizati; Kim F.,33,0,100,67
1683720344754,CHEM 40B,A01,184686,Albizati; Kim F.,0,22,100,100
1683720345785,CHEM 41B,A01,184690,Staff,51,0,100,49
1683720346810,COGS 3,A01,184715,Boyle; Mary E. T.,0,27,40,40
1683720347838,COGS 14B,A01,185172,Staff,0,14,38,38
1683720348870,COGS 18,A01,184736,Staff,14,0,80,66
1683720349895,COGS 100,A01,184932,Staff,0,8,73,73
1683720350925,COGS 101A,A01,184935,Staff,0,40,30,30
1683720351957,COGS 101B,A01,184944,Staff,0,2,30,30
1683720352987,COGS 101C,A01,184946,Staff,0,10,30,30
1683720354020,COGS 102A,A01,184951,Johnson; Christine M.,1,0,40,39
1683720355048,COGS 107B,A01,184953,Mooshagian; Eric Frederick,0,52,40,40
1683720356075,COGS 118B,A01,184959,Gupta; Anjum,0,50,40,40
1683720357101,COGS 153,A00,184961,Staff,1,16,30,29
1683720358128,COGS 177,A00,184962,Staff,0,20,30,30
1683720359155,COGS 187A,A01,184969,Boyle; Mary E. T.,0,19,40,40
1683720360187,COMM 10,A01,185174,Staff,0,5,25,25
1683720360187,COMM 10,A02,185189,Staff,0,2,25,25
1683720360187,COMM 10,A03,269821,Staff,0,1,0,0
1683720361270,COMM 100B,A02,185476,Staff,10,0,25,15
1683720361270,COMM 100B,A03,277340,Staff,25,0,25,0
1683720362305,COMM 100C,A01,185314,Staff,2,0,25,23
1683720362305,COMM 100C,A02,185327,Staff,17,0,25,8
1683720363330,COMM 110M,A00,185349,Staff,0,0,40,40
1683720364357,COMM 113T,A00,185352,Staff,25,0,40,15
1683720365386,COMM 114I,A00,185353,Staff,31,0,40,9
1683720366416,COMM 131,A00,185354,Staff,17,0,30,13
1683720367445,CSE 8A,A50,185358,Cao; Yingjun,0,46,10,10
1683720368477,CSE 8B,A01,185362,Staff,0,48,50,50
1683720369504,CSE 11,A01,185416,Cao; Yingjun,0,91,10,10
1683720370533,CSE 20,A01,185445,Briones; Jor-el Thomas Caparas,3,0,25,22
1683720371559,CSE 21,A01,185447,Staff,9,0,50,41
1683720372587,CSE 101,A01,185451,Staff,0,13,50,50
1683720372587,CSE 101,B01,185453,Jones; Miles E,0,15,50,50
1683720374645,CSE 141,A01,185458,Eldon; John,16,0,100,84
1683720375672,CSE 141L,A01,185461,Eldon; John,8,0,100,92
1683720376698,CSE 142,A01,185463,Staff,34,0,60,26
1683720376698,CSE 142,B01,201355,Staff,0,7,60,60
1683720377729,CSE 142L,A01,185470,Staff,34,0,60,26
1683720377729,CSE 142L,B01,201417,Staff,0,6,60,60
1683720378759,CSE 190,A00,201433,Staff,32,0,49,17
1683720379787,DOC 1,A01,259136,Strom; Megan C.,7,0,15,8
1683720379787,DOC 1,A02,259137,Strom; Megan C.,15,0,15,0
1683720379787,DOC 1,A03,259138,Strom; Megan C.,14,0,15,1
1683720379787,DOC 1,A04,259139,Strom; Megan C.,13,0,15,2
1683720380816,DOC 100D,A00,259140,Pass; Natalye Joann,14,0,25,11
1683720381844,DSGN 1,A01,184749,Rill; Bryan,0,26,30,30
1683720382869,DSGN 100,A01,185168,Staff,0,2,25,25
1683720383903,ECE 5,A01,185626,Morris; Karcher William,0,12,0,0
1683720384929,ECE 101,A01,185628,Staff,14,0,70,56
1683720385960,ECE 107,A01,185635,Baghdadchi; Saharnaz,0,0,20,20
1683720385960,ECE 107,A02,185638,Baghdadchi; Saharnaz,1,0,20,19
1683720386992,ECE 148,A01,185647,Silberman; Jack,0,0,16,16
1683720388024,ECON 1,A01,185537,Crane; Meredith Helen,54,0,70,16
1683720389048,ECON 3,A01,185549,Crane; Meredith Helen,30,0,70,40
1683720390075,ECON 4,A01,203354,Anderson; John Charles,0,5,10,10
1683720391101,ECON 100A,A01,185574,Staff,0,5,40,40
1683720392127,ECON 100B,A01,185576,Staff,0,12,50,50
1683720393158,ECON 100C,A01,185589,Newhouse; Herbert S,30,0,70,40
1683720394182,ECON 105,A00,185608,Vespa; Emanuel Ignacio,19,0,35,16
1683720395211,ECON 109,A01,185610,Shishkin; Denis,9,0,35,26
1683720396236,ECON 110A,A01,185612,Staff,8,0,40,32
1683720397260,ECON 120A,A01,185615,Staff,19,0,40,21
1683720398292,ECON 120C,A01,185617,Sun; Yixiao,0,21,70,70
1683720399323,ECON 144,A00,203346,Squires; Dale E,2,0,35,33
1683720400346,ECON 171,A01,203349,Newhouse; Herbert S,0,1,35,35
1683720401372,ECON 173A,A01,185621,Toda; Alexis Akira,21,0,35,14
1683720402416,EDS 25,A01,202413,Staff,0,1,0,0
1683720402416,EDS 25,A02,202414,Staff,0,1,0,0
1683720402416,EDS 25,A03,202415,Staff,0,0,0,0
1683720402416,EDS 25,A04,202416,Staff,0,1,0,0
1683720402416,EDS 25,A05,202439,Staff,0,0,0,0
1683720402416,EDS 25,A06,202440,Staff,0,0,0,0
1683720402416,EDS 25,B01,202631,Staff,0,0,0,0
1683720402416,EDS 25,B02,202632,Staff,0,0,0,0
1683720402416,EDS 25,B03,202639,Staff,0,0,0,0
1683720402416,EDS 25,B04,202640,Staff,0,0,0,0
1683720402416,EDS 25,B05,202643,Staff,0,0,0,0
1683720402416,EDS 25,B06,202644,Staff,0,0,0,0
1683720403449,EDS 38,A01,202659,Black; Alison Michelle,25,0,25,0
1683720404475,EDS 115,A00,202652,Staff,18,0,30,12
1683720405503,EDS 125,A00,202649,Staff,13,0,30,17
1683720406526,EDS 126,A01,203332,Staff,30,0,30,0
1683720407550,EDS 139,A00,202838,Staff,16,0,25,9
1683720408576,EDS 146,A01,202655,Staff,14,0,25,11
1683720409602,ENG 15,A00,185667,Staff,0,1,0,0
1683720409602,ENG 15,B00,185672,Staff,0,0,0,0
1683720409602,ENG 15,C00,185675,Staff,0,0,0,0
1683720409602,ENG 15,D00,185682,Staff,0,0,0,0
1683720409602,ENG 15,E00,185684,Staff,0,0,0,0
1683720410626,ETHN 103,A00,185710,Staff,0,8,35,35
1683720411659,ETHN 103A,A00,199228,Man; Simeon S,0,0,9,9
1683720412690,ETHN 109,A00,185711,Staff,15,0,35,20
1683720413719,ETHN 142,A00,185726,Staff,0,4,30,30
1683720414745,ETHN 163J,A00,199229,Man; Simeon S,5,0,8,3
1683720415770,ETHN 168,A00,185727,Staff,7,0,10,3
1683720416795,ETHN 182,A00,185728,Staff,0,0,35,35
1683720417830,ETHN 183,A00,185737,Staff,10,0,18,8
1683720418855,GLBH 111,A01,209361,Burgos; Jose L.,0,0,0,0
1683720420920,HIEU 104,A00,185792,Staff,14,0,20,6
1683720421946,HIEU 115,A00,185800,Staff,0,0,20,20
1683720422976,HIEU 128,A00,185801,Staff,0,9,20,20
1683720424006,HIEU 147,A00,185802,Staff,15,0,20,5
1683720425032,HIEU 154,A00,185823,Staff,11,0,20,9
1683720426062,HILA 102,A00,185826,Staff,14,0,20,6
1683720427088,HILD 2C,A01,185778,Staff,0,13,20,20
1683720428121,HILD 7B,A01,185780,Kwak; Nancy,0,17,32,32
1683720428121,HILD 7B,A02,185781,Kwak; Nancy,0,18,32,32
1683720429147,HILD 30,A01,185791,Staff,12,0,20,8
1683720430172,HISC 119,A00,185830,Golan; Tal,0,10,20,20
1683720431203,HITO 156GS,A00,185831,Patterson; Patrick H.,0,0,0,23
1683720432229,HIUS 103,A00,185832,Man; Simeon S,0,4,20,20
1683720433255,HIUS 117,A00,185836,Kwak; Nancy,2,0,20,18
1683720434280,HIUS 125,A00,185840,Man; Simeon S,0,2,23,23
1683720435307,HIUS 149,A00,185845,Staff,1,0,20,19
1683720436341,HUM 3,A01,185882,Zavodny; Tatiana Sophia,0,8,50,50
1683720436341,HUM 3,B01,185899,Caldwell; Michael Alan,0,18,50,50
1683720437369,HUM 3GS,A00,185900,Patterson; Patrick H.,0,0,0,23
1683720438396,HUM 4,A01,185938,Zroka; Amy Liane,28,0,50,22
1683720438396,HUM 4,B01,185956,Watkins; Eric,0,6,50,50
1683720438396,HUM 4,B02,202209,Watkins; Eric,0,6,50,50
1683720438396,HUM 4,B03,202210,Watkins; Eric,0,5,50,50
1683720439421,HUM 5,A01,185958,West; Geoffrey Scott,0,0,50,50
1683720439421,HUM 5,A02,202215,West; Geoffrey Scott,0,1,50,50
1683720440455,INTL 190,A00,185959,Gagnon; Jeffrey C,0,0,0,9
1683720440455,INTL 190,B00,185960,Lettieri; Michael Joseph,0,0,0,2
1683720441487,JAPN 180,A00,254509,Staff,5,0,30,25
1683720442525,LATI 10,A01,202853,Kennemore; Amy Michelle,4,0,35,31
1683720442525,LATI 10,A02,202854,Kennemore; Amy Michelle,3,0,35,32
1683720442525,LATI 10,A03,270054,Kennemore; Amy Michelle,30,0,30,0
1683720443551,LATI 180,A00,202855,Kennemore; Amy Michelle,11,0,20,9
1683720444578,LAWS 101,A00,201767,Golan; Tal,0,7,40,40
1683720445618,LIFR 1C,A00,185961,Staff,6,0,20,14
1683720446647,LIFR 1CX,A00,185962,Staff,7,0,20,13
1683720447675,LIFR 1D,A00,185963,Staff,7,0,20,13
1683720448705,LIFR 1DX,A00,185964,Staff,7,0,20,13
1683720449736,LIGN 101,A01,186039,Staff,43,0,50,7
1683720450766,LIGN 165,A00,186040,Staff,14,0,50,36
1683720451791,LTCS 108,A00,186041,Staff,5,0,10,5
1683720452819,LTCS 119,A00,186042,Staff,15,0,20,5
1683720453848,LTCS 130,A00,186043,Wesling; Megan E.,15,0,25,10
1683720455909,LTEA 138,A00,186119,Staff,14,0,40,26
1683720456934,LTEN 124,A00,186148,Staff,5,0,25,20
1683720457958,LTEN 178,A00,186149,Staff,6,0,15,9
1683720458991,LTEN 181,A00,186150,Blanco; John D,34,0,40,6
1683720460022,LTWL 120,A00,186160,Staff,19,0,25,6
1683720461053,LTWL 165,A00,186161,Staff,22,0,25,3
1683720462081,LTWR 100,A00,186162,Staff,0,5,15,15
1683720463114,LTWR 102,A00,186163,Doller; Ben,5,0,15,10
1683720464140,MAE 8,A01,186412,Staff,0,1,0,0
1683720465229,MAE 30B,A00,186445,Bahadori; Mohammad Yousef,81,0,100,19
1683720466254,MAE 40,A00,186592,Bewley; Thomas R,10,0,50,40
1683720467283,MAE 101B,A00,186593,Bahadori; Mohammad Yousef,80,0,100,20
1683720468315,MAE 105,A00,186594,Bandaru; Prabhakar,10,0,50,40
1683720469341,MAE 107,A00,186599,Pham; Hieu Tan,0,8,120,120
1683720470368,MAE 148,A01,186660,Silberman; Jack,3,0,16,13
1683720471397,MATH 10A,A01,188095,Staff,0,6,35,35
1683720472426,MATH 10B,A01,188097,Bowers; Adam R.,0,12,30,30
1683720472426,MATH 10B,A02,188099,Bowers; Adam R.,0,11,30,30
1683720472426,MATH 10B,B01,188104,Bowers; Adam R.,0,10,30,30
1683720472426,MATH 10B,B02,188106,Bowers; Adam R.,0,9,30,30
1683720473453,MATH 10C,A01,188111,Staff,0,20,30,30
1683720473453,MATH 10C,A02,188127,Staff,0,19,30,30
1683720473453,MATH 10C,A03,188131,Staff,0,19,30,30
1683720473453,MATH 10C,B01,188218,Staff,17,0,30,13
1683720473453,MATH 10C,B02,188244,Staff,13,0,30,17
1683720473453,MATH 10C,B03,188277,Staff,14,0,30,16
1683720474481,MATH 18,A01,188344,Bach; Quang Tran,18,0,30,12
1683720474481,MATH 18,A02,188345,Bach; Quang Tran,11,0,30,19
1683720474481,MATH 18,B01,188353,Bach; Quang Tran,11,0,30,19
1683720474481,MATH 18,B02,188354,Bach; Quang Tran,19,0,30,11
1683720475511,MATH 20A,A01,188374,Staff,11,0,35,24
1683720476538,MATH 20B,A01,188382,Ohm; Ko Woon,7,0,30,23
1683720476538,MATH 20B,A02,188383,Ohm; Ko Woon,22,0,30,8
1683720476538,MATH 20B,B01,188385,Ohm; Ko Woon,7,0,30,23
1683720476538,MATH 20B,B02,188392,Ohm; Ko Woon,22,0,30,8
1683720477565,MATH 20C,A01,188394,Harel; Guershon,10,0,30,20
1683720477565,MATH 20C,A02,188395,Harel; Guershon,13,0,30,17
1683720477565,MATH 20C,B01,188404,Harel; Guershon,5,0,30,25
1683720477565,MATH 20C,B02,188405,Harel; Guershon,18,0,30,12
1683720478600,MATH 20D,A01,188414,Hammock; Frances H,0,1,30,30
1683720478600,MATH 20D,A02,188415,Hammock; Frances H,0,1,30,30
1683720478600,MATH 20D,B01,188447,Hammock; Frances H,0,1,30,30
1683720478600,MATH 20D,B02,188486,Hammock; Frances H,2,0,30,28
1683720479627,MATH 20E,A01,188649,Staff,21,0,30,9
1683720479627,MATH 20E,A02,188650,Staff,20,0,30,10
1683720479627,MATH 20E,A03,188673,Staff,0,0,30,30
1683720480652,MATH 102,A01,188675,Staff,0,40,35,35
1683720481685,MATH 103B,A01,188681,Staff,3,0,35,32
1683720481685,MATH 103B,B01,188692,Staff,5,0,35,30
1683720482717,MATH 109,A01,188695,Salehi Golsefidy; Alireza,24,0,35,11
1683720482717,MATH 109,A02,188696,Salehi Golsefidy; Alireza,24,0,35,11
1683720483746,MATH 120A,A01,188698,Eggers; John Dietrich,7,0,35,28
1683720484777,MATH 142B,A01,188736,Ioana; Adrian,0,0,30,30
1683720484777,MATH 142B,A02,188741,Ioana; Adrian,0,1,30,30
1683720484777,MATH 142B,A03,188743,Ioana; Adrian,0,2,30,30
1683720485804,MATH 168A,A01,188790,Staff,0,11,35,35
1683720486832,MATH 170A,A01,188803,Nie; Jiawang,0,2,35,35
1683720486832,MATH 170A,A02,188811,Nie; Jiawang,0,1,35,35
1683720486832,MATH 170A,A03,188814,Nie; Jiawang,1,0,35,34
1683720486832,MATH 170A,A04,188815,Nie; Jiawang,5,0,35,30
1683720487862,MATH 193B,A01,188817,Staff,0,0,35,35
1683720487862,MATH 193B,A02,188818,Staff,6,0,35,29
1683720488889,MGT 4,A01,202857,Anderson; John Charles,59,0,80,21
1683720489916,MGT 12,A00,202858,Lindenberger; Wade Douglas,40,0,90,50
1683720490942,MGT 18,A00,202859,Staff,73,0,90,17
1683720491968,MGT 18GS,A00,202860,McKay; Michael J,13,0,28,15
1683720492994,MGT 45,A00,202861,Pecore; Joseph P.,8,0,90,82
1683720494025,MGT 100,A00,202863,Yavorsky; Daniel Ryan,27,0,90,63
1683720495062,MGT 103,A00,202864,Ehrich; Kristine R,0,19,90,90
1683720496088,MGT 112,A00,202865,Ehrich; Kristine R,15,0,90,75
1683720497125,MGT 121A,A00,202868,Staff,70,0,90,20
1683720498156,MGT 131B,A00,202869,Anderson; John Charles,58,0,90,32
1683720499180,MGT 136,A00,202871,Lindenberger; Wade Douglas,83,0,90,7
1683720500210,MGT 164,A00,202873,Staff,0,67,90,91
1683720501236,MGT 164GS,A00,202874,McKay; Mary A,13,0,28,15
1683720502265,MGT 180,A00,202875,Staff,0,51,90,91
1683720503290,MMW 11R,A01,205019,Herbst; Matthew,0,0,30,30
1683720503290,MMW 11R,A02,205026,Herbst; Matthew,29,0,30,1
1683720504318,MMW 15,A01,193512,Chang; Edmond Yi-Teh,0,8,28,28
1683720504318,MMW 15,A02,193513,Chang; Edmond Yi-Teh,0,5,28,28
1683720504318,MMW 15,A03,193514,Chang; Edmond Yi-Teh,0,5,28,28
1683720504318,MMW 15,A04,193515,Chang; Edmond Yi-Teh,0,5,28,28
1683720504318,MMW 15,A05,193516,Chang; Edmond Yi-Teh,0,5,28,28
1683720504318,MMW 15,A06,193517,Chang; Edmond Yi-Teh,0,6,28,28
1683720504318,MMW 15,B01,193519,Chang; Edmond Yi-Teh,0,5,28,28
1683720504318,MMW 15,B02,193520,Chang; Edmond Yi-Teh,0,5,28,28
1683720504318,MMW 15,B03,193521,Chang; Edmond Yi-Teh,0,5,28,28
1683720504318,MMW 15,B04,193522,Chang; Edmond Yi-Teh,0,6,28,28
1683720504318,MMW 15,B05,193523,Chang; Edmond Yi-Teh,0,5,28,28
1683720504318,MMW 15,B06,193524,Chang; Edmond Yi-Teh,0,5,28,28
1683720505345,MMW 122,A01,193526,Rahimi; Babak,0,16,28,28
1683720505345,MMW 122,A02,193527,Rahimi; Babak,0,15,28,28
1683720505345,MMW 122,A03,193528,Rahimi; Babak,0,0,0,0
1683720505345,MMW 122,A04,193529,Rahimi; Babak,0,0,0,0
1683720506370,MUS 1A,A01,186663,Staff,0,18,35,35
1683720507397,MUS 4,A01,186715,Staff,0,12,35,35
1683720508431,MUS 5R,A01,186796,Dubnov; Shlomo,0,17,35,35
1683720509473,MUS 6,A01,186798,Staff,0,4,25,25
1683720510499,MUS 7,A01,186830,Staff,11,0,35,24
1683720511523,MUS 8,A01,186930,Staff,0,27,35,35
1683720512550,MUS 15,A01,186932,Staff,0,15,35,35
1683720512550,MUS 15,B01,186934,Staff,0,16,35,35
1683720513575,MUS 80,A00,186935,Staff,0,0,20,20
1683720513575,MUS 80,B00,186936,Staff,24,0,25,1
1683720514603,NANO 11,A00,204702,Lipomi; Darren John,0,0,0,0
1683720515631,NANO 15,A01,204709,Yang; Kesong,0,1,0,0
1683720516667,NANO 114,A00,202069,Jahed Motlagh; Zeinab,2,0,10,8
1683720517703,PHIL 1,A00,186955,Grush; Rick Scott,31,0,40,9
1683720518729,PHIL 10,A01,186973,Grush; Rick Scott,27,0,35,8
1683720518729,PHIL 10,A02,186974,Grush; Rick Scott,33,0,35,2
1683720519755,PHIL 13,A01,186976,Staff,1,0,35,34
1683720519755,PHIL 13,A02,186977,Staff,16,0,35,19
1683720520785,PHIL 14,A01,186979,Staff,30,0,35,5
1683720520785,PHIL 14,A02,186986,Staff,32,0,35,3
1683720521817,PHIL 28,A01,186988,Staff,16,0,30,14
1683720521817,PHIL 28,A02,186989,Staff,0,0,30,30
1683720521817,PHIL 28,A03,186990,Staff,10,0,30,20
1683720521817,PHIL 28,A04,186991,Staff,26,0,30,4
1683720522844,PHIL 120,A00,186997,Staff,23,0,40,17
1683720523869,PHIL 137,A00,187003,Staff,8,0,40,32
1683720524898,PHIL 150,A00,187015,Staff,47,0,70,23
1683720525925,PHIL 167,A00,187021,Lamey; Andy M.,34,0,40,6
1683720526951,PHIL 174,A01,202226,Staff,17,0,20,3
1683720526951,PHIL 174,A02,202235,Staff,20,0,20,0
1683720527977,PHIL 191A,A00,258918,Staff,0,0,1,1
1683720529002,PHYS 1A,A00,187028,Staff,26,0,60,34
1683720530031,PHYS 1AL,001,187036,Staff,3,0,30,27
1683720530031,PHYS 1AL,002,187049,Staff,18,0,30,12
1683720531058,PHYS 1B,A00,187058,Staff,21,0,60,39
1683720532086,PHYS 1BL,001,187064,Staff,0,1,30,30
1683720532086,PHYS 1BL,002,187070,Staff,4,0,30,26
1683720533111,PHYS 1C,A00,187082,Staff,30,0,120,90
1683720534139,PHYS 1CL,001,187088,Staff,0,9,30,30
1683720534139,PHYS 1CL,002,187089,Staff,0,1,30,30
1683720534139,PHYS 1CL,009,262693,Staff,9,0,30,21
1683720535164,PHYS 2B,A01,187097,Staff,55,0,115,60
1683720536194,PHYS 2C,A01,187099,Staff,63,0,115,52
1683720537221,PHYS 2CL,A01,187101,Staff,5,0,28,23
1683720537221,PHYS 2CL,A02,187102,Staff,15,0,28,13
1683720538246,PHYS 2D,A01,187123,Shotwell; Brian,95,0,115,20
1683720539273,PHYS 4B,A01,187133,Grinstein; Benjamin,35,0,50,15
1683720540299,POLI 10,A00,188819,Staff,0,4,50,50
1683720541324,POLI 11,A00,188827,Staff,43,0,50,7
1683720542348,POLI 13R,A00,188828,Staff,0,2,20,20
1683720543375,POLI 27,A01,188830,Elgin; Samuel Zincke,0,2,70,70
1683720544401,POLI 30,A00,188832,Desposato; Scott,30,0,50,20
1683720545426,POLI 102F,A00,188834,Staff,1,0,40,39
1683720546452,POLI 104A,A00,188852,Staff,12,0,30,18
1683720547482,POLI 104I,A00,188853,Staff,0,8,20,20
1683720548507,POLI 110B,A00,188854,Wiens; David,6,0,20,14
1683720549533,POLI 112A,A00,188855,Wiens; David,3,0,30,27
1683720550561,POLI 117R,A00,188856,Forman; Fonna,0,12,20,20
1683720551591,POLI 118,A00,188857,Ingham; Sean,8,0,20,12
1683720552615,POLI 120G,A00,188858,Staff,7,0,30,23
1683720553642,POLI 131CR,A00,188863,Hoston; Germaine,20,0,50,30
1683720554667,POLI 133,A00,188864,Nellis; Gareth Hb,44,0,50,6
1683720555697,POLI 134D,A00,188865,Desposato; Scott,27,0,30,3
1683720556723,POLI 142A,A00,188871,Gartzke; Erik,21,0,50,29
1683720557754,POLI 142K,A00,188874,Staff,38,0,50,12
1683720558781,POLI 143,A00,188940,Gartzke; Erik,15,0,30,15
1683720559809,POLI 153,A00,188943,Staff,1,0,20,19
1683720560834,POLI 160AA,A00,188944,Staff,10,0,40,30
1683720561861,POLI 170A,A00,188945,Staff,10,0,30,20
1683720563922,PSYC 1,A00,188952,Staff,36,0,90,54
1683720564952,PSYC 2,B00,188953,Staff,19,0,35,16
1683720565978,PSYC 6,A00,188970,Staff,47,0,60,13
1683720567005,PSYC 7,A00,188973,Staff,35,0,45,10
1683720568031,PSYC 60,A01,188980,Rickard; Timothy C.,42,0,60,18
1683720569113,PSYC 70,A01,189001,Steiner; Eric Tomas,22,0,45,23
1683720570140,PSYC 100,A00,189005,Lacefield; Katharine I,1,98,120,119
1683720571164,PSYC 102,A00,189008,Staff,6,0,30,24
1683720572191,PSYC 106,B00,189026,Gorman; Michael R.,27,0,60,33
1683720573223,PSYC 114,B01,189033,Winkielman; Piotr,0,31,30,30
1683720574248,PSYC 131,A00,189036,Anagnostaras; Stephan,0,44,60,60
1683720575278,PSYC 136,A00,189041,Lowe; Angela Beth,0,7,25,25
1683720576307,PSYC 137,A00,189057,Winkielman; Piotr,0,36,25,25
1683720577334,PSYC 144,A00,189107,Wixted; John T,0,11,50,50
1683720579389,PSYC 162,A00,189142,Staff,0,9,85,85
1683720580416,PSYC 172,A00,189144,Gorman; Michael R.,0,6,30,30
1683720582474,PSYC 179,A00,189146,Lacefield; Katharine I,0,88,120,120
1683720583498,PSYC 181,A00,189147,Anagnostaras; Stephan,0,45,90,90
1683720584531,PSYC 190R,A00,189148,Barner; David A.,0,23,80,80
1683720585555,PSYC 191,A00,189275,Rickard; Timothy C.,0,11,25,25
1683720586581,PSYC 193,A00,189276,Chapman; Eddie Nathaniel,0,1,0,4
1683720587613,PSYC 193L,A01,189281,Lowe; Angela Beth,8,0,20,12
1683720587613,PSYC 193L,B01,189285,Staff,28,0,35,7
1683720588641,RELI 149,A00,187137,Rahimi; Babak,6,0,40,34
1683720589669,SE 9,A01,187315,Staff,0,2,18,18
1683720590694,SE 101B,A00,187409,Staff,24,0,30,6
1683720591720,SE 110B,A00,187444,Staff,10,0,40,30
1683720592745,SE 130B,A00,187449,Staff,31,0,40,9
1683720593777,SE 150A,A00,187516,Staff,8,0,20,12
1683720594803,SE 154,A00,187528,Staff,29,0,50,21
1683720595831,SIO 3,A01,258171,Staff,35,0,40,5
1683720596862,SIO 10,A00,187144,Cook; Geoffrey W,0,6,75,75
1683720597891,SIO 45,A00,187152,Cook; Geoffrey W,1,7,100,99
1683720598918,SIO 109R,A00,194486,Staff,0,4,20,20
1683720600969,SIO 187,A01,187233,Kacev; David,12,0,40,28
1683720602003,SOCI 1,A01,258656,Thorpe; Charles Robert,28,0,30,2
1683720602003,SOCI 1,A02,258658,Thorpe; Charles Robert,30,0,30,0
1683720602003,SOCI 1,A03,258661,Thorpe; Charles Robert,25,0,25,0
1683720602003,SOCI 1,A04,258666,Thorpe; Charles Robert,22,0,25,3
1683720602003,SOCI 1,A05,258897,Thorpe; Charles Robert,22,0,25,3
1683720602003,SOCI 1,A06,258898,Thorpe; Charles Robert,25,0,25,0
1683720603034,SOCI 30,A01,258903,Pardo Guerra; Juan Pablo,14,0,30,16
1683720604062,SOCI 102,A00,258904,Staff,9,0,25,16
1683720605087,SOCI 106,A00,258905,Staff,19,0,25,6
1683720606118,SOCI 111,A00,258907,Ribas Norris; Janet Vanesa,26,0,30,4
1683720607143,SOCI 121R,A00,258908,Pardo Guerra; Juan Pablo,7,0,30,23
1683720608174,SOCI 126,A01,203330,Staff,14,0,20,6
1683720609219,SOCI 131,A00,258909,Thorpe; Charles Robert,30,0,60,30
1683720610249,SOCI 135,A00,258910,Payne; Christine Anna,0,13,30,30
1683720611286,SOCI 157,A00,258911,Staff,10,0,30,20
1683720612312,SOCI 184,A00,258912,Staff,25,0,30,5
1683720613336,SOCI 188D,A00,258913,Staff,22,0,30,8
1683720614364,SYN 2,001,187529,Staff,9,0,16,7
1683720614364,SYN 2,002,201452,Staff,0,20,16,16
1683720614364,SYN 2,003,201469,Staff,1,0,16,15
1683720615390,SYN 100,A01,187531,Staff,0,9,20,20
1683720615390,SYN 100,B01,201491,Staff,0,10,20,20
1683720616419,TDAC 1,A00,189286,Walsh; Kim C.,3,0,20,17
1683720616419,TDAC 1,B00,189287,Harting; Carla Kelso,10,0,20,10
1683720617443,TDAC 101,A00,189300,Walsh; Kim C.,16,0,20,4
1683720617443,TDAC 101,B00,189301,Harting; Carla Kelso,18,0,20,2
1683720618470,TDAC 102,A00,189304,Basso; Beatrice,14,0,20,6
1683720619499,TDAC 108,A00,189305,Staff,18,0,20,2
1683720620528,TDDE 131,A00,189310,Staff,19,0,20,1
1683720620528,TDDE 131,B00,189314,Staff,19,0,20,1
1683720620528,TDDE 131,C00,189315,Staff,48,0,50,2
1683720620528,TDDE 131,D00,189316,Staff,14,0,15,1
1683720620528,TDDE 131,E00,204841,Staff,20,0,20,0
1683720621557,TDGE 10,A00,189289,Staff,26,0,50,24
1683720621557,TDGE 10,B00,189290,Havis; Allan,0,1,50,50
1683720622585,TDGE 11,A00,189291,Fulton; Julia,0,4,50,50
1683720622585,TDGE 11,B00,189292,Staff,20,0,25,5
1683720622585,TDGE 11,C00,260270,Staff,0,0,0,0
1683720623610,TDGE 25,A00,189294,Staff,1,0,20,19
1683720624637,TDGE 124,A00,189318,Fulton; Julia,0,7,50,50
1683720625662,TDGE 125,A00,189319,Staff,13,0,25,12
1683720625662,TDGE 125,B00,189320,Staff,23,0,25,2
1683720626688,TDGE 127,A00,189322,Havis; Allan,1,0,50,49
1683720627714,TDHT 101,A00,189323,Staff,18,0,25,7
1683720627714,TDHT 101,B00,189324,Staff,25,0,25,0
1683720628744,TDHT 102,A00,189325,Staff,49,0,50,1
1683720629771,TDMV 1,A00,189295,Arcidiacono; Kristin,20,0,30,10
1683720629771,TDMV 1,B00,189296,Caligagan; Maria T.,23,0,30,7
1683720630798,TDMV 2,A00,189297,Sammartano; Tonnie,27,0,30,3
1683720630798,TDMV 2,B00,189299,Arcidiacono; Kristin,23,0,30,7
1683720631824,TDMV 3,A00,204998,Rincon; Alicia,22,0,30,8
1683720632852,TDMV 120,A00,189458,Sammartano; Tonnie,28,0,30,2
1683720633883,TDMV 138,A00,189541,Jun; Grace Shin Hae,20,0,40,20
1683720634910,TDMV 142,A00,189717,Caligagan; Tony,25,0,30,5
1683720634910,TDMV 142,B00,189718,Caligagan; Maria T.,25,0,30,5
1683720635945,TMC 2,A01,187533,Staff,25,0,25,0
1683720635945,TMC 2,A02,187534,Staff,25,0,25,0
1683720636971,USP 1,A01,187536,Kwak; Nancy,0,16,25,25
1683720637998,USP 5,A01,187538,Staff,8,0,25,17
1683720639026,USP 101,A00,199253,Staff,0,4,0,0
1683720640056,USP 124,A00,187562,Boomhower; Matthew Charles,0,0,30,30
1683720641086,USP 138,A00,187582,Staff,19,0,25,6
1683720642111,USP 152,A01,187597,Staff,3,0,25,22
1683720643136,USP 153,A00,187598,Staff,18,0,25,7
1683720644166,USP 168,A00,187607,Kwak; Nancy,2,0,5,3
1683720645195,USP 173,A00,187619,Staff,4,0,25,21
1683720646221,USP 181,A00,187638,Staff,0,4,25,25
1683720647256,VIS 103,A00,187650,Cruz; Edwin Teddy,17,0,75,58
1683720648282,VIS 110D,A00,187669,Staff,13,0,22,9
1683720649311,VIS 127C,A00,187720,Shen; Kuiyi,67,0,146,79
1683720650342,VIS 149,A00,187731,Yoldas; Pinar,0,12,22,22
1683720651375,VIS 151,A01,188091,Staff,22,0,34,12
1683720651375,VIS 151,A02,188092,Staff,11,0,34,23
1683720652401,VIS 160B,A00,188093,Stalbaum; Brett,0,1,10,10
1683720654458,WCWP 10B,A00,201720,Staff,0,0,5,5
1683720654458,WCWP 10B,B00,201722,Staff,0,0,6,6
1683720655489,WCWP 100,A00,201725,Gagnon; Jeffrey C,0,0,2,2
1683720655489,WCWP 100,B00,201727,Staff,0,4,15,15
1683720658668,ANBI 133,A00,258401,Wilder; Linnea Lorene,34,0,40,6
1683720659694,ANBI 140,A00,258395,Hrvoj Mihic; Branka,18,0,25,7
1683720660725,ANSC 120,A00,258402,Bialecki; Jon Anthony,26,0,40,14
1683720661750,ANSC 144,A00,258400,Staff,12,0,40,28
1683720663807,ANSC 166,A00,258396,Parish; Steven Martin,156,0,175,19
1683720664838,ANSC 180,A00,193533,Staff,8,0,20,12
1683720665869,ANSC 188,A00,258397,Jassal; Aftab,34,0,40,6
1683720666895,ANTH 3,A01,258316,Staff,23,0,30,7
1683720667922,ANTH 5,A00,258394,Semendeferi; Ekaterini,16,0,20,4
1683720668952,ANTH 21,A01,258331,Staff,4,0,40,36
1683720669981,ANTH 103,A00,258398,Varma; Saiba,15,0,25,10
1683720671013,AWP 10,001,202034,Staff,0,0,0,0
1683720671013,AWP 10,002,202035,Staff,0,0,0,0
1683720671013,AWP 10,003,202036,Staff,0,0,0,0
1683720671013,AWP 10,004,202037,Staff,0,0,0,0
1683720671013,AWP 10,005,202038,Staff,0,0,0,0
1683720671013,AWP 10,006,202039,Staff,0,0,0,0
1683720671013,AWP 10,007,202040,Staff,0,0,0,0
1683720671013,AWP 10,008,202041,Staff,0,0,0,0
1683720671013,AWP 10,009,202042,Staff,0,0,0,0
1683720671013,AWP 10,010,202043,Staff,0,0,0,0
1683720671013,AWP 10,011,202044,Staff,0,0,0,0
1683720671013,AWP 10,012,202045,Staff,0,0,0,0
1683720671013,AWP 10,013,202046,Staff,0,0,0,0
1683720671013,AWP 10,014,202047,Staff,0,0,0,0
1683720671013,AWP 10,015,202048,Staff,0,0,0,0
1683720671013,AWP 10,016,202049,Staff,0,0,0,0
1683720671013,AWP 10,017,202050,Staff,0,0,0,0
1683720671013,AWP 10,018,202051,Staff,0,0,0,0
1683720671013,AWP 10,019,202052,Staff,0,0,0,0
1683720671013,AWP 10,020,202053,Staff,0,0,0,0
1683720671013,AWP 10,021,202054,Staff,0,0,0,0
1683720671013,AWP 10,022,202055,Staff,0,0,0,0
1683720671013,AWP 10,023,202056,Staff,0,0,0,0
1683720671013,AWP 10,024,202057,Staff,0,0,0,0
1683720671013,AWP 10,025,202058,Staff,0,0,0,0
1683720671013,AWP 10,026,202059,Staff,0,0,0,0
1683720672039,AWP 102,001,202032,Staff,0,0,0,0
1683720672039,AWP 102,002,202033,Staff,0,0,0,0
1683720673123,BENG 100,A01,254234,Taylor Amos; Alyssa C,31,0,40,9
1683720674151,BENG 196,001,270013,Engler; Adam J.,9999,0,9999,0
1683720675187,BICD 100R,A01,202018,Smith; Laurie,0,7,32,32
1683720675187,BICD 100R,A02,202019,Smith; Laurie,0,3,32,32
1683720675187,BICD 100R,A03,202020,Smith; Laurie,0,1,32,32
1683720675187,BICD 100R,A04,202021,Smith; Laurie,6,0,32,26
1683720675187,BICD 100R,A05,202022,Smith; Laurie,10,0,32,22
1683720676212,BICD 136,A01,193242,Gustafson-Brown; Cindy,0,2,32,32
1683720676212,BICD 136,A02,193244,Gustafson-Brown; Cindy,13,0,32,19
1683720677239,BIEB 102,A01,193249,Butler; Shannon Rhey,0,0,32,32
1683720677239,BIEB 102,A02,193251,Butler; Shannon Rhey,0,0,32,32
1683720677239,BIEB 102,A03,193253,Butler; Shannon Rhey,0,0,32,32
1683720677239,BIEB 102,A04,193255,Butler; Shannon Rhey,13,0,32,19
1683720677239,BIEB 102,A05,193265,Butler; Shannon Rhey,25,0,32,7
1683720677239,BIEB 102,A06,193269,Butler; Shannon Rhey,12,0,32,20
1683720679290,BIEB 150,A01,193274,Staff,0,0,32,32
1683720679290,BIEB 150,A02,193285,Staff,24,0,32,8
1683720680317,BIEB 194,A00,193286,Kurle; Carolyn M.,19,0,32,13
1683720681353,BILD 1,A01,192291,Staff,15,0,32,17
1683720681353,BILD 1,A02,192292,Staff,30,0,32,2
1683720681353,BILD 1,B01,192520,Reuther; Keefe,0,1,0,0
1683720681353,BILD 1,B02,192532,Reuther; Keefe,0,1,0,0
1683720682385,BILD 3,A01,192556,Butler; Shannon Rhey,0,0,32,32
1683720682385,BILD 3,A02,192581,Butler; Shannon Rhey,0,1,32,32
1683720682385,BILD 3,A03,192611,Butler; Shannon Rhey,19,0,32,13
1683720682385,BILD 3,A04,192612,Butler; Shannon Rhey,23,0,32,9
1683720682385,BILD 3,A05,192613,Butler; Shannon Rhey,26,0,32,6
1683720682385,BILD 3,A06,192679,Butler; Shannon Rhey,27,0,32,5
1683720682385,BILD 3,A07,192682,Butler; Shannon Rhey,20,0,32,12
1683720683417,BILD 4,A01,192836,Reuther; Keefe,1,0,24,23
1683720683417,BILD 4,A02,193044,Reuther; Keefe,4,0,24,20
1683720684447,BILD 10,A01,193142,Gustafson-Brown; Cindy,29,0,32,3
1683720684447,BILD 10,A02,193149,Gustafson-Brown; Cindy,31,0,32,1
1683720685477,BIMM 100,A01,193301,Staff,0,6,32,32
1683720685477,BIMM 100,A02,193312,Staff,0,7,32,32
1683720685477,BIMM 100,A03,193323,Staff,0,10,32,32
1683720686509,BIMM 101,A01,193329,McDonnell; Lisa Marie,0,3,24,24
1683720686509,BIMM 101,A02,193339,McDonnell; Lisa Marie,0,3,24,24
1683720686509,BIMM 101,B01,193354,McDonnell; Lisa Marie,0,4,24,24
1683720686509,BIMM 101,B02,193357,McDonnell; Lisa Marie,0,3,24,24
1683720687536,BIMM 110,A01,193377,Tat; John,0,11,32,32
1683720687536,BIMM 110,A02,193378,Tat; John,0,11,32,32
1683720688565,BIMM 120,A01,206116,Staff,0,0,32,32
1683720688565,BIMM 120,A02,206117,Staff,7,0,32,25
1683720688565,BIMM 120,A03,206121,Staff,21,0,32,11
1683720689598,BIPN 100,A01,193393,Park; Ji Young,0,15,32,32
1683720689598,BIPN 100,A02,193402,Park; Ji Young,0,14,32,32
1683720689598,BIPN 100,A03,193413,Park; Ji Young,0,14,32,32
1683720689598,BIPN 100,A04,193414,Park; Ji Young,0,13,32,32
1683720690622,BIPN 102,A01,193429,Staff,0,0,32,32
1683720690622,BIPN 102,A02,193438,Staff,18,0,32,14
1683720691653,BIPN 106,A01,193450,Reyes Gonzalez; Catalina,0,2,40,40
1683720692680,BIPN 134,A01,193465,Cooke; James Edward,0,0,32,32
1683720692680,BIPN 134,A02,193474,Cooke; James Edward,25,0,32,7
1683720692680,BIPN 134,A03,193485,Cooke; James Edward,29,0,32,3
1683720692680,BIPN 134,A04,193486,Cooke; James Edward,20,0,32,12
1683720692680,BIPN 134,A05,193491,Cooke; James Edward,31,0,32,1
1683720692680,BIPN 134,A06,193501,Cooke; James Edward,30,0,32,2
1683720692680,BIPN 134,A07,193510,Cooke; James Edward,29,0,32,3
1683720694737,BISP 194,A00,222522,Staff,14,0,32,18
1683720695763,CAT 124,A01,202407,Staff,19,0,25,6
1683720696790,CAT 125,A00,202408,Marchisotto; Jennifer Anne,2,0,20,18
1683720697820,CAT 125R,A00,202409,Smith; Lauryn Alissa,0,11,20,20
1683720697820,CAT 125R,B00,202410,Morales; Celeste Georgianna,0,11,20,20
1683720697820,CAT 125R,C00,202411,Irwin; Matthew Joseph,0,12,20,20
1683720698853,CENG 15,A01,204712,Yang; Kesong,0,1,0,0
1683720699878,CENG 114,A00,202070,Jahed Motlagh; Zeinab,5,0,20,15
1683720700905,CGS 105,A00,185477,Wesling; Megan E.,24,0,40,16
1683720701929,CGS 106,A00,185494,Staff,11,0,22,11
1683720702955,CGS 108,A00,185495,Staff,14,0,20,6
1683720703981,CGS 114,A00,185496,Staff,13,0,18,5
1683720705010,CGS 119,A00,185501,Staff,15,0,20,5
1683720706037,CGS 120,A00,185511,Staff,11,0,20,9
1683720707067,CHEM 4,A01,184675,Bussey; Thomas J,97,0,100,3
1683720708096,CHEM 6A,A01,184677,Staff,32,0,60,28
1683720709121,CHEM 6B,A01,184679,Staff,63,0,100,37
1683720710147,CHEM 6C,A01,184681,Bussey; Thomas J,0,0,50,50
1683720710147,CHEM 6C,A02,184682,Bussey; Thomas J,32,0,50,18
1683720711174,CHEM 40A,A01,184684,Albizati; Kim F.,33,0,100,67
1683720712199,CHEM 40B,A01,184686,Albizati; Kim F.,0,22,100,100
1683720713226,CHEM 41B,A01,184690,Staff,51,0,100,49
1683720714253,COGS 3,A01,184715,Boyle; Mary E. T.,0,27,40,40
1683720715279,COGS 14B,A01,185172,Staff,0,14,38,38
1683720716305,COGS 18,A01,184736,Staff,14,0,80,66
1683720717332,COGS 100,A01,184932,Staff,0,8,73,73
1683720718359,COGS 101A,A01,184935,Staff,0,40,30,30
1683720719385,COGS 101B,A01,184944,Staff,0,2,30,30
1683720720413,COGS 101C,A01,184946,Staff,0,10,30,30
1683720721440,COGS 102A,A01,184951,Johnson; Christine M.,1,0,40,39
1683720722467,COGS 107B,A01,184953,Mooshagian; Eric Frederick,0,52,40,40
1683720723500,COGS 118B,A01,184959,Gupta; Anjum,0,50,40,40
1683720724525,COGS 153,A00,184961,Staff,1,16,30,29
1683720725555,COGS 177,A00,184962,Staff,0,20,30,30
1683720726579,COGS 187A,A01,184969,Boyle; Mary E. T.,0,19,40,40
1683720727609,COMM 10,A01,185174,Staff,0,5,25,25
1683720727609,COMM 10,A02,185189,Staff,0,2,25,25
1683720727609,COMM 10,A03,269821,Staff,0,1,0,0
1683720728635,COMM 100B,A02,185476,Staff,10,0,25,15
1683720728635,COMM 100B,A03,277340,Staff,25,0,25,0
1683720729661,COMM 100C,A01,185314,Staff,2,0,25,23
1683720729661,COMM 100C,A02,185327,Staff,17,0,25,8
1683720730686,COMM 110M,A00,185349,Staff,0,0,40,40
1683720731721,COMM 113T,A00,185352,Staff,25,0,40,15
1683720732750,COMM 114I,A00,185353,Staff,31,0,40,9
1683720733777,COMM 131,A00,185354,Staff,17,0,30,13
1683720734802,CSE 8A,A50,185358,Cao; Yingjun,0,46,10,10
1683720735832,CSE 8B,A01,185362,Staff,0,48,50,50
1683720736861,CSE 11,A01,185416,Cao; Yingjun,0,91,10,10
1683720737892,CSE 20,A01,185445,Briones; Jor-el Thomas Caparas,3,0,25,22
1683720738921,CSE 21,A01,185447,Staff,9,0,50,41
1683720739947,CSE 101,A01,185451,Staff,0,13,50,50
1683720739947,CSE 101,B01,185453,Jones; Miles E,0,15,50,50
1683720742005,CSE 141,A01,185458,Eldon; John,16,0,100,84
1683720743030,CSE 141L,A01,185461,Eldon; John,8,0,100,92
1683720744056,CSE 142,A01,185463,Staff,34,0,60,26
1683720744056,CSE 142,B01,201355,Staff,0,7,60,60
1683720745084,CSE 142L,A01,185470,Staff,34,0,60,26
1683720745084,CSE 142L,B01,201417,Staff,0,6,60,60
1683720746113,CSE 190,A00,201433,Staff,32,0,49,17
1683720747147,DOC 1,A01,259136,Strom; Megan C.,7,0,15,8
1683720747147,DOC 1,A02,259137,Strom; Megan C.,15,0,15,0
1683720747147,DOC 1,A03,259138,Strom; Megan C.,14,0,15,1
1683720747147,DOC 1,A04,259139,Strom; Megan C.,13,0,15,2
1683720748173,DOC 100D,A00,259140,Pass; Natalye Joann,14,0,25,11
1683720749204,DSGN 1,A01,184749,Rill; Bryan,0,26,30,30
1683720750229,DSGN 100,A01,185168,Staff,0,2,25,25
1683720751260,ECE 5,A01,185626,Morris; Karcher William,0,12,0,0
1683720752285,ECE 101,A01,185628,Staff,14,0,70,56
1683720753314,ECE 107,A01,185635,Baghdadchi; Saharnaz,0,0,20,20
1683720753314,ECE 107,A02,185638,Baghdadchi; Saharnaz,1,0,20,19
1683720754340,ECE 148,A01,185647,Silberman; Jack,0,0,16,16
1683720755369,ECON 1,A01,185537,Crane; Meredith Helen,54,0,70,16
1683720756395,ECON 3,A01,185549,Crane; Meredith Helen,30,0,70,40
1683720757421,ECON 4,A01,203354,Anderson; John Charles,0,5,10,10
1683720758449,ECON 100A,A01,185574,Staff,0,5,40,40
1683720759478,ECON 100B,A01,185576,Staff,0,12,50,50
1683720760506,ECON 100C,A01,185589,Newhouse; Herbert S,30,0,70,40
1683720761534,ECON 105,A00,185608,Vespa; Emanuel Ignacio,19,0,35,16
1683720762560,ECON 109,A01,185610,Shishkin; Denis,9,0,35,26
1683720763585,ECON 110A,A01,185612,Staff,8,0,40,32
1683720764610,ECON 120A,A01,185615,Staff,19,0,40,21
1683720765643,ECON 120C,A01,185617,Sun; Yixiao,0,21,70,70
1683720766669,ECON 144,A00,203346,Squires; Dale E,2,0,35,33
1683720767694,ECON 171,A01,203349,Newhouse; Herbert S,0,1,35,35
1683720768725,ECON 173A,A01,185621,Toda; Alexis Akira,21,0,35,14
1683720769754,EDS 25,A01,202413,Staff,0,1,0,0
1683720769754,EDS 25,A02,202414,Staff,0,1,0,0
1683720769754,EDS 25,A03,202415,Staff,0,0,0,0
1683720769754,EDS 25,A04,202416,Staff,0,1,0,0
1683720769754,EDS 25,A05,202439,Staff,0,0,0,0
1683720769754,EDS 25,A06,202440,Staff,0,0,0,0
1683720769754,EDS 25,B01,202631,Staff,0,0,0,0
1683720769754,EDS 25,B02,202632,Staff,0,0,0,0
1683720769754,EDS 25,B03,202639,Staff,0,0,0,0
1683720769754,EDS 25,B04,202640,Staff,0,0,0,0
1683720769754,EDS 25,B05,202643,Staff,0,0,0,0
1683720769754,EDS 25,B06,202644,Staff,0,0,0,0
1683720770781,EDS 38,A01,202659,Black; Alison Michelle,25,0,25,0
1683720771806,EDS 115,A00,202652,Staff,18,0,30,12
1683720772834,EDS 125,A00,202649,Staff,13,0,30,17
1683720773863,EDS 126,A01,203332,Staff,30,0,30,0
1683720774887,EDS 139,A00,202838,Staff,16,0,25,9
1683720775913,EDS 146,A01,202655,Staff,14,0,25,11
1683720776999,ENG 15,A00,185667,Staff,0,1,0,0
1683720776999,ENG 15,B00,185672,Staff,0,0,0,0
1683720776999,ENG 15,C00,185675,Staff,0,0,0,0
1683720776999,ENG 15,D00,185682,Staff,0,0,0,0
1683720776999,ENG 15,E00,185684,Staff,0,0,0,0
1683720778026,ETHN 103,A00,185710,Staff,0,8,35,35
1683720779058,ETHN 103A,A00,199228,Man; Simeon S,0,0,9,9
1683720780087,ETHN 109,A00,185711,Staff,15,0,35,20
1683720781132,ETHN 142,A00,185726,Staff,0,4,30,30
1683720782157,ETHN 163J,A00,199229,Man; Simeon S,5,0,8,3
1683720783182,ETHN 168,A00,185727,Staff,7,0,10,3
1683720784209,ETHN 182,A00,185728,Staff,0,0,35,35
1683720785235,ETHN 183,A00,185737,Staff,10,0,18,8
1683720786263,GLBH 111,A01,209361,Burgos; Jose L.,0,0,0,0
1683720788314,HIEU 104,A00,185792,Staff,14,0,20,6
1683720789339,HIEU 115,A00,185800,Staff,0,0,20,20
1683720790362,HIEU 128,A00,185801,Staff,0,9,20,20
1683720791386,HIEU 147,A00,185802,Staff,15,0,20,5
1683720792411,HIEU 154,A00,185823,Staff,11,0,20,9
1683720793436,HILA 102,A00,185826,Staff,14,0,20,6
1683720794465,HILD 2C,A01,185778,Staff,0,13,20,20
1683720795491,HILD 7B,A01,185780,Kwak; Nancy,0,17,32,32
1683720795491,HILD 7B,A02,185781,Kwak; Nancy,0,18,32,32
1683720796522,HILD 30,A01,185791,Staff,12,0,20,8
1683720797553,HISC 119,A00,185830,Golan; Tal,0,10,20,20
1683720798579,HITO 156GS,A00,185831,Patterson; Patrick H.,0,0,0,23
1683720799605,HIUS 103,A00,185832,Man; Simeon S,0,4,20,20
1683720800632,HIUS 117,A00,185836,Kwak; Nancy,2,0,20,18
1683720801657,HIUS 125,A00,185840,Man; Simeon S,0,2,23,23
1683720802683,HIUS 149,A00,185845,Staff,1,0,20,19
1683720803717,HUM 3,A01,185882,Zavodny; Tatiana Sophia,0,8,50,50
1683720803717,HUM 3,B01,185899,Caldwell; Michael Alan,0,18,50,50
1683720804743,HUM 3GS,A00,185900,Patterson; Patrick H.,0,0,0,23
1683720805771,HUM 4,A01,185938,Zroka; Amy Liane,28,0,50,22
1683720805771,HUM 4,B01,185956,Watkins; Eric,0,6,50,50
1683720805771,HUM 4,B02,202209,Watkins; Eric,0,6,50,50
1683720805771,HUM 4,B03,202210,Watkins; Eric,0,5,50,50
1683720806801,HUM 5,A01,185958,West; Geoffrey Scott,0,0,50,50
1683720806801,HUM 5,A02,202215,West; Geoffrey Scott,0,1,50,50
1683720807831,INTL 190,A00,185959,Gagnon; Jeffrey C,0,0,0,9
1683720807831,INTL 190,B00,185960,Lettieri; Michael Joseph,0,0,0,2
1683720808857,JAPN 180,A00,254509,Staff,4,0,30,26
1683720809885,LATI 10,A01,202853,Kennemore; Amy Michelle,4,0,35,31
1683720809885,LATI 10,A02,202854,Kennemore; Amy Michelle,3,0,35,32
1683720809885,LATI 10,A03,270054,Kennemore; Amy Michelle,30,0,30,0
1683720810916,LATI 180,A00,202855,Kennemore; Amy Michelle,11,0,20,9
1683720811944,LAWS 101,A00,201767,Golan; Tal,0,7,40,40
1683720812970,LIFR 1C,A00,185961,Staff,6,0,20,14
1683720813999,LIFR 1CX,A00,185962,Staff,7,0,20,13
1683720815027,LIFR 1D,A00,185963,Staff,7,0,20,13
1683720816055,LIFR 1DX,A00,185964,Staff,7,0,20,13
1683720817080,LIGN 101,A01,186039,Staff,43,0,50,7
1683720818108,LIGN 165,A00,186040,Staff,14,0,50,36
1683720819134,LTCS 108,A00,186041,Staff,5,0,10,5
1683720820161,LTCS 119,A00,186042,Staff,15,0,20,5
1683720821193,LTCS 130,A00,186043,Wesling; Megan E.,15,0,25,10
1683720823245,LTEA 138,A00,186119,Staff,13,0,40,27
1683720824270,LTEN 124,A00,186148,Staff,5,0,25,20
1683720825299,LTEN 178,A00,186149,Staff,6,0,15,9
1683720826326,LTEN 181,A00,186150,Blanco; John D,34,0,40,6
1683720827355,LTWL 120,A00,186160,Staff,19,0,25,6
1683720828380,LTWL 165,A00,186161,Staff,22,0,25,3
1683720829405,LTWR 100,A00,186162,Staff,0,5,15,15
1683720830431,LTWR 102,A00,186163,Doller; Ben,5,0,15,10
1683720831461,MAE 8,A01,186412,Staff,0,1,0,0
1683720832492,MAE 30B,A00,186445,Bahadori; Mohammad Yousef,81,0,100,19
1683720833517,MAE 40,A00,186592,Bewley; Thomas R,10,0,50,40
1683720834543,MAE 101B,A00,186593,Bahadori; Mohammad Yousef,80,0,100,20
1683720835573,MAE 105,A00,186594,Bandaru; Prabhakar,10,0,50,40
1683720836600,MAE 107,A00,186599,Pham; Hieu Tan,0,8,120,120
1683720837627,MAE 148,A01,186660,Silberman; Jack,3,0,16,13
1683720838657,MATH 10A,A01,188095,Staff,0,6,35,35
1683720839684,MATH 10B,A01,188097,Bowers; Adam R.,0,12,30,30
1683720839684,MATH 10B,A02,188099,Bowers; Adam R.,0,11,30,30
1683720839684,MATH 10B,B01,188104,Bowers; Adam R.,0,10,30,30
1683720839684,MATH 10B,B02,188106,Bowers; Adam R.,0,9,30,30
1683720840712,MATH 10C,A01,188111,Staff,0,20,30,30
1683720840712,MATH 10C,A02,188127,Staff,0,19,30,30
1683720840712,MATH 10C,A03,188131,Staff,0,19,30,30
1683720840712,MATH 10C,B01,188218,Staff,17,0,30,13
1683720840712,MATH 10C,B02,188244,Staff,13,0,30,17
1683720840712,MATH 10C,B03,188277,Staff,14,0,30,16
1683720841746,MATH 18,A01,188344,Bach; Quang Tran,18,0,30,12
1683720841746,MATH 18,A02,188345,Bach; Quang Tran,11,0,30,19
1683720841746,MATH 18,B01,188353,Bach; Quang Tran,11,0,30,19
1683720841746,MATH 18,B02,188354,Bach; Quang Tran,19,0,30,11
1683720842772,MATH 20A,A01,188374,Staff,11,0,35,24
1683720843806,MATH 20B,A01,188382,Ohm; Ko Woon,7,0,30,23
1683720843806,MATH 20B,A02,188383,Ohm; Ko Woon,22,0,30,8
1683720843806,MATH 20B,B01,188385,Ohm; Ko Woon,7,0,30,23
1683720843806,MATH 20B,B02,188392,Ohm; Ko Woon,22,0,30,8
1683720844837,MATH 20C,A01,188394,Harel; Guershon,10,0,30,20
1683720844837,MATH 20C,A02,188395,Harel; Guershon,13,0,30,17
1683720844837,MATH 20C,B01,188404,Harel; Guershon,5,0,30,25
1683720844837,MATH 20C,B02,188405,Harel; Guershon,18,0,30,12
1683720845863,MATH 20D,A01,188414,Hammock; Frances H,0,1,30,30
1683720845863,MATH 20D,A02,188415,Hammock; Frances H,0,1,30,30
1683720845863,MATH 20D,B01,188447,Hammock; Frances H,0,1,30,30
1683720845863,MATH 20D,B02,188486,Hammock; Frances H,2,0,30,28
1683720846892,MATH 20E,A01,188649,Staff,21,0,30,9
1683720846892,MATH 20E,A02,188650,Staff,20,0,30,10
1683720846892,MATH 20E,A03,188673,Staff,0,0,30,30
1683720847920,MATH 102,A01,188675,Staff,0,40,35,35
1683720848945,MATH 103B,A01,188681,Staff,3,0,35,32
1683720848945,MATH 103B,B01,188692,Staff,5,0,35,30
1683720849976,MATH 109,A01,188695,Salehi Golsefidy; Alireza,24,0,35,11
1683720849976,MATH 109,A02,188696,Salehi Golsefidy; Alireza,24,0,35,11
1683720851007,MATH 120A,A01,188698,Eggers; John Dietrich,7,0,35,28
1683720852036,MATH 142B,A01,188736,Ioana; Adrian,0,0,30,30
1683720852036,MATH 142B,A02,188741,Ioana; Adrian,0,1,30,30
1683720852036,MATH 142B,A03,188743,Ioana; Adrian,0,3,30,30
1683720853063,MATH 168A,A01,188790,Staff,0,11,35,35
1683720854094,MATH 170A,A01,188803,Nie; Jiawang,0,2,35,35
1683720854094,MATH 170A,A02,188811,Nie; Jiawang,0,1,35,35
1683720854094,MATH 170A,A03,188814,Nie; Jiawang,1,0,35,34
1683720854094,MATH 170A,A04,188815,Nie; Jiawang,5,0,35,30
1683720855123,MATH 193B,A01,188817,Staff,0,0,35,35
1683720855123,MATH 193B,A02,188818,Staff,6,0,35,29
1683720856155,MGT 4,A01,202857,Anderson; John Charles,59,0,80,21
1683720857179,MGT 12,A00,202858,Lindenberger; Wade Douglas,40,0,90,50
1683720858204,MGT 18,A00,202859,Staff,73,0,90,17
1683720859228,MGT 18GS,A00,202860,McKay; Michael J,13,0,28,15
1683720860254,MGT 45,A00,202861,Pecore; Joseph P.,8,0,90,82
1683720861279,MGT 100,A00,202863,Yavorsky; Daniel Ryan,27,0,90,63
1683720862304,MGT 103,A00,202864,Ehrich; Kristine R,0,19,90,90
1683720863333,MGT 112,A00,202865,Ehrich; Kristine R,15,0,90,75
1683720864365,MGT 121A,A00,202868,Staff,70,0,90,20
1683720865391,MGT 131B,A00,202869,Anderson; John Charles,58,0,90,32
1683720866420,MGT 136,A00,202871,Lindenberger; Wade Douglas,83,0,90,7
1683720867446,MGT 164,A00,202873,Staff,0,67,90,91
1683720868475,MGT 164GS,A00,202874,McKay; Mary A,13,0,28,15
1683720869499,MGT 180,A00,202875,Staff,0,51,90,91
1683720870532,MMW 11R,A01,205019,Herbst; Matthew,0,0,30,30
1683720870532,MMW 11R,A02,205026,Herbst; Matthew,29,0,30,1
1683720871566,MMW 15,A01,193512,Chang; Edmond Yi-Teh,0,8,28,28
1683720871566,MMW 15,A02,193513,Chang; Edmond Yi-Teh,0,5,28,28
1683720871566,MMW 15,A03,193514,Chang; Edmond Yi-Teh,0,5,28,28
1683720871566,MMW 15,A04,193515,Chang; Edmond Yi-Teh,0,5,28,28
1683720871566,MMW 15,A05,193516,Chang; Edmond Yi-Teh,0,5,28,28
1683720871566,MMW 15,A06,193517,Chang; Edmond Yi-Teh,0,6,28,28
1683720871566,MMW 15,B01,193519,Chang; Edmond Yi-Teh,0,5,28,28
1683720871566,MMW 15,B02,193520,Chang; Edmond Yi-Teh,0,5,28,28
1683720871566,MMW 15,B03,193521,Chang; Edmond Yi-Teh,0,5,28,28
1683720871566,MMW 15,B04,193522,Chang; Edmond Yi-Teh,0,6,28,28
1683720871566,MMW 15,B05,193523,Chang; Edmond Yi-Teh,0,5,28,28
1683720871566,MMW 15,B06,193524,Chang; Edmond Yi-Teh,0,5,28,28
1683720872591,MMW 122,A01,193526,Rahimi; Babak,0,16,28,28
1683720872591,MMW 122,A02,193527,Rahimi; Babak,0,15,28,28
1683720872591,MMW 122,A03,193528,Rahimi; Babak,0,0,0,0
1683720872591,MMW 122,A04,193529,Rahimi; Babak,0,0,0,0
1683720873621,MUS 1A,A01,186663,Staff,0,18,35,35
1683720874660,MUS 4,A01,186715,Staff,0,12,35,35
1683720875688,MUS 5R,A01,186796,Dubnov; Shlomo,0,17,35,35
1683720876713,MUS 6,A01,186798,Staff,0,4,25,25
1683720877739,MUS 7,A01,186830,Staff,11,0,35,24
1683720878763,MUS 8,A01,186930,Staff,0,27,35,35
1683720879789,MUS 15,A01,186932,Staff,0,15,35,35
1683720879789,MUS 15,B01,186934,Staff,0,16,35,35
1683720880870,MUS 80,A00,186935,Staff,0,0,20,20
1683720880870,MUS 80,B00,186936,Staff,24,0,25,1
1683720881902,NANO 11,A00,204702,Lipomi; Darren John,0,0,0,0
1683720882934,NANO 15,A01,204709,Yang; Kesong,0,1,0,0
1683720883960,NANO 114,A00,202069,Jahed Motlagh; Zeinab,2,0,10,8
1683720884991,PHIL 1,A00,186955,Grush; Rick Scott,31,0,40,9
1683720886021,PHIL 10,A01,186973,Grush; Rick Scott,27,0,35,8
1683720886021,PHIL 10,A02,186974,Grush; Rick Scott,33,0,35,2
1683720887047,PHIL 13,A01,186976,Staff,1,0,35,34
1683720887047,PHIL 13,A02,186977,Staff,16,0,35,19
1683720888072,PHIL 14,A01,186979,Staff,30,0,35,5
1683720888072,PHIL 14,A02,186986,Staff,32,0,35,3
1683720889102,PHIL 28,A01,186988,Staff,16,0,30,14
1683720889102,PHIL 28,A02,186989,Staff,0,0,30,30
1683720889102,PHIL 28,A03,186990,Staff,10,0,30,20
1683720889102,PHIL 28,A04,186991,Staff,26,0,30,4
1683720890131,PHIL 120,A00,186997,Staff,23,0,40,17
1683720891156,PHIL 137,A00,187003,Staff,8,0,40,32
1683720892184,PHIL 150,A00,187015,Staff,47,0,70,23
1683720893209,PHIL 167,A00,187021,Lamey; Andy M.,34,0,40,6
1683720894238,PHIL 174,A01,202226,Staff,17,0,20,3
1683720894238,PHIL 174,A02,202235,Staff,20,0,20,0
1683720895266,PHIL 191A,A00,258918,Staff,0,0,1,1
1683720896294,PHYS 1A,A00,187028,Staff,26,0,60,34
1683720897320,PHYS 1AL,001,187036,Staff,3,0,30,27
1683720897320,PHYS 1AL,002,187049,Staff,18,0,30,12
1683720898342,PHYS 1B,A00,187058,Staff,21,0,60,39
1683720899371,PHYS 1BL,001,187064,Staff,0,1,30,30
1683720899371,PHYS 1BL,002,187070,Staff,4,0,30,26
1683720900400,PHYS 1C,A00,187082,Staff,30,0,120,90
1683720901440,PHYS 1CL,001,187088,Staff,0,9,30,30
1683720901440,PHYS 1CL,002,187089,Staff,0,1,30,30
1683720901440,PHYS 1CL,009,262693,Staff,9,0,30,21
1683720902465,PHYS 2B,A01,187097,Staff,55,0,115,60
1683720903492,PHYS 2C,A01,187099,Staff,63,0,115,52
1683720904522,PHYS 2CL,A01,187101,Staff,5,0,28,23
1683720904522,PHYS 2CL,A02,187102,Staff,15,0,28,13
1683720905545,PHYS 2D,A01,187123,Shotwell; Brian,95,0,115,20
1683720906578,PHYS 4B,A01,187133,Grinstein; Benjamin,35,0,50,15
1683720907604,POLI 10,A00,188819,Staff,0,4,50,50
1683720908630,POLI 11,A00,188827,Staff,43,0,50,7
1683720909659,POLI 13R,A00,188828,Staff,0,2,20,20
1683720910687,POLI 27,A01,188830,Elgin; Samuel Zincke,0,2,70,70
1683720911722,POLI 30,A00,188832,Desposato; Scott,30,0,50,20
1683720912747,POLI 102F,A00,188834,Staff,1,0,40,39
1683720913771,POLI 104A,A00,188852,Staff,12,0,30,18
1683720914795,POLI 104I,A00,188853,Staff,0,8,20,20
1683720915825,POLI 110B,A00,188854,Wiens; David,6,0,20,14
1683720916853,POLI 112A,A00,188855,Wiens; David,3,0,30,27
1683720917878,POLI 117R,A00,188856,Forman; Fonna,0,12,20,20
1683720918904,POLI 118,A00,188857,Ingham; Sean,8,0,20,12
1683720919928,POLI 120G,A00,188858,Staff,7,0,30,23
1683720920951,POLI 131CR,A00,188863,Hoston; Germaine,20,0,50,30
1683720921978,POLI 133,A00,188864,Nellis; Gareth Hb,44,0,50,6
1683720923003,POLI 134D,A00,188865,Desposato; Scott,27,0,30,3
1683720924033,POLI 142A,A00,188871,Gartzke; Erik,21,0,50,29
1683720925058,POLI 142K,A00,188874,Staff,38,0,50,12
1683720926081,POLI 143,A00,188940,Gartzke; Erik,15,0,30,15
1683720927107,POLI 153,A00,188943,Staff,1,0,20,19
1683720928132,POLI 160AA,A00,188944,Staff,10,0,40,30
1683720929156,POLI 170A,A00,188945,Staff,10,0,30,20
1683720931208,PSYC 1,A00,188952,Staff,36,0,90,54
1683720932236,PSYC 2,B00,188953,Staff,19,0,35,16
1683720933261,PSYC 6,A00,188970,Staff,47,0,60,13
1683720934288,PSYC 7,A00,188973,Staff,35,0,45,10
1683720935318,PSYC 60,A01,188980,Rickard; Timothy C.,42,0,60,18
1683720936347,PSYC 70,A01,189001,Steiner; Eric Tomas,22,0,45,23
1683720937374,PSYC 100,A00,189005,Lacefield; Katharine I,1,98,120,119
1683720938403,PSYC 102,A00,189008,Staff,6,0,30,24
1683720939428,PSYC 106,B00,189026,Gorman; Michael R.,27,0,60,33
1683720940457,PSYC 114,B01,189033,Winkielman; Piotr,0,31,30,30
1683720941486,PSYC 131,A00,189036,Anagnostaras; Stephan,0,44,60,60
1683720942511,PSYC 136,A00,189041,Lowe; Angela Beth,0,7,25,25
1683720943540,PSYC 137,A00,189057,Winkielman; Piotr,0,36,25,25
1683720944571,PSYC 144,A00,189107,Wixted; John T,0,11,50,50
1683720946625,PSYC 162,A00,189142,Staff,0,9,85,85
1683720947653,PSYC 172,A00,189144,Gorman; Michael R.,0,6,30,30
1683720949707,PSYC 179,A00,189146,Lacefield; Katharine I,0,88,120,120
1683720950736,PSYC 181,A00,189147,Anagnostaras; Stephan,0,45,90,90
1683720951766,PSYC 190R,A00,189148,Barner; David A.,0,23,80,80
1683720952792,PSYC 191,A00,189275,Rickard; Timothy C.,0,11,25,25
1683720953817,PSYC 193,A00,189276,Chapman; Eddie Nathaniel,0,1,0,4
1683720954843,PSYC 193L,A01,189281,Lowe; Angela Beth,8,0,20,12
1683720954843,PSYC 193L,B01,189285,Staff,28,0,35,7
1683720955872,RELI 149,A00,187137,Rahimi; Babak,6,0,40,34
1683720956904,SE 9,A01,187315,Staff,0,2,18,18
1683720957933,SE 101B,A00,187409,Staff,24,0,30,6
1683720958961,SE 110B,A00,187444,Staff,10,0,40,30
1683720959990,SE 130B,A00,187449,Staff,31,0,40,9
1683720961017,SE 150A,A00,187516,Staff,8,0,20,12
1683720962049,SE 154,A00,187528,Staff,29,0,50,21
1683720963082,SIO 3,A01,258171,Staff,35,0,40,5
1683720964110,SIO 10,A00,187144,Cook; Geoffrey W,0,6,75,75
1683720965142,SIO 45,A00,187152,Cook; Geoffrey W,1,7,100,99
1683720966170,SIO 109R,A00,194486,Staff,0,4,20,20
1683720968229,SIO 187,A01,187233,Kacev; David,12,0,40,28
1683720969258,SOCI 1,A01,258656,Thorpe; Charles Robert,28,0,30,2
1683720969258,SOCI 1,A02,258658,Thorpe; Charles Robert,30,0,30,0
1683720969258,SOCI 1,A03,258661,Thorpe; Charles Robert,25,0,25,0
1683720969258,SOCI 1,A04,258666,Thorpe; Charles Robert,22,0,25,3
1683720969258,SOCI 1,A05,258897,Thorpe; Charles Robert,22,0,25,3
1683720969258,SOCI 1,A06,258898,Thorpe; Charles Robert,25,0,25,0
1683720970284,SOCI 30,A01,258903,Pardo Guerra; Juan Pablo,14,0,30,16
1683720971310,SOCI 102,A00,258904,Staff,9,0,25,16
1683720972336,SOCI 106,A00,258905,Staff,19,0,25,6
1683720973362,SOCI 111,A00,258907,Ribas Norris; Janet Vanesa,26,0,30,4
1683720974388,SOCI 121R,A00,258908,Pardo Guerra; Juan Pablo,7,0,30,23
1683720975414,SOCI 126,A01,203330,Staff,14,0,20,6
1683720976438,SOCI 131,A00,258909,Thorpe; Charles Robert,30,0,60,30
1683720977471,SOCI 135,A00,258910,Payne; Christine Anna,0,13,30,30
1683720978499,SOCI 157,A00,258911,Staff,10,0,30,20
1683720979529,SOCI 184,A00,258912,Staff,25,0,30,5
1683720980558,SOCI 188D,A00,258913,Staff,22,0,30,8
1683720981583,SYN 2,001,187529,Staff,9,0,16,7
1683720981583,SYN 2,002,201452,Staff,0,20,16,16
1683720981583,SYN 2,003,201469,Staff,1,0,16,15
1683720982609,SYN 100,A01,187531,Staff,0,9,20,20
1683720982609,SYN 100,B01,201491,Staff,0,10,20,20
1683720983638,TDAC 1,A00,189286,Walsh; Kim C.,3,0,20,17
1683720983638,TDAC 1,B00,189287,Harting; Carla Kelso,10,0,20,10
1683720984748,TDAC 101,A00,189300,Walsh; Kim C.,16,0,20,4
1683720984748,TDAC 101,B00,189301,Harting; Carla Kelso,18,0,20,2
1683720985776,TDAC 102,A00,189304,Basso; Beatrice,14,0,20,6
1683720986802,TDAC 108,A00,189305,Staff,18,0,20,2
1683720987831,TDDE 131,A00,189310,Staff,19,0,20,1
1683720987831,TDDE 131,B00,189314,Staff,19,0,20,1
1683720987831,TDDE 131,C00,189315,Staff,48,0,50,2
1683720987831,TDDE 131,D00,189316,Staff,14,0,15,1
1683720987831,TDDE 131,E00,204841,Staff,20,0,20,0
1683720988858,TDGE 10,A00,189289,Staff,26,0,50,24
1683720988858,TDGE 10,B00,189290,Havis; Allan,0,1,50,50
1683720989885,TDGE 11,A00,189291,Fulton; Julia,0,4,50,50
1683720989885,TDGE 11,B00,189292,Staff,20,0,25,5
1683720989885,TDGE 11,C00,260270,Staff,0,0,0,0
1683720990915,TDGE 25,A00,189294,Staff,1,0,20,19
1683720991941,TDGE 124,A00,189318,Fulton; Julia,0,7,50,50
1683720992970,TDGE 125,A00,189319,Staff,13,0,25,12
1683720992970,TDGE 125,B00,189320,Staff,23,0,25,2
1683720993999,TDGE 127,A00,189322,Havis; Allan,1,0,50,49
1683720995025,TDHT 101,A00,189323,Staff,18,0,25,7
1683720995025,TDHT 101,B00,189324,Staff,25,0,25,0
1683720996051,TDHT 102,A00,189325,Staff,49,0,50,1
1683720997084,TDMV 1,A00,189295,Arcidiacono; Kristin,20,0,30,10
1683720997084,TDMV 1,B00,189296,Caligagan; Maria T.,23,0,30,7
1683720998115,TDMV 2,A00,189297,Sammartano; Tonnie,27,0,30,3
1683720998115,TDMV 2,B00,189299,Arcidiacono; Kristin,23,0,30,7
1683720999142,TDMV 3,A00,204998,Rincon; Alicia,22,0,30,8
1683721000166,TDMV 120,A00,189458,Sammartano; Tonnie,28,0,30,2
1683721001193,TDMV 138,A00,189541,Jun; Grace Shin Hae,20,0,40,20
1683721002223,TDMV 142,A00,189717,Caligagan; Tony,25,0,30,5
1683721002223,TDMV 142,B00,189718,Caligagan; Maria T.,25,0,30,5
1683721003253,TMC 2,A01,187533,Staff,25,0,25,0
1683721003253,TMC 2,A02,187534,Staff,25,0,25,0
1683721004280,USP 1,A01,187536,Kwak; Nancy,0,16,25,25
1683721005307,USP 5,A01,187538,Staff,8,0,25,17
1683721006337,USP 101,A00,199253,Staff,0,4,0,0
1683721007364,USP 124,A00,187562,Boomhower; Matthew Charles,0,0,30,30
1683721008394,USP 138,A00,187582,Staff,19,0,25,6
1683721009419,USP 152,A01,187597,Staff,3,0,25,22
1683721010448,USP 153,A00,187598,Staff,18,0,25,7
1683721011480,USP 168,A00,187607,Kwak; Nancy,2,0,5,3
1683721012511,USP 173,A00,187619,Staff,4,0,25,21
1683721013538,USP 181,A00,187638,Staff,0,4,25,25
1683721014564,VIS 103,A00,187650,Cruz; Edwin Teddy,17,0,75,58
1683721015593,VIS 110D,A00,187669,Staff,13,0,22,9
1683721016624,VIS 127C,A00,187720,Shen; Kuiyi,67,0,146,79
1683721017651,VIS 149,A00,187731,Yoldas; Pinar,0,12,22,22
1683721018675,VIS 151,A01,188091,Staff,22,0,34,12
1683721018675,VIS 151,A02,188092,Staff,11,0,34,23
1683721019705,VIS 160B,A00,188093,Stalbaum; Brett,0,1,10,10
1683721021762,WCWP 10B,A00,201720,Staff,0,0,5,5
1683721021762,WCWP 10B,B00,201722,Staff,0,0,6,6
1683721022789,WCWP 100,A00,201725,Gagnon; Jeffrey C,0,0,2,2
1683721022789,WCWP 100,B00,201727,Staff,0,4,15,15
1683721025921,ANBI 133,A00,258401,Wilder; Linnea Lorene,34,0,40,6
1683721026949,ANBI 140,A00,258395,Hrvoj Mihic; Branka,18,0,25,7
1683721027980,ANSC 120,A00,258402,Bialecki; Jon Anthony,26,0,40,14
1683721029006,ANSC 144,A00,258400,Staff,12,0,40,28
1683721031062,ANSC 166,A00,258396,Parish; Steven Martin,156,0,175,19
1683721032089,ANSC 180,A00,193533,Staff,8,0,20,12
1683721033114,ANSC 188,A00,258397,Jassal; Aftab,34,0,40,6
1683721034141,ANTH 3,A01,258316,Staff,23,0,30,7
1683721035168,ANTH 5,A00,258394,Semendeferi; Ekaterini,16,0,20,4
1683721036194,ANTH 21,A01,258331,Staff,4,0,40,36
1683721037224,ANTH 103,A00,258398,Varma; Saiba,15,0,25,10
1683721038258,AWP 10,001,202034,Staff,0,0,0,0
1683721038258,AWP 10,002,202035,Staff,0,0,0,0
1683721038258,AWP 10,003,202036,Staff,0,0,0,0
1683721038258,AWP 10,004,202037,Staff,0,0,0,0
1683721038258,AWP 10,005,202038,Staff,0,0,0,0
1683721038258,AWP 10,006,202039,Staff,0,0,0,0
1683721038258,AWP 10,007,202040,Staff,0,0,0,0
1683721038258,AWP 10,008,202041,Staff,0,0,0,0
1683721038258,AWP 10,009,202042,Staff,0,0,0,0
1683721038258,AWP 10,010,202043,Staff,0,0,0,0
1683721038258,AWP 10,011,202044,Staff,0,0,0,0
1683721038258,AWP 10,012,202045,Staff,0,0,0,0
1683721038258,AWP 10,013,202046,Staff,0,0,0,0
1683721038258,AWP 10,014,202047,Staff,0,0,0,0
1683721038258,AWP 10,015,202048,Staff,0,0,0,0
1683721038258,AWP 10,016,202049,Staff,0,0,0,0
1683721038258,AWP 10,017,202050,Staff,0,0,0,0
1683721038258,AWP 10,018,202051,Staff,0,0,0,0
1683721038258,AWP 10,019,202052,Staff,0,0,0,0
1683721038258,AWP 10,020,202053,Staff,0,0,0,0
1683721038258,AWP 10,021,202054,Staff,0,0,0,0
1683721038258,AWP 10,022,202055,Staff,0,0,0,0
1683721038258,AWP 10,023,202056,Staff,0,0,0,0
1683721038258,AWP 10,024,202057,Staff,0,0,0,0
1683721038258,AWP 10,025,202058,Staff,0,0,0,0
1683721038258,AWP 10,026,202059,Staff,0,0,0,0
1683721039283,AWP 102,001,202032,Staff,0,0,0,0
1683721039283,AWP 102,002,202033,Staff,0,0,0,0
1683721040313,BENG 100,A01,254234,Taylor Amos; Alyssa C,31,0,40,9
1683721041338,BENG 196,001,270013,Engler; Adam J.,9999,0,9999,0
1683721042365,BICD 100R,A01,202018,Smith; Laurie,0,7,32,32
1683721042365,BICD 100R,A02,202019,Smith; Laurie,0,3,32,32
1683721042365,BICD 100R,A03,202020,Smith; Laurie,0,1,32,32
1683721042365,BICD 100R,A04,202021,Smith; Laurie,6,0,32,26
1683721042365,BICD 100R,A05,202022,Smith; Laurie,10,0,32,22
1683721043391,BICD 136,A01,193242,Gustafson-Brown; Cindy,0,2,32,32
1683721043391,BICD 136,A02,193244,Gustafson-Brown; Cindy,13,0,32,19
1683721044419,BIEB 102,A01,193249,Butler; Shannon Rhey,0,0,32,32
1683721044419,BIEB 102,A02,193251,Butler; Shannon Rhey,0,0,32,32
1683721044419,BIEB 102,A03,193253,Butler; Shannon Rhey,0,0,32,32
1683721044419,BIEB 102,A04,193255,Butler; Shannon Rhey,13,0,32,19
1683721044419,BIEB 102,A05,193265,Butler; Shannon Rhey,25,0,32,7
1683721044419,BIEB 102,A06,193269,Butler; Shannon Rhey,12,0,32,20
1683721046469,BIEB 150,A01,193274,Staff,0,0,32,32
1683721046469,BIEB 150,A02,193285,Staff,24,0,32,8
1683721047499,BIEB 194,A00,193286,Kurle; Carolyn M.,19,0,32,13
1683721048532,BILD 1,A01,192291,Staff,15,0,32,17
1683721048532,BILD 1,A02,192292,Staff,30,0,32,2
1683721048532,BILD 1,B01,192520,Reuther; Keefe,0,1,0,0
1683721048532,BILD 1,B02,192532,Reuther; Keefe,0,1,0,0
1683721049559,BILD 3,A01,192556,Butler; Shannon Rhey,0,0,32,32
1683721049559,BILD 3,A02,192581,Butler; Shannon Rhey,0,1,32,32
1683721049559,BILD 3,A03,192611,Butler; Shannon Rhey,19,0,32,13
1683721049559,BILD 3,A04,192612,Butler; Shannon Rhey,23,0,32,9
1683721049559,BILD 3,A05,192613,Butler; Shannon Rhey,26,0,32,6
1683721049559,BILD 3,A06,192679,Butler; Shannon Rhey,27,0,32,5
1683721049559,BILD 3,A07,192682,Butler; Shannon Rhey,20,0,32,12
1683721050591,BILD 4,A01,192836,Reuther; Keefe,1,0,24,23
1683721050591,BILD 4,A02,193044,Reuther; Keefe,4,0,24,20
1683721051616,BILD 10,A01,193142,Gustafson-Brown; Cindy,29,0,32,3
1683721051616,BILD 10,A02,193149,Gustafson-Brown; Cindy,31,0,32,1
1683721052641,BIMM 100,A01,193301,Staff,0,6,32,32
1683721052641,BIMM 100,A02,193312,Staff,0,7,32,32
1683721052641,BIMM 100,A03,193323,Staff,0,10,32,32
1683721053673,BIMM 101,A01,193329,McDonnell; Lisa Marie,0,3,24,24
1683721053673,BIMM 101,A02,193339,McDonnell; Lisa Marie,0,3,24,24
1683721053673,BIMM 101,B01,193354,McDonnell; Lisa Marie,0,4,24,24
1683721053673,BIMM 101,B02,193357,McDonnell; Lisa Marie,0,3,24,24
1683721054700,BIMM 110,A01,193377,Tat; John,0,11,32,32
1683721054700,BIMM 110,A02,193378,Tat; John,0,11,32,32
1683721055732,BIMM 120,A01,206116,Staff,0,0,32,32
1683721055732,BIMM 120,A02,206117,Staff,7,0,32,25
1683721055732,BIMM 120,A03,206121,Staff,21,0,32,11
1683721056757,BIPN 100,A01,193393,Park; Ji Young,0,15,32,32
1683721056757,BIPN 100,A02,193402,Park; Ji Young,0,14,32,32
1683721056757,BIPN 100,A03,193413,Park; Ji Young,0,14,32,32
1683721056757,BIPN 100,A04,193414,Park; Ji Young,0,13,32,32
1683721057784,BIPN 102,A01,193429,Staff,0,0,32,32
1683721057784,BIPN 102,A02,193438,Staff,18,0,32,14
1683721058809,BIPN 106,A01,193450,Reyes Gonzalez; Catalina,0,2,40,40
1683721059839,BIPN 134,A01,193465,Cooke; James Edward,0,0,32,32
1683721059839,BIPN 134,A02,193474,Cooke; James Edward,25,0,32,7
1683721059839,BIPN 134,A03,193485,Cooke; James Edward,29,0,32,3
1683721059839,BIPN 134,A04,193486,Cooke; James Edward,20,0,32,12
1683721059839,BIPN 134,A05,193491,Cooke; James Edward,31,0,32,1
1683721059839,BIPN 134,A06,193501,Cooke; James Edward,30,0,32,2
1683721059839,BIPN 134,A07,193510,Cooke; James Edward,29,0,32,3
1683721061891,BISP 194,A00,222522,Staff,14,0,32,18
1683721062917,CAT 124,A01,202407,Staff,19,0,25,6
1683721063944,CAT 125,A00,202408,Marchisotto; Jennifer Anne,2,0,20,18
1683721064970,CAT 125R,A00,202409,Smith; Lauryn Alissa,0,11,20,20
1683721064970,CAT 125R,B00,202410,Morales; Celeste Georgianna,0,11,20,20
1683721064970,CAT 125R,C00,202411,Irwin; Matthew Joseph,0,12,20,20
1683721065998,CENG 15,A01,204712,Yang; Kesong,0,1,0,0
1683721067026,CENG 114,A00,202070,Jahed Motlagh; Zeinab,5,0,20,15
1683721068053,CGS 105,A00,185477,Wesling; Megan E.,24,0,40,16
1683721069082,CGS 106,A00,185494,Staff,11,0,22,11
1683721070110,CGS 108,A00,185495,Staff,14,0,20,6
1683721071134,CGS 114,A00,185496,Staff,13,0,18,5
1683721072161,CGS 119,A00,185501,Staff,15,0,20,5
1683721073187,CGS 120,A00,185511,Staff,11,0,20,9
1683721074216,CHEM 4,A01,184675,Bussey; Thomas J,97,0,100,3
1683721075240,CHEM 6A,A01,184677,Staff,32,0,60,28
1683721076266,CHEM 6B,A01,184679,Staff,63,0,100,37
1683721077298,CHEM 6C,A01,184681,Bussey; Thomas J,0,0,50,50
1683721077298,CHEM 6C,A02,184682,Bussey; Thomas J,32,0,50,18
1683721078326,CHEM 40A,A01,184684,Albizati; Kim F.,33,0,100,67
1683721079350,CHEM 40B,A01,184686,Albizati; Kim F.,0,22,100,100
1683721080376,CHEM 41B,A01,184690,Staff,51,0,100,49
1683721081401,COGS 3,A01,184715,Boyle; Mary E. T.,0,27,40,40
1683721082427,COGS 14B,A01,185172,Staff,0,14,38,38
1683721083457,COGS 18,A01,184736,Staff,14,0,80,66
1683721084486,COGS 100,A01,184932,Staff,0,8,73,73
1683721085514,COGS 101A,A01,184935,Staff,0,40,30,30
1683721086544,COGS 101B,A01,184944,Staff,0,2,30,30
1683721087569,COGS 101C,A01,184946,Staff,0,10,30,30
1683721088654,COGS 102A,A01,184951,Johnson; Christine M.,1,0,40,39
1683721089680,COGS 107B,A01,184953,Mooshagian; Eric Frederick,0,52,40,40
1683721090713,COGS 118B,A01,184959,Gupta; Anjum,0,50,40,40
1683721091737,COGS 153,A00,184961,Staff,1,16,30,29
1683721092766,COGS 177,A00,184962,Staff,0,20,30,30
1683721093795,COGS 187A,A01,184969,Boyle; Mary E. T.,0,19,40,40
1683721094865,COMM 10,A01,185174,Staff,0,5,25,25
1683721094865,COMM 10,A02,185189,Staff,0,2,25,25
1683721094865,COMM 10,A03,269821,Staff,0,1,0,0
1683721095891,COMM 100B,A02,185476,Staff,10,0,25,15
1683721095891,COMM 100B,A03,277340,Staff,25,0,25,0
1683721096918,COMM 100C,A01,185314,Staff,2,0,25,23
1683721096918,COMM 100C,A02,185327,Staff,17,0,25,8
1683721097947,COMM 110M,A00,185349,Staff,0,0,40,40
1683721098973,COMM 113T,A00,185352,Staff,25,0,40,15
1683721100004,COMM 114I,A00,185353,Staff,31,0,40,9
1683721101033,COMM 131,A00,185354,Staff,17,0,30,13
1683721102065,CSE 8A,A50,185358,Cao; Yingjun,0,46,10,10
1683721103093,CSE 8B,A01,185362,Staff,0,48,50,50
1683721104119,CSE 11,A01,185416,Cao; Yingjun,0,91,10,10
1683721105147,CSE 20,A01,185445,Briones; Jor-el Thomas Caparas,3,0,25,22
1683721106175,CSE 21,A01,185447,Staff,9,0,50,41
1683721107207,CSE 101,A01,185451,Staff,0,13,50,50
1683721107207,CSE 101,B01,185453,Jones; Miles E,0,15,50,50
1683721109260,CSE 141,A01,185458,Eldon; John,16,0,100,84
1683721110289,CSE 141L,A01,185461,Eldon; John,8,0,100,92
1683721111315,CSE 142,A01,185463,Staff,34,0,60,26
1683721111315,CSE 142,B01,201355,Staff,0,7,60,60
1683721112343,CSE 142L,A01,185470,Staff,34,0,60,26
1683721112343,CSE 142L,B01,201417,Staff,0,6,60,60
1683721113372,CSE 190,A00,201433,Staff,32,0,49,17
1683721114398,DOC 1,A01,259136,Strom; Megan C.,7,0,15,8
1683721114398,DOC 1,A02,259137,Strom; Megan C.,15,0,15,0
1683721114398,DOC 1,A03,259138,Strom; Megan C.,14,0,15,1
1683721114398,DOC 1,A04,259139,Strom; Megan C.,13,0,15,2
1683721115425,DOC 100D,A00,259140,Pass; Natalye Joann,14,0,25,11
1683721116450,DSGN 1,A01,184749,Rill; Bryan,0,26,30,30
1683721117479,DSGN 100,A01,185168,Staff,0,2,25,25
1683721118507,ECE 5,A01,185626,Morris; Karcher William,0,12,0,0
1683721119533,ECE 101,A01,185628,Staff,14,0,70,56
1683721120559,ECE 107,A01,185635,Baghdadchi; Saharnaz,0,0,20,20
1683721120559,ECE 107,A02,185638,Baghdadchi; Saharnaz,1,0,20,19
1683721121588,ECE 148,A01,185647,Silberman; Jack,0,0,16,16
1683721122614,ECON 1,A01,185537,Crane; Meredith Helen,54,0,70,16
1683721123643,ECON 3,A01,185549,Crane; Meredith Helen,30,0,70,40
1683721124673,ECON 4,A01,203354,Anderson; John Charles,0,5,10,10
1683721125699,ECON 100A,A01,185574,Staff,0,5,40,40
1683721126724,ECON 100B,A01,185576,Staff,0,12,50,50
1683721127750,ECON 100C,A01,185589,Newhouse; Herbert S,30,0,70,40
1683721128773,ECON 105,A00,185608,Vespa; Emanuel Ignacio,19,0,35,16
1683721129799,ECON 109,A01,185610,Shishkin; Denis,9,0,35,26
1683721130825,ECON 110A,A01,185612,Staff,8,0,40,32
1683721131852,ECON 120A,A01,185615,Staff,19,0,40,21
1683721132883,ECON 120C,A01,185617,Sun; Yixiao,0,21,70,70
1683721133908,ECON 144,A00,203346,Squires; Dale E,2,0,35,33
1683721134934,ECON 171,A01,203349,Newhouse; Herbert S,0,1,35,35
1683721135961,ECON 173A,A01,185621,Toda; Alexis Akira,21,0,35,14
1683721136996,EDS 25,A01,202413,Staff,0,1,0,0
1683721136996,EDS 25,A02,202414,Staff,0,1,0,0
1683721136996,EDS 25,A03,202415,Staff,0,0,0,0
1683721136996,EDS 25,A04,202416,Staff,0,1,0,0
1683721136996,EDS 25,A05,202439,Staff,0,0,0,0
1683721136996,EDS 25,A06,202440,Staff,0,0,0,0
1683721136996,EDS 25,B01,202631,Staff,0,0,0,0
1683721136996,EDS 25,B02,202632,Staff,0,0,0,0
1683721136996,EDS 25,B03,202639,Staff,0,0,0,0
1683721136996,EDS 25,B04,202640,Staff,0,0,0,0
1683721136996,EDS 25,B05,202643,Staff,0,0,0,0
1683721136996,EDS 25,B06,202644,Staff,0,0,0,0
1683721138021,EDS 38,A01,202659,Black; Alison Michelle,25,0,25,0
1683721139049,EDS 115,A00,202652,Staff,18,0,30,12
1683721140077,EDS 125,A00,202649,Staff,13,0,30,17
1683721141133,EDS 126,A01,203332,Staff,30,0,30,0
1683721142159,EDS 139,A00,202838,Staff,16,0,25,9
1683721143190,EDS 146,A01,202655,Staff,14,0,25,11
1683721144213,ENG 15,A00,185667,Staff,0,1,0,0
1683721144213,ENG 15,B00,185672,Staff,0,0,0,0
1683721144213,ENG 15,C00,185675,Staff,0,0,0,0
1683721144213,ENG 15,D00,185682,Staff,0,0,0,0
1683721144213,ENG 15,E00,185684,Staff,0,0,0,0
1683721145238,ETHN 103,A00,185710,Staff,0,8,35,35
1683721146268,ETHN 103A,A00,199228,Man; Simeon S,0,0,9,9
1683721147293,ETHN 109,A00,185711,Staff,15,0,35,20
1683721148318,ETHN 142,A00,185726,Staff,0,4,30,30
1683721149346,ETHN 163J,A00,199229,Man; Simeon S,5,0,8,3
1683721150370,ETHN 168,A00,185727,Staff,7,0,10,3
1683721151399,ETHN 182,A00,185728,Staff,0,0,35,35
1683721152429,ETHN 183,A00,185737,Staff,10,0,18,8
1683721153461,GLBH 111,A01,209361,Burgos; Jose L.,0,0,0,0
1683721155515,HIEU 104,A00,185792,Staff,14,0,20,6
1683721156540,HIEU 115,A00,185800,Staff,0,0,20,20
1683721157568,HIEU 128,A00,185801,Staff,0,9,20,20
1683721158597,HIEU 147,A00,185802,Staff,15,0,20,5
1683721159626,HIEU 154,A00,185823,Staff,11,0,20,9
1683721160652,HILA 102,A00,185826,Staff,14,0,20,6
1683721161679,HILD 2C,A01,185778,Staff,0,13,20,20
1683721162704,HILD 7B,A01,185780,Kwak; Nancy,0,17,32,32
1683721162704,HILD 7B,A02,185781,Kwak; Nancy,0,18,32,32
1683721163734,HILD 30,A01,185791,Staff,12,0,20,8
1683721164761,HISC 119,A00,185830,Golan; Tal,0,10,20,20
1683721165792,HITO 156GS,A00,185831,Patterson; Patrick H.,0,0,0,23
1683721166818,HIUS 103,A00,185832,Man; Simeon S,0,4,20,20
1683721167843,HIUS 117,A00,185836,Kwak; Nancy,2,0,20,18
1683721168868,HIUS 125,A00,185840,Man; Simeon S,0,2,23,23
1683721169897,HIUS 149,A00,185845,Staff,1,0,20,19
1683721170926,HUM 3,A01,185882,Zavodny; Tatiana Sophia,0,8,50,50
1683721170926,HUM 3,B01,185899,Caldwell; Michael Alan,0,18,50,50
1683721171953,HUM 3GS,A00,185900,Patterson; Patrick H.,0,0,0,23
1683721172991,HUM 4,A01,185938,Zroka; Amy Liane,28,0,50,22
1683721172991,HUM 4,B01,185956,Watkins; Eric,0,6,50,50
1683721172991,HUM 4,B02,202209,Watkins; Eric,0,6,50,50
1683721172991,HUM 4,B03,202210,Watkins; Eric,0,5,50,50
1683721174020,HUM 5,A01,185958,West; Geoffrey Scott,0,0,50,50
1683721174020,HUM 5,A02,202215,West; Geoffrey Scott,0,1,50,50
1683721175050,INTL 190,A00,185959,Gagnon; Jeffrey C,0,0,0,9
1683721175050,INTL 190,B00,185960,Lettieri; Michael Joseph,0,0,0,2
1683721176080,JAPN 180,A00,254509,Staff,4,0,30,26
1683721177110,LATI 10,A01,202853,Kennemore; Amy Michelle,4,0,35,31
1683721177110,LATI 10,A02,202854,Kennemore; Amy Michelle,3,0,35,32
1683721177110,LATI 10,A03,270054,Kennemore; Amy Michelle,30,0,30,0
1683721178138,LATI 180,A00,202855,Kennemore; Amy Michelle,11,0,20,9
1683721179164,LAWS 101,A00,201767,Golan; Tal,0,7,40,40
1683721180192,LIFR 1C,A00,185961,Staff,6,0,20,14
1683721181217,LIFR 1CX,A00,185962,Staff,7,0,20,13
1683721182246,LIFR 1D,A00,185963,Staff,7,0,20,13
1683721183269,LIFR 1DX,A00,185964,Staff,7,0,20,13
1683721184297,LIGN 101,A01,186039,Staff,43,0,50,7
1683721185324,LIGN 165,A00,186040,Staff,14,0,50,36
1683721186350,LTCS 108,A00,186041,Staff,5,0,10,5
1683721187375,LTCS 119,A00,186042,Staff,15,0,20,5
1683721188409,LTCS 130,A00,186043,Wesling; Megan E.,15,0,25,10
1683721190457,LTEA 138,A00,186119,Staff,13,0,40,27
1683721191486,LTEN 124,A00,186148,Staff,5,0,25,20
1683721192572,LTEN 178,A00,186149,Staff,6,0,15,9
1683721193606,LTEN 181,A00,186150,Blanco; John D,34,0,40,6
1683721194632,LTWL 120,A00,186160,Staff,19,0,25,6
1683721195659,LTWL 165,A00,186161,Staff,22,0,25,3
1683721196686,LTWR 100,A00,186162,Staff,0,5,15,15
1683721197713,LTWR 102,A00,186163,Doller; Ben,5,0,15,10
1683721198743,MAE 8,A01,186412,Staff,0,1,0,0
1683721199772,MAE 30B,A00,186445,Bahadori; Mohammad Yousef,81,0,100,19
1683721200802,MAE 40,A00,186592,Bewley; Thomas R,10,0,50,40
1683721201833,MAE 101B,A00,186593,Bahadori; Mohammad Yousef,80,0,100,20
1683721202864,MAE 105,A00,186594,Bandaru; Prabhakar,10,0,50,40
1683721203891,MAE 107,A00,186599,Pham; Hieu Tan,0,8,120,120
1683721204923,MAE 148,A01,186660,Silberman; Jack,3,0,16,13
1683721205950,MATH 10A,A01,188095,Staff,0,6,35,35
1683721206977,MATH 10B,A01,188097,Bowers; Adam R.,0,12,30,30
1683721206977,MATH 10B,A02,188099,Bowers; Adam R.,0,11,30,30
1683721206977,MATH 10B,B01,188104,Bowers; Adam R.,0,10,30,30
1683721206977,MATH 10B,B02,188106,Bowers; Adam R.,0,9,30,30
1683721208011,MATH 10C,A01,188111,Staff,0,20,30,30
1683721208011,MATH 10C,A02,188127,Staff,0,19,30,30
1683721208011,MATH 10C,A03,188131,Staff,0,19,30,30
1683721208011,MATH 10C,B01,188218,Staff,17,0,30,13
1683721208011,MATH 10C,B02,188244,Staff,13,0,30,17
1683721208011,MATH 10C,B03,188277,Staff,14,0,30,16
1683721209041,MATH 18,A01,188344,Bach; Quang Tran,18,0,30,12
1683721209041,MATH 18,A02,188345,Bach; Quang Tran,11,0,30,19
1683721209041,MATH 18,B01,188353,Bach; Quang Tran,11,0,30,19
1683721209041,MATH 18,B02,188354,Bach; Quang Tran,19,0,30,11
1683721210067,MATH 20A,A01,188374,Staff,11,0,35,24
1683721211100,MATH 20B,A01,188382,Ohm; Ko Woon,7,0,30,23
1683721211100,MATH 20B,A02,188383,Ohm; Ko Woon,22,0,30,8
1683721211100,MATH 20B,B01,188385,Ohm; Ko Woon,7,0,30,23
1683721211100,MATH 20B,B02,188392,Ohm; Ko Woon,22,0,30,8
1683721212127,MATH 20C,A01,188394,Harel; Guershon,10,0,30,20
1683721212127,MATH 20C,A02,188395,Harel; Guershon,13,0,30,17
1683721212127,MATH 20C,B01,188404,Harel; Guershon,5,0,30,25
1683721212127,MATH 20C,B02,188405,Harel; Guershon,18,0,30,12
1683721213158,MATH 20D,A01,188414,Hammock; Frances H,0,1,30,30
1683721213158,MATH 20D,A02,188415,Hammock; Frances H,0,1,30,30
1683721213158,MATH 20D,B01,188447,Hammock; Frances H,0,1,30,30
1683721213158,MATH 20D,B02,188486,Hammock; Frances H,2,0,30,28
1683721214184,MATH 20E,A01,188649,Staff,21,0,30,9
1683721214184,MATH 20E,A02,188650,Staff,20,0,30,10
1683721214184,MATH 20E,A03,188673,Staff,0,0,30,30
1683721215210,MATH 102,A01,188675,Staff,0,40,35,35
1683721216237,MATH 103B,A01,188681,Staff,3,0,35,32
1683721216237,MATH 103B,B01,188692,Staff,5,0,35,30
1683721217269,MATH 109,A01,188695,Salehi Golsefidy; Alireza,24,0,35,11
1683721217269,MATH 109,A02,188696,Salehi Golsefidy; Alireza,24,0,35,11
1683721218298,MATH 120A,A01,188698,Eggers; John Dietrich,7,0,35,28
1683721219329,MATH 142B,A01,188736,Ioana; Adrian,0,0,30,30
1683721219329,MATH 142B,A02,188741,Ioana; Adrian,0,1,30,30
1683721219329,MATH 142B,A03,188743,Ioana; Adrian,0,3,30,30
1683721220356,MATH 168A,A01,188790,Staff,0,11,35,35
1683721221390,MATH 170A,A01,188803,Nie; Jiawang,0,2,35,35
1683721221390,MATH 170A,A02,188811,Nie; Jiawang,0,1,35,35
1683721221390,MATH 170A,A03,188814,Nie; Jiawang,1,0,35,34
1683721221390,MATH 170A,A04,188815,Nie; Jiawang,5,0,35,30
1683721222417,MATH 193B,A01,188817,Staff,0,0,35,35
1683721222417,MATH 193B,A02,188818,Staff,6,0,35,29
1683721223443,MGT 4,A01,202857,Anderson; John Charles,59,0,80,21
1683721224469,MGT 12,A00,202858,Lindenberger; Wade Douglas,40,0,90,50
1683721225494,MGT 18,A00,202859,Staff,73,0,90,17
1683721226520,MGT 18GS,A00,202860,McKay; Michael J,13,0,28,15
1683721227546,MGT 45,A00,202861,Pecore; Joseph P.,8,0,90,82
1683721228576,MGT 100,A00,202863,Yavorsky; Daniel Ryan,27,0,90,63
1683721229605,MGT 103,A00,202864,Ehrich; Kristine R,0,19,90,90
1683721230634,MGT 112,A00,202865,Ehrich; Kristine R,15,0,90,75
1683721231661,MGT 121A,A00,202868,Staff,70,0,90,20
1683721232687,MGT 131B,A00,202869,Anderson; John Charles,58,0,90,32
1683721233713,MGT 136,A00,202871,Lindenberger; Wade Douglas,83,0,90,7
1683721234742,MGT 164,A00,202873,Staff,0,67,90,91
1683721235770,MGT 164GS,A00,202874,McKay; Mary A,13,0,28,15
1683721236799,MGT 180,A00,202875,Staff,0,51,90,91
1683721237824,MMW 11R,A01,205019,Herbst; Matthew,0,0,30,30
1683721237824,MMW 11R,A02,205026,Herbst; Matthew,29,0,30,1
1683721238858,MMW 15,A01,193512,Chang; Edmond Yi-Teh,0,8,28,28
1683721238858,MMW 15,A02,193513,Chang; Edmond Yi-Teh,0,5,28,28
1683721238858,MMW 15,A03,193514,Chang; Edmond Yi-Teh,0,5,28,28
1683721238858,MMW 15,A04,193515,Chang; Edmond Yi-Teh,0,5,28,28
1683721238858,MMW 15,A05,193516,Chang; Edmond Yi-Teh,0,5,28,28
1683721238858,MMW 15,A06,193517,Chang; Edmond Yi-Teh,0,6,28,28
1683721238858,MMW 15,B01,193519,Chang; Edmond Yi-Teh,0,5,28,28
1683721238858,MMW 15,B02,193520,Chang; Edmond Yi-Teh,0,5,28,28
1683721238858,MMW 15,B03,193521,Chang; Edmond Yi-Teh,0,5,28,28
1683721238858,MMW 15,B04,193522,Chang; Edmond Yi-Teh,0,6,28,28
1683721238858,MMW 15,B05,193523,Chang; Edmond Yi-Teh,0,5,28,28
1683721238858,MMW 15,B06,193524,Chang; Edmond Yi-Teh,0,5,28,28
1683721239883,MMW 122,A01,193526,Rahimi; Babak,0,16,28,28
1683721239883,MMW 122,A02,193527,Rahimi; Babak,0,15,28,28
1683721239883,MMW 122,A03,193528,Rahimi; Babak,0,0,0,0
1683721239883,MMW 122,A04,193529,Rahimi; Babak,0,0,0,0
1683721240910,MUS 1A,A01,186663,Staff,0,18,35,35
1683721241939,MUS 4,A01,186715,Staff,0,12,35,35
1683721242965,MUS 5R,A01,186796,Dubnov; Shlomo,0,17,35,35
1683721243991,MUS 6,A01,186798,Staff,0,4,25,25
1683721245018,MUS 7,A01,186830,Staff,11,0,35,24
1683721246049,MUS 8,A01,186930,Staff,0,27,35,35
1683721247078,MUS 15,A01,186932,Staff,0,15,35,35
1683721247078,MUS 15,B01,186934,Staff,0,16,35,35
1683721248108,MUS 80,A00,186935,Staff,0,0,20,20
1683721248108,MUS 80,B00,186936,Staff,24,0,25,1
1683721249134,NANO 11,A00,204702,Lipomi; Darren John,0,0,0,0
1683721250161,NANO 15,A01,204709,Yang; Kesong,0,1,0,0
1683721251187,NANO 114,A00,202069,Jahed Motlagh; Zeinab,2,0,10,8
1683721252217,PHIL 1,A00,186955,Grush; Rick Scott,31,0,40,9
1683721253243,PHIL 10,A01,186973,Grush; Rick Scott,27,0,35,8
1683721253243,PHIL 10,A02,186974,Grush; Rick Scott,33,0,35,2
1683721254273,PHIL 13,A01,186976,Staff,1,0,35,34
1683721254273,PHIL 13,A02,186977,Staff,16,0,35,19
1683721255300,PHIL 14,A01,186979,Staff,30,0,35,5
1683721255300,PHIL 14,A02,186986,Staff,32,0,35,3
1683721256330,PHIL 28,A01,186988,Staff,16,0,30,14
1683721256330,PHIL 28,A02,186989,Staff,0,0,30,30
1683721256330,PHIL 28,A03,186990,Staff,10,0,30,20
1683721256330,PHIL 28,A04,186991,Staff,26,0,30,4
1683721257355,PHIL 120,A00,186997,Staff,23,0,40,17
1683721258381,PHIL 137,A00,187003,Staff,8,0,40,32
1683721259409,PHIL 150,A00,187015,Staff,47,0,70,23
1683721260434,PHIL 167,A00,187021,Lamey; Andy M.,34,0,40,6
1683721261465,PHIL 174,A01,202226,Staff,17,0,20,3
1683721261465,PHIL 174,A02,202235,Staff,20,0,20,0
1683721262488,PHIL 191A,A00,258918,Staff,0,0,1,1
1683721263512,PHYS 1A,A00,187028,Staff,26,0,60,34
1683721264542,PHYS 1AL,001,187036,Staff,3,0,30,27
1683721264542,PHYS 1AL,002,187049,Staff,18,0,30,12
1683721265570,PHYS 1B,A00,187058,Staff,21,0,60,39
1683721266594,PHYS 1BL,001,187064,Staff,0,1,30,30
1683721266594,PHYS 1BL,002,187070,Staff,4,0,30,26
1683721267624,PHYS 1C,A00,187082,Staff,30,0,120,90
1683721268651,PHYS 1CL,001,187088,Staff,0,9,30,30
1683721268651,PHYS 1CL,002,187089,Staff,0,1,30,30
1683721268651,PHYS 1CL,009,262693,Staff,9,0,30,21
1683721269682,PHYS 2B,A01,187097,Staff,55,0,115,60
1683721270708,PHYS 2C,A01,187099,Staff,63,0,115,52
1683721271733,PHYS 2CL,A01,187101,Staff,5,0,28,23
1683721271733,PHYS 2CL,A02,187102,Staff,15,0,28,13
1683721272761,PHYS 2D,A01,187123,Shotwell; Brian,95,0,115,20
1683721273788,PHYS 4B,A01,187133,Grinstein; Benjamin,35,0,50,15
1683721274816,POLI 10,A00,188819,Staff,0,4,50,50
1683721275841,POLI 11,A00,188827,Staff,43,0,50,7
1683721276865,POLI 13R,A00,188828,Staff,0,2,20,20
1683721277896,POLI 27,A01,188830,Elgin; Samuel Zincke,0,2,70,70
1683721278922,POLI 30,A00,188832,Desposato; Scott,30,0,50,20
1683721279949,POLI 102F,A00,188834,Staff,1,0,40,39
1683721280978,POLI 104A,A00,188852,Staff,12,0,30,18
1683721282007,POLI 104I,A00,188853,Staff,0,8,20,20
1683721283033,POLI 110B,A00,188854,Wiens; David,6,0,20,14
1683721284059,POLI 112A,A00,188855,Wiens; David,3,0,30,27
1683721285085,POLI 117R,A00,188856,Forman; Fonna,0,12,20,20
1683721286111,POLI 118,A00,188857,Ingham; Sean,8,0,20,12
1683721287139,POLI 120G,A00,188858,Staff,7,0,30,23
1683721288164,POLI 131CR,A00,188863,Hoston; Germaine,20,0,50,30
1683721289189,POLI 133,A00,188864,Nellis; Gareth Hb,44,0,50,6
1683721290213,POLI 134D,A00,188865,Desposato; Scott,27,0,30,3
1683721291240,POLI 142A,A00,188871,Gartzke; Erik,21,0,50,29
1683721292270,POLI 142K,A00,188874,Staff,38,0,50,12
1683721293299,POLI 143,A00,188940,Gartzke; Erik,15,0,30,15
1683721294327,POLI 153,A00,188943,Staff,1,0,20,19
1683721295353,POLI 160AA,A00,188944,Staff,10,0,40,30
1683721296439,POLI 170A,A00,188945,Staff,10,0,30,20
1683721298495,PSYC 1,A00,188952,Staff,36,0,90,54
1683721299521,PSYC 2,B00,188953,Staff,19,0,35,16
1683721300578,PSYC 6,A00,188970,Staff,47,0,60,13
1683721301609,PSYC 7,A00,188973,Staff,35,0,45,10
1683721302635,PSYC 60,A01,188980,Rickard; Timothy C.,42,0,60,18
1683721303668,PSYC 70,A01,189001,Steiner; Eric Tomas,22,0,45,23
1683721304695,PSYC 100,A00,189005,Lacefield; Katharine I,1,98,120,119
1683721305720,PSYC 102,A00,189008,Staff,6,0,30,24
1683721306751,PSYC 106,B00,189026,Gorman; Michael R.,27,0,60,33
1683721307779,PSYC 114,B01,189033,Winkielman; Piotr,0,31,30,30
1683721308807,PSYC 131,A00,189036,Anagnostaras; Stephan,0,44,60,60
1683721309837,PSYC 136,A00,189041,Lowe; Angela Beth,0,7,25,25
1683721310872,PSYC 137,A00,189057,Winkielman; Piotr,0,36,25,25
1683721311901,PSYC 144,A00,189107,Wixted; John T,0,11,50,50
1683721313962,PSYC 162,A00,189142,Staff,0,9,85,85
1683721314990,PSYC 172,A00,189144,Gorman; Michael R.,0,6,30,30
1683721317041,PSYC 179,A00,189146,Lacefield; Katharine I,0,88,120,120
1683721318066,PSYC 181,A00,189147,Anagnostaras; Stephan,0,45,90,90
1683721319092,PSYC 190R,A00,189148,Barner; David A.,0,23,80,80
1683721320121,PSYC 191,A00,189275,Rickard; Timothy C.,0,11,25,25
1683721321152,PSYC 193,A00,189276,Chapman; Eddie Nathaniel,0,1,0,4
1683721322183,PSYC 193L,A01,189281,Lowe; Angela Beth,8,0,20,12
1683721322183,PSYC 193L,B01,189285,Staff,28,0,35,7
1683721323209,RELI 149,A00,187137,Rahimi; Babak,6,0,40,34
1683721324235,SE 9,A01,187315,Staff,0,2,18,18
1683721325264,SE 101B,A00,187409,Staff,24,0,30,6
1683721326292,SE 110B,A00,187444,Staff,10,0,40,30
1683721327320,SE 130B,A00,187449,Staff,31,0,40,9
1683721328346,SE 150A,A00,187516,Staff,8,0,20,12
1683721329373,SE 154,A00,187528,Staff,29,0,50,21
1683721330397,SIO 3,A01,258171,Staff,35,0,40,5
1683721331423,SIO 10,A00,187144,Cook; Geoffrey W,0,6,75,75
1683721332450,SIO 45,A00,187152,Cook; Geoffrey W,1,7,100,99
1683721333481,SIO 109R,A00,194486,Staff,0,4,20,20
1683721335535,SIO 187,A01,187233,Kacev; David,12,0,40,28
1683721336564,SOCI 1,A01,258656,Thorpe; Charles Robert,28,0,30,2
1683721336564,SOCI 1,A02,258658,Thorpe; Charles Robert,30,0,30,0
1683721336564,SOCI 1,A03,258661,Thorpe; Charles Robert,25,0,25,0
1683721336564,SOCI 1,A04,258666,Thorpe; Charles Robert,22,0,25,3
1683721336564,SOCI 1,A05,258897,Thorpe; Charles Robert,22,0,25,3
1683721336564,SOCI 1,A06,258898,Thorpe; Charles Robert,25,0,25,0
1683721337591,SOCI 30,A01,258903,Pardo Guerra; Juan Pablo,14,0,30,16
1683721338621,SOCI 102,A00,258904,Staff,9,0,25,16
1683721339646,SOCI 106,A00,258905,Staff,19,0,25,6
1683721340671,SOCI 111,A00,258907,Ribas Norris; Janet Vanesa,26,0,30,4
1683721341700,SOCI 121R,A00,258908,Pardo Guerra; Juan Pablo,7,0,30,23
1683721342728,SOCI 126,A01,203330,Staff,14,0,20,6
1683721343754,SOCI 131,A00,258909,Thorpe; Charles Robert,30,0,60,30
1683721344779,SOCI 135,A00,258910,Payne; Christine Anna,0,13,30,30
1683721345807,SOCI 157,A00,258911,Staff,10,0,30,20
1683721346833,SOCI 184,A00,258912,Staff,25,0,30,5
1683721347859,SOCI 188D,A00,258913,Staff,22,0,30,8
1683721348890,SYN 2,001,187529,Staff,9,0,16,7
1683721348890,SYN 2,002,201452,Staff,0,20,16,16
1683721348890,SYN 2,003,201469,Staff,1,0,16,15
1683721349919,SYN 100,A01,187531,Staff,0,9,20,20
1683721349919,SYN 100,B01,201491,Staff,0,10,20,20
1683721350950,TDAC 1,A00,189286,Walsh; Kim C.,3,0,20,17
1683721350950,TDAC 1,B00,189287,Harting; Carla Kelso,10,0,20,10
1683721351975,TDAC 101,A00,189300,Walsh; Kim C.,16,0,20,4
1683721351975,TDAC 101,B00,189301,Harting; Carla Kelso,18,0,20,2
1683721353009,TDAC 102,A00,189304,Basso; Beatrice,14,0,20,6
1683721354035,TDAC 108,A00,189305,Staff,18,0,20,2
1683721355063,TDDE 131,A00,189310,Staff,19,0,20,1
1683721355063,TDDE 131,B00,189314,Staff,19,0,20,1
1683721355063,TDDE 131,C00,189315,Staff,48,0,50,2
1683721355063,TDDE 131,D00,189316,Staff,14,0,15,1
1683721355063,TDDE 131,E00,204841,Staff,20,0,20,0
1683721356092,TDGE 10,A00,189289,Staff,26,0,50,24
1683721356092,TDGE 10,B00,189290,Havis; Allan,0,1,50,50
1683721357119,TDGE 11,A00,189291,Fulton; Julia,0,4,50,50
1683721357119,TDGE 11,B00,189292,Staff,20,0,25,5
1683721357119,TDGE 11,C00,260270,Staff,0,0,0,0
1683721358146,TDGE 25,A00,189294,Staff,1,0,20,19
1683721359173,TDGE 124,A00,189318,Fulton; Julia,0,7,50,50
1683721360200,TDGE 125,A00,189319,Staff,13,0,25,12
1683721360200,TDGE 125,B00,189320,Staff,23,0,25,2
1683721361228,TDGE 127,A00,189322,Havis; Allan,1,0,50,49
1683721362253,TDHT 101,A00,189323,Staff,18,0,25,7
1683721362253,TDHT 101,B00,189324,Staff,25,0,25,0
1683721363280,TDHT 102,A00,189325,Staff,49,0,50,1
1683721364306,TDMV 1,A00,189295,Arcidiacono; Kristin,20,0,30,10
1683721364306,TDMV 1,B00,189296,Caligagan; Maria T.,23,0,30,7
1683721365332,TDMV 2,A00,189297,Sammartano; Tonnie,27,0,30,3
1683721365332,TDMV 2,B00,189299,Arcidiacono; Kristin,23,0,30,7
1683721366359,TDMV 3,A00,204998,Rincon; Alicia,22,0,30,8
1683721367386,TDMV 120,A00,189458,Sammartano; Tonnie,28,0,30,2
1683721368418,TDMV 138,A00,189541,Jun; Grace Shin Hae,20,0,40,20
1683721369443,TDMV 142,A00,189717,Caligagan; Tony,25,0,30,5
1683721369443,TDMV 142,B00,189718,Caligagan; Maria T.,25,0,30,5
1683721370469,TMC 2,A01,187533,Staff,25,0,25,0
1683721370469,TMC 2,A02,187534,Staff,25,0,25,0
1683721371501,USP 1,A01,187536,Kwak; Nancy,0,16,25,25
1683721372531,USP 5,A01,187538,Staff,8,0,25,17
1683721373558,USP 101,A00,199253,Staff,0,4,0,0
1683721374584,USP 124,A00,187562,Boomhower; Matthew Charles,0,0,30,30
1683721375613,USP 138,A00,187582,Staff,19,0,25,6
1683721376639,USP 152,A01,187597,Staff,3,0,25,22
1683721377665,USP 153,A00,187598,Staff,18,0,25,7
1683721378697,USP 168,A00,187607,Kwak; Nancy,2,0,5,3
1683721379723,USP 173,A00,187619,Staff,4,0,25,21
1683721380749,USP 181,A00,187638,Staff,0,4,25,25
1683721381781,VIS 103,A00,187650,Cruz; Edwin Teddy,17,0,75,58
1683721382808,VIS 110D,A00,187669,Staff,13,0,22,9
1683721383834,VIS 127C,A00,187720,Shen; Kuiyi,67,0,146,79
1683721384858,VIS 149,A00,187731,Yoldas; Pinar,0,12,22,22
1683721385887,VIS 151,A01,188091,Staff,22,0,34,12
1683721385887,VIS 151,A02,188092,Staff,11,0,34,23
1683721386913,VIS 160B,A00,188093,Stalbaum; Brett,0,1,10,10
1683721388964,WCWP 10B,A00,201720,Staff,0,0,5,5
1683721388964,WCWP 10B,B00,201722,Staff,0,0,6,6
1683721389990,WCWP 100,A00,201725,Gagnon; Jeffrey C,0,0,2,2
1683721389990,WCWP 100,B00,201727,Staff,0,4,15,15
1683721393138,ANBI 133,A00,258401,Wilder; Linnea Lorene,34,0,40,6
1683721394166,ANBI 140,A00,258395,Hrvoj Mihic; Branka,18,0,25,7
1683721395194,ANSC 120,A00,258402,Bialecki; Jon Anthony,26,0,40,14
1683721396218,ANSC 144,A00,258400,Staff,12,0,40,28
1683721398273,ANSC 166,A00,258396,Parish; Steven Martin,156,0,175,19
1683721399300,ANSC 180,A00,193533,Staff,8,0,20,12
1683721400383,ANSC 188,A00,258397,Jassal; Aftab,34,0,40,6
1683721401410,ANTH 3,A01,258316,Staff,23,0,30,7
1683721402436,ANTH 5,A00,258394,Semendeferi; Ekaterini,16,0,20,4
1683721403462,ANTH 21,A01,258331,Staff,4,0,40,36
1683721404488,ANTH 103,A00,258398,Varma; Saiba,15,0,25,10
1683721405519,AWP 10,001,202034,Staff,0,0,0,0
1683721405519,AWP 10,002,202035,Staff,0,0,0,0
1683721405519,AWP 10,003,202036,Staff,0,0,0,0
1683721405519,AWP 10,004,202037,Staff,0,0,0,0
1683721405519,AWP 10,005,202038,Staff,0,0,0,0
1683721405519,AWP 10,006,202039,Staff,0,0,0,0
1683721405519,AWP 10,007,202040,Staff,0,0,0,0
1683721405519,AWP 10,008,202041,Staff,0,0,0,0
1683721405519,AWP 10,009,202042,Staff,0,0,0,0
1683721405519,AWP 10,010,202043,Staff,0,0,0,0
1683721405519,AWP 10,011,202044,Staff,0,0,0,0
1683721405519,AWP 10,012,202045,Staff,0,0,0,0
1683721405519,AWP 10,013,202046,Staff,0,0,0,0
1683721405519,AWP 10,014,202047,Staff,0,0,0,0
1683721405519,AWP 10,015,202048,Staff,0,0,0,0
1683721405519,AWP 10,016,202049,Staff,0,0,0,0
1683721405519,AWP 10,017,202050,Staff,0,0,0,0
1683721405519,AWP 10,018,202051,Staff,0,0,0,0
1683721405519,AWP 10,019,202052,Staff,0,0,0,0
1683721405519,AWP 10,020,202053,Staff,0,0,0,0
1683721405519,AWP 10,021,202054,Staff,0,0,0,0
1683721405519,AWP 10,022,202055,Staff,0,0,0,0
1683721405519,AWP 10,023,202056,Staff,0,0,0,0
1683721405519,AWP 10,024,202057,Staff,0,0,0,0
1683721405519,AWP 10,025,202058,Staff,0,0,0,0
1683721405519,AWP 10,026,202059,Staff,0,0,0,0
1683721406546,AWP 102,001,202032,Staff,0,0,0,0
1683721406546,AWP 102,002,202033,Staff,0,0,0,0
1683721407569,BENG 100,A01,254234,Taylor Amos; Alyssa C,31,0,40,9
1683721408596,BENG 196,001,270013,Engler; Adam J.,9999,0,9999,0
1683721409625,BICD 100R,A01,202018,Smith; Laurie,0,7,32,32
1683721409625,BICD 100R,A02,202019,Smith; Laurie,0,3,32,32
1683721409625,BICD 100R,A03,202020,Smith; Laurie,0,1,32,32
1683721409625,BICD 100R,A04,202021,Smith; Laurie,6,0,32,26
1683721409625,BICD 100R,A05,202022,Smith; Laurie,10,0,32,22
1683721410661,BICD 136,A01,193242,Gustafson-Brown; Cindy,0,2,32,32
1683721410661,BICD 136,A02,193244,Gustafson-Brown; Cindy,13,0,32,19
1683721411698,BIEB 102,A01,193249,Butler; Shannon Rhey,0,0,32,32
1683721411698,BIEB 102,A02,193251,Butler; Shannon Rhey,0,0,32,32
1683721411698,BIEB 102,A03,193253,Butler; Shannon Rhey,0,0,32,32
1683721411698,BIEB 102,A04,193255,Butler; Shannon Rhey,13,0,32,19
1683721411698,BIEB 102,A05,193265,Butler; Shannon Rhey,25,0,32,7
1683721411698,BIEB 102,A06,193269,Butler; Shannon Rhey,12,0,32,20
1683721413749,BIEB 150,A01,193274,Staff,0,0,32,32
1683721413749,BIEB 150,A02,193285,Staff,24,0,32,8
1683721414778,BIEB 194,A00,193286,Kurle; Carolyn M.,19,0,32,13
1683721415806,BILD 1,A01,192291,Staff,15,0,32,17
1683721415806,BILD 1,A02,192292,Staff,30,0,32,2
1683721415806,BILD 1,B01,192520,Reuther; Keefe,0,1,0,0
1683721415806,BILD 1,B02,192532,Reuther; Keefe,0,1,0,0
1683721416837,BILD 3,A01,192556,Butler; Shannon Rhey,0,0,32,32
1683721416837,BILD 3,A02,192581,Butler; Shannon Rhey,0,1,32,32
1683721416837,BILD 3,A03,192611,Butler; Shannon Rhey,19,0,32,13
1683721416837,BILD 3,A04,192612,Butler; Shannon Rhey,23,0,32,9
1683721416837,BILD 3,A05,192613,Butler; Shannon Rhey,26,0,32,6
1683721416837,BILD 3,A06,192679,Butler; Shannon Rhey,27,0,32,5
1683721416837,BILD 3,A07,192682,Butler; Shannon Rhey,20,0,32,12
1683721417864,BILD 4,A01,192836,Reuther; Keefe,1,0,24,23
1683721417864,BILD 4,A02,193044,Reuther; Keefe,4,0,24,20
1683721418891,BILD 10,A01,193142,Gustafson-Brown; Cindy,29,0,32,3
1683721418891,BILD 10,A02,193149,Gustafson-Brown; Cindy,31,0,32,1
1683721419916,BIMM 100,A01,193301,Staff,0,6,32,32
1683721419916,BIMM 100,A02,193312,Staff,0,7,32,32
1683721419916,BIMM 100,A03,193323,Staff,0,10,32,32
1683721420949,BIMM 101,A01,193329,McDonnell; Lisa Marie,0,3,24,24
1683721420949,BIMM 101,A02,193339,McDonnell; Lisa Marie,0,3,24,24
1683721420949,BIMM 101,B01,193354,McDonnell; Lisa Marie,0,4,24,24
1683721420949,BIMM 101,B02,193357,McDonnell; Lisa Marie,0,3,24,24
1683721421979,BIMM 110,A01,193377,Tat; John,0,11,32,32
1683721421979,BIMM 110,A02,193378,Tat; John,0,11,32,32
1683721423008,BIMM 120,A01,206116,Staff,0,0,32,32
1683721423008,BIMM 120,A02,206117,Staff,7,0,32,25
1683721423008,BIMM 120,A03,206121,Staff,21,0,32,11
1683721424035,BIPN 100,A01,193393,Park; Ji Young,0,15,32,32
1683721424035,BIPN 100,A02,193402,Park; Ji Young,0,14,32,32
1683721424035,BIPN 100,A03,193413,Park; Ji Young,0,14,32,32
1683721424035,BIPN 100,A04,193414,Park; Ji Young,0,13,32,32
1683721425061,BIPN 102,A01,193429,Staff,0,0,32,32
1683721425061,BIPN 102,A02,193438,Staff,18,0,32,14
1683721426092,BIPN 106,A01,193450,Reyes Gonzalez; Catalina,0,2,40,40
1683721427118,BIPN 134,A01,193465,Cooke; James Edward,0,0,32,32
1683721427118,BIPN 134,A02,193474,Cooke; James Edward,25,0,32,7
1683721427118,BIPN 134,A03,193485,Cooke; James Edward,29,0,32,3
1683721427118,BIPN 134,A04,193486,Cooke; James Edward,20,0,32,12
1683721427118,BIPN 134,A05,193491,Cooke; James Edward,31,0,32,1
1683721427118,BIPN 134,A06,193501,Cooke; James Edward,30,0,32,2
1683721427118,BIPN 134,A07,193510,Cooke; James Edward,29,0,32,3
1683721429173,BISP 194,A00,222522,Staff,14,0,32,18
1683721430203,CAT 124,A01,202407,Staff,19,0,25,6
1683721431230,CAT 125,A00,202408,Marchisotto; Jennifer Anne,2,0,20,18
1683721432267,CAT 125R,A00,202409,Smith; Lauryn Alissa,0,11,20,20
1683721432267,CAT 125R,B00,202410,Morales; Celeste Georgianna,0,11,20,20
1683721432267,CAT 125R,C00,202411,Irwin; Matthew Joseph,0,12,20,20
1683721433293,CENG 15,A01,204712,Yang; Kesong,0,1,0,0
1683721434320,CENG 114,A00,202070,Jahed Motlagh; Zeinab,5,0,20,15
1683721435348,CGS 105,A00,185477,Wesling; Megan E.,24,0,40,16
1683721436378,CGS 106,A00,185494,Staff,11,0,22,11
1683721437405,CGS 108,A00,185495,Staff,14,0,20,6
1683721438435,CGS 114,A00,185496,Staff,13,0,18,5
1683721439461,CGS 119,A00,185501,Staff,15,0,20,5
1683721440485,CGS 120,A00,185511,Staff,11,0,20,9
1683721441520,CHEM 4,A01,184675,Bussey; Thomas J,97,0,100,3
1683721442546,CHEM 6A,A01,184677,Staff,32,0,60,28
1683721443571,CHEM 6B,A01,184679,Staff,63,0,100,37
1683721444597,CHEM 6C,A01,184681,Bussey; Thomas J,0,0,50,50
1683721444597,CHEM 6C,A02,184682,Bussey; Thomas J,32,0,50,18
1683721445625,CHEM 40A,A01,184684,Albizati; Kim F.,33,0,100,67
1683721446653,CHEM 40B,A01,184686,Albizati; Kim F.,0,22,100,100
1683721447678,CHEM 41B,A01,184690,Staff,51,0,100,49
1683721448705,COGS 3,A01,184715,Boyle; Mary E. T.,0,27,40,40
1683721449732,COGS 14B,A01,185172,Staff,0,14,38,38
1683721450761,COGS 18,A01,184736,Staff,14,0,80,66
1683721451794,COGS 100,A01,184932,Staff,0,8,73,73
1683721452822,COGS 101A,A01,184935,Staff,0,40,30,30
1683721453857,COGS 101B,A01,184944,Staff,0,2,30,30
1683721454881,COGS 101C,A01,184946,Staff,0,10,30,30
1683721455913,COGS 102A,A01,184951,Johnson; Christine M.,1,0,40,39
1683721456943,COGS 107B,A01,184953,Mooshagian; Eric Frederick,0,52,40,40
1683721457969,COGS 118B,A01,184959,Gupta; Anjum,0,50,40,40
1683721458994,COGS 153,A00,184961,Staff,1,16,30,29
1683721460022,COGS 177,A00,184962,Staff,0,20,30,30
1683721461052,COGS 187A,A01,184969,Boyle; Mary E. T.,0,19,40,40
1683721462080,COMM 10,A01,185174,Staff,0,5,25,25
1683721462080,COMM 10,A02,185189,Staff,0,2,25,25
1683721462080,COMM 10,A03,269821,Staff,0,1,0,0
1683721463108,COMM 100B,A02,185476,Staff,10,0,25,15
1683721463108,COMM 100B,A03,277340,Staff,25,0,25,0
1683721464134,COMM 100C,A01,185314,Staff,2,0,25,23
1683721464134,COMM 100C,A02,185327,Staff,17,0,25,8
1683721465162,COMM 110M,A00,185349,Staff,0,0,40,40
1683721466193,COMM 113T,A00,185352,Staff,25,0,40,15
1683721467218,COMM 114I,A00,185353,Staff,31,0,40,9
1683721468242,COMM 131,A00,185354,Staff,17,0,30,13
1683721469268,CSE 8A,A50,185358,Cao; Yingjun,0,46,10,10
1683721470293,CSE 8B,A01,185362,Staff,0,48,50,50
1683721471319,CSE 11,A01,185416,Cao; Yingjun,0,91,10,10
1683721472345,CSE 20,A01,185445,Briones; Jor-el Thomas Caparas,3,0,25,22
1683721473377,CSE 21,A01,185447,Staff,9,0,50,41
1683721474406,CSE 101,A01,185451,Staff,0,13,50,50
1683721474406,CSE 101,B01,185453,Jones; Miles E,0,15,50,50
1683721476457,CSE 141,A01,185458,Eldon; John,16,0,100,84
1683721477486,CSE 141L,A01,185461,Eldon; John,8,0,100,92
1683721478512,CSE 142,A01,185463,Staff,34,0,60,26
1683721478512,CSE 142,B01,201355,Staff,0,7,60,60
1683721479537,CSE 142L,A01,185470,Staff,34,0,60,26
1683721479537,CSE 142L,B01,201417,Staff,0,6,60,60
1683721480565,CSE 190,A00,201433,Staff,32,0,49,17
1683721481597,DOC 1,A01,259136,Strom; Megan C.,7,0,15,8
1683721481597,DOC 1,A02,259137,Strom; Megan C.,15,0,15,0
1683721481597,DOC 1,A03,259138,Strom; Megan C.,14,0,15,1
1683721481597,DOC 1,A04,259139,Strom; Megan C.,13,0,15,2
1683721482622,DOC 100D,A00,259140,Pass; Natalye Joann,14,0,25,11
1683721483648,DSGN 1,A01,184749,Rill; Bryan,0,26,30,30
1683721484674,DSGN 100,A01,185168,Staff,0,2,25,25
1683721485707,ECE 5,A01,185626,Morris; Karcher William,0,12,0,0
1683721486736,ECE 101,A01,185628,Staff,14,0,70,56
1683721487763,ECE 107,A01,185635,Baghdadchi; Saharnaz,0,0,20,20
1683721487763,ECE 107,A02,185638,Baghdadchi; Saharnaz,1,0,20,19
1683721488791,ECE 148,A01,185647,Silberman; Jack,0,0,16,16
1683721489815,ECON 1,A01,185537,Crane; Meredith Helen,54,0,70,16
1683721490842,ECON 3,A01,185549,Crane; Meredith Helen,30,0,70,40
1683721491874,ECON 4,A01,203354,Anderson; John Charles,0,5,10,10
1683721492901,ECON 100A,A01,185574,Staff,0,5,40,40
1683721493926,ECON 100B,A01,185576,Staff,0,12,50,50
1683721494952,ECON 100C,A01,185589,Newhouse; Herbert S,30,0,70,40
1683721495979,ECON 105,A00,185608,Vespa; Emanuel Ignacio,19,0,35,16
1683721497008,ECON 109,A01,185610,Shishkin; Denis,9,0,35,26
1683721498035,ECON 110A,A01,185612,Staff,8,0,40,32
1683721499060,ECON 120A,A01,185615,Staff,19,0,40,21
1683721500087,ECON 120C,A01,185617,Sun; Yixiao,0,21,70,70
1683721501134,ECON 144,A00,203346,Squires; Dale E,2,0,35,33
1683721502159,ECON 171,A01,203349,Newhouse; Herbert S,0,1,35,35
1683721503188,ECON 173A,A01,185621,Toda; Alexis Akira,21,0,35,14
1683721504299,EDS 25,A01,202413,Staff,0,1,0,0
1683721504299,EDS 25,A02,202414,Staff,0,1,0,0
1683721504299,EDS 25,A03,202415,Staff,0,0,0,0
1683721504299,EDS 25,A04,202416,Staff,0,1,0,0
1683721504299,EDS 25,A05,202439,Staff,0,0,0,0
1683721504299,EDS 25,A06,202440,Staff,0,0,0,0
1683721504299,EDS 25,B01,202631,Staff,0,0,0,0
1683721504299,EDS 25,B02,202632,Staff,0,0,0,0
1683721504299,EDS 25,B03,202639,Staff,0,0,0,0
1683721504299,EDS 25,B04,202640,Staff,0,0,0,0
1683721504299,EDS 25,B05,202643,Staff,0,0,0,0
1683721504299,EDS 25,B06,202644,Staff,0,0,0,0
1683721505325,EDS 38,A01,202659,Black; Alison Michelle,25,0,25,0
1683721506355,EDS 115,A00,202652,Staff,18,0,30,12
1683721507384,EDS 125,A00,202649,Staff,13,0,30,17
1683721508409,EDS 126,A01,203332,Staff,30,0,30,0
1683721509434,EDS 139,A00,202838,Staff,16,0,25,9
1683721510461,EDS 146,A01,202655,Staff,14,0,25,11
1683721511490,ENG 15,A00,185667,Staff,0,1,0,0
1683721511490,ENG 15,B00,185672,Staff,0,0,0,0
1683721511490,ENG 15,C00,185675,Staff,0,0,0,0
1683721511490,ENG 15,D00,185682,Staff,0,0,0,0
1683721511490,ENG 15,E00,185684,Staff,0,0,0,0
1683721512520,ETHN 103,A00,185710,Staff,0,8,35,35
1683721513546,ETHN 103A,A00,199228,Man; Simeon S,0,0,9,9
1683721514573,ETHN 109,A00,185711,Staff,15,0,35,20
1683721515598,ETHN 142,A00,185726,Staff,0,4,30,30
1683721516623,ETHN 163J,A00,199229,Man; Simeon S,5,0,8,3
1683721517653,ETHN 168,A00,185727,Staff,7,0,10,3
1683721518680,ETHN 182,A00,185728,Staff,0,0,35,35
1683721519706,ETHN 183,A00,185737,Staff,10,0,18,8
1683721520734,GLBH 111,A01,209361,Burgos; Jose L.,0,0,0,0
1683721522785,HIEU 104,A00,185792,Staff,14,0,20,6
1683721523811,HIEU 115,A00,185800,Staff,0,0,20,20
1683721524840,HIEU 128,A00,185801,Staff,0,9,20,20
1683721525868,HIEU 147,A00,185802,Staff,15,0,20,5
1683721526893,HIEU 154,A00,185823,Staff,11,0,20,9
1683721527920,HILA 102,A00,185826,Staff,14,0,20,6
1683721528946,HILD 2C,A01,185778,Staff,0,13,20,20
1683721529969,HILD 7B,A01,185780,Kwak; Nancy,0,17,32,32
1683721529969,HILD 7B,A02,185781,Kwak; Nancy,0,18,32,32
1683721530995,HILD 30,A01,185791,Staff,12,0,20,8
1683721532023,HISC 119,A00,185830,Golan; Tal,0,10,20,20
1683721533054,HITO 156GS,A00,185831,Patterson; Patrick H.,0,0,0,23
1683721534080,HIUS 103,A00,185832,Man; Simeon S,0,4,20,20
1683721535109,HIUS 117,A00,185836,Kwak; Nancy,2,0,20,18
1683721536138,HIUS 125,A00,185840,Man; Simeon S,0,2,23,23
1683721537164,HIUS 149,A00,185845,Staff,1,0,20,19
1683721538194,HUM 3,A01,185882,Zavodny; Tatiana Sophia,0,8,50,50
1683721538194,HUM 3,B01,185899,Caldwell; Michael Alan,0,18,50,50
1683721539219,HUM 3GS,A00,185900,Patterson; Patrick H.,0,0,0,23
1683721540244,HUM 4,A01,185938,Zroka; Amy Liane,28,0,50,22
1683721540244,HUM 4,B01,185956,Watkins; Eric,0,6,50,50
1683721540244,HUM 4,B02,202209,Watkins; Eric,0,6,50,50
1683721540244,HUM 4,B03,202210,Watkins; Eric,0,5,50,50
1683721541272,HUM 5,A01,185958,West; Geoffrey Scott,0,0,50,50
1683721541272,HUM 5,A02,202215,West; Geoffrey Scott,0,1,50,50
1683721542304,INTL 190,A00,185959,Gagnon; Jeffrey C,0,0,0,9
1683721542304,INTL 190,B00,185960,Lettieri; Michael Joseph,0,0,0,2
1683721543334,JAPN 180,A00,254509,Staff,4,0,30,26
1683721544363,LATI 10,A01,202853,Kennemore; Amy Michelle,4,0,35,31
1683721544363,LATI 10,A02,202854,Kennemore; Amy Michelle,3,0,35,32
1683721544363,LATI 10,A03,270054,Kennemore; Amy Michelle,30,0,30,0
1683721545393,LATI 180,A00,202855,Kennemore; Amy Michelle,11,0,20,9
1683721546422,LAWS 101,A00,201767,Golan; Tal,0,7,40,40
1683721547448,LIFR 1C,A00,185961,Staff,6,0,20,14
1683721548480,LIFR 1CX,A00,185962,Staff,7,0,20,13
1683721549508,LIFR 1D,A00,185963,Staff,7,0,20,13
1683721550534,LIFR 1DX,A00,185964,Staff,7,0,20,13
1683721551559,LIGN 101,A01,186039,Staff,43,0,50,7
1683721552591,LIGN 165,A00,186040,Staff,14,0,50,36
1683721553617,LTCS 108,A00,186041,Staff,5,0,10,5
1683721554642,LTCS 119,A00,186042,Staff,15,0,20,5
1683721555671,LTCS 130,A00,186043,Wesling; Megan E.,15,0,25,10
1683721557726,LTEA 138,A00,186119,Staff,13,0,40,27
1683721558755,LTEN 124,A00,186148,Staff,5,0,25,20
1683721559786,LTEN 178,A00,186149,Staff,6,0,15,9
1683721560811,LTEN 181,A00,186150,Blanco; John D,34,0,40,6
1683721561838,LTWL 120,A00,186160,Staff,19,0,25,6
1683721562868,LTWL 165,A00,186161,Staff,22,0,25,3
1683721563893,LTWR 100,A00,186162,Staff,0,5,15,15
1683721564919,LTWR 102,A00,186163,Doller; Ben,5,0,15,10
1683721565952,MAE 8,A01,186412,Staff,0,1,0,0
1683721566990,MAE 30B,A00,186445,Bahadori; Mohammad Yousef,81,0,100,19
1683721568017,MAE 40,A00,186592,Bewley; Thomas R,10,0,50,40
1683721569049,MAE 101B,A00,186593,Bahadori; Mohammad Yousef,80,0,100,20
1683721570080,MAE 105,A00,186594,Bandaru; Prabhakar,10,0,50,40
1683721571107,MAE 107,A00,186599,Pham; Hieu Tan,0,8,120,120
1683721572133,MAE 148,A01,186660,Silberman; Jack,3,0,16,13
1683721573159,MATH 10A,A01,188095,Staff,0,6,35,35
1683721574187,MATH 10B,A01,188097,Bowers; Adam R.,0,12,30,30
1683721574187,MATH 10B,A02,188099,Bowers; Adam R.,0,11,30,30
1683721574187,MATH 10B,B01,188104,Bowers; Adam R.,0,10,30,30
1683721574187,MATH 10B,B02,188106,Bowers; Adam R.,0,9,30,30
1683721575216,MATH 10C,A01,188111,Staff,0,20,30,30
1683721575216,MATH 10C,A02,188127,Staff,0,19,30,30
1683721575216,MATH 10C,A03,188131,Staff,0,19,30,30
1683721575216,MATH 10C,B01,188218,Staff,17,0,30,13
1683721575216,MATH 10C,B02,188244,Staff,13,0,30,17
1683721575216,MATH 10C,B03,188277,Staff,14,0,30,16
1683721576247,MATH 18,A01,188344,Bach; Quang Tran,18,0,30,12
1683721576247,MATH 18,A02,188345,Bach; Quang Tran,11,0,30,19
1683721576247,MATH 18,B01,188353,Bach; Quang Tran,11,0,30,19
1683721576247,MATH 18,B02,188354,Bach; Quang Tran,19,0,30,11
1683721577272,MATH 20A,A01,188374,Staff,11,0,35,24
1683721578299,MATH 20B,A01,188382,Ohm; Ko Woon,7,0,30,23
1683721578299,MATH 20B,A02,188383,Ohm; Ko Woon,22,0,30,8
1683721578299,MATH 20B,B01,188385,Ohm; Ko Woon,7,0,30,23
1683721578299,MATH 20B,B02,188392,Ohm; Ko Woon,22,0,30,8
1683721579332,MATH 20C,A01,188394,Harel; Guershon,10,0,30,20
1683721579332,MATH 20C,A02,188395,Harel; Guershon,13,0,30,17
1683721579332,MATH 20C,B01,188404,Harel; Guershon,5,0,30,25
1683721579332,MATH 20C,B02,188405,Harel; Guershon,18,0,30,12
1683721580365,MATH 20D,A01,188414,Hammock; Frances H,0,1,30,30
1683721580365,MATH 20D,A02,188415,Hammock; Frances H,0,1,30,30
1683721580365,MATH 20D,B01,188447,Hammock; Frances H,0,1,30,30
1683721580365,MATH 20D,B02,188486,Hammock; Frances H,2,0,30,28
1683721581396,MATH 20E,A01,188649,Staff,21,0,30,9
1683721581396,MATH 20E,A02,188650,Staff,20,0,30,10
1683721581396,MATH 20E,A03,188673,Staff,0,0,30,30
1683721582424,MATH 102,A01,188675,Staff,0,40,35,35
1683721583451,MATH 103B,A01,188681,Staff,3,0,35,32
1683721583451,MATH 103B,B01,188692,Staff,5,0,35,30
1683721584477,MATH 109,A01,188695,Salehi Golsefidy; Alireza,24,0,35,11
1683721584477,MATH 109,A02,188696,Salehi Golsefidy; Alireza,24,0,35,11
1683721585504,MATH 120A,A01,188698,Eggers; John Dietrich,7,0,35,28
1683721586534,MATH 142B,A01,188736,Ioana; Adrian,0,0,30,30
1683721586534,MATH 142B,A02,188741,Ioana; Adrian,0,1,30,30
1683721586534,MATH 142B,A03,188743,Ioana; Adrian,0,3,30,30
1683721587561,MATH 168A,A01,188790,Staff,0,11,35,35
1683721588594,MATH 170A,A01,188803,Nie; Jiawang,0,2,35,35
1683721588594,MATH 170A,A02,188811,Nie; Jiawang,0,1,35,35
1683721588594,MATH 170A,A03,188814,Nie; Jiawang,1,0,35,34
1683721588594,MATH 170A,A04,188815,Nie; Jiawang,5,0,35,30
1683721589619,MATH 193B,A01,188817,Staff,0,0,35,35
1683721589619,MATH 193B,A02,188818,Staff,6,0,35,29
1683721590646,MGT 4,A01,202857,Anderson; John Charles,59,0,80,21
1683721591680,MGT 12,A00,202858,Lindenberger; Wade Douglas,40,0,90,50
1683721592708,MGT 18,A00,202859,Staff,73,0,90,17
1683721593734,MGT 18GS,A00,202860,McKay; Michael J,13,0,28,15
1683721594764,MGT 45,A00,202861,Pecore; Joseph P.,8,0,90,82
1683721595790,MGT 100,A00,202863,Yavorsky; Daniel Ryan,27,0,90,63
1683721596821,MGT 103,A00,202864,Ehrich; Kristine R,0,19,90,90
1683721597846,MGT 112,A00,202865,Ehrich; Kristine R,15,0,90,75
1683721598878,MGT 121A,A00,202868,Staff,70,0,90,20
1683721599904,MGT 131B,A00,202869,Anderson; John Charles,58,0,90,32
1683721600934,MGT 136,A00,202871,Lindenberger; Wade Douglas,83,0,90,7
1683721601960,MGT 164,A00,202873,Staff,0,67,90,91
1683721602985,MGT 164GS,A00,202874,McKay; Mary A,13,0,28,15
1683721604013,MGT 180,A00,202875,Staff,0,51,90,91
1683721605041,MMW 11R,A01,205019,Herbst; Matthew,0,0,30,30
1683721605041,MMW 11R,A02,205026,Herbst; Matthew,29,0,30,1
1683721606070,MMW 15,A01,193512,Chang; Edmond Yi-Teh,0,8,28,28
1683721606070,MMW 15,A02,193513,Chang; Edmond Yi-Teh,0,5,28,28
1683721606070,MMW 15,A03,193514,Chang; Edmond Yi-Teh,0,5,28,28
1683721606070,MMW 15,A04,193515,Chang; Edmond Yi-Teh,0,5,28,28
1683721606070,MMW 15,A05,193516,Chang; Edmond Yi-Teh,0,5,28,28
1683721606070,MMW 15,A06,193517,Chang; Edmond Yi-Teh,0,6,28,28
1683721606070,MMW 15,B01,193519,Chang; Edmond Yi-Teh,0,5,28,28
1683721606070,MMW 15,B02,193520,Chang; Edmond Yi-Teh,0,5,28,28
1683721606070,MMW 15,B03,193521,Chang; Edmond Yi-Teh,0,5,28,28
1683721606070,MMW 15,B04,193522,Chang; Edmond Yi-Teh,0,6,28,28
1683721606070,MMW 15,B05,193523,Chang; Edmond Yi-Teh,0,5,28,28
1683721606070,MMW 15,B06,193524,Chang; Edmond Yi-Teh,0,5,28,28
1683721607096,MMW 122,A01,193526,Rahimi; Babak,0,16,28,28
1683721607096,MMW 122,A02,193527,Rahimi; Babak,0,15,28,28
1683721607096,MMW 122,A03,193528,Rahimi; Babak,0,0,0,0
1683721607096,MMW 122,A04,193529,Rahimi; Babak,0,0,0,0
1683721608181,MUS 1A,A01,186663,Staff,0,18,35,35
1683721609208,MUS 4,A01,186715,Staff,0,12,35,35
1683721610234,MUS 5R,A01,186796,Dubnov; Shlomo,0,17,35,35
1683721611259,MUS 6,A01,186798,Staff,0,4,25,25
1683721612284,MUS 7,A01,186830,Staff,11,0,35,24
1683721613312,MUS 8,A01,186930,Staff,0,27,35,35
1683721614339,MUS 15,A01,186932,Staff,0,15,35,35
1683721614339,MUS 15,B01,186934,Staff,0,16,35,35
1683721615364,MUS 80,A00,186935,Staff,0,0,20,20
1683721615364,MUS 80,B00,186936,Staff,24,0,25,1
1683721616391,NANO 11,A00,204702,Lipomi; Darren John,0,0,0,0
1683721617420,NANO 15,A01,204709,Yang; Kesong,0,1,0,0
1683721618446,NANO 114,A00,202069,Jahed Motlagh; Zeinab,2,0,10,8
1683721619477,PHIL 1,A00,186955,Grush; Rick Scott,31,0,40,9
1683721620509,PHIL 10,A01,186973,Grush; Rick Scott,27,0,35,8
1683721620509,PHIL 10,A02,186974,Grush; Rick Scott,33,0,35,2
1683721621532,PHIL 13,A01,186976,Staff,1,0,35,34
1683721621532,PHIL 13,A02,186977,Staff,16,0,35,19
1683721622558,PHIL 14,A01,186979,Staff,30,0,35,5
1683721622558,PHIL 14,A02,186986,Staff,32,0,35,3
1683721623589,PHIL 28,A01,186988,Staff,16,0,30,14
1683721623589,PHIL 28,A02,186989,Staff,0,0,30,30
1683721623589,PHIL 28,A03,186990,Staff,10,0,30,20
1683721623589,PHIL 28,A04,186991,Staff,26,0,30,4
1683721624614,PHIL 120,A00,186997,Staff,23,0,40,17
1683721625639,PHIL 137,A00,187003,Staff,8,0,40,32
1683721626667,PHIL 150,A00,187015,Staff,47,0,70,23
1683721627699,PHIL 167,A00,187021,Lamey; Andy M.,34,0,40,6
1683721628729,PHIL 174,A01,202226,Staff,17,0,20,3
1683721628729,PHIL 174,A02,202235,Staff,20,0,20,0
1683721629754,PHIL 191A,A00,258918,Staff,0,0,1,1
1683721630780,PHYS 1A,A00,187028,Staff,26,0,60,34
1683721631810,PHYS 1AL,001,187036,Staff,3,0,30,27
1683721631810,PHYS 1AL,002,187049,Staff,18,0,30,12
1683721632839,PHYS 1B,A00,187058,Staff,21,0,60,39
1683721633873,PHYS 1BL,001,187064,Staff,0,1,30,30
1683721633873,PHYS 1BL,002,187070,Staff,4,0,30,26
1683721634901,PHYS 1C,A00,187082,Staff,30,0,120,90
1683721635929,PHYS 1CL,001,187088,Staff,0,9,30,30
1683721635929,PHYS 1CL,002,187089,Staff,0,1,30,30
1683721635929,PHYS 1CL,009,262693,Staff,9,0,30,21
1683721636956,PHYS 2B,A01,187097,Staff,55,0,115,60
1683721637983,PHYS 2C,A01,187099,Staff,63,0,115,52
1683721639009,PHYS 2CL,A01,187101,Staff,5,0,28,23
1683721639009,PHYS 2CL,A02,187102,Staff,15,0,28,13
1683721640036,PHYS 2D,A01,187123,Shotwell; Brian,95,0,115,20
1683721641064,PHYS 4B,A01,187133,Grinstein; Benjamin,35,0,50,15
1683721642087,POLI 10,A00,188819,Staff,0,4,50,50
1683721643114,POLI 11,A00,188827,Staff,43,0,50,7
1683721644140,POLI 13R,A00,188828,Staff,0,2,20,20
1683721645175,POLI 27,A01,188830,Elgin; Samuel Zincke,0,2,70,70
1683721646205,POLI 30,A00,188832,Desposato; Scott,30,0,50,20
1683721647231,POLI 102F,A00,188834,Staff,1,0,40,39
1683721648255,POLI 104A,A00,188852,Staff,12,0,30,18
1683721649284,POLI 104I,A00,188853,Staff,0,8,20,20
1683721650315,POLI 110B,A00,188854,Wiens; David,6,0,20,14
1683721651349,POLI 112A,A00,188855,Wiens; David,3,0,30,27
1683721652377,POLI 117R,A00,188856,Forman; Fonna,0,12,20,20
1683721653402,POLI 118,A00,188857,Ingham; Sean,8,0,20,12
1683721654426,POLI 120G,A00,188858,Staff,7,0,30,23
1683721655455,POLI 131CR,A00,188863,Hoston; Germaine,20,0,50,30
1683721656481,POLI 133,A00,188864,Nellis; Gareth Hb,44,0,50,6
1683721657508,POLI 134D,A00,188865,Desposato; Scott,27,0,30,3
1683721658534,POLI 142A,A00,188871,Gartzke; Erik,21,0,50,29
1683721659561,POLI 142K,A00,188874,Staff,38,0,50,12
1683721660591,POLI 143,A00,188940,Gartzke; Erik,15,0,30,15
1683721661619,POLI 153,A00,188943,Staff,1,0,20,19
1683721662645,POLI 160AA,A00,188944,Staff,10,0,40,30
1683721663670,POLI 170A,A00,188945,Staff,10,0,30,20
1683721665724,PSYC 1,A00,188952,Staff,36,0,90,54
1683721666750,PSYC 2,B00,188953,Staff,19,0,35,16
1683721667776,PSYC 6,A00,188970,Staff,47,0,60,13
1683721668800,PSYC 7,A00,188973,Staff,35,0,45,10
1683721669829,PSYC 60,A01,188980,Rickard; Timothy C.,42,0,60,18
1683721670861,PSYC 70,A01,189001,Steiner; Eric Tomas,22,0,45,23
1683721671891,PSYC 100,A00,189005,Lacefield; Katharine I,1,98,120,119
1683721672920,PSYC 102,A00,189008,Staff,6,0,30,24
1683721673947,PSYC 106,B00,189026,Gorman; Michael R.,27,0,60,33
1683721674975,PSYC 114,B01,189033,Winkielman; Piotr,0,31,30,30
1683721676013,PSYC 131,A00,189036,Anagnostaras; Stephan,0,44,60,60
1683721677039,PSYC 136,A00,189041,Lowe; Angela Beth,0,7,25,25
1683721678063,PSYC 137,A00,189057,Winkielman; Piotr,0,36,25,25
1683721679090,PSYC 144,A00,189107,Wixted; John T,0,11,50,50
1683721681138,PSYC 162,A00,189142,Staff,0,9,85,85
1683721682168,PSYC 172,A00,189144,Gorman; Michael R.,0,6,30,30
1683721684225,PSYC 179,A00,189146,Lacefield; Katharine I,0,88,120,120
1683721685252,PSYC 181,A00,189147,Anagnostaras; Stephan,0,45,90,90
1683721686278,PSYC 190R,A00,189148,Barner; David A.,0,23,80,80
1683721687304,PSYC 191,A00,189275,Rickard; Timothy C.,0,11,25,25
1683721688335,PSYC 193,A00,189276,Chapman; Eddie Nathaniel,0,1,0,4
1683721689365,PSYC 193L,A01,189281,Lowe; Angela Beth,8,0,20,12
1683721689365,PSYC 193L,B01,189285,Staff,28,0,35,7
1683721690396,RELI 149,A00,187137,Rahimi; Babak,6,0,40,34
1683721691424,SE 9,A01,187315,Staff,0,2,18,18
1683721692453,SE 101B,A00,187409,Staff,24,0,30,6
1683721693484,SE 110B,A00,187444,Staff,10,0,40,30
1683721694509,SE 130B,A00,187449,Staff,31,0,40,9
1683721695535,SE 150A,A00,187516,Staff,8,0,20,12
1683721696564,SE 154,A00,187528,Staff,29,0,50,21
1683721697591,SIO 3,A01,258171,Staff,35,0,40,5
1683721698621,SIO 10,A00,187144,Cook; Geoffrey W,0,6,75,75
1683721699647,SIO 45,A00,187152,Cook; Geoffrey W,1,7,100,99
1683721700681,SIO 109R,A00,194486,Staff,0,4,20,20
1683721702734,SIO 187,A01,187233,Kacev; David,12,0,40,28
1683721703764,SOCI 1,A01,258656,Thorpe; Charles Robert,28,0,30,2
1683721703764,SOCI 1,A02,258658,Thorpe; Charles Robert,30,0,30,0
1683721703764,SOCI 1,A03,258661,Thorpe; Charles Robert,25,0,25,0
1683721703764,SOCI 1,A04,258666,Thorpe; Charles Robert,22,0,25,3
1683721703764,SOCI 1,A05,258897,Thorpe; Charles Robert,22,0,25,3
1683721703764,SOCI 1,A06,258898,Thorpe; Charles Robert,25,0,25,0
1683721704796,SOCI 30,A01,258903,Pardo Guerra; Juan Pablo,14,0,30,16
1683721705822,SOCI 102,A00,258904,Staff,9,0,25,16
1683721706852,SOCI 106,A00,258905,Staff,19,0,25,6
1683721707881,SOCI 111,A00,258907,Ribas Norris; Janet Vanesa,26,0,30,4
1683721708909,SOCI 121R,A00,258908,Pardo Guerra; Juan Pablo,7,0,30,23
1683721709939,SOCI 126,A01,203330,Staff,14,0,20,6
1683721710968,SOCI 131,A00,258909,Thorpe; Charles Robert,30,0,60,30
1683721712052,SOCI 135,A00,258910,Payne; Christine Anna,0,13,30,30
1683721713076,SOCI 157,A00,258911,Staff,10,0,30,20
1683721714104,SOCI 184,A00,258912,Staff,25,0,30,5
1683721715132,SOCI 188D,A00,258913,Staff,22,0,30,8
1683721716165,SYN 2,001,187529,Staff,9,0,16,7
1683721716165,SYN 2,002,201452,Staff,0,20,16,16
1683721716165,SYN 2,003,201469,Staff,1,0,16,15
1683721717190,SYN 100,A01,187531,Staff,0,9,20,20
1683721717190,SYN 100,B01,201491,Staff,0,10,20,20
1683721718218,TDAC 1,A00,189286,Walsh; Kim C.,3,0,20,17
1683721718218,TDAC 1,B00,189287,Harting; Carla Kelso,10,0,20,10
1683721719247,TDAC 101,A00,189300,Walsh; Kim C.,16,0,20,4
1683721719247,TDAC 101,B00,189301,Harting; Carla Kelso,18,0,20,2
1683721720278,TDAC 102,A00,189304,Basso; Beatrice,14,0,20,6
1683721721305,TDAC 108,A00,189305,Staff,18,0,20,2
1683721722339,TDDE 131,A00,189310,Staff,19,0,20,1
1683721722339,TDDE 131,B00,189314,Staff,19,0,20,1
1683721722339,TDDE 131,C00,189315,Staff,48,0,50,2
1683721722339,TDDE 131,D00,189316,Staff,14,0,15,1
1683721722339,TDDE 131,E00,204841,Staff,20,0,20,0
1683721723364,TDGE 10,A00,189289,Staff,26,0,50,24
1683721723364,TDGE 10,B00,189290,Havis; Allan,0,1,50,50
1683721724397,TDGE 11,A00,189291,Fulton; Julia,0,4,50,50
1683721724397,TDGE 11,B00,189292,Staff,20,0,25,5
1683721724397,TDGE 11,C00,260270,Staff,0,0,0,0
1683721725426,TDGE 25,A00,189294,Staff,1,0,20,19
1683721726453,TDGE 124,A00,189318,Fulton; Julia,0,7,50,50
1683721727482,TDGE 125,A00,189319,Staff,13,0,25,12
1683721727482,TDGE 125,B00,189320,Staff,23,0,25,2
1683721728511,TDGE 127,A00,189322,Havis; Allan,1,0,50,49
1683721729537,TDHT 101,A00,189323,Staff,18,0,25,7
1683721729537,TDHT 101,B00,189324,Staff,25,0,25,0
1683721730569,TDHT 102,A00,189325,Staff,49,0,50,1
1683721731600,TDMV 1,A00,189295,Arcidiacono; Kristin,20,0,30,10
1683721731600,TDMV 1,B00,189296,Caligagan; Maria T.,23,0,30,7
1683721732628,TDMV 2,A00,189297,Sammartano; Tonnie,27,0,30,3
1683721732628,TDMV 2,B00,189299,Arcidiacono; Kristin,23,0,30,7
1683721733655,TDMV 3,A00,204998,Rincon; Alicia,22,0,30,8
1683721734685,TDMV 120,A00,189458,Sammartano; Tonnie,28,0,30,2
1683721735711,TDMV 138,A00,189541,Jun; Grace Shin Hae,20,0,40,20
1683721736738,TDMV 142,A00,189717,Caligagan; Tony,25,0,30,5
1683721736738,TDMV 142,B00,189718,Caligagan; Maria T.,25,0,30,5
1683721737764,TMC 2,A01,187533,Staff,25,0,25,0
1683721737764,TMC 2,A02,187534,Staff,25,0,25,0
1683721738791,USP 1,A01,187536,Kwak; Nancy,0,16,25,25
1683721739817,USP 5,A01,187538,Staff,8,0,25,17
1683721740843,USP 101,A00,199253,Staff,0,4,0,0
1683721741875,USP 124,A00,187562,Boomhower; Matthew Charles,0,0,30,30
1683721742903,USP 138,A00,187582,Staff,19,0,25,6
1683721743937,USP 152,A01,187597,Staff,3,0,25,22
1683721744962,USP 153,A00,187598,Staff,18,0,25,7
1683721745989,USP 168,A00,187607,Kwak; Nancy,2,0,5,3
1683721747014,USP 173,A00,187619,Staff,4,0,25,21
1683721748044,USP 181,A00,187638,Staff,0,4,25,25
1683721749071,VIS 103,A00,187650,Cruz; Edwin Teddy,17,0,75,58
1683721750097,VIS 110D,A00,187669,Staff,13,0,22,9
1683721751127,VIS 127C,A00,187720,Shen; Kuiyi,67,0,146,79
1683721752157,VIS 149,A00,187731,Yoldas; Pinar,0,12,22,22
1683721753183,VIS 151,A01,188091,Staff,22,0,34,12
1683721753183,VIS 151,A02,188092,Staff,11,0,34,23
1683721754209,VIS 160B,A00,188093,Stalbaum; Brett,0,1,10,10
1683721756260,WCWP 10B,A00,201720,Staff,0,0,5,5
1683721756260,WCWP 10B,B00,201722,Staff,0,0,6,6
1683721757287,WCWP 100,A00,201725,Gagnon; Jeffrey C,0,0,2,2
1683721757287,WCWP 100,B00,201727,Staff,0,4,15,15
1683721760468,ANBI 133,A00,258401,Wilder; Linnea Lorene,34,0,40,6
1683721761493,ANBI 140,A00,258395,Hrvoj Mihic; Branka,18,0,25,7
1683721762518,ANSC 120,A00,258402,Bialecki; Jon Anthony,26,0,40,14
1683721763547,ANSC 144,A00,258400,Staff,12,0,40,28
1683721765601,ANSC 166,A00,258396,Parish; Steven Martin,156,0,175,19
1683721766630,ANSC 180,A00,193533,Staff,8,0,20,12
1683721767661,ANSC 188,A00,258397,Jassal; Aftab,34,0,40,6
1683721768687,ANTH 3,A01,258316,Staff,23,0,30,7
1683721769718,ANTH 5,A00,258394,Semendeferi; Ekaterini,16,0,20,4
1683721770742,ANTH 21,A01,258331,Staff,4,0,40,36
1683721771767,ANTH 103,A00,258398,Varma; Saiba,15,0,25,10
1683721772795,AWP 10,001,202034,Staff,0,0,0,0
1683721772795,AWP 10,002,202035,Staff,0,0,0,0
1683721772795,AWP 10,003,202036,Staff,0,0,0,0
1683721772795,AWP 10,004,202037,Staff,0,0,0,0
1683721772795,AWP 10,005,202038,Staff,0,0,0,0
1683721772795,AWP 10,006,202039,Staff,0,0,0,0
1683721772795,AWP 10,007,202040,Staff,0,0,0,0
1683721772795,AWP 10,008,202041,Staff,0,0,0,0
1683721772795,AWP 10,009,202042,Staff,0,0,0,0
1683721772795,AWP 10,010,202043,Staff,0,0,0,0
1683721772795,AWP 10,011,202044,Staff,0,0,0,0
1683721772795,AWP 10,012,202045,Staff,0,0,0,0
1683721772795,AWP 10,013,202046,Staff,0,0,0,0
1683721772795,AWP 10,014,202047,Staff,0,0,0,0
1683721772795,AWP 10,015,202048,Staff,0,0,0,0
1683721772795,AWP 10,016,202049,Staff,0,0,0,0
1683721772795,AWP 10,017,202050,Staff,0,0,0,0
1683721772795,AWP 10,018,202051,Staff,0,0,0,0
1683721772795,AWP 10,019,202052,Staff,0,0,0,0
1683721772795,AWP 10,020,202053,Staff,0,0,0,0
1683721772795,AWP 10,021,202054,Staff,0,0,0,0
1683721772795,AWP 10,022,202055,Staff,0,0,0,0
1683721772795,AWP 10,023,202056,Staff,0,0,0,0
1683721772795,AWP 10,024,202057,Staff,0,0,0,0
1683721772795,AWP 10,025,202058,Staff,0,0,0,0
1683721772795,AWP 10,026,202059,Staff,0,0,0,0
1683721773822,AWP 102,001,202032,Staff,0,0,0,0
1683721773822,AWP 102,002,202033,Staff,0,0,0,0
1683721774848,BENG 100,A01,254234,Taylor Amos; Alyssa C,31,0,40,9
1683721775878,BENG 196,001,270013,Engler; Adam J.,9999,0,9999,0
1683721776908,BICD 100R,A01,202018,Smith; Laurie,0,7,32,32
1683721776908,BICD 100R,A02,202019,Smith; Laurie,0,3,32,32
1683721776908,BICD 100R,A03,202020,Smith; Laurie,0,1,32,32
1683721776908,BICD 100R,A04,202021,Smith; Laurie,6,0,32,26
1683721776908,BICD 100R,A05,202022,Smith; Laurie,10,0,32,22
1683721777935,BICD 136,A01,193242,Gustafson-Brown; Cindy,0,2,32,32
1683721777935,BICD 136,A02,193244,Gustafson-Brown; Cindy,13,0,32,19
1683721778963,BIEB 102,A01,193249,Butler; Shannon Rhey,0,0,32,32
1683721778963,BIEB 102,A02,193251,Butler; Shannon Rhey,0,0,32,32
1683721778963,BIEB 102,A03,193253,Butler; Shannon Rhey,0,0,32,32
1683721778963,BIEB 102,A04,193255,Butler; Shannon Rhey,13,0,32,19
1683721778963,BIEB 102,A05,193265,Butler; Shannon Rhey,25,0,32,7
1683721778963,BIEB 102,A06,193269,Butler; Shannon Rhey,12,0,32,20
1683721781016,BIEB 150,A01,193274,Staff,0,0,32,32
1683721781016,BIEB 150,A02,193285,Staff,24,0,32,8
1683721782043,BIEB 194,A00,193286,Kurle; Carolyn M.,19,0,32,13
1683721783071,BILD 1,A01,192291,Staff,15,0,32,17
1683721783071,BILD 1,A02,192292,Staff,30,0,32,2
1683721783071,BILD 1,B01,192520,Reuther; Keefe,0,1,0,0
1683721783071,BILD 1,B02,192532,Reuther; Keefe,0,1,0,0
1683721784096,BILD 3,A01,192556,Butler; Shannon Rhey,0,0,32,32
1683721784096,BILD 3,A02,192581,Butler; Shannon Rhey,0,1,32,32
1683721784096,BILD 3,A03,192611,Butler; Shannon Rhey,19,0,32,13
1683721784096,BILD 3,A04,192612,Butler; Shannon Rhey,23,0,32,9
1683721784096,BILD 3,A05,192613,Butler; Shannon Rhey,26,0,32,6
1683721784096,BILD 3,A06,192679,Butler; Shannon Rhey,27,0,32,5
1683721784096,BILD 3,A07,192682,Butler; Shannon Rhey,20,0,32,12
1683721785122,BILD 4,A01,192836,Reuther; Keefe,1,0,24,23
1683721785122,BILD 4,A02,193044,Reuther; Keefe,4,0,24,20
1683721786147,BILD 10,A01,193142,Gustafson-Brown; Cindy,29,0,32,3
1683721786147,BILD 10,A02,193149,Gustafson-Brown; Cindy,31,0,32,1
1683721787177,BIMM 100,A01,193301,Staff,0,6,32,32
1683721787177,BIMM 100,A02,193312,Staff,0,7,32,32
1683721787177,BIMM 100,A03,193323,Staff,0,10,32,32
1683721788210,BIMM 101,A01,193329,McDonnell; Lisa Marie,0,3,24,24
1683721788210,BIMM 101,A02,193339,McDonnell; Lisa Marie,0,3,24,24
1683721788210,BIMM 101,B01,193354,McDonnell; Lisa Marie,0,4,24,24
1683721788210,BIMM 101,B02,193357,McDonnell; Lisa Marie,0,3,24,24
1683721789236,BIMM 110,A01,193377,Tat; John,0,11,32,32
1683721789236,BIMM 110,A02,193378,Tat; John,0,11,32,32
1683721790266,BIMM 120,A01,206116,Staff,0,0,32,32
1683721790266,BIMM 120,A02,206117,Staff,7,0,32,25
1683721790266,BIMM 120,A03,206121,Staff,21,0,32,11
1683721791297,BIPN 100,A01,193393,Park; Ji Young,0,15,32,32
1683721791297,BIPN 100,A02,193402,Park; Ji Young,0,14,32,32
1683721791297,BIPN 100,A03,193413,Park; Ji Young,0,14,32,32
1683721791297,BIPN 100,A04,193414,Park; Ji Young,0,13,32,32
1683721792324,BIPN 102,A01,193429,Staff,0,0,32,32
1683721792324,BIPN 102,A02,193438,Staff,18,0,32,14
1683721793350,BIPN 106,A01,193450,Reyes Gonzalez; Catalina,0,2,40,40
1683721794376,BIPN 134,A01,193465,Cooke; James Edward,0,0,32,32
1683721794376,BIPN 134,A02,193474,Cooke; James Edward,25,0,32,7
1683721794376,BIPN 134,A03,193485,Cooke; James Edward,29,0,32,3
1683721794376,BIPN 134,A04,193486,Cooke; James Edward,20,0,32,12
1683721794376,BIPN 134,A05,193491,Cooke; James Edward,31,0,32,1
1683721794376,BIPN 134,A06,193501,Cooke; James Edward,30,0,32,2
1683721794376,BIPN 134,A07,193510,Cooke; James Edward,29,0,32,3
1683721796428,BISP 194,A00,222522,Staff,14,0,32,18
1683721797457,CAT 124,A01,202407,Staff,19,0,25,6
1683721798488,CAT 125,A00,202408,Marchisotto; Jennifer Anne,2,0,20,18
1683721799516,CAT 125R,A00,202409,Smith; Lauryn Alissa,0,11,20,20
1683721799516,CAT 125R,B00,202410,Morales; Celeste Georgianna,0,11,20,20
1683721799516,CAT 125R,C00,202411,Irwin; Matthew Joseph,0,12,20,20
1683721800542,CENG 15,A01,204712,Yang; Kesong,0,1,0,0
1683721801568,CENG 114,A00,202070,Jahed Motlagh; Zeinab,5,0,20,15
1683721802602,CGS 105,A00,185477,Wesling; Megan E.,24,0,40,16
1683721803630,CGS 106,A00,185494,Staff,11,0,22,11
1683721804656,CGS 108,A00,185495,Staff,14,0,20,6
1683721805684,CGS 114,A00,185496,Staff,13,0,18,5
1683721806709,CGS 119,A00,185501,Staff,15,0,20,5
1683721807734,CGS 120,A00,185511,Staff,11,0,20,9
1683721808761,CHEM 4,A01,184675,Bussey; Thomas J,97,0,100,3
1683721809788,CHEM 6A,A01,184677,Staff,32,0,60,28
1683721810813,CHEM 6B,A01,184679,Staff,63,0,100,37
1683721811839,CHEM 6C,A01,184681,Bussey; Thomas J,0,0,50,50
1683721811839,CHEM 6C,A02,184682,Bussey; Thomas J,32,0,50,18
1683721812866,CHEM 40A,A01,184684,Albizati; Kim F.,33,0,100,67
1683721813896,CHEM 40B,A01,184686,Albizati; Kim F.,0,22,100,100
1683721814926,CHEM 41B,A01,184690,Staff,51,0,100,49
1683721816010,COGS 3,A01,184715,Boyle; Mary E. T.,0,27,40,40
1683721817036,COGS 14B,A01,185172,Staff,0,14,38,38
1683721818067,COGS 18,A01,184736,Staff,14,0,80,66
1683721819092,COGS 100,A01,184932,Staff,0,8,73,73
1683721820118,COGS 101A,A01,184935,Staff,0,40,30,30
1683721821144,COGS 101B,A01,184944,Staff,0,2,30,30
1683721822170,COGS 101C,A01,184946,Staff,0,10,30,30
1683721823200,COGS 102A,A01,184951,Johnson; Christine M.,1,0,40,39
1683721824225,COGS 107B,A01,184953,Mooshagian; Eric Frederick,0,52,40,40
1683721825255,COGS 118B,A01,184959,Gupta; Anjum,0,50,40,40
1683721826280,COGS 153,A00,184961,Staff,1,16,30,29
1683721827313,COGS 177,A00,184962,Staff,0,20,30,30
1683721828345,COGS 187A,A01,184969,Boyle; Mary E. T.,0,19,40,40
1683721829371,COMM 10,A01,185174,Staff,0,5,25,25
1683721829371,COMM 10,A02,185189,Staff,0,2,25,25
1683721829371,COMM 10,A03,269821,Staff,0,1,0,0
1683721830406,COMM 100B,A02,185476,Staff,10,0,25,15
1683721830406,COMM 100B,A03,277340,Staff,25,0,25,0
1683721831436,COMM 100C,A01,185314,Staff,2,0,25,23
1683721831436,COMM 100C,A02,185327,Staff,17,0,25,8
1683721832465,COMM 110M,A00,185349,Staff,0,0,40,40
1683721833490,COMM 113T,A00,185352,Staff,25,0,40,15
1683721834519,COMM 114I,A00,185353,Staff,31,0,40,9
1683721835544,COMM 131,A00,185354,Staff,17,0,30,13
1683721836569,CSE 8A,A50,185358,Cao; Yingjun,0,46,10,10
1683721837595,CSE 8B,A01,185362,Staff,0,48,50,50
1683721838627,CSE 11,A01,185416,Cao; Yingjun,0,91,10,10
1683721839653,CSE 20,A01,185445,Briones; Jor-el Thomas Caparas,3,0,25,22
1683721840677,CSE 21,A01,185447,Staff,9,0,50,41
1683721841702,CSE 101,A01,185451,Staff,0,13,50,50
1683721841702,CSE 101,B01,185453,Jones; Miles E,0,15,50,50
1683721843760,CSE 141,A01,185458,Eldon; John,16,0,100,84
1683721844786,CSE 141L,A01,185461,Eldon; John,8,0,100,92
1683721845818,CSE 142,A01,185463,Staff,34,0,60,26
1683721845818,CSE 142,B01,201355,Staff,0,7,60,60
1683721846846,CSE 142L,A01,185470,Staff,34,0,60,26
1683721846846,CSE 142L,B01,201417,Staff,0,6,60,60
1683721847874,CSE 190,A00,201433,Staff,32,0,49,17
1683721848908,DOC 1,A01,259136,Strom; Megan C.,7,0,15,8
1683721848908,DOC 1,A02,259137,Strom; Megan C.,15,0,15,0
1683721848908,DOC 1,A03,259138,Strom; Megan C.,14,0,15,1
1683721848908,DOC 1,A04,259139,Strom; Megan C.,13,0,15,2
1683721849934,DOC 100D,A00,259140,Pass; Natalye Joann,14,0,25,11
1683721850960,DSGN 1,A01,184749,Rill; Bryan,0,26,30,30
1683721851985,DSGN 100,A01,185168,Staff,0,2,25,25
1683721853011,ECE 5,A01,185626,Morris; Karcher William,0,12,0,0
1683721854040,ECE 101,A01,185628,Staff,14,0,70,56
1683721855066,ECE 107,A01,185635,Baghdadchi; Saharnaz,0,0,20,20
1683721855066,ECE 107,A02,185638,Baghdadchi; Saharnaz,1,0,20,19
1683721856093,ECE 148,A01,185647,Silberman; Jack,0,0,16,16
1683721857122,ECON 1,A01,185537,Crane; Meredith Helen,54,0,70,16
1683721858150,ECON 3,A01,185549,Crane; Meredith Helen,30,0,70,40
1683721859186,ECON 4,A01,203354,Anderson; John Charles,0,5,10,10
1683721860211,ECON 100A,A01,185574,Staff,0,5,40,40
1683721861360,ECON 100B,A01,185576,Staff,0,12,50,50
1683721862391,ECON 100C,A01,185589,Newhouse; Herbert S,30,0,70,40
1683721863417,ECON 105,A00,185608,Vespa; Emanuel Ignacio,19,0,35,16
1683721864442,ECON 109,A01,185610,Shishkin; Denis,9,0,35,26
1683721865472,ECON 110A,A01,185612,Staff,8,0,40,32
1683721866501,ECON 120A,A01,185615,Staff,19,0,40,21
1683721867527,ECON 120C,A01,185617,Sun; Yixiao,0,21,70,70
1683721868554,ECON 144,A00,203346,Squires; Dale E,2,0,35,33
1683721869583,ECON 171,A01,203349,Newhouse; Herbert S,0,1,35,35
1683721870615,ECON 173A,A01,185621,Toda; Alexis Akira,21,0,35,14
1683721871643,EDS 25,A01,202413,Staff,0,1,0,0
1683721871643,EDS 25,A02,202414,Staff,0,1,0,0
1683721871643,EDS 25,A03,202415,Staff,0,0,0,0
1683721871643,EDS 25,A04,202416,Staff,0,1,0,0
1683721871643,EDS 25,A05,202439,Staff,0,0,0,0
1683721871643,EDS 25,A06,202440,Staff,0,0,0,0
1683721871643,EDS 25,B01,202631,Staff,0,0,0,0
1683721871643,EDS 25,B02,202632,Staff,0,0,0,0
1683721871643,EDS 25,B03,202639,Staff,0,0,0,0
1683721871643,EDS 25,B04,202640,Staff,0,0,0,0
1683721871643,EDS 25,B05,202643,Staff,0,0,0,0
1683721871643,EDS 25,B06,202644,Staff,0,0,0,0
1683721872670,EDS 38,A01,202659,Black; Alison Michelle,25,0,25,0
1683721873699,EDS 115,A00,202652,Staff,18,0,30,12
1683721874723,EDS 125,A00,202649,Staff,13,0,30,17
1683721875753,EDS 126,A01,203332,Staff,30,0,30,0
1683721876779,EDS 139,A00,202838,Staff,16,0,25,9
1683721877808,EDS 146,A01,202655,Staff,14,0,25,11
1683721878839,ENG 15,A00,185667,Staff,0,1,0,0
1683721878839,ENG 15,B00,185672,Staff,0,0,0,0
1683721878839,ENG 15,C00,185675,Staff,0,0,0,0
1683721878839,ENG 15,D00,185682,Staff,0,0,0,0
1683721878839,ENG 15,E00,185684,Staff,0,0,0,0
1683721879866,ETHN 103,A00,185710,Staff,0,8,35,35
1683721880894,ETHN 103A,A00,199228,Man; Simeon S,0,0,9,9
1683721881923,ETHN 109,A00,185711,Staff,15,0,35,20
1683721882949,ETHN 142,A00,185726,Staff,0,4,30,30
1683721883973,ETHN 163J,A00,199229,Man; Simeon S,5,0,8,3
1683721885003,ETHN 168,A00,185727,Staff,7,0,10,3
1683721886029,ETHN 182,A00,185728,Staff,0,0,35,35
1683721887058,ETHN 183,A00,185737,Staff,10,0,18,8
1683721888083,GLBH 111,A01,209361,Burgos; Jose L.,0,0,0,0
1683721890139,HIEU 104,A00,185792,Staff,14,0,20,6
1683721891168,HIEU 115,A00,185800,Staff,0,0,20,20
1683721892194,HIEU 128,A00,185801,Staff,0,9,20,20
1683721893220,HIEU 147,A00,185802,Staff,15,0,20,5
1683721894244,HIEU 154,A00,185823,Staff,11,0,20,9
1683721895269,HILA 102,A00,185826,Staff,14,0,20,6
1683721896295,HILD 2C,A01,185778,Staff,0,13,20,20
1683721897325,HILD 7B,A01,185780,Kwak; Nancy,0,17,32,32
1683721897325,HILD 7B,A02,185781,Kwak; Nancy,0,18,32,32
1683721898351,HILD 30,A01,185791,Staff,12,0,20,8
1683721899378,HISC 119,A00,185830,Golan; Tal,0,10,20,20
1683721900403,HITO 156GS,A00,185831,Patterson; Patrick H.,0,0,0,23
1683721901430,HIUS 103,A00,185832,Man; Simeon S,0,4,20,20
1683721902455,HIUS 117,A00,185836,Kwak; Nancy,2,0,20,18
1683721903479,HIUS 125,A00,185840,Man; Simeon S,0,2,23,23
1683721904510,HIUS 149,A00,185845,Staff,1,0,20,19
1683721905538,HUM 3,A01,185882,Zavodny; Tatiana Sophia,0,8,50,50
1683721905538,HUM 3,B01,185899,Caldwell; Michael Alan,0,18,50,50
1683721906564,HUM 3GS,A00,185900,Patterson; Patrick H.,0,0,0,23
1683721907600,HUM 4,A01,185938,Zroka; Amy Liane,28,0,50,22
1683721907600,HUM 4,B01,185956,Watkins; Eric,0,6,50,50
1683721907600,HUM 4,B02,202209,Watkins; Eric,0,6,50,50
1683721907600,HUM 4,B03,202210,Watkins; Eric,0,5,50,50
1683721908626,HUM 5,A01,185958,West; Geoffrey Scott,0,0,50,50
1683721908626,HUM 5,A02,202215,West; Geoffrey Scott,0,1,50,50
1683721909656,INTL 190,A00,185959,Gagnon; Jeffrey C,0,0,0,9
1683721909656,INTL 190,B00,185960,Lettieri; Michael Joseph,0,0,0,2
1683721910682,JAPN 180,A00,254509,Staff,4,0,30,26
1683721911711,LATI 10,A01,202853,Kennemore; Amy Michelle,4,0,35,31
1683721911711,LATI 10,A02,202854,Kennemore; Amy Michelle,3,0,35,32
1683721911711,LATI 10,A03,270054,Kennemore; Amy Michelle,30,0,30,0
1683721912737,LATI 180,A00,202855,Kennemore; Amy Michelle,11,0,20,9
1683721913768,LAWS 101,A00,201767,Golan; Tal,0,7,40,40
1683721914797,LIFR 1C,A00,185961,Staff,6,0,20,14
1683721915826,LIFR 1CX,A00,185962,Staff,7,0,20,13
1683721916851,LIFR 1D,A00,185963,Staff,7,0,20,13
1683721917876,LIFR 1DX,A00,185964,Staff,7,0,20,13
1683721918902,LIGN 101,A01,186039,Staff,43,0,50,7
1683721919986,LIGN 165,A00,186040,Staff,14,0,50,36
1683721921011,LTCS 108,A00,186041,Staff,5,0,10,5
1683721922041,LTCS 119,A00,186042,Staff,15,0,20,5
1683721923075,LTCS 130,A00,186043,Wesling; Megan E.,15,0,25,10
1683721925129,LTEA 138,A00,186119,Staff,13,0,40,27
1683721926156,LTEN 124,A00,186148,Staff,5,0,25,20
1683721927186,LTEN 178,A00,186149,Staff,6,0,15,9
1683721928211,LTEN 181,A00,186150,Blanco; John D,34,0,40,6
1683721929243,LTWL 120,A00,186160,Staff,19,0,25,6
1683721930275,LTWL 165,A00,186161,Staff,22,0,25,3
1683721931300,LTWR 100,A00,186162,Staff,0,5,15,15
1683721932330,LTWR 102,A00,186163,Doller; Ben,5,0,15,10
1683721933359,MAE 8,A01,186412,Staff,0,1,0,0
1683721934386,MAE 30B,A00,186445,Bahadori; Mohammad Yousef,81,0,100,19
1683721935411,MAE 40,A00,186592,Bewley; Thomas R,10,0,50,40
1683721936436,MAE 101B,A00,186593,Bahadori; Mohammad Yousef,80,0,100,20
1683721937462,MAE 105,A00,186594,Bandaru; Prabhakar,10,0,50,40
1683721938487,MAE 107,A00,186599,Pham; Hieu Tan,0,8,120,120
1683721939518,MAE 148,A01,186660,Silberman; Jack,3,0,16,13
1683721940548,MATH 10A,A01,188095,Staff,0,6,35,35
1683721941582,MATH 10B,A01,188097,Bowers; Adam R.,0,12,30,30
1683721941582,MATH 10B,A02,188099,Bowers; Adam R.,0,11,30,30
1683721941582,MATH 10B,B01,188104,Bowers; Adam R.,0,10,30,30
1683721941582,MATH 10B,B02,188106,Bowers; Adam R.,0,9,30,30
1683721942614,MATH 10C,A01,188111,Staff,0,20,30,30
1683721942614,MATH 10C,A02,188127,Staff,0,19,30,30
1683721942614,MATH 10C,A03,188131,Staff,0,19,30,30
1683721942614,MATH 10C,B01,188218,Staff,17,0,30,13
1683721942614,MATH 10C,B02,188244,Staff,13,0,30,17
1683721942614,MATH 10C,B03,188277,Staff,14,0,30,16
1683721943647,MATH 18,A01,188344,Bach; Quang Tran,18,0,30,12
1683721943647,MATH 18,A02,188345,Bach; Quang Tran,11,0,30,19
1683721943647,MATH 18,B01,188353,Bach; Quang Tran,11,0,30,19
1683721943647,MATH 18,B02,188354,Bach; Quang Tran,19,0,30,11
1683721944676,MATH 20A,A01,188374,Staff,11,0,35,24
1683721945703,MATH 20B,A01,188382,Ohm; Ko Woon,7,0,30,23
1683721945703,MATH 20B,A02,188383,Ohm; Ko Woon,22,0,30,8
1683721945703,MATH 20B,B01,188385,Ohm; Ko Woon,7,0,30,23
1683721945703,MATH 20B,B02,188392,Ohm; Ko Woon,22,0,30,8
1683721946730,MATH 20C,A01,188394,Harel; Guershon,10,0,30,20
1683721946730,MATH 20C,A02,188395,Harel; Guershon,13,0,30,17
1683721946730,MATH 20C,B01,188404,Harel; Guershon,5,0,30,25
1683721946730,MATH 20C,B02,188405,Harel; Guershon,18,0,30,12
1683721947763,MATH 20D,A01,188414,Hammock; Frances H,0,1,30,30
1683721947763,MATH 20D,A02,188415,Hammock; Frances H,0,1,30,30
1683721947763,MATH 20D,B01,188447,Hammock; Frances H,0,1,30,30
1683721947763,MATH 20D,B02,188486,Hammock; Frances H,2,0,30,28
1683721948791,MATH 20E,A01,188649,Staff,21,0,30,9
1683721948791,MATH 20E,A02,188650,Staff,20,0,30,10
1683721948791,MATH 20E,A03,188673,Staff,0,0,30,30
1683721949818,MATH 102,A01,188675,Staff,0,40,35,35
1683721950845,MATH 103B,A01,188681,Staff,3,0,35,32
1683721950845,MATH 103B,B01,188692,Staff,5,0,35,30
1683721951872,MATH 109,A01,188695,Salehi Golsefidy; Alireza,24,0,35,11
1683721951872,MATH 109,A02,188696,Salehi Golsefidy; Alireza,24,0,35,11
1683721952904,MATH 120A,A01,188698,Eggers; John Dietrich,7,0,35,28
1683721953934,MATH 142B,A01,188736,Ioana; Adrian,0,0,30,30
1683721953934,MATH 142B,A02,188741,Ioana; Adrian,0,1,30,30
1683721953934,MATH 142B,A03,188743,Ioana; Adrian,0,3,30,30
1683721954960,MATH 168A,A01,188790,Staff,0,11,35,35
1683721955987,MATH 170A,A01,188803,Nie; Jiawang,0,2,35,35
1683721955987,MATH 170A,A02,188811,Nie; Jiawang,0,1,35,35
1683721955987,MATH 170A,A03,188814,Nie; Jiawang,1,0,35,34
1683721955987,MATH 170A,A04,188815,Nie; Jiawang,5,0,35,30
1683721957016,MATH 193B,A01,188817,Staff,0,0,35,35
1683721957016,MATH 193B,A02,188818,Staff,6,0,35,29
1683721958048,MGT 4,A01,202857,Anderson; John Charles,59,0,80,21
1683721959074,MGT 12,A00,202858,Lindenberger; Wade Douglas,40,0,90,50
1683721960101,MGT 18,A00,202859,Staff,73,0,90,17
1683721961131,MGT 18GS,A00,202860,McKay; Michael J,13,0,28,15
1683721962157,MGT 45,A00,202861,Pecore; Joseph P.,8,0,90,82
1683721963183,MGT 100,A00,202863,Yavorsky; Daniel Ryan,27,0,90,63
1683721964210,MGT 103,A00,202864,Ehrich; Kristine R,0,19,90,90
1683721965239,MGT 112,A00,202865,Ehrich; Kristine R,15,0,90,75
1683721966270,MGT 121A,A00,202868,Staff,70,0,90,20
1683721967296,MGT 131B,A00,202869,Anderson; John Charles,58,0,90,32
1683721968326,MGT 136,A00,202871,Lindenberger; Wade Douglas,83,0,90,7
1683721969351,MGT 164,A00,202873,Staff,0,67,90,91
1683721970382,MGT 164GS,A00,202874,McKay; Mary A,13,0,28,15
1683721971412,MGT 180,A00,202875,Staff,0,51,90,91
1683721972438,MMW 11R,A01,205019,Herbst; Matthew,0,0,30,30
1683721972438,MMW 11R,A02,205026,Herbst; Matthew,29,0,30,1
1683721973473,MMW 15,A01,193512,Chang; Edmond Yi-Teh,0,8,28,28
1683721973473,MMW 15,A02,193513,Chang; Edmond Yi-Teh,0,5,28,28
1683721973473,MMW 15,A03,193514,Chang; Edmond Yi-Teh,0,5,28,28
1683721973473,MMW 15,A04,193515,Chang; Edmond Yi-Teh,0,5,28,28
1683721973473,MMW 15,A05,193516,Chang; Edmond Yi-Teh,0,5,28,28
1683721973473,MMW 15,A06,193517,Chang; Edmond Yi-Teh,0,6,28,28
1683721973473,MMW 15,B01,193519,Chang; Edmond Yi-Teh,0,5,28,28
1683721973473,MMW 15,B02,193520,Chang; Edmond Yi-Teh,0,5,28,28
1683721973473,MMW 15,B03,193521,Chang; Edmond Yi-Teh,0,5,28,28
1683721973473,MMW 15,B04,193522,Chang; Edmond Yi-Teh,0,6,28,28
1683721973473,MMW 15,B05,193523,Chang; Edmond Yi-Teh,0,5,28,28
1683721973473,MMW 15,B06,193524,Chang; Edmond Yi-Teh,0,5,28,28
1683721974506,MMW 122,A01,193526,Rahimi; Babak,0,16,28,28
1683721974506,MMW 122,A02,193527,Rahimi; Babak,0,15,28,28
1683721974506,MMW 122,A03,193528,Rahimi; Babak,0,0,0,0
1683721974506,MMW 122,A04,193529,Rahimi; Babak,0,0,0,0
1683721975533,MUS 1A,A01,186663,Staff,0,18,35,35
1683721976558,MUS 4,A01,186715,Staff,0,12,35,35
1683721977587,MUS 5R,A01,186796,Dubnov; Shlomo,0,17,35,35
1683721978617,MUS 6,A01,186798,Staff,0,4,25,25
1683721979646,MUS 7,A01,186830,Staff,11,0,35,24
1683721980677,MUS 8,A01,186930,Staff,0,27,35,35
1683721981704,MUS 15,A01,186932,Staff,0,15,35,35
1683721981704,MUS 15,B01,186934,Staff,0,16,35,35
1683721982728,MUS 80,A00,186935,Staff,0,0,20,20
1683721982728,MUS 80,B00,186936,Staff,24,0,25,1
1683721983755,NANO 11,A00,204702,Lipomi; Darren John,0,0,0,0
1683721984781,NANO 15,A01,204709,Yang; Kesong,0,1,0,0
1683721985812,NANO 114,A00,202069,Jahed Motlagh; Zeinab,2,0,10,8
1683721986838,PHIL 1,A00,186955,Grush; Rick Scott,31,0,40,9
1683721987864,PHIL 10,A01,186973,Grush; Rick Scott,27,0,35,8
1683721987864,PHIL 10,A02,186974,Grush; Rick Scott,33,0,35,2
1683721988893,PHIL 13,A01,186976,Staff,1,0,35,34
1683721988893,PHIL 13,A02,186977,Staff,16,0,35,19
1683721989919,PHIL 14,A01,186979,Staff,30,0,35,5
1683721989919,PHIL 14,A02,186986,Staff,32,0,35,3
1683721990949,PHIL 28,A01,186988,Staff,16,0,30,14
1683721990949,PHIL 28,A02,186989,Staff,0,0,30,30
1683721990949,PHIL 28,A03,186990,Staff,10,0,30,20
1683721990949,PHIL 28,A04,186991,Staff,26,0,30,4
1683721991978,PHIL 120,A00,186997,Staff,23,0,40,17
1683721993005,PHIL 137,A00,187003,Staff,8,0,40,32
1683721994030,PHIL 150,A00,187015,Staff,47,0,70,23
1683721995057,PHIL 167,A00,187021,Lamey; Andy M.,34,0,40,6
1683721996088,PHIL 174,A01,202226,Staff,17,0,20,3
1683721996088,PHIL 174,A02,202235,Staff,20,0,20,0
1683721997125,PHIL 191A,A00,258918,Staff,0,0,1,1
1683721998151,PHYS 1A,A00,187028,Staff,26,0,60,34
1683721999176,PHYS 1AL,001,187036,Staff,3,0,30,27
1683721999176,PHYS 1AL,002,187049,Staff,18,0,30,12
1683722000206,PHYS 1B,A00,187058,Staff,21,0,60,39
1683722001232,PHYS 1BL,001,187064,Staff,0,1,30,30
1683722001232,PHYS 1BL,002,187070,Staff,4,0,30,26
1683722002257,PHYS 1C,A00,187082,Staff,30,0,120,90
1683722003288,PHYS 1CL,001,187088,Staff,0,9,30,30
1683722003288,PHYS 1CL,002,187089,Staff,0,1,30,30
1683722003288,PHYS 1CL,009,262693,Staff,9,0,30,21
1683722004319,PHYS 2B,A01,187097,Staff,55,0,115,60
1683722005345,PHYS 2C,A01,187099,Staff,63,0,115,52
1683722006371,PHYS 2CL,A01,187101,Staff,5,0,28,23
1683722006371,PHYS 2CL,A02,187102,Staff,15,0,28,13
1683722007398,PHYS 2D,A01,187123,Shotwell; Brian,95,0,115,20
1683722008425,PHYS 4B,A01,187133,Grinstein; Benjamin,35,0,50,15
1683722009455,POLI 10,A00,188819,Staff,0,4,50,50
1683722010482,POLI 11,A00,188827,Staff,43,0,50,7
1683722011506,POLI 13R,A00,188828,Staff,0,2,20,20
1683722012532,POLI 27,A01,188830,Elgin; Samuel Zincke,0,2,70,70
1683722013559,POLI 30,A00,188832,Desposato; Scott,30,0,50,20
1683722014586,POLI 102F,A00,188834,Staff,1,0,40,39
1683722015612,POLI 104A,A00,188852,Staff,12,0,30,18
1683722016638,POLI 104I,A00,188853,Staff,0,8,20,20
1683722017669,POLI 110B,A00,188854,Wiens; David,6,0,20,14
1683722018698,POLI 112A,A00,188855,Wiens; David,3,0,30,27
1683722019724,POLI 117R,A00,188856,Forman; Fonna,0,12,20,20
1683722020750,POLI 118,A00,188857,Ingham; Sean,8,0,20,12
1683722021778,POLI 120G,A00,188858,Staff,7,0,30,23
1683722022806,POLI 131CR,A00,188863,Hoston; Germaine,20,0,50,30
1683722023892,POLI 133,A00,188864,Nellis; Gareth Hb,44,0,50,6
1683722024920,POLI 134D,A00,188865,Desposato; Scott,27,0,30,3
1683722025948,POLI 142A,A00,188871,Gartzke; Erik,21,0,50,29
1683722026976,POLI 142K,A00,188874,Staff,38,0,50,12
1683722028006,POLI 143,A00,188940,Gartzke; Erik,15,0,30,15
1683722029030,POLI 153,A00,188943,Staff,1,0,20,19
1683722030055,POLI 160AA,A00,188944,Staff,10,0,40,30
1683722031083,POLI 170A,A00,188945,Staff,10,0,30,20
1683722033136,PSYC 1,A00,188952,Staff,36,0,90,54
1683722034164,PSYC 2,B00,188953,Staff,19,0,35,16
1683722035193,PSYC 6,A00,188970,Staff,47,0,60,13
1683722036219,PSYC 7,A00,188973,Staff,35,0,45,10
1683722037248,PSYC 60,A01,188980,Rickard; Timothy C.,42,0,60,18
1683722038279,PSYC 70,A01,189001,Steiner; Eric Tomas,22,0,45,23
1683722039310,PSYC 100,A00,189005,Lacefield; Katharine I,1,98,120,119
1683722040334,PSYC 102,A00,189008,Staff,6,0,30,24
1683722041358,PSYC 106,B00,189026,Gorman; Michael R.,27,0,60,33
1683722042389,PSYC 114,B01,189033,Winkielman; Piotr,0,31,30,30
1683722043415,PSYC 131,A00,189036,Anagnostaras; Stephan,0,44,60,60
1683722044441,PSYC 136,A00,189041,Lowe; Angela Beth,0,7,25,25
1683722045469,PSYC 137,A00,189057,Winkielman; Piotr,0,36,25,25
1683722046500,PSYC 144,A00,189107,Wixted; John T,0,11,50,50
1683722048556,PSYC 162,A00,189142,Staff,0,9,85,85
1683722049585,PSYC 172,A00,189144,Gorman; Michael R.,0,6,30,30
1683722051640,PSYC 179,A00,189146,Lacefield; Katharine I,0,88,120,120
1683722052666,PSYC 181,A00,189147,Anagnostaras; Stephan,0,45,90,90
1683722053697,PSYC 190R,A00,189148,Barner; David A.,0,23,80,80
1683722054726,PSYC 191,A00,189275,Rickard; Timothy C.,0,11,25,25
1683722055751,PSYC 193,A00,189276,Chapman; Eddie Nathaniel,0,1,0,4
1683722056782,PSYC 193L,A01,189281,Lowe; Angela Beth,8,0,20,12
1683722056782,PSYC 193L,B01,189285,Staff,28,0,35,7
1683722057811,RELI 149,A00,187137,Rahimi; Babak,6,0,40,34
1683722058837,SE 9,A01,187315,Staff,0,2,18,18
1683722059862,SE 101B,A00,187409,Staff,24,0,30,6
1683722060887,SE 110B,A00,187444,Staff,10,0,40,30
1683722061918,SE 130B,A00,187449,Staff,31,0,40,9
1683722062945,SE 150A,A00,187516,Staff,8,0,20,12
1683722063970,SE 154,A00,187528,Staff,29,0,50,21
1683722065001,SIO 3,A01,258171,Staff,35,0,40,5
1683722066036,SIO 10,A00,187144,Cook; Geoffrey W,0,6,75,75
1683722067066,SIO 45,A00,187152,Cook; Geoffrey W,1,7,100,99
1683722068091,SIO 109R,A00,194486,Staff,0,4,20,20
1683722070143,SIO 187,A01,187233,Kacev; David,12,0,40,28
1683722071177,SOCI 1,A01,258656,Thorpe; Charles Robert,28,0,30,2
1683722071177,SOCI 1,A02,258658,Thorpe; Charles Robert,30,0,30,0
1683722071177,SOCI 1,A03,258661,Thorpe; Charles Robert,25,0,25,0
1683722071177,SOCI 1,A04,258666,Thorpe; Charles Robert,22,0,25,3
1683722071177,SOCI 1,A05,258897,Thorpe; Charles Robert,22,0,25,3
1683722071177,SOCI 1,A06,258898,Thorpe; Charles Robert,25,0,25,0
1683722072204,SOCI 30,A01,258903,Pardo Guerra; Juan Pablo,14,0,30,16
1683722073232,SOCI 102,A00,258904,Staff,9,0,25,16
1683722074257,SOCI 106,A00,258905,Staff,19,0,25,6
1683722075281,SOCI 111,A00,258907,Ribas Norris; Janet Vanesa,26,0,30,4
1683722076309,SOCI 121R,A00,258908,Pardo Guerra; Juan Pablo,7,0,30,23
1683722077339,SOCI 126,A01,203330,Staff,14,0,20,6
1683722078364,SOCI 131,A00,258909,Thorpe; Charles Robert,30,0,60,30
1683722079394,SOCI 135,A00,258910,Payne; Christine Anna,0,13,30,30
1683722080419,SOCI 157,A00,258911,Staff,10,0,30,20
1683722081447,SOCI 184,A00,258912,Staff,25,0,30,5
1683722082475,SOCI 188D,A00,258913,Staff,22,0,30,8
1683722083503,SYN 2,001,187529,Staff,9,0,16,7
1683722083503,SYN 2,002,201452,Staff,0,20,16,16
1683722083503,SYN 2,003,201469,Staff,1,0,16,15
1683722084528,SYN 100,A01,187531,Staff,0,9,20,20
1683722084528,SYN 100,B01,201491,Staff,0,10,20,20
1683722085563,TDAC 1,A00,189286,Walsh; Kim C.,3,0,20,17
1683722085563,TDAC 1,B00,189287,Harting; Carla Kelso,10,0,20,10
1683722086590,TDAC 101,A00,189300,Walsh; Kim C.,16,0,20,4
1683722086590,TDAC 101,B00,189301,Harting; Carla Kelso,18,0,20,2
1683722087623,TDAC 102,A00,189304,Basso; Beatrice,14,0,20,6
1683722088654,TDAC 108,A00,189305,Staff,18,0,20,2
1683722089682,TDDE 131,A00,189310,Staff,19,0,20,1
1683722089682,TDDE 131,B00,189314,Staff,19,0,20,1
1683722089682,TDDE 131,C00,189315,Staff,48,0,50,2
1683722089682,TDDE 131,D00,189316,Staff,14,0,15,1
1683722089682,TDDE 131,E00,204841,Staff,20,0,20,0
1683722090709,TDGE 10,A00,189289,Staff,26,0,50,24
1683722090709,TDGE 10,B00,189290,Havis; Allan,0,1,50,50
1683722091737,TDGE 11,A00,189291,Fulton; Julia,0,4,50,50
1683722091737,TDGE 11,B00,189292,Staff,20,0,25,5
1683722091737,TDGE 11,C00,260270,Staff,0,0,0,0
1683722092766,TDGE 25,A00,189294,Staff,1,0,20,19
1683722093794,TDGE 124,A00,189318,Fulton; Julia,0,7,50,50
1683722094819,TDGE 125,A00,189319,Staff,13,0,25,12
1683722094819,TDGE 125,B00,189320,Staff,23,0,25,2
1683722095848,TDGE 127,A00,189322,Havis; Allan,1,0,50,49
1683722096874,TDHT 101,A00,189323,Staff,18,0,25,7
1683722096874,TDHT 101,B00,189324,Staff,25,0,25,0
1683722097900,TDHT 102,A00,189325,Staff,49,0,50,1
1683722098927,TDMV 1,A00,189295,Arcidiacono; Kristin,20,0,30,10
1683722098927,TDMV 1,B00,189296,Caligagan; Maria T.,23,0,30,7
1683722099958,TDMV 2,A00,189297,Sammartano; Tonnie,27,0,30,3
1683722099958,TDMV 2,B00,189299,Arcidiacono; Kristin,23,0,30,7
1683722100986,TDMV 3,A00,204998,Rincon; Alicia,22,0,30,8
1683722102016,TDMV 120,A00,189458,Sammartano; Tonnie,28,0,30,2
1683722103043,TDMV 138,A00,189541,Jun; Grace Shin Hae,20,0,40,20
1683722104068,TDMV 142,A00,189717,Caligagan; Tony,25,0,30,5
1683722104068,TDMV 142,B00,189718,Caligagan; Maria T.,25,0,30,5
1683722105098,TMC 2,A01,187533,Staff,25,0,25,0
1683722105098,TMC 2,A02,187534,Staff,25,0,25,0
1683722106126,USP 1,A01,187536,Kwak; Nancy,0,16,25,25
1683722107156,USP 5,A01,187538,Staff,8,0,25,17
1683722108182,USP 101,A00,199253,Staff,0,4,0,0
1683722109214,USP 124,A00,187562,Boomhower; Matthew Charles,0,0,30,30
1683722110239,USP 138,A00,187582,Staff,19,0,25,6
1683722111265,USP 152,A01,187597,Staff,3,0,25,22
1683722112289,USP 153,A00,187598,Staff,18,0,25,7
1683722113316,USP 168,A00,187607,Kwak; Nancy,2,0,5,3
1683722114340,USP 173,A00,187619,Staff,4,0,25,21
1683722115366,USP 181,A00,187638,Staff,0,4,25,25
1683722116390,VIS 103,A00,187650,Cruz; Edwin Teddy,17,0,75,58
1683722117417,VIS 110D,A00,187669,Staff,13,0,22,9
1683722118444,VIS 127C,A00,187720,Shen; Kuiyi,67,0,146,79
1683722119472,VIS 149,A00,187731,Yoldas; Pinar,0,12,22,22
1683722120501,VIS 151,A01,188091,Staff,22,0,34,12
1683722120501,VIS 151,A02,188092,Staff,11,0,34,23
1683722121531,VIS 160B,A00,188093,Stalbaum; Brett,0,1,10,10
1683722123587,WCWP 10B,A00,201720,Staff,0,0,5,5
1683722123587,WCWP 10B,B00,201722,Staff,0,0,6,6
1683722124615,WCWP 100,A00,201725,Gagnon; Jeffrey C,0,0,2,2
1683722124615,WCWP 100,B00,201727,Staff,0,4,15,15
1683722127799,ANBI 133,A00,258401,Wilder; Linnea Lorene,34,0,40,6
1683722128824,ANBI 140,A00,258395,Hrvoj Mihic; Branka,18,0,25,7
1683722129849,ANSC 120,A00,258402,Bialecki; Jon Anthony,26,0,40,14
1683722130878,ANSC 144,A00,258400,Staff,12,0,40,28
1683722132928,ANSC 166,A00,258396,Parish; Steven Martin,156,0,175,19
1683722133957,ANSC 180,A00,193533,Staff,8,0,20,12
1683722134983,ANSC 188,A00,258397,Jassal; Aftab,34,0,40,6
1683722136008,ANTH 3,A01,258316,Staff,23,0,30,7
1683722137034,ANTH 5,A00,258394,Semendeferi; Ekaterini,16,0,20,4
1683722138059,ANTH 21,A01,258331,Staff,4,0,40,36
1683722139084,ANTH 103,A00,258398,Varma; Saiba,15,0,25,10
1683722140119,AWP 10,001,202034,Staff,0,0,0,0
1683722140119,AWP 10,002,202035,Staff,0,0,0,0
1683722140119,AWP 10,003,202036,Staff,0,0,0,0
1683722140119,AWP 10,004,202037,Staff,0,0,0,0
1683722140119,AWP 10,005,202038,Staff,0,0,0,0
1683722140119,AWP 10,006,202039,Staff,0,0,0,0
1683722140119,AWP 10,007,202040,Staff,0,0,0,0
1683722140119,AWP 10,008,202041,Staff,0,0,0,0
1683722140119,AWP 10,009,202042,Staff,0,0,0,0
1683722140119,AWP 10,010,202043,Staff,0,0,0,0
1683722140119,AWP 10,011,202044,Staff,0,0,0,0
1683722140119,AWP 10,012,202045,Staff,0,0,0,0
1683722140119,AWP 10,013,202046,Staff,0,0,0,0
1683722140119,AWP 10,014,202047,Staff,0,0,0,0
1683722140119,AWP 10,015,202048,Staff,0,0,0,0
1683722140119,AWP 10,016,202049,Staff,0,0,0,0
1683722140119,AWP 10,017,202050,Staff,0,0,0,0
1683722140119,AWP 10,018,202051,Staff,0,0,0,0
1683722140119,AWP 10,019,202052,Staff,0,0,0,0
1683722140119,AWP 10,020,202053,Staff,0,0,0,0
1683722140119,AWP 10,021,202054,Staff,0,0,0,0
1683722140119,AWP 10,022,202055,Staff,0,0,0,0
1683722140119,AWP 10,023,202056,Staff,0,0,0,0
1683722140119,AWP 10,024,202057,Staff,0,0,0,0
1683722140119,AWP 10,025,202058,Staff,0,0,0,0
1683722140119,AWP 10,026,202059,Staff,0,0,0,0
1683722141144,AWP 102,001,202032,Staff,0,0,0,0
1683722141144,AWP 102,002,202033,Staff,0,0,0,0
1683722142171,BENG 100,A01,254234,Taylor Amos; Alyssa C,31,0,40,9
1683722143197,BENG 196,001,270013,Engler; Adam J.,9999,0,9999,0
1683722144230,BICD 100R,A01,202018,Smith; Laurie,0,7,32,32
1683722144230,BICD 100R,A02,202019,Smith; Laurie,0,3,32,32
1683722144230,BICD 100R,A03,202020,Smith; Laurie,0,1,32,32
1683722144230,BICD 100R,A04,202021,Smith; Laurie,6,0,32,26
1683722144230,BICD 100R,A05,202022,Smith; Laurie,10,0,32,22
1683722145262,BICD 136,A01,193242,Gustafson-Brown; Cindy,0,2,32,32
1683722145262,BICD 136,A02,193244,Gustafson-Brown; Cindy,13,0,32,19
1683722146289,BIEB 102,A01,193249,Butler; Shannon Rhey,0,0,32,32
1683722146289,BIEB 102,A02,193251,Butler; Shannon Rhey,0,0,32,32
1683722146289,BIEB 102,A03,193253,Butler; Shannon Rhey,0,0,32,32
1683722146289,BIEB 102,A04,193255,Butler; Shannon Rhey,13,0,32,19
1683722146289,BIEB 102,A05,193265,Butler; Shannon Rhey,25,0,32,7
1683722146289,BIEB 102,A06,193269,Butler; Shannon Rhey,12,0,32,20
1683722148343,BIEB 150,A01,193274,Staff,0,0,32,32
1683722148343,BIEB 150,A02,193285,Staff,24,0,32,8
1683722149369,BIEB 194,A00,193286,Kurle; Carolyn M.,19,0,32,13
1683722150397,BILD 1,A01,192291,Staff,15,0,32,17
1683722150397,BILD 1,A02,192292,Staff,30,0,32,2
1683722150397,BILD 1,B01,192520,Reuther; Keefe,0,1,0,0
1683722150397,BILD 1,B02,192532,Reuther; Keefe,0,1,0,0
1683722151421,BILD 3,A01,192556,Butler; Shannon Rhey,0,0,32,32
1683722151421,BILD 3,A02,192581,Butler; Shannon Rhey,0,1,32,32
1683722151421,BILD 3,A03,192611,Butler; Shannon Rhey,19,0,32,13
1683722151421,BILD 3,A04,192612,Butler; Shannon Rhey,23,0,32,9
1683722151421,BILD 3,A05,192613,Butler; Shannon Rhey,26,0,32,6
1683722151421,BILD 3,A06,192679,Butler; Shannon Rhey,27,0,32,5
1683722151421,BILD 3,A07,192682,Butler; Shannon Rhey,20,0,32,12
1683722152448,BILD 4,A01,192836,Reuther; Keefe,1,0,24,23
1683722152448,BILD 4,A02,193044,Reuther; Keefe,4,0,24,20
1683722153473,BILD 10,A01,193142,Gustafson-Brown; Cindy,29,0,32,3
1683722153473,BILD 10,A02,193149,Gustafson-Brown; Cindy,31,0,32,1
1683722154498,BIMM 100,A01,193301,Staff,0,6,32,32
1683722154498,BIMM 100,A02,193312,Staff,0,7,32,32
1683722154498,BIMM 100,A03,193323,Staff,0,10,32,32
1683722155530,BIMM 101,A01,193329,McDonnell; Lisa Marie,0,3,24,24
1683722155530,BIMM 101,A02,193339,McDonnell; Lisa Marie,0,3,24,24
1683722155530,BIMM 101,B01,193354,McDonnell; Lisa Marie,0,4,24,24
1683722155530,BIMM 101,B02,193357,McDonnell; Lisa Marie,0,3,24,24
1683722156558,BIMM 110,A01,193377,Tat; John,0,11,32,32
1683722156558,BIMM 110,A02,193378,Tat; John,0,11,32,32
1683722157584,BIMM 120,A01,206116,Staff,0,0,32,32
1683722157584,BIMM 120,A02,206117,Staff,7,0,32,25
1683722157584,BIMM 120,A03,206121,Staff,21,0,32,11
1683722158615,BIPN 100,A01,193393,Park; Ji Young,0,15,32,32
1683722158615,BIPN 100,A02,193402,Park; Ji Young,0,14,32,32
1683722158615,BIPN 100,A03,193413,Park; Ji Young,0,14,32,32
1683722158615,BIPN 100,A04,193414,Park; Ji Young,0,13,32,32
1683722159641,BIPN 102,A01,193429,Staff,0,0,32,32
1683722159641,BIPN 102,A02,193438,Staff,18,0,32,14
1683722160667,BIPN 106,A01,193450,Reyes Gonzalez; Catalina,0,2,40,40
1683722161698,BIPN 134,A01,193465,Cooke; James Edward,0,0,32,32
1683722161698,BIPN 134,A02,193474,Cooke; James Edward,25,0,32,7
1683722161698,BIPN 134,A03,193485,Cooke; James Edward,29,0,32,3
1683722161698,BIPN 134,A04,193486,Cooke; James Edward,20,0,32,12
1683722161698,BIPN 134,A05,193491,Cooke; James Edward,31,0,32,1
1683722161698,BIPN 134,A06,193501,Cooke; James Edward,30,0,32,2
1683722161698,BIPN 134,A07,193510,Cooke; James Edward,29,0,32,3
1683722163750,BISP 194,A00,222522,Staff,14,0,32,18
1683722164779,CAT 124,A01,202407,Staff,19,0,25,6
1683722165806,CAT 125,A00,202408,Marchisotto; Jennifer Anne,2,0,20,18
1683722166832,CAT 125R,A00,202409,Smith; Lauryn Alissa,0,11,20,20
1683722166832,CAT 125R,B00,202410,Morales; Celeste Georgianna,0,11,20,20
1683722166832,CAT 125R,C00,202411,Irwin; Matthew Joseph,0,12,20,20
1683722167864,CENG 15,A01,204712,Yang; Kesong,0,1,0,0
1683722168890,CENG 114,A00,202070,Jahed Motlagh; Zeinab,5,0,20,15
1683722169921,CGS 105,A00,185477,Wesling; Megan E.,24,0,40,16
1683722170950,CGS 106,A00,185494,Staff,11,0,22,11
1683722171976,CGS 108,A00,185495,Staff,14,0,20,6
1683722173003,CGS 114,A00,185496,Staff,13,0,18,5
1683722174028,CGS 119,A00,185501,Staff,15,0,20,5
1683722175058,CGS 120,A00,185511,Staff,11,0,20,9
1683722176084,CHEM 4,A01,184675,Bussey; Thomas J,97,0,100,3
1683722177112,CHEM 6A,A01,184677,Staff,32,0,60,28
1683722178142,CHEM 6B,A01,184679,Staff,63,0,100,37
1683722179172,CHEM 6C,A01,184681,Bussey; Thomas J,0,0,50,50
1683722179172,CHEM 6C,A02,184682,Bussey; Thomas J,32,0,50,18
1683722180197,CHEM 40A,A01,184684,Albizati; Kim F.,33,0,100,67
1683722181223,CHEM 40B,A01,184686,Albizati; Kim F.,0,22,100,100
1683722182249,CHEM 41B,A01,184690,Staff,51,0,100,49
1683722183280,COGS 3,A01,184715,Boyle; Mary E. T.,0,27,40,40
1683722184311,COGS 14B,A01,185172,Staff,0,14,38,38
1683722185337,COGS 18,A01,184736,Staff,14,0,80,66
1683722186362,COGS 100,A01,184932,Staff,0,8,73,73
1683722187390,COGS 101A,A01,184935,Staff,0,40,30,30
1683722188417,COGS 101B,A01,184944,Staff,0,2,30,30
1683722189447,COGS 101C,A01,184946,Staff,0,10,30,30
1683722190473,COGS 102A,A01,184951,Johnson; Christine M.,1,0,40,39
1683722191498,COGS 107B,A01,184953,Mooshagian; Eric Frederick,0,52,40,40
1683722192528,COGS 118B,A01,184959,Gupta; Anjum,0,50,40,40
1683722193556,COGS 153,A00,184961,Staff,1,16,30,29
1683722194585,COGS 177,A00,184962,Staff,0,20,30,30
1683722195611,COGS 187A,A01,184969,Boyle; Mary E. T.,0,19,40,40
1683722196641,COMM 10,A01,185174,Staff,0,5,25,25
1683722196641,COMM 10,A02,185189,Staff,0,2,25,25
1683722196641,COMM 10,A03,269821,Staff,0,1,0,0
1683722197668,COMM 100B,A02,185476,Staff,10,0,25,15
1683722197668,COMM 100B,A03,277340,Staff,25,0,25,0
1683722198693,COMM 100C,A01,185314,Staff,2,0,25,23
1683722198693,COMM 100C,A02,185327,Staff,17,0,25,8
1683722199725,COMM 110M,A00,185349,Staff,0,0,40,40
1683722200750,COMM 113T,A00,185352,Staff,25,0,40,15
1683722201775,COMM 114I,A00,185353,Staff,31,0,40,9
1683722202803,COMM 131,A00,185354,Staff,17,0,30,13
1683722203835,CSE 8A,A50,185358,Cao; Yingjun,0,46,10,10
1683722204863,CSE 8B,A01,185362,Staff,0,48,50,50
1683722205887,CSE 11,A01,185416,Cao; Yingjun,0,91,10,10
1683722206915,CSE 20,A01,185445,Briones; Jor-el Thomas Caparas,3,0,25,22
1683722207940,CSE 21,A01,185447,Staff,9,0,50,41
1683722208967,CSE 101,A01,185451,Staff,0,13,50,50
1683722208967,CSE 101,B01,185453,Jones; Miles E,0,15,50,50
1683722211028,CSE 141,A01,185458,Eldon; John,16,0,100,84
1683722212057,CSE 141L,A01,185461,Eldon; John,8,0,100,92
1683722213084,CSE 142,A01,185463,Staff,34,0,60,26
1683722213084,CSE 142,B01,201355,Staff,0,7,60,60
1683722214109,CSE 142L,A01,185470,Staff,34,0,60,26
1683722214109,CSE 142L,B01,201417,Staff,0,6,60,60
1683722215135,CSE 190,A00,201433,Staff,32,0,49,17
1683722216161,DOC 1,A01,259136,Strom; Megan C.,7,0,15,8
1683722216161,DOC 1,A02,259137,Strom; Megan C.,15,0,15,0
1683722216161,DOC 1,A03,259138,Strom; Megan C.,14,0,15,1
1683722216161,DOC 1,A04,259139,Strom; Megan C.,13,0,15,2
1683722217188,DOC 100D,A00,259140,Pass; Natalye Joann,14,0,25,11
1683722218218,DSGN 1,A01,184749,Rill; Bryan,0,26,30,30
1683722219247,DSGN 100,A01,185168,Staff,0,2,25,25
1683722220280,ECE 5,A01,185626,Morris; Karcher William,0,12,0,0
1683722221306,ECE 101,A01,185628,Staff,14,0,70,56
1683722222337,ECE 107,A01,185635,Baghdadchi; Saharnaz,0,0,20,20
1683722222337,ECE 107,A02,185638,Baghdadchi; Saharnaz,1,0,20,19
1683722223363,ECE 148,A01,185647,Silberman; Jack,0,0,16,16
1683722224392,ECON 1,A01,185537,Crane; Meredith Helen,54,0,70,16
1683722225418,ECON 3,A01,185549,Crane; Meredith Helen,30,0,70,40
1683722226448,ECON 4,A01,203354,Anderson; John Charles,0,5,10,10
1683722227476,ECON 100A,A01,185574,Staff,0,5,40,40
1683722228501,ECON 100B,A01,185576,Staff,0,12,50,50
1683722229531,ECON 100C,A01,185589,Newhouse; Herbert S,30,0,70,40
1683722230557,ECON 105,A00,185608,Vespa; Emanuel Ignacio,19,0,35,16
1683722231643,ECON 109,A01,185610,Shishkin; Denis,9,0,35,26
1683722232669,ECON 110A,A01,185612,Staff,8,0,40,32
1683722233699,ECON 120A,A01,185615,Staff,19,0,40,21
1683722234731,ECON 120C,A01,185617,Sun; Yixiao,0,21,70,70
1683722235763,ECON 144,A00,203346,Squires; Dale E,2,0,35,33
1683722236788,ECON 171,A01,203349,Newhouse; Herbert S,0,1,35,35
1683722237811,ECON 173A,A01,185621,Toda; Alexis Akira,21,0,35,14
1683722238847,EDS 25,A01,202413,Staff,0,1,0,0
1683722238847,EDS 25,A02,202414,Staff,0,1,0,0
1683722238847,EDS 25,A03,202415,Staff,0,0,0,0
1683722238847,EDS 25,A04,202416,Staff,0,1,0,0
1683722238847,EDS 25,A05,202439,Staff,0,0,0,0
1683722238847,EDS 25,A06,202440,Staff,0,0,0,0
1683722238847,EDS 25,B01,202631,Staff,0,0,0,0
1683722238847,EDS 25,B02,202632,Staff,0,0,0,0
1683722238847,EDS 25,B03,202639,Staff,0,0,0,0
1683722238847,EDS 25,B04,202640,Staff,0,0,0,0
1683722238847,EDS 25,B05,202643,Staff,0,0,0,0
1683722238847,EDS 25,B06,202644,Staff,0,0,0,0
1683722239874,EDS 38,A01,202659,Black; Alison Michelle,25,0,25,0
1683722240900,EDS 115,A00,202652,Staff,18,0,30,12
1683722241928,EDS 125,A00,202649,Staff,13,0,30,17
1683722242959,EDS 126,A01,203332,Staff,30,0,30,0
1683722243986,EDS 139,A00,202838,Staff,16,0,25,9
1683722245015,EDS 146,A01,202655,Staff,14,0,25,11
1683722246042,ENG 15,A00,185667,Staff,0,1,0,0
1683722246042,ENG 15,B00,185672,Staff,0,0,0,0
1683722246042,ENG 15,C00,185675,Staff,0,0,0,0
1683722246042,ENG 15,D00,185682,Staff,0,0,0,0
1683722246042,ENG 15,E00,185684,Staff,0,0,0,0
1683722247069,ETHN 103,A00,185710,Staff,0,8,35,35
1683722248096,ETHN 103A,A00,199228,Man; Simeon S,0,0,9,9
1683722249124,ETHN 109,A00,185711,Staff,15,0,35,20
1683722250154,ETHN 142,A00,185726,Staff,0,4,30,30
1683722251181,ETHN 163J,A00,199229,Man; Simeon S,5,0,8,3
1683722252207,ETHN 168,A00,185727,Staff,7,0,10,3
1683722253236,ETHN 182,A00,185728,Staff,0,0,35,35
1683722254261,ETHN 183,A00,185737,Staff,10,0,18,8
1683722255287,GLBH 111,A01,209361,Burgos; Jose L.,0,0,0,0
1683722257344,HIEU 104,A00,185792,Staff,14,0,20,6
1683722258369,HIEU 115,A00,185800,Staff,0,0,20,20
1683722259398,HIEU 128,A00,185801,Staff,0,9,20,20
1683722260423,HIEU 147,A00,185802,Staff,15,0,20,5
1683722261449,HIEU 154,A00,185823,Staff,11,0,20,9
1683722262475,HILA 102,A00,185826,Staff,14,0,20,6
1683722263501,HILD 2C,A01,185778,Staff,0,13,20,20
1683722264532,HILD 7B,A01,185780,Kwak; Nancy,0,17,32,32
1683722264532,HILD 7B,A02,185781,Kwak; Nancy,0,18,32,32
1683722265558,HILD 30,A01,185791,Staff,12,0,20,8
1683722266584,HISC 119,A00,185830,Golan; Tal,0,10,20,20
1683722267611,HITO 156GS,A00,185831,Patterson; Patrick H.,0,0,0,23
1683722268643,HIUS 103,A00,185832,Man; Simeon S,0,4,20,20
1683722269669,HIUS 117,A00,185836,Kwak; Nancy,2,0,20,18
1683722270695,HIUS 125,A00,185840,Man; Simeon S,0,2,23,23
1683722271722,HIUS 149,A00,185845,Staff,1,0,20,19
1683722272757,HUM 3,A01,185882,Zavodny; Tatiana Sophia,0,8,50,50
1683722272757,HUM 3,B01,185899,Caldwell; Michael Alan,0,18,50,50
1683722273782,HUM 3GS,A00,185900,Patterson; Patrick H.,0,0,0,23
1683722274810,HUM 4,A01,185938,Zroka; Amy Liane,28,0,50,22
1683722274810,HUM 4,B01,185956,Watkins; Eric,0,6,50,50
1683722274810,HUM 4,B02,202209,Watkins; Eric,0,6,50,50
1683722274810,HUM 4,B03,202210,Watkins; Eric,0,5,50,50
1683722275842,HUM 5,A01,185958,West; Geoffrey Scott,0,0,50,50
1683722275842,HUM 5,A02,202215,West; Geoffrey Scott,0,1,50,50
1683722276876,INTL 190,A00,185959,Gagnon; Jeffrey C,0,0,0,9
1683722276876,INTL 190,B00,185960,Lettieri; Michael Joseph,0,0,0,2
1683722277902,JAPN 180,A00,254509,Staff,4,0,30,26
1683722278931,LATI 10,A01,202853,Kennemore; Amy Michelle,4,0,35,31
1683722278931,LATI 10,A02,202854,Kennemore; Amy Michelle,3,0,35,32
1683722278931,LATI 10,A03,270054,Kennemore; Amy Michelle,30,0,30,0
1683722279962,LATI 180,A00,202855,Kennemore; Amy Michelle,11,0,20,9
1683722280990,LAWS 101,A00,201767,Golan; Tal,0,7,40,40
1683722282016,LIFR 1C,A00,185961,Staff,6,0,20,14
1683722283041,LIFR 1CX,A00,185962,Staff,7,0,20,13
1683722284063,LIFR 1D,A00,185963,Staff,7,0,20,13
1683722285094,LIFR 1DX,A00,185964,Staff,7,0,20,13
1683722286119,LIGN 101,A01,186039,Staff,43,0,50,7
1683722287145,LIGN 165,A00,186040,Staff,14,0,50,36
1683722288172,LTCS 108,A00,186041,Staff,5,0,10,5
1683722289200,LTCS 119,A00,186042,Staff,15,0,20,5
1683722290227,LTCS 130,A00,186043,Wesling; Megan E.,15,0,25,10
1683722292278,LTEA 138,A00,186119,Staff,13,0,40,27
1683722293308,LTEN 124,A00,186148,Staff,5,0,25,20
1683722294334,LTEN 178,A00,186149,Staff,6,0,15,9
1683722295365,LTEN 181,A00,186150,Blanco; John D,34,0,40,6
1683722296395,LTWL 120,A00,186160,Staff,19,0,25,6
1683722297421,LTWL 165,A00,186161,Staff,22,0,25,3
1683722298449,LTWR 100,A00,186162,Staff,0,5,15,15
1683722299473,LTWR 102,A00,186163,Doller; Ben,5,0,15,10
1683722300503,MAE 8,A01,186412,Staff,0,1,0,0
1683722301530,MAE 30B,A00,186445,Bahadori; Mohammad Yousef,81,0,100,19
1683722302560,MAE 40,A00,186592,Bewley; Thomas R,10,0,50,40
1683722303586,MAE 101B,A00,186593,Bahadori; Mohammad Yousef,80,0,100,20
1683722304614,MAE 105,A00,186594,Bandaru; Prabhakar,10,0,50,40
1683722305641,MAE 107,A00,186599,Pham; Hieu Tan,0,8,120,120
1683722306672,MAE 148,A01,186660,Silberman; Jack,3,0,16,13
1683722307696,MATH 10A,A01,188095,Staff,0,6,35,35
1683722308723,MATH 10B,A01,188097,Bowers; Adam R.,0,12,30,30
1683722308723,MATH 10B,A02,188099,Bowers; Adam R.,0,11,30,30
1683722308723,MATH 10B,B01,188104,Bowers; Adam R.,0,10,30,30
1683722308723,MATH 10B,B02,188106,Bowers; Adam R.,0,9,30,30
1683722309751,MATH 10C,A01,188111,Staff,0,20,30,30
1683722309751,MATH 10C,A02,188127,Staff,0,19,30,30
1683722309751,MATH 10C,A03,188131,Staff,0,19,30,30
1683722309751,MATH 10C,B01,188218,Staff,17,0,30,13
1683722309751,MATH 10C,B02,188244,Staff,13,0,30,17
1683722309751,MATH 10C,B03,188277,Staff,14,0,30,16
1683722310779,MATH 18,A01,188344,Bach; Quang Tran,18,0,30,12
1683722310779,MATH 18,A02,188345,Bach; Quang Tran,11,0,30,19
1683722310779,MATH 18,B01,188353,Bach; Quang Tran,11,0,30,19
1683722310779,MATH 18,B02,188354,Bach; Quang Tran,19,0,30,11
1683722311809,MATH 20A,A01,188374,Staff,11,0,35,24
1683722312841,MATH 20B,A01,188382,Ohm; Ko Woon,7,0,30,23
1683722312841,MATH 20B,A02,188383,Ohm; Ko Woon,22,0,30,8
1683722312841,MATH 20B,B01,188385,Ohm; Ko Woon,7,0,30,23
1683722312841,MATH 20B,B02,188392,Ohm; Ko Woon,22,0,30,8
1683722313868,MATH 20C,A01,188394,Harel; Guershon,10,0,30,20
1683722313868,MATH 20C,A02,188395,Harel; Guershon,13,0,30,17
1683722313868,MATH 20C,B01,188404,Harel; Guershon,5,0,30,25
1683722313868,MATH 20C,B02,188405,Harel; Guershon,18,0,30,12
1683722314895,MATH 20D,A01,188414,Hammock; Frances H,0,1,30,30
1683722314895,MATH 20D,A02,188415,Hammock; Frances H,0,1,30,30
1683722314895,MATH 20D,B01,188447,Hammock; Frances H,0,1,30,30
1683722314895,MATH 20D,B02,188486,Hammock; Frances H,2,0,30,28
1683722315920,MATH 20E,A01,188649,Staff,21,0,30,9
1683722315920,MATH 20E,A02,188650,Staff,20,0,30,10
1683722315920,MATH 20E,A03,188673,Staff,0,0,30,30
1683722316949,MATH 102,A01,188675,Staff,0,40,35,35
1683722317979,MATH 103B,A01,188681,Staff,3,0,35,32
1683722317979,MATH 103B,B01,188692,Staff,5,0,35,30
1683722319010,MATH 109,A01,188695,Salehi Golsefidy; Alireza,24,0,35,11
1683722319010,MATH 109,A02,188696,Salehi Golsefidy; Alireza,24,0,35,11
1683722320040,MATH 120A,A01,188698,Eggers; John Dietrich,7,0,35,28
1683722321074,MATH 142B,A01,188736,Ioana; Adrian,0,0,30,30
1683722321074,MATH 142B,A02,188741,Ioana; Adrian,0,1,30,30
1683722321074,MATH 142B,A03,188743,Ioana; Adrian,0,3,30,30
1683722322100,MATH 168A,A01,188790,Staff,0,11,35,35
1683722323129,MATH 170A,A01,188803,Nie; Jiawang,0,2,35,35
1683722323129,MATH 170A,A02,188811,Nie; Jiawang,0,1,35,35
1683722323129,MATH 170A,A03,188814,Nie; Jiawang,1,0,35,34
1683722323129,MATH 170A,A04,188815,Nie; Jiawang,5,0,35,30
1683722324156,MATH 193B,A01,188817,Staff,0,0,35,35
1683722324156,MATH 193B,A02,188818,Staff,6,0,35,29
1683722325183,MGT 4,A01,202857,Anderson; John Charles,59,0,80,21
1683722326211,MGT 12,A00,202858,Lindenberger; Wade Douglas,40,0,90,50
1683722327237,MGT 18,A00,202859,Staff,73,0,90,17
1683722328261,MGT 18GS,A00,202860,McKay; Michael J,13,0,28,15
1683722329292,MGT 45,A00,202861,Pecore; Joseph P.,8,0,90,82
1683722330324,MGT 100,A00,202863,Yavorsky; Daniel Ryan,27,0,90,63
1683722331355,MGT 103,A00,202864,Ehrich; Kristine R,0,19,90,90
1683722332381,MGT 112,A00,202865,Ehrich; Kristine R,15,0,90,75
1683722333412,MGT 121A,A00,202868,Staff,70,0,90,20
1683722334443,MGT 131B,A00,202869,Anderson; John Charles,58,0,90,32
1683722335530,MGT 136,A00,202871,Lindenberger; Wade Douglas,83,0,90,7
1683722336561,MGT 164,A00,202873,Staff,0,67,90,91
1683722337591,MGT 164GS,A00,202874,McKay; Mary A,13,0,28,15
1683722338619,MGT 180,A00,202875,Staff,0,51,90,91
1683722339646,MMW 11R,A01,205019,Herbst; Matthew,0,0,30,30
1683722339646,MMW 11R,A02,205026,Herbst; Matthew,29,0,30,1
1683722340674,MMW 15,A01,193512,Chang; Edmond Yi-Teh,0,8,28,28
1683722340674,MMW 15,A02,193513,Chang; Edmond Yi-Teh,0,5,28,28
1683722340674,MMW 15,A03,193514,Chang; Edmond Yi-Teh,0,5,28,28
1683722340674,MMW 15,A04,193515,Chang; Edmond Yi-Teh,0,5,28,28
1683722340674,MMW 15,A05,193516,Chang; Edmond Yi-Teh,0,5,28,28
1683722340674,MMW 15,A06,193517,Chang; Edmond Yi-Teh,0,6,28,28
1683722340674,MMW 15,B01,193519,Chang; Edmond Yi-Teh,0,5,28,28
1683722340674,MMW 15,B02,193520,Chang; Edmond Yi-Teh,0,5,28,28
1683722340674,MMW 15,B03,193521,Chang; Edmond Yi-Teh,0,5,28,28
1683722340674,MMW 15,B04,193522,Chang; Edmond Yi-Teh,0,6,28,28
1683722340674,MMW 15,B05,193523,Chang; Edmond Yi-Teh,0,5,28,28
1683722340674,MMW 15,B06,193524,Chang; Edmond Yi-Teh,0,5,28,28
1683722341699,MMW 122,A01,193526,Rahimi; Babak,0,16,28,28
1683722341699,MMW 122,A02,193527,Rahimi; Babak,0,15,28,28
1683722341699,MMW 122,A03,193528,Rahimi; Babak,0,0,0,0
1683722341699,MMW 122,A04,193529,Rahimi; Babak,0,0,0,0
1683722342733,MUS 1A,A01,186663,Staff,0,18,35,35
1683722343759,MUS 4,A01,186715,Staff,0,12,35,35
1683722344790,MUS 5R,A01,186796,Dubnov; Shlomo,0,17,35,35
1683722345814,MUS 6,A01,186798,Staff,0,4,25,25
1683722346842,MUS 7,A01,186830,Staff,11,0,35,24
1683722347871,MUS 8,A01,186930,Staff,0,27,35,35
1683722348897,MUS 15,A01,186932,Staff,0,15,35,35
1683722348897,MUS 15,B01,186934,Staff,0,16,35,35
1683722349922,MUS 80,A00,186935,Staff,0,0,20,20
1683722349922,MUS 80,B00,186936,Staff,24,0,25,1
1683722350949,NANO 11,A00,204702,Lipomi; Darren John,0,0,0,0
1683722351976,NANO 15,A01,204709,Yang; Kesong,0,1,0,0
1683722353010,NANO 114,A00,202069,Jahed Motlagh; Zeinab,2,0,10,8
1683722354040,PHIL 1,A00,186955,Grush; Rick Scott,31,0,40,9
1683722355074,PHIL 10,A01,186973,Grush; Rick Scott,27,0,35,8
1683722355074,PHIL 10,A02,186974,Grush; Rick Scott,33,0,35,2
1683722356098,PHIL 13,A01,186976,Staff,1,0,35,34
1683722356098,PHIL 13,A02,186977,Staff,16,0,35,19
1683722357124,PHIL 14,A01,186979,Staff,30,0,35,5
1683722357124,PHIL 14,A02,186986,Staff,32,0,35,3
1683722358155,PHIL 28,A01,186988,Staff,16,0,30,14
1683722358155,PHIL 28,A02,186989,Staff,0,0,30,30
1683722358155,PHIL 28,A03,186990,Staff,10,0,30,20
1683722358155,PHIL 28,A04,186991,Staff,26,0,30,4
1683722359183,PHIL 120,A00,186997,Staff,23,0,40,17
1683722360208,PHIL 137,A00,187003,Staff,8,0,40,32
1683722361233,PHIL 150,A00,187015,Staff,47,0,70,23
1683722362263,PHIL 167,A00,187021,Lamey; Andy M.,34,0,40,6
1683722363293,PHIL 174,A01,202226,Staff,17,0,20,3
1683722363293,PHIL 174,A02,202235,Staff,20,0,20,0
1683722364319,PHIL 191A,A00,258918,Staff,0,0,1,1
1683722365346,PHYS 1A,A00,187028,Staff,26,0,60,34
1683722366377,PHYS 1AL,001,187036,Staff,3,0,30,27
1683722366377,PHYS 1AL,002,187049,Staff,18,0,30,12
1683722367406,PHYS 1B,A00,187058,Staff,21,0,60,39
1683722368432,PHYS 1BL,001,187064,Staff,0,1,30,30
1683722368432,PHYS 1BL,002,187070,Staff,4,0,30,26
1683722369459,PHYS 1C,A00,187082,Staff,30,0,120,90
1683722370491,PHYS 1CL,001,187088,Staff,0,9,30,30
1683722370491,PHYS 1CL,002,187089,Staff,0,1,30,30
1683722370491,PHYS 1CL,009,262693,Staff,9,0,30,21
1683722371519,PHYS 2B,A01,187097,Staff,55,0,115,60
1683722372551,PHYS 2C,A01,187099,Staff,63,0,115,52
1683722373585,PHYS 2CL,A01,187101,Staff,5,0,28,23
1683722373585,PHYS 2CL,A02,187102,Staff,15,0,28,13
1683722374616,PHYS 2D,A01,187123,Shotwell; Brian,95,0,115,20
1683722375643,PHYS 4B,A01,187133,Grinstein; Benjamin,35,0,50,15
1683722376669,POLI 10,A00,188819,Staff,0,4,50,50
1683722377695,POLI 11,A00,188827,Staff,43,0,50,7
1683722378721,POLI 13R,A00,188828,Staff,0,2,20,20
1683722379750,POLI 27,A01,188830,Elgin; Samuel Zincke,0,2,70,70
1683722380781,POLI 30,A00,188832,Desposato; Scott,30,0,50,20
1683722381808,POLI 102F,A00,188834,Staff,1,0,40,39
1683722382834,POLI 104A,A00,188852,Staff,12,0,30,18
1683722383863,POLI 104I,A00,188853,Staff,0,8,20,20
1683722384892,POLI 110B,A00,188854,Wiens; David,6,0,20,14
1683722385918,POLI 112A,A00,188855,Wiens; David,3,0,30,27
1683722386942,POLI 117R,A00,188856,Forman; Fonna,0,12,20,20
1683722387969,POLI 118,A00,188857,Ingham; Sean,8,0,20,12
1683722388994,POLI 120G,A00,188858,Staff,7,0,30,23
1683722390020,POLI 131CR,A00,188863,Hoston; Germaine,20,0,50,30
1683722391045,POLI 133,A00,188864,Nellis; Gareth Hb,44,0,50,6
1683722392072,POLI 134D,A00,188865,Desposato; Scott,27,0,30,3
1683722393105,POLI 142A,A00,188871,Gartzke; Erik,21,0,50,29
1683722394130,POLI 142K,A00,188874,Staff,38,0,50,12
1683722395156,POLI 143,A00,188940,Gartzke; Erik,15,0,30,15
1683722396182,POLI 153,A00,188943,Staff,1,0,20,19
1683722397211,POLI 160AA,A00,188944,Staff,10,0,40,30
1683722398239,POLI 170A,A00,188945,Staff,10,0,30,20
1683722400292,PSYC 1,A00,188952,Staff,36,0,90,54
1683722401324,PSYC 2,B00,188953,Staff,19,0,35,16
1683722402358,PSYC 6,A00,188970,Staff,47,0,60,13
1683722403388,PSYC 7,A00,188973,Staff,35,0,45,10
1683722404415,PSYC 60,A01,188980,Rickard; Timothy C.,42,0,60,18
1683722405449,PSYC 70,A01,189001,Steiner; Eric Tomas,22,0,45,23
1683722406481,PSYC 100,A00,189005,Lacefield; Katharine I,1,98,120,119
1683722407508,PSYC 102,A00,189008,Staff,6,0,30,24
1683722408538,PSYC 106,B00,189026,Gorman; Michael R.,27,0,60,33
1683722409564,PSYC 114,B01,189033,Winkielman; Piotr,0,31,30,30
1683722410595,PSYC 131,A00,189036,Anagnostaras; Stephan,0,44,60,60
1683722411621,PSYC 136,A00,189041,Lowe; Angela Beth,0,7,25,25
1683722412646,PSYC 137,A00,189057,Winkielman; Piotr,0,36,25,25
1683722413670,PSYC 144,A00,189107,Wixted; John T,0,11,50,50
1683722415720,PSYC 162,A00,189142,Staff,0,9,85,85
1683722416746,PSYC 172,A00,189144,Gorman; Michael R.,0,6,30,30
1683722418803,PSYC 179,A00,189146,Lacefield; Katharine I,0,88,120,120
1683722419829,PSYC 181,A00,189147,Anagnostaras; Stephan,0,45,90,90
1683722420854,PSYC 190R,A00,189148,Barner; David A.,0,23,80,80
1683722421884,PSYC 191,A00,189275,Rickard; Timothy C.,0,11,25,25
1683722422911,PSYC 193,A00,189276,Chapman; Eddie Nathaniel,0,1,0,4
1683722423942,PSYC 193L,A01,189281,Lowe; Angela Beth,8,0,20,12
1683722423942,PSYC 193L,B01,189285,Staff,28,0,35,7
1683722424968,RELI 149,A00,187137,Rahimi; Babak,6,0,40,34
1683722425993,SE 9,A01,187315,Staff,0,2,18,18
1683722427020,SE 101B,A00,187409,Staff,24,0,30,6
1683722428046,SE 110B,A00,187444,Staff,10,0,40,30
1683722429072,SE 130B,A00,187449,Staff,31,0,40,9
1683722430099,SE 150A,A00,187516,Staff,8,0,20,12
1683722431127,SE 154,A00,187528,Staff,29,0,50,21
1683722432153,SIO 3,A01,258171,Staff,35,0,40,5
1683722433179,SIO 10,A00,187144,Cook; Geoffrey W,0,6,75,75
1683722434205,SIO 45,A00,187152,Cook; Geoffrey W,1,7,100,99
1683722435236,SIO 109R,A00,194486,Staff,0,4,20,20
1683722437292,SIO 187,A01,187233,Kacev; David,12,0,40,28
1683722438329,SOCI 1,A01,258656,Thorpe; Charles Robert,28,0,30,2
1683722438329,SOCI 1,A02,258658,Thorpe; Charles Robert,30,0,30,0
1683722438329,SOCI 1,A03,258661,Thorpe; Charles Robert,25,0,25,0
1683722438329,SOCI 1,A04,258666,Thorpe; Charles Robert,22,0,25,3
1683722438329,SOCI 1,A05,258897,Thorpe; Charles Robert,22,0,25,3
1683722438329,SOCI 1,A06,258898,Thorpe; Charles Robert,25,0,25,0
1683722439433,SOCI 30,A01,258903,Pardo Guerra; Juan Pablo,14,0,30,16
1683722440459,SOCI 102,A00,258904,Staff,9,0,25,16
1683722441484,SOCI 106,A00,258905,Staff,19,0,25,6
1683722442513,SOCI 111,A00,258907,Ribas Norris; Janet Vanesa,26,0,30,4
1683722443543,SOCI 121R,A00,258908,Pardo Guerra; Juan Pablo,7,0,30,23
1683722444570,SOCI 126,A01,203330,Staff,14,0,20,6
1683722445598,SOCI 131,A00,258909,Thorpe; Charles Robert,30,0,60,30
1683722446628,SOCI 135,A00,258910,Payne; Christine Anna,0,13,30,30
1683722447654,SOCI 157,A00,258911,Staff,10,0,30,20
1683722448682,SOCI 184,A00,258912,Staff,25,0,30,5
1683722449713,SOCI 188D,A00,258913,Staff,22,0,30,8
1683722450744,SYN 2,001,187529,Staff,9,0,16,7
1683722450744,SYN 2,002,201452,Staff,0,20,16,16
1683722450744,SYN 2,003,201469,Staff,1,0,16,15
1683722451768,SYN 100,A01,187531,Staff,0,9,20,20
1683722451768,SYN 100,B01,201491,Staff,0,10,20,20
1683722452800,TDAC 1,A00,189286,Walsh; Kim C.,3,0,20,17
1683722452800,TDAC 1,B00,189287,Harting; Carla Kelso,10,0,20,10
1683722453827,TDAC 101,A00,189300,Walsh; Kim C.,16,0,20,4
1683722453827,TDAC 101,B00,189301,Harting; Carla Kelso,18,0,20,2
1683722454853,TDAC 102,A00,189304,Basso; Beatrice,14,0,20,6
1683722455882,TDAC 108,A00,189305,Staff,18,0,20,2
1683722456919,TDDE 131,A00,189310,Staff,19,0,20,1
1683722456919,TDDE 131,B00,189314,Staff,19,0,20,1
1683722456919,TDDE 131,C00,189315,Staff,48,0,50,2
1683722456919,TDDE 131,D00,189316,Staff,14,0,15,1
1683722456919,TDDE 131,E00,204841,Staff,20,0,20,0
1683722457948,TDGE 10,A00,189289,Staff,26,0,50,24
1683722457948,TDGE 10,B00,189290,Havis; Allan,0,1,50,50
1683722458977,TDGE 11,A00,189291,Fulton; Julia,0,4,50,50
1683722458977,TDGE 11,B00,189292,Staff,20,0,25,5
1683722458977,TDGE 11,C00,260270,Staff,0,0,0,0
1683722460002,TDGE 25,A00,189294,Staff,1,0,20,19
1683722461030,TDGE 124,A00,189318,Fulton; Julia,0,7,50,50
1683722462056,TDGE 125,A00,189319,Staff,13,0,25,12
1683722462056,TDGE 125,B00,189320,Staff,23,0,25,2
1683722463083,TDGE 127,A00,189322,Havis; Allan,1,0,50,49
1683722464115,TDHT 101,A00,189323,Staff,18,0,25,7
1683722464115,TDHT 101,B00,189324,Staff,25,0,25,0
1683722465146,TDHT 102,A00,189325,Staff,49,0,50,1
1683722466178,TDMV 1,A00,189295,Arcidiacono; Kristin,20,0,30,10
1683722466178,TDMV 1,B00,189296,Caligagan; Maria T.,23,0,30,7
1683722467205,TDMV 2,A00,189297,Sammartano; Tonnie,27,0,30,3
1683722467205,TDMV 2,B00,189299,Arcidiacono; Kristin,23,0,30,7
1683722468232,TDMV 3,A00,204998,Rincon; Alicia,22,0,30,8
1683722469259,TDMV 120,A00,189458,Sammartano; Tonnie,28,0,30,2
1683722470284,TDMV 138,A00,189541,Jun; Grace Shin Hae,20,0,40,20
1683722471311,TDMV 142,A00,189717,Caligagan; Tony,25,0,30,5
1683722471311,TDMV 142,B00,189718,Caligagan; Maria T.,25,0,30,5
1683722472337,TMC 2,A01,187533,Staff,25,0,25,0
1683722472337,TMC 2,A02,187534,Staff,25,0,25,0
1683722473368,USP 1,A01,187536,Kwak; Nancy,0,16,25,25
1683722474398,USP 5,A01,187538,Staff,8,0,25,17
1683722475423,USP 101,A00,199253,Staff,0,4,0,0
1683722476448,USP 124,A00,187562,Boomhower; Matthew Charles,0,0,30,30
1683722477474,USP 138,A00,187582,Staff,19,0,25,6
1683722478500,USP 152,A01,187597,Staff,3,0,25,22
1683722479526,USP 153,A00,187598,Staff,18,0,25,7
1683722480553,USP 168,A00,187607,Kwak; Nancy,2,0,5,3
1683722481581,USP 173,A00,187619,Staff,4,0,25,21
1683722482607,USP 181,A00,187638,Staff,0,4,25,25
1683722483634,VIS 103,A00,187650,Cruz; Edwin Teddy,17,0,75,58
1683722484659,VIS 110D,A00,187669,Staff,13,0,22,9
1683722485690,VIS 127C,A00,187720,Shen; Kuiyi,67,0,146,79
1683722486716,VIS 149,A00,187731,Yoldas; Pinar,0,12,22,22
1683722487742,VIS 151,A01,188091,Staff,22,0,34,12
1683722487742,VIS 151,A02,188092,Staff,11,0,34,23
1683722488772,VIS 160B,A00,188093,Stalbaum; Brett,0,1,10,10
1683722490829,WCWP 10B,A00,201720,Staff,0,0,5,5
1683722490829,WCWP 10B,B00,201722,Staff,0,0,6,6
1683722491855,WCWP 100,A00,201725,Gagnon; Jeffrey C,0,0,2,2
1683722491855,WCWP 100,B00,201727,Staff,0,4,15,15
1683722494981,ANBI 133,A00,258401,Wilder; Linnea Lorene,34,0,40,6
1683722496008,ANBI 140,A00,258395,Hrvoj Mihic; Branka,18,0,25,7
1683722497039,ANSC 120,A00,258402,Bialecki; Jon Anthony,26,0,40,14
1683722498067,ANSC 144,A00,258400,Staff,12,0,40,28
1683722500118,ANSC 166,A00,258396,Parish; Steven Martin,156,0,175,19
1683722501143,ANSC 180,A00,193533,Staff,8,0,20,12
1683722502176,ANSC 188,A00,258397,Jassal; Aftab,34,0,40,6
1683722503201,ANTH 3,A01,258316,Staff,23,0,30,7
1683722504228,ANTH 5,A00,258394,Semendeferi; Ekaterini,16,0,20,4
1683722505258,ANTH 21,A01,258331,Staff,4,0,40,36
1683722506287,ANTH 103,A00,258398,Varma; Saiba,15,0,25,10
1683722507319,AWP 10,001,202034,Staff,0,0,0,0
1683722507319,AWP 10,002,202035,Staff,0,0,0,0
1683722507319,AWP 10,003,202036,Staff,0,0,0,0
1683722507319,AWP 10,004,202037,Staff,0,0,0,0
1683722507319,AWP 10,005,202038,Staff,0,0,0,0
1683722507319,AWP 10,006,202039,Staff,0,0,0,0
1683722507319,AWP 10,007,202040,Staff,0,0,0,0
1683722507319,AWP 10,008,202041,Staff,0,0,0,0
1683722507319,AWP 10,009,202042,Staff,0,0,0,0
1683722507319,AWP 10,010,202043,Staff,0,0,0,0
1683722507319,AWP 10,011,202044,Staff,0,0,0,0
1683722507319,AWP 10,012,202045,Staff,0,0,0,0
1683722507319,AWP 10,013,202046,Staff,0,0,0,0
1683722507319,AWP 10,014,202047,Staff,0,0,0,0
1683722507319,AWP 10,015,202048,Staff,0,0,0,0
1683722507319,AWP 10,016,202049,Staff,0,0,0,0
1683722507319,AWP 10,017,202050,Staff,0,0,0,0
1683722507319,AWP 10,018,202051,Staff,0,0,0,0
1683722507319,AWP 10,019,202052,Staff,0,0,0,0
1683722507319,AWP 10,020,202053,Staff,0,0,0,0
1683722507319,AWP 10,021,202054,Staff,0,0,0,0
1683722507319,AWP 10,022,202055,Staff,0,0,0,0
1683722507319,AWP 10,023,202056,Staff,0,0,0,0
1683722507319,AWP 10,024,202057,Staff,0,0,0,0
1683722507319,AWP 10,025,202058,Staff,0,0,0,0
1683722507319,AWP 10,026,202059,Staff,0,0,0,0
1683722508347,AWP 102,001,202032,Staff,0,0,0,0
1683722508347,AWP 102,002,202033,Staff,0,0,0,0
1683722509371,BENG 100,A01,254234,Taylor Amos; Alyssa C,31,0,40,9
1683722510397,BENG 196,001,270013,Engler; Adam J.,9999,0,9999,0
1683722511426,BICD 100R,A01,202018,Smith; Laurie,0,7,32,32
1683722511426,BICD 100R,A02,202019,Smith; Laurie,0,3,32,32
1683722511426,BICD 100R,A03,202020,Smith; Laurie,0,1,32,32
1683722511426,BICD 100R,A04,202021,Smith; Laurie,6,0,32,26
1683722511426,BICD 100R,A05,202022,Smith; Laurie,10,0,32,22
1683722512459,BICD 136,A01,193242,Gustafson-Brown; Cindy,0,2,32,32
1683722512459,BICD 136,A02,193244,Gustafson-Brown; Cindy,13,0,32,19
1683722513494,BIEB 102,A01,193249,Butler; Shannon Rhey,0,0,32,32
1683722513494,BIEB 102,A02,193251,Butler; Shannon Rhey,0,0,32,32
1683722513494,BIEB 102,A03,193253,Butler; Shannon Rhey,0,0,32,32
1683722513494,BIEB 102,A04,193255,Butler; Shannon Rhey,13,0,32,19
1683722513494,BIEB 102,A05,193265,Butler; Shannon Rhey,25,0,32,7
1683722513494,BIEB 102,A06,193269,Butler; Shannon Rhey,12,0,32,20
1683722515549,BIEB 150,A01,193274,Staff,0,0,32,32
1683722515549,BIEB 150,A02,193285,Staff,24,0,32,8
1683722516575,BIEB 194,A00,193286,Kurle; Carolyn M.,19,0,32,13
1683722517604,BILD 1,A01,192291,Staff,15,0,32,17
1683722517604,BILD 1,A02,192292,Staff,30,0,32,2
1683722517604,BILD 1,B01,192520,Reuther; Keefe,0,1,0,0
1683722517604,BILD 1,B02,192532,Reuther; Keefe,0,1,0,0
1683722518635,BILD 3,A01,192556,Butler; Shannon Rhey,0,0,32,32
1683722518635,BILD 3,A02,192581,Butler; Shannon Rhey,0,1,32,32
1683722518635,BILD 3,A03,192611,Butler; Shannon Rhey,19,0,32,13
1683722518635,BILD 3,A04,192612,Butler; Shannon Rhey,23,0,32,9
1683722518635,BILD 3,A05,192613,Butler; Shannon Rhey,26,0,32,6
1683722518635,BILD 3,A06,192679,Butler; Shannon Rhey,27,0,32,5
1683722518635,BILD 3,A07,192682,Butler; Shannon Rhey,20,0,32,12
1683722519667,BILD 4,A01,192836,Reuther; Keefe,1,0,24,23
1683722519667,BILD 4,A02,193044,Reuther; Keefe,4,0,24,20
1683722520693,BILD 10,A01,193142,Gustafson-Brown; Cindy,29,0,32,3
1683722520693,BILD 10,A02,193149,Gustafson-Brown; Cindy,31,0,32,1
1683722521727,BIMM 100,A01,193301,Staff,0,6,32,32
1683722521727,BIMM 100,A02,193312,Staff,0,7,32,32
1683722521727,BIMM 100,A03,193323,Staff,0,10,32,32
1683722522762,BIMM 101,A01,193329,McDonnell; Lisa Marie,0,3,24,24
1683722522762,BIMM 101,A02,193339,McDonnell; Lisa Marie,0,3,24,24
1683722522762,BIMM 101,B01,193354,McDonnell; Lisa Marie,0,4,24,24
1683722522762,BIMM 101,B02,193357,McDonnell; Lisa Marie,0,3,24,24
1683722523789,BIMM 110,A01,193377,Tat; John,0,11,32,32
1683722523789,BIMM 110,A02,193378,Tat; John,0,11,32,32
1683722524824,BIMM 120,A01,206116,Staff,0,0,32,32
1683722524824,BIMM 120,A02,206117,Staff,7,0,32,25
1683722524824,BIMM 120,A03,206121,Staff,21,0,32,11
1683722525854,BIPN 100,A01,193393,Park; Ji Young,0,15,32,32
1683722525854,BIPN 100,A02,193402,Park; Ji Young,0,14,32,32
1683722525854,BIPN 100,A03,193413,Park; Ji Young,0,14,32,32
1683722525854,BIPN 100,A04,193414,Park; Ji Young,0,13,32,32
1683722526881,BIPN 102,A01,193429,Staff,0,0,32,32
1683722526881,BIPN 102,A02,193438,Staff,18,0,32,14
1683722527913,BIPN 106,A01,193450,Reyes Gonzalez; Catalina,0,2,40,40
1683722528944,BIPN 134,A01,193465,Cooke; James Edward,0,0,32,32
1683722528944,BIPN 134,A02,193474,Cooke; James Edward,25,0,32,7
1683722528944,BIPN 134,A03,193485,Cooke; James Edward,29,0,32,3
1683722528944,BIPN 134,A04,193486,Cooke; James Edward,20,0,32,12
1683722528944,BIPN 134,A05,193491,Cooke; James Edward,31,0,32,1
1683722528944,BIPN 134,A06,193501,Cooke; James Edward,30,0,32,2
1683722528944,BIPN 134,A07,193510,Cooke; James Edward,29,0,32,3
1683722531000,BISP 194,A00,222522,Staff,14,0,32,18
1683722532025,CAT 124,A01,202407,Staff,19,0,25,6
1683722533052,CAT 125,A00,202408,Marchisotto; Jennifer Anne,2,0,20,18
1683722534080,CAT 125R,A00,202409,Smith; Lauryn Alissa,0,11,20,20
1683722534080,CAT 125R,B00,202410,Morales; Celeste Georgianna,0,11,20,20
1683722534080,CAT 125R,C00,202411,Irwin; Matthew Joseph,0,12,20,20
1683722535107,CENG 15,A01,204712,Yang; Kesong,0,1,0,0
1683722536134,CENG 114,A00,202070,Jahed Motlagh; Zeinab,5,0,20,15
1683722537160,CGS 105,A00,185477,Wesling; Megan E.,24,0,40,16
1683722538256,CGS 106,A00,185494,Staff,11,0,22,11
1683722539283,CGS 108,A00,185495,Staff,14,0,20,6
1683722540308,CGS 114,A00,185496,Staff,13,0,18,5
1683722541333,CGS 119,A00,185501,Staff,15,0,20,5
1683722542358,CGS 120,A00,185511,Staff,11,0,20,9
1683722543442,CHEM 4,A01,184675,Bussey; Thomas J,97,0,100,3
1683722544468,CHEM 6A,A01,184677,Staff,32,0,60,28
1683722545499,CHEM 6B,A01,184679,Staff,63,0,100,37
1683722546530,CHEM 6C,A01,184681,Bussey; Thomas J,0,0,50,50
1683722546530,CHEM 6C,A02,184682,Bussey; Thomas J,32,0,50,18
1683722547557,CHEM 40A,A01,184684,Albizati; Kim F.,33,0,100,67
1683722548583,CHEM 40B,A01,184686,Albizati; Kim F.,0,22,100,100
1683722549609,CHEM 41B,A01,184690,Staff,51,0,100,49
1683722550641,COGS 3,A01,184715,Boyle; Mary E. T.,0,27,40,40
1683722551672,COGS 14B,A01,185172,Staff,0,14,38,38
1683722552702,COGS 18,A01,184736,Staff,14,0,80,66
1683722553733,COGS 100,A01,184932,Staff,0,8,73,73
1683722554756,COGS 101A,A01,184935,Staff,0,40,30,30
1683722555782,COGS 101B,A01,184944,Staff,0,2,30,30
1683722556811,COGS 101C,A01,184946,Staff,0,10,30,30
1683722557836,COGS 102A,A01,184951,Johnson; Christine M.,1,0,40,39
1683722558862,COGS 107B,A01,184953,Mooshagian; Eric Frederick,0,52,40,40
1683722559888,COGS 118B,A01,184959,Gupta; Anjum,0,50,40,40
1683722560914,COGS 153,A00,184961,Staff,1,16,30,29
1683722561945,COGS 177,A00,184962,Staff,0,20,30,30
1683722562975,COGS 187A,A01,184969,Boyle; Mary E. T.,0,19,40,40
1683722564004,COMM 10,A01,185174,Staff,0,5,25,25
1683722564004,COMM 10,A02,185189,Staff,0,2,25,25
1683722564004,COMM 10,A03,269821,Staff,0,1,0,0
1683722565032,COMM 100B,A02,185476,Staff,10,0,25,15
1683722565032,COMM 100B,A03,277340,Staff,25,0,25,0
1683722566057,COMM 100C,A01,185314,Staff,2,0,25,23
1683722566057,COMM 100C,A02,185327,Staff,17,0,25,8
1683722567086,COMM 110M,A00,185349,Staff,0,0,40,40
1683722568111,COMM 113T,A00,185352,Staff,25,0,40,15
1683722569137,COMM 114I,A00,185353,Staff,31,0,40,9
1683722570168,COMM 131,A00,185354,Staff,17,0,30,13
1683722571199,CSE 8A,A50,185358,Cao; Yingjun,0,46,10,10
1683722572223,CSE 8B,A01,185362,Staff,0,48,50,50
1683722573248,CSE 11,A01,185416,Cao; Yingjun,0,91,10,10
1683722574275,CSE 20,A01,185445,Briones; Jor-el Thomas Caparas,3,0,25,22
1683722575306,CSE 21,A01,185447,Staff,9,0,50,41
1683722576333,CSE 101,A01,185451,Staff,0,13,50,50
1683722576333,CSE 101,B01,185453,Jones; Miles E,0,15,50,50
1683722578392,CSE 141,A01,185458,Eldon; John,16,0,100,84
1683722579421,CSE 141L,A01,185461,Eldon; John,8,0,100,92
1683722580446,CSE 142,A01,185463,Staff,34,0,60,26
1683722580446,CSE 142,B01,201355,Staff,0,7,60,60
1683722581474,CSE 142L,A01,185470,Staff,34,0,60,26
1683722581474,CSE 142L,B01,201417,Staff,0,6,60,60
1683722582503,CSE 190,A00,201433,Staff,32,0,49,17
1683722583531,DOC 1,A01,259136,Strom; Megan C.,7,0,15,8
1683722583531,DOC 1,A02,259137,Strom; Megan C.,15,0,15,0
1683722583531,DOC 1,A03,259138,Strom; Megan C.,14,0,15,1
1683722583531,DOC 1,A04,259139,Strom; Megan C.,13,0,15,2
1683722584558,DOC 100D,A00,259140,Pass; Natalye Joann,14,0,25,11
1683722585588,DSGN 1,A01,184749,Rill; Bryan,0,26,30,30
1683722586618,DSGN 100,A01,185168,Staff,0,2,25,25
1683722587644,ECE 5,A01,185626,Morris; Karcher William,0,12,0,0
1683722588671,ECE 101,A01,185628,Staff,14,0,70,56
1683722589703,ECE 107,A01,185635,Baghdadchi; Saharnaz,0,0,20,20
1683722589703,ECE 107,A02,185638,Baghdadchi; Saharnaz,1,0,20,19
1683722590730,ECE 148,A01,185647,Silberman; Jack,0,0,16,16
1683722591756,ECON 1,A01,185537,Crane; Meredith Helen,54,0,70,16
1683722592780,ECON 3,A01,185549,Crane; Meredith Helen,30,0,70,40
1683722593812,ECON 4,A01,203354,Anderson; John Charles,0,5,10,10
1683722594837,ECON 100A,A01,185574,Staff,0,5,40,40
1683722595861,ECON 100B,A01,185576,Staff,0,12,50,50
1683722596891,ECON 100C,A01,185589,Newhouse; Herbert S,30,0,70,40
1683722597922,ECON 105,A00,185608,Vespa; Emanuel Ignacio,19,0,35,16
1683722598949,ECON 109,A01,185610,Shishkin; Denis,9,0,35,26
1683722599976,ECON 110A,A01,185612,Staff,8,0,40,32
1683722601001,ECON 120A,A01,185615,Staff,19,0,40,21
1683722602027,ECON 120C,A01,185617,Sun; Yixiao,0,21,70,70
1683722603054,ECON 144,A00,203346,Squires; Dale E,2,0,35,33
1683722604079,ECON 171,A01,203349,Newhouse; Herbert S,0,1,35,35
1683722605102,ECON 173A,A01,185621,Toda; Alexis Akira,21,0,35,14
1683722606131,EDS 25,A01,202413,Staff,0,1,0,0
1683722606131,EDS 25,A02,202414,Staff,0,1,0,0
1683722606131,EDS 25,A03,202415,Staff,0,0,0,0
1683722606131,EDS 25,A04,202416,Staff,0,1,0,0
1683722606131,EDS 25,A05,202439,Staff,0,0,0,0
1683722606131,EDS 25,A06,202440,Staff,0,0,0,0
1683722606131,EDS 25,B01,202631,Staff,0,0,0,0
1683722606131,EDS 25,B02,202632,Staff,0,0,0,0
1683722606131,EDS 25,B03,202639,Staff,0,0,0,0
1683722606131,EDS 25,B04,202640,Staff,0,0,0,0
1683722606131,EDS 25,B05,202643,Staff,0,0,0,0
1683722606131,EDS 25,B06,202644,Staff,0,0,0,0
1683722607163,EDS 38,A01,202659,Black; Alison Michelle,25,0,25,0
1683722608191,EDS 115,A00,202652,Staff,18,0,30,12
1683722609216,EDS 125,A00,202649,Staff,13,0,30,17
1683722610242,EDS 126,A01,203332,Staff,30,0,30,0
1683722611268,EDS 139,A00,202838,Staff,16,0,25,9
1683722612293,EDS 146,A01,202655,Staff,14,0,25,11
1683722613320,ENG 15,A00,185667,Staff,0,1,0,0
1683722613320,ENG 15,B00,185672,Staff,0,0,0,0
1683722613320,ENG 15,C00,185675,Staff,0,0,0,0
1683722613320,ENG 15,D00,185682,Staff,0,0,0,0
1683722613320,ENG 15,E00,185684,Staff,0,0,0,0
1683722614348,ETHN 103,A00,185710,Staff,0,8,35,35
1683722615374,ETHN 103A,A00,199228,Man; Simeon S,0,0,9,9
1683722616400,ETHN 109,A00,185711,Staff,15,0,35,20
1683722617424,ETHN 142,A00,185726,Staff,0,4,30,30
1683722618454,ETHN 163J,A00,199229,Man; Simeon S,5,0,8,3
1683722619482,ETHN 168,A00,185727,Staff,7,0,10,3
1683722620507,ETHN 182,A00,185728,Staff,0,0,35,35
1683722621531,ETHN 183,A00,185737,Staff,10,0,18,8
1683722622563,GLBH 111,A01,209361,Burgos; Jose L.,0,0,0,0
1683722624615,HIEU 104,A00,185792,Staff,14,0,20,6
1683722625640,HIEU 115,A00,185800,Staff,0,0,20,20
1683722626666,HIEU 128,A00,185801,Staff,0,9,20,20
1683722627691,HIEU 147,A00,185802,Staff,15,0,20,5
1683722628721,HIEU 154,A00,185823,Staff,11,0,20,9
1683722629749,HILA 102,A00,185826,Staff,14,0,20,6
1683722630778,HILD 2C,A01,185778,Staff,0,13,20,20
1683722631804,HILD 7B,A01,185780,Kwak; Nancy,0,17,32,32
1683722631804,HILD 7B,A02,185781,Kwak; Nancy,0,18,32,32
1683722632829,HILD 30,A01,185791,Staff,12,0,20,8
1683722633856,HISC 119,A00,185830,Golan; Tal,0,10,20,20
1683722634883,HITO 156GS,A00,185831,Patterson; Patrick H.,0,0,0,23
1683722635907,HIUS 103,A00,185832,Man; Simeon S,0,4,20,20
1683722636935,HIUS 117,A00,185836,Kwak; Nancy,2,0,20,18
1683722637965,HIUS 125,A00,185840,Man; Simeon S,0,2,23,23
1683722638994,HIUS 149,A00,185845,Staff,1,0,20,19
1683722640019,HUM 3,A01,185882,Zavodny; Tatiana Sophia,0,8,50,50
1683722640019,HUM 3,B01,185899,Caldwell; Michael Alan,0,18,50,50
1683722641044,HUM 3GS,A00,185900,Patterson; Patrick H.,0,0,0,23
1683722642086,HUM 4,A01,185938,Zroka; Amy Liane,28,0,50,22
1683722642086,HUM 4,B01,185956,Watkins; Eric,0,6,50,50
1683722642086,HUM 4,B02,202209,Watkins; Eric,0,6,50,50
1683722642086,HUM 4,B03,202210,Watkins; Eric,0,5,50,50
1683722643118,HUM 5,A01,185958,West; Geoffrey Scott,0,0,50,50
1683722643118,HUM 5,A02,202215,West; Geoffrey Scott,0,1,50,50
1683722644151,INTL 190,A00,185959,Gagnon; Jeffrey C,0,0,0,9
1683722644151,INTL 190,B00,185960,Lettieri; Michael Joseph,0,0,0,2
1683722645178,JAPN 180,A00,254509,Staff,4,0,30,26
1683722646206,LATI 10,A01,202853,Kennemore; Amy Michelle,4,0,35,31
1683722646206,LATI 10,A02,202854,Kennemore; Amy Michelle,3,0,35,32
1683722646206,LATI 10,A03,270054,Kennemore; Amy Michelle,30,0,30,0
1683722647295,LATI 180,A00,202855,Kennemore; Amy Michelle,11,0,20,9
1683722648328,LAWS 101,A00,201767,Golan; Tal,0,7,40,40
1683722649357,LIFR 1C,A00,185961,Staff,6,0,20,14
1683722650382,LIFR 1CX,A00,185962,Staff,7,0,20,13
1683722651408,LIFR 1D,A00,185963,Staff,7,0,20,13
1683722652438,LIFR 1DX,A00,185964,Staff,7,0,20,13
1683722653463,LIGN 101,A01,186039,Staff,43,0,50,7
1683722654486,LIGN 165,A00,186040,Staff,14,0,50,36
1683722655514,LTCS 108,A00,186041,Staff,5,0,10,5
1683722656540,LTCS 119,A00,186042,Staff,15,0,20,5
1683722657566,LTCS 130,A00,186043,Wesling; Megan E.,15,0,25,10
1683722659623,LTEA 138,A00,186119,Staff,13,0,40,27
1683722660648,LTEN 124,A00,186148,Staff,5,0,25,20
1683722661673,LTEN 178,A00,186149,Staff,6,0,15,9
1683722662700,LTEN 181,A00,186150,Blanco; John D,34,0,40,6
1683722663726,LTWL 120,A00,186160,Staff,19,0,25,6
1683722664752,LTWL 165,A00,186161,Staff,22,0,25,3
1683722665780,LTWR 100,A00,186162,Staff,0,5,15,15
1683722666811,LTWR 102,A00,186163,Doller; Ben,5,0,15,10
1683722667840,MAE 8,A01,186412,Staff,0,1,0,0
1683722668867,MAE 30B,A00,186445,Bahadori; Mohammad Yousef,81,0,100,19
1683722669893,MAE 40,A00,186592,Bewley; Thomas R,10,0,50,40
1683722670918,MAE 101B,A00,186593,Bahadori; Mohammad Yousef,80,0,100,20
1683722671944,MAE 105,A00,186594,Bandaru; Prabhakar,10,0,50,40
1683722672971,MAE 107,A00,186599,Pham; Hieu Tan,0,8,120,120
1683722674002,MAE 148,A01,186660,Silberman; Jack,3,0,16,13
1683722675032,MATH 10A,A01,188095,Staff,0,6,35,35
1683722676072,MATH 10B,A01,188097,Bowers; Adam R.,0,12,30,30
1683722676072,MATH 10B,A02,188099,Bowers; Adam R.,0,11,30,30
1683722676072,MATH 10B,B01,188104,Bowers; Adam R.,0,10,30,30
1683722676072,MATH 10B,B02,188106,Bowers; Adam R.,0,9,30,30
1683722677106,MATH 10C,A01,188111,Staff,0,20,30,30
1683722677106,MATH 10C,A02,188127,Staff,0,19,30,30
1683722677106,MATH 10C,A03,188131,Staff,0,19,30,30
1683722677106,MATH 10C,B01,188218,Staff,17,0,30,13
1683722677106,MATH 10C,B02,188244,Staff,13,0,30,17
1683722677106,MATH 10C,B03,188277,Staff,14,0,30,16
1683722678137,MATH 18,A01,188344,Bach; Quang Tran,18,0,30,12
1683722678137,MATH 18,A02,188345,Bach; Quang Tran,11,0,30,19
1683722678137,MATH 18,B01,188353,Bach; Quang Tran,11,0,30,19
1683722678137,MATH 18,B02,188354,Bach; Quang Tran,19,0,30,11
1683722679164,MATH 20A,A01,188374,Staff,11,0,35,24
1683722680191,MATH 20B,A01,188382,Ohm; Ko Woon,7,0,30,23
1683722680191,MATH 20B,A02,188383,Ohm; Ko Woon,22,0,30,8
1683722680191,MATH 20B,B01,188385,Ohm; Ko Woon,7,0,30,23
1683722680191,MATH 20B,B02,188392,Ohm; Ko Woon,22,0,30,8
1683722681218,MATH 20C,A01,188394,Harel; Guershon,10,0,30,20
1683722681218,MATH 20C,A02,188395,Harel; Guershon,13,0,30,17
1683722681218,MATH 20C,B01,188404,Harel; Guershon,5,0,30,25
1683722681218,MATH 20C,B02,188405,Harel; Guershon,18,0,30,12
1683722682252,MATH 20D,A01,188414,Hammock; Frances H,0,1,30,30
1683722682252,MATH 20D,A02,188415,Hammock; Frances H,0,1,30,30
1683722682252,MATH 20D,B01,188447,Hammock; Frances H,0,1,30,30
1683722682252,MATH 20D,B02,188486,Hammock; Frances H,2,0,30,28
1683722683282,MATH 20E,A01,188649,Staff,21,0,30,9
1683722683282,MATH 20E,A02,188650,Staff,20,0,30,10
1683722683282,MATH 20E,A03,188673,Staff,0,0,30,30
1683722684307,MATH 102,A01,188675,Staff,0,40,35,35
1683722685337,MATH 103B,A01,188681,Staff,3,0,35,32
1683722685337,MATH 103B,B01,188692,Staff,5,0,35,30
1683722686365,MATH 109,A01,188695,Salehi Golsefidy; Alireza,24,0,35,11
1683722686365,MATH 109,A02,188696,Salehi Golsefidy; Alireza,24,0,35,11
1683722687391,MATH 120A,A01,188698,Eggers; John Dietrich,7,0,35,28
1683722688416,MATH 142B,A01,188736,Ioana; Adrian,0,0,30,30
1683722688416,MATH 142B,A02,188741,Ioana; Adrian,0,1,30,30
1683722688416,MATH 142B,A03,188743,Ioana; Adrian,0,3,30,30
1683722689441,MATH 168A,A01,188790,Staff,0,11,35,35
1683722690468,MATH 170A,A01,188803,Nie; Jiawang,0,2,35,35
1683722690468,MATH 170A,A02,188811,Nie; Jiawang,0,1,35,35
1683722690468,MATH 170A,A03,188814,Nie; Jiawang,1,0,35,34
1683722690468,MATH 170A,A04,188815,Nie; Jiawang,5,0,35,30
1683722691493,MATH 193B,A01,188817,Staff,0,0,35,35
1683722691493,MATH 193B,A02,188818,Staff,6,0,35,29
1683722692519,MGT 4,A01,202857,Anderson; John Charles,59,0,80,21
1683722693545,MGT 12,A00,202858,Lindenberger; Wade Douglas,40,0,90,50
1683722694570,MGT 18,A00,202859,Staff,73,0,90,17
1683722695595,MGT 18GS,A00,202860,McKay; Michael J,13,0,28,15
1683722696622,MGT 45,A00,202861,Pecore; Joseph P.,8,0,90,82
1683722697649,MGT 100,A00,202863,Yavorsky; Daniel Ryan,27,0,90,63
1683722698676,MGT 103,A00,202864,Ehrich; Kristine R,0,19,90,90
1683722699701,MGT 112,A00,202865,Ehrich; Kristine R,15,0,90,75
1683722700728,MGT 121A,A00,202868,Staff,70,0,90,20
1683722701761,MGT 131B,A00,202869,Anderson; John Charles,58,0,90,32
1683722702793,MGT 136,A00,202871,Lindenberger; Wade Douglas,83,0,90,7
1683722703821,MGT 164,A00,202873,Staff,0,67,90,91
1683722704851,MGT 164GS,A00,202874,McKay; Mary A,13,0,28,15
1683722705876,MGT 180,A00,202875,Staff,0,51,90,91
1683722706902,MMW 11R,A01,205019,Herbst; Matthew,0,0,30,30
1683722706902,MMW 11R,A02,205026,Herbst; Matthew,29,0,30,1
1683722707930,MMW 15,A01,193512,Chang; Edmond Yi-Teh,0,8,28,28
1683722707930,MMW 15,A02,193513,Chang; Edmond Yi-Teh,0,5,28,28
1683722707930,MMW 15,A03,193514,Chang; Edmond Yi-Teh,0,5,28,28
1683722707930,MMW 15,A04,193515,Chang; Edmond Yi-Teh,0,5,28,28
1683722707930,MMW 15,A05,193516,Chang; Edmond Yi-Teh,0,5,28,28
1683722707930,MMW 15,A06,193517,Chang; Edmond Yi-Teh,0,6,28,28
1683722707930,MMW 15,B01,193519,Chang; Edmond Yi-Teh,0,5,28,28
1683722707930,MMW 15,B02,193520,Chang; Edmond Yi-Teh,0,5,28,28
1683722707930,MMW 15,B03,193521,Chang; Edmond Yi-Teh,0,5,28,28
1683722707930,MMW 15,B04,193522,Chang; Edmond Yi-Teh,0,6,28,28
1683722707930,MMW 15,B05,193523,Chang; Edmond Yi-Teh,0,5,28,28
1683722707930,MMW 15,B06,193524,Chang; Edmond Yi-Teh,0,5,28,28
1683722708956,MMW 122,A01,193526,Rahimi; Babak,0,16,28,28
1683722708956,MMW 122,A02,193527,Rahimi; Babak,0,15,28,28
1683722708956,MMW 122,A03,193528,Rahimi; Babak,0,0,0,0
1683722708956,MMW 122,A04,193529,Rahimi; Babak,0,0,0,0
1683722709983,MUS 1A,A01,186663,Staff,0,18,35,35
1683722711009,MUS 4,A01,186715,Staff,0,12,35,35
1683722712033,MUS 5R,A01,186796,Dubnov; Shlomo,0,17,35,35
1683722713059,MUS 6,A01,186798,Staff,0,4,25,25
1683722714090,MUS 7,A01,186830,Staff,11,0,35,24
1683722715118,MUS 8,A01,186930,Staff,0,27,35,35
1683722716144,MUS 15,A01,186932,Staff,0,15,35,35
1683722716144,MUS 15,B01,186934,Staff,0,16,35,35
1683722717175,MUS 80,A00,186935,Staff,0,0,20,20
1683722717175,MUS 80,B00,186936,Staff,24,0,25,1
1683722718200,NANO 11,A00,204702,Lipomi; Darren John,0,0,0,0
1683722719224,NANO 15,A01,204709,Yang; Kesong,0,1,0,0
1683722720250,NANO 114,A00,202069,Jahed Motlagh; Zeinab,2,0,10,8
1683722721277,PHIL 1,A00,186955,Grush; Rick Scott,31,0,40,9
1683722722308,PHIL 10,A01,186973,Grush; Rick Scott,27,0,35,8
1683722722308,PHIL 10,A02,186974,Grush; Rick Scott,33,0,35,2
1683722723338,PHIL 13,A01,186976,Staff,1,0,35,34
1683722723338,PHIL 13,A02,186977,Staff,16,0,35,19
1683722724368,PHIL 14,A01,186979,Staff,30,0,35,5
1683722724368,PHIL 14,A02,186986,Staff,32,0,35,3
1683722725394,PHIL 28,A01,186988,Staff,16,0,30,14
1683722725394,PHIL 28,A02,186989,Staff,0,0,30,30
1683722725394,PHIL 28,A03,186990,Staff,10,0,30,20
1683722725394,PHIL 28,A04,186991,Staff,26,0,30,4
1683722726422,PHIL 120,A00,186997,Staff,23,0,40,17
1683722727449,PHIL 137,A00,187003,Staff,8,0,40,32
1683722728474,PHIL 150,A00,187015,Staff,47,0,70,23
1683722729500,PHIL 167,A00,187021,Lamey; Andy M.,34,0,40,6
1683722730527,PHIL 174,A01,202226,Staff,17,0,20,3
1683722730527,PHIL 174,A02,202235,Staff,20,0,20,0
1683722731552,PHIL 191A,A00,258918,Staff,0,0,1,1
1683722732581,PHYS 1A,A00,187028,Staff,26,0,60,34
1683722733606,PHYS 1AL,001,187036,Staff,3,0,30,27
1683722733606,PHYS 1AL,002,187049,Staff,18,0,30,12
1683722734634,PHYS 1B,A00,187058,Staff,21,0,60,39
1683722735660,PHYS 1BL,001,187064,Staff,0,1,30,30
1683722735660,PHYS 1BL,002,187070,Staff,4,0,30,26
1683722736690,PHYS 1C,A00,187082,Staff,30,0,120,90
1683722737715,PHYS 1CL,001,187088,Staff,0,9,30,30
1683722737715,PHYS 1CL,002,187089,Staff,0,1,30,30
1683722737715,PHYS 1CL,009,262693,Staff,9,0,30,21
1683722738742,PHYS 2B,A01,187097,Staff,55,0,115,60
1683722739770,PHYS 2C,A01,187099,Staff,63,0,115,52
1683722740797,PHYS 2CL,A01,187101,Staff,5,0,28,23
1683722740797,PHYS 2CL,A02,187102,Staff,15,0,28,13
1683722741822,PHYS 2D,A01,187123,Shotwell; Brian,95,0,115,20
1683722742848,PHYS 4B,A01,187133,Grinstein; Benjamin,35,0,50,15
1683722743878,POLI 10,A00,188819,Staff,0,4,50,50
1683722744906,POLI 11,A00,188827,Staff,43,0,50,7
1683722745935,POLI 13R,A00,188828,Staff,0,2,20,20
1683722746964,POLI 27,A01,188830,Elgin; Samuel Zincke,0,2,70,70
1683722747990,POLI 30,A00,188832,Desposato; Scott,30,0,50,20
1683722749018,POLI 102F,A00,188834,Staff,1,0,40,39
1683722750044,POLI 104A,A00,188852,Staff,12,0,30,18
1683722751125,POLI 104I,A00,188853,Staff,0,8,20,20
1683722752155,POLI 110B,A00,188854,Wiens; David,6,0,20,14
1683722753186,POLI 112A,A00,188855,Wiens; David,3,0,30,27
1683722754216,POLI 117R,A00,188856,Forman; Fonna,0,12,20,20
1683722755245,POLI 118,A00,188857,Ingham; Sean,8,0,20,12
1683722756268,POLI 120G,A00,188858,Staff,7,0,30,23
1683722757294,POLI 131CR,A00,188863,Hoston; Germaine,20,0,50,30
1683722758322,POLI 133,A00,188864,Nellis; Gareth Hb,44,0,50,6
1683722759351,POLI 134D,A00,188865,Desposato; Scott,27,0,30,3
1683722760377,POLI 142A,A00,188871,Gartzke; Erik,21,0,50,29
1683722761415,POLI 142K,A00,188874,Staff,38,0,50,12
1683722762439,POLI 143,A00,188940,Gartzke; Erik,15,0,30,15
1683722763465,POLI 153,A00,188943,Staff,1,0,20,19
1683722764490,POLI 160AA,A00,188944,Staff,10,0,40,30
1683722765519,POLI 170A,A00,188945,Staff,10,0,30,20
1683722767574,PSYC 1,A00,188952,Staff,36,0,90,54
1683722768598,PSYC 2,B00,188953,Staff,19,0,35,16
1683722769623,PSYC 6,A00,188970,Staff,47,0,60,13
1683722770651,PSYC 7,A00,188973,Staff,35,0,45,10
1683722771682,PSYC 60,A01,188980,Rickard; Timothy C.,42,0,60,18
1683722772712,PSYC 70,A01,189001,Steiner; Eric Tomas,22,0,45,23
1683722773738,PSYC 100,A00,189005,Lacefield; Katharine I,1,98,120,119
1683722774774,PSYC 102,A00,189008,Staff,6,0,30,24
1683722775800,PSYC 106,B00,189026,Gorman; Michael R.,27,0,60,33
1683722776825,PSYC 114,B01,189033,Winkielman; Piotr,0,31,30,30
1683722777854,PSYC 131,A00,189036,Anagnostaras; Stephan,0,44,60,60
1683722778883,PSYC 136,A00,189041,Lowe; Angela Beth,0,7,25,25
1683722779910,PSYC 137,A00,189057,Winkielman; Piotr,0,36,25,25
1683722780935,PSYC 144,A00,189107,Wixted; John T,0,11,50,50
1683722782994,PSYC 162,A00,189142,Staff,0,9,85,85
1683722784017,PSYC 172,A00,189144,Gorman; Michael R.,0,6,30,30
1683722786065,PSYC 179,A00,189146,Lacefield; Katharine I,0,88,120,120
1683722787098,PSYC 181,A00,189147,Anagnostaras; Stephan,0,45,90,90
1683722788129,PSYC 190R,A00,189148,Barner; David A.,0,23,80,80
1683722789158,PSYC 191,A00,189275,Rickard; Timothy C.,0,11,25,25
1683722790184,PSYC 193,A00,189276,Chapman; Eddie Nathaniel,0,1,0,4
1683722791214,PSYC 193L,A01,189281,Lowe; Angela Beth,8,0,20,12
1683722791214,PSYC 193L,B01,189285,Staff,28,0,35,7
1683722792239,RELI 149,A00,187137,Rahimi; Babak,6,0,40,34
1683722793269,SE 9,A01,187315,Staff,0,2,18,18
1683722794299,SE 101B,A00,187409,Staff,24,0,30,6
1683722795328,SE 110B,A00,187444,Staff,10,0,40,30
1683722796358,SE 130B,A00,187449,Staff,31,0,40,9
1683722797384,SE 150A,A00,187516,Staff,8,0,20,12
1683722798414,SE 154,A00,187528,Staff,29,0,50,21
1683722799444,SIO 3,A01,258171,Staff,35,0,40,5
1683722800471,SIO 10,A00,187144,Cook; Geoffrey W,0,6,75,75
1683722801496,SIO 45,A00,187152,Cook; Geoffrey W,1,7,100,99
1683722802522,SIO 109R,A00,194486,Staff,0,4,20,20
1683722804579,SIO 187,A01,187233,Kacev; David,12,0,40,28
1683722805606,SOCI 1,A01,258656,Thorpe; Charles Robert,28,0,30,2
1683722805606,SOCI 1,A02,258658,Thorpe; Charles Robert,30,0,30,0
1683722805606,SOCI 1,A03,258661,Thorpe; Charles Robert,25,0,25,0
1683722805606,SOCI 1,A04,258666,Thorpe; Charles Robert,22,0,25,3
1683722805606,SOCI 1,A05,258897,Thorpe; Charles Robert,22,0,25,3
1683722805606,SOCI 1,A06,258898,Thorpe; Charles Robert,25,0,25,0
1683722806639,SOCI 30,A01,258903,Pardo Guerra; Juan Pablo,14,0,30,16
1683722807666,SOCI 102,A00,258904,Staff,9,0,25,16
1683722808697,SOCI 106,A00,258905,Staff,19,0,25,6
1683722809732,SOCI 111,A00,258907,Ribas Norris; Janet Vanesa,26,0,30,4
1683722810758,SOCI 121R,A00,258908,Pardo Guerra; Juan Pablo,7,0,30,23
1683722811789,SOCI 126,A01,203330,Staff,14,0,20,6
1683722812815,SOCI 131,A00,258909,Thorpe; Charles Robert,30,0,60,30
1683722813842,SOCI 135,A00,258910,Payne; Christine Anna,0,13,30,30
1683722814878,SOCI 157,A00,258911,Staff,10,0,30,20
1683722815904,SOCI 184,A00,258912,Staff,25,0,30,5
1683722816934,SOCI 188D,A00,258913,Staff,22,0,30,8
1683722817967,SYN 2,001,187529,Staff,9,0,16,7
1683722817967,SYN 2,002,201452,Staff,0,20,16,16
1683722817967,SYN 2,003,201469,Staff,1,0,16,15
1683722818997,SYN 100,A01,187531,Staff,0,9,20,20
1683722818997,SYN 100,B01,201491,Staff,0,10,20,20
1683722820031,TDAC 1,A00,189286,Walsh; Kim C.,3,0,20,17
1683722820031,TDAC 1,B00,189287,Harting; Carla Kelso,10,0,20,10
1683722821069,TDAC 101,A00,189300,Walsh; Kim C.,16,0,20,4
1683722821069,TDAC 101,B00,189301,Harting; Carla Kelso,18,0,20,2
1683722822096,TDAC 102,A00,189304,Basso; Beatrice,14,0,20,6
1683722823123,TDAC 108,A00,189305,Staff,18,0,20,2
1683722824152,TDDE 131,A00,189310,Staff,19,0,20,1
1683722824152,TDDE 131,B00,189314,Staff,19,0,20,1
1683722824152,TDDE 131,C00,189315,Staff,48,0,50,2
1683722824152,TDDE 131,D00,189316,Staff,14,0,15,1
1683722824152,TDDE 131,E00,204841,Staff,20,0,20,0
1683722825178,TDGE 10,A00,189289,Staff,26,0,50,24
1683722825178,TDGE 10,B00,189290,Havis; Allan,0,1,50,50
1683722826241,TDGE 11,A00,189291,Fulton; Julia,0,4,50,50
1683722826241,TDGE 11,B00,189292,Staff,20,0,25,5
1683722826241,TDGE 11,C00,260270,Staff,0,0,0,0
1683722827268,TDGE 25,A00,189294,Staff,1,0,20,19
1683722828293,TDGE 124,A00,189318,Fulton; Julia,0,7,50,50
1683722829322,TDGE 125,A00,189319,Staff,13,0,25,12
1683722829322,TDGE 125,B00,189320,Staff,23,0,25,2
1683722830355,TDGE 127,A00,189322,Havis; Allan,1,0,50,49
1683722831393,TDHT 101,A00,189323,Staff,18,0,25,7
1683722831393,TDHT 101,B00,189324,Staff,25,0,25,0
1683722832419,TDHT 102,A00,189325,Staff,49,0,50,1
1683722833445,TDMV 1,A00,189295,Arcidiacono; Kristin,20,0,30,10
1683722833445,TDMV 1,B00,189296,Caligagan; Maria T.,23,0,30,7
1683722834478,TDMV 2,A00,189297,Sammartano; Tonnie,27,0,30,3
1683722834478,TDMV 2,B00,189299,Arcidiacono; Kristin,23,0,30,7
1683722835507,TDMV 3,A00,204998,Rincon; Alicia,22,0,30,8
1683722836538,TDMV 120,A00,189458,Sammartano; Tonnie,28,0,30,2
1683722837564,TDMV 138,A00,189541,Jun; Grace Shin Hae,20,0,40,20
1683722838589,TDMV 142,A00,189717,Caligagan; Tony,25,0,30,5
1683722838589,TDMV 142,B00,189718,Caligagan; Maria T.,25,0,30,5
1683722839624,TMC 2,A01,187533,Staff,25,0,25,0
1683722839624,TMC 2,A02,187534,Staff,25,0,25,0
1683722840650,USP 1,A01,187536,Kwak; Nancy,0,16,25,25
1683722841679,USP 5,A01,187538,Staff,8,0,25,17
1683722842705,USP 101,A00,199253,Staff,0,4,0,0
1683722843737,USP 124,A00,187562,Boomhower; Matthew Charles,0,0,30,30
1683722844768,USP 138,A00,187582,Staff,19,0,25,6
1683722845809,USP 152,A01,187597,Staff,3,0,25,22
1683722846838,USP 153,A00,187598,Staff,18,0,25,7
1683722847869,USP 168,A00,187607,Kwak; Nancy,2,0,5,3
1683722848901,USP 173,A00,187619,Staff,4,0,25,21
1683722849933,USP 181,A00,187638,Staff,0,4,25,25
1683722850961,VIS 103,A00,187650,Cruz; Edwin Teddy,17,0,75,58
1683722851990,VIS 110D,A00,187669,Staff,13,0,22,9
1683722853017,VIS 127C,A00,187720,Shen; Kuiyi,67,0,146,79
1683722854045,VIS 149,A00,187731,Yoldas; Pinar,0,12,22,22
1683722855130,VIS 151,A01,188091,Staff,22,0,34,12
1683722855130,VIS 151,A02,188092,Staff,11,0,34,23
1683722856159,VIS 160B,A00,188093,Stalbaum; Brett,0,1,10,10
1683722858216,WCWP 10B,A00,201720,Staff,0,0,5,5
1683722858216,WCWP 10B,B00,201722,Staff,0,0,6,6
1683722859247,WCWP 100,A00,201725,Gagnon; Jeffrey C,0,0,2,2
1683722859247,WCWP 100,B00,201727,Staff,0,4,15,15
1683722862475,ANBI 133,A00,258401,Wilder; Linnea Lorene,34,0,40,6
1683722863502,ANBI 140,A00,258395,Hrvoj Mihic; Branka,18,0,25,7
1683722864575,ANSC 120,A00,258402,Bialecki; Jon Anthony,26,0,40,14
1683722865602,ANSC 144,A00,258400,Staff,12,0,40,28
1683722867660,ANSC 166,A00,258396,Parish; Steven Martin,156,0,175,19
1683722868703,ANSC 180,A00,193533,Staff,8,0,20,12
1683722869730,ANSC 188,A00,258397,Jassal; Aftab,34,0,40,6
1683722870756,ANTH 3,A01,258316,Staff,23,0,30,7
1683722871782,ANTH 5,A00,258394,Semendeferi; Ekaterini,16,0,20,4
1683722872809,ANTH 21,A01,258331,Staff,4,0,40,36
1683722873835,ANTH 103,A00,258398,Varma; Saiba,15,0,25,10
1683722874874,AWP 10,001,202034,Staff,0,0,0,0
1683722874874,AWP 10,002,202035,Staff,0,0,0,0
1683722874874,AWP 10,003,202036,Staff,0,0,0,0
1683722874874,AWP 10,004,202037,Staff,0,0,0,0
1683722874874,AWP 10,005,202038,Staff,0,0,0,0
1683722874874,AWP 10,006,202039,Staff,0,0,0,0
1683722874874,AWP 10,007,202040,Staff,0,0,0,0
1683722874874,AWP 10,008,202041,Staff,0,0,0,0
1683722874874,AWP 10,009,202042,Staff,0,0,0,0
1683722874874,AWP 10,010,202043,Staff,0,0,0,0
1683722874874,AWP 10,011,202044,Staff,0,0,0,0
1683722874874,AWP 10,012,202045,Staff,0,0,0,0
1683722874874,AWP 10,013,202046,Staff,0,0,0,0
1683722874874,AWP 10,014,202047,Staff,0,0,0,0
1683722874874,AWP 10,015,202048,Staff,0,0,0,0
1683722874874,AWP 10,016,202049,Staff,0,0,0,0
1683722874874,AWP 10,017,202050,Staff,0,0,0,0
1683722874874,AWP 10,018,202051,Staff,0,0,0,0
1683722874874,AWP 10,019,202052,Staff,0,0,0,0
1683722874874,AWP 10,020,202053,Staff,0,0,0,0
1683722874874,AWP 10,021,202054,Staff,0,0,0,0
1683722874874,AWP 10,022,202055,Staff,0,0,0,0
1683722874874,AWP 10,023,202056,Staff,0,0,0,0
1683722874874,AWP 10,024,202057,Staff,0,0,0,0
1683722874874,AWP 10,025,202058,Staff,0,0,0,0
1683722874874,AWP 10,026,202059,Staff,0,0,0,0
1683722875903,AWP 102,001,202032,Staff,0,0,0,0
1683722875903,AWP 102,002,202033,Staff,0,0,0,0
1683722876937,BENG 100,A01,254234,Taylor Amos; Alyssa C,31,0,40,9
1683722877970,BENG 196,001,270013,Engler; Adam J.,9999,0,9999,0
1683722879001,BICD 100R,A01,202018,Smith; Laurie,0,7,32,32
1683722879001,BICD 100R,A02,202019,Smith; Laurie,0,3,32,32
1683722879001,BICD 100R,A03,202020,Smith; Laurie,0,1,32,32
1683722879001,BICD 100R,A04,202021,Smith; Laurie,6,0,32,26
1683722879001,BICD 100R,A05,202022,Smith; Laurie,10,0,32,22
1683722880033,BICD 136,A01,193242,Gustafson-Brown; Cindy,0,2,32,32
1683722880033,BICD 136,A02,193244,Gustafson-Brown; Cindy,13,0,32,19
1683722881064,BIEB 102,A01,193249,Butler; Shannon Rhey,0,0,32,32
1683722881064,BIEB 102,A02,193251,Butler; Shannon Rhey,0,0,32,32
1683722881064,BIEB 102,A03,193253,Butler; Shannon Rhey,0,0,32,32
1683722881064,BIEB 102,A04,193255,Butler; Shannon Rhey,13,0,32,19
1683722881064,BIEB 102,A05,193265,Butler; Shannon Rhey,25,0,32,7
1683722881064,BIEB 102,A06,193269,Butler; Shannon Rhey,12,0,32,20
1683722883123,BIEB 150,A01,193274,Staff,0,0,32,32
1683722883123,BIEB 150,A02,193285,Staff,24,0,32,8
1683722884159,BIEB 194,A00,193286,Kurle; Carolyn M.,19,0,32,13
1683722885192,BILD 1,A01,192291,Staff,15,0,32,17
1683722885192,BILD 1,A02,192292,Staff,30,0,32,2
1683722885192,BILD 1,B01,192520,Reuther; Keefe,0,1,0,0
1683722885192,BILD 1,B02,192532,Reuther; Keefe,0,1,0,0
1683722886225,BILD 3,A01,192556,Butler; Shannon Rhey,0,0,32,32
1683722886225,BILD 3,A02,192581,Butler; Shannon Rhey,0,1,32,32
1683722886225,BILD 3,A03,192611,Butler; Shannon Rhey,19,0,32,13
1683722886225,BILD 3,A04,192612,Butler; Shannon Rhey,23,0,32,9
1683722886225,BILD 3,A05,192613,Butler; Shannon Rhey,26,0,32,6
1683722886225,BILD 3,A06,192679,Butler; Shannon Rhey,27,0,32,5
1683722886225,BILD 3,A07,192682,Butler; Shannon Rhey,20,0,32,12
1683722887251,BILD 4,A01,192836,Reuther; Keefe,1,0,24,23
1683722887251,BILD 4,A02,193044,Reuther; Keefe,4,0,24,20
1683722888281,BILD 10,A01,193142,Gustafson-Brown; Cindy,29,0,32,3
1683722888281,BILD 10,A02,193149,Gustafson-Brown; Cindy,31,0,32,1
1683722889307,BIMM 100,A01,193301,Staff,0,6,32,32
1683722889307,BIMM 100,A02,193312,Staff,0,7,32,32
1683722889307,BIMM 100,A03,193323,Staff,0,10,32,32
1683722890334,BIMM 101,A01,193329,McDonnell; Lisa Marie,0,3,24,24
1683722890334,BIMM 101,A02,193339,McDonnell; Lisa Marie,0,3,24,24
1683722890334,BIMM 101,B01,193354,McDonnell; Lisa Marie,0,4,24,24
1683722890334,BIMM 101,B02,193357,McDonnell; Lisa Marie,0,3,24,24
1683722891361,BIMM 110,A01,193377,Tat; John,0,11,32,32
1683722891361,BIMM 110,A02,193378,Tat; John,0,11,32,32
1683722892397,BIMM 120,A01,206116,Staff,0,0,32,32
1683722892397,BIMM 120,A02,206117,Staff,7,0,32,25
1683722892397,BIMM 120,A03,206121,Staff,21,0,32,11
1683722893434,BIPN 100,A01,193393,Park; Ji Young,0,15,32,32
1683722893434,BIPN 100,A02,193402,Park; Ji Young,0,14,32,32
1683722893434,BIPN 100,A03,193413,Park; Ji Young,0,14,32,32
1683722893434,BIPN 100,A04,193414,Park; Ji Young,0,13,32,32
1683722894459,BIPN 102,A01,193429,Staff,0,0,32,32
1683722894459,BIPN 102,A02,193438,Staff,18,0,32,14
1683722895486,BIPN 106,A01,193450,Reyes Gonzalez; Catalina,0,2,40,40
1683722896514,BIPN 134,A01,193465,Cooke; James Edward,0,0,32,32
1683722896514,BIPN 134,A02,193474,Cooke; James Edward,25,0,32,7
1683722896514,BIPN 134,A03,193485,Cooke; James Edward,29,0,32,3
1683722896514,BIPN 134,A04,193486,Cooke; James Edward,20,0,32,12
1683722896514,BIPN 134,A05,193491,Cooke; James Edward,31,0,32,1
1683722896514,BIPN 134,A06,193501,Cooke; James Edward,30,0,32,2
1683722896514,BIPN 134,A07,193510,Cooke; James Edward,29,0,32,3
1683722898573,BISP 194,A00,222522,Staff,14,0,32,18
1683722899598,CAT 124,A01,202407,Staff,19,0,25,6
1683722900624,CAT 125,A00,202408,Marchisotto; Jennifer Anne,2,0,20,18
1683722901662,CAT 125R,A00,202409,Smith; Lauryn Alissa,0,11,20,20
1683722901662,CAT 125R,B00,202410,Morales; Celeste Georgianna,0,11,20,20
1683722901662,CAT 125R,C00,202411,Irwin; Matthew Joseph,0,12,20,20
1683722902697,CENG 15,A01,204712,Yang; Kesong,0,1,0,0
1683722903736,CENG 114,A00,202070,Jahed Motlagh; Zeinab,5,0,20,15
1683722904764,CGS 105,A00,185477,Wesling; Megan E.,24,0,40,16
1683722905793,CGS 106,A00,185494,Staff,11,0,22,11
1683722906824,CGS 108,A00,185495,Staff,14,0,20,6
1683722907849,CGS 114,A00,185496,Staff,13,0,18,5
1683722908875,CGS 119,A00,185501,Staff,15,0,20,5
1683722909904,CGS 120,A00,185511,Staff,11,0,20,9
1683722910932,CHEM 4,A01,184675,Bussey; Thomas J,97,0,100,3
1683722911964,CHEM 6A,A01,184677,Staff,32,0,60,28
1683722912993,CHEM 6B,A01,184679,Staff,63,0,100,37
1683722914023,CHEM 6C,A01,184681,Bussey; Thomas J,0,0,50,50
1683722914023,CHEM 6C,A02,184682,Bussey; Thomas J,32,0,50,18
1683722915051,CHEM 40A,A01,184684,Albizati; Kim F.,33,0,100,67
1683722916078,CHEM 40B,A01,184686,Albizati; Kim F.,0,22,100,100
1683722917108,CHEM 41B,A01,184690,Staff,51,0,100,49
1683722918141,COGS 3,A01,184715,Boyle; Mary E. T.,0,27,40,40
1683722919167,COGS 14B,A01,185172,Staff,0,14,38,38
1683722920195,COGS 18,A01,184736,Staff,14,0,80,66
1683722921220,COGS 100,A01,184932,Staff,0,8,73,73
1683722922245,COGS 101A,A01,184935,Staff,0,40,30,30
1683722923270,COGS 101B,A01,184944,Staff,0,2,30,30
1683722924299,COGS 101C,A01,184946,Staff,0,10,30,30
1683722925324,COGS 102A,A01,184951,Johnson; Christine M.,1,0,40,39
1683722926350,COGS 107B,A01,184953,Mooshagian; Eric Frederick,0,52,40,40
1683722927376,COGS 118B,A01,184959,Gupta; Anjum,0,50,40,40
1683722928401,COGS 153,A00,184961,Staff,1,16,30,29
1683722929427,COGS 177,A00,184962,Staff,0,20,30,30
1683722930453,COGS 187A,A01,184969,Boyle; Mary E. T.,0,19,40,40
1683722931480,COMM 10,A01,185174,Staff,0,5,25,25
1683722931480,COMM 10,A02,185189,Staff,0,2,25,25
1683722931480,COMM 10,A03,269821,Staff,0,1,0,0
1683722932513,COMM 100B,A02,185476,Staff,10,0,25,15
1683722932513,COMM 100B,A03,277340,Staff,25,0,25,0
1683722933545,COMM 100C,A01,185314,Staff,2,0,25,23
1683722933545,COMM 100C,A02,185327,Staff,17,0,25,8
1683722934570,COMM 110M,A00,185349,Staff,0,0,40,40
1683722935594,COMM 113T,A00,185352,Staff,25,0,40,15
1683722936619,COMM 114I,A00,185353,Staff,31,0,40,9
1683722937644,COMM 131,A00,185354,Staff,17,0,30,13
1683722938670,CSE 8A,A50,185358,Cao; Yingjun,0,46,10,10
1683722939701,CSE 8B,A01,185362,Staff,0,48,50,50
1683722940731,CSE 11,A01,185416,Cao; Yingjun,0,91,10,10
1683722941758,CSE 20,A01,185445,Briones; Jor-el Thomas Caparas,3,0,25,22
1683722942785,CSE 21,A01,185447,Staff,9,0,50,41
1683722943811,CSE 101,A01,185451,Staff,0,13,50,50
1683722943811,CSE 101,B01,185453,Jones; Miles E,0,15,50,50
1683722945866,CSE 141,A01,185458,Eldon; John,16,0,100,84
1683722946892,CSE 141L,A01,185461,Eldon; John,8,0,100,92
1683722947918,CSE 142,A01,185463,Staff,34,0,60,26
1683722947918,CSE 142,B01,201355,Staff,0,7,60,60
1683722948943,CSE 142L,A01,185470,Staff,34,0,60,26
1683722948943,CSE 142L,B01,201417,Staff,0,6,60,60
1683722949972,CSE 190,A00,201433,Staff,32,0,49,17
1683722951000,DOC 1,A01,259136,Strom; Megan C.,7,0,15,8
1683722951000,DOC 1,A02,259137,Strom; Megan C.,15,0,15,0
1683722951000,DOC 1,A03,259138,Strom; Megan C.,14,0,15,1
1683722951000,DOC 1,A04,259139,Strom; Megan C.,13,0,15,2
1683722952025,DOC 100D,A00,259140,Pass; Natalye Joann,14,0,25,11
1683722953058,DSGN 1,A01,184749,Rill; Bryan,0,26,30,30
1683722954087,DSGN 100,A01,185168,Staff,0,2,25,25
1683722955118,ECE 5,A01,185626,Morris; Karcher William,0,12,0,0
1683722956145,ECE 101,A01,185628,Staff,14,0,70,56
1683722957171,ECE 107,A01,185635,Baghdadchi; Saharnaz,0,0,20,20
1683722957171,ECE 107,A02,185638,Baghdadchi; Saharnaz,1,0,20,19
1683722958202,ECE 148,A01,185647,Silberman; Jack,0,0,16,16
1683722959290,ECON 1,A01,185537,Crane; Meredith Helen,54,0,70,16
1683722960317,ECON 3,A01,185549,Crane; Meredith Helen,30,0,70,40
1683722961345,ECON 4,A01,203354,Anderson; John Charles,0,5,10,10
1683722962371,ECON 100A,A01,185574,Staff,0,5,40,40
1683722963395,ECON 100B,A01,185576,Staff,0,12,50,50
1683722964422,ECON 100C,A01,185589,Newhouse; Herbert S,30,0,70,40
1683722965449,ECON 105,A00,185608,Vespa; Emanuel Ignacio,19,0,35,16
1683722966473,ECON 109,A01,185610,Shishkin; Denis,9,0,35,26
1683722967499,ECON 110A,A01,185612,Staff,8,0,40,32
1683722968525,ECON 120A,A01,185615,Staff,19,0,40,21
1683722969557,ECON 120C,A01,185617,Sun; Yixiao,0,21,70,70
1683722970588,ECON 144,A00,203346,Squires; Dale E,2,0,35,33
1683722971616,ECON 171,A01,203349,Newhouse; Herbert S,0,1,35,35
1683722972641,ECON 173A,A01,185621,Toda; Alexis Akira,21,0,35,14
1683722973671,EDS 25,A01,202413,Staff,0,1,0,0
1683722973671,EDS 25,A02,202414,Staff,0,1,0,0
1683722973671,EDS 25,A03,202415,Staff,0,0,0,0
1683722973671,EDS 25,A04,202416,Staff,0,1,0,0
1683722973671,EDS 25,A05,202439,Staff,0,0,0,0
1683722973671,EDS 25,A06,202440,Staff,0,0,0,0
1683722973671,EDS 25,B01,202631,Staff,0,0,0,0
1683722973671,EDS 25,B02,202632,Staff,0,0,0,0
1683722973671,EDS 25,B03,202639,Staff,0,0,0,0
1683722973671,EDS 25,B04,202640,Staff,0,0,0,0
1683722973671,EDS 25,B05,202643,Staff,0,0,0,0
1683722973671,EDS 25,B06,202644,Staff,0,0,0,0
1683722974703,EDS 38,A01,202659,Black; Alison Michelle,25,0,25,0
1683722975727,EDS 115,A00,202652,Staff,18,0,30,12
1683722976756,EDS 125,A00,202649,Staff,13,0,30,17
1683722977786,EDS 126,A01,203332,Staff,30,0,30,0
1683722978815,EDS 139,A00,202838,Staff,16,0,25,9
1683722979840,EDS 146,A01,202655,Staff,14,0,25,11
1683722980866,ENG 15,A00,185667,Staff,0,1,0,0
1683722980866,ENG 15,B00,185672,Staff,0,0,0,0
1683722980866,ENG 15,C00,185675,Staff,0,0,0,0
1683722980866,ENG 15,D00,185682,Staff,0,0,0,0
1683722980866,ENG 15,E00,185684,Staff,0,0,0,0
1683722981891,ETHN 103,A00,185710,Staff,0,8,35,35
1683722982916,ETHN 103A,A00,199228,Man; Simeon S,0,0,9,9
1683722983941,ETHN 109,A00,185711,Staff,15,0,35,20
1683722984971,ETHN 142,A00,185726,Staff,0,4,30,30
1683722985998,ETHN 163J,A00,199229,Man; Simeon S,5,0,8,3
1683722987028,ETHN 168,A00,185727,Staff,7,0,10,3
1683722988086,ETHN 182,A00,185728,Staff,0,0,35,35
1683722989115,ETHN 183,A00,185737,Staff,10,0,18,8
1683722990143,GLBH 111,A01,209361,Burgos; Jose L.,0,0,0,0
1683722992209,HIEU 104,A00,185792,Staff,14,0,20,6
1683722993239,HIEU 115,A00,185800,Staff,0,0,20,20
1683722994270,HIEU 128,A00,185801,Staff,0,9,20,20
1683722995296,HIEU 147,A00,185802,Staff,15,0,20,5
1683722996322,HIEU 154,A00,185823,Staff,11,0,20,9
1683722997348,HILA 102,A00,185826,Staff,14,0,20,6
1683722998373,HILD 2C,A01,185778,Staff,0,13,20,20
1683722999403,HILD 7B,A01,185780,Kwak; Nancy,0,17,32,32
1683722999403,HILD 7B,A02,185781,Kwak; Nancy,0,18,32,32
1683723000427,HILD 30,A01,185791,Staff,12,0,20,8
1683723001457,HISC 119,A00,185830,Golan; Tal,0,10,20,20
1683723002492,HITO 156GS,A00,185831,Patterson; Patrick H.,0,0,0,23
1683723003519,HIUS 103,A00,185832,Man; Simeon S,0,4,20,20
1683723004546,HIUS 117,A00,185836,Kwak; Nancy,2,0,20,18
1683723005576,HIUS 125,A00,185840,Man; Simeon S,0,2,23,23
1683723006602,HIUS 149,A00,185845,Staff,1,0,20,19
1683723007637,HUM 3,A01,185882,Zavodny; Tatiana Sophia,0,8,50,50
1683723007637,HUM 3,B01,185899,Caldwell; Michael Alan,0,18,50,50
1683723008664,HUM 3GS,A00,185900,Patterson; Patrick H.,0,0,0,23
1683723009699,HUM 4,A01,185938,Zroka; Amy Liane,28,0,50,22
1683723009699,HUM 4,B01,185956,Watkins; Eric,0,6,50,50
1683723009699,HUM 4,B02,202209,Watkins; Eric,0,6,50,50
1683723009699,HUM 4,B03,202210,Watkins; Eric,0,5,50,50
1683723010731,HUM 5,A01,185958,West; Geoffrey Scott,0,0,50,50
1683723010731,HUM 5,A02,202215,West; Geoffrey Scott,0,1,50,50
1683723011762,INTL 190,A00,185959,Gagnon; Jeffrey C,0,0,0,9
1683723011762,INTL 190,B00,185960,Lettieri; Michael Joseph,0,0,0,2
1683723012787,JAPN 180,A00,254509,Staff,4,0,30,26
1683723013824,LATI 10,A01,202853,Kennemore; Amy Michelle,4,0,35,31
1683723013824,LATI 10,A02,202854,Kennemore; Amy Michelle,3,0,35,32
1683723013824,LATI 10,A03,270054,Kennemore; Amy Michelle,30,0,30,0
1683723014850,LATI 180,A00,202855,Kennemore; Amy Michelle,11,0,20,9
1683723015874,LAWS 101,A00,201767,Golan; Tal,0,7,40,40
1683723016900,LIFR 1C,A00,185961,Staff,6,0,20,14
1683723017933,LIFR 1CX,A00,185962,Staff,7,0,20,13
1683723018963,LIFR 1D,A00,185963,Staff,7,0,20,13
1683723019995,LIFR 1DX,A00,185964,Staff,7,0,20,13
1683723021026,LIGN 101,A01,186039,Staff,43,0,50,7
1683723022057,LIGN 165,A00,186040,Staff,14,0,50,36
1683723023083,LTCS 108,A00,186041,Staff,5,0,10,5
1683723024108,LTCS 119,A00,186042,Staff,15,0,20,5
1683723025137,LTCS 130,A00,186043,Wesling; Megan E.,15,0,25,10
1683723027193,LTEA 138,A00,186119,Staff,13,0,40,27
1683723028218,LTEN 124,A00,186148,Staff,5,0,25,20
1683723029248,LTEN 178,A00,186149,Staff,6,0,15,9
1683723030276,LTEN 181,A00,186150,Blanco; John D,34,0,40,6
1683723031310,LTWL 120,A00,186160,Staff,19,0,25,6
1683723032340,LTWL 165,A00,186161,Staff,22,0,25,3
1683723033367,LTWR 100,A00,186162,Staff,0,5,15,15
1683723034396,LTWR 102,A00,186163,Doller; Ben,5,0,15,10
1683723035429,MAE 8,A01,186412,Staff,0,1,0,0
1683723036458,MAE 30B,A00,186445,Bahadori; Mohammad Yousef,81,0,100,19
1683723037483,MAE 40,A00,186592,Bewley; Thomas R,10,0,50,40
1683723038509,MAE 101B,A00,186593,Bahadori; Mohammad Yousef,80,0,100,20
1683723039540,MAE 105,A00,186594,Bandaru; Prabhakar,10,0,50,40
1683723040566,MAE 107,A00,186599,Pham; Hieu Tan,0,8,120,120
1683723041596,MAE 148,A01,186660,Silberman; Jack,3,0,16,13
1683723042621,MATH 10A,A01,188095,Staff,0,6,35,35
1683723043647,MATH 10B,A01,188097,Bowers; Adam R.,0,12,30,30
1683723043647,MATH 10B,A02,188099,Bowers; Adam R.,0,11,30,30
1683723043647,MATH 10B,B01,188104,Bowers; Adam R.,0,10,30,30
1683723043647,MATH 10B,B02,188106,Bowers; Adam R.,0,9,30,30
1683723044679,MATH 10C,A01,188111,Staff,0,20,30,30
1683723044679,MATH 10C,A02,188127,Staff,0,19,30,30
1683723044679,MATH 10C,A03,188131,Staff,0,19,30,30
1683723044679,MATH 10C,B01,188218,Staff,17,0,30,13
1683723044679,MATH 10C,B02,188244,Staff,13,0,30,17
1683723044679,MATH 10C,B03,188277,Staff,14,0,30,16
1683723045707,MATH 18,A01,188344,Bach; Quang Tran,18,0,30,12
1683723045707,MATH 18,A02,188345,Bach; Quang Tran,11,0,30,19
1683723045707,MATH 18,B01,188353,Bach; Quang Tran,11,0,30,19
1683723045707,MATH 18,B02,188354,Bach; Quang Tran,19,0,30,11
1683723046734,MATH 20A,A01,188374,Staff,11,0,35,24
1683723047764,MATH 20B,A01,188382,Ohm; Ko Woon,7,0,30,23
1683723047764,MATH 20B,A02,188383,Ohm; Ko Woon,22,0,30,8
1683723047764,MATH 20B,B01,188385,Ohm; Ko Woon,7,0,30,23
1683723047764,MATH 20B,B02,188392,Ohm; Ko Woon,22,0,30,8
1683723048797,MATH 20C,A01,188394,Harel; Guershon,10,0,30,20
1683723048797,MATH 20C,A02,188395,Harel; Guershon,13,0,30,17
1683723048797,MATH 20C,B01,188404,Harel; Guershon,5,0,30,25
1683723048797,MATH 20C,B02,188405,Harel; Guershon,18,0,30,12
1683723049826,MATH 20D,A01,188414,Hammock; Frances H,0,1,30,30
1683723049826,MATH 20D,A02,188415,Hammock; Frances H,0,1,30,30
1683723049826,MATH 20D,B01,188447,Hammock; Frances H,0,1,30,30
1683723049826,MATH 20D,B02,188486,Hammock; Frances H,2,0,30,28
1683723050853,MATH 20E,A01,188649,Staff,21,0,30,9
1683723050853,MATH 20E,A02,188650,Staff,20,0,30,10
1683723050853,MATH 20E,A03,188673,Staff,0,0,30,30
1683723051878,MATH 102,A01,188675,Staff,0,40,35,35
1683723052909,MATH 103B,A01,188681,Staff,3,0,35,32
1683723052909,MATH 103B,B01,188692,Staff,5,0,35,30
1683723053935,MATH 109,A01,188695,Salehi Golsefidy; Alireza,24,0,35,11
1683723053935,MATH 109,A02,188696,Salehi Golsefidy; Alireza,24,0,35,11
1683723054966,MATH 120A,A01,188698,Eggers; John Dietrich,7,0,35,28
1683723055996,MATH 142B,A01,188736,Ioana; Adrian,0,0,30,30
1683723055996,MATH 142B,A02,188741,Ioana; Adrian,0,1,30,30
1683723055996,MATH 142B,A03,188743,Ioana; Adrian,0,3,30,30
1683723057022,MATH 168A,A01,188790,Staff,0,11,35,35
1683723058054,MATH 170A,A01,188803,Nie; Jiawang,0,2,35,35
1683723058054,MATH 170A,A02,188811,Nie; Jiawang,0,1,35,35
1683723058054,MATH 170A,A03,188814,Nie; Jiawang,1,0,35,34
1683723058054,MATH 170A,A04,188815,Nie; Jiawang,5,0,35,30
1683723059079,MATH 193B,A01,188817,Staff,0,0,35,35
1683723059079,MATH 193B,A02,188818,Staff,6,0,35,29
1683723060110,MGT 4,A01,202857,Anderson; John Charles,59,0,80,21
1683723061136,MGT 12,A00,202858,Lindenberger; Wade Douglas,40,0,90,50
1683723062165,MGT 18,A00,202859,Staff,73,0,90,17
1683723063244,MGT 18GS,A00,202860,McKay; Michael J,13,0,28,15
1683723064269,MGT 45,A00,202861,Pecore; Joseph P.,8,0,90,82
1683723065298,MGT 100,A00,202863,Yavorsky; Daniel Ryan,27,0,90,63
1683723066323,MGT 103,A00,202864,Ehrich; Kristine R,0,19,90,90
1683723067346,MGT 112,A00,202865,Ehrich; Kristine R,15,0,90,75
1683723068372,MGT 121A,A00,202868,Staff,70,0,90,20
1683723070403,MGT 131B,A00,202869,Anderson; John Charles,58,0,90,32
1683723071431,MGT 136,A00,202871,Lindenberger; Wade Douglas,83,0,90,7
1683723072461,MGT 164,A00,202873,Staff,0,67,90,91
1683723073486,MGT 164GS,A00,202874,McKay; Mary A,13,0,28,15
1683723074512,MGT 180,A00,202875,Staff,0,51,90,91
1683723075539,MMW 11R,A01,205019,Herbst; Matthew,0,0,30,30
1683723075539,MMW 11R,A02,205026,Herbst; Matthew,29,0,30,1
1683723076565,MMW 15,A01,193512,Chang; Edmond Yi-Teh,0,8,28,28
1683723076565,MMW 15,A02,193513,Chang; Edmond Yi-Teh,0,5,28,28
1683723076565,MMW 15,A03,193514,Chang; Edmond Yi-Teh,0,5,28,28
1683723076565,MMW 15,A04,193515,Chang; Edmond Yi-Teh,0,5,28,28
1683723076565,MMW 15,A05,193516,Chang; Edmond Yi-Teh,0,5,28,28
1683723076565,MMW 15,A06,193517,Chang; Edmond Yi-Teh,0,6,28,28
1683723076565,MMW 15,B01,193519,Chang; Edmond Yi-Teh,0,5,28,28
1683723076565,MMW 15,B02,193520,Chang; Edmond Yi-Teh,0,5,28,28
1683723076565,MMW 15,B03,193521,Chang; Edmond Yi-Teh,0,5,28,28
1683723076565,MMW 15,B04,193522,Chang; Edmond Yi-Teh,0,6,28,28
1683723076565,MMW 15,B05,193523,Chang; Edmond Yi-Teh,0,5,28,28
1683723076565,MMW 15,B06,193524,Chang; Edmond Yi-Teh,0,5,28,28
1683723077591,MMW 122,A01,193526,Rahimi; Babak,0,16,28,28
1683723077591,MMW 122,A02,193527,Rahimi; Babak,0,15,28,28
1683723077591,MMW 122,A03,193528,Rahimi; Babak,0,0,0,0
1683723077591,MMW 122,A04,193529,Rahimi; Babak,0,0,0,0
1683723078618,MUS 1A,A01,186663,Staff,0,18,35,35
1683723079645,MUS 4,A01,186715,Staff,0,12,35,35
1683723080675,MUS 5R,A01,186796,Dubnov; Shlomo,0,17,35,35
1683723081701,MUS 6,A01,186798,Staff,0,4,25,25
1683723082740,MUS 7,A01,186830,Staff,11,0,35,24
1683723083767,MUS 8,A01,186930,Staff,0,27,35,35
1683723084794,MUS 15,A01,186932,Staff,0,15,35,35
1683723084794,MUS 15,B01,186934,Staff,0,16,35,35
1683723085819,MUS 80,A00,186935,Staff,0,0,20,20
1683723085819,MUS 80,B00,186936,Staff,24,0,25,1
1683723086850,NANO 11,A00,204702,Lipomi; Darren John,0,0,0,0
1683723087880,NANO 15,A01,204709,Yang; Kesong,0,1,0,0
1683723088908,NANO 114,A00,202069,Jahed Motlagh; Zeinab,2,0,10,8
1683723089930,PHIL 1,A00,186955,Grush; Rick Scott,31,0,40,9
1683723090954,PHIL 10,A01,186973,Grush; Rick Scott,27,0,35,8
1683723090954,PHIL 10,A02,186974,Grush; Rick Scott,33,0,35,2
1683723091984,PHIL 13,A01,186976,Staff,1,0,35,34
1683723091984,PHIL 13,A02,186977,Staff,16,0,35,19
1683723093018,PHIL 14,A01,186979,Staff,30,0,35,5
1683723093018,PHIL 14,A02,186986,Staff,32,0,35,3
1683723094043,PHIL 28,A01,186988,Staff,16,0,30,14
1683723094043,PHIL 28,A02,186989,Staff,0,0,30,30
1683723094043,PHIL 28,A03,186990,Staff,10,0,30,20
1683723094043,PHIL 28,A04,186991,Staff,26,0,30,4
1683723095068,PHIL 120,A00,186997,Staff,23,0,40,17
1683723096096,PHIL 137,A00,187003,Staff,8,0,40,32
1683723097124,PHIL 150,A00,187015,Staff,47,0,70,23
1683723098152,PHIL 167,A00,187021,Lamey; Andy M.,34,0,40,6
1683723099181,PHIL 174,A01,202226,Staff,17,0,20,3
1683723099181,PHIL 174,A02,202235,Staff,20,0,20,0
1683723100206,PHIL 191A,A00,258918,Staff,0,0,1,1
1683723101232,PHYS 1A,A00,187028,Staff,26,0,60,34
1683723102263,PHYS 1AL,001,187036,Staff,3,0,30,27
1683723102263,PHYS 1AL,002,187049,Staff,18,0,30,12
1683723103290,PHYS 1B,A00,187058,Staff,21,0,60,39
1683723104320,PHYS 1BL,001,187064,Staff,0,1,30,30
1683723104320,PHYS 1BL,002,187070,Staff,4,0,30,26
1683723105350,PHYS 1C,A00,187082,Staff,30,0,120,90
1683723106382,PHYS 1CL,001,187088,Staff,0,9,30,30
1683723106382,PHYS 1CL,002,187089,Staff,0,1,30,30
1683723106382,PHYS 1CL,009,262693,Staff,9,0,30,21
1683723107409,PHYS 2B,A01,187097,Staff,55,0,115,60
1683723108434,PHYS 2C,A01,187099,Staff,63,0,115,52
1683723109460,PHYS 2CL,A01,187101,Staff,5,0,28,23
1683723109460,PHYS 2CL,A02,187102,Staff,15,0,28,13
1683723110486,PHYS 2D,A01,187123,Shotwell; Brian,95,0,115,20
1683723111515,PHYS 4B,A01,187133,Grinstein; Benjamin,35,0,50,15
1683723112541,POLI 10,A00,188819,Staff,0,4,50,50
1683723113567,POLI 11,A00,188827,Staff,43,0,50,7
1683723114591,POLI 13R,A00,188828,Staff,0,2,20,20
1683723115619,POLI 27,A01,188830,Elgin; Samuel Zincke,0,2,70,70
1683723116647,POLI 30,A00,188832,Desposato; Scott,30,0,50,20
1683723117675,POLI 102F,A00,188834,Staff,1,0,40,39
1683723118700,POLI 104A,A00,188852,Staff,12,0,30,18
1683723119726,POLI 104I,A00,188853,Staff,0,8,20,20
1683723120754,POLI 110B,A00,188854,Wiens; David,6,0,20,14
1683723121780,POLI 112A,A00,188855,Wiens; David,3,0,30,27
1683723122806,POLI 117R,A00,188856,Forman; Fonna,0,12,20,20
1683723123833,POLI 118,A00,188857,Ingham; Sean,8,0,20,12
1683723124864,POLI 120G,A00,188858,Staff,7,0,30,23
1683723125891,POLI 131CR,A00,188863,Hoston; Germaine,20,0,50,30
1683723126920,POLI 133,A00,188864,Nellis; Gareth Hb,44,0,50,6
1683723127950,POLI 134D,A00,188865,Desposato; Scott,27,0,30,3
1683723128977,POLI 142A,A00,188871,Gartzke; Erik,21,0,50,29
1683723130007,POLI 142K,A00,188874,Staff,38,0,50,12
1683723131033,POLI 143,A00,188940,Gartzke; Erik,15,0,30,15
1683723132059,POLI 153,A00,188943,Staff,1,0,20,19
1683723133083,POLI 160AA,A00,188944,Staff,10,0,40,30
1683723134109,POLI 170A,A00,188945,Staff,10,0,30,20
1683723136165,PSYC 1,A00,188952,Staff,36,0,90,54
1683723137200,PSYC 2,B00,188953,Staff,19,0,35,16
1683723138226,PSYC 6,A00,188970,Staff,47,0,60,13
1683723139255,PSYC 7,A00,188973,Staff,35,0,45,10
1683723140282,PSYC 60,A01,188980,Rickard; Timothy C.,42,0,60,18
1683723141323,PSYC 70,A01,189001,Steiner; Eric Tomas,22,0,45,23
1683723142351,PSYC 100,A00,189005,Lacefield; Katharine I,1,98,120,119
1683723143378,PSYC 102,A00,189008,Staff,6,0,30,24
1683723144404,PSYC 106,B00,189026,Gorman; Michael R.,27,0,60,33
1683723145428,PSYC 114,B01,189033,Winkielman; Piotr,0,31,30,30
1683723146453,PSYC 131,A00,189036,Anagnostaras; Stephan,0,44,60,60
1683723147484,PSYC 136,A00,189041,Lowe; Angela Beth,0,7,25,25
1683723148509,PSYC 137,A00,189057,Winkielman; Piotr,0,36,25,25
1683723149537,PSYC 144,A00,189107,Wixted; John T,0,11,50,50
1683723151590,PSYC 162,A00,189142,Staff,0,9,85,85
1683723152619,PSYC 172,A00,189144,Gorman; Michael R.,0,6,30,30
1683723154677,PSYC 179,A00,189146,Lacefield; Katharine I,0,88,120,120
1683723155702,PSYC 181,A00,189147,Anagnostaras; Stephan,0,45,90,90
1683723156727,PSYC 190R,A00,189148,Barner; David A.,0,23,80,80
1683723157766,PSYC 191,A00,189275,Rickard; Timothy C.,0,11,25,25
1683723158791,PSYC 193,A00,189276,Chapman; Eddie Nathaniel,0,1,0,4
1683723159818,PSYC 193L,A01,189281,Lowe; Angela Beth,8,0,20,12
1683723159818,PSYC 193L,B01,189285,Staff,28,0,35,7
1683723160842,RELI 149,A00,187137,Rahimi; Babak,6,0,40,34
1683723161869,SE 9,A01,187315,Staff,0,2,18,18
1683723162897,SE 101B,A00,187409,Staff,24,0,30,6
1683723163928,SE 110B,A00,187444,Staff,10,0,40,30
1683723164955,SE 130B,A00,187449,Staff,31,0,40,9
1683723165983,SE 150A,A00,187516,Staff,8,0,20,12
1683723167010,SE 154,A00,187528,Staff,29,0,50,21
1683723168101,SIO 3,A01,258171,Staff,35,0,40,5
1683723169130,SIO 10,A00,187144,Cook; Geoffrey W,0,6,75,75
1683723170155,SIO 45,A00,187152,Cook; Geoffrey W,1,7,100,99
1683723171183,SIO 109R,A00,194486,Staff,0,4,20,20
1683723173238,SIO 187,A01,187233,Kacev; David,12,0,40,28
1683723174272,SOCI 1,A01,258656,Thorpe; Charles Robert,28,0,30,2
1683723174272,SOCI 1,A02,258658,Thorpe; Charles Robert,30,0,30,0
1683723174272,SOCI 1,A03,258661,Thorpe; Charles Robert,25,0,25,0
1683723174272,SOCI 1,A04,258666,Thorpe; Charles Robert,22,0,25,3
1683723174272,SOCI 1,A05,258897,Thorpe; Charles Robert,22,0,25,3
1683723174272,SOCI 1,A06,258898,Thorpe; Charles Robert,25,0,25,0
1683723175299,SOCI 30,A01,258903,Pardo Guerra; Juan Pablo,14,0,30,16
1683723176326,SOCI 102,A00,258904,Staff,9,0,25,16
1683723177352,SOCI 106,A00,258905,Staff,19,0,25,6
1683723178376,SOCI 111,A00,258907,Ribas Norris; Janet Vanesa,26,0,30,4
1683723179400,SOCI 121R,A00,258908,Pardo Guerra; Juan Pablo,7,0,30,23
1683723180425,SOCI 126,A01,203330,Staff,14,0,20,6
1683723181455,SOCI 131,A00,258909,Thorpe; Charles Robert,30,0,60,30
1683723182480,SOCI 135,A00,258910,Payne; Christine Anna,0,13,30,30
1683723183506,SOCI 157,A00,258911,Staff,10,0,30,20
1683723184533,SOCI 184,A00,258912,Staff,25,0,30,5
1683723185562,SOCI 188D,A00,258913,Staff,22,0,30,8
1683723186597,SYN 2,001,187529,Staff,9,0,16,7
1683723186597,SYN 2,002,201452,Staff,0,20,16,16
1683723186597,SYN 2,003,201469,Staff,1,0,16,15
1683723187628,SYN 100,A01,187531,Staff,0,9,20,20
1683723187628,SYN 100,B01,201491,Staff,0,10,20,20
1683723188656,TDAC 1,A00,189286,Walsh; Kim C.,3,0,20,17
1683723188656,TDAC 1,B00,189287,Harting; Carla Kelso,10,0,20,10
1683723189684,TDAC 101,A00,189300,Walsh; Kim C.,16,0,20,4
1683723189684,TDAC 101,B00,189301,Harting; Carla Kelso,18,0,20,2
1683723190710,TDAC 102,A00,189304,Basso; Beatrice,14,0,20,6
1683723191740,TDAC 108,A00,189305,Staff,18,0,20,2
1683723192773,TDDE 131,A00,189310,Staff,19,0,20,1
1683723192773,TDDE 131,B00,189314,Staff,19,0,20,1
1683723192773,TDDE 131,C00,189315,Staff,48,0,50,2
1683723192773,TDDE 131,D00,189316,Staff,14,0,15,1
1683723192773,TDDE 131,E00,204841,Staff,20,0,20,0
1683723193804,TDGE 10,A00,189289,Staff,26,0,50,24
1683723193804,TDGE 10,B00,189290,Havis; Allan,0,1,50,50
1683723194834,TDGE 11,A00,189291,Fulton; Julia,0,4,50,50
1683723194834,TDGE 11,B00,189292,Staff,20,0,25,5
1683723194834,TDGE 11,C00,260270,Staff,0,0,0,0
1683723195861,TDGE 25,A00,189294,Staff,1,0,20,19
1683723196888,TDGE 124,A00,189318,Fulton; Julia,0,7,50,50
1683723197914,TDGE 125,A00,189319,Staff,13,0,25,12
1683723197914,TDGE 125,B00,189320,Staff,23,0,25,2
1683723198944,TDGE 127,A00,189322,Havis; Allan,1,0,50,49
1683723199977,TDHT 101,A00,189323,Staff,18,0,25,7
1683723199977,TDHT 101,B00,189324,Staff,25,0,25,0
1683723201002,TDHT 102,A00,189325,Staff,49,0,50,1
1683723202028,TDMV 1,A00,189295,Arcidiacono; Kristin,20,0,30,10
1683723202028,TDMV 1,B00,189296,Caligagan; Maria T.,23,0,30,7
1683723203058,TDMV 2,A00,189297,Sammartano; Tonnie,27,0,30,3
1683723203058,TDMV 2,B00,189299,Arcidiacono; Kristin,23,0,30,7
1683723204089,TDMV 3,A00,204998,Rincon; Alicia,22,0,30,8
1683723205115,TDMV 120,A00,189458,Sammartano; Tonnie,28,0,30,2
1683723206144,TDMV 138,A00,189541,Jun; Grace Shin Hae,20,0,40,20
1683723207174,TDMV 142,A00,189717,Caligagan; Tony,25,0,30,5
1683723207174,TDMV 142,B00,189718,Caligagan; Maria T.,25,0,30,5
1683723208199,TMC 2,A01,187533,Staff,25,0,25,0
1683723208199,TMC 2,A02,187534,Staff,25,0,25,0
1683723209228,USP 1,A01,187536,Kwak; Nancy,0,16,25,25
1683723210253,USP 5,A01,187538,Staff,8,0,25,17
1683723211278,USP 101,A00,199253,Staff,0,4,0,0
1683723212304,USP 124,A00,187562,Boomhower; Matthew Charles,0,0,30,30
1683723213331,USP 138,A00,187582,Staff,19,0,25,6
1683723214357,USP 152,A01,187597,Staff,3,0,25,22
1683723215380,USP 153,A00,187598,Staff,18,0,25,7
1683723216410,USP 168,A00,187607,Kwak; Nancy,2,0,5,3
1683723217434,USP 173,A00,187619,Staff,4,0,25,21
1683723218461,USP 181,A00,187638,Staff,0,4,25,25
1683723219486,VIS 103,A00,187650,Cruz; Edwin Teddy,17,0,75,58
1683723220510,VIS 110D,A00,187669,Staff,13,0,22,9
1683723221535,VIS 127C,A00,187720,Shen; Kuiyi,67,0,146,79
1683723222560,VIS 149,A00,187731,Yoldas; Pinar,0,12,22,22
1683723223588,VIS 151,A01,188091,Staff,22,0,34,12
1683723223588,VIS 151,A02,188092,Staff,11,0,34,23
1683723224613,VIS 160B,A00,188093,Stalbaum; Brett,0,1,10,10
1683723226665,WCWP 10B,A00,201720,Staff,0,0,5,5
1683723226665,WCWP 10B,B00,201722,Staff,0,0,6,6
1683723227690,WCWP 100,A00,201725,Gagnon; Jeffrey C,0,0,2,2
1683723227690,WCWP 100,B00,201727,Staff,0,4,15,15
1683723230828,ANBI 133,A00,258401,Wilder; Linnea Lorene,34,0,40,6
1683723231854,ANBI 140,A00,258395,Hrvoj Mihic; Branka,18,0,25,7
1683723232878,ANSC 120,A00,258402,Bialecki; Jon Anthony,26,0,40,14
1683723233905,ANSC 144,A00,258400,Staff,12,0,40,28
1683723235958,ANSC 166,A00,258396,Parish; Steven Martin,156,0,175,19
1683723236987,ANSC 180,A00,193533,Staff,8,0,20,12
1683723238016,ANSC 188,A00,258397,Jassal; Aftab,34,0,40,6
1683723239044,ANTH 3,A01,258316,Staff,23,0,30,7
1683723240070,ANTH 5,A00,258394,Semendeferi; Ekaterini,16,0,20,4
1683723241094,ANTH 21,A01,258331,Staff,4,0,40,36
1683723242120,ANTH 103,A00,258398,Varma; Saiba,15,0,25,10
1683723243149,AWP 10,001,202034,Staff,0,0,0,0
1683723243149,AWP 10,002,202035,Staff,0,0,0,0
1683723243149,AWP 10,003,202036,Staff,0,0,0,0
1683723243149,AWP 10,004,202037,Staff,0,0,0,0
1683723243149,AWP 10,005,202038,Staff,0,0,0,0
1683723243149,AWP 10,006,202039,Staff,0,0,0,0
1683723243149,AWP 10,007,202040,Staff,0,0,0,0
1683723243149,AWP 10,008,202041,Staff,0,0,0,0
1683723243149,AWP 10,009,202042,Staff,0,0,0,0
1683723243149,AWP 10,010,202043,Staff,0,0,0,0
1683723243149,AWP 10,011,202044,Staff,0,0,0,0
1683723243149,AWP 10,012,202045,Staff,0,0,0,0
1683723243149,AWP 10,013,202046,Staff,0,0,0,0
1683723243149,AWP 10,014,202047,Staff,0,0,0,0
1683723243149,AWP 10,015,202048,Staff,0,0,0,0
1683723243149,AWP 10,016,202049,Staff,0,0,0,0
1683723243149,AWP 10,017,202050,Staff,0,0,0,0
1683723243149,AWP 10,018,202051,Staff,0,0,0,0
1683723243149,AWP 10,019,202052,Staff,0,0,0,0
1683723243149,AWP 10,020,202053,Staff,0,0,0,0
1683723243149,AWP 10,021,202054,Staff,0,0,0,0
1683723243149,AWP 10,022,202055,Staff,0,0,0,0
1683723243149,AWP 10,023,202056,Staff,0,0,0,0
1683723243149,AWP 10,024,202057,Staff,0,0,0,0
1683723243149,AWP 10,025,202058,Staff,0,0,0,0
1683723243149,AWP 10,026,202059,Staff,0,0,0,0
1683723244175,AWP 102,001,202032,Staff,0,0,0,0
1683723244175,AWP 102,002,202033,Staff,0,0,0,0
1683723245206,BENG 100,A01,254234,Taylor Amos; Alyssa C,31,0,40,9
1683723246236,BENG 196,001,270013,Engler; Adam J.,9999,0,9999,0
1683723247263,BICD 100R,A01,202018,Smith; Laurie,0,7,32,32
1683723247263,BICD 100R,A02,202019,Smith; Laurie,0,3,32,32
1683723247263,BICD 100R,A03,202020,Smith; Laurie,0,1,32,32
1683723247263,BICD 100R,A04,202021,Smith; Laurie,6,0,32,26
1683723247263,BICD 100R,A05,202022,Smith; Laurie,10,0,32,22
1683723248295,BICD 136,A01,193242,Gustafson-Brown; Cindy,0,2,32,32
1683723248295,BICD 136,A02,193244,Gustafson-Brown; Cindy,13,0,32,19
1683723249323,BIEB 102,A01,193249,Butler; Shannon Rhey,0,0,32,32
1683723249323,BIEB 102,A02,193251,Butler; Shannon Rhey,0,0,32,32
1683723249323,BIEB 102,A03,193253,Butler; Shannon Rhey,0,0,32,32
1683723249323,BIEB 102,A04,193255,Butler; Shannon Rhey,13,0,32,19
1683723249323,BIEB 102,A05,193265,Butler; Shannon Rhey,25,0,32,7
1683723249323,BIEB 102,A06,193269,Butler; Shannon Rhey,12,0,32,20
1683723251381,BIEB 150,A01,193274,Staff,0,0,32,32
1683723251381,BIEB 150,A02,193285,Staff,24,0,32,8
1683723252407,BIEB 194,A00,193286,Kurle; Carolyn M.,19,0,32,13
1683723253441,BILD 1,A01,192291,Staff,15,0,32,17
1683723253441,BILD 1,A02,192292,Staff,30,0,32,2
1683723253441,BILD 1,B01,192520,Reuther; Keefe,0,1,0,0
1683723253441,BILD 1,B02,192532,Reuther; Keefe,0,1,0,0
1683723254472,BILD 3,A01,192556,Butler; Shannon Rhey,0,0,32,32
1683723254472,BILD 3,A02,192581,Butler; Shannon Rhey,0,1,32,32
1683723254472,BILD 3,A03,192611,Butler; Shannon Rhey,19,0,32,13
1683723254472,BILD 3,A04,192612,Butler; Shannon Rhey,23,0,32,9
1683723254472,BILD 3,A05,192613,Butler; Shannon Rhey,26,0,32,6
1683723254472,BILD 3,A06,192679,Butler; Shannon Rhey,27,0,32,5
1683723254472,BILD 3,A07,192682,Butler; Shannon Rhey,20,0,32,12
1683723255498,BILD 4,A01,192836,Reuther; Keefe,1,0,24,23
1683723255498,BILD 4,A02,193044,Reuther; Keefe,4,0,24,20
1683723256523,BILD 10,A01,193142,Gustafson-Brown; Cindy,29,0,32,3
1683723256523,BILD 10,A02,193149,Gustafson-Brown; Cindy,31,0,32,1
1683723257548,BIMM 100,A01,193301,Staff,0,6,32,32
1683723257548,BIMM 100,A02,193312,Staff,0,7,32,32
1683723257548,BIMM 100,A03,193323,Staff,0,10,32,32
1683723258580,BIMM 101,A01,193329,McDonnell; Lisa Marie,0,3,24,24
1683723258580,BIMM 101,A02,193339,McDonnell; Lisa Marie,0,3,24,24
1683723258580,BIMM 101,B01,193354,McDonnell; Lisa Marie,0,4,24,24
1683723258580,BIMM 101,B02,193357,McDonnell; Lisa Marie,0,3,24,24
1683723259610,BIMM 110,A01,193377,Tat; John,0,11,32,32
1683723259610,BIMM 110,A02,193378,Tat; John,0,11,32,32
1683723260637,BIMM 120,A01,206116,Staff,0,0,32,32
1683723260637,BIMM 120,A02,206117,Staff,7,0,32,25
1683723260637,BIMM 120,A03,206121,Staff,21,0,32,11
1683723261663,BIPN 100,A01,193393,Park; Ji Young,0,15,32,32
1683723261663,BIPN 100,A02,193402,Park; Ji Young,0,14,32,32
1683723261663,BIPN 100,A03,193413,Park; Ji Young,0,14,32,32
1683723261663,BIPN 100,A04,193414,Park; Ji Young,0,13,32,32
1683723262692,BIPN 102,A01,193429,Staff,0,0,32,32
1683723262692,BIPN 102,A02,193438,Staff,18,0,32,14
1683723263720,BIPN 106,A01,193450,Reyes Gonzalez; Catalina,0,2,40,40
1683723264747,BIPN 134,A01,193465,Cooke; James Edward,0,0,32,32
1683723264747,BIPN 134,A02,193474,Cooke; James Edward,25,0,32,7
1683723264747,BIPN 134,A03,193485,Cooke; James Edward,29,0,32,3
1683723264747,BIPN 134,A04,193486,Cooke; James Edward,20,0,32,12
1683723264747,BIPN 134,A05,193491,Cooke; James Edward,31,0,32,1
1683723264747,BIPN 134,A06,193501,Cooke; James Edward,30,0,32,2
1683723264747,BIPN 134,A07,193510,Cooke; James Edward,29,0,32,3
1683723266803,BISP 194,A00,222522,Staff,14,0,32,18
1683723267831,CAT 124,A01,202407,Staff,19,0,25,6
1683723268858,CAT 125,A00,202408,Marchisotto; Jennifer Anne,2,0,20,18
1683723269885,CAT 125R,A00,202409,Smith; Lauryn Alissa,0,11,20,20
1683723269885,CAT 125R,B00,202410,Morales; Celeste Georgianna,0,11,20,20
1683723269885,CAT 125R,C00,202411,Irwin; Matthew Joseph,0,12,20,20
1683723270911,CENG 15,A01,204712,Yang; Kesong,0,1,0,0
1683723272009,CENG 114,A00,202070,Jahed Motlagh; Zeinab,5,0,20,15
1683723273038,CGS 105,A00,185477,Wesling; Megan E.,24,0,40,16
1683723274062,CGS 106,A00,185494,Staff,11,0,22,11
1683723275088,CGS 108,A00,185495,Staff,14,0,20,6
1683723276114,CGS 114,A00,185496,Staff,13,0,18,5
1683723277140,CGS 119,A00,185501,Staff,15,0,20,5
1683723278166,CGS 120,A00,185511,Staff,11,0,20,9
1683723279198,CHEM 4,A01,184675,Bussey; Thomas J,97,0,100,3
1683723280222,CHEM 6A,A01,184677,Staff,32,0,60,28
1683723281246,CHEM 6B,A01,184679,Staff,63,0,100,37
1683723282273,CHEM 6C,A01,184681,Bussey; Thomas J,0,0,50,50
1683723282273,CHEM 6C,A02,184682,Bussey; Thomas J,32,0,50,18
1683723283299,CHEM 40A,A01,184684,Albizati; Kim F.,33,0,100,67
1683723284329,CHEM 40B,A01,184686,Albizati; Kim F.,0,22,100,100
1683723285354,CHEM 41B,A01,184690,Staff,51,0,100,49
1683723286380,COGS 3,A01,184715,Boyle; Mary E. T.,0,27,40,40
1683723287411,COGS 14B,A01,185172,Staff,0,14,38,38
1683723288437,COGS 18,A01,184736,Staff,14,0,80,66
1683723289461,COGS 100,A01,184932,Staff,0,8,73,73
1683723290490,COGS 101A,A01,184935,Staff,0,40,30,30
1683723291518,COGS 101B,A01,184944,Staff,0,2,30,30
1683723292547,COGS 101C,A01,184946,Staff,0,10,30,30
1683723293570,COGS 102A,A01,184951,Johnson; Christine M.,1,0,40,39
1683723294598,COGS 107B,A01,184953,Mooshagian; Eric Frederick,0,52,40,40
1683723295623,COGS 118B,A01,184959,Gupta; Anjum,0,50,40,40
1683723296652,COGS 153,A00,184961,Staff,1,16,30,29
1683723297676,COGS 177,A00,184962,Staff,0,20,30,30
1683723298706,COGS 187A,A01,184969,Boyle; Mary E. T.,0,19,40,40
1683723299735,COMM 10,A01,185174,Staff,0,5,25,25
1683723299735,COMM 10,A02,185189,Staff,0,2,25,25
1683723299735,COMM 10,A03,269821,Staff,0,1,0,0
1683723300760,COMM 100B,A02,185476,Staff,10,0,25,15
1683723300760,COMM 100B,A03,277340,Staff,25,0,25,0
1683723301789,COMM 100C,A01,185314,Staff,2,0,25,23
1683723301789,COMM 100C,A02,185327,Staff,17,0,25,8
1683723302814,COMM 110M,A00,185349,Staff,0,0,40,40
1683723303846,COMM 113T,A00,185352,Staff,25,0,40,15
1683723304873,COMM 114I,A00,185353,Staff,31,0,40,9
1683723305898,COMM 131,A00,185354,Staff,17,0,30,13
1683723306929,CSE 8A,A50,185358,Cao; Yingjun,0,46,10,10
1683723307962,CSE 8B,A01,185362,Staff,0,48,50,50
1683723308986,CSE 11,A01,185416,Cao; Yingjun,0,91,10,10
1683723310011,CSE 20,A01,185445,Briones; Jor-el Thomas Caparas,3,0,25,22
1683723311037,CSE 21,A01,185447,Staff,9,0,50,41
1683723312068,CSE 101,A01,185451,Staff,0,13,50,50
1683723312068,CSE 101,B01,185453,Jones; Miles E,0,15,50,50
1683723314128,CSE 141,A01,185458,Eldon; John,16,0,100,84
1683723315158,CSE 141L,A01,185461,Eldon; John,8,0,100,92
1683723316190,CSE 142,A01,185463,Staff,34,0,60,26
1683723316190,CSE 142,B01,201355,Staff,0,7,60,60
1683723317213,CSE 142L,A01,185470,Staff,34,0,60,26
1683723317213,CSE 142L,B01,201417,Staff,0,6,60,60
1683723318242,CSE 190,A00,201433,Staff,32,0,49,17
1683723319272,DOC 1,A01,259136,Strom; Megan C.,7,0,15,8
1683723319272,DOC 1,A02,259137,Strom; Megan C.,15,0,15,0
1683723319272,DOC 1,A03,259138,Strom; Megan C.,14,0,15,1
1683723319272,DOC 1,A04,259139,Strom; Megan C.,13,0,15,2
1683723320299,DOC 100D,A00,259140,Pass; Natalye Joann,14,0,25,11
1683723321325,DSGN 1,A01,184749,Rill; Bryan,0,26,30,30
1683723322352,DSGN 100,A01,185168,Staff,0,2,25,25
1683723323385,ECE 5,A01,185626,Morris; Karcher William,0,12,0,0
1683723324414,ECE 101,A01,185628,Staff,14,0,70,56
1683723325440,ECE 107,A01,185635,Baghdadchi; Saharnaz,0,0,20,20
1683723325440,ECE 107,A02,185638,Baghdadchi; Saharnaz,1,0,20,19
1683723326464,ECE 148,A01,185647,Silberman; Jack,0,0,16,16
1683723327492,ECON 1,A01,185537,Crane; Meredith Helen,54,0,70,16
1683723328517,ECON 3,A01,185549,Crane; Meredith Helen,30,0,70,40
1683723329546,ECON 4,A01,203354,Anderson; John Charles,0,5,10,10
1683723330570,ECON 100A,A01,185574,Staff,0,5,40,40
1683723331593,ECON 100B,A01,185576,Staff,0,12,50,50
1683723332618,ECON 100C,A01,185589,Newhouse; Herbert S,30,0,70,40
1683723333644,ECON 105,A00,185608,Vespa; Emanuel Ignacio,19,0,35,16
1683723334672,ECON 109,A01,185610,Shishkin; Denis,9,0,35,26
1683723335695,ECON 110A,A01,185612,Staff,8,0,40,32
1683723336723,ECON 120A,A01,185615,Staff,19,0,40,21
1683723337754,ECON 120C,A01,185617,Sun; Yixiao,0,21,70,70
1683723338780,ECON 144,A00,203346,Squires; Dale E,2,0,35,33
1683723339805,ECON 171,A01,203349,Newhouse; Herbert S,0,1,35,35
1683723340834,ECON 173A,A01,185621,Toda; Alexis Akira,21,0,35,14
1683723341863,EDS 25,A01,202413,Staff,0,1,0,0
1683723341863,EDS 25,A02,202414,Staff,0,1,0,0
1683723341863,EDS 25,A03,202415,Staff,0,0,0,0
1683723341863,EDS 25,A04,202416,Staff,0,1,0,0
1683723341863,EDS 25,A05,202439,Staff,0,0,0,0
1683723341863,EDS 25,A06,202440,Staff,0,0,0,0
1683723341863,EDS 25,B01,202631,Staff,0,0,0,0
1683723341863,EDS 25,B02,202632,Staff,0,0,0,0
1683723341863,EDS 25,B03,202639,Staff,0,0,0,0
1683723341863,EDS 25,B04,202640,Staff,0,0,0,0
1683723341863,EDS 25,B05,202643,Staff,0,0,0,0
1683723341863,EDS 25,B06,202644,Staff,0,0,0,0
1683723342889,EDS 38,A01,202659,Black; Alison Michelle,25,0,25,0
1683723343915,EDS 115,A00,202652,Staff,18,0,30,12
1683723344944,EDS 125,A00,202649,Staff,13,0,30,17
1683723345969,EDS 126,A01,203332,Staff,30,0,30,0
1683723346996,EDS 139,A00,202838,Staff,16,0,25,9
1683723348021,EDS 146,A01,202655,Staff,14,0,25,11
1683723349071,ENG 15,A00,185667,Staff,0,1,0,0
1683723349071,ENG 15,B00,185672,Staff,0,0,0,0
1683723349071,ENG 15,C00,185675,Staff,0,0,0,0
1683723349071,ENG 15,D00,185682,Staff,0,0,0,0
1683723349071,ENG 15,E00,185684,Staff,0,0,0,0
1683723350096,ETHN 103,A00,185710,Staff,0,8,35,35
1683723351123,ETHN 103A,A00,199228,Man; Simeon S,0,0,9,9
1683723352148,ETHN 109,A00,185711,Staff,15,0,35,20
1683723353176,ETHN 142,A00,185726,Staff,0,4,30,30
1683723354202,ETHN 163J,A00,199229,Man; Simeon S,5,0,8,3
1683723355227,ETHN 168,A00,185727,Staff,7,0,10,3
1683723356254,ETHN 182,A00,185728,Staff,0,0,35,35
1683723357322,ETHN 183,A00,185737,Staff,10,0,18,8
1683723358351,GLBH 111,A01,209361,Burgos; Jose L.,0,0,0,0
1683723360401,HIEU 104,A00,185792,Staff,14,0,20,6
1683723361434,HIEU 115,A00,185800,Staff,0,0,20,20
1683723362461,HIEU 128,A00,185801,Staff,0,9,20,20
1683723363488,HIEU 147,A00,185802,Staff,15,0,20,5
1683723364512,HIEU 154,A00,185823,Staff,11,0,20,9
1683723365538,HILA 102,A00,185826,Staff,14,0,20,6
1683723366562,HILD 2C,A01,185778,Staff,0,13,20,20
1683723367592,HILD 7B,A01,185780,Kwak; Nancy,0,17,32,32
1683723367592,HILD 7B,A02,185781,Kwak; Nancy,0,18,32,32
1683723368621,HILD 30,A01,185791,Staff,12,0,20,8
1683723369646,HISC 119,A00,185830,Golan; Tal,0,10,20,20
1683723370671,HITO 156GS,A00,185831,Patterson; Patrick H.,0,0,0,23
1683723371699,HIUS 103,A00,185832,Man; Simeon S,0,4,20,20
1683723372725,HIUS 117,A00,185836,Kwak; Nancy,2,0,20,18
1683723373749,HIUS 125,A00,185840,Man; Simeon S,0,2,23,23
1683723374773,HIUS 149,A00,185845,Staff,1,0,20,19
1683723375856,HUM 3,A01,185882,Zavodny; Tatiana Sophia,0,8,50,50
1683723375856,HUM 3,B01,185899,Caldwell; Michael Alan,0,18,50,50
1683723376881,HUM 3GS,A00,185900,Patterson; Patrick H.,0,0,0,23
1683723377908,HUM 4,A01,185938,Zroka; Amy Liane,28,0,50,22
1683723377908,HUM 4,B01,185956,Watkins; Eric,0,6,50,50
1683723377908,HUM 4,B02,202209,Watkins; Eric,0,6,50,50
1683723377908,HUM 4,B03,202210,Watkins; Eric,0,5,50,50
1683723378937,HUM 5,A01,185958,West; Geoffrey Scott,0,0,50,50
1683723378937,HUM 5,A02,202215,West; Geoffrey Scott,0,1,50,50
1683723379963,INTL 190,A00,185959,Gagnon; Jeffrey C,0,0,0,9
1683723379963,INTL 190,B00,185960,Lettieri; Michael Joseph,0,0,0,2
1683723380990,JAPN 180,A00,254509,Staff,4,0,30,26
1683723382024,LATI 10,A01,202853,Kennemore; Amy Michelle,4,0,35,31
1683723382024,LATI 10,A02,202854,Kennemore; Amy Michelle,3,0,35,32
1683723382024,LATI 10,A03,270054,Kennemore; Amy Michelle,30,0,30,0
1683723383048,LATI 180,A00,202855,Kennemore; Amy Michelle,11,0,20,9
1683723384074,LAWS 101,A00,201767,Golan; Tal,0,7,40,40
1683723385097,LIFR 1C,A00,185961,Staff,6,0,20,14
1683723386123,LIFR 1CX,A00,185962,Staff,7,0,20,13
1683723387148,LIFR 1D,A00,185963,Staff,7,0,20,13
1683723388173,LIFR 1DX,A00,185964,Staff,7,0,20,13
1683723389202,LIGN 101,A01,186039,Staff,43,0,50,7
1683723390231,LIGN 165,A00,186040,Staff,14,0,50,36
1683723391255,LTCS 108,A00,186041,Staff,5,0,10,5
1683723392278,LTCS 119,A00,186042,Staff,15,0,20,5
1683723393304,LTCS 130,A00,186043,Wesling; Megan E.,15,0,25,10
1683723395358,LTEA 138,A00,186119,Staff,13,0,40,27
1683723396384,LTEN 124,A00,186148,Staff,5,0,25,20
1683723397411,LTEN 178,A00,186149,Staff,6,0,15,9
1683723398437,LTEN 181,A00,186150,Blanco; John D,34,0,40,6
1683723399463,LTWL 120,A00,186160,Staff,19,0,25,6
1683723400493,LTWL 165,A00,186161,Staff,22,0,25,3
1683723401521,LTWR 100,A00,186162,Staff,0,5,15,15
1683723402546,LTWR 102,A00,186163,Doller; Ben,5,0,15,10
1683723403571,MAE 8,A01,186412,Staff,0,1,0,0
1683723404599,MAE 30B,A00,186445,Bahadori; Mohammad Yousef,81,0,100,19
1683723405629,MAE 40,A00,186592,Bewley; Thomas R,10,0,50,40
1683723406653,MAE 101B,A00,186593,Bahadori; Mohammad Yousef,80,0,100,20
1683723407679,MAE 105,A00,186594,Bandaru; Prabhakar,10,0,50,40
1683723408709,MAE 107,A00,186599,Pham; Hieu Tan,0,8,120,120
1683723409736,MAE 148,A01,186660,Silberman; Jack,3,0,16,13
1683723410763,MATH 10A,A01,188095,Staff,0,6,35,35
1683723411793,MATH 10B,A01,188097,Bowers; Adam R.,0,12,30,30
1683723411793,MATH 10B,A02,188099,Bowers; Adam R.,0,11,30,30
1683723411793,MATH 10B,B01,188104,Bowers; Adam R.,0,10,30,30
1683723411793,MATH 10B,B02,188106,Bowers; Adam R.,0,9,30,30
1683723412820,MATH 10C,A01,188111,Staff,0,20,30,30
1683723412820,MATH 10C,A02,188127,Staff,0,19,30,30
1683723412820,MATH 10C,A03,188131,Staff,0,19,30,30
1683723412820,MATH 10C,B01,188218,Staff,17,0,30,13
1683723412820,MATH 10C,B02,188244,Staff,13,0,30,17
1683723412820,MATH 10C,B03,188277,Staff,14,0,30,16
1683723413846,MATH 18,A01,188344,Bach; Quang Tran,18,0,30,12
1683723413846,MATH 18,A02,188345,Bach; Quang Tran,11,0,30,19
1683723413846,MATH 18,B01,188353,Bach; Quang Tran,11,0,30,19
1683723413846,MATH 18,B02,188354,Bach; Quang Tran,19,0,30,11
1683723414872,MATH 20A,A01,188374,Staff,11,0,35,24
1683723415897,MATH 20B,A01,188382,Ohm; Ko Woon,7,0,30,23
1683723415897,MATH 20B,A02,188383,Ohm; Ko Woon,22,0,30,8
1683723415897,MATH 20B,B01,188385,Ohm; Ko Woon,7,0,30,23
1683723415897,MATH 20B,B02,188392,Ohm; Ko Woon,22,0,30,8
1683723416928,MATH 20C,A01,188394,Harel; Guershon,10,0,30,20
1683723416928,MATH 20C,A02,188395,Harel; Guershon,13,0,30,17
1683723416928,MATH 20C,B01,188404,Harel; Guershon,5,0,30,25
1683723416928,MATH 20C,B02,188405,Harel; Guershon,18,0,30,12
1683723417960,MATH 20D,A01,188414,Hammock; Frances H,0,1,30,30
1683723417960,MATH 20D,A02,188415,Hammock; Frances H,0,1,30,30
1683723417960,MATH 20D,B01,188447,Hammock; Frances H,0,1,30,30
1683723417960,MATH 20D,B02,188486,Hammock; Frances H,2,0,30,28
1683723418986,MATH 20E,A01,188649,Staff,21,0,30,9
1683723418986,MATH 20E,A02,188650,Staff,20,0,30,10
1683723418986,MATH 20E,A03,188673,Staff,0,0,30,30
1683723420014,MATH 102,A01,188675,Staff,0,40,35,35
1683723421040,MATH 103B,A01,188681,Staff,3,0,35,32
1683723421040,MATH 103B,B01,188692,Staff,5,0,35,30
1683723422066,MATH 109,A01,188695,Salehi Golsefidy; Alireza,24,0,35,11
1683723422066,MATH 109,A02,188696,Salehi Golsefidy; Alireza,24,0,35,11
1683723423094,MATH 120A,A01,188698,Eggers; John Dietrich,7,0,35,28
1683723424124,MATH 142B,A01,188736,Ioana; Adrian,0,0,30,30
1683723424124,MATH 142B,A02,188741,Ioana; Adrian,0,1,30,30
1683723424124,MATH 142B,A03,188743,Ioana; Adrian,0,3,30,30
1683723425159,MATH 168A,A01,188790,Staff,0,11,35,35
1683723426183,MATH 170A,A01,188803,Nie; Jiawang,0,2,35,35
1683723426183,MATH 170A,A02,188811,Nie; Jiawang,0,1,35,35
1683723426183,MATH 170A,A03,188814,Nie; Jiawang,1,0,35,34
1683723426183,MATH 170A,A04,188815,Nie; Jiawang,5,0,35,30
1683723427207,MATH 193B,A01,188817,Staff,0,0,35,35
1683723427207,MATH 193B,A02,188818,Staff,6,0,35,29
1683723428232,MGT 4,A01,202857,Anderson; John Charles,59,0,80,21
1683723429262,MGT 12,A00,202858,Lindenberger; Wade Douglas,40,0,90,50
1683723430290,MGT 18,A00,202859,Staff,73,0,90,17
1683723431318,MGT 18GS,A00,202860,McKay; Michael J,13,0,28,15
1683723432350,MGT 45,A00,202861,Pecore; Joseph P.,8,0,90,82
1683723433377,MGT 100,A00,202863,Yavorsky; Daniel Ryan,27,0,90,63
1683723434402,MGT 103,A00,202864,Ehrich; Kristine R,0,19,90,90
1683723435431,MGT 112,A00,202865,Ehrich; Kristine R,15,0,90,75
1683723436460,MGT 121A,A00,202868,Staff,70,0,90,20
1683723437485,MGT 131B,A00,202869,Anderson; John Charles,58,0,90,32
1683723438513,MGT 136,A00,202871,Lindenberger; Wade Douglas,83,0,90,7
1683723439539,MGT 164,A00,202873,Staff,0,67,90,91
1683723440567,MGT 164GS,A00,202874,McKay; Mary A,13,0,28,15
1683723441592,MGT 180,A00,202875,Staff,0,51,90,91
1683723442617,MMW 11R,A01,205019,Herbst; Matthew,0,0,30,30
1683723442617,MMW 11R,A02,205026,Herbst; Matthew,29,0,30,1
1683723443644,MMW 15,A01,193512,Chang; Edmond Yi-Teh,0,8,28,28
1683723443644,MMW 15,A02,193513,Chang; Edmond Yi-Teh,0,5,28,28
1683723443644,MMW 15,A03,193514,Chang; Edmond Yi-Teh,0,5,28,28
1683723443644,MMW 15,A04,193515,Chang; Edmond Yi-Teh,0,5,28,28
1683723443644,MMW 15,A05,193516,Chang; Edmond Yi-Teh,0,5,28,28
1683723443644,MMW 15,A06,193517,Chang; Edmond Yi-Teh,0,6,28,28
1683723443644,MMW 15,B01,193519,Chang; Edmond Yi-Teh,0,5,28,28
1683723443644,MMW 15,B02,193520,Chang; Edmond Yi-Teh,0,5,28,28
1683723443644,MMW 15,B03,193521,Chang; Edmond Yi-Teh,0,5,28,28
1683723443644,MMW 15,B04,193522,Chang; Edmond Yi-Teh,0,6,28,28
1683723443644,MMW 15,B05,193523,Chang; Edmond Yi-Teh,0,5,28,28
1683723443644,MMW 15,B06,193524,Chang; Edmond Yi-Teh,0,5,28,28
1683723444669,MMW 122,A01,193526,Rahimi; Babak,0,16,28,28
1683723444669,MMW 122,A02,193527,Rahimi; Babak,0,15,28,28
1683723444669,MMW 122,A03,193528,Rahimi; Babak,0,0,0,0
1683723444669,MMW 122,A04,193529,Rahimi; Babak,0,0,0,0
1683723445709,MUS 1A,A01,186663,Staff,0,18,35,35
1683723446732,MUS 4,A01,186715,Staff,0,12,35,35
1683723447762,MUS 5R,A01,186796,Dubnov; Shlomo,0,17,35,35
1683723448790,MUS 6,A01,186798,Staff,0,4,25,25
1683723449818,MUS 7,A01,186830,Staff,11,0,35,24
1683723450843,MUS 8,A01,186930,Staff,0,27,35,35
1683723451869,MUS 15,A01,186932,Staff,0,15,35,35
1683723451869,MUS 15,B01,186934,Staff,0,16,35,35
1683723452898,MUS 80,A00,186935,Staff,0,0,20,20
1683723452898,MUS 80,B00,186936,Staff,24,0,25,1
1683723453930,NANO 11,A00,204702,Lipomi; Darren John,0,0,0,0
1683723454956,NANO 15,A01,204709,Yang; Kesong,0,1,0,0
1683723455986,NANO 114,A00,202069,Jahed Motlagh; Zeinab,2,0,10,8
1683723457012,PHIL 1,A00,186955,Grush; Rick Scott,31,0,40,9
1683723458037,PHIL 10,A01,186973,Grush; Rick Scott,27,0,35,8
1683723458037,PHIL 10,A02,186974,Grush; Rick Scott,33,0,35,2
1683723459064,PHIL 13,A01,186976,Staff,1,0,35,34
1683723459064,PHIL 13,A02,186977,Staff,16,0,35,19
1683723460093,PHIL 14,A01,186979,Staff,30,0,35,5
1683723460093,PHIL 14,A02,186986,Staff,32,0,35,3
1683723461121,PHIL 28,A01,186988,Staff,16,0,30,14
1683723461121,PHIL 28,A02,186989,Staff,0,0,30,30
1683723461121,PHIL 28,A03,186990,Staff,10,0,30,20
1683723461121,PHIL 28,A04,186991,Staff,26,0,30,4
1683723462149,PHIL 120,A00,186997,Staff,23,0,40,17
1683723463176,PHIL 137,A00,187003,Staff,8,0,40,32
1683723464201,PHIL 150,A00,187015,Staff,47,0,70,23
1683723465226,PHIL 167,A00,187021,Lamey; Andy M.,34,0,40,6
1683723466254,PHIL 174,A01,202226,Staff,17,0,20,3
1683723466254,PHIL 174,A02,202235,Staff,20,0,20,0
1683723467282,PHIL 191A,A00,258918,Staff,0,0,1,1
1683723468311,PHYS 1A,A00,187028,Staff,26,0,60,34
1683723469341,PHYS 1AL,001,187036,Staff,3,0,30,27
1683723469341,PHYS 1AL,002,187049,Staff,18,0,30,12
1683723470371,PHYS 1B,A00,187058,Staff,21,0,60,39
1683723471397,PHYS 1BL,001,187064,Staff,0,1,30,30
1683723471397,PHYS 1BL,002,187070,Staff,4,0,30,26
1683723472421,PHYS 1C,A00,187082,Staff,30,0,120,90
1683723473447,PHYS 1CL,001,187088,Staff,0,9,30,30
1683723473447,PHYS 1CL,002,187089,Staff,0,1,30,30
1683723473447,PHYS 1CL,009,262693,Staff,9,0,30,21
1683723474477,PHYS 2B,A01,187097,Staff,55,0,115,60
1683723475506,PHYS 2C,A01,187099,Staff,63,0,115,52
1683723476532,PHYS 2CL,A01,187101,Staff,5,0,28,23
1683723476532,PHYS 2CL,A02,187102,Staff,15,0,28,13
1683723477560,PHYS 2D,A01,187123,Shotwell; Brian,95,0,115,20
1683723478584,PHYS 4B,A01,187133,Grinstein; Benjamin,35,0,50,15
1683723479666,POLI 10,A00,188819,Staff,0,4,50,50
1683723480694,POLI 11,A00,188827,Staff,43,0,50,7
1683723481721,POLI 13R,A00,188828,Staff,0,2,20,20
1683723482747,POLI 27,A01,188830,Elgin; Samuel Zincke,0,2,70,70
1683723483774,POLI 30,A00,188832,Desposato; Scott,30,0,50,20
1683723484801,POLI 102F,A00,188834,Staff,1,0,40,39
1683723485825,POLI 104A,A00,188852,Staff,12,0,30,18
1683723486852,POLI 104I,A00,188853,Staff,0,8,20,20
1683723487878,POLI 110B,A00,188854,Wiens; David,6,0,20,14
1683723488901,POLI 112A,A00,188855,Wiens; David,3,0,30,27
1683723489926,POLI 117R,A00,188856,Forman; Fonna,0,12,20,20
1683723490951,POLI 118,A00,188857,Ingham; Sean,8,0,20,12
1683723491978,POLI 120G,A00,188858,Staff,7,0,30,23
1683723493006,POLI 131CR,A00,188863,Hoston; Germaine,20,0,50,30
1683723494030,POLI 133,A00,188864,Nellis; Gareth Hb,44,0,50,6
1683723495054,POLI 134D,A00,188865,Desposato; Scott,27,0,30,3
1683723496082,POLI 142A,A00,188871,Gartzke; Erik,21,0,50,29
1683723497106,POLI 142K,A00,188874,Staff,38,0,50,12
1683723498134,POLI 143,A00,188940,Gartzke; Erik,15,0,30,15
1683723499160,POLI 153,A00,188943,Staff,1,0,20,19
1683723500187,POLI 160AA,A00,188944,Staff,10,0,40,30
1683723501212,POLI 170A,A00,188945,Staff,10,0,30,20
1683723503261,PSYC 1,A00,188952,Staff,36,0,90,54
1683723504289,PSYC 2,B00,188953,Staff,19,0,35,16
1683723505315,PSYC 6,A00,188970,Staff,47,0,60,13
1683723506339,PSYC 7,A00,188973,Staff,35,0,45,10
1683723507370,PSYC 60,A01,188980,Rickard; Timothy C.,42,0,60,18
1683723508398,PSYC 70,A01,189001,Steiner; Eric Tomas,22,0,45,23
1683723509423,PSYC 100,A00,189005,Lacefield; Katharine I,1,98,120,119
1683723510450,PSYC 102,A00,189008,Staff,6,0,30,24
1683723511474,PSYC 106,B00,189026,Gorman; Michael R.,27,0,60,33
1683723512499,PSYC 114,B01,189033,Winkielman; Piotr,0,31,30,30
1683723513523,PSYC 131,A00,189036,Anagnostaras; Stephan,0,44,60,60
1683723514554,PSYC 136,A00,189041,Lowe; Angela Beth,0,7,25,25
1683723515583,PSYC 137,A00,189057,Winkielman; Piotr,0,36,25,25
1683723516608,PSYC 144,A00,189107,Wixted; John T,0,11,50,50
1683723518657,PSYC 162,A00,189142,Staff,0,9,85,85
1683723519684,PSYC 172,A00,189144,Gorman; Michael R.,0,6,30,30
1683723521738,PSYC 179,A00,189146,Lacefield; Katharine I,0,88,120,120
1683723522762,PSYC 181,A00,189147,Anagnostaras; Stephan,0,45,90,90
1683723523786,PSYC 190R,A00,189148,Barner; David A.,0,23,80,80
1683723524811,PSYC 191,A00,189275,Rickard; Timothy C.,0,11,25,25
1683723525842,PSYC 193,A00,189276,Chapman; Eddie Nathaniel,0,1,0,4
1683723526871,PSYC 193L,A01,189281,Lowe; Angela Beth,8,0,20,12
1683723526871,PSYC 193L,B01,189285,Staff,28,0,35,7
1683723527896,RELI 149,A00,187137,Rahimi; Babak,6,0,40,34
1683723528920,SE 9,A01,187315,Staff,0,2,18,18
1683723529943,SE 101B,A00,187409,Staff,24,0,30,6
1683723530970,SE 110B,A00,187444,Staff,10,0,40,30
1683723531996,SE 130B,A00,187449,Staff,31,0,40,9
1683723533025,SE 150A,A00,187516,Staff,8,0,20,12
1683723534050,SE 154,A00,187528,Staff,29,0,50,21
1683723535075,SIO 3,A01,258171,Staff,35,0,40,5
1683723536105,SIO 10,A00,187144,Cook; Geoffrey W,0,6,75,75
1683723537133,SIO 45,A00,187152,Cook; Geoffrey W,1,7,100,99
1683723538157,SIO 109R,A00,194486,Staff,0,4,20,20
1683723540208,SIO 187,A01,187233,Kacev; David,12,0,40,28
1683723541236,SOCI 1,A01,258656,Thorpe; Charles Robert,28,0,30,2
1683723541236,SOCI 1,A02,258658,Thorpe; Charles Robert,30,0,30,0
1683723541236,SOCI 1,A03,258661,Thorpe; Charles Robert,25,0,25,0
1683723541236,SOCI 1,A04,258666,Thorpe; Charles Robert,22,0,25,3
1683723541236,SOCI 1,A05,258897,Thorpe; Charles Robert,22,0,25,3
1683723541236,SOCI 1,A06,258898,Thorpe; Charles Robert,25,0,25,0
1683723542263,SOCI 30,A01,258903,Pardo Guerra; Juan Pablo,14,0,30,16
1683723543293,SOCI 102,A00,258904,Staff,9,0,25,16
1683723544322,SOCI 106,A00,258905,Staff,19,0,25,6
1683723545350,SOCI 111,A00,258907,Ribas Norris; Janet Vanesa,26,0,30,4
1683723546378,SOCI 121R,A00,258908,Pardo Guerra; Juan Pablo,7,0,30,23
1683723547404,SOCI 126,A01,203330,Staff,14,0,20,6
1683723548429,SOCI 131,A00,258909,Thorpe; Charles Robert,30,0,60,30
1683723549455,SOCI 135,A00,258910,Payne; Christine Anna,0,13,30,30
1683723550479,SOCI 157,A00,258911,Staff,10,0,30,20
1683723551505,SOCI 184,A00,258912,Staff,25,0,30,5
1683723552533,SOCI 188D,A00,258913,Staff,22,0,30,8
1683723553559,SYN 2,001,187529,Staff,9,0,16,7
1683723553559,SYN 2,002,201452,Staff,0,20,16,16
1683723553559,SYN 2,003,201469,Staff,1,0,16,15
1683723554588,SYN 100,A01,187531,Staff,0,9,20,20
1683723554588,SYN 100,B01,201491,Staff,0,10,20,20
1683723555616,TDAC 1,A00,189286,Walsh; Kim C.,3,0,20,17
1683723555616,TDAC 1,B00,189287,Harting; Carla Kelso,10,0,20,10
1683723556641,TDAC 101,A00,189300,Walsh; Kim C.,16,0,20,4
1683723556641,TDAC 101,B00,189301,Harting; Carla Kelso,18,0,20,2
1683723557672,TDAC 102,A00,189304,Basso; Beatrice,14,0,20,6
1683723558701,TDAC 108,A00,189305,Staff,18,0,20,2
1683723559728,TDDE 131,A00,189310,Staff,19,0,20,1
1683723559728,TDDE 131,B00,189314,Staff,19,0,20,1
1683723559728,TDDE 131,C00,189315,Staff,48,0,50,2
1683723559728,TDDE 131,D00,189316,Staff,14,0,15,1
1683723559728,TDDE 131,E00,204841,Staff,20,0,20,0
1683723560755,TDGE 10,A00,189289,Staff,26,0,50,24
1683723560755,TDGE 10,B00,189290,Havis; Allan,0,1,50,50
1683723561781,TDGE 11,A00,189291,Fulton; Julia,0,4,50,50
1683723561781,TDGE 11,B00,189292,Staff,20,0,25,5
1683723561781,TDGE 11,C00,260270,Staff,0,0,0,0
1683723562814,TDGE 25,A00,189294,Staff,1,0,20,19
1683723563843,TDGE 124,A00,189318,Fulton; Julia,0,7,50,50
1683723564867,TDGE 125,A00,189319,Staff,13,0,25,12
1683723564867,TDGE 125,B00,189320,Staff,23,0,25,2
1683723565892,TDGE 127,A00,189322,Havis; Allan,1,0,50,49
1683723566918,TDHT 101,A00,189323,Staff,18,0,25,7
1683723566918,TDHT 101,B00,189324,Staff,25,0,25,0
1683723567947,TDHT 102,A00,189325,Staff,49,0,50,1
1683723568972,TDMV 1,A00,189295,Arcidiacono; Kristin,20,0,30,10
1683723568972,TDMV 1,B00,189296,Caligagan; Maria T.,23,0,30,7
1683723569998,TDMV 2,A00,189297,Sammartano; Tonnie,27,0,30,3
1683723569998,TDMV 2,B00,189299,Arcidiacono; Kristin,23,0,30,7
1683723571025,TDMV 3,A00,204998,Rincon; Alicia,22,0,30,8
1683723572050,TDMV 120,A00,189458,Sammartano; Tonnie,28,0,30,2
1683723573079,TDMV 138,A00,189541,Jun; Grace Shin Hae,20,0,40,20
1683723574110,TDMV 142,A00,189717,Caligagan; Tony,25,0,30,5
1683723574110,TDMV 142,B00,189718,Caligagan; Maria T.,25,0,30,5
1683723575140,TMC 2,A01,187533,Staff,25,0,25,0
1683723575140,TMC 2,A02,187534,Staff,25,0,25,0
1683723576167,USP 1,A01,187536,Kwak; Nancy,0,16,25,25
1683723577194,USP 5,A01,187538,Staff,8,0,25,17
1683723578219,USP 101,A00,199253,Staff,0,4,0,0
1683723579245,USP 124,A00,187562,Boomhower; Matthew Charles,0,0,30,30
1683723580270,USP 138,A00,187582,Staff,19,0,25,6
1683723581301,USP 152,A01,187597,Staff,3,0,25,22
1683723582327,USP 153,A00,187598,Staff,18,0,25,7
1683723583411,USP 168,A00,187607,Kwak; Nancy,2,0,5,3
1683723584437,USP 173,A00,187619,Staff,4,0,25,21
1683723585463,USP 181,A00,187638,Staff,0,4,25,25
1683723586488,VIS 103,A00,187650,Cruz; Edwin Teddy,17,0,75,58
1683723587513,VIS 110D,A00,187669,Staff,13,0,22,9
1683723588539,VIS 127C,A00,187720,Shen; Kuiyi,67,0,146,79
1683723589566,VIS 149,A00,187731,Yoldas; Pinar,0,12,22,22
1683723590592,VIS 151,A01,188091,Staff,22,0,34,12
1683723590592,VIS 151,A02,188092,Staff,11,0,34,23
1683723591618,VIS 160B,A00,188093,Stalbaum; Brett,0,1,10,10
1683723593667,WCWP 10B,A00,201720,Staff,0,0,5,5
1683723593667,WCWP 10B,B00,201722,Staff,0,0,6,6
1683723594694,WCWP 100,A00,201725,Gagnon; Jeffrey C,0,0,2,2
1683723594694,WCWP 100,B00,201727,Staff,0,4,15,15
1683723597858,ANBI 133,A00,258401,Wilder; Linnea Lorene,34,0,40,6
1683723598882,ANBI 140,A00,258395,Hrvoj Mihic; Branka,18,0,25,7
1683723599910,ANSC 120,A00,258402,Bialecki; Jon Anthony,26,0,40,14
1683723600937,ANSC 144,A00,258400,Staff,12,0,40,28
1683723602989,ANSC 166,A00,258396,Parish; Steven Martin,156,0,175,19
1683723604014,ANSC 180,A00,193533,Staff,8,0,20,12
1683723605039,ANSC 188,A00,258397,Jassal; Aftab,34,0,40,6
1683723606067,ANTH 3,A01,258316,Staff,23,0,30,7
1683723607098,ANTH 5,A00,258394,Semendeferi; Ekaterini,16,0,20,4
1683723608125,ANTH 21,A01,258331,Staff,4,0,40,36
1683723609154,ANTH 103,A00,258398,Varma; Saiba,15,0,25,10
1683723610183,AWP 10,001,202034,Staff,0,0,0,0
1683723610183,AWP 10,002,202035,Staff,0,0,0,0
1683723610183,AWP 10,003,202036,Staff,0,0,0,0
1683723610183,AWP 10,004,202037,Staff,0,0,0,0
1683723610183,AWP 10,005,202038,Staff,0,0,0,0
1683723610183,AWP 10,006,202039,Staff,0,0,0,0
1683723610183,AWP 10,007,202040,Staff,0,0,0,0
1683723610183,AWP 10,008,202041,Staff,0,0,0,0
1683723610183,AWP 10,009,202042,Staff,0,0,0,0
1683723610183,AWP 10,010,202043,Staff,0,0,0,0
1683723610183,AWP 10,011,202044,Staff,0,0,0,0
1683723610183,AWP 10,012,202045,Staff,0,0,0,0
1683723610183,AWP 10,013,202046,Staff,0,0,0,0
1683723610183,AWP 10,014,202047,Staff,0,0,0,0
1683723610183,AWP 10,015,202048,Staff,0,0,0,0
1683723610183,AWP 10,016,202049,Staff,0,0,0,0
1683723610183,AWP 10,017,202050,Staff,0,0,0,0
1683723610183,AWP 10,018,202051,Staff,0,0,0,0
1683723610183,AWP 10,019,202052,Staff,0,0,0,0
1683723610183,AWP 10,020,202053,Staff,0,0,0,0
1683723610183,AWP 10,021,202054,Staff,0,0,0,0
1683723610183,AWP 10,022,202055,Staff,0,0,0,0
1683723610183,AWP 10,023,202056,Staff,0,0,0,0
1683723610183,AWP 10,024,202057,Staff,0,0,0,0
1683723610183,AWP 10,025,202058,Staff,0,0,0,0
1683723610183,AWP 10,026,202059,Staff,0,0,0,0
1683723611207,AWP 102,001,202032,Staff,0,0,0,0
1683723611207,AWP 102,002,202033,Staff,0,0,0,0
1683723612234,BENG 100,A01,254234,Taylor Amos; Alyssa C,31,0,40,9
1683723613264,BENG 196,001,270013,Engler; Adam J.,9999,0,9999,0
1683723614292,BICD 100R,A01,202018,Smith; Laurie,0,7,32,32
1683723614292,BICD 100R,A02,202019,Smith; Laurie,0,3,32,32
1683723614292,BICD 100R,A03,202020,Smith; Laurie,0,1,32,32
1683723614292,BICD 100R,A04,202021,Smith; Laurie,6,0,32,26
1683723614292,BICD 100R,A05,202022,Smith; Laurie,10,0,32,22
1683723615325,BICD 136,A01,193242,Gustafson-Brown; Cindy,0,2,32,32
1683723615325,BICD 136,A02,193244,Gustafson-Brown; Cindy,13,0,32,19
1683723616353,BIEB 102,A01,193249,Butler; Shannon Rhey,0,0,32,32
1683723616353,BIEB 102,A02,193251,Butler; Shannon Rhey,0,0,32,32
1683723616353,BIEB 102,A03,193253,Butler; Shannon Rhey,0,0,32,32
1683723616353,BIEB 102,A04,193255,Butler; Shannon Rhey,13,0,32,19
1683723616353,BIEB 102,A05,193265,Butler; Shannon Rhey,25,0,32,7
1683723616353,BIEB 102,A06,193269,Butler; Shannon Rhey,12,0,32,20
1683723618404,BIEB 150,A01,193274,Staff,0,0,32,32
1683723618404,BIEB 150,A02,193285,Staff,24,0,32,8
1683723619430,BIEB 194,A00,193286,Kurle; Carolyn M.,19,0,32,13
1683723620469,BILD 1,A01,192291,Staff,15,0,32,17
1683723620469,BILD 1,A02,192292,Staff,30,0,32,2
1683723620469,BILD 1,B01,192520,Reuther; Keefe,0,1,0,0
1683723620469,BILD 1,B02,192532,Reuther; Keefe,0,1,0,0
1683723621507,BILD 3,A01,192556,Butler; Shannon Rhey,0,0,32,32
1683723621507,BILD 3,A02,192581,Butler; Shannon Rhey,0,1,32,32
1683723621507,BILD 3,A03,192611,Butler; Shannon Rhey,19,0,32,13
1683723621507,BILD 3,A04,192612,Butler; Shannon Rhey,23,0,32,9
1683723621507,BILD 3,A05,192613,Butler; Shannon Rhey,26,0,32,6
1683723621507,BILD 3,A06,192679,Butler; Shannon Rhey,27,0,32,5
1683723621507,BILD 3,A07,192682,Butler; Shannon Rhey,20,0,32,12
1683723622539,BILD 4,A01,192836,Reuther; Keefe,1,0,24,23
1683723622539,BILD 4,A02,193044,Reuther; Keefe,4,0,24,20
1683723623568,BILD 10,A01,193142,Gustafson-Brown; Cindy,29,0,32,3
1683723623568,BILD 10,A02,193149,Gustafson-Brown; Cindy,31,0,32,1
1683723624600,BIMM 100,A01,193301,Staff,0,6,32,32
1683723624600,BIMM 100,A02,193312,Staff,0,7,32,32
1683723624600,BIMM 100,A03,193323,Staff,0,10,32,32
1683723625628,BIMM 101,A01,193329,McDonnell; Lisa Marie,0,3,24,24
1683723625628,BIMM 101,A02,193339,McDonnell; Lisa Marie,0,3,24,24
1683723625628,BIMM 101,B01,193354,McDonnell; Lisa Marie,0,4,24,24
1683723625628,BIMM 101,B02,193357,McDonnell; Lisa Marie,0,3,24,24
1683723626656,BIMM 110,A01,193377,Tat; John,0,11,32,32
1683723626656,BIMM 110,A02,193378,Tat; John,0,11,32,32
1683723627681,BIMM 120,A01,206116,Staff,0,0,32,32
1683723627681,BIMM 120,A02,206117,Staff,7,0,32,25
1683723627681,BIMM 120,A03,206121,Staff,21,0,32,11
1683723628709,BIPN 100,A01,193393,Park; Ji Young,0,15,32,32
1683723628709,BIPN 100,A02,193402,Park; Ji Young,0,14,32,32
1683723628709,BIPN 100,A03,193413,Park; Ji Young,0,14,32,32
1683723628709,BIPN 100,A04,193414,Park; Ji Young,0,13,32,32
1683723629741,BIPN 102,A01,193429,Staff,0,0,32,32
1683723629741,BIPN 102,A02,193438,Staff,18,0,32,14
1683723630772,BIPN 106,A01,193450,Reyes Gonzalez; Catalina,0,2,40,40
1683723631799,BIPN 134,A01,193465,Cooke; James Edward,0,0,32,32
1683723631799,BIPN 134,A02,193474,Cooke; James Edward,25,0,32,7
1683723631799,BIPN 134,A03,193485,Cooke; James Edward,29,0,32,3
1683723631799,BIPN 134,A04,193486,Cooke; James Edward,20,0,32,12
1683723631799,BIPN 134,A05,193491,Cooke; James Edward,31,0,32,1
1683723631799,BIPN 134,A06,193501,Cooke; James Edward,30,0,32,2
1683723631799,BIPN 134,A07,193510,Cooke; James Edward,29,0,32,3
1683723633855,BISP 194,A00,222522,Staff,14,0,32,18
1683723634885,CAT 124,A01,202407,Staff,19,0,25,6
1683723635911,CAT 125,A00,202408,Marchisotto; Jennifer Anne,2,0,20,18
1683723636947,CAT 125R,A00,202409,Smith; Lauryn Alissa,0,11,20,20
1683723636947,CAT 125R,B00,202410,Morales; Celeste Georgianna,0,11,20,20
1683723636947,CAT 125R,C00,202411,Irwin; Matthew Joseph,0,12,20,20
1683723637979,CENG 15,A01,204712,Yang; Kesong,0,1,0,0
1683723639005,CENG 114,A00,202070,Jahed Motlagh; Zeinab,5,0,20,15
1683723640032,CGS 105,A00,185477,Wesling; Megan E.,24,0,40,16
1683723641064,CGS 106,A00,185494,Staff,11,0,22,11
1683723642088,CGS 108,A00,185495,Staff,14,0,20,6
1683723643113,CGS 114,A00,185496,Staff,13,0,18,5
1683723644139,CGS 119,A00,185501,Staff,15,0,20,5
1683723645163,CGS 120,A00,185511,Staff,11,0,20,9
1683723646190,CHEM 4,A01,184675,Bussey; Thomas J,97,0,100,3
1683723647219,CHEM 6A,A01,184677,Staff,32,0,60,28
1683723648244,CHEM 6B,A01,184679,Staff,63,0,100,37
1683723649274,CHEM 6C,A01,184681,Bussey; Thomas J,0,0,50,50
1683723649274,CHEM 6C,A02,184682,Bussey; Thomas J,32,0,50,18
1683723650303,CHEM 40A,A01,184684,Albizati; Kim F.,33,0,100,67
1683723651334,CHEM 40B,A01,184686,Albizati; Kim F.,0,22,100,100
1683723652360,CHEM 41B,A01,184690,Staff,51,0,100,49
1683723653389,COGS 3,A01,184715,Boyle; Mary E. T.,0,27,40,40
1683723654417,COGS 14B,A01,185172,Staff,0,14,38,38
1683723655443,COGS 18,A01,184736,Staff,14,0,80,66
1683723656469,COGS 100,A01,184932,Staff,0,8,73,73
1683723657494,COGS 101A,A01,184935,Staff,0,40,30,30
1683723658520,COGS 101B,A01,184944,Staff,0,2,30,30
1683723659546,COGS 101C,A01,184946,Staff,0,10,30,30
1683723660572,COGS 102A,A01,184951,Johnson; Christine M.,1,0,40,39
1683723661599,COGS 107B,A01,184953,Mooshagian; Eric Frederick,0,52,40,40
1683723662629,COGS 118B,A01,184959,Gupta; Anjum,0,50,40,40
1683723663655,COGS 153,A00,184961,Staff,1,16,30,29
1683723664685,COGS 177,A00,184962,Staff,0,20,30,30
1683723665709,COGS 187A,A01,184969,Boyle; Mary E. T.,0,19,40,40
1683723666734,COMM 10,A01,185174,Staff,0,5,25,25
1683723666734,COMM 10,A02,185189,Staff,0,2,25,25
1683723666734,COMM 10,A03,269821,Staff,0,1,0,0
1683723667763,COMM 100B,A02,185476,Staff,10,0,25,15
1683723667763,COMM 100B,A03,277340,Staff,25,0,25,0
1683723668790,COMM 100C,A01,185314,Staff,2,0,25,23
1683723668790,COMM 100C,A02,185327,Staff,17,0,25,8
1683723669819,COMM 110M,A00,185349,Staff,0,0,40,40
1683723670845,COMM 113T,A00,185352,Staff,25,0,40,15
1683723671871,COMM 114I,A00,185353,Staff,31,0,40,9
1683723672897,COMM 131,A00,185354,Staff,17,0,30,13
1683723673928,CSE 8A,A50,185358,Cao; Yingjun,0,46,10,10
1683723674957,CSE 8B,A01,185362,Staff,0,48,50,50
1683723675985,CSE 11,A01,185416,Cao; Yingjun,0,91,10,10
1683723677016,CSE 20,A01,185445,Briones; Jor-el Thomas Caparas,3,0,25,22
1683723678043,CSE 21,A01,185447,Staff,9,0,50,41
1683723679077,CSE 101,A01,185451,Staff,0,13,50,50
1683723679077,CSE 101,B01,185453,Jones; Miles E,0,15,50,50
1683723681136,CSE 141,A01,185458,Eldon; John,16,0,100,84
1683723682164,CSE 141L,A01,185461,Eldon; John,8,0,100,92
1683723683191,CSE 142,A01,185463,Staff,34,0,60,26
1683723683191,CSE 142,B01,201355,Staff,0,7,60,60
1683723684215,CSE 142L,A01,185470,Staff,34,0,60,26
1683723684215,CSE 142L,B01,201417,Staff,0,6,60,60
1683723685243,CSE 190,A00,201433,Staff,32,0,49,17
1683723686270,DOC 1,A01,259136,Strom; Megan C.,7,0,15,8
1683723686270,DOC 1,A02,259137,Strom; Megan C.,15,0,15,0
1683723686270,DOC 1,A03,259138,Strom; Megan C.,14,0,15,1
1683723686270,DOC 1,A04,259139,Strom; Megan C.,13,0,15,2
1683723687369,DOC 100D,A00,259140,Pass; Natalye Joann,14,0,25,11
1683723688404,DSGN 1,A01,184749,Rill; Bryan,0,26,30,30
1683723689428,DSGN 100,A01,185168,Staff,0,2,25,25
1683723690458,ECE 5,A01,185626,Morris; Karcher William,0,12,0,0
1683723691481,ECE 101,A01,185628,Staff,14,0,70,56
1683723692509,ECE 107,A01,185635,Baghdadchi; Saharnaz,0,0,20,20
1683723692509,ECE 107,A02,185638,Baghdadchi; Saharnaz,1,0,20,19
1683723693534,ECE 148,A01,185647,Silberman; Jack,0,0,16,16
1683723694563,ECON 1,A01,185537,Crane; Meredith Helen,54,0,70,16
1683723695590,ECON 3,A01,185549,Crane; Meredith Helen,30,0,70,40
1683723696618,ECON 4,A01,203354,Anderson; John Charles,0,5,10,10
1683723697642,ECON 100A,A01,185574,Staff,0,5,40,40
1683723698671,ECON 100B,A01,185576,Staff,0,12,50,50
1683723699702,ECON 100C,A01,185589,Newhouse; Herbert S,30,0,70,40
1683723700728,ECON 105,A00,185608,Vespa; Emanuel Ignacio,19,0,35,16
1683723701755,ECON 109,A01,185610,Shishkin; Denis,9,0,35,26
1683723702785,ECON 110A,A01,185612,Staff,8,0,40,32
1683723703813,ECON 120A,A01,185615,Staff,19,0,40,21
1683723704839,ECON 120C,A01,185617,Sun; Yixiao,0,21,70,70
1683723705870,ECON 144,A00,203346,Squires; Dale E,2,0,35,33
1683723706896,ECON 171,A01,203349,Newhouse; Herbert S,0,1,35,35
1683723707921,ECON 173A,A01,185621,Toda; Alexis Akira,21,0,35,14
1683723708951,EDS 25,A01,202413,Staff,0,1,0,0
1683723708951,EDS 25,A02,202414,Staff,0,1,0,0
1683723708951,EDS 25,A03,202415,Staff,0,0,0,0
1683723708951,EDS 25,A04,202416,Staff,0,1,0,0
1683723708951,EDS 25,A05,202439,Staff,0,0,0,0
1683723708951,EDS 25,A06,202440,Staff,0,0,0,0
1683723708951,EDS 25,B01,202631,Staff,0,0,0,0
1683723708951,EDS 25,B02,202632,Staff,0,0,0,0
1683723708951,EDS 25,B03,202639,Staff,0,0,0,0
1683723708951,EDS 25,B04,202640,Staff,0,0,0,0
1683723708951,EDS 25,B05,202643,Staff,0,0,0,0
1683723708951,EDS 25,B06,202644,Staff,0,0,0,0
1683723709980,EDS 38,A01,202659,Black; Alison Michelle,25,0,25,0
1683723711008,EDS 115,A00,202652,Staff,18,0,30,12
1683723712033,EDS 125,A00,202649,Staff,13,0,30,17
1683723713063,EDS 126,A01,203332,Staff,30,0,30,0
1683723714088,EDS 139,A00,202838,Staff,16,0,25,9
1683723715113,EDS 146,A01,202655,Staff,14,0,25,11
1683723716140,ENG 15,A00,185667,Staff,0,1,0,0
1683723716140,ENG 15,B00,185672,Staff,0,0,0,0
1683723716140,ENG 15,C00,185675,Staff,0,0,0,0
1683723716140,ENG 15,D00,185682,Staff,0,0,0,0
1683723716140,ENG 15,E00,185684,Staff,0,0,0,0
1683723717170,ETHN 103,A00,185710,Staff,0,8,35,35
1683723718199,ETHN 103A,A00,199228,Man; Simeon S,0,0,9,9
1683723719227,ETHN 109,A00,185711,Staff,15,0,35,20
1683723720253,ETHN 142,A00,185726,Staff,0,4,30,30
1683723721283,ETHN 163J,A00,199229,Man; Simeon S,5,0,8,3
1683723722313,ETHN 168,A00,185727,Staff,7,0,10,3
1683723723343,ETHN 182,A00,185728,Staff,0,0,35,35
1683723724370,ETHN 183,A00,185737,Staff,10,0,18,8
1683723725397,GLBH 111,A01,209361,Burgos; Jose L.,0,0,0,0
1683723727455,HIEU 104,A00,185792,Staff,14,0,20,6
1683723728482,HIEU 115,A00,185800,Staff,0,0,20,20
1683723729507,HIEU 128,A00,185801,Staff,0,9,20,20
1683723730532,HIEU 147,A00,185802,Staff,15,0,20,5
1683723731562,HIEU 154,A00,185823,Staff,11,0,20,9
1683723732588,HILA 102,A00,185826,Staff,14,0,20,6
1683723733613,HILD 2C,A01,185778,Staff,0,13,20,20
1683723734643,HILD 7B,A01,185780,Kwak; Nancy,0,17,32,32
1683723734643,HILD 7B,A02,185781,Kwak; Nancy,0,18,32,32
1683723735674,HILD 30,A01,185791,Staff,12,0,20,8
1683723736704,HISC 119,A00,185830,Golan; Tal,0,10,20,20
1683723737729,HITO 156GS,A00,185831,Patterson; Patrick H.,0,0,0,23
1683723738757,HIUS 103,A00,185832,Man; Simeon S,0,4,20,20
1683723739785,HIUS 117,A00,185836,Kwak; Nancy,2,0,20,18
1683723740810,HIUS 125,A00,185840,Man; Simeon S,0,2,23,23
1683723741835,HIUS 149,A00,185845,Staff,1,0,20,19
1683723742868,HUM 3,A01,185882,Zavodny; Tatiana Sophia,0,8,50,50
1683723742868,HUM 3,B01,185899,Caldwell; Michael Alan,0,18,50,50
1683723743895,HUM 3GS,A00,185900,Patterson; Patrick H.,0,0,0,23
1683723744923,HUM 4,A01,185938,Zroka; Amy Liane,28,0,50,22
1683723744923,HUM 4,B01,185956,Watkins; Eric,0,6,50,50
1683723744923,HUM 4,B02,202209,Watkins; Eric,0,6,50,50
1683723744923,HUM 4,B03,202210,Watkins; Eric,0,5,50,50
1683723745951,HUM 5,A01,185958,West; Geoffrey Scott,0,0,50,50
1683723745951,HUM 5,A02,202215,West; Geoffrey Scott,0,1,50,50
1683723746981,INTL 190,A00,185959,Gagnon; Jeffrey C,0,0,0,9
1683723746981,INTL 190,B00,185960,Lettieri; Michael Joseph,0,0,0,2
1683723748016,JAPN 180,A00,254509,Staff,4,0,30,26
1683723749045,LATI 10,A01,202853,Kennemore; Amy Michelle,4,0,35,31
1683723749045,LATI 10,A02,202854,Kennemore; Amy Michelle,3,0,35,32
1683723749045,LATI 10,A03,270054,Kennemore; Amy Michelle,30,0,30,0
1683723750071,LATI 180,A00,202855,Kennemore; Amy Michelle,11,0,20,9
1683723751101,LAWS 101,A00,201767,Golan; Tal,0,7,40,40
1683723752131,LIFR 1C,A00,185961,Staff,6,0,20,14
1683723753157,LIFR 1CX,A00,185962,Staff,7,0,20,13
1683723754183,LIFR 1D,A00,185963,Staff,7,0,20,13
1683723755211,LIFR 1DX,A00,185964,Staff,7,0,20,13
1683723756239,LIGN 101,A01,186039,Staff,43,0,50,7
1683723757269,LIGN 165,A00,186040,Staff,14,0,50,36
1683723758297,LTCS 108,A00,186041,Staff,5,0,10,5
1683723759325,LTCS 119,A00,186042,Staff,15,0,20,5
1683723760351,LTCS 130,A00,186043,Wesling; Megan E.,15,0,25,10
1683723762404,LTEA 138,A00,186119,Staff,13,0,40,27
1683723763430,LTEN 124,A00,186148,Staff,5,0,25,20
1683723764455,LTEN 178,A00,186149,Staff,6,0,15,9
1683723765479,LTEN 181,A00,186150,Blanco; John D,34,0,40,6
1683723766506,LTWL 120,A00,186160,Staff,19,0,25,6
1683723767534,LTWL 165,A00,186161,Staff,22,0,25,3
1683723768569,LTWR 100,A00,186162,Staff,0,5,15,15
1683723769596,LTWR 102,A00,186163,Doller; Ben,5,0,15,10
1683723770626,MAE 8,A01,186412,Staff,0,1,0,0
1683723771652,MAE 30B,A00,186445,Bahadori; Mohammad Yousef,81,0,100,19
1683723772677,MAE 40,A00,186592,Bewley; Thomas R,10,0,50,40
1683723773707,MAE 101B,A00,186593,Bahadori; Mohammad Yousef,80,0,100,20
1683723774733,MAE 105,A00,186594,Bandaru; Prabhakar,10,0,50,40
1683723775758,MAE 107,A00,186599,Pham; Hieu Tan,0,8,120,120
1683723776784,MAE 148,A01,186660,Silberman; Jack,3,0,16,13
1683723777816,MATH 10A,A01,188095,Staff,0,6,35,35
1683723778848,MATH 10B,A01,188097,Bowers; Adam R.,0,12,30,30
1683723778848,MATH 10B,A02,188099,Bowers; Adam R.,0,11,30,30
1683723778848,MATH 10B,B01,188104,Bowers; Adam R.,0,10,30,30
1683723778848,MATH 10B,B02,188106,Bowers; Adam R.,0,9,30,30
1683723779875,MATH 10C,A01,188111,Staff,0,20,30,30
1683723779875,MATH 10C,A02,188127,Staff,0,19,30,30
1683723779875,MATH 10C,A03,188131,Staff,0,19,30,30
1683723779875,MATH 10C,B01,188218,Staff,17,0,30,13
1683723779875,MATH 10C,B02,188244,Staff,13,0,30,17
1683723779875,MATH 10C,B03,188277,Staff,14,0,30,16
1683723780900,MATH 18,A01,188344,Bach; Quang Tran,18,0,30,12
1683723780900,MATH 18,A02,188345,Bach; Quang Tran,11,0,30,19
1683723780900,MATH 18,B01,188353,Bach; Quang Tran,11,0,30,19
1683723780900,MATH 18,B02,188354,Bach; Quang Tran,19,0,30,11
1683723781926,MATH 20A,A01,188374,Staff,11,0,35,24
1683723782952,MATH 20B,A01,188382,Ohm; Ko Woon,7,0,30,23
1683723782952,MATH 20B,A02,188383,Ohm; Ko Woon,22,0,30,8
1683723782952,MATH 20B,B01,188385,Ohm; Ko Woon,7,0,30,23
1683723782952,MATH 20B,B02,188392,Ohm; Ko Woon,22,0,30,8
1683723783978,MATH 20C,A01,188394,Harel; Guershon,10,0,30,20
1683723783978,MATH 20C,A02,188395,Harel; Guershon,13,0,30,17
1683723783978,MATH 20C,B01,188404,Harel; Guershon,5,0,30,25
1683723783978,MATH 20C,B02,188405,Harel; Guershon,18,0,30,12
1683723785010,MATH 20D,A01,188414,Hammock; Frances H,0,1,30,30
1683723785010,MATH 20D,A02,188415,Hammock; Frances H,0,1,30,30
1683723785010,MATH 20D,B01,188447,Hammock; Frances H,0,1,30,30
1683723785010,MATH 20D,B02,188486,Hammock; Frances H,2,0,30,28
1683723786038,MATH 20E,A01,188649,Staff,21,0,30,9
1683723786038,MATH 20E,A02,188650,Staff,20,0,30,10
1683723786038,MATH 20E,A03,188673,Staff,0,0,30,30
1683723787066,MATH 102,A01,188675,Staff,0,40,35,35
1683723788091,MATH 103B,A01,188681,Staff,3,0,35,32
1683723788091,MATH 103B,B01,188692,Staff,5,0,35,30
1683723789116,MATH 109,A01,188695,Salehi Golsefidy; Alireza,24,0,35,11
1683723789116,MATH 109,A02,188696,Salehi Golsefidy; Alireza,24,0,35,11
1683723790147,MATH 120A,A01,188698,Eggers; John Dietrich,7,0,35,28
1683723791228,MATH 142B,A01,188736,Ioana; Adrian,0,0,30,30
1683723791228,MATH 142B,A02,188741,Ioana; Adrian,0,1,30,30
1683723791228,MATH 142B,A03,188743,Ioana; Adrian,0,3,30,30
1683723792258,MATH 168A,A01,188790,Staff,0,11,35,35
1683723793283,MATH 170A,A01,188803,Nie; Jiawang,0,2,35,35
1683723793283,MATH 170A,A02,188811,Nie; Jiawang,0,1,35,35
1683723793283,MATH 170A,A03,188814,Nie; Jiawang,1,0,35,34
1683723793283,MATH 170A,A04,188815,Nie; Jiawang,5,0,35,30
1683723794311,MATH 193B,A01,188817,Staff,0,0,35,35
1683723794311,MATH 193B,A02,188818,Staff,6,0,35,29
1683723795337,MGT 4,A01,202857,Anderson; John Charles,59,0,80,21
1683723796363,MGT 12,A00,202858,Lindenberger; Wade Douglas,40,0,90,50
1683723797389,MGT 18,A00,202859,Staff,73,0,90,17
1683723798414,MGT 18GS,A00,202860,McKay; Michael J,13,0,28,15
1683723799445,MGT 45,A00,202861,Pecore; Joseph P.,8,0,90,82
1683723800474,MGT 100,A00,202863,Yavorsky; Daniel Ryan,27,0,90,63
1683723801503,MGT 103,A00,202864,Ehrich; Kristine R,0,19,90,90
1683723802529,MGT 112,A00,202865,Ehrich; Kristine R,15,0,90,75
1683723803557,MGT 121A,A00,202868,Staff,70,0,90,20
1683723804583,MGT 131B,A00,202869,Anderson; John Charles,58,0,90,32
1683723805608,MGT 136,A00,202871,Lindenberger; Wade Douglas,83,0,90,7
1683723806633,MGT 164,A00,202873,Staff,0,67,90,91
1683723807658,MGT 164GS,A00,202874,McKay; Mary A,13,0,28,15
1683723808683,MGT 180,A00,202875,Staff,0,51,90,91
1683723809711,MMW 11R,A01,205019,Herbst; Matthew,0,0,30,30
1683723809711,MMW 11R,A02,205026,Herbst; Matthew,29,0,30,1
1683723810738,MMW 15,A01,193512,Chang; Edmond Yi-Teh,0,8,28,28
1683723810738,MMW 15,A02,193513,Chang; Edmond Yi-Teh,0,5,28,28
1683723810738,MMW 15,A03,193514,Chang; Edmond Yi-Teh,0,5,28,28
1683723810738,MMW 15,A04,193515,Chang; Edmond Yi-Teh,0,5,28,28
1683723810738,MMW 15,A05,193516,Chang; Edmond Yi-Teh,0,5,28,28
1683723810738,MMW 15,A06,193517,Chang; Edmond Yi-Teh,0,6,28,28
1683723810738,MMW 15,B01,193519,Chang; Edmond Yi-Teh,0,5,28,28
1683723810738,MMW 15,B02,193520,Chang; Edmond Yi-Teh,0,5,28,28
1683723810738,MMW 15,B03,193521,Chang; Edmond Yi-Teh,0,5,28,28
1683723810738,MMW 15,B04,193522,Chang; Edmond Yi-Teh,0,6,28,28
1683723810738,MMW 15,B05,193523,Chang; Edmond Yi-Teh,0,5,28,28
1683723810738,MMW 15,B06,193524,Chang; Edmond Yi-Teh,0,5,28,28
1683723811769,MMW 122,A01,193526,Rahimi; Babak,0,16,28,28
1683723811769,MMW 122,A02,193527,Rahimi; Babak,0,15,28,28
1683723811769,MMW 122,A03,193528,Rahimi; Babak,0,0,0,0
1683723811769,MMW 122,A04,193529,Rahimi; Babak,0,0,0,0
1683723812796,MUS 1A,A01,186663,Staff,0,18,35,35
1683723813822,MUS 4,A01,186715,Staff,0,12,35,35
1683723814846,MUS 5R,A01,186796,Dubnov; Shlomo,0,17,35,35
1683723815875,MUS 6,A01,186798,Staff,0,4,25,25
1683723816901,MUS 7,A01,186830,Staff,11,0,35,24
1683723817930,MUS 8,A01,186930,Staff,0,27,35,35
1683723818960,MUS 15,A01,186932,Staff,0,15,35,35
1683723818960,MUS 15,B01,186934,Staff,0,16,35,35
1683723819990,MUS 80,A00,186935,Staff,0,0,20,20
1683723819990,MUS 80,B00,186936,Staff,24,0,25,1
1683723821016,NANO 11,A00,204702,Lipomi; Darren John,0,0,0,0
1683723822042,NANO 15,A01,204709,Yang; Kesong,0,1,0,0
1683723823070,NANO 114,A00,202069,Jahed Motlagh; Zeinab,2,0,10,8
1683723824096,PHIL 1,A00,186955,Grush; Rick Scott,31,0,40,9
1683723825120,PHIL 10,A01,186973,Grush; Rick Scott,27,0,35,8
1683723825120,PHIL 10,A02,186974,Grush; Rick Scott,33,0,35,2
1683723826148,PHIL 13,A01,186976,Staff,1,0,35,34
1683723826148,PHIL 13,A02,186977,Staff,16,0,35,19
1683723827174,PHIL 14,A01,186979,Staff,30,0,35,5
1683723827174,PHIL 14,A02,186986,Staff,32,0,35,3
1683723828202,PHIL 28,A01,186988,Staff,16,0,30,14
1683723828202,PHIL 28,A02,186989,Staff,0,0,30,30
1683723828202,PHIL 28,A03,186990,Staff,10,0,30,20
1683723828202,PHIL 28,A04,186991,Staff,26,0,30,4
1683723829229,PHIL 120,A00,186997,Staff,23,0,40,17
1683723830259,PHIL 137,A00,187003,Staff,8,0,40,32
1683723831286,PHIL 150,A00,187015,Staff,47,0,70,23
1683723832315,PHIL 167,A00,187021,Lamey; Andy M.,34,0,40,6
1683723833341,PHIL 174,A01,202226,Staff,17,0,20,3
1683723833341,PHIL 174,A02,202235,Staff,20,0,20,0
1683723834369,PHIL 191A,A00,258918,Staff,0,0,1,1
1683723835393,PHYS 1A,A00,187028,Staff,26,0,60,34
1683723836419,PHYS 1AL,001,187036,Staff,3,0,30,27
1683723836419,PHYS 1AL,002,187049,Staff,18,0,30,12
1683723837445,PHYS 1B,A00,187058,Staff,21,0,60,39
1683723838469,PHYS 1BL,001,187064,Staff,0,1,30,30
1683723838469,PHYS 1BL,002,187070,Staff,4,0,30,26
1683723839495,PHYS 1C,A00,187082,Staff,30,0,120,90
1683723840526,PHYS 1CL,001,187088,Staff,0,9,30,30
1683723840526,PHYS 1CL,002,187089,Staff,0,1,30,30
1683723840526,PHYS 1CL,009,262693,Staff,9,0,30,21
1683723841551,PHYS 2B,A01,187097,Staff,55,0,115,60
1683723842575,PHYS 2C,A01,187099,Staff,63,0,115,52
1683723843602,PHYS 2CL,A01,187101,Staff,5,0,28,23
1683723843602,PHYS 2CL,A02,187102,Staff,15,0,28,13
1683723844627,PHYS 2D,A01,187123,Shotwell; Brian,95,0,115,20
1683723845651,PHYS 4B,A01,187133,Grinstein; Benjamin,35,0,50,15
1683723846680,POLI 10,A00,188819,Staff,0,4,50,50
1683723847707,POLI 11,A00,188827,Staff,43,0,50,7
1683723848738,POLI 13R,A00,188828,Staff,0,2,20,20
1683723849763,POLI 27,A01,188830,Elgin; Samuel Zincke,0,2,70,70
1683723850791,POLI 30,A00,188832,Desposato; Scott,30,0,50,20
1683723851815,POLI 102F,A00,188834,Staff,1,0,40,39
1683723852839,POLI 104A,A00,188852,Staff,12,0,30,18
1683723853869,POLI 104I,A00,188853,Staff,0,8,20,20
1683723854898,POLI 110B,A00,188854,Wiens; David,6,0,20,14
1683723855926,POLI 112A,A00,188855,Wiens; David,3,0,30,27
1683723856960,POLI 117R,A00,188856,Forman; Fonna,0,12,20,20
1683723857985,POLI 118,A00,188857,Ingham; Sean,8,0,20,12
1683723859010,POLI 120G,A00,188858,Staff,7,0,30,23
1683723860036,POLI 131CR,A00,188863,Hoston; Germaine,20,0,50,30
1683723861063,POLI 133,A00,188864,Nellis; Gareth Hb,44,0,50,6
1683723862087,POLI 134D,A00,188865,Desposato; Scott,27,0,30,3
1683723863116,POLI 142A,A00,188871,Gartzke; Erik,21,0,50,29
1683723864146,POLI 142K,A00,188874,Staff,38,0,50,12
1683723865170,POLI 143,A00,188940,Gartzke; Erik,15,0,30,15
1683723866195,POLI 153,A00,188943,Staff,1,0,20,19
1683723867224,POLI 160AA,A00,188944,Staff,10,0,40,30
1683723868247,POLI 170A,A00,188945,Staff,10,0,30,20
1683723870303,PSYC 1,A00,188952,Staff,36,0,90,54
1683723871333,PSYC 2,B00,188953,Staff,19,0,35,16
1683723872361,PSYC 6,A00,188970,Staff,47,0,60,13
1683723873386,PSYC 7,A00,188973,Staff,35,0,45,10
1683723874412,PSYC 60,A01,188980,Rickard; Timothy C.,42,0,60,18
1683723875442,PSYC 70,A01,189001,Steiner; Eric Tomas,22,0,45,23
1683723876468,PSYC 100,A00,189005,Lacefield; Katharine I,1,98,120,119
1683723877494,PSYC 102,A00,189008,Staff,6,0,30,24
1683723878520,PSYC 106,B00,189026,Gorman; Michael R.,27,0,60,33
1683723879545,PSYC 114,B01,189033,Winkielman; Piotr,0,31,30,30
1683723880576,PSYC 131,A00,189036,Anagnostaras; Stephan,0,44,60,60
1683723881602,PSYC 136,A00,189041,Lowe; Angela Beth,0,7,25,25
1683723882627,PSYC 137,A00,189057,Winkielman; Piotr,0,36,25,25
1683723883652,PSYC 144,A00,189107,Wixted; John T,0,11,50,50
1683723885706,PSYC 162,A00,189142,Staff,0,9,85,85
1683723886731,PSYC 172,A00,189144,Gorman; Michael R.,0,6,30,30
1683723888782,PSYC 179,A00,189146,Lacefield; Katharine I,0,88,120,120
1683723889806,PSYC 181,A00,189147,Anagnostaras; Stephan,0,45,90,90
1683723890831,PSYC 190R,A00,189148,Barner; David A.,0,23,80,80
1683723891859,PSYC 191,A00,189275,Rickard; Timothy C.,0,11,25,25
1683723892888,PSYC 193,A00,189276,Chapman; Eddie Nathaniel,0,1,0,4
1683723893913,PSYC 193L,A01,189281,Lowe; Angela Beth,8,0,20,12
1683723893913,PSYC 193L,B01,189285,Staff,28,0,35,7
1683723894992,RELI 149,A00,187137,Rahimi; Babak,6,0,40,34
1683723896018,SE 9,A01,187315,Staff,0,2,18,18
1683723897047,SE 101B,A00,187409,Staff,24,0,30,6
1683723898073,SE 110B,A00,187444,Staff,10,0,40,30
1683723899100,SE 130B,A00,187449,Staff,31,0,40,9
1683723900128,SE 150A,A00,187516,Staff,8,0,20,12
1683723901157,SE 154,A00,187528,Staff,29,0,50,21
1683723902182,SIO 3,A01,258171,Staff,35,0,40,5
1683723903207,SIO 10,A00,187144,Cook; Geoffrey W,0,6,75,75
1683723904232,SIO 45,A00,187152,Cook; Geoffrey W,1,7,100,99
1683723905257,SIO 109R,A00,194486,Staff,0,4,20,20
1683723907306,SIO 187,A01,187233,Kacev; David,12,0,40,28
1683723908341,SOCI 1,A01,258656,Thorpe; Charles Robert,28,0,30,2
1683723908341,SOCI 1,A02,258658,Thorpe; Charles Robert,30,0,30,0
1683723908341,SOCI 1,A03,258661,Thorpe; Charles Robert,25,0,25,0
1683723908341,SOCI 1,A04,258666,Thorpe; Charles Robert,22,0,25,3
1683723908341,SOCI 1,A05,258897,Thorpe; Charles Robert,22,0,25,3
1683723908341,SOCI 1,A06,258898,Thorpe; Charles Robert,25,0,25,0
1683723909366,SOCI 30,A01,258903,Pardo Guerra; Juan Pablo,14,0,30,16
1683723910392,SOCI 102,A00,258904,Staff,9,0,25,16
1683723911422,SOCI 106,A00,258905,Staff,19,0,25,6
1683723912451,SOCI 111,A00,258907,Ribas Norris; Janet Vanesa,26,0,30,4
1683723913475,SOCI 121R,A00,258908,Pardo Guerra; Juan Pablo,7,0,30,23
1683723914505,SOCI 126,A01,203330,Staff,14,0,20,6
1683723915534,SOCI 131,A00,258909,Thorpe; Charles Robert,30,0,60,30
1683723916563,SOCI 135,A00,258910,Payne; Christine Anna,0,13,30,30
1683723917588,SOCI 157,A00,258911,Staff,10,0,30,20
1683723918615,SOCI 184,A00,258912,Staff,25,0,30,5
1683723919642,SOCI 188D,A00,258913,Staff,22,0,30,8
1683723920669,SYN 2,001,187529,Staff,9,0,16,7
1683723920669,SYN 2,002,201452,Staff,0,20,16,16
1683723920669,SYN 2,003,201469,Staff,1,0,16,15
1683723921698,SYN 100,A01,187531,Staff,0,9,20,20
1683723921698,SYN 100,B01,201491,Staff,0,10,20,20
1683723922731,TDAC 1,A00,189286,Walsh; Kim C.,3,0,20,17
1683723922731,TDAC 1,B00,189287,Harting; Carla Kelso,10,0,20,10
1683723923755,TDAC 101,A00,189300,Walsh; Kim C.,16,0,20,4
1683723923755,TDAC 101,B00,189301,Harting; Carla Kelso,18,0,20,2
1683723924781,TDAC 102,A00,189304,Basso; Beatrice,14,0,20,6
1683723925806,TDAC 108,A00,189305,Staff,18,0,20,2
1683723926833,TDDE 131,A00,189310,Staff,19,0,20,1
1683723926833,TDDE 131,B00,189314,Staff,19,0,20,1
1683723926833,TDDE 131,C00,189315,Staff,48,0,50,2
1683723926833,TDDE 131,D00,189316,Staff,14,0,15,1
1683723926833,TDDE 131,E00,204841,Staff,20,0,20,0
1683723927858,TDGE 10,A00,189289,Staff,26,0,50,24
1683723927858,TDGE 10,B00,189290,Havis; Allan,0,1,50,50
1683723928889,TDGE 11,A00,189291,Fulton; Julia,0,4,50,50
1683723928889,TDGE 11,B00,189292,Staff,20,0,25,5
1683723928889,TDGE 11,C00,260270,Staff,0,0,0,0
1683723929917,TDGE 25,A00,189294,Staff,1,0,20,19
1683723930945,TDGE 124,A00,189318,Fulton; Julia,0,7,50,50
1683723931970,TDGE 125,A00,189319,Staff,13,0,25,12
1683723931970,TDGE 125,B00,189320,Staff,23,0,25,2
1683723932999,TDGE 127,A00,189322,Havis; Allan,1,0,50,49
1683723934028,TDHT 101,A00,189323,Staff,18,0,25,7
1683723934028,TDHT 101,B00,189324,Staff,25,0,25,0
1683723935058,TDHT 102,A00,189325,Staff,49,0,50,1
1683723936082,TDMV 1,A00,189295,Arcidiacono; Kristin,20,0,30,10
1683723936082,TDMV 1,B00,189296,Caligagan; Maria T.,23,0,30,7
1683723937111,TDMV 2,A00,189297,Sammartano; Tonnie,27,0,30,3
1683723937111,TDMV 2,B00,189299,Arcidiacono; Kristin,23,0,30,7
1683723938150,TDMV 3,A00,204998,Rincon; Alicia,22,0,30,8
1683723939175,TDMV 120,A00,189458,Sammartano; Tonnie,28,0,30,2
1683723940200,TDMV 138,A00,189541,Jun; Grace Shin Hae,20,0,40,20
1683723941225,TDMV 142,A00,189717,Caligagan; Tony,25,0,30,5
1683723941225,TDMV 142,B00,189718,Caligagan; Maria T.,25,0,30,5
1683723942250,TMC 2,A01,187533,Staff,25,0,25,0
1683723942250,TMC 2,A02,187534,Staff,25,0,25,0
1683723943279,USP 1,A01,187536,Kwak; Nancy,0,16,25,25
1683723944303,USP 5,A01,187538,Staff,8,0,25,17
1683723945328,USP 101,A00,199253,Staff,0,4,0,0
1683723946358,USP 124,A00,187562,Boomhower; Matthew Charles,0,0,30,30
1683723947383,USP 138,A00,187582,Staff,19,0,25,6
1683723948409,USP 152,A01,187597,Staff,3,0,25,22
1683723949435,USP 153,A00,187598,Staff,18,0,25,7
1683723950461,USP 168,A00,187607,Kwak; Nancy,2,0,5,3
1683723951485,USP 173,A00,187619,Staff,4,0,25,21
1683723952510,USP 181,A00,187638,Staff,0,4,25,25
1683723953539,VIS 103,A00,187650,Cruz; Edwin Teddy,17,0,75,58
1683723954564,VIS 110D,A00,187669,Staff,13,0,22,9
1683723955588,VIS 127C,A00,187720,Shen; Kuiyi,67,0,146,79
1683723956613,VIS 149,A00,187731,Yoldas; Pinar,0,12,22,22
1683723957639,VIS 151,A01,188091,Staff,22,0,34,12
1683723957639,VIS 151,A02,188092,Staff,11,0,34,23
1683723958668,VIS 160B,A00,188093,Stalbaum; Brett,0,1,10,10
1683723960724,WCWP 10B,A00,201720,Staff,0,0,5,5
1683723960724,WCWP 10B,B00,201722,Staff,0,0,6,6
1683723961750,WCWP 100,A00,201725,Gagnon; Jeffrey C,0,0,2,2
1683723961750,WCWP 100,B00,201727,Staff,0,4,15,15
1683723964877,ANBI 133,A00,258401,Wilder; Linnea Lorene,34,0,40,6
1683723965906,ANBI 140,A00,258395,Hrvoj Mihic; Branka,18,0,25,7
1683723966932,ANSC 120,A00,258402,Bialecki; Jon Anthony,26,0,40,14
1683723967958,ANSC 144,A00,258400,Staff,12,0,40,28
1683723970021,ANSC 166,A00,258396,Parish; Steven Martin,156,0,175,19
1683723971046,ANSC 180,A00,193533,Staff,8,0,20,12
1683723972072,ANSC 188,A00,258397,Jassal; Aftab,34,0,40,6
1683723973098,ANTH 3,A01,258316,Staff,23,0,30,7
1683723974127,ANTH 5,A00,258394,Semendeferi; Ekaterini,16,0,20,4
1683723975153,ANTH 21,A01,258331,Staff,4,0,40,36
1683723976176,ANTH 103,A00,258398,Varma; Saiba,15,0,25,10
1683723977215,AWP 10,001,202034,Staff,0,0,0,0
1683723977215,AWP 10,002,202035,Staff,0,0,0,0
1683723977215,AWP 10,003,202036,Staff,0,0,0,0
1683723977215,AWP 10,004,202037,Staff,0,0,0,0
1683723977215,AWP 10,005,202038,Staff,0,0,0,0
1683723977215,AWP 10,006,202039,Staff,0,0,0,0
1683723977215,AWP 10,007,202040,Staff,0,0,0,0
1683723977215,AWP 10,008,202041,Staff,0,0,0,0
1683723977215,AWP 10,009,202042,Staff,0,0,0,0
1683723977215,AWP 10,010,202043,Staff,0,0,0,0
1683723977215,AWP 10,011,202044,Staff,0,0,0,0
1683723977215,AWP 10,012,202045,Staff,0,0,0,0
1683723977215,AWP 10,013,202046,Staff,0,0,0,0
1683723977215,AWP 10,014,202047,Staff,0,0,0,0
1683723977215,AWP 10,015,202048,Staff,0,0,0,0
1683723977215,AWP 10,016,202049,Staff,0,0,0,0
1683723977215,AWP 10,017,202050,Staff,0,0,0,0
1683723977215,AWP 10,018,202051,Staff,0,0,0,0
1683723977215,AWP 10,019,202052,Staff,0,0,0,0
1683723977215,AWP 10,020,202053,Staff,0,0,0,0
1683723977215,AWP 10,021,202054,Staff,0,0,0,0
1683723977215,AWP 10,022,202055,Staff,0,0,0,0
1683723977215,AWP 10,023,202056,Staff,0,0,0,0
1683723977215,AWP 10,024,202057,Staff,0,0,0,0
1683723977215,AWP 10,025,202058,Staff,0,0,0,0
1683723977215,AWP 10,026,202059,Staff,0,0,0,0
1683723978242,AWP 102,001,202032,Staff,0,0,0,0
1683723978242,AWP 102,002,202033,Staff,0,0,0,0
1683723979268,BENG 100,A01,254234,Taylor Amos; Alyssa C,31,0,40,9
1683723980298,BENG 196,001,270013,Engler; Adam J.,9999,0,9999,0
1683723981330,BICD 100R,A01,202018,Smith; Laurie,0,7,32,32
1683723981330,BICD 100R,A02,202019,Smith; Laurie,0,3,32,32
1683723981330,BICD 100R,A03,202020,Smith; Laurie,0,1,32,32
1683723981330,BICD 100R,A04,202021,Smith; Laurie,6,0,32,26
1683723981330,BICD 100R,A05,202022,Smith; Laurie,10,0,32,22
1683723982355,BICD 136,A01,193242,Gustafson-Brown; Cindy,0,2,32,32
1683723982355,BICD 136,A02,193244,Gustafson-Brown; Cindy,13,0,32,19
1683723983382,BIEB 102,A01,193249,Butler; Shannon Rhey,0,0,32,32
1683723983382,BIEB 102,A02,193251,Butler; Shannon Rhey,0,0,32,32
1683723983382,BIEB 102,A03,193253,Butler; Shannon Rhey,0,0,32,32
1683723983382,BIEB 102,A04,193255,Butler; Shannon Rhey,13,0,32,19
1683723983382,BIEB 102,A05,193265,Butler; Shannon Rhey,25,0,32,7
1683723983382,BIEB 102,A06,193269,Butler; Shannon Rhey,12,0,32,20
1683723985437,BIEB 150,A01,193274,Staff,0,0,32,32
1683723985437,BIEB 150,A02,193285,Staff,24,0,32,8
1683723986468,BIEB 194,A00,193286,Kurle; Carolyn M.,19,0,32,13
1683723987495,BILD 1,A01,192291,Staff,15,0,32,17
1683723987495,BILD 1,A02,192292,Staff,30,0,32,2
1683723987495,BILD 1,B01,192520,Reuther; Keefe,0,1,0,0
1683723987495,BILD 1,B02,192532,Reuther; Keefe,0,1,0,0
1683723988526,BILD 3,A01,192556,Butler; Shannon Rhey,0,0,32,32
1683723988526,BILD 3,A02,192581,Butler; Shannon Rhey,0,1,32,32
1683723988526,BILD 3,A03,192611,Butler; Shannon Rhey,19,0,32,13
1683723988526,BILD 3,A04,192612,Butler; Shannon Rhey,23,0,32,9
1683723988526,BILD 3,A05,192613,Butler; Shannon Rhey,26,0,32,6
1683723988526,BILD 3,A06,192679,Butler; Shannon Rhey,27,0,32,5
1683723988526,BILD 3,A07,192682,Butler; Shannon Rhey,20,0,32,12
1683723989555,BILD 4,A01,192836,Reuther; Keefe,1,0,24,23
1683723989555,BILD 4,A02,193044,Reuther; Keefe,4,0,24,20
1683723990597,BILD 10,A01,193142,Gustafson-Brown; Cindy,29,0,32,3
1683723990597,BILD 10,A02,193149,Gustafson-Brown; Cindy,31,0,32,1
1683723991621,BIMM 100,A01,193301,Staff,0,6,32,32
1683723991621,BIMM 100,A02,193312,Staff,0,7,32,32
1683723991621,BIMM 100,A03,193323,Staff,0,10,32,32
1683723992648,BIMM 101,A01,193329,McDonnell; Lisa Marie,0,3,24,24
1683723992648,BIMM 101,A02,193339,McDonnell; Lisa Marie,0,3,24,24
1683723992648,BIMM 101,B01,193354,McDonnell; Lisa Marie,0,4,24,24
1683723992648,BIMM 101,B02,193357,McDonnell; Lisa Marie,0,3,24,24
1683723993674,BIMM 110,A01,193377,Tat; John,0,11,32,32
1683723993674,BIMM 110,A02,193378,Tat; John,0,11,32,32
1683723994699,BIMM 120,A01,206116,Staff,0,0,32,32
1683723994699,BIMM 120,A02,206117,Staff,7,0,32,25
1683723994699,BIMM 120,A03,206121,Staff,21,0,32,11
1683723995725,BIPN 100,A01,193393,Park; Ji Young,0,15,32,32
1683723995725,BIPN 100,A02,193402,Park; Ji Young,0,14,32,32
1683723995725,BIPN 100,A03,193413,Park; Ji Young,0,14,32,32
1683723995725,BIPN 100,A04,193414,Park; Ji Young,0,13,32,32
1683723996750,BIPN 102,A01,193429,Staff,0,0,32,32
1683723996750,BIPN 102,A02,193438,Staff,18,0,32,14
1683723997777,BIPN 106,A01,193450,Reyes Gonzalez; Catalina,0,2,40,40
1683723998858,BIPN 134,A01,193465,Cooke; James Edward,0,0,32,32
1683723998858,BIPN 134,A02,193474,Cooke; James Edward,25,0,32,7
1683723998858,BIPN 134,A03,193485,Cooke; James Edward,29,0,32,3
1683723998858,BIPN 134,A04,193486,Cooke; James Edward,20,0,32,12
1683723998858,BIPN 134,A05,193491,Cooke; James Edward,31,0,32,1
1683723998858,BIPN 134,A06,193501,Cooke; James Edward,30,0,32,2
1683723998858,BIPN 134,A07,193510,Cooke; James Edward,29,0,32,3
1683724000912,BISP 194,A00,222522,Staff,14,0,32,18
1683724001937,CAT 124,A01,202407,Staff,19,0,25,6
1683724002963,CAT 125,A00,202408,Marchisotto; Jennifer Anne,2,0,20,18
1683724003997,CAT 125R,A00,202409,Smith; Lauryn Alissa,0,11,20,20
1683724003997,CAT 125R,B00,202410,Morales; Celeste Georgianna,0,11,20,20
1683724003997,CAT 125R,C00,202411,Irwin; Matthew Joseph,0,12,20,20
1683724005027,CENG 15,A01,204712,Yang; Kesong,0,1,0,0
1683724006058,CENG 114,A00,202070,Jahed Motlagh; Zeinab,5,0,20,15
1683724007085,CGS 105,A00,185477,Wesling; Megan E.,24,0,40,16
1683724008110,CGS 106,A00,185494,Staff,11,0,22,11
1683724009133,CGS 108,A00,185495,Staff,14,0,20,6
1683724010158,CGS 114,A00,185496,Staff,13,0,18,5
1683724011183,CGS 119,A00,185501,Staff,15,0,20,5
1683724012209,CGS 120,A00,185511,Staff,11,0,20,9
1683724013237,CHEM 4,A01,184675,Bussey; Thomas J,97,0,100,3
1683724014263,CHEM 6A,A01,184677,Staff,32,0,60,28
1683724015289,CHEM 6B,A01,184679,Staff,63,0,100,37
1683724016315,CHEM 6C,A01,184681,Bussey; Thomas J,0,0,50,50
1683724016315,CHEM 6C,A02,184682,Bussey; Thomas J,32,0,50,18
1683724017342,CHEM 40A,A01,184684,Albizati; Kim F.,33,0,100,67
1683724018368,CHEM 40B,A01,184686,Albizati; Kim F.,0,22,100,100
1683724019392,CHEM 41B,A01,184690,Staff,51,0,100,49
1683724020425,COGS 3,A01,184715,Boyle; Mary E. T.,0,27,40,40
1683724021450,COGS 14B,A01,185172,Staff,0,14,38,38
1683724022478,COGS 18,A01,184736,Staff,14,0,80,66
1683724023508,COGS 100,A01,184932,Staff,0,8,73,73
1683724024537,COGS 101A,A01,184935,Staff,0,40,30,30
1683724025562,COGS 101B,A01,184944,Staff,0,2,30,30
1683724026587,COGS 101C,A01,184946,Staff,0,10,30,30
1683724027618,COGS 102A,A01,184951,Johnson; Christine M.,1,0,40,39
1683724028649,COGS 107B,A01,184953,Mooshagian; Eric Frederick,0,52,40,40
1683724029677,COGS 118B,A01,184959,Gupta; Anjum,0,50,40,40
1683724030701,COGS 153,A00,184961,Staff,1,16,30,29
1683724031730,COGS 177,A00,184962,Staff,0,20,30,30
1683724032755,COGS 187A,A01,184969,Boyle; Mary E. T.,0,19,40,40
1683724033781,COMM 10,A01,185174,Staff,0,5,25,25
1683724033781,COMM 10,A02,185189,Staff,0,2,25,25
1683724033781,COMM 10,A03,269821,Staff,0,1,0,0
1683724034807,COMM 100B,A02,185476,Staff,10,0,25,15
1683724034807,COMM 100B,A03,277340,Staff,25,0,25,0
1683724035836,COMM 100C,A01,185314,Staff,2,0,25,23
1683724035836,COMM 100C,A02,185327,Staff,17,0,25,8
1683724036864,COMM 110M,A00,185349,Staff,0,0,40,40
1683724037892,COMM 113T,A00,185352,Staff,25,0,40,15
1683724038917,COMM 114I,A00,185353,Staff,31,0,40,9
1683724039942,COMM 131,A00,185354,Staff,17,0,30,13
1683724040973,CSE 8A,A50,185358,Cao; Yingjun,0,46,10,10
1683724041997,CSE 8B,A01,185362,Staff,0,48,50,50
1683724043024,CSE 11,A01,185416,Cao; Yingjun,0,91,10,10
1683724044054,CSE 20,A01,185445,Briones; Jor-el Thomas Caparas,3,0,25,22
1683724045082,CSE 21,A01,185447,Staff,9,0,50,41
1683724046107,CSE 101,A01,185451,Staff,0,13,50,50
1683724046107,CSE 101,B01,185453,Jones; Miles E,0,15,50,50
1683724048154,CSE 141,A01,185458,Eldon; John,16,0,100,84
1683724049180,CSE 141L,A01,185461,Eldon; John,8,0,100,92
1683724050205,CSE 142,A01,185463,Staff,34,0,60,26
1683724050205,CSE 142,B01,201355,Staff,0,7,60,60
1683724051229,CSE 142L,A01,185470,Staff,34,0,60,26
1683724051229,CSE 142L,B01,201417,Staff,0,6,60,60
1683724052255,CSE 190,A00,201433,Staff,32,0,49,17
1683724053280,DOC 1,A01,259136,Strom; Megan C.,7,0,15,8
1683724053280,DOC 1,A02,259137,Strom; Megan C.,15,0,15,0
1683724053280,DOC 1,A03,259138,Strom; Megan C.,14,0,15,1
1683724053280,DOC 1,A04,259139,Strom; Megan C.,13,0,15,2
1683724054307,DOC 100D,A00,259140,Pass; Natalye Joann,14,0,25,11
1683724055332,DSGN 1,A01,184749,Rill; Bryan,0,26,30,30
1683724056359,DSGN 100,A01,185168,Staff,0,2,25,25
1683724057390,ECE 5,A01,185626,Morris; Karcher William,0,12,0,0
1683724058415,ECE 101,A01,185628,Staff,14,0,70,56
1683724059444,ECE 107,A01,185635,Baghdadchi; Saharnaz,0,0,20,20
1683724059444,ECE 107,A02,185638,Baghdadchi; Saharnaz,1,0,20,19
1683724060478,ECE 148,A01,185647,Silberman; Jack,0,0,16,16
1683724061507,ECON 1,A01,185537,Crane; Meredith Helen,54,0,70,16
1683724062533,ECON 3,A01,185549,Crane; Meredith Helen,30,0,70,40
1683724063563,ECON 4,A01,203354,Anderson; John Charles,0,5,10,10
1683724064590,ECON 100A,A01,185574,Staff,0,5,40,40
1683724065616,ECON 100B,A01,185576,Staff,0,12,50,50
1683724066648,ECON 100C,A01,185589,Newhouse; Herbert S,30,0,70,40
1683724067674,ECON 105,A00,185608,Vespa; Emanuel Ignacio,19,0,35,16
1683724068705,ECON 109,A01,185610,Shishkin; Denis,9,0,35,26
1683724069735,ECON 110A,A01,185612,Staff,8,0,40,32
1683724070759,ECON 120A,A01,185615,Staff,19,0,40,21
1683724071783,ECON 120C,A01,185617,Sun; Yixiao,0,21,70,70
1683724072810,ECON 144,A00,203346,Squires; Dale E,2,0,35,33
1683724073835,ECON 171,A01,203349,Newhouse; Herbert S,0,1,35,35
1683724074861,ECON 173A,A01,185621,Toda; Alexis Akira,21,0,35,14
1683724075889,EDS 25,A01,202413,Staff,0,1,0,0
1683724075889,EDS 25,A02,202414,Staff,0,1,0,0
1683724075889,EDS 25,A03,202415,Staff,0,0,0,0
1683724075889,EDS 25,A04,202416,Staff,0,1,0,0
1683724075889,EDS 25,A05,202439,Staff,0,0,0,0
1683724075889,EDS 25,A06,202440,Staff,0,0,0,0
1683724075889,EDS 25,B01,202631,Staff,0,0,0,0
1683724075889,EDS 25,B02,202632,Staff,0,0,0,0
1683724075889,EDS 25,B03,202639,Staff,0,0,0,0
1683724075889,EDS 25,B04,202640,Staff,0,0,0,0
1683724075889,EDS 25,B05,202643,Staff,0,0,0,0
1683724075889,EDS 25,B06,202644,Staff,0,0,0,0
1683724076915,EDS 38,A01,202659,Black; Alison Michelle,25,0,25,0
1683724077942,EDS 115,A00,202652,Staff,18,0,30,12
1683724078967,EDS 125,A00,202649,Staff,13,0,30,17
1683724079992,EDS 126,A01,203332,Staff,30,0,30,0
1683724081020,EDS 139,A00,202838,Staff,16,0,25,9
1683724082048,EDS 146,A01,202655,Staff,14,0,25,11
1683724083077,ENG 15,A00,185667,Staff,0,1,0,0
1683724083077,ENG 15,B00,185672,Staff,0,0,0,0
1683724083077,ENG 15,C00,185675,Staff,0,0,0,0
1683724083077,ENG 15,D00,185682,Staff,0,0,0,0
1683724083077,ENG 15,E00,185684,Staff,0,0,0,0
1683724084102,ETHN 103,A00,185710,Staff,0,8,35,35
1683724085130,ETHN 103A,A00,199228,Man; Simeon S,0,0,9,9
1683724086155,ETHN 109,A00,185711,Staff,15,0,35,20
1683724087180,ETHN 142,A00,185726,Staff,0,4,30,30
1683724088211,ETHN 163J,A00,199229,Man; Simeon S,5,0,8,3
1683724089234,ETHN 168,A00,185727,Staff,7,0,10,3
1683724090259,ETHN 182,A00,185728,Staff,0,0,35,35
1683724091288,ETHN 183,A00,185737,Staff,10,0,18,8
1683724092314,GLBH 111,A01,209361,Burgos; Jose L.,0,0,0,0
1683724094368,HIEU 104,A00,185792,Staff,14,0,20,6
1683724095397,HIEU 115,A00,185800,Staff,0,0,20,20
1683724096422,HIEU 128,A00,185801,Staff,0,9,20,20
1683724097447,HIEU 147,A00,185802,Staff,15,0,20,5
1683724098473,HIEU 154,A00,185823,Staff,11,0,20,9
1683724099502,HILA 102,A00,185826,Staff,14,0,20,6
1683724100526,HILD 2C,A01,185778,Staff,0,13,20,20
1683724101554,HILD 7B,A01,185780,Kwak; Nancy,0,17,32,32
1683724101554,HILD 7B,A02,185781,Kwak; Nancy,0,18,32,32
1683724102638,HILD 30,A01,185791,Staff,12,0,20,8
1683724103667,HISC 119,A00,185830,Golan; Tal,0,10,20,20
1683724104691,HITO 156GS,A00,185831,Patterson; Patrick H.,0,0,0,23
1683724105716,HIUS 103,A00,185832,Man; Simeon S,0,4,20,20
1683724106744,HIUS 117,A00,185836,Kwak; Nancy,2,0,20,18
1683724107769,HIUS 125,A00,185840,Man; Simeon S,0,2,23,23
1683724108799,HIUS 149,A00,185845,Staff,1,0,20,19
1683724109833,HUM 3,A01,185882,Zavodny; Tatiana Sophia,0,8,50,50
1683724109833,HUM 3,B01,185899,Caldwell; Michael Alan,0,18,50,50
1683724110857,HUM 3GS,A00,185900,Patterson; Patrick H.,0,0,0,23
1683724111883,HUM 4,A01,185938,Zroka; Amy Liane,28,0,50,22
1683724111883,HUM 4,B01,185956,Watkins; Eric,0,6,50,50
1683724111883,HUM 4,B02,202209,Watkins; Eric,0,6,50,50
1683724111883,HUM 4,B03,202210,Watkins; Eric,0,5,50,50
1683724112912,HUM 5,A01,185958,West; Geoffrey Scott,0,0,50,50
1683724112912,HUM 5,A02,202215,West; Geoffrey Scott,0,1,50,50
1683724113942,INTL 190,A00,185959,Gagnon; Jeffrey C,0,0,0,9
1683724113942,INTL 190,B00,185960,Lettieri; Michael Joseph,0,0,0,2
1683724114968,JAPN 180,A00,254509,Staff,4,0,30,26
1683724116001,LATI 10,A01,202853,Kennemore; Amy Michelle,4,0,35,31
1683724116001,LATI 10,A02,202854,Kennemore; Amy Michelle,3,0,35,32
1683724116001,LATI 10,A03,270054,Kennemore; Amy Michelle,30,0,30,0
1683724117031,LATI 180,A00,202855,Kennemore; Amy Michelle,11,0,20,9
1683724118058,LAWS 101,A00,201767,Golan; Tal,0,7,40,40
1683724119085,LIFR 1C,A00,185961,Staff,6,0,20,14
1683724120109,LIFR 1CX,A00,185962,Staff,7,0,20,13
1683724121137,LIFR 1D,A00,185963,Staff,7,0,20,13
1683724122164,LIFR 1DX,A00,185964,Staff,7,0,20,13
1683724123189,LIGN 101,A01,186039,Staff,43,0,50,7
1683724124213,LIGN 165,A00,186040,Staff,14,0,50,36
1683724125238,LTCS 108,A00,186041,Staff,5,0,10,5
1683724126263,LTCS 119,A00,186042,Staff,15,0,20,5
1683724127287,LTCS 130,A00,186043,Wesling; Megan E.,15,0,25,10
1683724129342,LTEA 138,A00,186119,Staff,13,0,40,27
1683724130367,LTEN 124,A00,186148,Staff,5,0,25,20
1683724131394,LTEN 178,A00,186149,Staff,6,0,15,9
1683724132424,LTEN 181,A00,186150,Blanco; John D,34,0,40,6
1683724133453,LTWL 120,A00,186160,Staff,19,0,25,6
1683724134479,LTWL 165,A00,186161,Staff,22,0,25,3
1683724135508,LTWR 100,A00,186162,Staff,0,5,15,15
1683724136534,LTWR 102,A00,186163,Doller; Ben,5,0,15,10
1683724137563,MAE 8,A01,186412,Staff,0,1,0,0
1683724138586,MAE 30B,A00,186445,Bahadori; Mohammad Yousef,81,0,100,19
1683724139611,MAE 40,A00,186592,Bewley; Thomas R,10,0,50,40
1683724140639,MAE 101B,A00,186593,Bahadori; Mohammad Yousef,80,0,100,20
1683724141667,MAE 105,A00,186594,Bandaru; Prabhakar,10,0,50,40
1683724142693,MAE 107,A00,186599,Pham; Hieu Tan,0,8,120,120
1683724143718,MAE 148,A01,186660,Silberman; Jack,3,0,16,13
1683724144747,MATH 10A,A01,188095,Staff,0,6,35,35
1683724145774,MATH 10B,A01,188097,Bowers; Adam R.,0,12,30,30
1683724145774,MATH 10B,A02,188099,Bowers; Adam R.,0,11,30,30
1683724145774,MATH 10B,B01,188104,Bowers; Adam R.,0,10,30,30
1683724145774,MATH 10B,B02,188106,Bowers; Adam R.,0,9,30,30
1683724146801,MATH 10C,A01,188111,Staff,0,20,30,30
1683724146801,MATH 10C,A02,188127,Staff,0,19,30,30
1683724146801,MATH 10C,A03,188131,Staff,0,19,30,30
1683724146801,MATH 10C,B01,188218,Staff,17,0,30,13
1683724146801,MATH 10C,B02,188244,Staff,13,0,30,17
1683724146801,MATH 10C,B03,188277,Staff,14,0,30,16
1683724147827,MATH 18,A01,188344,Bach; Quang Tran,18,0,30,12
1683724147827,MATH 18,A02,188345,Bach; Quang Tran,11,0,30,19
1683724147827,MATH 18,B01,188353,Bach; Quang Tran,11,0,30,19
1683724147827,MATH 18,B02,188354,Bach; Quang Tran,19,0,30,11
1683724148856,MATH 20A,A01,188374,Staff,11,0,35,24
1683724149886,MATH 20B,A01,188382,Ohm; Ko Woon,7,0,30,23
1683724149886,MATH 20B,A02,188383,Ohm; Ko Woon,22,0,30,8
1683724149886,MATH 20B,B01,188385,Ohm; Ko Woon,7,0,30,23
1683724149886,MATH 20B,B02,188392,Ohm; Ko Woon,22,0,30,8
1683724150913,MATH 20C,A01,188394,Harel; Guershon,10,0,30,20
1683724150913,MATH 20C,A02,188395,Harel; Guershon,13,0,30,17
1683724150913,MATH 20C,B01,188404,Harel; Guershon,5,0,30,25
1683724150913,MATH 20C,B02,188405,Harel; Guershon,18,0,30,12
1683724151941,MATH 20D,A01,188414,Hammock; Frances H,0,1,30,30
1683724151941,MATH 20D,A02,188415,Hammock; Frances H,0,1,30,30
1683724151941,MATH 20D,B01,188447,Hammock; Frances H,0,1,30,30
1683724151941,MATH 20D,B02,188486,Hammock; Frances H,2,0,30,28
1683724152966,MATH 20E,A01,188649,Staff,21,0,30,9
1683724152966,MATH 20E,A02,188650,Staff,20,0,30,10
1683724152966,MATH 20E,A03,188673,Staff,0,0,30,30
1683724153992,MATH 102,A01,188675,Staff,0,40,35,35
1683724155025,MATH 103B,A01,188681,Staff,3,0,35,32
1683724155025,MATH 103B,B01,188692,Staff,5,0,35,30
1683724156052,MATH 109,A01,188695,Salehi Golsefidy; Alireza,24,0,35,11
1683724156052,MATH 109,A02,188696,Salehi Golsefidy; Alireza,24,0,35,11
1683724157077,MATH 120A,A01,188698,Eggers; John Dietrich,7,0,35,28
1683724158103,MATH 142B,A01,188736,Ioana; Adrian,0,0,30,30
1683724158103,MATH 142B,A02,188741,Ioana; Adrian,0,1,30,30
1683724158103,MATH 142B,A03,188743,Ioana; Adrian,0,3,30,30
1683724159132,MATH 168A,A01,188790,Staff,0,11,35,35
1683724160163,MATH 170A,A01,188803,Nie; Jiawang,0,2,35,35
1683724160163,MATH 170A,A02,188811,Nie; Jiawang,0,1,35,35
1683724160163,MATH 170A,A03,188814,Nie; Jiawang,1,0,35,34
1683724160163,MATH 170A,A04,188815,Nie; Jiawang,5,0,35,30
1683724161188,MATH 193B,A01,188817,Staff,0,0,35,35
1683724161188,MATH 193B,A02,188818,Staff,6,0,35,29
1683724162214,MGT 4,A01,202857,Anderson; John Charles,59,0,80,21
1683724163238,MGT 12,A00,202858,Lindenberger; Wade Douglas,40,0,90,50
1683724164263,MGT 18,A00,202859,Staff,73,0,90,17
1683724165288,MGT 18GS,A00,202860,McKay; Michael J,13,0,28,15
1683724166320,MGT 45,A00,202861,Pecore; Joseph P.,8,0,90,82
1683724167346,MGT 100,A00,202863,Yavorsky; Daniel Ryan,27,0,90,63
1683724168373,MGT 103,A00,202864,Ehrich; Kristine R,0,19,90,90
1683724169400,MGT 112,A00,202865,Ehrich; Kristine R,15,0,90,75
1683724170432,MGT 121A,A00,202868,Staff,70,0,90,20
1683724171458,MGT 131B,A00,202869,Anderson; John Charles,58,0,90,32
1683724172483,MGT 136,A00,202871,Lindenberger; Wade Douglas,83,0,90,7
1683724173507,MGT 164,A00,202873,Staff,0,67,90,91
1683724174531,MGT 164GS,A00,202874,McKay; Mary A,13,0,28,15
1683724175555,MGT 180,A00,202875,Staff,0,51,90,91
1683724176580,MMW 11R,A01,205019,Herbst; Matthew,0,0,30,30
1683724176580,MMW 11R,A02,205026,Herbst; Matthew,29,0,30,1
1683724177614,MMW 15,A01,193512,Chang; Edmond Yi-Teh,0,8,28,28
1683724177614,MMW 15,A02,193513,Chang; Edmond Yi-Teh,0,5,28,28
1683724177614,MMW 15,A03,193514,Chang; Edmond Yi-Teh,0,5,28,28
1683724177614,MMW 15,A04,193515,Chang; Edmond Yi-Teh,0,5,28,28
1683724177614,MMW 15,A05,193516,Chang; Edmond Yi-Teh,0,5,28,28
1683724177614,MMW 15,A06,193517,Chang; Edmond Yi-Teh,0,6,28,28
1683724177614,MMW 15,B01,193519,Chang; Edmond Yi-Teh,0,5,28,28
1683724177614,MMW 15,B02,193520,Chang; Edmond Yi-Teh,0,5,28,28
1683724177614,MMW 15,B03,193521,Chang; Edmond Yi-Teh,0,5,28,28
1683724177614,MMW 15,B04,193522,Chang; Edmond Yi-Teh,0,6,28,28
1683724177614,MMW 15,B05,193523,Chang; Edmond Yi-Teh,0,5,28,28
1683724177614,MMW 15,B06,193524,Chang; Edmond Yi-Teh,0,5,28,28
1683724178643,MMW 122,A01,193526,Rahimi; Babak,0,16,28,28
1683724178643,MMW 122,A02,193527,Rahimi; Babak,0,15,28,28
1683724178643,MMW 122,A03,193528,Rahimi; Babak,0,0,0,0
1683724178643,MMW 122,A04,193529,Rahimi; Babak,0,0,0,0
1683724179670,MUS 1A,A01,186663,Staff,0,18,35,35
1683724180699,MUS 4,A01,186715,Staff,0,12,35,35
1683724181728,MUS 5R,A01,186796,Dubnov; Shlomo,0,17,35,35
1683724182762,MUS 6,A01,186798,Staff,0,4,25,25
1683724183790,MUS 7,A01,186830,Staff,11,0,35,24
1683724184819,MUS 8,A01,186930,Staff,0,27,35,35
1683724185849,MUS 15,A01,186932,Staff,0,15,35,35
1683724185849,MUS 15,B01,186934,Staff,0,16,35,35
1683724186882,MUS 80,A00,186935,Staff,0,0,20,20
1683724186882,MUS 80,B00,186936,Staff,24,0,25,1
1683724187909,NANO 11,A00,204702,Lipomi; Darren John,0,0,0,0
1683724188935,NANO 15,A01,204709,Yang; Kesong,0,1,0,0
1683724189965,NANO 114,A00,202069,Jahed Motlagh; Zeinab,2,0,10,8
1683724190990,PHIL 1,A00,186955,Grush; Rick Scott,31,0,40,9
1683724192015,PHIL 10,A01,186973,Grush; Rick Scott,27,0,35,8
1683724192015,PHIL 10,A02,186974,Grush; Rick Scott,33,0,35,2
1683724193040,PHIL 13,A01,186976,Staff,1,0,35,34
1683724193040,PHIL 13,A02,186977,Staff,16,0,35,19
1683724194070,PHIL 14,A01,186979,Staff,30,0,35,5
1683724194070,PHIL 14,A02,186986,Staff,32,0,35,3
1683724195097,PHIL 28,A01,186988,Staff,16,0,30,14
1683724195097,PHIL 28,A02,186989,Staff,0,0,30,30
1683724195097,PHIL 28,A03,186990,Staff,10,0,30,20
1683724195097,PHIL 28,A04,186991,Staff,26,0,30,4
1683724196125,PHIL 120,A00,186997,Staff,23,0,40,17
1683724197150,PHIL 137,A00,187003,Staff,8,0,40,32
1683724198175,PHIL 150,A00,187015,Staff,47,0,70,23
1683724199201,PHIL 167,A00,187021,Lamey; Andy M.,34,0,40,6
1683724200228,PHIL 174,A01,202226,Staff,17,0,20,3
1683724200228,PHIL 174,A02,202235,Staff,20,0,20,0
1683724201253,PHIL 191A,A00,258918,Staff,0,0,1,1
1683724202279,PHYS 1A,A00,187028,Staff,26,0,60,34
1683724203306,PHYS 1AL,001,187036,Staff,3,0,30,27
1683724203306,PHYS 1AL,002,187049,Staff,18,0,30,12
1683724204336,PHYS 1B,A00,187058,Staff,21,0,60,39
1683724205914,PHYS 1BL,001,187064,Staff,0,1,30,30
1683724205914,PHYS 1BL,002,187070,Staff,4,0,30,26
1683724207003,PHYS 1C,A00,187082,Staff,30,0,120,90
1683724208029,PHYS 1CL,001,187088,Staff,0,9,30,30
1683724208029,PHYS 1CL,002,187089,Staff,0,1,30,30
1683724208029,PHYS 1CL,009,262693,Staff,9,0,30,21
1683724209058,PHYS 2B,A01,187097,Staff,55,0,115,60
1683724210084,PHYS 2C,A01,187099,Staff,63,0,115,52
1683724211114,PHYS 2CL,A01,187101,Staff,5,0,28,23
1683724211114,PHYS 2CL,A02,187102,Staff,15,0,28,13
1683724212139,PHYS 2D,A01,187123,Shotwell; Brian,95,0,115,20
1683724213165,PHYS 4B,A01,187133,Grinstein; Benjamin,35,0,50,15
1683724214191,POLI 10,A00,188819,Staff,0,4,50,50
1683724215219,POLI 11,A00,188827,Staff,43,0,50,7
1683724216243,POLI 13R,A00,188828,Staff,0,2,20,20
1683724217272,POLI 27,A01,188830,Elgin; Samuel Zincke,0,2,70,70
1683724218302,POLI 30,A00,188832,Desposato; Scott,30,0,50,20
1683724219329,POLI 102F,A00,188834,Staff,1,0,40,39
1683724220356,POLI 104A,A00,188852,Staff,12,0,30,18
1683724221380,POLI 104I,A00,188853,Staff,0,8,20,20
1683724222404,POLI 110B,A00,188854,Wiens; David,6,0,20,14
1683724223429,POLI 112A,A00,188855,Wiens; David,3,0,30,27
1683724224454,POLI 117R,A00,188856,Forman; Fonna,0,12,20,20
1683724225483,POLI 118,A00,188857,Ingham; Sean,8,0,20,12
1683724226511,POLI 120G,A00,188858,Staff,7,0,30,23
1683724227536,POLI 131CR,A00,188863,Hoston; Germaine,20,0,50,30
1683724228566,POLI 133,A00,188864,Nellis; Gareth Hb,44,0,50,6
1683724229591,POLI 134D,A00,188865,Desposato; Scott,27,0,30,3
1683724230625,POLI 142A,A00,188871,Gartzke; Erik,21,0,50,29
1683724231654,POLI 142K,A00,188874,Staff,38,0,50,12
1683724232682,POLI 143,A00,188940,Gartzke; Erik,15,0,30,15
1683724233707,POLI 153,A00,188943,Staff,1,0,20,19
1683724234731,POLI 160AA,A00,188944,Staff,10,0,40,30
1683724235758,POLI 170A,A00,188945,Staff,10,0,30,20
1683724237814,PSYC 1,A00,188952,Staff,36,0,90,54
1683724238842,PSYC 2,B00,188953,Staff,19,0,35,16
1683724239866,PSYC 6,A00,188970,Staff,47,0,60,13
1683724240893,PSYC 7,A00,188973,Staff,35,0,45,10
1683724241920,PSYC 60,A01,188980,Rickard; Timothy C.,42,0,60,18
1683724242945,PSYC 70,A01,189001,Steiner; Eric Tomas,22,0,45,23
1683724243974,PSYC 100,A00,189005,Lacefield; Katharine I,1,98,120,119
1683724245002,PSYC 102,A00,189008,Staff,6,0,30,24
1683724246028,PSYC 106,B00,189026,Gorman; Michael R.,27,0,60,33
1683724247059,PSYC 114,B01,189033,Winkielman; Piotr,0,31,30,30
1683724248090,PSYC 131,A00,189036,Anagnostaras; Stephan,0,44,60,60
1683724249120,PSYC 136,A00,189041,Lowe; Angela Beth,0,7,25,25
1683724250144,PSYC 137,A00,189057,Winkielman; Piotr,0,36,25,25
1683724251174,PSYC 144,A00,189107,Wixted; John T,0,11,50,50
1683724253223,PSYC 162,A00,189142,Staff,0,9,85,85
1683724254253,PSYC 172,A00,189144,Gorman; Michael R.,0,6,30,30
1683724256306,PSYC 179,A00,189146,Lacefield; Katharine I,0,88,120,120
1683724257347,PSYC 181,A00,189147,Anagnostaras; Stephan,0,45,90,90
1683724258376,PSYC 190R,A00,189148,Barner; David A.,0,23,80,80
1683724259401,PSYC 191,A00,189275,Rickard; Timothy C.,0,11,25,25
1683724260428,PSYC 193,A00,189276,Chapman; Eddie Nathaniel,0,1,0,4
1683724261461,PSYC 193L,A01,189281,Lowe; Angela Beth,8,0,20,12
1683724261461,PSYC 193L,B01,189285,Staff,28,0,35,7
1683724262488,RELI 149,A00,187137,Rahimi; Babak,6,0,40,34
1683724263514,SE 9,A01,187315,Staff,0,2,18,18
1683724264540,SE 101B,A00,187409,Staff,24,0,30,6
1683724265565,SE 110B,A00,187444,Staff,10,0,40,30
1683724266595,SE 130B,A00,187449,Staff,31,0,40,9
1683724267622,SE 150A,A00,187516,Staff,8,0,20,12
1683724268649,SE 154,A00,187528,Staff,29,0,50,21
1683724269677,SIO 3,A01,258171,Staff,35,0,40,5
1683724270705,SIO 10,A00,187144,Cook; Geoffrey W,0,6,75,75
1683724271730,SIO 45,A00,187152,Cook; Geoffrey W,1,7,100,99
1683724272760,SIO 109R,A00,194486,Staff,0,4,20,20
1683724274811,SIO 187,A01,187233,Kacev; David,12,0,40,28
1683724275838,SOCI 1,A01,258656,Thorpe; Charles Robert,28,0,30,2
1683724275838,SOCI 1,A02,258658,Thorpe; Charles Robert,30,0,30,0
1683724275838,SOCI 1,A03,258661,Thorpe; Charles Robert,25,0,25,0
1683724275838,SOCI 1,A04,258666,Thorpe; Charles Robert,22,0,25,3
1683724275838,SOCI 1,A05,258897,Thorpe; Charles Robert,22,0,25,3
1683724275838,SOCI 1,A06,258898,Thorpe; Charles Robert,25,0,25,0
1683724276863,SOCI 30,A01,258903,Pardo Guerra; Juan Pablo,14,0,30,16
1683724277891,SOCI 102,A00,258904,Staff,9,0,25,16
1683724278915,SOCI 106,A00,258905,Staff,19,0,25,6
1683724279940,SOCI 111,A00,258907,Ribas Norris; Janet Vanesa,26,0,30,4
1683724280968,SOCI 121R,A00,258908,Pardo Guerra; Juan Pablo,7,0,30,23
1683724281993,SOCI 126,A01,203330,Staff,14,0,20,6
1683724283022,SOCI 131,A00,258909,Thorpe; Charles Robert,30,0,60,30
1683724284048,SOCI 135,A00,258910,Payne; Christine Anna,0,13,30,30
1683724285072,SOCI 157,A00,258911,Staff,10,0,30,20
1683724286096,SOCI 184,A00,258912,Staff,25,0,30,5
1683724287122,SOCI 188D,A00,258913,Staff,22,0,30,8
1683724288146,SYN 2,001,187529,Staff,9,0,16,7
1683724288146,SYN 2,002,201452,Staff,0,20,16,16
1683724288146,SYN 2,003,201469,Staff,1,0,16,15
1683724289175,SYN 100,A01,187531,Staff,0,9,20,20
1683724289175,SYN 100,B01,201491,Staff,0,10,20,20
1683724290202,TDAC 1,A00,189286,Walsh; Kim C.,3,0,20,17
1683724290202,TDAC 1,B00,189287,Harting; Carla Kelso,10,0,20,10
1683724291227,TDAC 101,A00,189300,Walsh; Kim C.,16,0,20,4
1683724291227,TDAC 101,B00,189301,Harting; Carla Kelso,18,0,20,2
1683724292258,TDAC 102,A00,189304,Basso; Beatrice,14,0,20,6
1683724293283,TDAC 108,A00,189305,Staff,18,0,20,2
1683724294313,TDDE 131,A00,189310,Staff,19,0,20,1
1683724294313,TDDE 131,B00,189314,Staff,19,0,20,1
1683724294313,TDDE 131,C00,189315,Staff,48,0,50,2
1683724294313,TDDE 131,D00,189316,Staff,14,0,15,1
1683724294313,TDDE 131,E00,204841,Staff,20,0,20,0
1683724295338,TDGE 10,A00,189289,Staff,26,0,50,24
1683724295338,TDGE 10,B00,189290,Havis; Allan,0,1,50,50
1683724296362,TDGE 11,A00,189291,Fulton; Julia,0,4,50,50
1683724296362,TDGE 11,B00,189292,Staff,20,0,25,5
1683724296362,TDGE 11,C00,260270,Staff,0,0,0,0
1683724297391,TDGE 25,A00,189294,Staff,1,0,20,19
1683724298416,TDGE 124,A00,189318,Fulton; Julia,0,7,50,50
1683724299440,TDGE 125,A00,189319,Staff,13,0,25,12
1683724299440,TDGE 125,B00,189320,Staff,23,0,25,2
1683724300469,TDGE 127,A00,189322,Havis; Allan,1,0,50,49
1683724301498,TDHT 101,A00,189323,Staff,18,0,25,7
1683724301498,TDHT 101,B00,189324,Staff,25,0,25,0
1683724302527,TDHT 102,A00,189325,Staff,49,0,50,1
1683724303553,TDMV 1,A00,189295,Arcidiacono; Kristin,20,0,30,10
1683724303553,TDMV 1,B00,189296,Caligagan; Maria T.,23,0,30,7
1683724304578,TDMV 2,A00,189297,Sammartano; Tonnie,27,0,30,3
1683724304578,TDMV 2,B00,189299,Arcidiacono; Kristin,23,0,30,7
1683724305610,TDMV 3,A00,204998,Rincon; Alicia,22,0,30,8
1683724306637,TDMV 120,A00,189458,Sammartano; Tonnie,28,0,30,2
1683724307662,TDMV 138,A00,189541,Jun; Grace Shin Hae,20,0,40,20
1683724308692,TDMV 142,A00,189717,Caligagan; Tony,25,0,30,5
1683724308692,TDMV 142,B00,189718,Caligagan; Maria T.,25,0,30,5
1683724309721,TMC 2,A01,187533,Staff,25,0,25,0
1683724309721,TMC 2,A02,187534,Staff,25,0,25,0
1683724310819,USP 1,A01,187536,Kwak; Nancy,0,16,25,25
1683724311844,USP 5,A01,187538,Staff,8,0,25,17
1683724312871,USP 101,A00,199253,Staff,0,4,0,0
1683724313901,USP 124,A00,187562,Boomhower; Matthew Charles,0,0,30,30
1683724314928,USP 138,A00,187582,Staff,19,0,25,6
1683724315954,USP 152,A01,187597,Staff,3,0,25,22
1683724316982,USP 153,A00,187598,Staff,18,0,25,7
1683724318010,USP 168,A00,187607,Kwak; Nancy,2,0,5,3
1683724319035,USP 173,A00,187619,Staff,4,0,25,21
1683724320062,USP 181,A00,187638,Staff,0,4,25,25
1683724321094,VIS 103,A00,187650,Cruz; Edwin Teddy,17,0,75,58
1683724322119,VIS 110D,A00,187669,Staff,13,0,22,9
1683724323144,VIS 127C,A00,187720,Shen; Kuiyi,67,0,146,79
1683724324170,VIS 149,A00,187731,Yoldas; Pinar,0,12,22,22
1683724325199,VIS 151,A01,188091,Staff,22,0,34,12
1683724325199,VIS 151,A02,188092,Staff,11,0,34,23
1683724326228,VIS 160B,A00,188093,Stalbaum; Brett,0,1,10,10
1683724328280,WCWP 10B,A00,201720,Staff,0,0,5,5
1683724328280,WCWP 10B,B00,201722,Staff,0,0,6,6
1683724329307,WCWP 100,A00,201725,Gagnon; Jeffrey C,0,0,2,2
1683724329307,WCWP 100,B00,201727,Staff,0,4,15,15
1683724332419,ANBI 133,A00,258401,Wilder; Linnea Lorene,34,0,40,6
1683724333449,ANBI 140,A00,258395,Hrvoj Mihic; Branka,18,0,25,7
1683724334475,ANSC 120,A00,258402,Bialecki; Jon Anthony,26,0,40,14
1683724335499,ANSC 144,A00,258400,Staff,12,0,40,28
1683724337558,ANSC 166,A00,258396,Parish; Steven Martin,156,0,175,19
1683724338583,ANSC 180,A00,193533,Staff,8,0,20,12
1683724339608,ANSC 188,A00,258397,Jassal; Aftab,34,0,40,6
1683724340636,ANTH 3,A01,258316,Staff,23,0,30,7
1683724341666,ANTH 5,A00,258394,Semendeferi; Ekaterini,16,0,20,4
1683724342694,ANTH 21,A01,258331,Staff,4,0,40,36
1683724343720,ANTH 103,A00,258398,Varma; Saiba,15,0,25,10
1683724344748,AWP 10,001,202034,Staff,0,0,0,0
1683724344748,AWP 10,002,202035,Staff,0,0,0,0
1683724344748,AWP 10,003,202036,Staff,0,0,0,0
1683724344748,AWP 10,004,202037,Staff,0,0,0,0
1683724344748,AWP 10,005,202038,Staff,0,0,0,0
1683724344748,AWP 10,006,202039,Staff,0,0,0,0
1683724344748,AWP 10,007,202040,Staff,0,0,0,0
1683724344748,AWP 10,008,202041,Staff,0,0,0,0
1683724344748,AWP 10,009,202042,Staff,0,0,0,0
1683724344748,AWP 10,010,202043,Staff,0,0,0,0
1683724344748,AWP 10,011,202044,Staff,0,0,0,0
1683724344748,AWP 10,012,202045,Staff,0,0,0,0
1683724344748,AWP 10,013,202046,Staff,0,0,0,0
1683724344748,AWP 10,014,202047,Staff,0,0,0,0
1683724344748,AWP 10,015,202048,Staff,0,0,0,0
1683724344748,AWP 10,016,202049,Staff,0,0,0,0
1683724344748,AWP 10,017,202050,Staff,0,0,0,0
1683724344748,AWP 10,018,202051,Staff,0,0,0,0
1683724344748,AWP 10,019,202052,Staff,0,0,0,0
1683724344748,AWP 10,020,202053,Staff,0,0,0,0
1683724344748,AWP 10,021,202054,Staff,0,0,0,0
1683724344748,AWP 10,022,202055,Staff,0,0,0,0
1683724344748,AWP 10,023,202056,Staff,0,0,0,0
1683724344748,AWP 10,024,202057,Staff,0,0,0,0
1683724344748,AWP 10,025,202058,Staff,0,0,0,0
1683724344748,AWP 10,026,202059,Staff,0,0,0,0
1683724345773,AWP 102,001,202032,Staff,0,0,0,0
1683724345773,AWP 102,002,202033,Staff,0,0,0,0
1683724346802,BENG 100,A01,254234,Taylor Amos; Alyssa C,31,0,40,9
1683724347831,BENG 196,001,270013,Engler; Adam J.,9999,0,9999,0
1683724348860,BICD 100R,A01,202018,Smith; Laurie,0,7,32,32
1683724348860,BICD 100R,A02,202019,Smith; Laurie,0,3,32,32
1683724348860,BICD 100R,A03,202020,Smith; Laurie,0,1,32,32
1683724348860,BICD 100R,A04,202021,Smith; Laurie,6,0,32,26
1683724348860,BICD 100R,A05,202022,Smith; Laurie,10,0,32,22
1683724349886,BICD 136,A01,193242,Gustafson-Brown; Cindy,0,2,32,32
1683724349886,BICD 136,A02,193244,Gustafson-Brown; Cindy,13,0,32,19
1683724350913,BIEB 102,A01,193249,Butler; Shannon Rhey,0,0,32,32
1683724350913,BIEB 102,A02,193251,Butler; Shannon Rhey,0,0,32,32
1683724350913,BIEB 102,A03,193253,Butler; Shannon Rhey,0,0,32,32
1683724350913,BIEB 102,A04,193255,Butler; Shannon Rhey,13,0,32,19
1683724350913,BIEB 102,A05,193265,Butler; Shannon Rhey,25,0,32,7
1683724350913,BIEB 102,A06,193269,Butler; Shannon Rhey,12,0,32,20
1683724352969,BIEB 150,A01,193274,Staff,0,0,32,32
1683724352969,BIEB 150,A02,193285,Staff,24,0,32,8
1683724353995,BIEB 194,A00,193286,Kurle; Carolyn M.,19,0,32,13
1683724355029,BILD 1,A01,192291,Staff,15,0,32,17
1683724355029,BILD 1,A02,192292,Staff,30,0,32,2
1683724355029,BILD 1,B01,192520,Reuther; Keefe,0,1,0,0
1683724355029,BILD 1,B02,192532,Reuther; Keefe,0,1,0,0
1683724356062,BILD 3,A01,192556,Butler; Shannon Rhey,0,0,32,32
1683724356062,BILD 3,A02,192581,Butler; Shannon Rhey,0,1,32,32
1683724356062,BILD 3,A03,192611,Butler; Shannon Rhey,19,0,32,13
1683724356062,BILD 3,A04,192612,Butler; Shannon Rhey,23,0,32,9
1683724356062,BILD 3,A05,192613,Butler; Shannon Rhey,26,0,32,6
1683724356062,BILD 3,A06,192679,Butler; Shannon Rhey,27,0,32,5
1683724356062,BILD 3,A07,192682,Butler; Shannon Rhey,20,0,32,12
1683724357091,BILD 4,A01,192836,Reuther; Keefe,1,0,24,23
1683724357091,BILD 4,A02,193044,Reuther; Keefe,4,0,24,20
1683724358115,BILD 10,A01,193142,Gustafson-Brown; Cindy,29,0,32,3
1683724358115,BILD 10,A02,193149,Gustafson-Brown; Cindy,31,0,32,1
1683724359144,BIMM 100,A01,193301,Staff,0,6,32,32
1683724359144,BIMM 100,A02,193312,Staff,0,7,32,32
1683724359144,BIMM 100,A03,193323,Staff,0,10,32,32
1683724360177,BIMM 101,A01,193329,McDonnell; Lisa Marie,0,3,24,24
1683724360177,BIMM 101,A02,193339,McDonnell; Lisa Marie,0,3,24,24
1683724360177,BIMM 101,B01,193354,McDonnell; Lisa Marie,0,4,24,24
1683724360177,BIMM 101,B02,193357,McDonnell; Lisa Marie,0,3,24,24
1683724361206,BIMM 110,A01,193377,Tat; John,0,11,32,32
1683724361206,BIMM 110,A02,193378,Tat; John,0,11,32,32
1683724362239,BIMM 120,A01,206116,Staff,0,0,32,32
1683724362239,BIMM 120,A02,206117,Staff,7,0,32,25
1683724362239,BIMM 120,A03,206121,Staff,21,0,32,11
1683724363269,BIPN 100,A01,193393,Park; Ji Young,0,15,32,32
1683724363269,BIPN 100,A02,193402,Park; Ji Young,0,14,32,32
1683724363269,BIPN 100,A03,193413,Park; Ji Young,0,14,32,32
1683724363269,BIPN 100,A04,193414,Park; Ji Young,0,13,32,32
1683724364297,BIPN 102,A01,193429,Staff,0,0,32,32
1683724364297,BIPN 102,A02,193438,Staff,18,0,32,14
1683724365322,BIPN 106,A01,193450,Reyes Gonzalez; Catalina,0,2,40,40
1683724366347,BIPN 134,A01,193465,Cooke; James Edward,0,0,32,32
1683724366347,BIPN 134,A02,193474,Cooke; James Edward,25,0,32,7
1683724366347,BIPN 134,A03,193485,Cooke; James Edward,29,0,32,3
1683724366347,BIPN 134,A04,193486,Cooke; James Edward,20,0,32,12
1683724366347,BIPN 134,A05,193491,Cooke; James Edward,31,0,32,1
1683724366347,BIPN 134,A06,193501,Cooke; James Edward,30,0,32,2
1683724366347,BIPN 134,A07,193510,Cooke; James Edward,29,0,32,3
1683724368404,BISP 194,A00,222522,Staff,14,0,32,18
1683724369429,CAT 124,A01,202407,Staff,19,0,25,6
1683724370458,CAT 125,A00,202408,Marchisotto; Jennifer Anne,2,0,20,18
1683724371486,CAT 125R,A00,202409,Smith; Lauryn Alissa,0,11,20,20
1683724371486,CAT 125R,B00,202410,Morales; Celeste Georgianna,0,11,20,20
1683724371486,CAT 125R,C00,202411,Irwin; Matthew Joseph,0,12,20,20
1683724372511,CENG 15,A01,204712,Yang; Kesong,0,1,0,0
1683724373541,CENG 114,A00,202070,Jahed Motlagh; Zeinab,5,0,20,15
1683724374567,CGS 105,A00,185477,Wesling; Megan E.,24,0,40,16
1683724375593,CGS 106,A00,185494,Staff,11,0,22,11
1683724376618,CGS 108,A00,185495,Staff,14,0,20,6
1683724377642,CGS 114,A00,185496,Staff,13,0,18,5
1683724378670,CGS 119,A00,185501,Staff,15,0,20,5
1683724379694,CGS 120,A00,185511,Staff,11,0,20,9
1683724380720,CHEM 4,A01,184675,Bussey; Thomas J,97,0,100,3
1683724381744,CHEM 6A,A01,184677,Staff,32,0,60,28
1683724382768,CHEM 6B,A01,184679,Staff,63,0,100,37
1683724383801,CHEM 6C,A01,184681,Bussey; Thomas J,0,0,50,50
1683724383801,CHEM 6C,A02,184682,Bussey; Thomas J,32,0,50,18
1683724384828,CHEM 40A,A01,184684,Albizati; Kim F.,33,0,100,67
1683724385853,CHEM 40B,A01,184686,Albizati; Kim F.,0,22,100,100
1683724386878,CHEM 41B,A01,184690,Staff,51,0,100,49
1683724387903,COGS 3,A01,184715,Boyle; Mary E. T.,0,27,40,40
1683724388932,COGS 14B,A01,185172,Staff,0,14,38,38
1683724389960,COGS 18,A01,184736,Staff,14,0,80,66
1683724390990,COGS 100,A01,184932,Staff,0,8,73,73
1683724392015,COGS 101A,A01,184935,Staff,0,40,30,30
1683724393039,COGS 101B,A01,184944,Staff,0,2,30,30
1683724394066,COGS 101C,A01,184946,Staff,0,10,30,30
1683724395096,COGS 102A,A01,184951,Johnson; Christine M.,1,0,40,39
1683724396120,COGS 107B,A01,184953,Mooshagian; Eric Frederick,0,52,40,40
1683724397145,COGS 118B,A01,184959,Gupta; Anjum,0,50,40,40
1683724398169,COGS 153,A00,184961,Staff,1,16,30,29
1683724399193,COGS 177,A00,184962,Staff,0,20,30,30
1683724400222,COGS 187A,A01,184969,Boyle; Mary E. T.,0,19,40,40
1683724401254,COMM 10,A01,185174,Staff,0,5,25,25
1683724401254,COMM 10,A02,185189,Staff,0,2,25,25
1683724401254,COMM 10,A03,269821,Staff,0,1,0,0
1683724402279,COMM 100B,A02,185476,Staff,10,0,25,15
1683724402279,COMM 100B,A03,277340,Staff,25,0,25,0
1683724403306,COMM 100C,A01,185314,Staff,2,0,25,23
1683724403306,COMM 100C,A02,185327,Staff,17,0,25,8
1683724404330,COMM 110M,A00,185349,Staff,0,0,40,40
1683724405356,COMM 113T,A00,185352,Staff,25,0,40,15
1683724406384,COMM 114I,A00,185353,Staff,31,0,40,9
1683724407410,COMM 131,A00,185354,Staff,17,0,30,13
1683724408436,CSE 8A,A50,185358,Cao; Yingjun,0,46,10,10
1683724409459,CSE 8B,A01,185362,Staff,0,48,50,50
1683724410483,CSE 11,A01,185416,Cao; Yingjun,0,91,10,10
1683724411509,CSE 20,A01,185445,Briones; Jor-el Thomas Caparas,3,0,25,22
1683724412536,CSE 21,A01,185447,Staff,9,0,50,41
1683724413567,CSE 101,A01,185451,Staff,0,13,50,50
1683724413567,CSE 101,B01,185453,Jones; Miles E,0,15,50,50
1683724415675,CSE 141,A01,185458,Eldon; John,16,0,100,84
1683724416700,CSE 141L,A01,185461,Eldon; John,8,0,100,92
1683724417726,CSE 142,A01,185463,Staff,34,0,60,26
1683724417726,CSE 142,B01,201355,Staff,0,7,60,60
1683724418755,CSE 142L,A01,185470,Staff,34,0,60,26
1683724418755,CSE 142L,B01,201417,Staff,0,6,60,60
1683724419783,CSE 190,A00,201433,Staff,32,0,49,17
1683724420815,DOC 1,A01,259136,Strom; Megan C.,7,0,15,8
1683724420815,DOC 1,A02,259137,Strom; Megan C.,15,0,15,0
1683724420815,DOC 1,A03,259138,Strom; Megan C.,14,0,15,1
1683724420815,DOC 1,A04,259139,Strom; Megan C.,13,0,15,2
1683724421839,DOC 100D,A00,259140,Pass; Natalye Joann,14,0,25,11
1683724422865,DSGN 1,A01,184749,Rill; Bryan,0,26,30,30
1683724423891,DSGN 100,A01,185168,Staff,0,2,25,25
1683724424920,ECE 5,A01,185626,Morris; Karcher William,0,12,0,0
1683724425946,ECE 101,A01,185628,Staff,14,0,70,56
1683724426975,ECE 107,A01,185635,Baghdadchi; Saharnaz,0,0,20,20
1683724426975,ECE 107,A02,185638,Baghdadchi; Saharnaz,1,0,20,19
1683724428006,ECE 148,A01,185647,Silberman; Jack,0,0,16,16
1683724429030,ECON 1,A01,185537,Crane; Meredith Helen,54,0,70,16
1683724430058,ECON 3,A01,185549,Crane; Meredith Helen,30,0,70,40
1683724431088,ECON 4,A01,203354,Anderson; John Charles,0,5,10,10
1683724432112,ECON 100A,A01,185574,Staff,0,5,40,40
1683724433140,ECON 100B,A01,185576,Staff,0,12,50,50
1683724434171,ECON 100C,A01,185589,Newhouse; Herbert S,30,0,70,40
1683724435195,ECON 105,A00,185608,Vespa; Emanuel Ignacio,19,0,35,16
1683724436219,ECON 109,A01,185610,Shishkin; Denis,9,0,35,26
1683724437244,ECON 110A,A01,185612,Staff,8,0,40,32
1683724438271,ECON 120A,A01,185615,Staff,19,0,40,21
1683724439296,ECON 120C,A01,185617,Sun; Yixiao,0,21,70,70
1683724440326,ECON 144,A00,203346,Squires; Dale E,2,0,35,33
1683724441352,ECON 171,A01,203349,Newhouse; Herbert S,0,1,35,35
1683724442387,ECON 173A,A01,185621,Toda; Alexis Akira,21,0,35,14
1683724443422,EDS 25,A01,202413,Staff,0,1,0,0
1683724443422,EDS 25,A02,202414,Staff,0,1,0,0
1683724443422,EDS 25,A03,202415,Staff,0,0,0,0
1683724443422,EDS 25,A04,202416,Staff,0,1,0,0
1683724443422,EDS 25,A05,202439,Staff,0,0,0,0
1683724443422,EDS 25,A06,202440,Staff,0,0,0,0
1683724443422,EDS 25,B01,202631,Staff,0,0,0,0
1683724443422,EDS 25,B02,202632,Staff,0,0,0,0
1683724443422,EDS 25,B03,202639,Staff,0,0,0,0
1683724443422,EDS 25,B04,202640,Staff,0,0,0,0
1683724443422,EDS 25,B05,202643,Staff,0,0,0,0
1683724443422,EDS 25,B06,202644,Staff,0,0,0,0
1683724444449,EDS 38,A01,202659,Black; Alison Michelle,25,0,25,0
1683724445475,EDS 115,A00,202652,Staff,18,0,30,12
1683724446500,EDS 125,A00,202649,Staff,13,0,30,17
1683724447529,EDS 126,A01,203332,Staff,30,0,30,0
1683724448554,EDS 139,A00,202838,Staff,16,0,25,9
1683724449577,EDS 146,A01,202655,Staff,14,0,25,11
1683724450607,ENG 15,A00,185667,Staff,0,1,0,0
1683724450607,ENG 15,B00,185672,Staff,0,0,0,0
1683724450607,ENG 15,C00,185675,Staff,0,0,0,0
1683724450607,ENG 15,D00,185682,Staff,0,0,0,0
1683724450607,ENG 15,E00,185684,Staff,0,0,0,0
1683724451637,ETHN 103,A00,185710,Staff,0,8,35,35
1683724452661,ETHN 103A,A00,199228,Man; Simeon S,0,0,9,9
1683724453687,ETHN 109,A00,185711,Staff,15,0,35,20
1683724454715,ETHN 142,A00,185726,Staff,0,4,30,30
1683724455740,ETHN 163J,A00,199229,Man; Simeon S,5,0,8,3
1683724456765,ETHN 168,A00,185727,Staff,7,0,10,3
1683724457790,ETHN 182,A00,185728,Staff,0,0,35,35
1683724458816,ETHN 183,A00,185737,Staff,10,0,18,8
1683724459847,GLBH 111,A01,209361,Burgos; Jose L.,0,0,0,0
1683724461898,HIEU 104,A00,185792,Staff,14,0,20,6
1683724462926,HIEU 115,A00,185800,Staff,0,0,20,20
1683724463952,HIEU 128,A00,185801,Staff,0,9,20,20
1683724464979,HIEU 147,A00,185802,Staff,15,0,20,5
1683724466004,HIEU 154,A00,185823,Staff,11,0,20,9
1683724467034,HILA 102,A00,185826,Staff,14,0,20,6
1683724468061,HILD 2C,A01,185778,Staff,0,13,20,20
1683724469085,HILD 7B,A01,185780,Kwak; Nancy,0,17,32,32
1683724469085,HILD 7B,A02,185781,Kwak; Nancy,0,18,32,32
1683724470111,HILD 30,A01,185791,Staff,12,0,20,8
1683724471141,HISC 119,A00,185830,Golan; Tal,0,10,20,20
1683724472168,HITO 156GS,A00,185831,Patterson; Patrick H.,0,0,0,23
1683724473199,HIUS 103,A00,185832,Man; Simeon S,0,4,20,20
1683724474223,HIUS 117,A00,185836,Kwak; Nancy,2,0,20,18
1683724475251,HIUS 125,A00,185840,Man; Simeon S,0,2,23,23
1683724476280,HIUS 149,A00,185845,Staff,1,0,20,19
1683724477311,HUM 3,A01,185882,Zavodny; Tatiana Sophia,0,8,50,50
1683724477311,HUM 3,B01,185899,Caldwell; Michael Alan,0,18,50,50
1683724478340,HUM 3GS,A00,185900,Patterson; Patrick H.,0,0,0,23
1683724479372,HUM 4,A01,185938,Zroka; Amy Liane,28,0,50,22
1683724479372,HUM 4,B01,185956,Watkins; Eric,0,6,50,50
1683724479372,HUM 4,B02,202209,Watkins; Eric,0,6,50,50
1683724479372,HUM 4,B03,202210,Watkins; Eric,0,5,50,50
1683724480398,HUM 5,A01,185958,West; Geoffrey Scott,0,0,50,50
1683724480398,HUM 5,A02,202215,West; Geoffrey Scott,0,1,50,50
1683724481424,INTL 190,A00,185959,Gagnon; Jeffrey C,0,0,0,9
1683724481424,INTL 190,B00,185960,Lettieri; Michael Joseph,0,0,0,2
1683724482449,JAPN 180,A00,254509,Staff,4,0,30,26
1683724483475,LATI 10,A01,202853,Kennemore; Amy Michelle,4,0,35,31
1683724483475,LATI 10,A02,202854,Kennemore; Amy Michelle,3,0,35,32
1683724483475,LATI 10,A03,270054,Kennemore; Amy Michelle,30,0,30,0
1683724484500,LATI 180,A00,202855,Kennemore; Amy Michelle,11,0,20,9
1683724485530,LAWS 101,A00,201767,Golan; Tal,0,7,40,40
1683724486557,LIFR 1C,A00,185961,Staff,6,0,20,14
1683724487584,LIFR 1CX,A00,185962,Staff,7,0,20,13
1683724488611,LIFR 1D,A00,185963,Staff,7,0,20,13
1683724489635,LIFR 1DX,A00,185964,Staff,7,0,20,13
1683724490660,LIGN 101,A01,186039,Staff,43,0,50,7
1683724491684,LIGN 165,A00,186040,Staff,14,0,50,36
1683724492710,LTCS 108,A00,186041,Staff,5,0,10,5
1683724493739,LTCS 119,A00,186042,Staff,15,0,20,5
1683724494767,LTCS 130,A00,186043,Wesling; Megan E.,15,0,25,10
1683724496819,LTEA 138,A00,186119,Staff,13,0,40,27
1683724497846,LTEN 124,A00,186148,Staff,5,0,25,20
1683724498875,LTEN 178,A00,186149,Staff,6,0,15,9
1683724499899,LTEN 181,A00,186150,Blanco; John D,34,0,40,6
1683724500923,LTWL 120,A00,186160,Staff,19,0,25,6
1683724501952,LTWL 165,A00,186161,Staff,22,0,25,3
1683724502978,LTWR 100,A00,186162,Staff,0,5,15,15
1683724504000,LTWR 102,A00,186163,Doller; Ben,5,0,15,10
1683724505030,MAE 8,A01,186412,Staff,0,1,0,0
1683724506059,MAE 30B,A00,186445,Bahadori; Mohammad Yousef,81,0,100,19
1683724507083,MAE 40,A00,186592,Bewley; Thomas R,10,0,50,40
1683724508112,MAE 101B,A00,186593,Bahadori; Mohammad Yousef,80,0,100,20
1683724509141,MAE 105,A00,186594,Bandaru; Prabhakar,10,0,50,40
1683724510171,MAE 107,A00,186599,Pham; Hieu Tan,0,8,120,120
1683724511202,MAE 148,A01,186660,Silberman; Jack,3,0,16,13
1683724512229,MATH 10A,A01,188095,Staff,0,6,35,35
1683724513256,MATH 10B,A01,188097,Bowers; Adam R.,0,12,30,30
1683724513256,MATH 10B,A02,188099,Bowers; Adam R.,0,11,30,30
1683724513256,MATH 10B,B01,188104,Bowers; Adam R.,0,10,30,30
1683724513256,MATH 10B,B02,188106,Bowers; Adam R.,0,9,30,30
1683724514283,MATH 10C,A01,188111,Staff,0,20,30,30
1683724514283,MATH 10C,A02,188127,Staff,0,19,30,30
1683724514283,MATH 10C,A03,188131,Staff,0,19,30,30
1683724514283,MATH 10C,B01,188218,Staff,17,0,30,13
1683724514283,MATH 10C,B02,188244,Staff,13,0,30,17
1683724514283,MATH 10C,B03,188277,Staff,14,0,30,16
1683724515308,MATH 18,A01,188344,Bach; Quang Tran,18,0,30,12
1683724515308,MATH 18,A02,188345,Bach; Quang Tran,11,0,30,19
1683724515308,MATH 18,B01,188353,Bach; Quang Tran,11,0,30,19
1683724515308,MATH 18,B02,188354,Bach; Quang Tran,19,0,30,11
1683724516336,MATH 20A,A01,188374,Staff,11,0,35,24
1683724517368,MATH 20B,A01,188382,Ohm; Ko Woon,7,0,30,23
1683724517368,MATH 20B,A02,188383,Ohm; Ko Woon,22,0,30,8
1683724517368,MATH 20B,B01,188385,Ohm; Ko Woon,7,0,30,23
1683724517368,MATH 20B,B02,188392,Ohm; Ko Woon,22,0,30,8
1683724518449,MATH 20C,A01,188394,Harel; Guershon,10,0,30,20
1683724518449,MATH 20C,A02,188395,Harel; Guershon,13,0,30,17
1683724518449,MATH 20C,B01,188404,Harel; Guershon,5,0,30,25
1683724518449,MATH 20C,B02,188405,Harel; Guershon,18,0,30,12
1683724519484,MATH 20D,A01,188414,Hammock; Frances H,0,1,30,30
1683724519484,MATH 20D,A02,188415,Hammock; Frances H,0,1,30,30
1683724519484,MATH 20D,B01,188447,Hammock; Frances H,0,1,30,30
1683724519484,MATH 20D,B02,188486,Hammock; Frances H,2,0,30,28
1683724520509,MATH 20E,A01,188649,Staff,21,0,30,9
1683724520509,MATH 20E,A02,188650,Staff,20,0,30,10
1683724520509,MATH 20E,A03,188673,Staff,0,0,30,30
1683724521536,MATH 102,A01,188675,Staff,0,40,35,35
1683724522566,MATH 103B,A01,188681,Staff,3,0,35,32
1683724522566,MATH 103B,B01,188692,Staff,5,0,35,30
1683724523594,MATH 109,A01,188695,Salehi Golsefidy; Alireza,24,0,35,11
1683724523594,MATH 109,A02,188696,Salehi Golsefidy; Alireza,24,0,35,11
1683724524620,MATH 120A,A01,188698,Eggers; John Dietrich,7,0,35,28
1683724525646,MATH 142B,A01,188736,Ioana; Adrian,0,0,30,30
1683724525646,MATH 142B,A02,188741,Ioana; Adrian,0,1,30,30
1683724525646,MATH 142B,A03,188743,Ioana; Adrian,0,3,30,30
1683724526672,MATH 168A,A01,188790,Staff,0,11,35,35
1683724527696,MATH 170A,A01,188803,Nie; Jiawang,0,2,35,35
1683724527696,MATH 170A,A02,188811,Nie; Jiawang,0,1,35,35
1683724527696,MATH 170A,A03,188814,Nie; Jiawang,1,0,35,34
1683724527696,MATH 170A,A04,188815,Nie; Jiawang,5,0,35,30
1683724528724,MATH 193B,A01,188817,Staff,0,0,35,35
1683724528724,MATH 193B,A02,188818,Staff,6,0,35,29
1683724529752,MGT 4,A01,202857,Anderson; John Charles,59,0,80,21
1683724530776,MGT 12,A00,202858,Lindenberger; Wade Douglas,40,0,90,50
1683724531804,MGT 18,A00,202859,Staff,73,0,90,17
1683724532829,MGT 18GS,A00,202860,McKay; Michael J,13,0,28,15
1683724533860,MGT 45,A00,202861,Pecore; Joseph P.,8,0,90,82
1683724534889,MGT 100,A00,202863,Yavorsky; Daniel Ryan,27,0,90,63
1683724535917,MGT 103,A00,202864,Ehrich; Kristine R,0,19,90,90
1683724536945,MGT 112,A00,202865,Ehrich; Kristine R,15,0,90,75
1683724537971,MGT 121A,A00,202868,Staff,70,0,90,20
1683724538999,MGT 131B,A00,202869,Anderson; John Charles,58,0,90,32
1683724540024,MGT 136,A00,202871,Lindenberger; Wade Douglas,83,0,90,7
1683724541049,MGT 164,A00,202873,Staff,0,67,90,91
1683724542078,MGT 164GS,A00,202874,McKay; Mary A,13,0,28,15
1683724543108,MGT 180,A00,202875,Staff,0,51,90,91
1683724544131,MMW 11R,A01,205019,Herbst; Matthew,0,0,30,30
1683724544131,MMW 11R,A02,205026,Herbst; Matthew,29,0,30,1
1683724545154,MMW 15,A01,193512,Chang; Edmond Yi-Teh,0,8,28,28
1683724545154,MMW 15,A02,193513,Chang; Edmond Yi-Teh,0,5,28,28
1683724545154,MMW 15,A03,193514,Chang; Edmond Yi-Teh,0,5,28,28
1683724545154,MMW 15,A04,193515,Chang; Edmond Yi-Teh,0,5,28,28
1683724545154,MMW 15,A05,193516,Chang; Edmond Yi-Teh,0,5,28,28
1683724545154,MMW 15,A06,193517,Chang; Edmond Yi-Teh,0,6,28,28
1683724545154,MMW 15,B01,193519,Chang; Edmond Yi-Teh,0,5,28,28
1683724545154,MMW 15,B02,193520,Chang; Edmond Yi-Teh,0,5,28,28
1683724545154,MMW 15,B03,193521,Chang; Edmond Yi-Teh,0,5,28,28
1683724545154,MMW 15,B04,193522,Chang; Edmond Yi-Teh,0,6,28,28
1683724545154,MMW 15,B05,193523,Chang; Edmond Yi-Teh,0,5,28,28
1683724545154,MMW 15,B06,193524,Chang; Edmond Yi-Teh,0,5,28,28
1683724546179,MMW 122,A01,193526,Rahimi; Babak,0,16,28,28
1683724546179,MMW 122,A02,193527,Rahimi; Babak,0,15,28,28
1683724546179,MMW 122,A03,193528,Rahimi; Babak,0,0,0,0
1683724546179,MMW 122,A04,193529,Rahimi; Babak,0,0,0,0
1683724547206,MUS 1A,A01,186663,Staff,0,18,35,35
1683724548235,MUS 4,A01,186715,Staff,0,12,35,35
1683724549262,MUS 5R,A01,186796,Dubnov; Shlomo,0,17,35,35
1683724550290,MUS 6,A01,186798,Staff,0,4,25,25
1683724551317,MUS 7,A01,186830,Staff,11,0,35,24
1683724552343,MUS 8,A01,186930,Staff,0,27,35,35
1683724553367,MUS 15,A01,186932,Staff,0,15,35,35
1683724553367,MUS 15,B01,186934,Staff,0,16,35,35
1683724554394,MUS 80,A00,186935,Staff,0,0,20,20
1683724554394,MUS 80,B00,186936,Staff,24,0,25,1
1683724555422,NANO 11,A00,204702,Lipomi; Darren John,0,0,0,0
1683724556447,NANO 15,A01,204709,Yang; Kesong,0,1,0,0
1683724557473,NANO 114,A00,202069,Jahed Motlagh; Zeinab,2,0,10,8
1683724558502,PHIL 1,A00,186955,Grush; Rick Scott,31,0,40,9
1683724559531,PHIL 10,A01,186973,Grush; Rick Scott,27,0,35,8
1683724559531,PHIL 10,A02,186974,Grush; Rick Scott,33,0,35,2
1683724560561,PHIL 13,A01,186976,Staff,1,0,35,34
1683724560561,PHIL 13,A02,186977,Staff,16,0,35,19
1683724561619,PHIL 14,A01,186979,Staff,30,0,35,5
1683724561619,PHIL 14,A02,186986,Staff,32,0,35,3
1683724562644,PHIL 28,A01,186988,Staff,16,0,30,14
1683724562644,PHIL 28,A02,186989,Staff,0,0,30,30
1683724562644,PHIL 28,A03,186990,Staff,10,0,30,20
1683724562644,PHIL 28,A04,186991,Staff,26,0,30,4
1683724563670,PHIL 120,A00,186997,Staff,23,0,40,17
1683724564693,PHIL 137,A00,187003,Staff,8,0,40,32
1683724565718,PHIL 150,A00,187015,Staff,47,0,70,23
1683724566747,PHIL 167,A00,187021,Lamey; Andy M.,34,0,40,6
1683724567777,PHIL 174,A01,202226,Staff,17,0,20,3
1683724567777,PHIL 174,A02,202235,Staff,20,0,20,0
1683724568802,PHIL 191A,A00,258918,Staff,0,0,1,1
1683724569826,PHYS 1A,A00,187028,Staff,26,0,60,34
1683724570855,PHYS 1AL,001,187036,Staff,3,0,30,27
1683724570855,PHYS 1AL,002,187049,Staff,18,0,30,12
1683724571881,PHYS 1B,A00,187058,Staff,21,0,60,39
1683724572907,PHYS 1BL,001,187064,Staff,0,1,30,30
1683724572907,PHYS 1BL,002,187070,Staff,4,0,30,26
1683724573931,PHYS 1C,A00,187082,Staff,30,0,120,90
1683724574957,PHYS 1CL,001,187088,Staff,0,9,30,30
1683724574957,PHYS 1CL,002,187089,Staff,0,1,30,30
1683724574957,PHYS 1CL,009,262693,Staff,9,0,30,21
1683724575982,PHYS 2B,A01,187097,Staff,55,0,115,60
1683724577007,PHYS 2C,A01,187099,Staff,63,0,115,52
1683724578032,PHYS 2CL,A01,187101,Staff,5,0,28,23
1683724578032,PHYS 2CL,A02,187102,Staff,15,0,28,13
1683724579058,PHYS 2D,A01,187123,Shotwell; Brian,95,0,115,20
1683724580082,PHYS 4B,A01,187133,Grinstein; Benjamin,35,0,50,15
1683724581113,POLI 10,A00,188819,Staff,0,4,50,50
1683724582136,POLI 11,A00,188827,Staff,43,0,50,7
1683724583164,POLI 13R,A00,188828,Staff,0,2,20,20
1683724584192,POLI 27,A01,188830,Elgin; Samuel Zincke,0,2,70,70
1683724585220,POLI 30,A00,188832,Desposato; Scott,30,0,50,20
1683724586245,POLI 102F,A00,188834,Staff,1,0,40,39
1683724587270,POLI 104A,A00,188852,Staff,12,0,30,18
1683724588297,POLI 104I,A00,188853,Staff,0,8,20,20
1683724589323,POLI 110B,A00,188854,Wiens; David,6,0,20,14
1683724590349,POLI 112A,A00,188855,Wiens; David,3,0,30,27
1683724591377,POLI 117R,A00,188856,Forman; Fonna,0,12,20,20
1683724592402,POLI 118,A00,188857,Ingham; Sean,8,0,20,12
1683724593427,POLI 120G,A00,188858,Staff,7,0,30,23
1683724594451,POLI 131CR,A00,188863,Hoston; Germaine,20,0,50,30
1683724595476,POLI 133,A00,188864,Nellis; Gareth Hb,44,0,50,6
1683724596500,POLI 134D,A00,188865,Desposato; Scott,27,0,30,3
1683724597530,POLI 142A,A00,188871,Gartzke; Erik,21,0,50,29
1683724598555,POLI 142K,A00,188874,Staff,38,0,50,12
1683724599579,POLI 143,A00,188940,Gartzke; Erik,15,0,30,15
1683724600608,POLI 153,A00,188943,Staff,1,0,20,19
1683724601634,POLI 160AA,A00,188944,Staff,10,0,40,30
1683724602659,POLI 170A,A00,188945,Staff,10,0,30,20
1683724604711,PSYC 1,A00,188952,Staff,36,0,90,54
1683724605736,PSYC 2,B00,188953,Staff,19,0,35,16
1683724606765,PSYC 6,A00,188970,Staff,47,0,60,13
1683724607792,PSYC 7,A00,188973,Staff,35,0,45,10
1683724608824,PSYC 60,A01,188980,Rickard; Timothy C.,42,0,60,18
1683724610866,PSYC 70,A01,189001,Steiner; Eric Tomas,22,0,45,23
1683724611895,PSYC 100,A00,189005,Lacefield; Katharine I,1,98,120,119
1683724612920,PSYC 102,A00,189008,Staff,6,0,30,24
1683724613949,PSYC 106,B00,189026,Gorman; Michael R.,27,0,60,33
1683724614982,PSYC 114,B01,189033,Winkielman; Piotr,0,31,30,30
1683724616008,PSYC 131,A00,189036,Anagnostaras; Stephan,0,44,60,60
1683724617032,PSYC 136,A00,189041,Lowe; Angela Beth,0,7,25,25
1683724618056,PSYC 137,A00,189057,Winkielman; Piotr,0,36,25,25
1683724619081,PSYC 144,A00,189107,Wixted; John T,0,11,50,50
1683724621142,PSYC 162,A00,189142,Staff,0,9,85,85
1683724622169,PSYC 172,A00,189144,Gorman; Michael R.,0,6,30,30
1683724624279,PSYC 179,A00,189146,Lacefield; Katharine I,0,88,120,120
1683724625310,PSYC 181,A00,189147,Anagnostaras; Stephan,0,45,90,90
1683724626335,PSYC 190R,A00,189148,Barner; David A.,0,23,80,80
1683724627359,PSYC 191,A00,189275,Rickard; Timothy C.,0,11,25,25
1683724628387,PSYC 193,A00,189276,Chapman; Eddie Nathaniel,0,1,0,4
1683724629416,PSYC 193L,A01,189281,Lowe; Angela Beth,8,0,20,12
1683724629416,PSYC 193L,B01,189285,Staff,28,0,35,7
1683724630446,RELI 149,A00,187137,Rahimi; Babak,6,0,40,34
1683724631471,SE 9,A01,187315,Staff,0,2,18,18
1683724632497,SE 101B,A00,187409,Staff,24,0,30,6
1683724633523,SE 110B,A00,187444,Staff,10,0,40,30
1683724634546,SE 130B,A00,187449,Staff,31,0,40,9
1683724635574,SE 150A,A00,187516,Staff,8,0,20,12
1683724636605,SE 154,A00,187528,Staff,29,0,50,21
1683724637629,SIO 3,A01,258171,Staff,35,0,40,5
1683724638654,SIO 10,A00,187144,Cook; Geoffrey W,0,6,75,75
1683724639684,SIO 45,A00,187152,Cook; Geoffrey W,1,7,100,99
1683724640712,SIO 109R,A00,194486,Staff,0,4,20,20
1683724642766,SIO 187,A01,187233,Kacev; David,12,0,40,28
1683724643793,SOCI 1,A01,258656,Thorpe; Charles Robert,28,0,30,2
1683724643793,SOCI 1,A02,258658,Thorpe; Charles Robert,30,0,30,0
1683724643793,SOCI 1,A03,258661,Thorpe; Charles Robert,25,0,25,0
1683724643793,SOCI 1,A04,258666,Thorpe; Charles Robert,22,0,25,3
1683724643793,SOCI 1,A05,258897,Thorpe; Charles Robert,22,0,25,3
1683724643793,SOCI 1,A06,258898,Thorpe; Charles Robert,25,0,25,0
1683724644819,SOCI 30,A01,258903,Pardo Guerra; Juan Pablo,14,0,30,16
1683724645843,SOCI 102,A00,258904,Staff,9,0,25,16
1683724646870,SOCI 106,A00,258905,Staff,19,0,25,6
1683724647895,SOCI 111,A00,258907,Ribas Norris; Janet Vanesa,26,0,30,4
1683724648926,SOCI 121R,A00,258908,Pardo Guerra; Juan Pablo,7,0,30,23
1683724649952,SOCI 126,A01,203330,Staff,14,0,20,6
1683724650980,SOCI 131,A00,258909,Thorpe; Charles Robert,30,0,60,30
1683724652006,SOCI 135,A00,258910,Payne; Christine Anna,0,13,30,30
1683724653035,SOCI 157,A00,258911,Staff,10,0,30,20
1683724654060,SOCI 184,A00,258912,Staff,25,0,30,5
1683724655083,SOCI 188D,A00,258913,Staff,22,0,30,8
1683724656108,SYN 2,001,187529,Staff,9,0,16,7
1683724656108,SYN 2,002,201452,Staff,0,20,16,16
1683724656108,SYN 2,003,201469,Staff,1,0,16,15
1683724657133,SYN 100,A01,187531,Staff,0,9,20,20
1683724657133,SYN 100,B01,201491,Staff,0,10,20,20
1683724658164,TDAC 1,A00,189286,Walsh; Kim C.,3,0,20,17
1683724658164,TDAC 1,B00,189287,Harting; Carla Kelso,10,0,20,10
1683724659195,TDAC 101,A00,189300,Walsh; Kim C.,16,0,20,4
1683724659195,TDAC 101,B00,189301,Harting; Carla Kelso,18,0,20,2
1683724660224,TDAC 102,A00,189304,Basso; Beatrice,14,0,20,6
1683724661252,TDAC 108,A00,189305,Staff,18,0,20,2
1683724662281,TDDE 131,A00,189310,Staff,19,0,20,1
1683724662281,TDDE 131,B00,189314,Staff,19,0,20,1
1683724662281,TDDE 131,C00,189315,Staff,48,0,50,2
1683724662281,TDDE 131,D00,189316,Staff,14,0,15,1
1683724662281,TDDE 131,E00,204841,Staff,20,0,20,0
1683724663314,TDGE 10,A00,189289,Staff,26,0,50,24
1683724663314,TDGE 10,B00,189290,Havis; Allan,0,1,50,50
1683724664340,TDGE 11,A00,189291,Fulton; Julia,0,4,50,50
1683724664340,TDGE 11,B00,189292,Staff,20,0,25,5
1683724664340,TDGE 11,C00,260270,Staff,0,0,0,0
1683724665367,TDGE 25,A00,189294,Staff,1,0,20,19
1683724666391,TDGE 124,A00,189318,Fulton; Julia,0,7,50,50
1683724667417,TDGE 125,A00,189319,Staff,13,0,25,12
1683724667417,TDGE 125,B00,189320,Staff,23,0,25,2
1683724668443,TDGE 127,A00,189322,Havis; Allan,1,0,50,49
1683724669467,TDHT 101,A00,189323,Staff,18,0,25,7
1683724669467,TDHT 101,B00,189324,Staff,25,0,25,0
1683724670496,TDHT 102,A00,189325,Staff,49,0,50,1
1683724671526,TDMV 1,A00,189295,Arcidiacono; Kristin,20,0,30,10
1683724671526,TDMV 1,B00,189296,Caligagan; Maria T.,23,0,30,7
1683724672551,TDMV 2,A00,189297,Sammartano; Tonnie,27,0,30,3
1683724672551,TDMV 2,B00,189299,Arcidiacono; Kristin,23,0,30,7
1683724673581,TDMV 3,A00,204998,Rincon; Alicia,22,0,30,8
1683724674606,TDMV 120,A00,189458,Sammartano; Tonnie,28,0,30,2
1683724675634,TDMV 138,A00,189541,Jun; Grace Shin Hae,20,0,40,20
1683724676658,TDMV 142,A00,189717,Caligagan; Tony,25,0,30,5
1683724676658,TDMV 142,B00,189718,Caligagan; Maria T.,25,0,30,5
1683724677686,TMC 2,A01,187533,Staff,25,0,25,0
1683724677686,TMC 2,A02,187534,Staff,25,0,25,0
1683724678715,USP 1,A01,187536,Kwak; Nancy,0,16,25,25
1683724679740,USP 5,A01,187538,Staff,8,0,25,17
1683724680766,USP 101,A00,199253,Staff,0,4,0,0
1683724681794,USP 124,A00,187562,Boomhower; Matthew Charles,0,0,30,30
1683724682820,USP 138,A00,187582,Staff,19,0,25,6
1683724683845,USP 152,A01,187597,Staff,3,0,25,22
1683724684870,USP 153,A00,187598,Staff,18,0,25,7
1683724685899,USP 168,A00,187607,Kwak; Nancy,2,0,5,3
1683724686927,USP 173,A00,187619,Staff,4,0,25,21
1683724687956,USP 181,A00,187638,Staff,0,4,25,25
1683724688995,VIS 103,A00,187650,Cruz; Edwin Teddy,17,0,75,58
1683724690024,VIS 110D,A00,187669,Staff,13,0,22,9
1683724691055,VIS 127C,A00,187720,Shen; Kuiyi,67,0,146,79
1683724692082,VIS 149,A00,187731,Yoldas; Pinar,0,12,22,22
1683724693111,VIS 151,A01,188091,Staff,22,0,34,12
1683724693111,VIS 151,A02,188092,Staff,11,0,34,23
1683724694137,VIS 160B,A00,188093,Stalbaum; Brett,0,1,10,10
1683724696189,WCWP 10B,A00,201720,Staff,0,0,5,5
1683724696189,WCWP 10B,B00,201722,Staff,0,0,6,6
1683724697217,WCWP 100,A00,201725,Gagnon; Jeffrey C,0,0,2,2
1683724697217,WCWP 100,B00,201727,Staff,0,4,15,15
1683724700408,ANBI 133,A00,258401,Wilder; Linnea Lorene,34,0,40,6
1683724701438,ANBI 140,A00,258395,Hrvoj Mihic; Branka,18,0,25,7
1683724702466,ANSC 120,A00,258402,Bialecki; Jon Anthony,26,0,40,14
1683724703490,ANSC 144,A00,258400,Staff,12,0,40,28
1683724705547,ANSC 166,A00,258396,Parish; Steven Martin,156,0,175,19
1683724706575,ANSC 180,A00,193533,Staff,8,0,20,12
1683724707602,ANSC 188,A00,258397,Jassal; Aftab,34,0,40,6
1683724708632,ANTH 3,A01,258316,Staff,23,0,30,7
1683724709664,ANTH 5,A00,258394,Semendeferi; Ekaterini,16,0,20,4
1683724710692,ANTH 21,A01,258331,Staff,4,0,40,36
1683724711718,ANTH 103,A00,258398,Varma; Saiba,15,0,25,10
1683724712747,AWP 10,001,202034,Staff,0,0,0,0
1683724712747,AWP 10,002,202035,Staff,0,0,0,0
1683724712747,AWP 10,003,202036,Staff,0,0,0,0
1683724712747,AWP 10,004,202037,Staff,0,0,0,0
1683724712747,AWP 10,005,202038,Staff,0,0,0,0
1683724712747,AWP 10,006,202039,Staff,0,0,0,0
1683724712747,AWP 10,007,202040,Staff,0,0,0,0
1683724712747,AWP 10,008,202041,Staff,0,0,0,0
1683724712747,AWP 10,009,202042,Staff,0,0,0,0
1683724712747,AWP 10,010,202043,Staff,0,0,0,0
1683724712747,AWP 10,011,202044,Staff,0,0,0,0
1683724712747,AWP 10,012,202045,Staff,0,0,0,0
1683724712747,AWP 10,013,202046,Staff,0,0,0,0
1683724712747,AWP 10,014,202047,Staff,0,0,0,0
1683724712747,AWP 10,015,202048,Staff,0,0,0,0
1683724712747,AWP 10,016,202049,Staff,0,0,0,0
1683724712747,AWP 10,017,202050,Staff,0,0,0,0
1683724712747,AWP 10,018,202051,Staff,0,0,0,0
1683724712747,AWP 10,019,202052,Staff,0,0,0,0
1683724712747,AWP 10,020,202053,Staff,0,0,0,0
1683724712747,AWP 10,021,202054,Staff,0,0,0,0
1683724712747,AWP 10,022,202055,Staff,0,0,0,0
1683724712747,AWP 10,023,202056,Staff,0,0,0,0
1683724712747,AWP 10,024,202057,Staff,0,0,0,0
1683724712747,AWP 10,025,202058,Staff,0,0,0,0
1683724712747,AWP 10,026,202059,Staff,0,0,0,0
1683724713772,AWP 102,001,202032,Staff,0,0,0,0
1683724713772,AWP 102,002,202033,Staff,0,0,0,0
1683724714805,BENG 100,A01,254234,Taylor Amos; Alyssa C,31,0,40,9
1683724715834,BENG 196,001,270013,Engler; Adam J.,9999,0,9999,0
1683724716873,BICD 100R,A01,202018,Smith; Laurie,0,7,32,32
1683724716873,BICD 100R,A02,202019,Smith; Laurie,0,3,32,32
1683724716873,BICD 100R,A03,202020,Smith; Laurie,0,1,32,32
1683724716873,BICD 100R,A04,202021,Smith; Laurie,6,0,32,26
1683724716873,BICD 100R,A05,202022,Smith; Laurie,10,0,32,22
1683724717900,BICD 136,A01,193242,Gustafson-Brown; Cindy,0,2,32,32
1683724717900,BICD 136,A02,193244,Gustafson-Brown; Cindy,13,0,32,19
1683724718926,BIEB 102,A01,193249,Butler; Shannon Rhey,0,0,32,32
1683724718926,BIEB 102,A02,193251,Butler; Shannon Rhey,0,0,32,32
1683724718926,BIEB 102,A03,193253,Butler; Shannon Rhey,0,0,32,32
1683724718926,BIEB 102,A04,193255,Butler; Shannon Rhey,13,0,32,19
1683724718926,BIEB 102,A05,193265,Butler; Shannon Rhey,25,0,32,7
1683724718926,BIEB 102,A06,193269,Butler; Shannon Rhey,12,0,32,20
1683724720979,BIEB 150,A01,193274,Staff,0,0,32,32
1683724720979,BIEB 150,A02,193285,Staff,24,0,32,8
1683724722005,BIEB 194,A00,193286,Kurle; Carolyn M.,19,0,32,13
1683724723032,BILD 1,A01,192291,Staff,15,0,32,17
1683724723032,BILD 1,A02,192292,Staff,30,0,32,2
1683724723032,BILD 1,B01,192520,Reuther; Keefe,0,1,0,0
1683724723032,BILD 1,B02,192532,Reuther; Keefe,0,1,0,0
1683724724061,BILD 3,A01,192556,Butler; Shannon Rhey,0,0,32,32
1683724724061,BILD 3,A02,192581,Butler; Shannon Rhey,0,1,32,32
1683724724061,BILD 3,A03,192611,Butler; Shannon Rhey,19,0,32,13
1683724724061,BILD 3,A04,192612,Butler; Shannon Rhey,23,0,32,9
1683724724061,BILD 3,A05,192613,Butler; Shannon Rhey,26,0,32,6
1683724724061,BILD 3,A06,192679,Butler; Shannon Rhey,27,0,32,5
1683724724061,BILD 3,A07,192682,Butler; Shannon Rhey,20,0,32,12
1683724725086,BILD 4,A01,192836,Reuther; Keefe,1,0,24,23
1683724725086,BILD 4,A02,193044,Reuther; Keefe,4,0,24,20
1683724726114,BILD 10,A01,193142,Gustafson-Brown; Cindy,29,0,32,3
1683724726114,BILD 10,A02,193149,Gustafson-Brown; Cindy,31,0,32,1
1683724727196,BIMM 100,A01,193301,Staff,0,6,32,32
1683724727196,BIMM 100,A02,193312,Staff,0,7,32,32
1683724727196,BIMM 100,A03,193323,Staff,0,10,32,32
1683724728222,BIMM 101,A01,193329,McDonnell; Lisa Marie,0,3,24,24
1683724728222,BIMM 101,A02,193339,McDonnell; Lisa Marie,0,3,24,24
1683724728222,BIMM 101,B01,193354,McDonnell; Lisa Marie,0,4,24,24
1683724728222,BIMM 101,B02,193357,McDonnell; Lisa Marie,0,3,24,24
1683724729248,BIMM 110,A01,193377,Tat; John,0,11,32,32
1683724729248,BIMM 110,A02,193378,Tat; John,0,11,32,32
1683724730274,BIMM 120,A01,206116,Staff,0,0,32,32
1683724730274,BIMM 120,A02,206117,Staff,7,0,32,25
1683724730274,BIMM 120,A03,206121,Staff,21,0,32,11
1683724731306,BIPN 100,A01,193393,Park; Ji Young,0,15,32,32
1683724731306,BIPN 100,A02,193402,Park; Ji Young,0,14,32,32
1683724731306,BIPN 100,A03,193413,Park; Ji Young,0,14,32,32
1683724731306,BIPN 100,A04,193414,Park; Ji Young,0,13,32,32
1683724732335,BIPN 102,A01,193429,Staff,0,0,32,32
1683724732335,BIPN 102,A02,193438,Staff,18,0,32,14
1683724733364,BIPN 106,A01,193450,Reyes Gonzalez; Catalina,0,2,40,40
1683724734391,BIPN 134,A01,193465,Cooke; James Edward,0,0,32,32
1683724734391,BIPN 134,A02,193474,Cooke; James Edward,25,0,32,7
1683724734391,BIPN 134,A03,193485,Cooke; James Edward,29,0,32,3
1683724734391,BIPN 134,A04,193486,Cooke; James Edward,20,0,32,12
1683724734391,BIPN 134,A05,193491,Cooke; James Edward,31,0,32,1
1683724734391,BIPN 134,A06,193501,Cooke; James Edward,30,0,32,2
1683724734391,BIPN 134,A07,193510,Cooke; James Edward,29,0,32,3
1683724736444,BISP 194,A00,222522,Staff,14,0,32,18
1683724737474,CAT 124,A01,202407,Staff,19,0,25,6
1683724738499,CAT 125,A00,202408,Marchisotto; Jennifer Anne,2,0,20,18
1683724739528,CAT 125R,A00,202409,Smith; Lauryn Alissa,0,11,20,20
1683724739528,CAT 125R,B00,202410,Morales; Celeste Georgianna,0,11,20,20
1683724739528,CAT 125R,C00,202411,Irwin; Matthew Joseph,0,12,20,20
1683724740553,CENG 15,A01,204712,Yang; Kesong,0,1,0,0
1683724741578,CENG 114,A00,202070,Jahed Motlagh; Zeinab,5,0,20,15
1683724742603,CGS 105,A00,185477,Wesling; Megan E.,24,0,40,16
1683724743629,CGS 106,A00,185494,Staff,11,0,22,11
1683724744657,CGS 108,A00,185495,Staff,14,0,20,6
1683724745691,CGS 114,A00,185496,Staff,13,0,18,5
1683724746722,CGS 119,A00,185501,Staff,15,0,20,5
1683724747751,CGS 120,A00,185511,Staff,11,0,20,9
1683724748779,CHEM 4,A01,184675,Bussey; Thomas J,97,0,100,3
1683724749803,CHEM 6A,A01,184677,Staff,32,0,60,28
1683724750831,CHEM 6B,A01,184679,Staff,63,0,100,37
1683724751865,CHEM 6C,A01,184681,Bussey; Thomas J,0,0,50,50
1683724751865,CHEM 6C,A02,184682,Bussey; Thomas J,32,0,50,18
1683724752895,CHEM 40A,A01,184684,Albizati; Kim F.,33,0,100,67
1683724753920,CHEM 40B,A01,184686,Albizati; Kim F.,0,22,100,100
1683724754949,CHEM 41B,A01,184690,Staff,51,0,100,49
1683724755974,COGS 3,A01,184715,Boyle; Mary E. T.,0,27,40,40
1683724757000,COGS 14B,A01,185172,Staff,0,14,38,38
1683724758027,COGS 18,A01,184736,Staff,14,0,80,66
1683724759054,COGS 100,A01,184932,Staff,0,8,73,73
1683724760081,COGS 101A,A01,184935,Staff,0,40,30,30
1683724761109,COGS 101B,A01,184944,Staff,0,2,30,30
1683724762140,COGS 101C,A01,184946,Staff,0,10,30,30
1683724763164,COGS 102A,A01,184951,Johnson; Christine M.,1,0,40,39
1683724764190,COGS 107B,A01,184953,Mooshagian; Eric Frederick,0,52,40,40
1683724765214,COGS 118B,A01,184959,Gupta; Anjum,0,50,40,40
1683724766240,COGS 153,A00,184961,Staff,1,16,30,29
1683724767264,COGS 177,A00,184962,Staff,0,20,30,30
1683724768291,COGS 187A,A01,184969,Boyle; Mary E. T.,0,19,40,40
1683724769322,COMM 10,A01,185174,Staff,0,5,25,25
1683724769322,COMM 10,A02,185189,Staff,0,2,25,25
1683724769322,COMM 10,A03,269821,Staff,0,1,0,0
1683724770349,COMM 100B,A02,185476,Staff,10,0,25,15
1683724770349,COMM 100B,A03,277340,Staff,25,0,25,0
1683724771377,COMM 100C,A01,185314,Staff,2,0,25,23
1683724771377,COMM 100C,A02,185327,Staff,17,0,25,8
1683724772402,COMM 110M,A00,185349,Staff,0,0,40,40
1683724773431,COMM 113T,A00,185352,Staff,25,0,40,15
1683724774458,COMM 114I,A00,185353,Staff,31,0,40,9
1683724775484,COMM 131,A00,185354,Staff,17,0,30,13
1683724776511,CSE 8A,A50,185358,Cao; Yingjun,0,46,10,10
1683724777541,CSE 8B,A01,185362,Staff,0,48,50,50
1683724778568,CSE 11,A01,185416,Cao; Yingjun,0,91,10,10
1683724779594,CSE 20,A01,185445,Briones; Jor-el Thomas Caparas,3,0,25,22
1683724780620,CSE 21,A01,185447,Staff,9,0,50,41
1683724781652,CSE 101,A01,185451,Staff,0,13,50,50
1683724781652,CSE 101,B01,185453,Jones; Miles E,0,15,50,50
1683724783708,CSE 141,A01,185458,Eldon; John,16,0,100,84
1683724784736,CSE 141L,A01,185461,Eldon; John,8,0,100,92
1683724785766,CSE 142,A01,185463,Staff,34,0,60,26
1683724785766,CSE 142,B01,201355,Staff,0,7,60,60
1683724786791,CSE 142L,A01,185470,Staff,34,0,60,26
1683724786791,CSE 142L,B01,201417,Staff,0,6,60,60
1683724787819,CSE 190,A00,201433,Staff,32,0,49,17
1683724788846,DOC 1,A01,259136,Strom; Megan C.,7,0,15,8
1683724788846,DOC 1,A02,259137,Strom; Megan C.,15,0,15,0
1683724788846,DOC 1,A03,259138,Strom; Megan C.,14,0,15,1
1683724788846,DOC 1,A04,259139,Strom; Megan C.,13,0,15,2
1683724789871,DOC 100D,A00,259140,Pass; Natalye Joann,14,0,25,11
1683724790897,DSGN 1,A01,184749,Rill; Bryan,0,26,30,30
1683724791922,DSGN 100,A01,185168,Staff,0,2,25,25
1683724792949,ECE 5,A01,185626,Morris; Karcher William,0,12,0,0
1683724793977,ECE 101,A01,185628,Staff,14,0,70,56
1683724795008,ECE 107,A01,185635,Baghdadchi; Saharnaz,0,0,20,20
1683724795008,ECE 107,A02,185638,Baghdadchi; Saharnaz,1,0,20,19
1683724796038,ECE 148,A01,185647,Silberman; Jack,0,0,16,16
1683724797065,ECON 1,A01,185537,Crane; Meredith Helen,54,0,70,16
1683724798089,ECON 3,A01,185549,Crane; Meredith Helen,30,0,70,40
1683724799116,ECON 4,A01,203354,Anderson; John Charles,0,5,10,10
1683724800139,ECON 100A,A01,185574,Staff,0,5,40,40
1683724801163,ECON 100B,A01,185576,Staff,0,12,50,50
1683724802200,ECON 100C,A01,185589,Newhouse; Herbert S,30,0,70,40
1683724803230,ECON 105,A00,185608,Vespa; Emanuel Ignacio,19,0,35,16
1683724804256,ECON 109,A01,185610,Shishkin; Denis,9,0,35,26
1683724805284,ECON 110A,A01,185612,Staff,8,0,40,32
1683724806314,ECON 120A,A01,185615,Staff,19,0,40,21
1683724807346,ECON 120C,A01,185617,Sun; Yixiao,0,21,70,70
1683724808379,ECON 144,A00,203346,Squires; Dale E,2,0,35,33
1683724809404,ECON 171,A01,203349,Newhouse; Herbert S,0,1,35,35
1683724810429,ECON 173A,A01,185621,Toda; Alexis Akira,21,0,35,14
1683724811457,EDS 25,A01,202413,Staff,0,1,0,0
1683724811457,EDS 25,A02,202414,Staff,0,1,0,0
1683724811457,EDS 25,A03,202415,Staff,0,0,0,0
1683724811457,EDS 25,A04,202416,Staff,0,1,0,0
1683724811457,EDS 25,A05,202439,Staff,0,0,0,0
1683724811457,EDS 25,A06,202440,Staff,0,0,0,0
1683724811457,EDS 25,B01,202631,Staff,0,0,0,0
1683724811457,EDS 25,B02,202632,Staff,0,0,0,0
1683724811457,EDS 25,B03,202639,Staff,0,0,0,0
1683724811457,EDS 25,B04,202640,Staff,0,0,0,0
1683724811457,EDS 25,B05,202643,Staff,0,0,0,0
1683724811457,EDS 25,B06,202644,Staff,0,0,0,0
1683724812483,EDS 38,A01,202659,Black; Alison Michelle,25,0,25,0
1683724813510,EDS 115,A00,202652,Staff,18,0,30,12
1683724814540,EDS 125,A00,202649,Staff,13,0,30,17
1683724815570,EDS 126,A01,203332,Staff,30,0,30,0
1683724816594,EDS 139,A00,202838,Staff,16,0,25,9
1683724817620,EDS 146,A01,202655,Staff,14,0,25,11
1683724818652,ENG 15,A00,185667,Staff,0,1,0,0
1683724818652,ENG 15,B00,185672,Staff,0,0,0,0
1683724818652,ENG 15,C00,185675,Staff,0,0,0,0
1683724818652,ENG 15,D00,185682,Staff,0,0,0,0
1683724818652,ENG 15,E00,185684,Staff,0,0,0,0
1683724819677,ETHN 103,A00,185710,Staff,0,8,35,35
1683724820707,ETHN 103A,A00,199228,Man; Simeon S,0,0,9,9
1683724821735,ETHN 109,A00,185711,Staff,15,0,35,20
1683724822764,ETHN 142,A00,185726,Staff,0,4,30,30
1683724823790,ETHN 163J,A00,199229,Man; Simeon S,5,0,8,3
1683724824817,ETHN 168,A00,185727,Staff,7,0,10,3
1683724825852,ETHN 182,A00,185728,Staff,0,0,35,35
1683724826878,ETHN 183,A00,185737,Staff,10,0,18,8
1683724827905,GLBH 111,A01,209361,Burgos; Jose L.,0,0,0,0
1683724829963,HIEU 104,A00,185792,Staff,14,0,20,6
1683724831050,HIEU 115,A00,185800,Staff,0,0,20,20
1683724832077,HIEU 128,A00,185801,Staff,0,9,20,20
1683724833101,HIEU 147,A00,185802,Staff,15,0,20,5
1683724834126,HIEU 154,A00,185823,Staff,11,0,20,9
1683724835156,HILA 102,A00,185826,Staff,14,0,20,6
1683724836184,HILD 2C,A01,185778,Staff,0,13,20,20
1683724837211,HILD 7B,A01,185780,Kwak; Nancy,0,17,32,32
1683724837211,HILD 7B,A02,185781,Kwak; Nancy,0,18,32,32
1683724838236,HILD 30,A01,185791,Staff,12,0,20,8
1683724839262,HISC 119,A00,185830,Golan; Tal,0,10,20,20
1683724840288,HITO 156GS,A00,185831,Patterson; Patrick H.,0,0,0,23
1683724841316,HIUS 103,A00,185832,Man; Simeon S,0,4,20,20
1683724842339,HIUS 117,A00,185836,Kwak; Nancy,2,0,20,18
1683724843367,HIUS 125,A00,185840,Man; Simeon S,0,2,23,23
1683724844393,HIUS 149,A00,185845,Staff,1,0,20,19
1683724845419,HUM 3,A01,185882,Zavodny; Tatiana Sophia,0,8,50,50
1683724845419,HUM 3,B01,185899,Caldwell; Michael Alan,0,18,50,50
1683724846446,HUM 3GS,A00,185900,Patterson; Patrick H.,0,0,0,23
1683724847484,HUM 4,A01,185938,Zroka; Amy Liane,28,0,50,22
1683724847484,HUM 4,B01,185956,Watkins; Eric,0,6,50,50
1683724847484,HUM 4,B02,202209,Watkins; Eric,0,6,50,50
1683724847484,HUM 4,B03,202210,Watkins; Eric,0,5,50,50
1683724848515,HUM 5,A01,185958,West; Geoffrey Scott,0,0,50,50
1683724848515,HUM 5,A02,202215,West; Geoffrey Scott,0,1,50,50
1683724849541,INTL 190,A00,185959,Gagnon; Jeffrey C,0,0,0,9
1683724849541,INTL 190,B00,185960,Lettieri; Michael Joseph,0,0,0,2
1683724850568,JAPN 180,A00,254509,Staff,4,0,30,26
1683724851600,LATI 10,A01,202853,Kennemore; Amy Michelle,4,0,35,31
1683724851600,LATI 10,A02,202854,Kennemore; Amy Michelle,3,0,35,32
1683724851600,LATI 10,A03,270054,Kennemore; Amy Michelle,30,0,30,0
1683724852625,LATI 180,A00,202855,Kennemore; Amy Michelle,11,0,20,9
1683724853651,LAWS 101,A00,201767,Golan; Tal,0,7,40,40
1683724854676,LIFR 1C,A00,185961,Staff,6,0,20,14
1683724855701,LIFR 1CX,A00,185962,Staff,7,0,20,13
1683724856729,LIFR 1D,A00,185963,Staff,7,0,20,13
1683724857753,LIFR 1DX,A00,185964,Staff,7,0,20,13
1683724858778,LIGN 101,A01,186039,Staff,43,0,50,7
1683724859807,LIGN 165,A00,186040,Staff,14,0,50,36
1683724860836,LTCS 108,A00,186041,Staff,5,0,10,5
1683724861862,LTCS 119,A00,186042,Staff,15,0,20,5
1683724862893,LTCS 130,A00,186043,Wesling; Megan E.,15,0,25,10
1683724864950,LTEA 138,A00,186119,Staff,13,0,40,27
1683724865975,LTEN 124,A00,186148,Staff,5,0,25,20
1683724867000,LTEN 178,A00,186149,Staff,6,0,15,9
1683724868025,LTEN 181,A00,186150,Blanco; John D,34,0,40,6
1683724869050,LTWL 120,A00,186160,Staff,19,0,25,6
1683724870078,LTWL 165,A00,186161,Staff,22,0,25,3
1683724871104,LTWR 100,A00,186162,Staff,0,5,15,15
1683724872130,LTWR 102,A00,186163,Doller; Ben,5,0,15,10
1683724873156,MAE 8,A01,186412,Staff,0,1,0,0
1683724874183,MAE 30B,A00,186445,Bahadori; Mohammad Yousef,81,0,100,19
1683724875208,MAE 40,A00,186592,Bewley; Thomas R,10,0,50,40
1683724876231,MAE 101B,A00,186593,Bahadori; Mohammad Yousef,80,0,100,20
1683724877261,MAE 105,A00,186594,Bandaru; Prabhakar,10,0,50,40
1683724878287,MAE 107,A00,186599,Pham; Hieu Tan,0,8,120,120
1683724879313,MAE 148,A01,186660,Silberman; Jack,3,0,16,13
1683724880345,MATH 10A,A01,188095,Staff,0,6,35,35
1683724881372,MATH 10B,A01,188097,Bowers; Adam R.,0,12,30,30
1683724881372,MATH 10B,A02,188099,Bowers; Adam R.,0,11,30,30
1683724881372,MATH 10B,B01,188104,Bowers; Adam R.,0,10,30,30
1683724881372,MATH 10B,B02,188106,Bowers; Adam R.,0,9,30,30
1683724882397,MATH 10C,A01,188111,Staff,0,20,30,30
1683724882397,MATH 10C,A02,188127,Staff,0,19,30,30
1683724882397,MATH 10C,A03,188131,Staff,0,19,30,30
1683724882397,MATH 10C,B01,188218,Staff,17,0,30,13
1683724882397,MATH 10C,B02,188244,Staff,13,0,30,17
1683724882397,MATH 10C,B03,188277,Staff,14,0,30,16
1683724883430,MATH 18,A01,188344,Bach; Quang Tran,18,0,30,12
1683724883430,MATH 18,A02,188345,Bach; Quang Tran,11,0,30,19
1683724883430,MATH 18,B01,188353,Bach; Quang Tran,11,0,30,19
1683724883430,MATH 18,B02,188354,Bach; Quang Tran,19,0,30,11
1683724884459,MATH 20A,A01,188374,Staff,11,0,35,24
1683724885487,MATH 20B,A01,188382,Ohm; Ko Woon,7,0,30,23
1683724885487,MATH 20B,A02,188383,Ohm; Ko Woon,22,0,30,8
1683724885487,MATH 20B,B01,188385,Ohm; Ko Woon,7,0,30,23
1683724885487,MATH 20B,B02,188392,Ohm; Ko Woon,22,0,30,8
1683724886514,MATH 20C,A01,188394,Harel; Guershon,10,0,30,20
1683724886514,MATH 20C,A02,188395,Harel; Guershon,13,0,30,17
1683724886514,MATH 20C,B01,188404,Harel; Guershon,5,0,30,25
1683724886514,MATH 20C,B02,188405,Harel; Guershon,18,0,30,12
1683724887541,MATH 20D,A01,188414,Hammock; Frances H,0,1,30,30
1683724887541,MATH 20D,A02,188415,Hammock; Frances H,0,1,30,30
1683724887541,MATH 20D,B01,188447,Hammock; Frances H,0,1,30,30
1683724887541,MATH 20D,B02,188486,Hammock; Frances H,2,0,30,28
1683724888567,MATH 20E,A01,188649,Staff,21,0,30,9
1683724888567,MATH 20E,A02,188650,Staff,20,0,30,10
1683724888567,MATH 20E,A03,188673,Staff,0,0,30,30
1683724889593,MATH 102,A01,188675,Staff,0,40,35,35
1683724890623,MATH 103B,A01,188681,Staff,3,0,35,32
1683724890623,MATH 103B,B01,188692,Staff,5,0,35,30
1683724891650,MATH 109,A01,188695,Salehi Golsefidy; Alireza,24,0,35,11
1683724891650,MATH 109,A02,188696,Salehi Golsefidy; Alireza,24,0,35,11
1683724892678,MATH 120A,A01,188698,Eggers; John Dietrich,7,0,35,28
1683724893714,MATH 142B,A01,188736,Ioana; Adrian,0,0,30,30
1683724893714,MATH 142B,A02,188741,Ioana; Adrian,0,1,30,30
1683724893714,MATH 142B,A03,188743,Ioana; Adrian,0,3,30,30
1683724894738,MATH 168A,A01,188790,Staff,0,11,35,35
1683724895765,MATH 170A,A01,188803,Nie; Jiawang,0,2,35,35
1683724895765,MATH 170A,A02,188811,Nie; Jiawang,0,1,35,35
1683724895765,MATH 170A,A03,188814,Nie; Jiawang,1,0,35,34
1683724895765,MATH 170A,A04,188815,Nie; Jiawang,5,0,35,30
1683724896791,MATH 193B,A01,188817,Staff,0,0,35,35
1683724896791,MATH 193B,A02,188818,Staff,6,0,35,29
1683724897819,MGT 4,A01,202857,Anderson; John Charles,59,0,80,21
1683724898852,MGT 12,A00,202858,Lindenberger; Wade Douglas,40,0,90,50
1683724899895,MGT 18,A00,202859,Staff,73,0,90,17
1683724900922,MGT 18GS,A00,202860,McKay; Michael J,13,0,28,15
1683724901957,MGT 45,A00,202861,Pecore; Joseph P.,8,0,90,82
1683724902988,MGT 100,A00,202863,Yavorsky; Daniel Ryan,27,0,90,63
1683724904014,MGT 103,A00,202864,Ehrich; Kristine R,0,19,90,90
1683724905040,MGT 112,A00,202865,Ehrich; Kristine R,15,0,90,75
1683724906066,MGT 121A,A00,202868,Staff,70,0,90,20
1683724907095,MGT 131B,A00,202869,Anderson; John Charles,58,0,90,32
1683724908121,MGT 136,A00,202871,Lindenberger; Wade Douglas,83,0,90,7
1683724909146,MGT 164,A00,202873,Staff,0,67,90,91
1683724910171,MGT 164GS,A00,202874,McKay; Mary A,13,0,28,15
1683724911197,MGT 180,A00,202875,Staff,0,51,90,91
1683724912223,MMW 11R,A01,205019,Herbst; Matthew,0,0,30,30
1683724912223,MMW 11R,A02,205026,Herbst; Matthew,29,0,30,1
1683724913259,MMW 15,A01,193512,Chang; Edmond Yi-Teh,0,8,28,28
1683724913259,MMW 15,A02,193513,Chang; Edmond Yi-Teh,0,5,28,28
1683724913259,MMW 15,A03,193514,Chang; Edmond Yi-Teh,0,5,28,28
1683724913259,MMW 15,A04,193515,Chang; Edmond Yi-Teh,0,5,28,28
1683724913259,MMW 15,A05,193516,Chang; Edmond Yi-Teh,0,5,28,28
1683724913259,MMW 15,A06,193517,Chang; Edmond Yi-Teh,0,6,28,28
1683724913259,MMW 15,B01,193519,Chang; Edmond Yi-Teh,0,5,28,28
1683724913259,MMW 15,B02,193520,Chang; Edmond Yi-Teh,0,5,28,28
1683724913259,MMW 15,B03,193521,Chang; Edmond Yi-Teh,0,5,28,28
1683724913259,MMW 15,B04,193522,Chang; Edmond Yi-Teh,0,6,28,28
1683724913259,MMW 15,B05,193523,Chang; Edmond Yi-Teh,0,5,28,28
1683724913259,MMW 15,B06,193524,Chang; Edmond Yi-Teh,0,5,28,28
1683724914289,MMW 122,A01,193526,Rahimi; Babak,0,16,28,28
1683724914289,MMW 122,A02,193527,Rahimi; Babak,0,15,28,28
1683724914289,MMW 122,A03,193528,Rahimi; Babak,0,0,0,0
1683724914289,MMW 122,A04,193529,Rahimi; Babak,0,0,0,0
1683724915316,MUS 1A,A01,186663,Staff,0,18,35,35
1683724916342,MUS 4,A01,186715,Staff,0,12,35,35
1683724917367,MUS 5R,A01,186796,Dubnov; Shlomo,0,17,35,35
1683724918395,MUS 6,A01,186798,Staff,0,4,25,25
1683724919428,MUS 7,A01,186830,Staff,11,0,35,24
1683724920458,MUS 8,A01,186930,Staff,0,27,35,35
1683724921485,MUS 15,A01,186932,Staff,0,15,35,35
1683724921485,MUS 15,B01,186934,Staff,0,16,35,35
1683724922510,MUS 80,A00,186935,Staff,0,0,20,20
1683724922510,MUS 80,B00,186936,Staff,24,0,25,1
1683724923542,NANO 11,A00,204702,Lipomi; Darren John,0,0,0,0
1683724924577,NANO 15,A01,204709,Yang; Kesong,0,1,0,0
1683724925606,NANO 114,A00,202069,Jahed Motlagh; Zeinab,2,0,10,8
1683724926637,PHIL 1,A00,186955,Grush; Rick Scott,31,0,40,9
1683724927668,PHIL 10,A01,186973,Grush; Rick Scott,27,0,35,8
1683724927668,PHIL 10,A02,186974,Grush; Rick Scott,33,0,35,2
1683724928698,PHIL 13,A01,186976,Staff,1,0,35,34
1683724928698,PHIL 13,A02,186977,Staff,16,0,35,19
1683724929724,PHIL 14,A01,186979,Staff,30,0,35,5
1683724929724,PHIL 14,A02,186986,Staff,32,0,35,3
1683724930750,PHIL 28,A01,186988,Staff,16,0,30,14
1683724930750,PHIL 28,A02,186989,Staff,0,0,30,30
1683724930750,PHIL 28,A03,186990,Staff,10,0,30,20
1683724930750,PHIL 28,A04,186991,Staff,26,0,30,4
1683724931775,PHIL 120,A00,186997,Staff,23,0,40,17
1683724932800,PHIL 137,A00,187003,Staff,8,0,40,32
1683724933825,PHIL 150,A00,187015,Staff,47,0,70,23
1683724934913,PHIL 167,A00,187021,Lamey; Andy M.,34,0,40,6
1683724935938,PHIL 174,A01,202226,Staff,17,0,20,3
1683724935938,PHIL 174,A02,202235,Staff,20,0,20,0
1683724936966,PHIL 191A,A00,258918,Staff,0,0,1,1
1683724937992,PHYS 1A,A00,187028,Staff,26,0,60,34
1683724939022,PHYS 1AL,001,187036,Staff,3,0,30,27
1683724939022,PHYS 1AL,002,187049,Staff,18,0,30,12
1683724940046,PHYS 1B,A00,187058,Staff,21,0,60,39
1683724941073,PHYS 1BL,001,187064,Staff,0,1,30,30
1683724941073,PHYS 1BL,002,187070,Staff,4,0,30,26
1683724942098,PHYS 1C,A00,187082,Staff,30,0,120,90
1683724943125,PHYS 1CL,001,187088,Staff,0,9,30,30
1683724943125,PHYS 1CL,002,187089,Staff,0,1,30,30
1683724943125,PHYS 1CL,009,262693,Staff,9,0,30,21
1683724944156,PHYS 2B,A01,187097,Staff,55,0,115,60
1683724945188,PHYS 2C,A01,187099,Staff,63,0,115,52
1683724946214,PHYS 2CL,A01,187101,Staff,5,0,28,23
1683724946214,PHYS 2CL,A02,187102,Staff,15,0,28,13
1683724947242,PHYS 2D,A01,187123,Shotwell; Brian,95,0,115,20
1683724948272,PHYS 4B,A01,187133,Grinstein; Benjamin,35,0,50,15
1683724949301,POLI 10,A00,188819,Staff,0,4,50,50
1683724950328,POLI 11,A00,188827,Staff,43,0,50,7
1683724951353,POLI 13R,A00,188828,Staff,0,2,20,20
1683724952383,POLI 27,A01,188830,Elgin; Samuel Zincke,0,2,70,70
1683724953415,POLI 30,A00,188832,Desposato; Scott,30,0,50,20
1683724954443,POLI 102F,A00,188834,Staff,1,0,40,39
1683724955471,POLI 104A,A00,188852,Staff,12,0,30,18
1683724956496,POLI 104I,A00,188853,Staff,0,8,20,20
1683724957521,POLI 110B,A00,188854,Wiens; David,6,0,20,14
1683724958544,POLI 112A,A00,188855,Wiens; David,3,0,30,27
1683724959568,POLI 117R,A00,188856,Forman; Fonna,0,12,20,20
1683724960595,POLI 118,A00,188857,Ingham; Sean,8,0,20,12
1683724961620,POLI 120G,A00,188858,Staff,7,0,30,23
1683724962646,POLI 131CR,A00,188863,Hoston; Germaine,20,0,50,30
1683724963673,POLI 133,A00,188864,Nellis; Gareth Hb,44,0,50,6
1683724964699,POLI 134D,A00,188865,Desposato; Scott,27,0,30,3
1683724965731,POLI 142A,A00,188871,Gartzke; Erik,21,0,50,29
1683724966754,POLI 142K,A00,188874,Staff,38,0,50,12
1683724967781,POLI 143,A00,188940,Gartzke; Erik,15,0,30,15
1683724968806,POLI 153,A00,188943,Staff,1,0,20,19
1683724969835,POLI 160AA,A00,188944,Staff,10,0,40,30
1683724970862,POLI 170A,A00,188945,Staff,10,0,30,20
1683724972914,PSYC 1,A00,188952,Staff,36,0,90,54
1683724973943,PSYC 2,B00,188953,Staff,19,0,35,16
1683724974991,PSYC 6,A00,188970,Staff,47,0,60,13
1683724976017,PSYC 7,A00,188973,Staff,35,0,45,10
1683724977050,PSYC 60,A01,188980,Rickard; Timothy C.,42,0,60,18
1683724978078,PSYC 70,A01,189001,Steiner; Eric Tomas,22,0,45,23
1683724979104,PSYC 100,A00,189005,Lacefield; Katharine I,1,98,120,119
1683724980131,PSYC 102,A00,189008,Staff,6,0,30,24
1683724981155,PSYC 106,B00,189026,Gorman; Michael R.,27,0,60,33
1683724982181,PSYC 114,B01,189033,Winkielman; Piotr,0,31,30,30
1683724983207,PSYC 131,A00,189036,Anagnostaras; Stephan,0,44,60,60
1683724984236,PSYC 136,A00,189041,Lowe; Angela Beth,0,7,25,25
1683724985264,PSYC 137,A00,189057,Winkielman; Piotr,0,36,25,25
1683724986289,PSYC 144,A00,189107,Wixted; John T,0,11,50,50
1683724988343,PSYC 162,A00,189142,Staff,0,9,85,85
1683724989374,PSYC 172,A00,189144,Gorman; Michael R.,0,6,30,30
1683724991424,PSYC 179,A00,189146,Lacefield; Katharine I,0,88,120,120
1683724992456,PSYC 181,A00,189147,Anagnostaras; Stephan,0,45,90,90
1683724993486,PSYC 190R,A00,189148,Barner; David A.,0,23,80,80
1683724994512,PSYC 191,A00,189275,Rickard; Timothy C.,0,11,25,25
1683724995538,PSYC 193,A00,189276,Chapman; Eddie Nathaniel,0,1,0,4
1683724996564,PSYC 193L,A01,189281,Lowe; Angela Beth,8,0,20,12
1683724996564,PSYC 193L,B01,189285,Staff,28,0,35,7
1683724997590,RELI 149,A00,187137,Rahimi; Babak,6,0,40,34
1683724998616,SE 9,A01,187315,Staff,0,2,18,18
1683724999641,SE 101B,A00,187409,Staff,24,0,30,6
1683725000671,SE 110B,A00,187444,Staff,10,0,40,30
1683725001698,SE 130B,A00,187449,Staff,31,0,40,9
1683725002722,SE 150A,A00,187516,Staff,8,0,20,12
1683725003747,SE 154,A00,187528,Staff,29,0,50,21
1683725004775,SIO 3,A01,258171,Staff,35,0,40,5
1683725005805,SIO 10,A00,187144,Cook; Geoffrey W,0,6,75,75
1683725006830,SIO 45,A00,187152,Cook; Geoffrey W,1,7,100,99
1683725007855,SIO 109R,A00,194486,Staff,0,4,20,20
1683725009910,SIO 187,A01,187233,Kacev; David,12,0,40,28
1683725010948,SOCI 1,A01,258656,Thorpe; Charles Robert,28,0,30,2
1683725010948,SOCI 1,A02,258658,Thorpe; Charles Robert,30,0,30,0
1683725010948,SOCI 1,A03,258661,Thorpe; Charles Robert,25,0,25,0
1683725010948,SOCI 1,A04,258666,Thorpe; Charles Robert,22,0,25,3
1683725010948,SOCI 1,A05,258897,Thorpe; Charles Robert,22,0,25,3
1683725010948,SOCI 1,A06,258898,Thorpe; Charles Robert,25,0,25,0
1683725011979,SOCI 30,A01,258903,Pardo Guerra; Juan Pablo,14,0,30,16
1683725013007,SOCI 102,A00,258904,Staff,9,0,25,16
1683725014032,SOCI 106,A00,258905,Staff,19,0,25,6
1683725015059,SOCI 111,A00,258907,Ribas Norris; Janet Vanesa,26,0,30,4
1683725016086,SOCI 121R,A00,258908,Pardo Guerra; Juan Pablo,7,0,30,23
1683725017115,SOCI 126,A01,203330,Staff,14,0,20,6
1683725018139,SOCI 131,A00,258909,Thorpe; Charles Robert,30,0,60,30
1683725019164,SOCI 135,A00,258910,Payne; Christine Anna,0,13,30,30
1683725020191,SOCI 157,A00,258911,Staff,10,0,30,20
1683725021218,SOCI 184,A00,258912,Staff,25,0,30,5
1683725022247,SOCI 188D,A00,258913,Staff,22,0,30,8
1683725023273,SYN 2,001,187529,Staff,9,0,16,7
1683725023273,SYN 2,002,201452,Staff,0,20,16,16
1683725023273,SYN 2,003,201469,Staff,1,0,16,15
1683725024297,SYN 100,A01,187531,Staff,0,9,20,20
1683725024297,SYN 100,B01,201491,Staff,0,10,20,20
1683725025331,TDAC 1,A00,189286,Walsh; Kim C.,3,0,20,17
1683725025331,TDAC 1,B00,189287,Harting; Carla Kelso,10,0,20,10
1683725026356,TDAC 101,A00,189300,Walsh; Kim C.,16,0,20,4
1683725026356,TDAC 101,B00,189301,Harting; Carla Kelso,18,0,20,2
1683725027382,TDAC 102,A00,189304,Basso; Beatrice,14,0,20,6
1683725028410,TDAC 108,A00,189305,Staff,18,0,20,2
1683725029442,TDDE 131,A00,189310,Staff,19,0,20,1
1683725029442,TDDE 131,B00,189314,Staff,19,0,20,1
1683725029442,TDDE 131,C00,189315,Staff,48,0,50,2
1683725029442,TDDE 131,D00,189316,Staff,14,0,15,1
1683725029442,TDDE 131,E00,204841,Staff,20,0,20,0
1683725030467,TDGE 10,A00,189289,Staff,26,0,50,24
1683725030467,TDGE 10,B00,189290,Havis; Allan,0,1,50,50
1683725031495,TDGE 11,A00,189291,Fulton; Julia,0,4,50,50
1683725031495,TDGE 11,B00,189292,Staff,20,0,25,5
1683725031495,TDGE 11,C00,260270,Staff,0,0,0,0
1683725032523,TDGE 25,A00,189294,Staff,1,0,20,19
1683725033552,TDGE 124,A00,189318,Fulton; Julia,0,7,50,50
1683725034577,TDGE 125,A00,189319,Staff,13,0,25,12
1683725034577,TDGE 125,B00,189320,Staff,23,0,25,2
1683725035602,TDGE 127,A00,189322,Havis; Allan,1,0,50,49
1683725036631,TDHT 101,A00,189323,Staff,18,0,25,7
1683725036631,TDHT 101,B00,189324,Staff,25,0,25,0
1683725037657,TDHT 102,A00,189325,Staff,49,0,50,1
1683725038762,TDMV 1,A00,189295,Arcidiacono; Kristin,20,0,30,10
1683725038762,TDMV 1,B00,189296,Caligagan; Maria T.,23,0,30,7
1683725039788,TDMV 2,A00,189297,Sammartano; Tonnie,27,0,30,3
1683725039788,TDMV 2,B00,189299,Arcidiacono; Kristin,23,0,30,7
1683725040816,TDMV 3,A00,204998,Rincon; Alicia,22,0,30,8
1683725041850,TDMV 120,A00,189458,Sammartano; Tonnie,28,0,30,2
1683725042875,TDMV 138,A00,189541,Jun; Grace Shin Hae,20,0,40,20
1683725043900,TDMV 142,A00,189717,Caligagan; Tony,25,0,30,5
1683725043900,TDMV 142,B00,189718,Caligagan; Maria T.,25,0,30,5
1683725044925,TMC 2,A01,187533,Staff,25,0,25,0
1683725044925,TMC 2,A02,187534,Staff,25,0,25,0
1683725045950,USP 1,A01,187536,Kwak; Nancy,0,16,25,25
1683725046979,USP 5,A01,187538,Staff,8,0,25,17
1683725048004,USP 101,A00,199253,Staff,0,4,0,0
1683725049030,USP 124,A00,187562,Boomhower; Matthew Charles,0,0,30,30
1683725050056,USP 138,A00,187582,Staff,19,0,25,6
1683725051082,USP 152,A01,187597,Staff,3,0,25,22
1683725052108,USP 153,A00,187598,Staff,18,0,25,7
1683725053136,USP 168,A00,187607,Kwak; Nancy,2,0,5,3
1683725054164,USP 173,A00,187619,Staff,4,0,25,21
1683725055190,USP 181,A00,187638,Staff,0,4,25,25
1683725056214,VIS 103,A00,187650,Cruz; Edwin Teddy,17,0,75,58
1683725057237,VIS 110D,A00,187669,Staff,13,0,22,9
1683725058268,VIS 127C,A00,187720,Shen; Kuiyi,67,0,146,79
1683725059298,VIS 149,A00,187731,Yoldas; Pinar,0,12,22,22
1683725060327,VIS 151,A01,188091,Staff,22,0,34,12
1683725060327,VIS 151,A02,188092,Staff,11,0,34,23
1683725061353,VIS 160B,A00,188093,Stalbaum; Brett,0,1,10,10
1683725063411,WCWP 10B,A00,201720,Staff,0,0,5,5
1683725063411,WCWP 10B,B00,201722,Staff,0,0,6,6
1683725064441,WCWP 100,A00,201725,Gagnon; Jeffrey C,0,0,2,2
1683725064441,WCWP 100,B00,201727,Staff,0,4,15,15
1683725067587,ANBI 133,A00,258401,Wilder; Linnea Lorene,34,0,40,6
1683725068615,ANBI 140,A00,258395,Hrvoj Mihic; Branka,18,0,25,7
1683725069640,ANSC 120,A00,258402,Bialecki; Jon Anthony,26,0,40,14
1683725070665,ANSC 144,A00,258400,Staff,12,0,40,28
1683725072724,ANSC 166,A00,258396,Parish; Steven Martin,156,0,175,19
1683725073754,ANSC 180,A00,193533,Staff,8,0,20,12
1683725074779,ANSC 188,A00,258397,Jassal; Aftab,34,0,40,6
1683725075804,ANTH 3,A01,258316,Staff,23,0,30,7
1683725076830,ANTH 5,A00,258394,Semendeferi; Ekaterini,16,0,20,4
1683725077855,ANTH 21,A01,258331,Staff,4,0,40,36
1683725078879,ANTH 103,A00,258398,Varma; Saiba,15,0,25,10
1683725079909,AWP 10,001,202034,Staff,0,0,0,0
1683725079909,AWP 10,002,202035,Staff,0,0,0,0
1683725079909,AWP 10,003,202036,Staff,0,0,0,0
1683725079909,AWP 10,004,202037,Staff,0,0,0,0
1683725079909,AWP 10,005,202038,Staff,0,0,0,0
1683725079909,AWP 10,006,202039,Staff,0,0,0,0
1683725079909,AWP 10,007,202040,Staff,0,0,0,0
1683725079909,AWP 10,008,202041,Staff,0,0,0,0
1683725079909,AWP 10,009,202042,Staff,0,0,0,0
1683725079909,AWP 10,010,202043,Staff,0,0,0,0
1683725079909,AWP 10,011,202044,Staff,0,0,0,0
1683725079909,AWP 10,012,202045,Staff,0,0,0,0
1683725079909,AWP 10,013,202046,Staff,0,0,0,0
1683725079909,AWP 10,014,202047,Staff,0,0,0,0
1683725079909,AWP 10,015,202048,Staff,0,0,0,0
1683725079909,AWP 10,016,202049,Staff,0,0,0,0
1683725079909,AWP 10,017,202050,Staff,0,0,0,0
1683725079909,AWP 10,018,202051,Staff,0,0,0,0
1683725079909,AWP 10,019,202052,Staff,0,0,0,0
1683725079909,AWP 10,020,202053,Staff,0,0,0,0
1683725079909,AWP 10,021,202054,Staff,0,0,0,0
1683725079909,AWP 10,022,202055,Staff,0,0,0,0
1683725079909,AWP 10,023,202056,Staff,0,0,0,0
1683725079909,AWP 10,024,202057,Staff,0,0,0,0
1683725079909,AWP 10,025,202058,Staff,0,0,0,0
1683725079909,AWP 10,026,202059,Staff,0,0,0,0
1683725080938,AWP 102,001,202032,Staff,0,0,0,0
1683725080938,AWP 102,002,202033,Staff,0,0,0,0
1683725081967,BENG 100,A01,254234,Taylor Amos; Alyssa C,31,0,40,9
1683725082992,BENG 196,001,270013,Engler; Adam J.,9999,0,9999,0
1683725084019,BICD 100R,A01,202018,Smith; Laurie,0,7,32,32
1683725084019,BICD 100R,A02,202019,Smith; Laurie,0,3,32,32
1683725084019,BICD 100R,A03,202020,Smith; Laurie,0,1,32,32
1683725084019,BICD 100R,A04,202021,Smith; Laurie,6,0,32,26
1683725084019,BICD 100R,A05,202022,Smith; Laurie,10,0,32,22
1683725085054,BICD 136,A01,193242,Gustafson-Brown; Cindy,0,2,32,32
1683725085054,BICD 136,A02,193244,Gustafson-Brown; Cindy,13,0,32,19
1683725086081,BIEB 102,A01,193249,Butler; Shannon Rhey,0,0,32,32
1683725086081,BIEB 102,A02,193251,Butler; Shannon Rhey,0,0,32,32
1683725086081,BIEB 102,A03,193253,Butler; Shannon Rhey,0,0,32,32
1683725086081,BIEB 102,A04,193255,Butler; Shannon Rhey,13,0,32,19
1683725086081,BIEB 102,A05,193265,Butler; Shannon Rhey,25,0,32,7
1683725086081,BIEB 102,A06,193269,Butler; Shannon Rhey,12,0,32,20
1683725088131,BIEB 150,A01,193274,Staff,0,0,32,32
1683725088131,BIEB 150,A02,193285,Staff,24,0,32,8
1683725089160,BIEB 194,A00,193286,Kurle; Carolyn M.,19,0,32,13
1683725090195,BILD 1,A01,192291,Staff,15,0,32,17
1683725090195,BILD 1,A02,192292,Staff,30,0,32,2
1683725090195,BILD 1,B01,192520,Reuther; Keefe,0,1,0,0
1683725090195,BILD 1,B02,192532,Reuther; Keefe,0,1,0,0
1683725091230,BILD 3,A01,192556,Butler; Shannon Rhey,0,0,32,32
1683725091230,BILD 3,A02,192581,Butler; Shannon Rhey,0,1,32,32
1683725091230,BILD 3,A03,192611,Butler; Shannon Rhey,19,0,32,13
1683725091230,BILD 3,A04,192612,Butler; Shannon Rhey,23,0,32,9
1683725091230,BILD 3,A05,192613,Butler; Shannon Rhey,26,0,32,6
1683725091230,BILD 3,A06,192679,Butler; Shannon Rhey,27,0,32,5
1683725091230,BILD 3,A07,192682,Butler; Shannon Rhey,20,0,32,12
1683725092261,BILD 4,A01,192836,Reuther; Keefe,1,0,24,23
1683725092261,BILD 4,A02,193044,Reuther; Keefe,4,0,24,20
1683725093287,BILD 10,A01,193142,Gustafson-Brown; Cindy,29,0,32,3
1683725093287,BILD 10,A02,193149,Gustafson-Brown; Cindy,31,0,32,1
1683725094317,BIMM 100,A01,193301,Staff,0,6,32,32
1683725094317,BIMM 100,A02,193312,Staff,0,7,32,32
1683725094317,BIMM 100,A03,193323,Staff,0,10,32,32
1683725095343,BIMM 101,A01,193329,McDonnell; Lisa Marie,0,3,24,24
1683725095343,BIMM 101,A02,193339,McDonnell; Lisa Marie,0,3,24,24
1683725095343,BIMM 101,B01,193354,McDonnell; Lisa Marie,0,4,24,24
1683725095343,BIMM 101,B02,193357,McDonnell; Lisa Marie,0,3,24,24
1683725096377,BIMM 110,A01,193377,Tat; John,0,11,32,32
1683725096377,BIMM 110,A02,193378,Tat; John,0,11,32,32
1683725097412,BIMM 120,A01,206116,Staff,0,0,32,32
1683725097412,BIMM 120,A02,206117,Staff,7,0,32,25
1683725097412,BIMM 120,A03,206121,Staff,21,0,32,11
1683725098439,BIPN 100,A01,193393,Park; Ji Young,0,15,32,32
1683725098439,BIPN 100,A02,193402,Park; Ji Young,0,14,32,32
1683725098439,BIPN 100,A03,193413,Park; Ji Young,0,14,32,32
1683725098439,BIPN 100,A04,193414,Park; Ji Young,0,13,32,32
1683725099464,BIPN 102,A01,193429,Staff,0,0,32,32
1683725099464,BIPN 102,A02,193438,Staff,18,0,32,14
1683725100489,BIPN 106,A01,193450,Reyes Gonzalez; Catalina,0,2,40,40
1683725101513,BIPN 134,A01,193465,Cooke; James Edward,0,0,32,32
1683725101513,BIPN 134,A02,193474,Cooke; James Edward,25,0,32,7
1683725101513,BIPN 134,A03,193485,Cooke; James Edward,29,0,32,3
1683725101513,BIPN 134,A04,193486,Cooke; James Edward,20,0,32,12
1683725101513,BIPN 134,A05,193491,Cooke; James Edward,31,0,32,1
1683725101513,BIPN 134,A06,193501,Cooke; James Edward,30,0,32,2
1683725101513,BIPN 134,A07,193510,Cooke; James Edward,29,0,32,3
1683725103567,BISP 194,A00,222522,Staff,14,0,32,18
1683725104592,CAT 124,A01,202407,Staff,19,0,25,6
1683725105618,CAT 125,A00,202408,Marchisotto; Jennifer Anne,2,0,20,18
1683725106643,CAT 125R,A00,202409,Smith; Lauryn Alissa,0,11,20,20
1683725106643,CAT 125R,B00,202410,Morales; Celeste Georgianna,0,11,20,20
1683725106643,CAT 125R,C00,202411,Irwin; Matthew Joseph,0,12,20,20
1683725107670,CENG 15,A01,204712,Yang; Kesong,0,1,0,0
1683725108694,CENG 114,A00,202070,Jahed Motlagh; Zeinab,5,0,20,15
1683725109732,CGS 105,A00,185477,Wesling; Megan E.,24,0,40,16
1683725110759,CGS 106,A00,185494,Staff,11,0,22,11
1683725111984,CGS 108,A00,185495,Staff,14,0,20,6
1683725113010,CGS 114,A00,185496,Staff,13,0,18,5
1683725114038,CGS 119,A00,185501,Staff,15,0,20,5
1683725115062,CGS 120,A00,185511,Staff,11,0,20,9
1683725116088,CHEM 4,A01,184675,Bussey; Thomas J,97,0,100,3
1683725117112,CHEM 6A,A01,184677,Staff,32,0,60,28
1683725118140,CHEM 6B,A01,184679,Staff,63,0,100,37
1683725119169,CHEM 6C,A01,184681,Bussey; Thomas J,0,0,50,50
1683725119169,CHEM 6C,A02,184682,Bussey; Thomas J,32,0,50,18
1683725120196,CHEM 40A,A01,184684,Albizati; Kim F.,33,0,100,67
1683725121221,CHEM 40B,A01,184686,Albizati; Kim F.,0,22,100,100
1683725122247,CHEM 41B,A01,184690,Staff,51,0,100,49
1683725123272,COGS 3,A01,184715,Boyle; Mary E. T.,0,27,40,40
1683725124298,COGS 14B,A01,185172,Staff,0,14,38,38
1683725125324,COGS 18,A01,184736,Staff,14,0,80,66
1683725126352,COGS 100,A01,184932,Staff,0,8,73,73
1683725127381,COGS 101A,A01,184935,Staff,0,40,30,30
1683725128410,COGS 101B,A01,184944,Staff,0,2,30,30
1683725129435,COGS 101C,A01,184946,Staff,0,10,30,30
1683725130464,COGS 102A,A01,184951,Johnson; Christine M.,1,0,40,39
1683725131497,COGS 107B,A01,184953,Mooshagian; Eric Frederick,0,52,40,40
1683725132525,COGS 118B,A01,184959,Gupta; Anjum,0,50,40,40
1683725133551,COGS 153,A00,184961,Staff,1,16,30,29
1683725134575,COGS 177,A00,184962,Staff,0,20,30,30
1683725135610,COGS 187A,A01,184969,Boyle; Mary E. T.,0,19,40,40
1683725136639,COMM 10,A01,185174,Staff,0,5,25,25
1683725136639,COMM 10,A02,185189,Staff,0,2,25,25
1683725136639,COMM 10,A03,269821,Staff,0,1,0,0
1683725137666,COMM 100B,A02,185476,Staff,10,0,25,15
1683725137666,COMM 100B,A03,277340,Staff,25,0,25,0
1683725138692,COMM 100C,A01,185314,Staff,2,0,25,23
1683725138692,COMM 100C,A02,185327,Staff,17,0,25,8
1683725139717,COMM 110M,A00,185349,Staff,0,0,40,40
1683725140744,COMM 113T,A00,185352,Staff,25,0,40,15
1683725141772,COMM 114I,A00,185353,Staff,31,0,40,9
1683725142849,COMM 131,A00,185354,Staff,17,0,30,13
1683725143875,CSE 8A,A50,185358,Cao; Yingjun,0,46,10,10
1683725144903,CSE 8B,A01,185362,Staff,0,48,50,50
1683725145936,CSE 11,A01,185416,Cao; Yingjun,0,91,10,10
1683725146968,CSE 20,A01,185445,Briones; Jor-el Thomas Caparas,3,0,25,22
1683725147993,CSE 21,A01,185447,Staff,9,0,50,41
1683725149020,CSE 101,A01,185451,Staff,0,13,50,50
1683725149020,CSE 101,B01,185453,Jones; Miles E,0,15,50,50
1683725151081,CSE 141,A01,185458,Eldon; John,16,0,100,84
1683725152110,CSE 141L,A01,185461,Eldon; John,8,0,100,92
1683725153135,CSE 142,A01,185463,Staff,34,0,60,26
1683725153135,CSE 142,B01,201355,Staff,0,7,60,60
1683725154161,CSE 142L,A01,185470,Staff,34,0,60,26
1683725154161,CSE 142L,B01,201417,Staff,0,6,60,60
1683725155187,CSE 190,A00,201433,Staff,32,0,49,17
1683725156220,DOC 1,A01,259136,Strom; Megan C.,7,0,15,8
1683725156220,DOC 1,A02,259137,Strom; Megan C.,15,0,15,0
1683725156220,DOC 1,A03,259138,Strom; Megan C.,14,0,15,1
1683725156220,DOC 1,A04,259139,Strom; Megan C.,13,0,15,2
1683725157249,DOC 100D,A00,259140,Pass; Natalye Joann,14,0,25,11
1683725158278,DSGN 1,A01,184749,Rill; Bryan,0,26,30,30
1683725159305,DSGN 100,A01,185168,Staff,0,2,25,25
1683725160334,ECE 5,A01,185626,Morris; Karcher William,0,12,0,0
1683725161359,ECE 101,A01,185628,Staff,14,0,70,56
1683725162385,ECE 107,A01,185635,Baghdadchi; Saharnaz,0,0,20,20
1683725162385,ECE 107,A02,185638,Baghdadchi; Saharnaz,1,0,20,19
1683725163412,ECE 148,A01,185647,Silberman; Jack,0,0,16,16
1683725164442,ECON 1,A01,185537,Crane; Meredith Helen,54,0,70,16
1683725165472,ECON 3,A01,185549,Crane; Meredith Helen,30,0,70,40
1683725166503,ECON 4,A01,203354,Anderson; John Charles,0,5,10,10
1683725167533,ECON 100A,A01,185574,Staff,0,5,40,40
1683725168558,ECON 100B,A01,185576,Staff,0,12,50,50
1683725169585,ECON 100C,A01,185589,Newhouse; Herbert S,30,0,70,40
1683725170616,ECON 105,A00,185608,Vespa; Emanuel Ignacio,19,0,35,16
1683725171646,ECON 109,A01,185610,Shishkin; Denis,9,0,35,26
1683725172675,ECON 110A,A01,185612,Staff,8,0,40,32
1683725173699,ECON 120A,A01,185615,Staff,19,0,40,21
1683725174725,ECON 120C,A01,185617,Sun; Yixiao,0,21,70,70
1683725175751,ECON 144,A00,203346,Squires; Dale E,2,0,35,33
1683725176779,ECON 171,A01,203349,Newhouse; Herbert S,0,1,35,35
1683725177806,ECON 173A,A01,185621,Toda; Alexis Akira,21,0,35,14
1683725178842,EDS 25,A01,202413,Staff,0,1,0,0
1683725178842,EDS 25,A02,202414,Staff,0,1,0,0
1683725178842,EDS 25,A03,202415,Staff,0,0,0,0
1683725178842,EDS 25,A04,202416,Staff,0,1,0,0
1683725178842,EDS 25,A05,202439,Staff,0,0,0,0
1683725178842,EDS 25,A06,202440,Staff,0,0,0,0
1683725178842,EDS 25,B01,202631,Staff,0,0,0,0
1683725178842,EDS 25,B02,202632,Staff,0,0,0,0
1683725178842,EDS 25,B03,202639,Staff,0,0,0,0
1683725178842,EDS 25,B04,202640,Staff,0,0,0,0
1683725178842,EDS 25,B05,202643,Staff,0,0,0,0
1683725178842,EDS 25,B06,202644,Staff,0,0,0,0
1683725179875,EDS 38,A01,202659,Black; Alison Michelle,25,0,25,0
1683725180927,EDS 115,A00,202652,Staff,18,0,30,12
1683725181955,EDS 125,A00,202649,Staff,13,0,30,17
1683725182986,EDS 126,A01,203332,Staff,30,0,30,0
1683725184011,EDS 139,A00,202838,Staff,16,0,25,9
1683725185040,EDS 146,A01,202655,Staff,14,0,25,11
1683725186066,ENG 15,A00,185667,Staff,0,1,0,0
1683725186066,ENG 15,B00,185672,Staff,0,0,0,0
1683725186066,ENG 15,C00,185675,Staff,0,0,0,0
1683725186066,ENG 15,D00,185682,Staff,0,0,0,0
1683725186066,ENG 15,E00,185684,Staff,0,0,0,0
1683725187091,ETHN 103,A00,185710,Staff,0,8,35,35
1683725188115,ETHN 103A,A00,199228,Man; Simeon S,0,0,9,9
1683725189140,ETHN 109,A00,185711,Staff,15,0,35,20
1683725190165,ETHN 142,A00,185726,Staff,0,4,30,30
1683725191189,ETHN 163J,A00,199229,Man; Simeon S,5,0,8,3
1683725192217,ETHN 168,A00,185727,Staff,7,0,10,3
1683725193242,ETHN 182,A00,185728,Staff,0,0,35,35
1683725194270,ETHN 183,A00,185737,Staff,10,0,18,8
1683725195295,GLBH 111,A01,209361,Burgos; Jose L.,0,0,0,0
1683725197346,HIEU 104,A00,185792,Staff,14,0,20,6
1683725198372,HIEU 115,A00,185800,Staff,0,0,20,20
1683725199402,HIEU 128,A00,185801,Staff,0,9,20,20
1683725200429,HIEU 147,A00,185802,Staff,15,0,20,5
1683725201455,HIEU 154,A00,185823,Staff,11,0,20,9
1683725202479,HILA 102,A00,185826,Staff,14,0,20,6
1683725203509,HILD 2C,A01,185778,Staff,0,13,20,20
1683725204540,HILD 7B,A01,185780,Kwak; Nancy,0,17,32,32
1683725204540,HILD 7B,A02,185781,Kwak; Nancy,0,18,32,32
1683725205566,HILD 30,A01,185791,Staff,12,0,20,8
1683725206591,HISC 119,A00,185830,Golan; Tal,0,10,20,20
1683725207616,HITO 156GS,A00,185831,Patterson; Patrick H.,0,0,0,23
1683725208644,HIUS 103,A00,185832,Man; Simeon S,0,4,20,20
1683725209672,HIUS 117,A00,185836,Kwak; Nancy,2,0,20,18
1683725210697,HIUS 125,A00,185840,Man; Simeon S,0,2,23,23
1683725211724,HIUS 149,A00,185845,Staff,1,0,20,19
1683725212757,HUM 3,A01,185882,Zavodny; Tatiana Sophia,0,8,50,50
1683725212757,HUM 3,B01,185899,Caldwell; Michael Alan,0,18,50,50
1683725213785,HUM 3GS,A00,185900,Patterson; Patrick H.,0,0,0,23
1683725214814,HUM 4,A01,185938,Zroka; Amy Liane,28,0,50,22
1683725214814,HUM 4,B01,185956,Watkins; Eric,0,6,50,50
1683725214814,HUM 4,B02,202209,Watkins; Eric,0,6,50,50
1683725214814,HUM 4,B03,202210,Watkins; Eric,0,5,50,50
1683725215840,HUM 5,A01,185958,West; Geoffrey Scott,0,0,50,50
1683725215840,HUM 5,A02,202215,West; Geoffrey Scott,0,1,50,50
1683725216867,INTL 190,A00,185959,Gagnon; Jeffrey C,0,0,0,9
1683725216867,INTL 190,B00,185960,Lettieri; Michael Joseph,0,0,0,2
1683725217897,JAPN 180,A00,254509,Staff,4,0,30,26
1683725218927,LATI 10,A01,202853,Kennemore; Amy Michelle,4,0,35,31
1683725218927,LATI 10,A02,202854,Kennemore; Amy Michelle,3,0,35,32
1683725218927,LATI 10,A03,270054,Kennemore; Amy Michelle,30,0,30,0
1683725219956,LATI 180,A00,202855,Kennemore; Amy Michelle,11,0,20,9
1683725220988,LAWS 101,A00,201767,Golan; Tal,0,7,40,40
1683725222015,LIFR 1C,A00,185961,Staff,6,0,20,14
1683725223044,LIFR 1CX,A00,185962,Staff,7,0,20,13
1683725224068,LIFR 1D,A00,185963,Staff,7,0,20,13
1683725225093,LIFR 1DX,A00,185964,Staff,7,0,20,13
1683725226121,LIGN 101,A01,186039,Staff,43,0,50,7
1683725227145,LIGN 165,A00,186040,Staff,14,0,50,36
1683725228174,LTCS 108,A00,186041,Staff,5,0,10,5
1683725229202,LTCS 119,A00,186042,Staff,15,0,20,5
1683725230232,LTCS 130,A00,186043,Wesling; Megan E.,15,0,25,10
1683725232288,LTEA 138,A00,186119,Staff,13,0,40,27
1683725233312,LTEN 124,A00,186148,Staff,5,0,25,20
1683725234338,LTEN 178,A00,186149,Staff,6,0,15,9
1683725235365,LTEN 181,A00,186150,Blanco; John D,34,0,40,6
1683725236394,LTWL 120,A00,186160,Staff,19,0,25,6
1683725237421,LTWL 165,A00,186161,Staff,22,0,25,3
1683725238448,LTWR 100,A00,186162,Staff,0,5,15,15
1683725239476,LTWR 102,A00,186163,Doller; Ben,5,0,15,10
1683725240503,MAE 8,A01,186412,Staff,0,1,0,0
1683725241529,MAE 30B,A00,186445,Bahadori; Mohammad Yousef,81,0,100,19
1683725242554,MAE 40,A00,186592,Bewley; Thomas R,10,0,50,40
1683725243583,MAE 101B,A00,186593,Bahadori; Mohammad Yousef,80,0,100,20
1683725244614,MAE 105,A00,186594,Bandaru; Prabhakar,10,0,50,40
1683725245640,MAE 107,A00,186599,Pham; Hieu Tan,0,8,120,120
1683725246728,MAE 148,A01,186660,Silberman; Jack,3,0,16,13
1683725247757,MATH 10A,A01,188095,Staff,0,6,35,35
1683725248785,MATH 10B,A01,188097,Bowers; Adam R.,0,12,30,30
1683725248785,MATH 10B,A02,188099,Bowers; Adam R.,0,11,30,30
1683725248785,MATH 10B,B01,188104,Bowers; Adam R.,0,10,30,30
1683725248785,MATH 10B,B02,188106,Bowers; Adam R.,0,9,30,30
1683725249815,MATH 10C,A01,188111,Staff,0,20,30,30
1683725249815,MATH 10C,A02,188127,Staff,0,19,30,30
1683725249815,MATH 10C,A03,188131,Staff,0,19,30,30
1683725249815,MATH 10C,B01,188218,Staff,17,0,30,13
1683725249815,MATH 10C,B02,188244,Staff,13,0,30,17
1683725249815,MATH 10C,B03,188277,Staff,14,0,30,16
1683725250840,MATH 18,A01,188344,Bach; Quang Tran,18,0,30,12
1683725250840,MATH 18,A02,188345,Bach; Quang Tran,11,0,30,19
1683725250840,MATH 18,B01,188353,Bach; Quang Tran,11,0,30,19
1683725250840,MATH 18,B02,188354,Bach; Quang Tran,19,0,30,11
1683725251865,MATH 20A,A01,188374,Staff,10,0,35,25
1683725252897,MATH 20B,A01,188382,Ohm; Ko Woon,7,0,30,23
1683725252897,MATH 20B,A02,188383,Ohm; Ko Woon,22,0,30,8
1683725252897,MATH 20B,B01,188385,Ohm; Ko Woon,7,0,30,23
1683725252897,MATH 20B,B02,188392,Ohm; Ko Woon,22,0,30,8
1683725253923,MATH 20C,A01,188394,Harel; Guershon,10,0,30,20
1683725253923,MATH 20C,A02,188395,Harel; Guershon,13,0,30,17
1683725253923,MATH 20C,B01,188404,Harel; Guershon,5,0,30,25
1683725253923,MATH 20C,B02,188405,Harel; Guershon,18,0,30,12
1683725254951,MATH 20D,A01,188414,Hammock; Frances H,0,1,30,30
1683725254951,MATH 20D,A02,188415,Hammock; Frances H,0,1,30,30
1683725254951,MATH 20D,B01,188447,Hammock; Frances H,0,1,30,30
1683725254951,MATH 20D,B02,188486,Hammock; Frances H,2,0,30,28
1683725255976,MATH 20E,A01,188649,Staff,21,0,30,9
1683725255976,MATH 20E,A02,188650,Staff,20,0,30,10
1683725255976,MATH 20E,A03,188673,Staff,0,0,30,30
1683725257002,MATH 102,A01,188675,Staff,0,40,35,35
1683725258034,MATH 103B,A01,188681,Staff,3,0,35,32
1683725258034,MATH 103B,B01,188692,Staff,5,0,35,30
1683725259065,MATH 109,A01,188695,Salehi Golsefidy; Alireza,24,0,35,11
1683725259065,MATH 109,A02,188696,Salehi Golsefidy; Alireza,24,0,35,11
1683725260095,MATH 120A,A01,188698,Eggers; John Dietrich,7,0,35,28
1683725261122,MATH 142B,A01,188736,Ioana; Adrian,0,0,30,30
1683725261122,MATH 142B,A02,188741,Ioana; Adrian,0,1,30,30
1683725261122,MATH 142B,A03,188743,Ioana; Adrian,0,3,30,30
1683725262151,MATH 168A,A01,188790,Staff,0,11,35,35
1683725263182,MATH 170A,A01,188803,Nie; Jiawang,0,2,35,35
1683725263182,MATH 170A,A02,188811,Nie; Jiawang,0,1,35,35
1683725263182,MATH 170A,A03,188814,Nie; Jiawang,1,0,35,34
1683725263182,MATH 170A,A04,188815,Nie; Jiawang,5,0,35,30
1683725264210,MATH 193B,A01,188817,Staff,0,0,35,35
1683725264210,MATH 193B,A02,188818,Staff,6,0,35,29
1683725265237,MGT 4,A01,202857,Anderson; John Charles,59,0,80,21
1683725266262,MGT 12,A00,202858,Lindenberger; Wade Douglas,40,0,90,50
1683725267290,MGT 18,A00,202859,Staff,73,0,90,17
1683725268317,MGT 18GS,A00,202860,McKay; Michael J,13,0,28,15
1683725269342,MGT 45,A00,202861,Pecore; Joseph P.,8,0,90,82
1683725270372,MGT 100,A00,202863,Yavorsky; Daniel Ryan,27,0,90,63
1683725271400,MGT 103,A00,202864,Ehrich; Kristine R,0,19,90,90
1683725272425,MGT 112,A00,202865,Ehrich; Kristine R,15,0,90,75
1683725273456,MGT 121A,A00,202868,Staff,70,0,90,20
1683725274481,MGT 131B,A00,202869,Anderson; John Charles,58,0,90,32
1683725275509,MGT 136,A00,202871,Lindenberger; Wade Douglas,83,0,90,7
1683725276542,MGT 164,A00,202873,Staff,0,67,90,91
1683725277566,MGT 164GS,A00,202874,McKay; Mary A,13,0,28,15
1683725278590,MGT 180,A00,202875,Staff,0,51,90,91
1683725279621,MMW 11R,A01,205019,Herbst; Matthew,0,0,30,30
1683725279621,MMW 11R,A02,205026,Herbst; Matthew,29,0,30,1
1683725280652,MMW 15,A01,193512,Chang; Edmond Yi-Teh,0,8,28,28
1683725280652,MMW 15,A02,193513,Chang; Edmond Yi-Teh,0,5,28,28
1683725280652,MMW 15,A03,193514,Chang; Edmond Yi-Teh,0,5,28,28
1683725280652,MMW 15,A04,193515,Chang; Edmond Yi-Teh,0,5,28,28
1683725280652,MMW 15,A05,193516,Chang; Edmond Yi-Teh,0,5,28,28
1683725280652,MMW 15,A06,193517,Chang; Edmond Yi-Teh,0,6,28,28
1683725280652,MMW 15,B01,193519,Chang; Edmond Yi-Teh,0,5,28,28
1683725280652,MMW 15,B02,193520,Chang; Edmond Yi-Teh,0,5,28,28
1683725280652,MMW 15,B03,193521,Chang; Edmond Yi-Teh,0,5,28,28
1683725280652,MMW 15,B04,193522,Chang; Edmond Yi-Teh,0,6,28,28
1683725280652,MMW 15,B05,193523,Chang; Edmond Yi-Teh,0,5,28,28
1683725280652,MMW 15,B06,193524,Chang; Edmond Yi-Teh,0,5,28,28
1683725281678,MMW 122,A01,193526,Rahimi; Babak,0,16,28,28
1683725281678,MMW 122,A02,193527,Rahimi; Babak,0,15,28,28
1683725281678,MMW 122,A03,193528,Rahimi; Babak,0,0,0,0
1683725281678,MMW 122,A04,193529,Rahimi; Babak,0,0,0,0
1683725282708,MUS 1A,A01,186663,Staff,0,18,35,35
1683725283734,MUS 4,A01,186715,Staff,0,12,35,35
1683725284759,MUS 5R,A01,186796,Dubnov; Shlomo,0,17,35,35
1683725285784,MUS 6,A01,186798,Staff,0,4,25,25
1683725286809,MUS 7,A01,186830,Staff,11,0,35,24
1683725287835,MUS 8,A01,186930,Staff,0,27,35,35
1683725288861,MUS 15,A01,186932,Staff,0,15,35,35
1683725288861,MUS 15,B01,186934,Staff,0,16,35,35
1683725289887,MUS 80,A00,186935,Staff,0,0,20,20
1683725289887,MUS 80,B00,186936,Staff,24,0,25,1
1683725290914,NANO 11,A00,204702,Lipomi; Darren John,0,0,0,0
1683725291947,NANO 15,A01,204709,Yang; Kesong,0,1,0,0
1683725292977,NANO 114,A00,202069,Jahed Motlagh; Zeinab,2,0,10,8
1683725294003,PHIL 1,A00,186955,Grush; Rick Scott,31,0,40,9
1683725295032,PHIL 10,A01,186973,Grush; Rick Scott,27,0,35,8
1683725295032,PHIL 10,A02,186974,Grush; Rick Scott,33,0,35,2
1683725296060,PHIL 13,A01,186976,Staff,1,0,35,34
1683725296060,PHIL 13,A02,186977,Staff,16,0,35,19
1683725297084,PHIL 14,A01,186979,Staff,30,0,35,5
1683725297084,PHIL 14,A02,186986,Staff,32,0,35,3
1683725298110,PHIL 28,A01,186988,Staff,16,0,30,14
1683725298110,PHIL 28,A02,186989,Staff,0,0,30,30
1683725298110,PHIL 28,A03,186990,Staff,10,0,30,20
1683725298110,PHIL 28,A04,186991,Staff,26,0,30,4
1683725299134,PHIL 120,A00,186997,Staff,23,0,40,17
1683725300160,PHIL 137,A00,187003,Staff,8,0,40,32
1683725301185,PHIL 150,A00,187015,Staff,47,0,70,23
1683725302214,PHIL 167,A00,187021,Lamey; Andy M.,34,0,40,6
1683725303237,PHIL 174,A01,202226,Staff,17,0,20,3
1683725303237,PHIL 174,A02,202235,Staff,20,0,20,0
1683725304265,PHIL 191A,A00,258918,Staff,0,0,1,1
1683725305290,PHYS 1A,A00,187028,Staff,26,0,60,34
1683725306316,PHYS 1AL,001,187036,Staff,3,0,30,27
1683725306316,PHYS 1AL,002,187049,Staff,18,0,30,12
1683725307341,PHYS 1B,A00,187058,Staff,21,0,60,39
1683725308367,PHYS 1BL,001,187064,Staff,0,1,30,30
1683725308367,PHYS 1BL,002,187070,Staff,4,0,30,26
1683725309396,PHYS 1C,A00,187082,Staff,30,0,120,90
1683725310424,PHYS 1CL,001,187088,Staff,0,9,30,30
1683725310424,PHYS 1CL,002,187089,Staff,0,1,30,30
1683725310424,PHYS 1CL,009,262693,Staff,9,0,30,21
1683725311450,PHYS 2B,A01,187097,Staff,55,0,115,60
1683725312474,PHYS 2C,A01,187099,Staff,63,0,115,52
1683725313498,PHYS 2CL,A01,187101,Staff,5,0,28,23
1683725313498,PHYS 2CL,A02,187102,Staff,15,0,28,13
1683725314523,PHYS 2D,A01,187123,Shotwell; Brian,95,0,115,20
1683725315549,PHYS 4B,A01,187133,Grinstein; Benjamin,35,0,50,15
1683725316574,POLI 10,A00,188819,Staff,0,4,50,50
1683725317599,POLI 11,A00,188827,Staff,43,0,50,7
1683725318625,POLI 13R,A00,188828,Staff,0,2,20,20
1683725319653,POLI 27,A01,188830,Elgin; Samuel Zincke,0,2,70,70
1683725320679,POLI 30,A00,188832,Desposato; Scott,30,0,50,20
1683725321707,POLI 102F,A00,188834,Staff,1,0,40,39
1683725322737,POLI 104A,A00,188852,Staff,12,0,30,18
1683725323766,POLI 104I,A00,188853,Staff,0,8,20,20
1683725324791,POLI 110B,A00,188854,Wiens; David,6,0,20,14
1683725325816,POLI 112A,A00,188855,Wiens; David,3,0,30,27
1683725326845,POLI 117R,A00,188856,Forman; Fonna,0,12,20,20
1683725327872,POLI 118,A00,188857,Ingham; Sean,8,0,20,12
1683725328900,POLI 120G,A00,188858,Staff,7,0,30,23
1683725329927,POLI 131CR,A00,188863,Hoston; Germaine,20,0,50,30
1683725330953,POLI 133,A00,188864,Nellis; Gareth Hb,44,0,50,6
1683725331984,POLI 134D,A00,188865,Desposato; Scott,27,0,30,3
1683725333008,POLI 142A,A00,188871,Gartzke; Erik,21,0,50,29
1683725334036,POLI 142K,A00,188874,Staff,38,0,50,12
1683725335059,POLI 143,A00,188940,Gartzke; Erik,15,0,30,15
1683725336084,POLI 153,A00,188943,Staff,1,0,20,19
1683725337109,POLI 160AA,A00,188944,Staff,10,0,40,30
1683725338137,POLI 170A,A00,188945,Staff,10,0,30,20
1683725340189,PSYC 1,A00,188952,Staff,36,0,90,54
1683725341278,PSYC 2,B00,188953,Staff,19,0,35,16
1683725342303,PSYC 6,A00,188970,Staff,47,0,60,13
1683725343331,PSYC 7,A00,188973,Staff,35,0,45,10
1683725344363,PSYC 60,A01,188980,Rickard; Timothy C.,42,0,60,18
1683725345389,PSYC 70,A01,189001,Steiner; Eric Tomas,22,0,45,23
1683725346416,PSYC 100,A00,189005,Lacefield; Katharine I,1,98,120,119
1683725347441,PSYC 102,A00,189008,Staff,6,0,30,24
1683725348466,PSYC 106,B00,189026,Gorman; Michael R.,27,0,60,33
1683725349489,PSYC 114,B01,189033,Winkielman; Piotr,0,31,30,30
1683725350574,PSYC 131,A00,189036,Anagnostaras; Stephan,0,44,60,60
1683725351600,PSYC 136,A00,189041,Lowe; Angela Beth,0,7,25,25
1683725352627,PSYC 137,A00,189057,Winkielman; Piotr,0,36,25,25
1683725353651,PSYC 144,A00,189107,Wixted; John T,0,11,50,50
1683725355700,PSYC 162,A00,189142,Staff,0,9,85,85
1683725356727,PSYC 172,A00,189144,Gorman; Michael R.,0,6,30,30
1683725358783,PSYC 179,A00,189146,Lacefield; Katharine I,0,88,120,120
1683725359813,PSYC 181,A00,189147,Anagnostaras; Stephan,0,45,90,90
1683725360842,PSYC 190R,A00,189148,Barner; David A.,0,23,80,80
1683725361868,PSYC 191,A00,189275,Rickard; Timothy C.,0,11,25,25
1683725362892,PSYC 193,A00,189276,Chapman; Eddie Nathaniel,0,1,0,4
1683725363921,PSYC 193L,A01,189281,Lowe; Angela Beth,8,0,20,12
1683725363921,PSYC 193L,B01,189285,Staff,28,0,35,7
1683725364951,RELI 149,A00,187137,Rahimi; Babak,6,0,40,34
1683725365982,SE 9,A01,187315,Staff,0,2,18,18
1683725367007,SE 101B,A00,187409,Staff,24,0,30,6
1683725368038,SE 110B,A00,187444,Staff,10,0,40,30
1683725369066,SE 130B,A00,187449,Staff,31,0,40,9
1683725370096,SE 150A,A00,187516,Staff,8,0,20,12
1683725371127,SE 154,A00,187528,Staff,29,0,50,21
1683725372157,SIO 3,A01,258171,Staff,35,0,40,5
1683725373188,SIO 10,A00,187144,Cook; Geoffrey W,0,6,75,75
1683725374213,SIO 45,A00,187152,Cook; Geoffrey W,1,7,100,99
1683725375240,SIO 109R,A00,194486,Staff,0,4,20,20
1683725377292,SIO 187,A01,187233,Kacev; David,12,0,40,28
1683725378319,SOCI 1,A01,258656,Thorpe; Charles Robert,28,0,30,2
1683725378319,SOCI 1,A02,258658,Thorpe; Charles Robert,30,0,30,0
1683725378319,SOCI 1,A03,258661,Thorpe; Charles Robert,25,0,25,0
1683725378319,SOCI 1,A04,258666,Thorpe; Charles Robert,22,0,25,3
1683725378319,SOCI 1,A05,258897,Thorpe; Charles Robert,22,0,25,3
1683725378319,SOCI 1,A06,258898,Thorpe; Charles Robert,25,0,25,0
1683725379350,SOCI 30,A01,258903,Pardo Guerra; Juan Pablo,14,0,30,16
1683725380375,SOCI 102,A00,258904,Staff,9,0,25,16
1683725381400,SOCI 106,A00,258905,Staff,19,0,25,6
1683725382425,SOCI 111,A00,258907,Ribas Norris; Janet Vanesa,26,0,30,4
1683725383453,SOCI 121R,A00,258908,Pardo Guerra; Juan Pablo,7,0,30,23
1683725384477,SOCI 126,A01,203330,Staff,14,0,20,6
1683725385505,SOCI 131,A00,258909,Thorpe; Charles Robert,30,0,60,30
1683725386531,SOCI 135,A00,258910,Payne; Christine Anna,0,13,30,30
1683725387558,SOCI 157,A00,258911,Staff,10,0,30,20
1683725388583,SOCI 184,A00,258912,Staff,25,0,30,5
1683725389607,SOCI 188D,A00,258913,Staff,22,0,30,8
1683725390638,SYN 2,001,187529,Staff,9,0,16,7
1683725390638,SYN 2,002,201452,Staff,0,20,16,16
1683725390638,SYN 2,003,201469,Staff,1,0,16,15
1683725391663,SYN 100,A01,187531,Staff,0,9,20,20
1683725391663,SYN 100,B01,201491,Staff,0,10,20,20
1683725392689,TDAC 1,A00,189286,Walsh; Kim C.,3,0,20,17
1683725392689,TDAC 1,B00,189287,Harting; Carla Kelso,10,0,20,10
1683725393712,TDAC 101,A00,189300,Walsh; Kim C.,16,0,20,4
1683725393712,TDAC 101,B00,189301,Harting; Carla Kelso,18,0,20,2
1683725394740,TDAC 102,A00,189304,Basso; Beatrice,14,0,20,6
1683725395768,TDAC 108,A00,189305,Staff,18,0,20,2
1683725396791,TDDE 131,A00,189310,Staff,19,0,20,1
1683725396791,TDDE 131,B00,189314,Staff,19,0,20,1
1683725396791,TDDE 131,C00,189315,Staff,48,0,50,2
1683725396791,TDDE 131,D00,189316,Staff,14,0,15,1
1683725396791,TDDE 131,E00,204841,Staff,20,0,20,0
1683725397815,TDGE 10,A00,189289,Staff,26,0,50,24
1683725397815,TDGE 10,B00,189290,Havis; Allan,0,1,50,50
1683725398842,TDGE 11,A00,189291,Fulton; Julia,0,4,50,50
1683725398842,TDGE 11,B00,189292,Staff,20,0,25,5
1683725398842,TDGE 11,C00,260270,Staff,0,0,0,0
1683725399867,TDGE 25,A00,189294,Staff,1,0,20,19
1683725400892,TDGE 124,A00,189318,Fulton; Julia,0,7,50,50
1683725401917,TDGE 125,A00,189319,Staff,13,0,25,12
1683725401917,TDGE 125,B00,189320,Staff,23,0,25,2
1683725402942,TDGE 127,A00,189322,Havis; Allan,1,0,50,49
1683725403967,TDHT 101,A00,189323,Staff,18,0,25,7
1683725403967,TDHT 101,B00,189324,Staff,25,0,25,0
1683725404996,TDHT 102,A00,189325,Staff,49,0,50,1
1683725406021,TDMV 1,A00,189295,Arcidiacono; Kristin,20,0,30,10
1683725406021,TDMV 1,B00,189296,Caligagan; Maria T.,23,0,30,7
1683725407049,TDMV 2,A00,189297,Sammartano; Tonnie,27,0,30,3
1683725407049,TDMV 2,B00,189299,Arcidiacono; Kristin,23,0,30,7
1683725408077,TDMV 3,A00,204998,Rincon; Alicia,22,0,30,8
1683725409102,TDMV 120,A00,189458,Sammartano; Tonnie,28,0,30,2
1683725410130,TDMV 138,A00,189541,Jun; Grace Shin Hae,20,0,40,20
1683725411154,TDMV 142,A00,189717,Caligagan; Tony,25,0,30,5
1683725411154,TDMV 142,B00,189718,Caligagan; Maria T.,25,0,30,5
1683725412180,TMC 2,A01,187533,Staff,25,0,25,0
1683725412180,TMC 2,A02,187534,Staff,25,0,25,0
1683725413204,USP 1,A01,187536,Kwak; Nancy,0,16,25,25
1683725414229,USP 5,A01,187538,Staff,8,0,25,17
1683725415258,USP 101,A00,199253,Staff,0,4,0,0
1683725416286,USP 124,A00,187562,Boomhower; Matthew Charles,0,0,30,30
1683725417314,USP 138,A00,187582,Staff,19,0,25,6
1683725418340,USP 152,A01,187597,Staff,3,0,25,22
1683725419365,USP 153,A00,187598,Staff,18,0,25,7
1683725420394,USP 168,A00,187607,Kwak; Nancy,2,0,5,3
1683725421418,USP 173,A00,187619,Staff,4,0,25,21
1683725422442,USP 181,A00,187638,Staff,0,4,25,25
1683725423472,VIS 103,A00,187650,Cruz; Edwin Teddy,17,0,75,58
1683725424498,VIS 110D,A00,187669,Staff,13,0,22,9
1683725425527,VIS 127C,A00,187720,Shen; Kuiyi,67,0,146,79
1683725426557,VIS 149,A00,187731,Yoldas; Pinar,0,12,22,22
1683725427585,VIS 151,A01,188091,Staff,22,0,34,12
1683725427585,VIS 151,A02,188092,Staff,11,0,34,23
1683725428613,VIS 160B,A00,188093,Stalbaum; Brett,0,1,10,10
1683725430662,WCWP 10B,A00,201720,Staff,0,0,5,5
1683725430662,WCWP 10B,B00,201722,Staff,0,0,6,6
1683725431688,WCWP 100,A00,201725,Gagnon; Jeffrey C,0,0,2,2
1683725431688,WCWP 100,B00,201727,Staff,0,4,15,15
1683725434824,ANBI 133,A00,258401,Wilder; Linnea Lorene,34,0,40,6
1683725435849,ANBI 140,A00,258395,Hrvoj Mihic; Branka,18,0,25,7
1683725436879,ANSC 120,A00,258402,Bialecki; Jon Anthony,26,0,40,14
1683725437908,ANSC 144,A00,258400,Staff,12,0,40,28
1683725439959,ANSC 166,A00,258396,Parish; Steven Martin,156,0,175,19
1683725440986,ANSC 180,A00,193533,Staff,8,0,20,12
1683725442014,ANSC 188,A00,258397,Jassal; Aftab,34,0,40,6
1683725443038,ANTH 3,A01,258316,Staff,23,0,30,7
1683725444063,ANTH 5,A00,258394,Semendeferi; Ekaterini,16,0,20,4
1683725445088,ANTH 21,A01,258331,Staff,4,0,40,36
1683725446113,ANTH 103,A00,258398,Varma; Saiba,15,0,25,10
1683725447142,AWP 10,001,202034,Staff,0,0,0,0
1683725447142,AWP 10,002,202035,Staff,0,0,0,0
1683725447142,AWP 10,003,202036,Staff,0,0,0,0
1683725447142,AWP 10,004,202037,Staff,0,0,0,0
1683725447142,AWP 10,005,202038,Staff,0,0,0,0
1683725447142,AWP 10,006,202039,Staff,0,0,0,0
1683725447142,AWP 10,007,202040,Staff,0,0,0,0
1683725447142,AWP 10,008,202041,Staff,0,0,0,0
1683725447142,AWP 10,009,202042,Staff,0,0,0,0
1683725447142,AWP 10,010,202043,Staff,0,0,0,0
1683725447142,AWP 10,011,202044,Staff,0,0,0,0
1683725447142,AWP 10,012,202045,Staff,0,0,0,0
1683725447142,AWP 10,013,202046,Staff,0,0,0,0
1683725447142,AWP 10,014,202047,Staff,0,0,0,0
1683725447142,AWP 10,015,202048,Staff,0,0,0,0
1683725447142,AWP 10,016,202049,Staff,0,0,0,0
1683725447142,AWP 10,017,202050,Staff,0,0,0,0
1683725447142,AWP 10,018,202051,Staff,0,0,0,0
1683725447142,AWP 10,019,202052,Staff,0,0,0,0
1683725447142,AWP 10,020,202053,Staff,0,0,0,0
1683725447142,AWP 10,021,202054,Staff,0,0,0,0
1683725447142,AWP 10,022,202055,Staff,0,0,0,0
1683725447142,AWP 10,023,202056,Staff,0,0,0,0
1683725447142,AWP 10,024,202057,Staff,0,0,0,0
1683725447142,AWP 10,025,202058,Staff,0,0,0,0
1683725447142,AWP 10,026,202059,Staff,0,0,0,0
1683725448168,AWP 102,001,202032,Staff,0,0,0,0
1683725448168,AWP 102,002,202033,Staff,0,0,0,0
1683725449195,BENG 100,A01,254234,Taylor Amos; Alyssa C,31,0,40,9
1683725450222,BENG 196,001,270013,Engler; Adam J.,9999,0,9999,0
1683725451255,BICD 100R,A01,202018,Smith; Laurie,0,7,32,32
1683725451255,BICD 100R,A02,202019,Smith; Laurie,0,3,32,32
1683725451255,BICD 100R,A03,202020,Smith; Laurie,0,1,32,32
1683725451255,BICD 100R,A04,202021,Smith; Laurie,6,0,32,26
1683725451255,BICD 100R,A05,202022,Smith; Laurie,10,0,32,22
1683725452284,BICD 136,A01,193242,Gustafson-Brown; Cindy,0,2,32,32
1683725452284,BICD 136,A02,193244,Gustafson-Brown; Cindy,13,0,32,19
1683725453318,BIEB 102,A01,193249,Butler; Shannon Rhey,0,0,32,32
1683725453318,BIEB 102,A02,193251,Butler; Shannon Rhey,0,0,32,32
1683725453318,BIEB 102,A03,193253,Butler; Shannon Rhey,0,0,32,32
1683725453318,BIEB 102,A04,193255,Butler; Shannon Rhey,13,0,32,19
1683725453318,BIEB 102,A05,193265,Butler; Shannon Rhey,25,0,32,7
1683725453318,BIEB 102,A06,193269,Butler; Shannon Rhey,12,0,32,20
1683725455430,BIEB 150,A01,193274,Staff,0,0,32,32
1683725455430,BIEB 150,A02,193285,Staff,24,0,32,8
1683725456456,BIEB 194,A00,193286,Kurle; Carolyn M.,19,0,32,13
1683725457483,BILD 1,A01,192291,Staff,15,0,32,17
1683725457483,BILD 1,A02,192292,Staff,30,0,32,2
1683725457483,BILD 1,B01,192520,Reuther; Keefe,0,1,0,0
1683725457483,BILD 1,B02,192532,Reuther; Keefe,0,1,0,0
1683725458510,BILD 3,A01,192556,Butler; Shannon Rhey,0,0,32,32
1683725458510,BILD 3,A02,192581,Butler; Shannon Rhey,0,1,32,32
1683725458510,BILD 3,A03,192611,Butler; Shannon Rhey,19,0,32,13
1683725458510,BILD 3,A04,192612,Butler; Shannon Rhey,23,0,32,9
1683725458510,BILD 3,A05,192613,Butler; Shannon Rhey,26,0,32,6
1683725458510,BILD 3,A06,192679,Butler; Shannon Rhey,27,0,32,5
1683725458510,BILD 3,A07,192682,Butler; Shannon Rhey,20,0,32,12
1683725459542,BILD 4,A01,192836,Reuther; Keefe,1,0,24,23
1683725459542,BILD 4,A02,193044,Reuther; Keefe,4,0,24,20
1683725460572,BILD 10,A01,193142,Gustafson-Brown; Cindy,29,0,32,3
1683725460572,BILD 10,A02,193149,Gustafson-Brown; Cindy,31,0,32,1
1683725461607,BIMM 100,A01,193301,Staff,0,6,32,32
1683725461607,BIMM 100,A02,193312,Staff,0,7,32,32
1683725461607,BIMM 100,A03,193323,Staff,0,10,32,32
1683725462640,BIMM 101,A01,193329,McDonnell; Lisa Marie,0,3,24,24
1683725462640,BIMM 101,A02,193339,McDonnell; Lisa Marie,0,3,24,24
1683725462640,BIMM 101,B01,193354,McDonnell; Lisa Marie,0,4,24,24
1683725462640,BIMM 101,B02,193357,McDonnell; Lisa Marie,0,3,24,24
1683725463671,BIMM 110,A01,193377,Tat; John,0,11,32,32
1683725463671,BIMM 110,A02,193378,Tat; John,0,11,32,32
1683725464698,BIMM 120,A01,206116,Staff,0,0,32,32
1683725464698,BIMM 120,A02,206117,Staff,7,0,32,25
1683725464698,BIMM 120,A03,206121,Staff,21,0,32,11
1683725465731,BIPN 100,A01,193393,Park; Ji Young,0,15,32,32
1683725465731,BIPN 100,A02,193402,Park; Ji Young,0,14,32,32
1683725465731,BIPN 100,A03,193413,Park; Ji Young,0,14,32,32
1683725465731,BIPN 100,A04,193414,Park; Ji Young,0,13,32,32
1683725466757,BIPN 102,A01,193429,Staff,0,0,32,32
1683725466757,BIPN 102,A02,193438,Staff,18,0,32,14
1683725467783,BIPN 106,A01,193450,Reyes Gonzalez; Catalina,0,2,40,40
1683725468814,BIPN 134,A01,193465,Cooke; James Edward,0,0,32,32
1683725468814,BIPN 134,A02,193474,Cooke; James Edward,25,0,32,7
1683725468814,BIPN 134,A03,193485,Cooke; James Edward,29,0,32,3
1683725468814,BIPN 134,A04,193486,Cooke; James Edward,20,0,32,12
1683725468814,BIPN 134,A05,193491,Cooke; James Edward,31,0,32,1
1683725468814,BIPN 134,A06,193501,Cooke; James Edward,30,0,32,2
1683725468814,BIPN 134,A07,193510,Cooke; James Edward,29,0,32,3
1683725470871,BISP 194,A00,222522,Staff,14,0,32,18
1683725471896,CAT 124,A01,202407,Staff,19,0,25,6
1683725472926,CAT 125,A00,202408,Marchisotto; Jennifer Anne,2,0,20,18
1683725473954,CAT 125R,A00,202409,Smith; Lauryn Alissa,0,11,20,20
1683725473954,CAT 125R,B00,202410,Morales; Celeste Georgianna,0,11,20,20
1683725473954,CAT 125R,C00,202411,Irwin; Matthew Joseph,0,12,20,20
1683725474979,CENG 15,A01,204712,Yang; Kesong,0,1,0,0
1683725476003,CENG 114,A00,202070,Jahed Motlagh; Zeinab,5,0,20,15
1683725477028,CGS 105,A00,185477,Wesling; Megan E.,24,0,40,16
1683725478053,CGS 106,A00,185494,Staff,11,0,22,11
1683725479078,CGS 108,A00,185495,Staff,14,0,20,6
1683725480106,CGS 114,A00,185496,Staff,13,0,18,5
1683725481133,CGS 119,A00,185501,Staff,15,0,20,5
1683725482161,CGS 120,A00,185511,Staff,11,0,20,9
1683725483192,CHEM 4,A01,184675,Bussey; Thomas J,97,0,100,3
1683725484220,CHEM 6A,A01,184677,Staff,32,0,60,28
1683725485245,CHEM 6B,A01,184679,Staff,63,0,100,37
1683725486270,CHEM 6C,A01,184681,Bussey; Thomas J,0,0,50,50
1683725486270,CHEM 6C,A02,184682,Bussey; Thomas J,32,0,50,18
1683725487296,CHEM 40A,A01,184684,Albizati; Kim F.,33,0,100,67
1683725488320,CHEM 40B,A01,184686,Albizati; Kim F.,0,22,100,100
1683725489357,CHEM 41B,A01,184690,Staff,51,0,100,49
1683725490383,COGS 3,A01,184715,Boyle; Mary E. T.,0,27,40,40
1683725491409,COGS 14B,A01,185172,Staff,0,14,38,38
1683725492438,COGS 18,A01,184736,Staff,14,0,80,66
1683725493468,COGS 100,A01,184932,Staff,0,8,73,73
1683725494495,COGS 101A,A01,184935,Staff,0,40,30,30
1683725495520,COGS 101B,A01,184944,Staff,0,2,30,30
1683725496544,COGS 101C,A01,184946,Staff,0,10,30,30
1683725497569,COGS 102A,A01,184951,Johnson; Christine M.,1,0,40,39
1683725498600,COGS 107B,A01,184953,Mooshagian; Eric Frederick,0,52,40,40
1683725499625,COGS 118B,A01,184959,Gupta; Anjum,0,50,40,40
1683725500654,COGS 153,A00,184961,Staff,1,16,30,29
1683725501680,COGS 177,A00,184962,Staff,0,20,30,30
1683725502708,COGS 187A,A01,184969,Boyle; Mary E. T.,0,19,40,40
1683725503738,COMM 10,A01,185174,Staff,0,5,25,25
1683725503738,COMM 10,A02,185189,Staff,0,2,25,25
1683725503738,COMM 10,A03,269821,Staff,0,1,0,0
1683725504768,COMM 100B,A02,185476,Staff,10,0,25,15
1683725504768,COMM 100B,A03,277340,Staff,25,0,25,0
1683725505794,COMM 100C,A01,185314,Staff,2,0,25,23
1683725505794,COMM 100C,A02,185327,Staff,17,0,25,8
1683725506819,COMM 110M,A00,185349,Staff,0,0,40,40
1683725507853,COMM 113T,A00,185352,Staff,25,0,40,15
1683725508878,COMM 114I,A00,185353,Staff,31,0,40,9
1683725509910,COMM 131,A00,185354,Staff,17,0,30,13
1683725510938,CSE 8A,A50,185358,Cao; Yingjun,0,46,10,10
1683725511962,CSE 8B,A01,185362,Staff,0,48,50,50
1683725512991,CSE 11,A01,185416,Cao; Yingjun,0,91,10,10
1683725514023,CSE 20,A01,185445,Briones; Jor-el Thomas Caparas,3,0,25,22
1683725515049,CSE 21,A01,185447,Staff,9,0,50,41
1683725516075,CSE 101,A01,185451,Staff,0,13,50,50
1683725516075,CSE 101,B01,185453,Jones; Miles E,0,15,50,50
1683725518127,CSE 141,A01,185458,Eldon; John,16,0,100,84
1683725519152,CSE 141L,A01,185461,Eldon; John,8,0,100,92
1683725520184,CSE 142,A01,185463,Staff,34,0,60,26
1683725520184,CSE 142,B01,201355,Staff,0,7,60,60
1683725521211,CSE 142L,A01,185470,Staff,34,0,60,26
1683725521211,CSE 142L,B01,201417,Staff,0,6,60,60
1683725522236,CSE 190,A00,201433,Staff,32,0,49,17
1683725523267,DOC 1,A01,259136,Strom; Megan C.,7,0,15,8
1683725523267,DOC 1,A02,259137,Strom; Megan C.,15,0,15,0
1683725523267,DOC 1,A03,259138,Strom; Megan C.,14,0,15,1
1683725523267,DOC 1,A04,259139,Strom; Megan C.,13,0,15,2
1683725524296,DOC 100D,A00,259140,Pass; Natalye Joann,14,0,25,11
1683725525320,DSGN 1,A01,184749,Rill; Bryan,0,26,30,30
1683725526344,DSGN 100,A01,185168,Staff,0,2,25,25
1683725527369,ECE 5,A01,185626,Morris; Karcher William,0,12,0,0
1683725528397,ECE 101,A01,185628,Staff,14,0,70,56
1683725529423,ECE 107,A01,185635,Baghdadchi; Saharnaz,0,0,20,20
1683725529423,ECE 107,A02,185638,Baghdadchi; Saharnaz,1,0,20,19
1683725530452,ECE 148,A01,185647,Silberman; Jack,0,0,16,16
1683725531478,ECON 1,A01,185537,Crane; Meredith Helen,54,0,70,16
1683725532508,ECON 3,A01,185549,Crane; Meredith Helen,30,0,70,40
1683725533534,ECON 4,A01,203354,Anderson; John Charles,0,5,10,10
1683725534560,ECON 100A,A01,185574,Staff,0,5,40,40
1683725535589,ECON 100B,A01,185576,Staff,0,12,50,50
1683725536612,ECON 100C,A01,185589,Newhouse; Herbert S,30,0,70,40
1683725537637,ECON 105,A00,185608,Vespa; Emanuel Ignacio,19,0,35,16
1683725538662,ECON 109,A01,185610,Shishkin; Denis,9,0,35,26
1683725539691,ECON 110A,A01,185612,Staff,8,0,40,32
1683725540719,ECON 120A,A01,185615,Staff,19,0,40,21
1683725541750,ECON 120C,A01,185617,Sun; Yixiao,0,21,70,70
1683725542782,ECON 144,A00,203346,Squires; Dale E,2,0,35,33
1683725543808,ECON 171,A01,203349,Newhouse; Herbert S,0,1,35,35
1683725544836,ECON 173A,A01,185621,Toda; Alexis Akira,21,0,35,14
1683725545872,EDS 25,A01,202413,Staff,0,1,0,0
1683725545872,EDS 25,A02,202414,Staff,0,1,0,0
1683725545872,EDS 25,A03,202415,Staff,0,0,0,0
1683725545872,EDS 25,A04,202416,Staff,0,1,0,0
1683725545872,EDS 25,A05,202439,Staff,0,0,0,0
1683725545872,EDS 25,A06,202440,Staff,0,0,0,0
1683725545872,EDS 25,B01,202631,Staff,0,0,0,0
1683725545872,EDS 25,B02,202632,Staff,0,0,0,0
1683725545872,EDS 25,B03,202639,Staff,0,0,0,0
1683725545872,EDS 25,B04,202640,Staff,0,0,0,0
1683725545872,EDS 25,B05,202643,Staff,0,0,0,0
1683725545872,EDS 25,B06,202644,Staff,0,0,0,0
1683725546902,EDS 38,A01,202659,Black; Alison Michelle,25,0,25,0
1683725547930,EDS 115,A00,202652,Staff,18,0,30,12
1683725548954,EDS 125,A00,202649,Staff,13,0,30,17
1683725549980,EDS 126,A01,203332,Staff,30,0,30,0
1683725551007,EDS 139,A00,202838,Staff,16,0,25,9
1683725552037,EDS 146,A01,202655,Staff,14,0,25,11
1683725553067,ENG 15,A00,185667,Staff,0,1,0,0
1683725553067,ENG 15,B00,185672,Staff,0,0,0,0
1683725553067,ENG 15,C00,185675,Staff,0,0,0,0
1683725553067,ENG 15,D00,185682,Staff,0,0,0,0
1683725553067,ENG 15,E00,185684,Staff,0,0,0,0
1683725554090,ETHN 103,A00,185710,Staff,0,8,35,35
1683725555115,ETHN 103A,A00,199228,Man; Simeon S,0,0,9,9
1683725556144,ETHN 109,A00,185711,Staff,15,0,35,20
1683725557171,ETHN 142,A00,185726,Staff,0,4,30,30
1683725558255,ETHN 163J,A00,199229,Man; Simeon S,5,0,8,3
1683725559280,ETHN 168,A00,185727,Staff,7,0,10,3
1683725560305,ETHN 182,A00,185728,Staff,0,0,35,35
1683725561336,ETHN 183,A00,185737,Staff,10,0,18,8
1683725562360,GLBH 111,A01,209361,Burgos; Jose L.,0,0,0,0
1683725564411,HIEU 104,A00,185792,Staff,14,0,20,6
1683725565435,HIEU 115,A00,185800,Staff,0,0,20,20
1683725566464,HIEU 128,A00,185801,Staff,0,9,20,20
1683725567492,HIEU 147,A00,185802,Staff,15,0,20,5
1683725568521,HIEU 154,A00,185823,Staff,11,0,20,9
1683725569549,HILA 102,A00,185826,Staff,14,0,20,6
1683725570577,HILD 2C,A01,185778,Staff,0,13,20,20
1683725571603,HILD 7B,A01,185780,Kwak; Nancy,0,17,32,32
1683725571603,HILD 7B,A02,185781,Kwak; Nancy,0,18,32,32
1683725572629,HILD 30,A01,185791,Staff,12,0,20,8
1683725573659,HISC 119,A00,185830,Golan; Tal,0,10,20,20
1683725574683,HITO 156GS,A00,185831,Patterson; Patrick H.,0,0,0,23
1683725575712,HIUS 103,A00,185832,Man; Simeon S,0,4,20,20
1683725576736,HIUS 117,A00,185836,Kwak; Nancy,2,0,20,18
1683725577760,HIUS 125,A00,185840,Man; Simeon S,0,2,23,23
1683725578788,HIUS 149,A00,185845,Staff,1,0,20,19
1683725579814,HUM 3,A01,185882,Zavodny; Tatiana Sophia,0,8,50,50
1683725579814,HUM 3,B01,185899,Caldwell; Michael Alan,0,18,50,50
1683725580840,HUM 3GS,A00,185900,Patterson; Patrick H.,0,0,0,23
1683725581868,HUM 4,A01,185938,Zroka; Amy Liane,28,0,50,22
1683725581868,HUM 4,B01,185956,Watkins; Eric,0,6,50,50
1683725581868,HUM 4,B02,202209,Watkins; Eric,0,6,50,50
1683725581868,HUM 4,B03,202210,Watkins; Eric,0,5,50,50
1683725582897,HUM 5,A01,185958,West; Geoffrey Scott,0,0,50,50
1683725582897,HUM 5,A02,202215,West; Geoffrey Scott,0,1,50,50
1683725583924,INTL 190,A00,185959,Gagnon; Jeffrey C,0,0,0,9
1683725583924,INTL 190,B00,185960,Lettieri; Michael Joseph,0,0,0,2
1683725584951,JAPN 180,A00,254509,Staff,4,0,30,26
1683725585981,LATI 10,A01,202853,Kennemore; Amy Michelle,4,0,35,31
1683725585981,LATI 10,A02,202854,Kennemore; Amy Michelle,3,0,35,32
1683725585981,LATI 10,A03,270054,Kennemore; Amy Michelle,30,0,30,0
1683725587008,LATI 180,A00,202855,Kennemore; Amy Michelle,11,0,20,9
1683725588034,LAWS 101,A00,201767,Golan; Tal,0,7,40,40
1683725589062,LIFR 1C,A00,185961,Staff,6,0,20,14
1683725590091,LIFR 1CX,A00,185962,Staff,7,0,20,13
1683725591119,LIFR 1D,A00,185963,Staff,7,0,20,13
1683725592144,LIFR 1DX,A00,185964,Staff,7,0,20,13
1683725593168,LIGN 101,A01,186039,Staff,43,0,50,7
1683725594195,LIGN 165,A00,186040,Staff,14,0,50,36
1683725595219,LTCS 108,A00,186041,Staff,5,0,10,5
1683725596246,LTCS 119,A00,186042,Staff,15,0,20,5
1683725597275,LTCS 130,A00,186043,Wesling; Megan E.,15,0,25,10
1683725599323,LTEA 138,A00,186119,Staff,13,0,40,27
1683725600351,LTEN 124,A00,186148,Staff,5,0,25,20
1683725601380,LTEN 178,A00,186149,Staff,6,0,15,9
1683725602405,LTEN 181,A00,186150,Blanco; John D,34,0,40,6
1683725603430,LTWL 120,A00,186160,Staff,19,0,25,6
1683725604458,LTWL 165,A00,186161,Staff,22,0,25,3
1683725605487,LTWR 100,A00,186162,Staff,0,5,15,15
1683725606516,LTWR 102,A00,186163,Doller; Ben,5,0,15,10
1683725607544,MAE 8,A01,186412,Staff,0,1,0,0
1683725608570,MAE 30B,A00,186445,Bahadori; Mohammad Yousef,81,0,100,19
1683725609600,MAE 40,A00,186592,Bewley; Thomas R,10,0,50,40
1683725610625,MAE 101B,A00,186593,Bahadori; Mohammad Yousef,80,0,100,20
1683725611650,MAE 105,A00,186594,Bandaru; Prabhakar,10,0,50,40
1683725612676,MAE 107,A00,186599,Pham; Hieu Tan,0,8,120,120
1683725613701,MAE 148,A01,186660,Silberman; Jack,3,0,16,13
1683725614726,MATH 10A,A01,188095,Staff,0,6,35,35
1683725615758,MATH 10B,A01,188097,Bowers; Adam R.,0,12,30,30
1683725615758,MATH 10B,A02,188099,Bowers; Adam R.,0,11,30,30
1683725615758,MATH 10B,B01,188104,Bowers; Adam R.,0,10,30,30
1683725615758,MATH 10B,B02,188106,Bowers; Adam R.,0,9,30,30
1683725616785,MATH 10C,A01,188111,Staff,0,20,30,30
1683725616785,MATH 10C,A02,188127,Staff,0,19,30,30
1683725616785,MATH 10C,A03,188131,Staff,0,19,30,30
1683725616785,MATH 10C,B01,188218,Staff,17,0,30,13
1683725616785,MATH 10C,B02,188244,Staff,13,0,30,17
1683725616785,MATH 10C,B03,188277,Staff,14,0,30,16
1683725617815,MATH 18,A01,188344,Bach; Quang Tran,18,0,30,12
1683725617815,MATH 18,A02,188345,Bach; Quang Tran,11,0,30,19
1683725617815,MATH 18,B01,188353,Bach; Quang Tran,11,0,30,19
1683725617815,MATH 18,B02,188354,Bach; Quang Tran,19,0,30,11
1683725618841,MATH 20A,A01,188374,Staff,10,0,35,25
1683725619873,MATH 20B,A01,188382,Ohm; Ko Woon,7,0,30,23
1683725619873,MATH 20B,A02,188383,Ohm; Ko Woon,22,0,30,8
1683725619873,MATH 20B,B01,188385,Ohm; Ko Woon,7,0,30,23
1683725619873,MATH 20B,B02,188392,Ohm; Ko Woon,22,0,30,8
1683725620901,MATH 20C,A01,188394,Harel; Guershon,10,0,30,20
1683725620901,MATH 20C,A02,188395,Harel; Guershon,13,0,30,17
1683725620901,MATH 20C,B01,188404,Harel; Guershon,5,0,30,25
1683725620901,MATH 20C,B02,188405,Harel; Guershon,18,0,30,12
1683725621928,MATH 20D,A01,188414,Hammock; Frances H,0,1,30,30
1683725621928,MATH 20D,A02,188415,Hammock; Frances H,0,1,30,30
1683725621928,MATH 20D,B01,188447,Hammock; Frances H,0,1,30,30
1683725621928,MATH 20D,B02,188486,Hammock; Frances H,2,0,30,28
1683725622957,MATH 20E,A01,188649,Staff,21,0,30,9
1683725622957,MATH 20E,A02,188650,Staff,20,0,30,10
1683725622957,MATH 20E,A03,188673,Staff,0,0,30,30
1683725623982,MATH 102,A01,188675,Staff,0,40,35,35
1683725625010,MATH 103B,A01,188681,Staff,3,0,35,32
1683725625010,MATH 103B,B01,188692,Staff,5,0,35,30
1683725626038,MATH 109,A01,188695,Salehi Golsefidy; Alireza,24,0,35,11
1683725626038,MATH 109,A02,188696,Salehi Golsefidy; Alireza,24,0,35,11
1683725627068,MATH 120A,A01,188698,Eggers; John Dietrich,7,0,35,28
1683725628095,MATH 142B,A01,188736,Ioana; Adrian,0,0,30,30
1683725628095,MATH 142B,A02,188741,Ioana; Adrian,0,1,30,30
1683725628095,MATH 142B,A03,188743,Ioana; Adrian,0,3,30,30
1683725629121,MATH 168A,A01,188790,Staff,0,11,35,35
1683725630152,MATH 170A,A01,188803,Nie; Jiawang,0,2,35,35
1683725630152,MATH 170A,A02,188811,Nie; Jiawang,0,1,35,35
1683725630152,MATH 170A,A03,188814,Nie; Jiawang,1,0,35,34
1683725630152,MATH 170A,A04,188815,Nie; Jiawang,5,0,35,30
1683725631178,MATH 193B,A01,188817,Staff,0,0,35,35
1683725631178,MATH 193B,A02,188818,Staff,6,0,35,29
1683725632202,MGT 4,A01,202857,Anderson; John Charles,59,0,80,21
1683725633233,MGT 12,A00,202858,Lindenberger; Wade Douglas,40,0,90,50
1683725634262,MGT 18,A00,202859,Staff,73,0,90,17
1683725635291,MGT 18GS,A00,202860,McKay; Michael J,13,0,28,15
1683725636316,MGT 45,A00,202861,Pecore; Joseph P.,8,0,90,82
1683725637342,MGT 100,A00,202863,Yavorsky; Daniel Ryan,27,0,90,63
1683725638372,MGT 103,A00,202864,Ehrich; Kristine R,0,19,90,90
1683725639402,MGT 112,A00,202865,Ehrich; Kristine R,15,0,90,75
1683725640435,MGT 121A,A00,202868,Staff,70,0,90,20
1683725641465,MGT 131B,A00,202869,Anderson; John Charles,58,0,90,32
1683725642490,MGT 136,A00,202871,Lindenberger; Wade Douglas,83,0,90,7
1683725643514,MGT 164,A00,202873,Staff,0,67,90,91
1683725644543,MGT 164GS,A00,202874,McKay; Mary A,13,0,28,15
1683725645570,MGT 180,A00,202875,Staff,0,51,90,91
1683725646596,MMW 11R,A01,205019,Herbst; Matthew,0,0,30,30
1683725646596,MMW 11R,A02,205026,Herbst; Matthew,29,0,30,1
1683725647626,MMW 15,A01,193512,Chang; Edmond Yi-Teh,0,8,28,28
1683725647626,MMW 15,A02,193513,Chang; Edmond Yi-Teh,0,5,28,28
1683725647626,MMW 15,A03,193514,Chang; Edmond Yi-Teh,0,5,28,28
1683725647626,MMW 15,A04,193515,Chang; Edmond Yi-Teh,0,5,28,28
1683725647626,MMW 15,A05,193516,Chang; Edmond Yi-Teh,0,5,28,28
1683725647626,MMW 15,A06,193517,Chang; Edmond Yi-Teh,0,6,28,28
1683725647626,MMW 15,B01,193519,Chang; Edmond Yi-Teh,0,5,28,28
1683725647626,MMW 15,B02,193520,Chang; Edmond Yi-Teh,0,5,28,28
1683725647626,MMW 15,B03,193521,Chang; Edmond Yi-Teh,0,5,28,28
1683725647626,MMW 15,B04,193522,Chang; Edmond Yi-Teh,0,6,28,28
1683725647626,MMW 15,B05,193523,Chang; Edmond Yi-Teh,0,5,28,28
1683725647626,MMW 15,B06,193524,Chang; Edmond Yi-Teh,0,5,28,28
1683725648658,MMW 122,A01,193526,Rahimi; Babak,0,16,28,28
1683725648658,MMW 122,A02,193527,Rahimi; Babak,0,15,28,28
1683725648658,MMW 122,A03,193528,Rahimi; Babak,0,0,0,0
1683725648658,MMW 122,A04,193529,Rahimi; Babak,0,0,0,0
1683725649681,MUS 1A,A01,186663,Staff,0,18,35,35
1683725650708,MUS 4,A01,186715,Staff,0,12,35,35
1683725651737,MUS 5R,A01,186796,Dubnov; Shlomo,0,17,35,35
1683725652762,MUS 6,A01,186798,Staff,0,4,25,25
1683725653789,MUS 7,A01,186830,Staff,11,0,35,24
1683725654818,MUS 8,A01,186930,Staff,0,27,35,35
1683725655851,MUS 15,A01,186932,Staff,0,15,35,35
1683725655851,MUS 15,B01,186934,Staff,0,16,35,35
1683725656876,MUS 80,A00,186935,Staff,0,0,20,20
1683725656876,MUS 80,B00,186936,Staff,24,0,25,1
1683725657902,NANO 11,A00,204702,Lipomi; Darren John,0,0,0,0
1683725658933,NANO 15,A01,204709,Yang; Kesong,0,1,0,0
1683725659958,NANO 114,A00,202069,Jahed Motlagh; Zeinab,2,0,10,8
1683725660984,PHIL 1,A00,186955,Grush; Rick Scott,31,0,40,9
1683725662066,PHIL 10,A01,186973,Grush; Rick Scott,27,0,35,8
1683725662066,PHIL 10,A02,186974,Grush; Rick Scott,33,0,35,2
1683725663093,PHIL 13,A01,186976,Staff,1,0,35,34
1683725663093,PHIL 13,A02,186977,Staff,16,0,35,19
1683725664117,PHIL 14,A01,186979,Staff,30,0,35,5
1683725664117,PHIL 14,A02,186986,Staff,32,0,35,3
1683725665146,PHIL 28,A01,186988,Staff,16,0,30,14
1683725665146,PHIL 28,A02,186989,Staff,0,0,30,30
1683725665146,PHIL 28,A03,186990,Staff,10,0,30,20
1683725665146,PHIL 28,A04,186991,Staff,26,0,30,4
1683725666174,PHIL 120,A00,186997,Staff,23,0,40,17
1683725667198,PHIL 137,A00,187003,Staff,8,0,40,32
1683725668221,PHIL 150,A00,187015,Staff,47,0,70,23
1683725669251,PHIL 167,A00,187021,Lamey; Andy M.,34,0,40,6
1683725670280,PHIL 174,A01,202226,Staff,17,0,20,3
1683725670280,PHIL 174,A02,202235,Staff,20,0,20,0
1683725671304,PHIL 191A,A00,258918,Staff,0,0,1,1
1683725672329,PHYS 1A,A00,187028,Staff,26,0,60,34
1683725673359,PHYS 1AL,001,187036,Staff,3,0,30,27
1683725673359,PHYS 1AL,002,187049,Staff,18,0,30,12
1683725674383,PHYS 1B,A00,187058,Staff,21,0,60,39
1683725675408,PHYS 1BL,001,187064,Staff,0,1,30,30
1683725675408,PHYS 1BL,002,187070,Staff,4,0,30,26
1683725676432,PHYS 1C,A00,187082,Staff,30,0,120,90
1683725677457,PHYS 1CL,001,187088,Staff,0,9,30,30
1683725677457,PHYS 1CL,002,187089,Staff,0,1,30,30
1683725677457,PHYS 1CL,009,262693,Staff,9,0,30,21
1683725678505,PHYS 2B,A01,187097,Staff,55,0,115,60
1683725679534,PHYS 2C,A01,187099,Staff,63,0,115,52
1683725680560,PHYS 2CL,A01,187101,Staff,5,0,28,23
1683725680560,PHYS 2CL,A02,187102,Staff,15,0,28,13
1683725681586,PHYS 2D,A01,187123,Shotwell; Brian,95,0,115,20
1683725682610,PHYS 4B,A01,187133,Grinstein; Benjamin,35,0,50,15
1683725683634,POLI 10,A00,188819,Staff,0,4,50,50
1683725684662,POLI 11,A00,188827,Staff,43,0,50,7
1683725685688,POLI 13R,A00,188828,Staff,0,2,20,20
1683725686719,POLI 27,A01,188830,Elgin; Samuel Zincke,0,2,70,70
1683725687751,POLI 30,A00,188832,Desposato; Scott,30,0,50,20
1683725688775,POLI 102F,A00,188834,Staff,1,0,40,39
1683725689800,POLI 104A,A00,188852,Staff,12,0,30,18
1683725690828,POLI 104I,A00,188853,Staff,0,8,20,20
1683725691858,POLI 110B,A00,188854,Wiens; David,6,0,20,14
1683725692883,POLI 112A,A00,188855,Wiens; David,3,0,30,27
1683725693909,POLI 117R,A00,188856,Forman; Fonna,0,12,20,20
1683725694937,POLI 118,A00,188857,Ingham; Sean,8,0,20,12
1683725695964,POLI 120G,A00,188858,Staff,7,0,30,23
1683725696990,POLI 131CR,A00,188863,Hoston; Germaine,20,0,50,30
1683725698017,POLI 133,A00,188864,Nellis; Gareth Hb,44,0,50,6
1683725699047,POLI 134D,A00,188865,Desposato; Scott,27,0,30,3
1683725700072,POLI 142A,A00,188871,Gartzke; Erik,21,0,50,29
1683725701114,POLI 142K,A00,188874,Staff,38,0,50,12
1683725702141,POLI 143,A00,188940,Gartzke; Erik,15,0,30,15
1683725703168,POLI 153,A00,188943,Staff,1,0,20,19
1683725704195,POLI 160AA,A00,188944,Staff,10,0,40,30
1683725705219,POLI 170A,A00,188945,Staff,10,0,30,20
1683725707267,PSYC 1,A00,188952,Staff,36,0,90,54
1683725708291,PSYC 2,B00,188953,Staff,19,0,35,16
1683725709318,PSYC 6,A00,188970,Staff,47,0,60,13
1683725710345,PSYC 7,A00,188973,Staff,35,0,45,10
1683725711370,PSYC 60,A01,188980,Rickard; Timothy C.,42,0,60,18
1683725712400,PSYC 70,A01,189001,Steiner; Eric Tomas,22,0,45,23
1683725713426,PSYC 100,A00,189005,Lacefield; Katharine I,1,98,120,119
1683725714449,PSYC 102,A00,189008,Staff,6,0,30,24
1683725715477,PSYC 106,B00,189026,Gorman; Michael R.,27,0,60,33
1683725716502,PSYC 114,B01,189033,Winkielman; Piotr,0,31,30,30
1683725717527,PSYC 131,A00,189036,Anagnostaras; Stephan,0,44,60,60
1683725718558,PSYC 136,A00,189041,Lowe; Angela Beth,0,7,25,25
1683725719587,PSYC 137,A00,189057,Winkielman; Piotr,0,36,25,25
1683725720611,PSYC 144,A00,189107,Wixted; John T,0,11,50,50
1683725722665,PSYC 162,A00,189142,Staff,0,9,85,85
1683725723690,PSYC 172,A00,189144,Gorman; Michael R.,0,6,30,30
1683725725743,PSYC 179,A00,189146,Lacefield; Katharine I,0,88,120,120
1683725726768,PSYC 181,A00,189147,Anagnostaras; Stephan,0,45,90,90
1683725727798,PSYC 190R,A00,189148,Barner; David A.,0,23,80,80
1683725728826,PSYC 191,A00,189275,Rickard; Timothy C.,0,11,25,25
1683725729850,PSYC 193,A00,189276,Chapman; Eddie Nathaniel,0,1,0,4
1683725730876,PSYC 193L,A01,189281,Lowe; Angela Beth,8,0,20,12
1683725730876,PSYC 193L,B01,189285,Staff,28,0,35,7
1683725731904,RELI 149,A00,187137,Rahimi; Babak,6,0,40,34
1683725732928,SE 9,A01,187315,Staff,0,2,18,18
1683725733952,SE 101B,A00,187409,Staff,24,0,30,6
1683725734977,SE 110B,A00,187444,Staff,10,0,40,30
1683725736006,SE 130B,A00,187449,Staff,31,0,40,9
1683725737034,SE 150A,A00,187516,Staff,8,0,20,12
1683725738058,SE 154,A00,187528,Staff,29,0,50,21
1683725739084,SIO 3,A01,258171,Staff,35,0,40,5
1683725740108,SIO 10,A00,187144,Cook; Geoffrey W,0,6,75,75
1683725741135,SIO 45,A00,187152,Cook; Geoffrey W,1,7,100,99
1683725742160,SIO 109R,A00,194486,Staff,0,4,20,20
1683725744214,SIO 187,A01,187233,Kacev; David,12,0,40,28
1683725745239,SOCI 1,A01,258656,Thorpe; Charles Robert,28,0,30,2
1683725745239,SOCI 1,A02,258658,Thorpe; Charles Robert,30,0,30,0
1683725745239,SOCI 1,A03,258661,Thorpe; Charles Robert,25,0,25,0
1683725745239,SOCI 1,A04,258666,Thorpe; Charles Robert,22,0,25,3
1683725745239,SOCI 1,A05,258897,Thorpe; Charles Robert,22,0,25,3
1683725745239,SOCI 1,A06,258898,Thorpe; Charles Robert,25,0,25,0
1683725746264,SOCI 30,A01,258903,Pardo Guerra; Juan Pablo,14,0,30,16
1683725747292,SOCI 102,A00,258904,Staff,9,0,25,16
1683725748317,SOCI 106,A00,258905,Staff,19,0,25,6
1683725749345,SOCI 111,A00,258907,Ribas Norris; Janet Vanesa,26,0,30,4
1683725750374,SOCI 121R,A00,258908,Pardo Guerra; Juan Pablo,7,0,30,23
1683725751398,SOCI 126,A01,203330,Staff,14,0,20,6
1683725752422,SOCI 131,A00,258909,Thorpe; Charles Robert,30,0,60,30
1683725753446,SOCI 135,A00,258910,Payne; Christine Anna,0,13,30,30
1683725754470,SOCI 157,A00,258911,Staff,10,0,30,20
1683725755496,SOCI 184,A00,258912,Staff,25,0,30,5
1683725756520,SOCI 188D,A00,258913,Staff,22,0,30,8
1683725757546,SYN 2,001,187529,Staff,9,0,16,7
1683725757546,SYN 2,002,201452,Staff,0,20,16,16
1683725757546,SYN 2,003,201469,Staff,1,0,16,15
1683725758572,SYN 100,A01,187531,Staff,0,9,20,20
1683725758572,SYN 100,B01,201491,Staff,0,10,20,20
1683725759603,TDAC 1,A00,189286,Walsh; Kim C.,3,0,20,17
1683725759603,TDAC 1,B00,189287,Harting; Carla Kelso,10,0,20,10
1683725760627,TDAC 101,A00,189300,Walsh; Kim C.,16,0,20,4
1683725760627,TDAC 101,B00,189301,Harting; Carla Kelso,18,0,20,2
1683725761657,TDAC 102,A00,189304,Basso; Beatrice,14,0,20,6
1683725762688,TDAC 108,A00,189305,Staff,18,0,20,2
1683725763716,TDDE 131,A00,189310,Staff,19,0,20,1
1683725763716,TDDE 131,B00,189314,Staff,19,0,20,1
1683725763716,TDDE 131,C00,189315,Staff,48,0,50,2
1683725763716,TDDE 131,D00,189316,Staff,14,0,15,1
1683725763716,TDDE 131,E00,204841,Staff,20,0,20,0
1683725764742,TDGE 10,A00,189289,Staff,26,0,50,24
1683725764742,TDGE 10,B00,189290,Havis; Allan,0,1,50,50
1683725765825,TDGE 11,A00,189291,Fulton; Julia,0,4,50,50
1683725765825,TDGE 11,B00,189292,Staff,20,0,25,5
1683725765825,TDGE 11,C00,260270,Staff,0,0,0,0
1683725766849,TDGE 25,A00,189294,Staff,1,0,20,19
1683725767875,TDGE 124,A00,189318,Fulton; Julia,0,7,50,50
1683725768900,TDGE 125,A00,189319,Staff,13,0,25,12
1683725768900,TDGE 125,B00,189320,Staff,23,0,25,2
1683725769925,TDGE 127,A00,189322,Havis; Allan,1,0,50,49
1683725770949,TDHT 101,A00,189323,Staff,18,0,25,7
1683725770949,TDHT 101,B00,189324,Staff,25,0,25,0
1683725771973,TDHT 102,A00,189325,Staff,49,0,50,1
1683725773004,TDMV 1,A00,189295,Arcidiacono; Kristin,20,0,30,10
1683725773004,TDMV 1,B00,189296,Caligagan; Maria T.,23,0,30,7
1683725774030,TDMV 2,A00,189297,Sammartano; Tonnie,27,0,30,3
1683725774030,TDMV 2,B00,189299,Arcidiacono; Kristin,23,0,30,7
1683725775056,TDMV 3,A00,204998,Rincon; Alicia,22,0,30,8
1683725776082,TDMV 120,A00,189458,Sammartano; Tonnie,28,0,30,2
1683725777111,TDMV 138,A00,189541,Jun; Grace Shin Hae,20,0,40,20
1683725778140,TDMV 142,A00,189717,Caligagan; Tony,25,0,30,5
1683725778140,TDMV 142,B00,189718,Caligagan; Maria T.,25,0,30,5
1683725779166,TMC 2,A01,187533,Staff,25,0,25,0
1683725779166,TMC 2,A02,187534,Staff,25,0,25,0
1683725780191,USP 1,A01,187536,Kwak; Nancy,0,16,25,25
1683725781217,USP 5,A01,187538,Staff,8,0,25,17
1683725782244,USP 101,A00,199253,Staff,0,4,0,0
1683725783270,USP 124,A00,187562,Boomhower; Matthew Charles,0,0,30,30
1683725784296,USP 138,A00,187582,Staff,19,0,25,6
1683725785326,USP 152,A01,187597,Staff,3,0,25,22
1683725786350,USP 153,A00,187598,Staff,18,0,25,7
1683725787376,USP 168,A00,187607,Kwak; Nancy,2,0,5,3
1683725788403,USP 173,A00,187619,Staff,4,0,25,21
1683725789429,USP 181,A00,187638,Staff,0,4,25,25
1683725790453,VIS 103,A00,187650,Cruz; Edwin Teddy,17,0,75,58
1683725791476,VIS 110D,A00,187669,Staff,13,0,22,9
1683725792506,VIS 127C,A00,187720,Shen; Kuiyi,67,0,146,79
1683725793532,VIS 149,A00,187731,Yoldas; Pinar,0,12,22,22
1683725794561,VIS 151,A01,188091,Staff,22,0,34,12
1683725794561,VIS 151,A02,188092,Staff,11,0,34,23
1683725795591,VIS 160B,A00,188093,Stalbaum; Brett,0,1,10,10
1683725797650,WCWP 10B,A00,201720,Staff,0,0,5,5
1683725797650,WCWP 10B,B00,201722,Staff,0,0,6,6
1683725798678,WCWP 100,A00,201725,Gagnon; Jeffrey C,0,0,2,2
1683725798678,WCWP 100,B00,201727,Staff,0,4,15,15
1683725801806,ANBI 133,A00,258401,Wilder; Linnea Lorene,34,0,40,6
1683725802831,ANBI 140,A00,258395,Hrvoj Mihic; Branka,18,0,25,7
1683725803857,ANSC 120,A00,258402,Bialecki; Jon Anthony,26,0,40,14
1683725804886,ANSC 144,A00,258400,Staff,12,0,40,28
1683725806940,ANSC 166,A00,258396,Parish; Steven Martin,156,0,175,19
1683725807967,ANSC 180,A00,193533,Staff,8,0,20,12
1683725808993,ANSC 188,A00,258397,Jassal; Aftab,34,0,40,6
1683725810022,ANTH 3,A01,258316,Staff,23,0,30,7
1683725811051,ANTH 5,A00,258394,Semendeferi; Ekaterini,16,0,20,4
1683725812075,ANTH 21,A01,258331,Staff,4,0,40,36
1683725813105,ANTH 103,A00,258398,Varma; Saiba,15,0,25,10
1683725814140,AWP 10,001,202034,Staff,0,0,0,0
1683725814140,AWP 10,002,202035,Staff,0,0,0,0
1683725814140,AWP 10,003,202036,Staff,0,0,0,0
1683725814140,AWP 10,004,202037,Staff,0,0,0,0
1683725814140,AWP 10,005,202038,Staff,0,0,0,0
1683725814140,AWP 10,006,202039,Staff,0,0,0,0
1683725814140,AWP 10,007,202040,Staff,0,0,0,0
1683725814140,AWP 10,008,202041,Staff,0,0,0,0
1683725814140,AWP 10,009,202042,Staff,0,0,0,0
1683725814140,AWP 10,010,202043,Staff,0,0,0,0
1683725814140,AWP 10,011,202044,Staff,0,0,0,0
1683725814140,AWP 10,012,202045,Staff,0,0,0,0
1683725814140,AWP 10,013,202046,Staff,0,0,0,0
1683725814140,AWP 10,014,202047,Staff,0,0,0,0
1683725814140,AWP 10,015,202048,Staff,0,0,0,0
1683725814140,AWP 10,016,202049,Staff,0,0,0,0
1683725814140,AWP 10,017,202050,Staff,0,0,0,0
1683725814140,AWP 10,018,202051,Staff,0,0,0,0
1683725814140,AWP 10,019,202052,Staff,0,0,0,0
1683725814140,AWP 10,020,202053,Staff,0,0,0,0
1683725814140,AWP 10,021,202054,Staff,0,0,0,0
1683725814140,AWP 10,022,202055,Staff,0,0,0,0
1683725814140,AWP 10,023,202056,Staff,0,0,0,0
1683725814140,AWP 10,024,202057,Staff,0,0,0,0
1683725814140,AWP 10,025,202058,Staff,0,0,0,0
1683725814140,AWP 10,026,202059,Staff,0,0,0,0
1683725815166,AWP 102,001,202032,Staff,0,0,0,0
1683725815166,AWP 102,002,202033,Staff,0,0,0,0
1683725816192,BENG 100,A01,254234,Taylor Amos; Alyssa C,31,0,40,9
1683725817218,BENG 196,001,270013,Engler; Adam J.,9999,0,9999,0
1683725818250,BICD 100R,A01,202018,Smith; Laurie,0,7,32,32
1683725818250,BICD 100R,A02,202019,Smith; Laurie,0,3,32,32
1683725818250,BICD 100R,A03,202020,Smith; Laurie,0,1,32,32
1683725818250,BICD 100R,A04,202021,Smith; Laurie,6,0,32,26
1683725818250,BICD 100R,A05,202022,Smith; Laurie,10,0,32,22
1683725819282,BICD 136,A01,193242,Gustafson-Brown; Cindy,0,2,32,32
1683725819282,BICD 136,A02,193244,Gustafson-Brown; Cindy,13,0,32,19
1683725820309,BIEB 102,A01,193249,Butler; Shannon Rhey,0,0,32,32
1683725820309,BIEB 102,A02,193251,Butler; Shannon Rhey,0,0,32,32
1683725820309,BIEB 102,A03,193253,Butler; Shannon Rhey,0,0,32,32
1683725820309,BIEB 102,A04,193255,Butler; Shannon Rhey,13,0,32,19
1683725820309,BIEB 102,A05,193265,Butler; Shannon Rhey,25,0,32,7
1683725820309,BIEB 102,A06,193269,Butler; Shannon Rhey,12,0,32,20
1683725822363,BIEB 150,A01,193274,Staff,0,0,32,32
1683725822363,BIEB 150,A02,193285,Staff,24,0,32,8
1683725823390,BIEB 194,A00,193286,Kurle; Carolyn M.,19,0,32,13
1683725824418,BILD 1,A01,192291,Staff,15,0,32,17
1683725824418,BILD 1,A02,192292,Staff,30,0,32,2
1683725824418,BILD 1,B01,192520,Reuther; Keefe,0,1,0,0
1683725824418,BILD 1,B02,192532,Reuther; Keefe,0,1,0,0
1683725825450,BILD 3,A01,192556,Butler; Shannon Rhey,0,0,32,32
1683725825450,BILD 3,A02,192581,Butler; Shannon Rhey,0,1,32,32
1683725825450,BILD 3,A03,192611,Butler; Shannon Rhey,19,0,32,13
1683725825450,BILD 3,A04,192612,Butler; Shannon Rhey,23,0,32,9
1683725825450,BILD 3,A05,192613,Butler; Shannon Rhey,26,0,32,6
1683725825450,BILD 3,A06,192679,Butler; Shannon Rhey,27,0,32,5
1683725825450,BILD 3,A07,192682,Butler; Shannon Rhey,20,0,32,12
1683725826476,BILD 4,A01,192836,Reuther; Keefe,1,0,24,23
1683725826476,BILD 4,A02,193044,Reuther; Keefe,4,0,24,20
1683725827506,BILD 10,A01,193142,Gustafson-Brown; Cindy,29,0,32,3
1683725827506,BILD 10,A02,193149,Gustafson-Brown; Cindy,31,0,32,1
1683725828535,BIMM 100,A01,193301,Staff,0,6,32,32
1683725828535,BIMM 100,A02,193312,Staff,0,7,32,32
1683725828535,BIMM 100,A03,193323,Staff,0,10,32,32
1683725829570,BIMM 101,A01,193329,McDonnell; Lisa Marie,0,3,24,24
1683725829570,BIMM 101,A02,193339,McDonnell; Lisa Marie,0,3,24,24
1683725829570,BIMM 101,B01,193354,McDonnell; Lisa Marie,0,4,24,24
1683725829570,BIMM 101,B02,193357,McDonnell; Lisa Marie,0,3,24,24
1683725830602,BIMM 110,A01,193377,Tat; John,0,11,32,32
1683725830602,BIMM 110,A02,193378,Tat; John,0,11,32,32
1683725831634,BIMM 120,A01,206116,Staff,0,0,32,32
1683725831634,BIMM 120,A02,206117,Staff,7,0,32,25
1683725831634,BIMM 120,A03,206121,Staff,21,0,32,11
1683725832665,BIPN 100,A01,193393,Park; Ji Young,0,15,32,32
1683725832665,BIPN 100,A02,193402,Park; Ji Young,0,14,32,32
1683725832665,BIPN 100,A03,193413,Park; Ji Young,0,14,32,32
1683725832665,BIPN 100,A04,193414,Park; Ji Young,0,13,32,32
1683725833692,BIPN 102,A01,193429,Staff,0,0,32,32
1683725833692,BIPN 102,A02,193438,Staff,18,0,32,14
1683725834719,BIPN 106,A01,193450,Reyes Gonzalez; Catalina,0,2,40,40
1683725835745,BIPN 134,A01,193465,Cooke; James Edward,0,0,32,32
1683725835745,BIPN 134,A02,193474,Cooke; James Edward,25,0,32,7
1683725835745,BIPN 134,A03,193485,Cooke; James Edward,29,0,32,3
1683725835745,BIPN 134,A04,193486,Cooke; James Edward,20,0,32,12
1683725835745,BIPN 134,A05,193491,Cooke; James Edward,31,0,32,1
1683725835745,BIPN 134,A06,193501,Cooke; James Edward,30,0,32,2
1683725835745,BIPN 134,A07,193510,Cooke; James Edward,29,0,32,3
1683725837800,BISP 194,A00,222522,Staff,14,0,32,18
1683725838826,CAT 124,A01,202407,Staff,19,0,25,6
1683725839860,CAT 125,A00,202408,Marchisotto; Jennifer Anne,2,0,20,18
1683725840902,CAT 125R,A00,202409,Smith; Lauryn Alissa,0,11,20,20
1683725840902,CAT 125R,B00,202410,Morales; Celeste Georgianna,0,11,20,20
1683725840902,CAT 125R,C00,202411,Irwin; Matthew Joseph,0,12,20,20
1683725841930,CENG 15,A01,204712,Yang; Kesong,0,1,0,0
1683725842962,CENG 114,A00,202070,Jahed Motlagh; Zeinab,5,0,20,15
1683725843988,CGS 105,A00,185477,Wesling; Megan E.,24,0,40,16
1683725845016,CGS 106,A00,185494,Staff,11,0,22,11
1683725846046,CGS 108,A00,185495,Staff,14,0,20,6
1683725847071,CGS 114,A00,185496,Staff,13,0,18,5
1683725848095,CGS 119,A00,185501,Staff,15,0,20,5
1683725849123,CGS 120,A00,185511,Staff,11,0,20,9
1683725850149,CHEM 4,A01,184675,Bussey; Thomas J,97,0,100,3
1683725851176,CHEM 6A,A01,184677,Staff,32,0,60,28
1683725852202,CHEM 6B,A01,184679,Staff,63,0,100,37
1683725853229,CHEM 6C,A01,184681,Bussey; Thomas J,0,0,50,50
1683725853229,CHEM 6C,A02,184682,Bussey; Thomas J,32,0,50,18
1683725854255,CHEM 40A,A01,184684,Albizati; Kim F.,33,0,100,67
1683725855283,CHEM 40B,A01,184686,Albizati; Kim F.,0,22,100,100
1683725856311,CHEM 41B,A01,184690,Staff,51,0,100,49
1683725857338,COGS 3,A01,184715,Boyle; Mary E. T.,0,27,40,40
1683725858362,COGS 14B,A01,185172,Staff,0,14,38,38
1683725859392,COGS 18,A01,184736,Staff,14,0,80,66
1683725860419,COGS 100,A01,184932,Staff,0,8,73,73
1683725861445,COGS 101A,A01,184935,Staff,0,40,30,30
1683725862470,COGS 101B,A01,184944,Staff,0,2,30,30
1683725863495,COGS 101C,A01,184946,Staff,0,10,30,30
1683725864520,COGS 102A,A01,184951,Johnson; Christine M.,1,0,40,39
1683725865546,COGS 107B,A01,184953,Mooshagian; Eric Frederick,0,52,40,40
1683725866573,COGS 118B,A01,184959,Gupta; Anjum,0,50,40,40
1683725867598,COGS 153,A00,184961,Staff,1,16,30,29
1683725868623,COGS 177,A00,184962,Staff,0,20,30,30
1683725869724,COGS 187A,A01,184969,Boyle; Mary E. T.,0,19,40,40
1683725870750,COMM 10,A01,185174,Staff,0,5,25,25
1683725870750,COMM 10,A02,185189,Staff,0,2,25,25
1683725870750,COMM 10,A03,269821,Staff,0,1,0,0
1683725871776,COMM 100B,A02,185476,Staff,10,0,25,15
1683725871776,COMM 100B,A03,277340,Staff,25,0,25,0
1683725872802,COMM 100C,A01,185314,Staff,2,0,25,23
1683725872802,COMM 100C,A02,185327,Staff,17,0,25,8
1683725873828,COMM 110M,A00,185349,Staff,0,0,40,40
1683725874852,COMM 113T,A00,185352,Staff,25,0,40,15
1683725875877,COMM 114I,A00,185353,Staff,31,0,40,9
1683725876906,COMM 131,A00,185354,Staff,17,0,30,13
1683725877936,CSE 8A,A50,185358,Cao; Yingjun,0,46,10,10
1683725878961,CSE 8B,A01,185362,Staff,0,48,50,50
1683725879987,CSE 11,A01,185416,Cao; Yingjun,0,91,10,10
1683725881014,CSE 20,A01,185445,Briones; Jor-el Thomas Caparas,3,0,25,22
1683725882045,CSE 21,A01,185447,Staff,9,0,50,41
1683725883073,CSE 101,A01,185451,Staff,0,13,50,50
1683725883073,CSE 101,B01,185453,Jones; Miles E,0,15,50,50
1683725885130,CSE 141,A01,185458,Eldon; John,16,0,100,84
1683725886160,CSE 141L,A01,185461,Eldon; John,8,0,100,92
1683725887191,CSE 142,A01,185463,Staff,34,0,60,26
1683725887191,CSE 142,B01,201355,Staff,0,7,60,60
1683725888219,CSE 142L,A01,185470,Staff,34,0,60,26
1683725888219,CSE 142L,B01,201417,Staff,0,6,60,60
1683725889244,CSE 190,A00,201433,Staff,32,0,49,17
1683725890278,DOC 1,A01,259136,Strom; Megan C.,7,0,15,8
1683725890278,DOC 1,A02,259137,Strom; Megan C.,15,0,15,0
1683725890278,DOC 1,A03,259138,Strom; Megan C.,14,0,15,1
1683725890278,DOC 1,A04,259139,Strom; Megan C.,13,0,15,2
1683725891304,DOC 100D,A00,259140,Pass; Natalye Joann,14,0,25,11
1683725892329,DSGN 1,A01,184749,Rill; Bryan,0,26,30,30
1683725893357,DSGN 100,A01,185168,Staff,0,2,25,25
1683725894384,ECE 5,A01,185626,Morris; Karcher William,0,12,0,0
1683725895411,ECE 101,A01,185628,Staff,14,0,70,56
1683725896437,ECE 107,A01,185635,Baghdadchi; Saharnaz,0,0,20,20
1683725896437,ECE 107,A02,185638,Baghdadchi; Saharnaz,1,0,20,19
1683725897463,ECE 148,A01,185647,Silberman; Jack,0,0,16,16
1683725898490,ECON 1,A01,185537,Crane; Meredith Helen,54,0,70,16
1683725899518,ECON 3,A01,185549,Crane; Meredith Helen,30,0,70,40
1683725900551,ECON 4,A01,203354,Anderson; John Charles,0,5,10,10
1683725901576,ECON 100A,A01,185574,Staff,0,5,40,40
1683725902602,ECON 100B,A01,185576,Staff,0,12,50,50
1683725903632,ECON 100C,A01,185589,Newhouse; Herbert S,30,0,70,40
1683725904662,ECON 105,A00,185608,Vespa; Emanuel Ignacio,19,0,35,16
1683725905687,ECON 109,A01,185610,Shishkin; Denis,9,0,35,26
1683725906712,ECON 110A,A01,185612,Staff,8,0,40,32
1683725907737,ECON 120A,A01,185615,Staff,19,0,40,21
1683725908766,ECON 120C,A01,185617,Sun; Yixiao,0,21,70,70
1683725909792,ECON 144,A00,203346,Squires; Dale E,2,0,35,33
1683725910822,ECON 171,A01,203349,Newhouse; Herbert S,0,1,35,35
1683725911853,ECON 173A,A01,185621,Toda; Alexis Akira,21,0,35,14
1683725912881,EDS 25,A01,202413,Staff,0,1,0,0
1683725912881,EDS 25,A02,202414,Staff,0,1,0,0
1683725912881,EDS 25,A03,202415,Staff,0,0,0,0
1683725912881,EDS 25,A04,202416,Staff,0,1,0,0
1683725912881,EDS 25,A05,202439,Staff,0,0,0,0
1683725912881,EDS 25,A06,202440,Staff,0,0,0,0
1683725912881,EDS 25,B01,202631,Staff,0,0,0,0
1683725912881,EDS 25,B02,202632,Staff,0,0,0,0
1683725912881,EDS 25,B03,202639,Staff,0,0,0,0
1683725912881,EDS 25,B04,202640,Staff,0,0,0,0
1683725912881,EDS 25,B05,202643,Staff,0,0,0,0
1683725912881,EDS 25,B06,202644,Staff,0,0,0,0
1683725913908,EDS 38,A01,202659,Black; Alison Michelle,25,0,25,0
1683725914932,EDS 115,A00,202652,Staff,18,0,30,12
1683725915962,EDS 125,A00,202649,Staff,13,0,30,17
1683725916988,EDS 126,A01,203332,Staff,30,0,30,0
1683725918015,EDS 139,A00,202838,Staff,16,0,25,9
1683725919044,EDS 146,A01,202655,Staff,14,0,25,11
1683725920070,ENG 15,A00,185667,Staff,0,1,0,0
1683725920070,ENG 15,B00,185672,Staff,0,0,0,0
1683725920070,ENG 15,C00,185675,Staff,0,0,0,0
1683725920070,ENG 15,D00,185682,Staff,0,0,0,0
1683725920070,ENG 15,E00,185684,Staff,0,0,0,0
1683725921095,ETHN 103,A00,185710,Staff,0,8,35,35
1683725922120,ETHN 103A,A00,199228,Man; Simeon S,0,0,9,9
1683725923149,ETHN 109,A00,185711,Staff,15,0,35,20
1683725924177,ETHN 142,A00,185726,Staff,0,4,30,30
1683725925203,ETHN 163J,A00,199229,Man; Simeon S,5,0,8,3
1683725926227,ETHN 168,A00,185727,Staff,7,0,10,3
1683725927258,ETHN 182,A00,185728,Staff,0,0,35,35
1683725928287,ETHN 183,A00,185737,Staff,10,0,18,8
1683725929313,GLBH 111,A01,209361,Burgos; Jose L.,0,0,0,0
1683725931371,HIEU 104,A00,185792,Staff,14,0,20,6
1683725932398,HIEU 115,A00,185800,Staff,0,0,20,20
1683725933423,HIEU 128,A00,185801,Staff,0,9,20,20
1683725934448,HIEU 147,A00,185802,Staff,15,0,20,5
1683725935473,HIEU 154,A00,185823,Staff,11,0,20,9
1683725936498,HILA 102,A00,185826,Staff,14,0,20,6
1683725937524,HILD 2C,A01,185778,Staff,0,13,20,20
1683725938554,HILD 7B,A01,185780,Kwak; Nancy,0,17,32,32
1683725938554,HILD 7B,A02,185781,Kwak; Nancy,0,18,32,32
1683725939579,HILD 30,A01,185791,Staff,12,0,20,8
1683725940604,HISC 119,A00,185830,Golan; Tal,0,10,20,20
1683725941660,HITO 156GS,A00,185831,Patterson; Patrick H.,0,0,0,23
1683725942685,HIUS 103,A00,185832,Man; Simeon S,0,4,20,20
1683725943710,HIUS 117,A00,185836,Kwak; Nancy,2,0,20,18
1683725944734,HIUS 125,A00,185840,Man; Simeon S,0,2,23,23
1683725945763,HIUS 149,A00,185845,Staff,1,0,20,19
1683725946796,HUM 3,A01,185882,Zavodny; Tatiana Sophia,0,8,50,50
1683725946796,HUM 3,B01,185899,Caldwell; Michael Alan,0,18,50,50
1683725947822,HUM 3GS,A00,185900,Patterson; Patrick H.,0,0,0,23
1683725948850,HUM 4,A01,185938,Zroka; Amy Liane,28,0,50,22
1683725948850,HUM 4,B01,185956,Watkins; Eric,0,6,50,50
1683725948850,HUM 4,B02,202209,Watkins; Eric,0,6,50,50
1683725948850,HUM 4,B03,202210,Watkins; Eric,0,5,50,50
1683725949876,HUM 5,A01,185958,West; Geoffrey Scott,0,0,50,50
1683725949876,HUM 5,A02,202215,West; Geoffrey Scott,0,1,50,50
1683725950912,INTL 190,A00,185959,Gagnon; Jeffrey C,0,0,0,9
1683725950912,INTL 190,B00,185960,Lettieri; Michael Joseph,0,0,0,2
1683725951940,JAPN 180,A00,254509,Staff,4,0,30,26
1683725952968,LATI 10,A01,202853,Kennemore; Amy Michelle,4,0,35,31
1683725952968,LATI 10,A02,202854,Kennemore; Amy Michelle,3,0,35,32
1683725952968,LATI 10,A03,270054,Kennemore; Amy Michelle,30,0,30,0
1683725953994,LATI 180,A00,202855,Kennemore; Amy Michelle,11,0,20,9
1683725955018,LAWS 101,A00,201767,Golan; Tal,0,7,40,40
1683725956047,LIFR 1C,A00,185961,Staff,6,0,20,14
1683725957073,LIFR 1CX,A00,185962,Staff,7,0,20,13
1683725958098,LIFR 1D,A00,185963,Staff,7,0,20,13
1683725959123,LIFR 1DX,A00,185964,Staff,7,0,20,13
1683725960151,LIGN 101,A01,186039,Staff,43,0,50,7
1683725961178,LIGN 165,A00,186040,Staff,14,0,50,36
1683725962206,LTCS 108,A00,186041,Staff,5,0,10,5
1683725963235,LTCS 119,A00,186042,Staff,15,0,20,5
1683725964261,LTCS 130,A00,186043,Wesling; Megan E.,15,0,25,10
1683725966314,LTEA 138,A00,186119,Staff,13,0,40,27
1683725967339,LTEN 124,A00,186148,Staff,5,0,25,20
1683725968364,LTEN 178,A00,186149,Staff,6,0,15,9
1683725969395,LTEN 181,A00,186150,Blanco; John D,34,0,40,6
1683725970421,LTWL 120,A00,186160,Staff,19,0,25,6
1683725971450,LTWL 165,A00,186161,Staff,22,0,25,3
1683725972476,LTWR 100,A00,186162,Staff,0,5,15,15
1683725973557,LTWR 102,A00,186163,Doller; Ben,5,0,15,10
1683725974588,MAE 8,A01,186412,Staff,0,1,0,0
1683725975618,MAE 30B,A00,186445,Bahadori; Mohammad Yousef,81,0,100,19
1683725976643,MAE 40,A00,186592,Bewley; Thomas R,10,0,50,40
1683725977666,MAE 101B,A00,186593,Bahadori; Mohammad Yousef,80,0,100,20
1683725978724,MAE 105,A00,186594,Bandaru; Prabhakar,10,0,50,40
1683725979750,MAE 107,A00,186599,Pham; Hieu Tan,0,8,120,120
1683725980774,MAE 148,A01,186660,Silberman; Jack,3,0,16,13
1683725981805,MATH 10A,A01,188095,Staff,0,6,35,35
1683725982903,MATH 10B,A01,188097,Bowers; Adam R.,0,12,30,30
1683725982903,MATH 10B,A02,188099,Bowers; Adam R.,0,11,30,30
1683725982903,MATH 10B,B01,188104,Bowers; Adam R.,0,10,30,30
1683725982903,MATH 10B,B02,188106,Bowers; Adam R.,0,9,30,30
1683725983931,MATH 10C,A01,188111,Staff,0,20,30,30
1683725983931,MATH 10C,A02,188127,Staff,0,19,30,30
1683725983931,MATH 10C,A03,188131,Staff,0,19,30,30
1683725983931,MATH 10C,B01,188218,Staff,17,0,30,13
1683725983931,MATH 10C,B02,188244,Staff,13,0,30,17
1683725983931,MATH 10C,B03,188277,Staff,14,0,30,16
1683725984957,MATH 18,A01,188344,Bach; Quang Tran,18,0,30,12
1683725984957,MATH 18,A02,188345,Bach; Quang Tran,11,0,30,19
1683725984957,MATH 18,B01,188353,Bach; Quang Tran,11,0,30,19
1683725984957,MATH 18,B02,188354,Bach; Quang Tran,19,0,30,11
1683725985982,MATH 20A,A01,188374,Staff,10,0,35,25
1683725987008,MATH 20B,A01,188382,Ohm; Ko Woon,7,0,30,23
1683725987008,MATH 20B,A02,188383,Ohm; Ko Woon,22,0,30,8
1683725987008,MATH 20B,B01,188385,Ohm; Ko Woon,7,0,30,23
1683725987008,MATH 20B,B02,188392,Ohm; Ko Woon,22,0,30,8
1683725988034,MATH 20C,A01,188394,Harel; Guershon,10,0,30,20
1683725988034,MATH 20C,A02,188395,Harel; Guershon,13,0,30,17
1683725988034,MATH 20C,B01,188404,Harel; Guershon,5,0,30,25
1683725988034,MATH 20C,B02,188405,Harel; Guershon,18,0,30,12
1683725989066,MATH 20D,A01,188414,Hammock; Frances H,0,1,30,30
1683725989066,MATH 20D,A02,188415,Hammock; Frances H,0,1,30,30
1683725989066,MATH 20D,B01,188447,Hammock; Frances H,0,1,30,30
1683725989066,MATH 20D,B02,188486,Hammock; Frances H,2,0,30,28
1683725990092,MATH 20E,A01,188649,Staff,21,0,30,9
1683725990092,MATH 20E,A02,188650,Staff,20,0,30,10
1683725990092,MATH 20E,A03,188673,Staff,0,0,30,30
1683725991119,MATH 102,A01,188675,Staff,0,40,35,35
1683725992146,MATH 103B,A01,188681,Staff,3,0,35,32
1683725992146,MATH 103B,B01,188692,Staff,5,0,35,30
1683725993176,MATH 109,A01,188695,Salehi Golsefidy; Alireza,24,0,35,11
1683725993176,MATH 109,A02,188696,Salehi Golsefidy; Alireza,24,0,35,11
1683725994202,MATH 120A,A01,188698,Eggers; John Dietrich,7,0,35,28
1683725995227,MATH 142B,A01,188736,Ioana; Adrian,0,0,30,30
1683725995227,MATH 142B,A02,188741,Ioana; Adrian,0,1,30,30
1683725995227,MATH 142B,A03,188743,Ioana; Adrian,0,3,30,30
1683725996255,MATH 168A,A01,188790,Staff,0,11,35,35
1683725997285,MATH 170A,A01,188803,Nie; Jiawang,0,2,35,35
1683725997285,MATH 170A,A02,188811,Nie; Jiawang,0,1,35,35
1683725997285,MATH 170A,A03,188814,Nie; Jiawang,1,0,35,34
1683725997285,MATH 170A,A04,188815,Nie; Jiawang,5,0,35,30
1683725998308,MATH 193B,A01,188817,Staff,0,0,35,35
1683725998308,MATH 193B,A02,188818,Staff,6,0,35,29
1683725999337,MGT 4,A01,202857,Anderson; John Charles,59,0,80,21
1683726000364,MGT 12,A00,202858,Lindenberger; Wade Douglas,40,0,90,50
1683726001389,MGT 18,A00,202859,Staff,73,0,90,17
1683726002418,MGT 18GS,A00,202860,McKay; Michael J,13,0,28,15
1683726003444,MGT 45,A00,202861,Pecore; Joseph P.,8,0,90,82
1683726004470,MGT 100,A00,202863,Yavorsky; Daniel Ryan,27,0,90,63
1683726005495,MGT 103,A00,202864,Ehrich; Kristine R,0,19,90,90
1683726006520,MGT 112,A00,202865,Ehrich; Kristine R,15,0,90,75
1683726007546,MGT 121A,A00,202868,Staff,70,0,90,20
1683726008571,MGT 131B,A00,202869,Anderson; John Charles,58,0,90,32
1683726009595,MGT 136,A00,202871,Lindenberger; Wade Douglas,83,0,90,7
1683726010620,MGT 164,A00,202873,Staff,0,67,90,91
1683726011650,MGT 164GS,A00,202874,McKay; Mary A,13,0,28,15
1683726012674,MGT 180,A00,202875,Staff,0,51,90,91
1683726013702,MMW 11R,A01,205019,Herbst; Matthew,0,0,30,30
1683726013702,MMW 11R,A02,205026,Herbst; Matthew,29,0,30,1
1683726014729,MMW 15,A01,193512,Chang; Edmond Yi-Teh,0,8,28,28
1683726014729,MMW 15,A02,193513,Chang; Edmond Yi-Teh,0,5,28,28
1683726014729,MMW 15,A03,193514,Chang; Edmond Yi-Teh,0,5,28,28
1683726014729,MMW 15,A04,193515,Chang; Edmond Yi-Teh,0,5,28,28
1683726014729,MMW 15,A05,193516,Chang; Edmond Yi-Teh,0,5,28,28
1683726014729,MMW 15,A06,193517,Chang; Edmond Yi-Teh,0,6,28,28
1683726014729,MMW 15,B01,193519,Chang; Edmond Yi-Teh,0,5,28,28
1683726014729,MMW 15,B02,193520,Chang; Edmond Yi-Teh,0,5,28,28
1683726014729,MMW 15,B03,193521,Chang; Edmond Yi-Teh,0,5,28,28
1683726014729,MMW 15,B04,193522,Chang; Edmond Yi-Teh,0,6,28,28
1683726014729,MMW 15,B05,193523,Chang; Edmond Yi-Teh,0,5,28,28
1683726014729,MMW 15,B06,193524,Chang; Edmond Yi-Teh,0,5,28,28
1683726015753,MMW 122,A01,193526,Rahimi; Babak,0,16,28,28
1683726015753,MMW 122,A02,193527,Rahimi; Babak,0,15,28,28
1683726015753,MMW 122,A03,193528,Rahimi; Babak,0,0,0,0
1683726015753,MMW 122,A04,193529,Rahimi; Babak,0,0,0,0
1683726016778,MUS 1A,A01,186663,Staff,0,18,35,35
1683726017803,MUS 4,A01,186715,Staff,0,12,35,35
1683726018827,MUS 5R,A01,186796,Dubnov; Shlomo,0,17,35,35
1683726019851,MUS 6,A01,186798,Staff,0,4,25,25
1683726020878,MUS 7,A01,186830,Staff,11,0,35,24
1683726021904,MUS 8,A01,186930,Staff,0,27,35,35
1683726022935,MUS 15,A01,186932,Staff,0,15,35,35
1683726022935,MUS 15,B01,186934,Staff,0,16,35,35
1683726023965,MUS 80,A00,186935,Staff,0,0,20,20
1683726023965,MUS 80,B00,186936,Staff,24,0,25,1
1683726024988,NANO 11,A00,204702,Lipomi; Darren John,0,0,0,0
1683726026013,NANO 15,A01,204709,Yang; Kesong,0,1,0,0
1683726027043,NANO 114,A00,202069,Jahed Motlagh; Zeinab,2,0,10,8
1683726028066,PHIL 1,A00,186955,Grush; Rick Scott,31,0,40,9
1683726029095,PHIL 10,A01,186973,Grush; Rick Scott,27,0,35,8
1683726029095,PHIL 10,A02,186974,Grush; Rick Scott,33,0,35,2
1683726030123,PHIL 13,A01,186976,Staff,1,0,35,34
1683726030123,PHIL 13,A02,186977,Staff,16,0,35,19
1683726031148,PHIL 14,A01,186979,Staff,30,0,35,5
1683726031148,PHIL 14,A02,186986,Staff,32,0,35,3
1683726032175,PHIL 28,A01,186988,Staff,16,0,30,14
1683726032175,PHIL 28,A02,186989,Staff,0,0,30,30
1683726032175,PHIL 28,A03,186990,Staff,10,0,30,20
1683726032175,PHIL 28,A04,186991,Staff,26,0,30,4
1683726033202,PHIL 120,A00,186997,Staff,23,0,40,17
1683726034229,PHIL 137,A00,187003,Staff,8,0,40,32
1683726035255,PHIL 150,A00,187015,Staff,47,0,70,23
1683726036278,PHIL 167,A00,187021,Lamey; Andy M.,34,0,40,6
1683726037302,PHIL 174,A01,202226,Staff,17,0,20,3
1683726037302,PHIL 174,A02,202235,Staff,20,0,20,0
1683726038325,PHIL 191A,A00,258918,Staff,0,0,1,1
1683726039354,PHYS 1A,A00,187028,Staff,26,0,60,34
1683726040383,PHYS 1AL,001,187036,Staff,3,0,30,27
1683726040383,PHYS 1AL,002,187049,Staff,18,0,30,12
1683726041410,PHYS 1B,A00,187058,Staff,21,0,60,39
1683726042439,PHYS 1BL,001,187064,Staff,0,1,30,30
1683726042439,PHYS 1BL,002,187070,Staff,4,0,30,26
1683726043466,PHYS 1C,A00,187082,Staff,30,0,120,90
1683726044494,PHYS 1CL,001,187088,Staff,0,9,30,30
1683726044494,PHYS 1CL,002,187089,Staff,0,1,30,30
1683726044494,PHYS 1CL,009,262693,Staff,9,0,30,21
1683726045518,PHYS 2B,A01,187097,Staff,55,0,115,60
1683726046543,PHYS 2C,A01,187099,Staff,63,0,115,52
1683726047568,PHYS 2CL,A01,187101,Staff,5,0,28,23
1683726047568,PHYS 2CL,A02,187102,Staff,15,0,28,13
1683726048593,PHYS 2D,A01,187123,Shotwell; Brian,95,0,115,20
1683726049620,PHYS 4B,A01,187133,Grinstein; Benjamin,35,0,50,15
1683726050648,POLI 10,A00,188819,Staff,0,4,50,50
1683726051672,POLI 11,A00,188827,Staff,43,0,50,7
1683726052698,POLI 13R,A00,188828,Staff,0,2,20,20
1683726053724,POLI 27,A01,188830,Elgin; Samuel Zincke,0,2,70,70
1683726054750,POLI 30,A00,188832,Desposato; Scott,30,0,50,20
1683726055779,POLI 102F,A00,188834,Staff,1,0,40,39
1683726056808,POLI 104A,A00,188852,Staff,12,0,30,18
1683726057833,POLI 104I,A00,188853,Staff,0,8,20,20
1683726058863,POLI 110B,A00,188854,Wiens; David,6,0,20,14
1683726059887,POLI 112A,A00,188855,Wiens; David,3,0,30,27
1683726060917,POLI 117R,A00,188856,Forman; Fonna,0,12,20,20
1683726061943,POLI 118,A00,188857,Ingham; Sean,8,0,20,12
1683726062972,POLI 120G,A00,188858,Staff,7,0,30,23
1683726063999,POLI 131CR,A00,188863,Hoston; Germaine,20,0,50,30
1683726065028,POLI 133,A00,188864,Nellis; Gareth Hb,44,0,50,6
1683726066061,POLI 134D,A00,188865,Desposato; Scott,27,0,30,3
1683726067091,POLI 142A,A00,188871,Gartzke; Erik,21,0,50,29
1683726068118,POLI 142K,A00,188874,Staff,38,0,50,12
1683726069147,POLI 143,A00,188940,Gartzke; Erik,15,0,30,15
1683726070174,POLI 153,A00,188943,Staff,1,0,20,19
1683726071199,POLI 160AA,A00,188944,Staff,10,0,40,30
1683726072224,POLI 170A,A00,188945,Staff,10,0,30,20
1683726074278,PSYC 1,A00,188952,Staff,36,0,90,54
1683726075303,PSYC 2,B00,188953,Staff,19,0,35,16
1683726076330,PSYC 6,A00,188970,Staff,47,0,60,13
1683726077416,PSYC 7,A00,188973,Staff,35,0,45,10
1683726078446,PSYC 60,A01,188980,Rickard; Timothy C.,42,0,60,18
1683726079474,PSYC 70,A01,189001,Steiner; Eric Tomas,22,0,45,23
1683726080502,PSYC 100,A00,189005,Lacefield; Katharine I,1,98,120,119
1683726081526,PSYC 102,A00,189008,Staff,6,0,30,24
1683726082552,PSYC 106,B00,189026,Gorman; Michael R.,27,0,60,33
1683726083580,PSYC 114,B01,189033,Winkielman; Piotr,0,31,30,30
1683726084606,PSYC 131,A00,189036,Anagnostaras; Stephan,0,44,60,60
1683726085631,PSYC 136,A00,189041,Lowe; Angela Beth,0,7,25,25
1683726086657,PSYC 137,A00,189057,Winkielman; Piotr,0,36,25,25
1683726087683,PSYC 144,A00,189107,Wixted; John T,0,11,50,50
1683726089740,PSYC 162,A00,189142,Staff,0,9,85,85
1683726090764,PSYC 172,A00,189144,Gorman; Michael R.,0,6,30,30
1683726092818,PSYC 179,A00,189146,Lacefield; Katharine I,0,88,120,120
1683726093848,PSYC 181,A00,189147,Anagnostaras; Stephan,0,45,90,90
1683726094874,PSYC 190R,A00,189148,Barner; David A.,0,23,80,80
1683726095899,PSYC 191,A00,189275,Rickard; Timothy C.,0,11,25,25
1683726096927,PSYC 193,A00,189276,Chapman; Eddie Nathaniel,0,1,0,4
1683726097958,PSYC 193L,A01,189281,Lowe; Angela Beth,8,0,20,12
1683726097958,PSYC 193L,B01,189285,Staff,28,0,35,7
1683726098982,RELI 149,A00,187137,Rahimi; Babak,6,0,40,34
1683726100008,SE 9,A01,187315,Staff,0,2,18,18
1683726101032,SE 101B,A00,187409,Staff,24,0,30,6
1683726102058,SE 110B,A00,187444,Staff,10,0,40,30
1683726103082,SE 130B,A00,187449,Staff,31,0,40,9
1683726104107,SE 150A,A00,187516,Staff,8,0,20,12
1683726105133,SE 154,A00,187528,Staff,29,0,50,21
1683726106158,SIO 3,A01,258171,Staff,35,0,40,5
1683726107184,SIO 10,A00,187144,Cook; Geoffrey W,0,6,75,75
1683726108209,SIO 45,A00,187152,Cook; Geoffrey W,1,7,100,99
1683726109234,SIO 109R,A00,194486,Staff,0,4,20,20
1683726111290,SIO 187,A01,187233,Kacev; David,12,0,40,28
1683726112317,SOCI 1,A01,258656,Thorpe; Charles Robert,28,0,30,2
1683726112317,SOCI 1,A02,258658,Thorpe; Charles Robert,30,0,30,0
1683726112317,SOCI 1,A03,258661,Thorpe; Charles Robert,25,0,25,0
1683726112317,SOCI 1,A04,258666,Thorpe; Charles Robert,22,0,25,3
1683726112317,SOCI 1,A05,258897,Thorpe; Charles Robert,22,0,25,3
1683726112317,SOCI 1,A06,258898,Thorpe; Charles Robert,25,0,25,0
1683726113347,SOCI 30,A01,258903,Pardo Guerra; Juan Pablo,14,0,30,16
1683726114371,SOCI 102,A00,258904,Staff,9,0,25,16
1683726115395,SOCI 106,A00,258905,Staff,19,0,25,6
1683726116420,SOCI 111,A00,258907,Ribas Norris; Janet Vanesa,26,0,30,4
1683726117450,SOCI 121R,A00,258908,Pardo Guerra; Juan Pablo,7,0,30,23
1683726118480,SOCI 126,A01,203330,Staff,14,0,20,6
1683726119505,SOCI 131,A00,258909,Thorpe; Charles Robert,30,0,60,30
1683726120534,SOCI 135,A00,258910,Payne; Christine Anna,0,13,30,30
1683726121559,SOCI 157,A00,258911,Staff,10,0,30,20
1683726122587,SOCI 184,A00,258912,Staff,25,0,30,5
1683726123610,SOCI 188D,A00,258913,Staff,22,0,30,8
1683726124636,SYN 2,001,187529,Staff,9,0,16,7
1683726124636,SYN 2,002,201452,Staff,0,20,16,16
1683726124636,SYN 2,003,201469,Staff,1,0,16,15
1683726125665,SYN 100,A01,187531,Staff,0,9,20,20
1683726125665,SYN 100,B01,201491,Staff,0,10,20,20
1683726126693,TDAC 1,A00,189286,Walsh; Kim C.,3,0,20,17
1683726126693,TDAC 1,B00,189287,Harting; Carla Kelso,10,0,20,10
1683726127718,TDAC 101,A00,189300,Walsh; Kim C.,16,0,20,4
1683726127718,TDAC 101,B00,189301,Harting; Carla Kelso,18,0,20,2
1683726128748,TDAC 102,A00,189304,Basso; Beatrice,14,0,20,6
1683726129776,TDAC 108,A00,189305,Staff,18,0,20,2
1683726130808,TDDE 131,A00,189310,Staff,19,0,20,1
1683726130808,TDDE 131,B00,189314,Staff,19,0,20,1
1683726130808,TDDE 131,C00,189315,Staff,48,0,50,2
1683726130808,TDDE 131,D00,189316,Staff,14,0,15,1
1683726130808,TDDE 131,E00,204841,Staff,20,0,20,0
1683726131836,TDGE 10,A00,189289,Staff,26,0,50,24
1683726131836,TDGE 10,B00,189290,Havis; Allan,0,1,50,50
1683726132867,TDGE 11,A00,189291,Fulton; Julia,0,4,50,50
1683726132867,TDGE 11,B00,189292,Staff,20,0,25,5
1683726132867,TDGE 11,C00,260270,Staff,0,0,0,0
1683726133898,TDGE 25,A00,189294,Staff,1,0,20,19
1683726134925,TDGE 124,A00,189318,Fulton; Julia,0,7,50,50
1683726135950,TDGE 125,A00,189319,Staff,13,0,25,12
1683726135950,TDGE 125,B00,189320,Staff,23,0,25,2
1683726136979,TDGE 127,A00,189322,Havis; Allan,1,0,50,49
1683726138006,TDHT 101,A00,189323,Staff,18,0,25,7
1683726138006,TDHT 101,B00,189324,Staff,25,0,25,0
1683726139031,TDHT 102,A00,189325,Staff,49,0,50,1
1683726140058,TDMV 1,A00,189295,Arcidiacono; Kristin,20,0,30,10
1683726140058,TDMV 1,B00,189296,Caligagan; Maria T.,23,0,30,7
1683726141085,TDMV 2,A00,189297,Sammartano; Tonnie,27,0,30,3
1683726141085,TDMV 2,B00,189299,Arcidiacono; Kristin,23,0,30,7
1683726142113,TDMV 3,A00,204998,Rincon; Alicia,22,0,30,8
1683726143142,TDMV 120,A00,189458,Sammartano; Tonnie,28,0,30,2
1683726144170,TDMV 138,A00,189541,Jun; Grace Shin Hae,20,0,40,20
1683726145200,TDMV 142,A00,189717,Caligagan; Tony,25,0,30,5
1683726145200,TDMV 142,B00,189718,Caligagan; Maria T.,25,0,30,5
1683726146227,TMC 2,A01,187533,Staff,25,0,25,0
1683726146227,TMC 2,A02,187534,Staff,25,0,25,0
1683726147259,USP 1,A01,187536,Kwak; Nancy,0,16,25,25
1683726148284,USP 5,A01,187538,Staff,8,0,25,17
1683726149309,USP 101,A00,199253,Staff,0,4,0,0
1683726150334,USP 124,A00,187562,Boomhower; Matthew Charles,0,0,30,30
1683726151362,USP 138,A00,187582,Staff,19,0,25,6
1683726152392,USP 152,A01,187597,Staff,3,0,25,22
1683726153418,USP 153,A00,187598,Staff,18,0,25,7
1683726154447,USP 168,A00,187607,Kwak; Nancy,2,0,5,3
1683726155475,USP 173,A00,187619,Staff,4,0,25,21
1683726156503,USP 181,A00,187638,Staff,0,4,25,25
1683726157531,VIS 103,A00,187650,Cruz; Edwin Teddy,17,0,75,58
1683726158557,VIS 110D,A00,187669,Staff,13,0,22,9
1683726159584,VIS 127C,A00,187720,Shen; Kuiyi,67,0,146,79
1683726160619,VIS 149,A00,187731,Yoldas; Pinar,0,12,22,22
1683726161644,VIS 151,A01,188091,Staff,22,0,34,12
1683726161644,VIS 151,A02,188092,Staff,11,0,34,23
1683726162673,VIS 160B,A00,188093,Stalbaum; Brett,0,1,10,10
1683726164728,WCWP 10B,A00,201720,Staff,0,0,5,5
1683726164728,WCWP 10B,B00,201722,Staff,0,0,6,6
1683726165754,WCWP 100,A00,201725,Gagnon; Jeffrey C,0,0,2,2
1683726165754,WCWP 100,B00,201727,Staff,0,4,15,15
1683726168915,ANBI 133,A00,258401,Wilder; Linnea Lorene,34,0,40,6
1683726169941,ANBI 140,A00,258395,Hrvoj Mihic; Branka,18,0,25,7
1683726170967,ANSC 120,A00,258402,Bialecki; Jon Anthony,26,0,40,14
1683726171993,ANSC 144,A00,258400,Staff,12,0,40,28
1683726174048,ANSC 166,A00,258396,Parish; Steven Martin,156,0,175,19
1683726175071,ANSC 180,A00,193533,Staff,8,0,20,12
1683726176104,ANSC 188,A00,258397,Jassal; Aftab,34,0,40,6
1683726177127,ANTH 3,A01,258316,Staff,23,0,30,7
1683726178151,ANTH 5,A00,258394,Semendeferi; Ekaterini,16,0,20,4
1683726179176,ANTH 21,A01,258331,Staff,4,0,40,36
1683726180203,ANTH 103,A00,258398,Varma; Saiba,15,0,25,10
1683726181310,AWP 10,001,202034,Staff,0,0,0,0
1683726181310,AWP 10,002,202035,Staff,0,0,0,0
1683726181310,AWP 10,003,202036,Staff,0,0,0,0
1683726181310,AWP 10,004,202037,Staff,0,0,0,0
1683726181310,AWP 10,005,202038,Staff,0,0,0,0
1683726181310,AWP 10,006,202039,Staff,0,0,0,0
1683726181310,AWP 10,007,202040,Staff,0,0,0,0
1683726181310,AWP 10,008,202041,Staff,0,0,0,0
1683726181310,AWP 10,009,202042,Staff,0,0,0,0
1683726181310,AWP 10,010,202043,Staff,0,0,0,0
1683726181310,AWP 10,011,202044,Staff,0,0,0,0
1683726181310,AWP 10,012,202045,Staff,0,0,0,0
1683726181310,AWP 10,013,202046,Staff,0,0,0,0
1683726181310,AWP 10,014,202047,Staff,0,0,0,0
1683726181310,AWP 10,015,202048,Staff,0,0,0,0
1683726181310,AWP 10,016,202049,Staff,0,0,0,0
1683726181310,AWP 10,017,202050,Staff,0,0,0,0
1683726181310,AWP 10,018,202051,Staff,0,0,0,0
1683726181310,AWP 10,019,202052,Staff,0,0,0,0
1683726181310,AWP 10,020,202053,Staff,0,0,0,0
1683726181310,AWP 10,021,202054,Staff,0,0,0,0
1683726181310,AWP 10,022,202055,Staff,0,0,0,0
1683726181310,AWP 10,023,202056,Staff,0,0,0,0
1683726181310,AWP 10,024,202057,Staff,0,0,0,0
1683726181310,AWP 10,025,202058,Staff,0,0,0,0
1683726181310,AWP 10,026,202059,Staff,0,0,0,0
1683726182338,AWP 102,001,202032,Staff,0,0,0,0
1683726182338,AWP 102,002,202033,Staff,0,0,0,0
1683726183369,BENG 100,A01,254234,Taylor Amos; Alyssa C,31,0,40,9
1683726184398,BENG 196,001,270013,Engler; Adam J.,9999,0,9999,0
1683726185423,BICD 100R,A01,202018,Smith; Laurie,0,7,32,32
1683726185423,BICD 100R,A02,202019,Smith; Laurie,0,3,32,32
1683726185423,BICD 100R,A03,202020,Smith; Laurie,0,1,32,32
1683726185423,BICD 100R,A04,202021,Smith; Laurie,6,0,32,26
1683726185423,BICD 100R,A05,202022,Smith; Laurie,10,0,32,22
1683726186450,BICD 136,A01,193242,Gustafson-Brown; Cindy,0,2,32,32
1683726186450,BICD 136,A02,193244,Gustafson-Brown; Cindy,13,0,32,19
1683726187477,BIEB 102,A01,193249,Butler; Shannon Rhey,0,0,32,32
1683726187477,BIEB 102,A02,193251,Butler; Shannon Rhey,0,0,32,32
1683726187477,BIEB 102,A03,193253,Butler; Shannon Rhey,0,0,32,32
1683726187477,BIEB 102,A04,193255,Butler; Shannon Rhey,13,0,32,19
1683726187477,BIEB 102,A05,193265,Butler; Shannon Rhey,25,0,32,7
1683726187477,BIEB 102,A06,193269,Butler; Shannon Rhey,12,0,32,20
1683726189531,BIEB 150,A01,193274,Staff,0,0,32,32
1683726189531,BIEB 150,A02,193285,Staff,24,0,32,8
1683726190561,BIEB 194,A00,193286,Kurle; Carolyn M.,19,0,32,13
1683726191588,BILD 1,A01,192291,Staff,15,0,32,17
1683726191588,BILD 1,A02,192292,Staff,30,0,32,2
1683726191588,BILD 1,B01,192520,Reuther; Keefe,0,1,0,0
1683726191588,BILD 1,B02,192532,Reuther; Keefe,0,1,0,0
1683726192620,BILD 3,A01,192556,Butler; Shannon Rhey,0,0,32,32
1683726192620,BILD 3,A02,192581,Butler; Shannon Rhey,0,1,32,32
1683726192620,BILD 3,A03,192611,Butler; Shannon Rhey,19,0,32,13
1683726192620,BILD 3,A04,192612,Butler; Shannon Rhey,23,0,32,9
1683726192620,BILD 3,A05,192613,Butler; Shannon Rhey,26,0,32,6
1683726192620,BILD 3,A06,192679,Butler; Shannon Rhey,27,0,32,5
1683726192620,BILD 3,A07,192682,Butler; Shannon Rhey,20,0,32,12
1683726193653,BILD 4,A01,192836,Reuther; Keefe,1,0,24,23
1683726193653,BILD 4,A02,193044,Reuther; Keefe,4,0,24,20
1683726194683,BILD 10,A01,193142,Gustafson-Brown; Cindy,29,0,32,3
1683726194683,BILD 10,A02,193149,Gustafson-Brown; Cindy,31,0,32,1
1683726195709,BIMM 100,A01,193301,Staff,0,6,32,32
1683726195709,BIMM 100,A02,193312,Staff,0,7,32,32
1683726195709,BIMM 100,A03,193323,Staff,0,10,32,32
1683726196735,BIMM 101,A01,193329,McDonnell; Lisa Marie,0,3,24,24
1683726196735,BIMM 101,A02,193339,McDonnell; Lisa Marie,0,3,24,24
1683726196735,BIMM 101,B01,193354,McDonnell; Lisa Marie,0,4,24,24
1683726196735,BIMM 101,B02,193357,McDonnell; Lisa Marie,0,3,24,24
1683726197761,BIMM 110,A01,193377,Tat; John,0,11,32,32
1683726197761,BIMM 110,A02,193378,Tat; John,0,11,32,32
1683726198797,BIMM 120,A01,206116,Staff,0,0,32,32
1683726198797,BIMM 120,A02,206117,Staff,7,0,32,25
1683726198797,BIMM 120,A03,206121,Staff,21,0,32,11
1683726199834,BIPN 100,A01,193393,Park; Ji Young,0,15,32,32
1683726199834,BIPN 100,A02,193402,Park; Ji Young,0,14,32,32
1683726199834,BIPN 100,A03,193413,Park; Ji Young,0,14,32,32
1683726199834,BIPN 100,A04,193414,Park; Ji Young,0,13,32,32
1683726200860,BIPN 102,A01,193429,Staff,0,0,32,32
1683726200860,BIPN 102,A02,193438,Staff,18,0,32,14
1683726201891,BIPN 106,A01,193450,Reyes Gonzalez; Catalina,0,2,40,40
1683726202916,BIPN 134,A01,193465,Cooke; James Edward,0,0,32,32
1683726202916,BIPN 134,A02,193474,Cooke; James Edward,25,0,32,7
1683726202916,BIPN 134,A03,193485,Cooke; James Edward,29,0,32,3
1683726202916,BIPN 134,A04,193486,Cooke; James Edward,20,0,32,12
1683726202916,BIPN 134,A05,193491,Cooke; James Edward,31,0,32,1
1683726202916,BIPN 134,A06,193501,Cooke; James Edward,30,0,32,2
1683726202916,BIPN 134,A07,193510,Cooke; James Edward,29,0,32,3
1683726204969,BISP 194,A00,222522,Staff,14,0,32,18
1683726205993,CAT 124,A01,202407,Staff,19,0,25,6
1683726207017,CAT 125,A00,202408,Marchisotto; Jennifer Anne,2,0,20,18
1683726208044,CAT 125R,A00,202409,Smith; Lauryn Alissa,0,11,20,20
1683726208044,CAT 125R,B00,202410,Morales; Celeste Georgianna,0,11,20,20
1683726208044,CAT 125R,C00,202411,Irwin; Matthew Joseph,0,12,20,20
1683726209071,CENG 15,A01,204712,Yang; Kesong,0,1,0,0
1683726210098,CENG 114,A00,202070,Jahed Motlagh; Zeinab,5,0,20,15
1683726211122,CGS 105,A00,185477,Wesling; Megan E.,24,0,40,16
1683726212146,CGS 106,A00,185494,Staff,11,0,22,11
1683726213174,CGS 108,A00,185495,Staff,14,0,20,6
1683726214201,CGS 114,A00,185496,Staff,13,0,18,5
1683726215227,CGS 119,A00,185501,Staff,15,0,20,5
1683726216252,CGS 120,A00,185511,Staff,11,0,20,9
1683726217281,CHEM 4,A01,184675,Bussey; Thomas J,97,0,100,3
1683726218308,CHEM 6A,A01,184677,Staff,32,0,60,28
1683726219332,CHEM 6B,A01,184679,Staff,63,0,100,37
1683726220358,CHEM 6C,A01,184681,Bussey; Thomas J,0,0,50,50
1683726220358,CHEM 6C,A02,184682,Bussey; Thomas J,32,0,50,18
1683726221384,CHEM 40A,A01,184684,Albizati; Kim F.,33,0,100,67
1683726222409,CHEM 40B,A01,184686,Albizati; Kim F.,0,22,100,100
1683726223437,CHEM 41B,A01,184690,Staff,51,0,100,49
1683726224463,COGS 3,A01,184715,Boyle; Mary E. T.,0,27,40,40
1683726225487,COGS 14B,A01,185172,Staff,0,14,38,38
1683726226516,COGS 18,A01,184736,Staff,14,0,80,66
1683726227542,COGS 100,A01,184932,Staff,0,8,73,73
1683726228571,COGS 101A,A01,184935,Staff,0,40,30,30
1683726229597,COGS 101B,A01,184944,Staff,0,2,30,30
1683726230621,COGS 101C,A01,184946,Staff,0,10,30,30
1683726231646,COGS 102A,A01,184951,Johnson; Christine M.,1,0,40,39
1683726232672,COGS 107B,A01,184953,Mooshagian; Eric Frederick,0,52,40,40
1683726233702,COGS 118B,A01,184959,Gupta; Anjum,0,50,40,40
1683726234731,COGS 153,A00,184961,Staff,1,16,30,29
1683726235756,COGS 177,A00,184962,Staff,0,20,30,30
1683726236782,COGS 187A,A01,184969,Boyle; Mary E. T.,0,19,40,40
1683726237808,COMM 10,A01,185174,Staff,0,5,25,25
1683726237808,COMM 10,A02,185189,Staff,0,2,25,25
1683726237808,COMM 10,A03,269821,Staff,0,1,0,0
1683726238839,COMM 100B,A02,185476,Staff,10,0,25,15
1683726238839,COMM 100B,A03,277340,Staff,25,0,25,0
1683726239867,COMM 100C,A01,185314,Staff,2,0,25,23
1683726239867,COMM 100C,A02,185327,Staff,17,0,25,8
1683726240892,COMM 110M,A00,185349,Staff,0,0,40,40
1683726241926,COMM 113T,A00,185352,Staff,25,0,40,15
1683726242952,COMM 114I,A00,185353,Staff,31,0,40,9
1683726243980,COMM 131,A00,185354,Staff,17,0,30,13
1683726245008,CSE 8A,A50,185358,Cao; Yingjun,0,46,10,10
1683726246034,CSE 8B,A01,185362,Staff,0,48,50,50
1683726247060,CSE 11,A01,185416,Cao; Yingjun,0,91,10,10
1683726248085,CSE 20,A01,185445,Briones; Jor-el Thomas Caparas,3,0,25,22
1683726249114,CSE 21,A01,185447,Staff,9,0,50,41
1683726250141,CSE 101,A01,185451,Staff,0,13,50,50
1683726250141,CSE 101,B01,185453,Jones; Miles E,0,15,50,50
1683726252194,CSE 141,A01,185458,Eldon; John,16,0,100,84
1683726253223,CSE 141L,A01,185461,Eldon; John,8,0,100,92
1683726254253,CSE 142,A01,185463,Staff,34,0,60,26
1683726254253,CSE 142,B01,201355,Staff,0,7,60,60
1683726255281,CSE 142L,A01,185470,Staff,34,0,60,26
1683726255281,CSE 142L,B01,201417,Staff,0,6,60,60
1683726256306,CSE 190,A00,201433,Staff,32,0,49,17
1683726257334,DOC 1,A01,259136,Strom; Megan C.,7,0,15,8
1683726257334,DOC 1,A02,259137,Strom; Megan C.,15,0,15,0
1683726257334,DOC 1,A03,259138,Strom; Megan C.,14,0,15,1
1683726257334,DOC 1,A04,259139,Strom; Megan C.,13,0,15,2
1683726258360,DOC 100D,A00,259140,Pass; Natalye Joann,14,0,25,11
1683726259390,DSGN 1,A01,184749,Rill; Bryan,0,26,30,30
1683726260419,DSGN 100,A01,185168,Staff,0,2,25,25
1683726261445,ECE 5,A01,185626,Morris; Karcher William,0,12,0,0
1683726262471,ECE 101,A01,185628,Staff,14,0,70,56
1683726263496,ECE 107,A01,185635,Baghdadchi; Saharnaz,0,0,20,20
1683726263496,ECE 107,A02,185638,Baghdadchi; Saharnaz,1,0,20,19
1683726264524,ECE 148,A01,185647,Silberman; Jack,0,0,16,16
1683726265548,ECON 1,A01,185537,Crane; Meredith Helen,54,0,70,16
1683726266573,ECON 3,A01,185549,Crane; Meredith Helen,30,0,70,40
1683726267603,ECON 4,A01,203354,Anderson; John Charles,0,5,10,10
1683726268631,ECON 100A,A01,185574,Staff,0,5,40,40
1683726269658,ECON 100B,A01,185576,Staff,0,12,50,50
1683726270687,ECON 100C,A01,185589,Newhouse; Herbert S,30,0,70,40
1683726271714,ECON 105,A00,185608,Vespa; Emanuel Ignacio,19,0,35,16
1683726272738,ECON 109,A01,185610,Shishkin; Denis,9,0,35,26
1683726273765,ECON 110A,A01,185612,Staff,8,0,40,32
1683726274790,ECON 120A,A01,185615,Staff,19,0,40,21
1683726275815,ECON 120C,A01,185617,Sun; Yixiao,0,21,70,70
1683726276842,ECON 144,A00,203346,Squires; Dale E,2,0,35,33
1683726277867,ECON 171,A01,203349,Newhouse; Herbert S,0,1,35,35
1683726278893,ECON 173A,A01,185621,Toda; Alexis Akira,21,0,35,14
1683726279925,EDS 25,A01,202413,Staff,0,1,0,0
1683726279925,EDS 25,A02,202414,Staff,0,1,0,0
1683726279925,EDS 25,A03,202415,Staff,0,0,0,0
1683726279925,EDS 25,A04,202416,Staff,0,1,0,0
1683726279925,EDS 25,A05,202439,Staff,0,0,0,0
1683726279925,EDS 25,A06,202440,Staff,0,0,0,0
1683726279925,EDS 25,B01,202631,Staff,0,0,0,0
1683726279925,EDS 25,B02,202632,Staff,0,0,0,0
1683726279925,EDS 25,B03,202639,Staff,0,0,0,0
1683726279925,EDS 25,B04,202640,Staff,0,0,0,0
1683726279925,EDS 25,B05,202643,Staff,0,0,0,0
1683726279925,EDS 25,B06,202644,Staff,0,0,0,0
1683726280956,EDS 38,A01,202659,Black; Alison Michelle,25,0,25,0
1683726281982,EDS 115,A00,202652,Staff,18,0,30,12
1683726283007,EDS 125,A00,202649,Staff,13,0,30,17
1683726284034,EDS 126,A01,203332,Staff,30,0,30,0
1683726285116,EDS 139,A00,202838,Staff,16,0,25,9
1683726286145,EDS 146,A01,202655,Staff,14,0,25,11
1683726287171,ENG 15,A00,185667,Staff,0,1,0,0
1683726287171,ENG 15,B00,185672,Staff,0,0,0,0
1683726287171,ENG 15,C00,185675,Staff,0,0,0,0
1683726287171,ENG 15,D00,185682,Staff,0,0,0,0
1683726287171,ENG 15,E00,185684,Staff,0,0,0,0
1683726288198,ETHN 103,A00,185710,Staff,0,8,35,35
1683726289226,ETHN 103A,A00,199228,Man; Simeon S,0,0,9,9
1683726290251,ETHN 109,A00,185711,Staff,15,0,35,20
1683726291275,ETHN 142,A00,185726,Staff,0,4,30,30
1683726292305,ETHN 163J,A00,199229,Man; Simeon S,5,0,8,3
1683726293330,ETHN 168,A00,185727,Staff,7,0,10,3
1683726294354,ETHN 182,A00,185728,Staff,0,0,35,35
1683726295379,ETHN 183,A00,185737,Staff,10,0,18,8
1683726296403,GLBH 111,A01,209361,Burgos; Jose L.,0,0,0,0
1683726298455,HIEU 104,A00,185792,Staff,14,0,20,6
1683726299484,HIEU 115,A00,185800,Staff,0,0,20,20
1683726300511,HIEU 128,A00,185801,Staff,0,9,20,20
1683726301536,HIEU 147,A00,185802,Staff,15,0,20,5
1683726302562,HIEU 154,A00,185823,Staff,11,0,20,9
1683726303587,HILA 102,A00,185826,Staff,14,0,20,6
1683726304613,HILD 2C,A01,185778,Staff,0,13,20,20
1683726305643,HILD 7B,A01,185780,Kwak; Nancy,0,17,32,32
1683726305643,HILD 7B,A02,185781,Kwak; Nancy,0,18,32,32
1683726306671,HILD 30,A01,185791,Staff,12,0,20,8
1683726307699,HISC 119,A00,185830,Golan; Tal,0,10,20,20
1683726308724,HITO 156GS,A00,185831,Patterson; Patrick H.,0,0,0,23
1683726309751,HIUS 103,A00,185832,Man; Simeon S,0,4,20,20
1683726310776,HIUS 117,A00,185836,Kwak; Nancy,2,0,20,18
1683726311801,HIUS 125,A00,185840,Man; Simeon S,0,2,23,23
1683726312827,HIUS 149,A00,185845,Staff,1,0,20,19
1683726313853,HUM 3,A01,185882,Zavodny; Tatiana Sophia,0,8,50,50
1683726313853,HUM 3,B01,185899,Caldwell; Michael Alan,0,18,50,50
1683726314878,HUM 3GS,A00,185900,Patterson; Patrick H.,0,0,0,23
1683726315913,HUM 4,A01,185938,Zroka; Amy Liane,28,0,50,22
1683726315913,HUM 4,B01,185956,Watkins; Eric,0,6,50,50
1683726315913,HUM 4,B02,202209,Watkins; Eric,0,6,50,50
1683726315913,HUM 4,B03,202210,Watkins; Eric,0,5,50,50
1683726316941,HUM 5,A01,185958,West; Geoffrey Scott,0,0,50,50
1683726316941,HUM 5,A02,202215,West; Geoffrey Scott,0,1,50,50
1683726317970,INTL 190,A00,185959,Gagnon; Jeffrey C,0,0,0,9
1683726317970,INTL 190,B00,185960,Lettieri; Michael Joseph,0,0,0,2
1683726318994,JAPN 180,A00,254509,Staff,4,0,30,26
1683726320026,LATI 10,A01,202853,Kennemore; Amy Michelle,4,0,35,31
1683726320026,LATI 10,A02,202854,Kennemore; Amy Michelle,3,0,35,32
1683726320026,LATI 10,A03,270054,Kennemore; Amy Michelle,30,0,30,0
1683726321055,LATI 180,A00,202855,Kennemore; Amy Michelle,11,0,20,9
1683726322079,LAWS 101,A00,201767,Golan; Tal,0,7,40,40
1683726323103,LIFR 1C,A00,185961,Staff,6,0,20,14
1683726324134,LIFR 1CX,A00,185962,Staff,7,0,20,13
1683726325157,LIFR 1D,A00,185963,Staff,7,0,20,13
1683726326185,LIFR 1DX,A00,185964,Staff,7,0,20,13
1683726327213,LIGN 101,A01,186039,Staff,43,0,50,7
1683726328235,LIGN 165,A00,186040,Staff,14,0,50,36
1683726329259,LTCS 108,A00,186041,Staff,5,0,10,5
1683726330286,LTCS 119,A00,186042,Staff,15,0,20,5
1683726331310,LTCS 130,A00,186043,Wesling; Megan E.,15,0,25,10
1683726333366,LTEA 138,A00,186119,Staff,13,0,40,27
1683726334390,LTEN 124,A00,186148,Staff,5,0,25,20
1683726335414,LTEN 178,A00,186149,Staff,6,0,15,9
1683726336443,LTEN 181,A00,186150,Blanco; John D,34,0,40,6
1683726337468,LTWL 120,A00,186160,Staff,19,0,25,6
1683726338494,LTWL 165,A00,186161,Staff,22,0,25,3
1683726339518,LTWR 100,A00,186162,Staff,0,5,15,15
1683726340546,LTWR 102,A00,186163,Doller; Ben,5,0,15,10
1683726341571,MAE 8,A01,186412,Staff,0,1,0,0
1683726342601,MAE 30B,A00,186445,Bahadori; Mohammad Yousef,81,0,100,19
1683726343626,MAE 40,A00,186592,Bewley; Thomas R,10,0,50,40
1683726344650,MAE 101B,A00,186593,Bahadori; Mohammad Yousef,80,0,100,20
1683726345675,MAE 105,A00,186594,Bandaru; Prabhakar,10,0,50,40
1683726346699,MAE 107,A00,186599,Pham; Hieu Tan,0,8,120,120
1683726347726,MAE 148,A01,186660,Silberman; Jack,3,0,16,13
1683726348754,MATH 10A,A01,188095,Staff,0,6,35,35
1683726349786,MATH 10B,A01,188097,Bowers; Adam R.,0,12,30,30
1683726349786,MATH 10B,A02,188099,Bowers; Adam R.,0,11,30,30
1683726349786,MATH 10B,B01,188104,Bowers; Adam R.,0,10,30,30
1683726349786,MATH 10B,B02,188106,Bowers; Adam R.,0,9,30,30
1683726350813,MATH 10C,A01,188111,Staff,0,20,30,30
1683726350813,MATH 10C,A02,188127,Staff,0,19,30,30
1683726350813,MATH 10C,A03,188131,Staff,0,19,30,30
1683726350813,MATH 10C,B01,188218,Staff,17,0,30,13
1683726350813,MATH 10C,B02,188244,Staff,13,0,30,17
1683726350813,MATH 10C,B03,188277,Staff,14,0,30,16
1683726351838,MATH 18,A01,188344,Bach; Quang Tran,18,0,30,12
1683726351838,MATH 18,A02,188345,Bach; Quang Tran,11,0,30,19
1683726351838,MATH 18,B01,188353,Bach; Quang Tran,11,0,30,19
1683726351838,MATH 18,B02,188354,Bach; Quang Tran,19,0,30,11
1683726352867,MATH 20A,A01,188374,Staff,10,0,35,25
1683726353897,MATH 20B,A01,188382,Ohm; Ko Woon,7,0,30,23
1683726353897,MATH 20B,A02,188383,Ohm; Ko Woon,22,0,30,8
1683726353897,MATH 20B,B01,188385,Ohm; Ko Woon,7,0,30,23
1683726353897,MATH 20B,B02,188392,Ohm; Ko Woon,22,0,30,8
1683726354922,MATH 20C,A01,188394,Harel; Guershon,10,0,30,20
1683726354922,MATH 20C,A02,188395,Harel; Guershon,13,0,30,17
1683726354922,MATH 20C,B01,188404,Harel; Guershon,5,0,30,25
1683726354922,MATH 20C,B02,188405,Harel; Guershon,18,0,30,12
1683726355949,MATH 20D,A01,188414,Hammock; Frances H,0,1,30,30
1683726355949,MATH 20D,A02,188415,Hammock; Frances H,0,1,30,30
1683726355949,MATH 20D,B01,188447,Hammock; Frances H,0,1,30,30
1683726355949,MATH 20D,B02,188486,Hammock; Frances H,2,0,30,28
1683726356976,MATH 20E,A01,188649,Staff,21,0,30,9
1683726356976,MATH 20E,A02,188650,Staff,20,0,30,10
1683726356976,MATH 20E,A03,188673,Staff,0,0,30,30
1683726358001,MATH 102,A01,188675,Staff,0,40,35,35
1683726359028,MATH 103B,A01,188681,Staff,3,0,35,32
1683726359028,MATH 103B,B01,188692,Staff,5,0,35,30
1683726360052,MATH 109,A01,188695,Salehi Golsefidy; Alireza,24,0,35,11
1683726360052,MATH 109,A02,188696,Salehi Golsefidy; Alireza,24,0,35,11
1683726361113,MATH 120A,A01,188698,Eggers; John Dietrich,7,0,35,28
1683726362142,MATH 142B,A01,188736,Ioana; Adrian,0,0,30,30
1683726362142,MATH 142B,A02,188741,Ioana; Adrian,0,1,30,30
1683726362142,MATH 142B,A03,188743,Ioana; Adrian,0,3,30,30
1683726363166,MATH 168A,A01,188790,Staff,0,11,35,35
1683726364193,MATH 170A,A01,188803,Nie; Jiawang,0,2,35,35
1683726364193,MATH 170A,A02,188811,Nie; Jiawang,0,1,35,35
1683726364193,MATH 170A,A03,188814,Nie; Jiawang,1,0,35,34
1683726364193,MATH 170A,A04,188815,Nie; Jiawang,5,0,35,30
1683726365219,MATH 193B,A01,188817,Staff,0,0,35,35
1683726365219,MATH 193B,A02,188818,Staff,6,0,35,29
1683726366244,MGT 4,A01,202857,Anderson; John Charles,59,0,80,21
1683726367273,MGT 12,A00,202858,Lindenberger; Wade Douglas,40,0,90,50
1683726368298,MGT 18,A00,202859,Staff,73,0,90,17
1683726369325,MGT 18GS,A00,202860,McKay; Michael J,13,0,28,15
1683726370359,MGT 45,A00,202861,Pecore; Joseph P.,8,0,90,82
1683726371384,MGT 100,A00,202863,Yavorsky; Daniel Ryan,27,0,90,63
1683726372408,MGT 103,A00,202864,Ehrich; Kristine R,0,19,90,90
1683726373437,MGT 112,A00,202865,Ehrich; Kristine R,15,0,90,75
1683726374467,MGT 121A,A00,202868,Staff,70,0,90,20
1683726375495,MGT 131B,A00,202869,Anderson; John Charles,58,0,90,32
1683726376520,MGT 136,A00,202871,Lindenberger; Wade Douglas,83,0,90,7
1683726377545,MGT 164,A00,202873,Staff,0,67,90,91
1683726378575,MGT 164GS,A00,202874,McKay; Mary A,13,0,28,15
1683726379599,MGT 180,A00,202875,Staff,0,51,90,91
1683726380626,MMW 11R,A01,205019,Herbst; Matthew,0,0,30,30
1683726380626,MMW 11R,A02,205026,Herbst; Matthew,29,0,30,1
1683726381658,MMW 15,A01,193512,Chang; Edmond Yi-Teh,0,8,28,28
1683726381658,MMW 15,A02,193513,Chang; Edmond Yi-Teh,0,5,28,28
1683726381658,MMW 15,A03,193514,Chang; Edmond Yi-Teh,0,5,28,28
1683726381658,MMW 15,A04,193515,Chang; Edmond Yi-Teh,0,5,28,28
1683726381658,MMW 15,A05,193516,Chang; Edmond Yi-Teh,0,5,28,28
1683726381658,MMW 15,A06,193517,Chang; Edmond Yi-Teh,0,6,28,28
1683726381658,MMW 15,B01,193519,Chang; Edmond Yi-Teh,0,5,28,28
1683726381658,MMW 15,B02,193520,Chang; Edmond Yi-Teh,0,5,28,28
1683726381658,MMW 15,B03,193521,Chang; Edmond Yi-Teh,0,5,28,28
1683726381658,MMW 15,B04,193522,Chang; Edmond Yi-Teh,0,6,28,28
1683726381658,MMW 15,B05,193523,Chang; Edmond Yi-Teh,0,5,28,28
1683726381658,MMW 15,B06,193524,Chang; Edmond Yi-Teh,0,5,28,28
1683726382687,MMW 122,A01,193526,Rahimi; Babak,0,16,28,28
1683726382687,MMW 122,A02,193527,Rahimi; Babak,0,15,28,28
1683726382687,MMW 122,A03,193528,Rahimi; Babak,0,0,0,0
1683726382687,MMW 122,A04,193529,Rahimi; Babak,0,0,0,0
1683726383717,MUS 1A,A01,186663,Staff,0,18,35,35
1683726384741,MUS 4,A01,186715,Staff,0,12,35,35
1683726385773,MUS 5R,A01,186796,Dubnov; Shlomo,0,17,35,35
1683726386798,MUS 6,A01,186798,Staff,0,4,25,25
1683726387824,MUS 7,A01,186830,Staff,11,0,35,24
1683726388910,MUS 8,A01,186930,Staff,0,27,35,35
1683726389937,MUS 15,A01,186932,Staff,0,15,35,35
1683726389937,MUS 15,B01,186934,Staff,0,16,35,35
1683726390963,MUS 80,A00,186935,Staff,0,0,20,20
1683726390963,MUS 80,B00,186936,Staff,24,0,25,1
1683726391994,NANO 11,A00,204702,Lipomi; Darren John,0,0,0,0
1683726393026,NANO 15,A01,204709,Yang; Kesong,0,1,0,0
1683726394054,NANO 114,A00,202069,Jahed Motlagh; Zeinab,2,0,10,8
1683726395080,PHIL 1,A00,186955,Grush; Rick Scott,31,0,40,9
1683726396107,PHIL 10,A01,186973,Grush; Rick Scott,27,0,35,8
1683726396107,PHIL 10,A02,186974,Grush; Rick Scott,33,0,35,2
1683726397136,PHIL 13,A01,186976,Staff,1,0,35,34
1683726397136,PHIL 13,A02,186977,Staff,16,0,35,19
1683726398161,PHIL 14,A01,186979,Staff,30,0,35,5
1683726398161,PHIL 14,A02,186986,Staff,32,0,35,3
1683726399187,PHIL 28,A01,186988,Staff,16,0,30,14
1683726399187,PHIL 28,A02,186989,Staff,0,0,30,30
1683726399187,PHIL 28,A03,186990,Staff,10,0,30,20
1683726399187,PHIL 28,A04,186991,Staff,26,0,30,4
1683726400212,PHIL 120,A00,186997,Staff,23,0,40,17
1683726401240,PHIL 137,A00,187003,Staff,8,0,40,32
1683726402265,PHIL 150,A00,187015,Staff,47,0,70,23
1683726403294,PHIL 167,A00,187021,Lamey; Andy M.,34,0,40,6
1683726404318,PHIL 174,A01,202226,Staff,17,0,20,3
1683726404318,PHIL 174,A02,202235,Staff,20,0,20,0
1683726405347,PHIL 191A,A00,258918,Staff,0,0,1,1
1683726406373,PHYS 1A,A00,187028,Staff,26,0,60,34
1683726407396,PHYS 1AL,001,187036,Staff,3,0,30,27
1683726407396,PHYS 1AL,002,187049,Staff,18,0,30,12
1683726408421,PHYS 1B,A00,187058,Staff,21,0,60,39
1683726409453,PHYS 1BL,001,187064,Staff,0,1,30,30
1683726409453,PHYS 1BL,002,187070,Staff,4,0,30,26
1683726410484,PHYS 1C,A00,187082,Staff,30,0,120,90
1683726411509,PHYS 1CL,001,187088,Staff,0,9,30,30
1683726411509,PHYS 1CL,002,187089,Staff,0,1,30,30
1683726411509,PHYS 1CL,009,262693,Staff,9,0,30,21
1683726412535,PHYS 2B,A01,187097,Staff,55,0,115,60
1683726413561,PHYS 2C,A01,187099,Staff,63,0,115,52
1683726414591,PHYS 2CL,A01,187101,Staff,5,0,28,23
1683726414591,PHYS 2CL,A02,187102,Staff,15,0,28,13
1683726415617,PHYS 2D,A01,187123,Shotwell; Brian,95,0,115,20
1683726416646,PHYS 4B,A01,187133,Grinstein; Benjamin,35,0,50,15
1683726417671,POLI 10,A00,188819,Staff,0,4,50,50
1683726418697,POLI 11,A00,188827,Staff,43,0,50,7
1683726419724,POLI 13R,A00,188828,Staff,0,2,20,20
1683726420750,POLI 27,A01,188830,Elgin; Samuel Zincke,0,2,70,70
1683726421781,POLI 30,A00,188832,Desposato; Scott,30,0,50,20
1683726422809,POLI 102F,A00,188834,Staff,1,0,40,39
1683726423834,POLI 104A,A00,188852,Staff,12,0,30,18
1683726424862,POLI 104I,A00,188853,Staff,0,8,20,20
1683726425891,POLI 110B,A00,188854,Wiens; David,6,0,20,14
1683726426916,POLI 112A,A00,188855,Wiens; David,3,0,30,27
1683726427946,POLI 117R,A00,188856,Forman; Fonna,0,12,20,20
1683726428977,POLI 118,A00,188857,Ingham; Sean,8,0,20,12
1683726430001,POLI 120G,A00,188858,Staff,7,0,30,23
1683726431029,POLI 131CR,A00,188863,Hoston; Germaine,20,0,50,30
1683726432055,POLI 133,A00,188864,Nellis; Gareth Hb,44,0,50,6
1683726433080,POLI 134D,A00,188865,Desposato; Scott,27,0,30,3
1683726434106,POLI 142A,A00,188871,Gartzke; Erik,21,0,50,29
1683726435130,POLI 142K,A00,188874,Staff,38,0,50,12
1683726436155,POLI 143,A00,188940,Gartzke; Erik,15,0,30,15
1683726437179,POLI 153,A00,188943,Staff,1,0,20,19
1683726438204,POLI 160AA,A00,188944,Staff,10,0,40,30
1683726439232,POLI 170A,A00,188945,Staff,10,0,30,20
1683726441286,PSYC 1,A00,188952,Staff,36,0,90,54
1683726442310,PSYC 2,B00,188953,Staff,19,0,35,16
1683726443335,PSYC 6,A00,188970,Staff,47,0,60,13
1683726444363,PSYC 7,A00,188973,Staff,35,0,45,10
1683726445390,PSYC 60,A01,188980,Rickard; Timothy C.,42,0,60,18
1683726446416,PSYC 70,A01,189001,Steiner; Eric Tomas,22,0,45,23
1683726447441,PSYC 100,A00,189005,Lacefield; Katharine I,1,98,120,119
1683726448466,PSYC 102,A00,189008,Staff,6,0,30,24
1683726449490,PSYC 106,B00,189026,Gorman; Michael R.,27,0,60,33
1683726450515,PSYC 114,B01,189033,Winkielman; Piotr,0,31,30,30
1683726451540,PSYC 131,A00,189036,Anagnostaras; Stephan,0,44,60,60
1683726452566,PSYC 136,A00,189041,Lowe; Angela Beth,0,7,25,25
1683726453594,PSYC 137,A00,189057,Winkielman; Piotr,0,36,25,25
1683726454624,PSYC 144,A00,189107,Wixted; John T,0,11,50,50
1683726456677,PSYC 162,A00,189142,Staff,0,9,85,85
1683726457705,PSYC 172,A00,189144,Gorman; Michael R.,0,6,30,30
1683726459758,PSYC 179,A00,189146,Lacefield; Katharine I,0,88,120,120
1683726460783,PSYC 181,A00,189147,Anagnostaras; Stephan,0,45,90,90
1683726461808,PSYC 190R,A00,189148,Barner; David A.,0,23,80,80
1683726462839,PSYC 191,A00,189275,Rickard; Timothy C.,0,11,25,25
1683726463864,PSYC 193,A00,189276,Chapman; Eddie Nathaniel,0,1,0,4
1683726464891,PSYC 193L,A01,189281,Lowe; Angela Beth,8,0,20,12
1683726464891,PSYC 193L,B01,189285,Staff,28,0,35,7
1683726465921,RELI 149,A00,187137,Rahimi; Babak,6,0,40,34
1683726466951,SE 9,A01,187315,Staff,0,2,18,18
1683726467976,SE 101B,A00,187409,Staff,24,0,30,6
1683726469005,SE 110B,A00,187444,Staff,10,0,40,30
1683726470030,SE 130B,A00,187449,Staff,31,0,40,9
1683726471060,SE 150A,A00,187516,Staff,8,0,20,12
1683726472088,SE 154,A00,187528,Staff,29,0,50,21
1683726473117,SIO 3,A01,258171,Staff,35,0,40,5
1683726474142,SIO 10,A00,187144,Cook; Geoffrey W,0,6,75,75
1683726475166,SIO 45,A00,187152,Cook; Geoffrey W,1,7,100,99
1683726476192,SIO 109R,A00,194486,Staff,0,4,20,20
1683726478241,SIO 187,A01,187233,Kacev; David,12,0,40,28
1683726479272,SOCI 1,A01,258656,Thorpe; Charles Robert,28,0,30,2
1683726479272,SOCI 1,A02,258658,Thorpe; Charles Robert,30,0,30,0
1683726479272,SOCI 1,A03,258661,Thorpe; Charles Robert,25,0,25,0
1683726479272,SOCI 1,A04,258666,Thorpe; Charles Robert,22,0,25,3
1683726479272,SOCI 1,A05,258897,Thorpe; Charles Robert,22,0,25,3
1683726479272,SOCI 1,A06,258898,Thorpe; Charles Robert,25,0,25,0
1683726480301,SOCI 30,A01,258903,Pardo Guerra; Juan Pablo,14,0,30,16
1683726481328,SOCI 102,A00,258904,Staff,9,0,25,16
1683726482354,SOCI 106,A00,258905,Staff,19,0,25,6
1683726483384,SOCI 111,A00,258907,Ribas Norris; Janet Vanesa,26,0,30,4
1683726484409,SOCI 121R,A00,258908,Pardo Guerra; Juan Pablo,7,0,30,23
1683726485434,SOCI 126,A01,203330,Staff,14,0,20,6
1683726486465,SOCI 131,A00,258909,Thorpe; Charles Robert,30,0,60,30
1683726487490,SOCI 135,A00,258910,Payne; Christine Anna,0,13,30,30
1683726488519,SOCI 157,A00,258911,Staff,10,0,30,20
1683726489544,SOCI 184,A00,258912,Staff,25,0,30,5
1683726490569,SOCI 188D,A00,258913,Staff,22,0,30,8
1683726491594,SYN 2,001,187529,Staff,9,0,16,7
1683726491594,SYN 2,002,201452,Staff,0,20,16,16
1683726491594,SYN 2,003,201469,Staff,1,0,16,15
1683726492675,SYN 100,A01,187531,Staff,0,9,20,20
1683726492675,SYN 100,B01,201491,Staff,0,10,20,20
1683726493706,TDAC 1,A00,189286,Walsh; Kim C.,3,0,20,17
1683726493706,TDAC 1,B00,189287,Harting; Carla Kelso,10,0,20,10
1683726494732,TDAC 101,A00,189300,Walsh; Kim C.,16,0,20,4
1683726494732,TDAC 101,B00,189301,Harting; Carla Kelso,18,0,20,2
1683726495759,TDAC 102,A00,189304,Basso; Beatrice,14,0,20,6
1683726496788,TDAC 108,A00,189305,Staff,18,0,20,2
1683726497814,TDDE 131,A00,189310,Staff,19,0,20,1
1683726497814,TDDE 131,B00,189314,Staff,19,0,20,1
1683726497814,TDDE 131,C00,189315,Staff,48,0,50,2
1683726497814,TDDE 131,D00,189316,Staff,14,0,15,1
1683726497814,TDDE 131,E00,204841,Staff,20,0,20,0
1683726498839,TDGE 10,A00,189289,Staff,26,0,50,24
1683726498839,TDGE 10,B00,189290,Havis; Allan,0,1,50,50
1683726499870,TDGE 11,A00,189291,Fulton; Julia,0,4,50,50
1683726499870,TDGE 11,B00,189292,Staff,20,0,25,5
1683726499870,TDGE 11,C00,260270,Staff,0,0,0,0
1683726500894,TDGE 25,A00,189294,Staff,1,0,20,19
1683726501918,TDGE 124,A00,189318,Fulton; Julia,0,7,50,50
1683726502942,TDGE 125,A00,189319,Staff,13,0,25,12
1683726502942,TDGE 125,B00,189320,Staff,23,0,25,2
1683726503971,TDGE 127,A00,189322,Havis; Allan,1,0,50,49
1683726504997,TDHT 101,A00,189323,Staff,18,0,25,7
1683726504997,TDHT 101,B00,189324,Staff,25,0,25,0
1683726506024,TDHT 102,A00,189325,Staff,49,0,50,1
1683726507056,TDMV 1,A00,189295,Arcidiacono; Kristin,20,0,30,10
1683726507056,TDMV 1,B00,189296,Caligagan; Maria T.,23,0,30,7
1683726508086,TDMV 2,A00,189297,Sammartano; Tonnie,27,0,30,3
1683726508086,TDMV 2,B00,189299,Arcidiacono; Kristin,23,0,30,7
1683726509112,TDMV 3,A00,204998,Rincon; Alicia,22,0,30,8
1683726510135,TDMV 120,A00,189458,Sammartano; Tonnie,28,0,30,2
1683726511162,TDMV 138,A00,189541,Jun; Grace Shin Hae,20,0,40,20
1683726512186,TDMV 142,A00,189717,Caligagan; Tony,25,0,30,5
1683726512186,TDMV 142,B00,189718,Caligagan; Maria T.,25,0,30,5
1683726513211,TMC 2,A01,187533,Staff,25,0,25,0
1683726513211,TMC 2,A02,187534,Staff,25,0,25,0
1683726514240,USP 1,A01,187536,Kwak; Nancy,0,16,25,25
1683726515265,USP 5,A01,187538,Staff,8,0,25,17
1683726516290,USP 101,A00,199253,Staff,0,4,0,0
1683726517317,USP 124,A00,187562,Boomhower; Matthew Charles,0,0,30,30
1683726518342,USP 138,A00,187582,Staff,19,0,25,6
1683726519372,USP 152,A01,187597,Staff,3,0,25,22
1683726520400,USP 153,A00,187598,Staff,18,0,25,7
1683726521429,USP 168,A00,187607,Kwak; Nancy,2,0,5,3
1683726522454,USP 173,A00,187619,Staff,4,0,25,21
1683726523483,USP 181,A00,187638,Staff,0,4,25,25
1683726524509,VIS 103,A00,187650,Cruz; Edwin Teddy,17,0,75,58
1683726525534,VIS 110D,A00,187669,Staff,13,0,22,9
1683726526559,VIS 127C,A00,187720,Shen; Kuiyi,67,0,146,79
1683726527590,VIS 149,A00,187731,Yoldas; Pinar,0,12,22,22
1683726528616,VIS 151,A01,188091,Staff,22,0,34,12
1683726528616,VIS 151,A02,188092,Staff,11,0,34,23
1683726529642,VIS 160B,A00,188093,Stalbaum; Brett,0,1,10,10
1683726531696,WCWP 10B,A00,201720,Staff,0,0,5,5
1683726531696,WCWP 10B,B00,201722,Staff,0,0,6,6
1683726532728,WCWP 100,A00,201725,Gagnon; Jeffrey C,0,0,2,2
1683726532728,WCWP 100,B00,201727,Staff,0,4,15,15
1683726535841,ANBI 133,A00,258401,Wilder; Linnea Lorene,34,0,40,6
1683726536870,ANBI 140,A00,258395,Hrvoj Mihic; Branka,18,0,25,7
1683726537896,ANSC 120,A00,258402,Bialecki; Jon Anthony,26,0,40,14
1683726538921,ANSC 144,A00,258400,Staff,12,0,40,28
1683726540972,ANSC 166,A00,258396,Parish; Steven Martin,156,0,175,19
1683726541997,ANSC 180,A00,193533,Staff,8,0,20,12
1683726543026,ANSC 188,A00,258397,Jassal; Aftab,34,0,40,6
1683726544054,ANTH 3,A01,258316,Staff,23,0,30,7
1683726545079,ANTH 5,A00,258394,Semendeferi; Ekaterini,16,0,20,4
1683726546107,ANTH 21,A01,258331,Staff,4,0,40,36
1683726547131,ANTH 103,A00,258398,Varma; Saiba,15,0,25,10
1683726548160,AWP 10,001,202034,Staff,0,0,0,0
1683726548160,AWP 10,002,202035,Staff,0,0,0,0
1683726548160,AWP 10,003,202036,Staff,0,0,0,0
1683726548160,AWP 10,004,202037,Staff,0,0,0,0
1683726548160,AWP 10,005,202038,Staff,0,0,0,0
1683726548160,AWP 10,006,202039,Staff,0,0,0,0
1683726548160,AWP 10,007,202040,Staff,0,0,0,0
1683726548160,AWP 10,008,202041,Staff,0,0,0,0
1683726548160,AWP 10,009,202042,Staff,0,0,0,0
1683726548160,AWP 10,010,202043,Staff,0,0,0,0
1683726548160,AWP 10,011,202044,Staff,0,0,0,0
1683726548160,AWP 10,012,202045,Staff,0,0,0,0
1683726548160,AWP 10,013,202046,Staff,0,0,0,0
1683726548160,AWP 10,014,202047,Staff,0,0,0,0
1683726548160,AWP 10,015,202048,Staff,0,0,0,0
1683726548160,AWP 10,016,202049,Staff,0,0,0,0
1683726548160,AWP 10,017,202050,Staff,0,0,0,0
1683726548160,AWP 10,018,202051,Staff,0,0,0,0
1683726548160,AWP 10,019,202052,Staff,0,0,0,0
1683726548160,AWP 10,020,202053,Staff,0,0,0,0
1683726548160,AWP 10,021,202054,Staff,0,0,0,0
1683726548160,AWP 10,022,202055,Staff,0,0,0,0
1683726548160,AWP 10,023,202056,Staff,0,0,0,0
1683726548160,AWP 10,024,202057,Staff,0,0,0,0
1683726548160,AWP 10,025,202058,Staff,0,0,0,0
1683726548160,AWP 10,026,202059,Staff,0,0,0,0
1683726549186,AWP 102,001,202032,Staff,0,0,0,0
1683726549186,AWP 102,002,202033,Staff,0,0,0,0
1683726550211,BENG 100,A01,254234,Taylor Amos; Alyssa C,31,0,40,9
1683726551240,BENG 196,001,270013,Engler; Adam J.,9999,0,9999,0
1683726552267,BICD 100R,A01,202018,Smith; Laurie,0,7,32,32
1683726552267,BICD 100R,A02,202019,Smith; Laurie,0,3,32,32
1683726552267,BICD 100R,A03,202020,Smith; Laurie,0,1,32,32
1683726552267,BICD 100R,A04,202021,Smith; Laurie,6,0,32,26
1683726552267,BICD 100R,A05,202022,Smith; Laurie,10,0,32,22
1683726553293,BICD 136,A01,193242,Gustafson-Brown; Cindy,0,2,32,32
1683726553293,BICD 136,A02,193244,Gustafson-Brown; Cindy,13,0,32,19
1683726554319,BIEB 102,A01,193249,Butler; Shannon Rhey,0,0,32,32
1683726554319,BIEB 102,A02,193251,Butler; Shannon Rhey,0,0,32,32
1683726554319,BIEB 102,A03,193253,Butler; Shannon Rhey,0,0,32,32
1683726554319,BIEB 102,A04,193255,Butler; Shannon Rhey,13,0,32,19
1683726554319,BIEB 102,A05,193265,Butler; Shannon Rhey,25,0,32,7
1683726554319,BIEB 102,A06,193269,Butler; Shannon Rhey,12,0,32,20
1683726556372,BIEB 150,A01,193274,Staff,0,0,32,32
1683726556372,BIEB 150,A02,193285,Staff,24,0,32,8
1683726557402,BIEB 194,A00,193286,Kurle; Carolyn M.,19,0,32,13
1683726558429,BILD 1,A01,192291,Staff,15,0,32,17
1683726558429,BILD 1,A02,192292,Staff,30,0,32,2
1683726558429,BILD 1,B01,192520,Reuther; Keefe,0,1,0,0
1683726558429,BILD 1,B02,192532,Reuther; Keefe,0,1,0,0
1683726559456,BILD 3,A01,192556,Butler; Shannon Rhey,0,0,32,32
1683726559456,BILD 3,A02,192581,Butler; Shannon Rhey,0,1,32,32
1683726559456,BILD 3,A03,192611,Butler; Shannon Rhey,19,0,32,13
1683726559456,BILD 3,A04,192612,Butler; Shannon Rhey,23,0,32,9
1683726559456,BILD 3,A05,192613,Butler; Shannon Rhey,26,0,32,6
1683726559456,BILD 3,A06,192679,Butler; Shannon Rhey,27,0,32,5
1683726559456,BILD 3,A07,192682,Butler; Shannon Rhey,20,0,32,12
1683726560482,BILD 4,A01,192836,Reuther; Keefe,1,0,24,23
1683726560482,BILD 4,A02,193044,Reuther; Keefe,4,0,24,20
1683726561512,BILD 10,A01,193142,Gustafson-Brown; Cindy,29,0,32,3
1683726561512,BILD 10,A02,193149,Gustafson-Brown; Cindy,31,0,32,1
1683726562539,BIMM 100,A01,193301,Staff,0,6,32,32
1683726562539,BIMM 100,A02,193312,Staff,0,7,32,32
1683726562539,BIMM 100,A03,193323,Staff,0,10,32,32
1683726563566,BIMM 101,A01,193329,McDonnell; Lisa Marie,0,3,24,24
1683726563566,BIMM 101,A02,193339,McDonnell; Lisa Marie,0,3,24,24
1683726563566,BIMM 101,B01,193354,McDonnell; Lisa Marie,0,4,24,24
1683726563566,BIMM 101,B02,193357,McDonnell; Lisa Marie,0,3,24,24
1683726564593,BIMM 110,A01,193377,Tat; John,0,11,32,32
1683726564593,BIMM 110,A02,193378,Tat; John,0,11,32,32
1683726565624,BIMM 120,A01,206116,Staff,0,0,32,32
1683726565624,BIMM 120,A02,206117,Staff,7,0,32,25
1683726565624,BIMM 120,A03,206121,Staff,21,0,32,11
1683726566656,BIPN 100,A01,193393,Park; Ji Young,0,15,32,32
1683726566656,BIPN 100,A02,193402,Park; Ji Young,0,14,32,32
1683726566656,BIPN 100,A03,193413,Park; Ji Young,0,14,32,32
1683726566656,BIPN 100,A04,193414,Park; Ji Young,0,13,32,32
1683726567683,BIPN 102,A01,193429,Staff,0,0,32,32
1683726567683,BIPN 102,A02,193438,Staff,18,0,32,14
1683726568712,BIPN 106,A01,193450,Reyes Gonzalez; Catalina,0,2,40,40
1683726569747,BIPN 134,A01,193465,Cooke; James Edward,0,0,32,32
1683726569747,BIPN 134,A02,193474,Cooke; James Edward,25,0,32,7
1683726569747,BIPN 134,A03,193485,Cooke; James Edward,29,0,32,3
1683726569747,BIPN 134,A04,193486,Cooke; James Edward,20,0,32,12
1683726569747,BIPN 134,A05,193491,Cooke; James Edward,31,0,32,1
1683726569747,BIPN 134,A06,193501,Cooke; James Edward,30,0,32,2
1683726569747,BIPN 134,A07,193510,Cooke; James Edward,29,0,32,3
1683726571796,BISP 194,A00,222522,Staff,14,0,32,18
1683726572821,CAT 124,A01,202407,Staff,19,0,25,6
1683726573852,CAT 125,A00,202408,Marchisotto; Jennifer Anne,2,0,20,18
1683726574881,CAT 125R,A00,202409,Smith; Lauryn Alissa,0,11,20,20
1683726574881,CAT 125R,B00,202410,Morales; Celeste Georgianna,0,11,20,20
1683726574881,CAT 125R,C00,202411,Irwin; Matthew Joseph,0,12,20,20
1683726575914,CENG 15,A01,204712,Yang; Kesong,0,1,0,0
1683726576943,CENG 114,A00,202070,Jahed Motlagh; Zeinab,5,0,20,15
1683726577974,CGS 105,A00,185477,Wesling; Megan E.,24,0,40,16
1683726579001,CGS 106,A00,185494,Staff,11,0,22,11
1683726580025,CGS 108,A00,185495,Staff,14,0,20,6
1683726581050,CGS 114,A00,185496,Staff,13,0,18,5
1683726582074,CGS 119,A00,185501,Staff,15,0,20,5
1683726583099,CGS 120,A00,185511,Staff,11,0,20,9
1683726584132,CHEM 4,A01,184675,Bussey; Thomas J,97,0,100,3
1683726585159,CHEM 6A,A01,184677,Staff,32,0,60,28
1683726586189,CHEM 6B,A01,184679,Staff,63,0,100,37
1683726587215,CHEM 6C,A01,184681,Bussey; Thomas J,0,0,50,50
1683726587215,CHEM 6C,A02,184682,Bussey; Thomas J,32,0,50,18
1683726588242,CHEM 40A,A01,184684,Albizati; Kim F.,33,0,100,67
1683726589270,CHEM 40B,A01,184686,Albizati; Kim F.,0,22,100,100
1683726590298,CHEM 41B,A01,184690,Staff,51,0,100,49
1683726591327,COGS 3,A01,184715,Boyle; Mary E. T.,0,27,40,40
1683726592355,COGS 14B,A01,185172,Staff,0,14,38,38
1683726593381,COGS 18,A01,184736,Staff,14,0,80,66
1683726594408,COGS 100,A01,184932,Staff,0,8,73,73
1683726595436,COGS 101A,A01,184935,Staff,0,40,30,30
1683726596534,COGS 101B,A01,184944,Staff,0,2,30,30
1683726597561,COGS 101C,A01,184946,Staff,0,10,30,30
1683726598586,COGS 102A,A01,184951,Johnson; Christine M.,1,0,40,39
1683726599616,COGS 107B,A01,184953,Mooshagian; Eric Frederick,0,52,40,40
1683726600641,COGS 118B,A01,184959,Gupta; Anjum,0,50,40,40
1683726601673,COGS 153,A00,184961,Staff,1,16,30,29
1683726602699,COGS 177,A00,184962,Staff,0,20,30,30
1683726603722,COGS 187A,A01,184969,Boyle; Mary E. T.,0,19,40,40
1683726604754,COMM 10,A01,185174,Staff,0,5,25,25
1683726604754,COMM 10,A02,185189,Staff,0,2,25,25
1683726604754,COMM 10,A03,269821,Staff,0,1,0,0
1683726605781,COMM 100B,A02,185476,Staff,10,0,25,15
1683726605781,COMM 100B,A03,277340,Staff,25,0,25,0
1683726606807,COMM 100C,A01,185314,Staff,2,0,25,23
1683726606807,COMM 100C,A02,185327,Staff,17,0,25,8
1683726607835,COMM 110M,A00,185349,Staff,0,0,40,40
1683726608859,COMM 113T,A00,185352,Staff,25,0,40,15
1683726609882,COMM 114I,A00,185353,Staff,31,0,40,9
1683726610913,COMM 131,A00,185354,Staff,17,0,30,13
1683726611938,CSE 8A,A50,185358,Cao; Yingjun,0,46,10,10
1683726612968,CSE 8B,A01,185362,Staff,0,48,50,50
1683726613993,CSE 11,A01,185416,Cao; Yingjun,0,91,10,10
1683726615018,CSE 20,A01,185445,Briones; Jor-el Thomas Caparas,3,0,25,22
1683726616049,CSE 21,A01,185447,Staff,9,0,50,41
1683726617081,CSE 101,A01,185451,Staff,0,13,50,50
1683726617081,CSE 101,B01,185453,Jones; Miles E,0,15,50,50
1683726619138,CSE 141,A01,185458,Eldon; John,16,0,100,84
1683726620165,CSE 141L,A01,185461,Eldon; John,8,0,100,92
1683726621194,CSE 142,A01,185463,Staff,34,0,60,26
1683726621194,CSE 142,B01,201355,Staff,0,7,60,60
1683726622221,CSE 142L,A01,185470,Staff,34,0,60,26
1683726622221,CSE 142L,B01,201417,Staff,0,6,60,60
1683726623247,CSE 190,A00,201433,Staff,32,0,49,17
1683726624273,DOC 1,A01,259136,Strom; Megan C.,7,0,15,8
1683726624273,DOC 1,A02,259137,Strom; Megan C.,15,0,15,0
1683726624273,DOC 1,A03,259138,Strom; Megan C.,14,0,15,1
1683726624273,DOC 1,A04,259139,Strom; Megan C.,13,0,15,2
1683726625302,DOC 100D,A00,259140,Pass; Natalye Joann,14,0,25,11
1683726626326,DSGN 1,A01,184749,Rill; Bryan,0,26,30,30
1683726627351,DSGN 100,A01,185168,Staff,0,2,25,25
1683726628382,ECE 5,A01,185626,Morris; Karcher William,0,12,0,0
1683726629412,ECE 101,A01,185628,Staff,14,0,70,56
1683726630441,ECE 107,A01,185635,Baghdadchi; Saharnaz,0,0,20,20
1683726630441,ECE 107,A02,185638,Baghdadchi; Saharnaz,1,0,20,19
1683726631466,ECE 148,A01,185647,Silberman; Jack,0,0,16,16
1683726632490,ECON 1,A01,185537,Crane; Meredith Helen,54,0,70,16
1683726633518,ECON 3,A01,185549,Crane; Meredith Helen,30,0,70,40
1683726634547,ECON 4,A01,203354,Anderson; John Charles,0,5,10,10
1683726635572,ECON 100A,A01,185574,Staff,0,5,40,40
1683726636595,ECON 100B,A01,185576,Staff,0,12,50,50
1683726637620,ECON 100C,A01,185589,Newhouse; Herbert S,30,0,70,40
1683726638649,ECON 105,A00,185608,Vespa; Emanuel Ignacio,19,0,35,16
1683726639674,ECON 109,A01,185610,Shishkin; Denis,9,0,35,26
1683726640702,ECON 110A,A01,185612,Staff,8,0,40,32
1683726641726,ECON 120A,A01,185615,Staff,19,0,40,21
1683726642750,ECON 120C,A01,185617,Sun; Yixiao,0,21,70,70
1683726643780,ECON 144,A00,203346,Squires; Dale E,2,0,35,33
1683726644808,ECON 171,A01,203349,Newhouse; Herbert S,0,1,35,35
1683726645837,ECON 173A,A01,185621,Toda; Alexis Akira,21,0,35,14
1683726646868,EDS 25,A01,202413,Staff,0,1,0,0
1683726646868,EDS 25,A02,202414,Staff,0,1,0,0
1683726646868,EDS 25,A03,202415,Staff,0,0,0,0
1683726646868,EDS 25,A04,202416,Staff,0,1,0,0
1683726646868,EDS 25,A05,202439,Staff,0,0,0,0
1683726646868,EDS 25,A06,202440,Staff,0,0,0,0
1683726646868,EDS 25,B01,202631,Staff,0,0,0,0
1683726646868,EDS 25,B02,202632,Staff,0,0,0,0
1683726646868,EDS 25,B03,202639,Staff,0,0,0,0
1683726646868,EDS 25,B04,202640,Staff,0,0,0,0
1683726646868,EDS 25,B05,202643,Staff,0,0,0,0
1683726646868,EDS 25,B06,202644,Staff,0,0,0,0
1683726647899,EDS 38,A01,202659,Black; Alison Michelle,25,0,25,0
1683726648923,EDS 115,A00,202652,Staff,18,0,30,12
1683726649951,EDS 125,A00,202649,Staff,13,0,30,17
1683726650980,EDS 126,A01,203332,Staff,30,0,30,0
1683726652006,EDS 139,A00,202838,Staff,16,0,25,9
1683726653033,EDS 146,A01,202655,Staff,14,0,25,11
1683726654060,ENG 15,A00,185667,Staff,0,1,0,0
1683726654060,ENG 15,B00,185672,Staff,0,0,0,0
1683726654060,ENG 15,C00,185675,Staff,0,0,0,0
1683726654060,ENG 15,D00,185682,Staff,0,0,0,0
1683726654060,ENG 15,E00,185684,Staff,0,0,0,0
1683726655084,ETHN 103,A00,185710,Staff,0,8,35,35
1683726656111,ETHN 103A,A00,199228,Man; Simeon S,0,0,9,9
1683726657139,ETHN 109,A00,185711,Staff,15,0,35,20
1683726658166,ETHN 142,A00,185726,Staff,0,4,30,30
1683726659190,ETHN 163J,A00,199229,Man; Simeon S,5,0,8,3
1683726660215,ETHN 168,A00,185727,Staff,7,0,10,3
1683726661240,ETHN 182,A00,185728,Staff,0,0,35,35
1683726662264,ETHN 183,A00,185737,Staff,10,0,18,8
1683726663289,GLBH 111,A01,209361,Burgos; Jose L.,0,0,0,0
1683726665349,HIEU 104,A00,185792,Staff,14,0,20,6
1683726666378,HIEU 115,A00,185800,Staff,0,0,20,20
1683726667405,HIEU 128,A00,185801,Staff,0,9,20,20
1683726668433,HIEU 147,A00,185802,Staff,15,0,20,5
1683726669457,HIEU 154,A00,185823,Staff,11,0,20,9
1683726670484,HILA 102,A00,185826,Staff,14,0,20,6
1683726671514,HILD 2C,A01,185778,Staff,0,13,20,20
1683726672545,HILD 7B,A01,185780,Kwak; Nancy,0,17,32,32
1683726672545,HILD 7B,A02,185781,Kwak; Nancy,0,18,32,32
1683726673571,HILD 30,A01,185791,Staff,12,0,20,8
1683726674600,HISC 119,A00,185830,Golan; Tal,0,10,20,20
1683726675626,HITO 156GS,A00,185831,Patterson; Patrick H.,0,0,0,23
1683726676651,HIUS 103,A00,185832,Man; Simeon S,0,4,20,20
1683726677675,HIUS 117,A00,185836,Kwak; Nancy,2,0,20,18
1683726678700,HIUS 125,A00,185840,Man; Simeon S,0,2,23,23
1683726679728,HIUS 149,A00,185845,Staff,1,0,20,19
1683726680764,HUM 3,A01,185882,Zavodny; Tatiana Sophia,0,8,50,50
1683726680764,HUM 3,B01,185899,Caldwell; Michael Alan,0,18,50,50
1683726681786,HUM 3GS,A00,185900,Patterson; Patrick H.,0,0,0,23
1683726682811,HUM 4,A01,185938,Zroka; Amy Liane,28,0,50,22
1683726682811,HUM 4,B01,185956,Watkins; Eric,0,6,50,50
1683726682811,HUM 4,B02,202209,Watkins; Eric,0,6,50,50
1683726682811,HUM 4,B03,202210,Watkins; Eric,0,5,50,50
1683726683841,HUM 5,A01,185958,West; Geoffrey Scott,0,0,50,50
1683726683841,HUM 5,A02,202215,West; Geoffrey Scott,0,1,50,50
1683726684867,INTL 190,A00,185959,Gagnon; Jeffrey C,0,0,0,9
1683726684867,INTL 190,B00,185960,Lettieri; Michael Joseph,0,0,0,2
1683726685897,JAPN 180,A00,254509,Staff,4,0,30,26
1683726686928,LATI 10,A01,202853,Kennemore; Amy Michelle,4,0,35,31
1683726686928,LATI 10,A02,202854,Kennemore; Amy Michelle,3,0,35,32
1683726686928,LATI 10,A03,270054,Kennemore; Amy Michelle,30,0,30,0
1683726687955,LATI 180,A00,202855,Kennemore; Amy Michelle,11,0,20,9
1683726688979,LAWS 101,A00,201767,Golan; Tal,0,7,40,40
1683726690005,LIFR 1C,A00,185961,Staff,6,0,20,14
1683726691030,LIFR 1CX,A00,185962,Staff,7,0,20,13
1683726692059,LIFR 1D,A00,185963,Staff,7,0,20,13
1683726693087,LIFR 1DX,A00,185964,Staff,7,0,20,13
1683726694114,LIGN 101,A01,186039,Staff,43,0,50,7
1683726695141,LIGN 165,A00,186040,Staff,14,0,50,36
1683726696170,LTCS 108,A00,186041,Staff,5,0,10,5
1683726697197,LTCS 119,A00,186042,Staff,15,0,20,5
1683726698226,LTCS 130,A00,186043,Wesling; Megan E.,15,0,25,10
1683726700386,LTEA 138,A00,186119,Staff,13,0,40,27
1683726701411,LTEN 124,A00,186148,Staff,5,0,25,20
1683726702437,LTEN 178,A00,186149,Staff,6,0,15,9
1683726703464,LTEN 181,A00,186150,Blanco; John D,34,0,40,6
1683726704493,LTWL 120,A00,186160,Staff,19,0,25,6
1683726705519,LTWL 165,A00,186161,Staff,22,0,25,3
1683726706545,LTWR 100,A00,186162,Staff,0,5,15,15
1683726707571,LTWR 102,A00,186163,Doller; Ben,5,0,15,10
1683726708596,MAE 8,A01,186412,Staff,0,1,0,0
1683726709622,MAE 30B,A00,186445,Bahadori; Mohammad Yousef,81,0,100,19
1683726710647,MAE 40,A00,186592,Bewley; Thomas R,10,0,50,40
1683726711677,MAE 101B,A00,186593,Bahadori; Mohammad Yousef,80,0,100,20
1683726712707,MAE 105,A00,186594,Bandaru; Prabhakar,10,0,50,40
1683726713736,MAE 107,A00,186599,Pham; Hieu Tan,0,8,120,120
1683726714763,MAE 148,A01,186660,Silberman; Jack,3,0,16,13
1683726715793,MATH 10A,A01,188095,Staff,0,6,35,35
1683726716817,MATH 10B,A01,188097,Bowers; Adam R.,0,12,30,30
1683726716817,MATH 10B,A02,188099,Bowers; Adam R.,0,11,30,30
1683726716817,MATH 10B,B01,188104,Bowers; Adam R.,0,10,30,30
1683726716817,MATH 10B,B02,188106,Bowers; Adam R.,0,9,30,30
1683726717842,MATH 10C,A01,188111,Staff,0,20,30,30
1683726717842,MATH 10C,A02,188127,Staff,0,19,30,30
1683726717842,MATH 10C,A03,188131,Staff,0,19,30,30
1683726717842,MATH 10C,B01,188218,Staff,17,0,30,13
1683726717842,MATH 10C,B02,188244,Staff,13,0,30,17
1683726717842,MATH 10C,B03,188277,Staff,14,0,30,16
1683726718872,MATH 18,A01,188344,Bach; Quang Tran,18,0,30,12
1683726718872,MATH 18,A02,188345,Bach; Quang Tran,11,0,30,19
1683726718872,MATH 18,B01,188353,Bach; Quang Tran,11,0,30,19
1683726718872,MATH 18,B02,188354,Bach; Quang Tran,19,0,30,11
1683726719896,MATH 20A,A01,188374,Staff,10,0,35,25
1683726720920,MATH 20B,A01,188382,Ohm; Ko Woon,7,0,30,23
1683726720920,MATH 20B,A02,188383,Ohm; Ko Woon,22,0,30,8
1683726720920,MATH 20B,B01,188385,Ohm; Ko Woon,7,0,30,23
1683726720920,MATH 20B,B02,188392,Ohm; Ko Woon,22,0,30,8
1683726721946,MATH 20C,A01,188394,Harel; Guershon,10,0,30,20
1683726721946,MATH 20C,A02,188395,Harel; Guershon,13,0,30,17
1683726721946,MATH 20C,B01,188404,Harel; Guershon,5,0,30,25
1683726721946,MATH 20C,B02,188405,Harel; Guershon,18,0,30,12
1683726722979,MATH 20D,A01,188414,Hammock; Frances H,0,1,30,30
1683726722979,MATH 20D,A02,188415,Hammock; Frances H,0,1,30,30
1683726722979,MATH 20D,B01,188447,Hammock; Frances H,0,1,30,30
1683726722979,MATH 20D,B02,188486,Hammock; Frances H,2,0,30,28
1683726724010,MATH 20E,A01,188649,Staff,21,0,30,9
1683726724010,MATH 20E,A02,188650,Staff,20,0,30,10
1683726724010,MATH 20E,A03,188673,Staff,0,0,30,30
1683726725041,MATH 102,A01,188675,Staff,0,40,35,35
1683726726066,MATH 103B,A01,188681,Staff,3,0,35,32
1683726726066,MATH 103B,B01,188692,Staff,5,0,35,30
1683726727092,MATH 109,A01,188695,Salehi Golsefidy; Alireza,24,0,35,11
1683726727092,MATH 109,A02,188696,Salehi Golsefidy; Alireza,24,0,35,11
1683726728119,MATH 120A,A01,188698,Eggers; John Dietrich,7,0,35,28
1683726729144,MATH 142B,A01,188736,Ioana; Adrian,0,0,30,30
1683726729144,MATH 142B,A02,188741,Ioana; Adrian,0,1,30,30
1683726729144,MATH 142B,A03,188743,Ioana; Adrian,0,3,30,30
1683726730170,MATH 168A,A01,188790,Staff,0,11,35,35
1683726731196,MATH 170A,A01,188803,Nie; Jiawang,0,2,35,35
1683726731196,MATH 170A,A02,188811,Nie; Jiawang,0,1,35,35
1683726731196,MATH 170A,A03,188814,Nie; Jiawang,1,0,35,34
1683726731196,MATH 170A,A04,188815,Nie; Jiawang,5,0,35,30
1683726732226,MATH 193B,A01,188817,Staff,0,0,35,35
1683726732226,MATH 193B,A02,188818,Staff,6,0,35,29
1683726733251,MGT 4,A01,202857,Anderson; John Charles,59,0,80,21
1683726734275,MGT 12,A00,202858,Lindenberger; Wade Douglas,40,0,90,50
1683726735304,MGT 18,A00,202859,Staff,73,0,90,17
1683726736334,MGT 18GS,A00,202860,McKay; Michael J,13,0,28,15
1683726737359,MGT 45,A00,202861,Pecore; Joseph P.,8,0,90,82
1683726738383,MGT 100,A00,202863,Yavorsky; Daniel Ryan,27,0,90,63
1683726739412,MGT 103,A00,202864,Ehrich; Kristine R,0,19,90,90
1683726740436,MGT 112,A00,202865,Ehrich; Kristine R,15,0,90,75
1683726741462,MGT 121A,A00,202868,Staff,70,0,90,20
1683726742493,MGT 131B,A00,202869,Anderson; John Charles,58,0,90,32
1683726743522,MGT 136,A00,202871,Lindenberger; Wade Douglas,83,0,90,7
1683726744552,MGT 164,A00,202873,Staff,0,67,90,91
1683726745581,MGT 164GS,A00,202874,McKay; Mary A,13,0,28,15
1683726746608,MGT 180,A00,202875,Staff,0,51,90,91
1683726747634,MMW 11R,A01,205019,Herbst; Matthew,0,0,30,30
1683726747634,MMW 11R,A02,205026,Herbst; Matthew,29,0,30,1
1683726748659,MMW 15,A01,193512,Chang; Edmond Yi-Teh,0,8,28,28
1683726748659,MMW 15,A02,193513,Chang; Edmond Yi-Teh,0,5,28,28
1683726748659,MMW 15,A03,193514,Chang; Edmond Yi-Teh,0,5,28,28
1683726748659,MMW 15,A04,193515,Chang; Edmond Yi-Teh,0,5,28,28
1683726748659,MMW 15,A05,193516,Chang; Edmond Yi-Teh,0,5,28,28
1683726748659,MMW 15,A06,193517,Chang; Edmond Yi-Teh,0,6,28,28
1683726748659,MMW 15,B01,193519,Chang; Edmond Yi-Teh,0,5,28,28
1683726748659,MMW 15,B02,193520,Chang; Edmond Yi-Teh,0,5,28,28
1683726748659,MMW 15,B03,193521,Chang; Edmond Yi-Teh,0,5,28,28
1683726748659,MMW 15,B04,193522,Chang; Edmond Yi-Teh,0,6,28,28
1683726748659,MMW 15,B05,193523,Chang; Edmond Yi-Teh,0,5,28,28
1683726748659,MMW 15,B06,193524,Chang; Edmond Yi-Teh,0,5,28,28
1683726749687,MMW 122,A01,193526,Rahimi; Babak,0,16,28,28
1683726749687,MMW 122,A02,193527,Rahimi; Babak,0,15,28,28
1683726749687,MMW 122,A03,193528,Rahimi; Babak,0,0,0,0
1683726749687,MMW 122,A04,193529,Rahimi; Babak,0,0,0,0
1683726750715,MUS 1A,A01,186663,Staff,0,18,35,35
1683726751740,MUS 4,A01,186715,Staff,0,12,35,35
1683726752771,MUS 5R,A01,186796,Dubnov; Shlomo,0,17,35,35
1683726753796,MUS 6,A01,186798,Staff,0,4,25,25
1683726754823,MUS 7,A01,186830,Staff,11,0,35,24
1683726755848,MUS 8,A01,186930,Staff,0,27,35,35
1683726756877,MUS 15,A01,186932,Staff,0,15,35,35
1683726756877,MUS 15,B01,186934,Staff,0,16,35,35
1683726757906,MUS 80,A00,186935,Staff,0,0,20,20
1683726757906,MUS 80,B00,186936,Staff,24,0,25,1
1683726758932,NANO 11,A00,204702,Lipomi; Darren John,0,0,0,0
1683726759965,NANO 15,A01,204709,Yang; Kesong,0,1,0,0
1683726760991,NANO 114,A00,202069,Jahed Motlagh; Zeinab,2,0,10,8
1683726762020,PHIL 1,A00,186955,Grush; Rick Scott,31,0,40,9
1683726763050,PHIL 10,A01,186973,Grush; Rick Scott,27,0,35,8
1683726763050,PHIL 10,A02,186974,Grush; Rick Scott,33,0,35,2
1683726764075,PHIL 13,A01,186976,Staff,1,0,35,34
1683726764075,PHIL 13,A02,186977,Staff,16,0,35,19
1683726765103,PHIL 14,A01,186979,Staff,30,0,35,5
1683726765103,PHIL 14,A02,186986,Staff,32,0,35,3
1683726766134,PHIL 28,A01,186988,Staff,16,0,30,14
1683726766134,PHIL 28,A02,186989,Staff,0,0,30,30
1683726766134,PHIL 28,A03,186990,Staff,10,0,30,20
1683726766134,PHIL 28,A04,186991,Staff,26,0,30,4
1683726767159,PHIL 120,A00,186997,Staff,23,0,40,17
1683726768183,PHIL 137,A00,187003,Staff,8,0,40,32
1683726769209,PHIL 150,A00,187015,Staff,47,0,70,23
1683726770240,PHIL 167,A00,187021,Lamey; Andy M.,34,0,40,6
1683726771269,PHIL 174,A01,202226,Staff,17,0,20,3
1683726771269,PHIL 174,A02,202235,Staff,20,0,20,0
1683726772296,PHIL 191A,A00,258918,Staff,0,0,1,1
1683726773321,PHYS 1A,A00,187028,Staff,26,0,60,34
1683726774349,PHYS 1AL,001,187036,Staff,3,0,30,27
1683726774349,PHYS 1AL,002,187049,Staff,18,0,30,12
1683726775372,PHYS 1B,A00,187058,Staff,21,0,60,39
1683726776402,PHYS 1BL,001,187064,Staff,0,1,30,30
1683726776402,PHYS 1BL,002,187070,Staff,4,0,30,26
1683726777428,PHYS 1C,A00,187082,Staff,30,0,120,90
1683726778456,PHYS 1CL,001,187088,Staff,0,9,30,30
1683726778456,PHYS 1CL,002,187089,Staff,0,1,30,30
1683726778456,PHYS 1CL,009,262693,Staff,9,0,30,21
1683726779482,PHYS 2B,A01,187097,Staff,55,0,115,60
1683726780507,PHYS 2C,A01,187099,Staff,63,0,115,52
1683726781531,PHYS 2CL,A01,187101,Staff,5,0,28,23
1683726781531,PHYS 2CL,A02,187102,Staff,15,0,28,13
1683726782561,PHYS 2D,A01,187123,Shotwell; Brian,95,0,115,20
1683726783587,PHYS 4B,A01,187133,Grinstein; Benjamin,35,0,50,15
1683726784612,POLI 10,A00,188819,Staff,0,4,50,50
1683726785640,POLI 11,A00,188827,Staff,43,0,50,7
1683726786665,POLI 13R,A00,188828,Staff,0,2,20,20
1683726787690,POLI 27,A01,188830,Elgin; Samuel Zincke,0,2,70,70
1683726788718,POLI 30,A00,188832,Desposato; Scott,30,0,50,20
1683726789746,POLI 102F,A00,188834,Staff,1,0,40,39
1683726790772,POLI 104A,A00,188852,Staff,12,0,30,18
1683726791802,POLI 104I,A00,188853,Staff,0,8,20,20
1683726792830,POLI 110B,A00,188854,Wiens; David,6,0,20,14
1683726793855,POLI 112A,A00,188855,Wiens; David,3,0,30,27
1683726794880,POLI 117R,A00,188856,Forman; Fonna,0,12,20,20
1683726795909,POLI 118,A00,188857,Ingham; Sean,8,0,20,12
1683726796939,POLI 120G,A00,188858,Staff,7,0,30,23
1683726797964,POLI 131CR,A00,188863,Hoston; Germaine,20,0,50,30
1683726798992,POLI 133,A00,188864,Nellis; Gareth Hb,44,0,50,6
1683726800021,POLI 134D,A00,188865,Desposato; Scott,27,0,30,3
1683726801047,POLI 142A,A00,188871,Gartzke; Erik,21,0,50,29
1683726802072,POLI 142K,A00,188874,Staff,38,0,50,12
1683726803099,POLI 143,A00,188940,Gartzke; Erik,15,0,30,15
1683726804180,POLI 153,A00,188943,Staff,1,0,20,19
1683726805206,POLI 160AA,A00,188944,Staff,10,0,40,30
1683726806231,POLI 170A,A00,188945,Staff,10,0,30,20
1683726808278,PSYC 1,A00,188952,Staff,36,0,90,54
1683726809319,PSYC 2,B00,188953,Staff,19,0,35,16
1683726810344,PSYC 6,A00,188970,Staff,47,0,60,13
1683726811366,PSYC 7,A00,188973,Staff,35,0,45,10
1683726812392,PSYC 60,A01,188980,Rickard; Timothy C.,42,0,60,18
1683726813423,PSYC 70,A01,189001,Steiner; Eric Tomas,22,0,45,23
1683726814446,PSYC 100,A00,189005,Lacefield; Katharine I,1,98,120,119
1683726815474,PSYC 102,A00,189008,Staff,6,0,30,24
1683726816501,PSYC 106,B00,189026,Gorman; Michael R.,27,0,60,33
1683726817526,PSYC 114,B01,189033,Winkielman; Piotr,0,31,30,30
1683726818555,PSYC 131,A00,189036,Anagnostaras; Stephan,0,44,60,60
1683726819584,PSYC 136,A00,189041,Lowe; Angela Beth,0,7,25,25
1683726820607,PSYC 137,A00,189057,Winkielman; Piotr,0,36,25,25
1683726821636,PSYC 144,A00,189107,Wixted; John T,0,11,50,50
1683726823688,PSYC 162,A00,189142,Staff,0,9,85,85
1683726824710,PSYC 172,A00,189144,Gorman; Michael R.,0,6,30,30
1683726826762,PSYC 179,A00,189146,Lacefield; Katharine I,0,88,120,120
1683726827794,PSYC 181,A00,189147,Anagnostaras; Stephan,0,45,90,90
1683726828823,PSYC 190R,A00,189148,Barner; David A.,0,23,80,80
1683726829848,PSYC 191,A00,189275,Rickard; Timothy C.,0,11,25,25
1683726830873,PSYC 193,A00,189276,Chapman; Eddie Nathaniel,0,1,0,4
1683726831910,PSYC 193L,A01,189281,Lowe; Angela Beth,8,0,20,12
1683726831910,PSYC 193L,B01,189285,Staff,28,0,35,7
1683726832938,RELI 149,A00,187137,Rahimi; Babak,6,0,40,34
1683726833968,SE 9,A01,187315,Staff,0,2,18,18
1683726834993,SE 101B,A00,187409,Staff,24,0,30,6
1683726836018,SE 110B,A00,187444,Staff,10,0,40,30
1683726837048,SE 130B,A00,187449,Staff,31,0,40,9
1683726838076,SE 150A,A00,187516,Staff,8,0,20,12
1683726839103,SE 154,A00,187528,Staff,29,0,50,21
1683726840126,SIO 3,A01,258171,Staff,35,0,40,5
1683726841150,SIO 10,A00,187144,Cook; Geoffrey W,0,6,75,75
1683726842179,SIO 45,A00,187152,Cook; Geoffrey W,1,7,100,99
1683726843205,SIO 109R,A00,194486,Staff,0,4,20,20
1683726845260,SIO 187,A01,187233,Kacev; David,12,0,40,28
1683726846288,SOCI 1,A01,258656,Thorpe; Charles Robert,28,0,30,2
1683726846288,SOCI 1,A02,258658,Thorpe; Charles Robert,30,0,30,0
1683726846288,SOCI 1,A03,258661,Thorpe; Charles Robert,25,0,25,0
1683726846288,SOCI 1,A04,258666,Thorpe; Charles Robert,22,0,25,3
1683726846288,SOCI 1,A05,258897,Thorpe; Charles Robert,22,0,25,3
1683726846288,SOCI 1,A06,258898,Thorpe; Charles Robert,25,0,25,0
1683726847314,SOCI 30,A01,258903,Pardo Guerra; Juan Pablo,14,0,30,16
1683726848342,SOCI 102,A00,258904,Staff,9,0,25,16
1683726849366,SOCI 106,A00,258905,Staff,19,0,25,6
1683726850390,SOCI 111,A00,258907,Ribas Norris; Janet Vanesa,26,0,30,4
1683726851415,SOCI 121R,A00,258908,Pardo Guerra; Juan Pablo,7,0,30,23
1683726852444,SOCI 126,A01,203330,Staff,14,0,20,6
1683726853470,SOCI 131,A00,258909,Thorpe; Charles Robert,30,0,60,30
1683726854496,SOCI 135,A00,258910,Payne; Christine Anna,0,13,30,30
1683726855522,SOCI 157,A00,258911,Staff,10,0,30,20
1683726856545,SOCI 184,A00,258912,Staff,25,0,30,5
1683726857572,SOCI 188D,A00,258913,Staff,22,0,30,8
1683726858598,SYN 2,001,187529,Staff,9,0,16,7
1683726858598,SYN 2,002,201452,Staff,0,20,16,16
1683726858598,SYN 2,003,201469,Staff,1,0,16,15
1683726859629,SYN 100,A01,187531,Staff,0,9,20,20
1683726859629,SYN 100,B01,201491,Staff,0,10,20,20
1683726860655,TDAC 1,A00,189286,Walsh; Kim C.,3,0,20,17
1683726860655,TDAC 1,B00,189287,Harting; Carla Kelso,10,0,20,10
1683726861680,TDAC 101,A00,189300,Walsh; Kim C.,16,0,20,4
1683726861680,TDAC 101,B00,189301,Harting; Carla Kelso,18,0,20,2
1683726862710,TDAC 102,A00,189304,Basso; Beatrice,14,0,20,6
1683726863734,TDAC 108,A00,189305,Staff,18,0,20,2
1683726864760,TDDE 131,A00,189310,Staff,19,0,20,1
1683726864760,TDDE 131,B00,189314,Staff,19,0,20,1
1683726864760,TDDE 131,C00,189315,Staff,48,0,50,2
1683726864760,TDDE 131,D00,189316,Staff,14,0,15,1
1683726864760,TDDE 131,E00,204841,Staff,20,0,20,0
1683726865786,TDGE 10,A00,189289,Staff,26,0,50,24
1683726865786,TDGE 10,B00,189290,Havis; Allan,0,1,50,50
1683726866818,TDGE 11,A00,189291,Fulton; Julia,0,4,50,50
1683726866818,TDGE 11,B00,189292,Staff,20,0,25,5
1683726866818,TDGE 11,C00,260270,Staff,0,0,0,0
1683726867843,TDGE 25,A00,189294,Staff,1,0,20,19
1683726868869,TDGE 124,A00,189318,Fulton; Julia,0,7,50,50
1683726869894,TDGE 125,A00,189319,Staff,13,0,25,12
1683726869894,TDGE 125,B00,189320,Staff,23,0,25,2
1683726870922,TDGE 127,A00,189322,Havis; Allan,1,0,50,49
1683726871948,TDHT 101,A00,189323,Staff,18,0,25,7
1683726871948,TDHT 101,B00,189324,Staff,25,0,25,0
1683726872974,TDHT 102,A00,189325,Staff,49,0,50,1
1683726873999,TDMV 1,A00,189295,Arcidiacono; Kristin,20,0,30,10
1683726873999,TDMV 1,B00,189296,Caligagan; Maria T.,23,0,30,7
1683726875027,TDMV 2,A00,189297,Sammartano; Tonnie,27,0,30,3
1683726875027,TDMV 2,B00,189299,Arcidiacono; Kristin,23,0,30,7
1683726876052,TDMV 3,A00,204998,Rincon; Alicia,22,0,30,8
1683726877080,TDMV 120,A00,189458,Sammartano; Tonnie,28,0,30,2
1683726878108,TDMV 138,A00,189541,Jun; Grace Shin Hae,20,0,40,20
1683726879137,TDMV 142,A00,189717,Caligagan; Tony,25,0,30,5
1683726879137,TDMV 142,B00,189718,Caligagan; Maria T.,25,0,30,5
1683726880164,TMC 2,A01,187533,Staff,25,0,25,0
1683726880164,TMC 2,A02,187534,Staff,25,0,25,0
1683726881193,USP 1,A01,187536,Kwak; Nancy,0,16,25,25
1683726882223,USP 5,A01,187538,Staff,8,0,25,17
1683726883248,USP 101,A00,199253,Staff,0,4,0,0
1683726884272,USP 124,A00,187562,Boomhower; Matthew Charles,0,0,30,30
1683726885295,USP 138,A00,187582,Staff,19,0,25,6
1683726886321,USP 152,A01,187597,Staff,3,0,25,22
1683726887347,USP 153,A00,187598,Staff,18,0,25,7
1683726888374,USP 168,A00,187607,Kwak; Nancy,2,0,5,3
1683726889401,USP 173,A00,187619,Staff,4,0,25,21
1683726890430,USP 181,A00,187638,Staff,0,4,25,25
1683726891459,VIS 103,A00,187650,Cruz; Edwin Teddy,17,0,75,58
1683726892487,VIS 110D,A00,187669,Staff,13,0,22,9
1683726893511,VIS 127C,A00,187720,Shen; Kuiyi,67,0,146,79
1683726894537,VIS 149,A00,187731,Yoldas; Pinar,0,12,22,22
1683726895562,VIS 151,A01,188091,Staff,22,0,34,12
1683726895562,VIS 151,A02,188092,Staff,11,0,34,23
1683726896590,VIS 160B,A00,188093,Stalbaum; Brett,0,1,10,10
1683726898640,WCWP 10B,A00,201720,Staff,0,0,5,5
1683726898640,WCWP 10B,B00,201722,Staff,0,0,6,6
1683726899666,WCWP 100,A00,201725,Gagnon; Jeffrey C,0,0,2,2
1683726899666,WCWP 100,B00,201727,Staff,0,4,15,15
1683726902791,ANBI 133,A00,258401,Wilder; Linnea Lorene,34,0,40,6
1683726903817,ANBI 140,A00,258395,Hrvoj Mihic; Branka,18,0,25,7
1683726904842,ANSC 120,A00,258402,Bialecki; Jon Anthony,26,0,40,14
1683726905866,ANSC 144,A00,258400,Staff,12,0,40,28
1683726907977,ANSC 166,A00,258396,Parish; Steven Martin,156,0,175,19
1683726909003,ANSC 180,A00,193533,Staff,8,0,20,12
1683726910029,ANSC 188,A00,258397,Jassal; Aftab,34,0,40,6
1683726911052,ANTH 3,A01,258316,Staff,23,0,30,7
1683726912077,ANTH 5,A00,258394,Semendeferi; Ekaterini,16,0,20,4
1683726913104,ANTH 21,A01,258331,Staff,4,0,40,36
1683726914128,ANTH 103,A00,258398,Varma; Saiba,15,0,25,10
1683726915155,AWP 10,001,202034,Staff,0,0,0,0
1683726915155,AWP 10,002,202035,Staff,0,0,0,0
1683726915155,AWP 10,003,202036,Staff,0,0,0,0
1683726915155,AWP 10,004,202037,Staff,0,0,0,0
1683726915155,AWP 10,005,202038,Staff,0,0,0,0
1683726915155,AWP 10,006,202039,Staff,0,0,0,0
1683726915155,AWP 10,007,202040,Staff,0,0,0,0
1683726915155,AWP 10,008,202041,Staff,0,0,0,0
1683726915155,AWP 10,009,202042,Staff,0,0,0,0
1683726915155,AWP 10,010,202043,Staff,0,0,0,0
1683726915155,AWP 10,011,202044,Staff,0,0,0,0
1683726915155,AWP 10,012,202045,Staff,0,0,0,0
1683726915155,AWP 10,013,202046,Staff,0,0,0,0
1683726915155,AWP 10,014,202047,Staff,0,0,0,0
1683726915155,AWP 10,015,202048,Staff,0,0,0,0
1683726915155,AWP 10,016,202049,Staff,0,0,0,0
1683726915155,AWP 10,017,202050,Staff,0,0,0,0
1683726915155,AWP 10,018,202051,Staff,0,0,0,0
1683726915155,AWP 10,019,202052,Staff,0,0,0,0
1683726915155,AWP 10,020,202053,Staff,0,0,0,0
1683726915155,AWP 10,021,202054,Staff,0,0,0,0
1683726915155,AWP 10,022,202055,Staff,0,0,0,0
1683726915155,AWP 10,023,202056,Staff,0,0,0,0
1683726915155,AWP 10,024,202057,Staff,0,0,0,0
1683726915155,AWP 10,025,202058,Staff,0,0,0,0
1683726915155,AWP 10,026,202059,Staff,0,0,0,0
1683726916179,AWP 102,001,202032,Staff,0,0,0,0
1683726916179,AWP 102,002,202033,Staff,0,0,0,0
1683726917203,BENG 100,A01,254234,Taylor Amos; Alyssa C,31,0,40,9
1683726918228,BENG 196,001,270013,Engler; Adam J.,9999,0,9999,0
1683726919258,BICD 100R,A01,202018,Smith; Laurie,0,7,32,32
1683726919258,BICD 100R,A02,202019,Smith; Laurie,0,3,32,32
1683726919258,BICD 100R,A03,202020,Smith; Laurie,0,1,32,32
1683726919258,BICD 100R,A04,202021,Smith; Laurie,6,0,32,26
1683726919258,BICD 100R,A05,202022,Smith; Laurie,10,0,32,22
1683726920286,BICD 136,A01,193242,Gustafson-Brown; Cindy,0,2,32,32
1683726920286,BICD 136,A02,193244,Gustafson-Brown; Cindy,13,0,32,19
1683726921316,BIEB 102,A01,193249,Butler; Shannon Rhey,0,0,32,32
1683726921316,BIEB 102,A02,193251,Butler; Shannon Rhey,0,0,32,32
1683726921316,BIEB 102,A03,193253,Butler; Shannon Rhey,0,0,32,32
1683726921316,BIEB 102,A04,193255,Butler; Shannon Rhey,13,0,32,19
1683726921316,BIEB 102,A05,193265,Butler; Shannon Rhey,25,0,32,7
1683726921316,BIEB 102,A06,193269,Butler; Shannon Rhey,12,0,32,20
1683726923366,BIEB 150,A01,193274,Staff,0,0,32,32
1683726923366,BIEB 150,A02,193285,Staff,24,0,32,8
1683726924393,BIEB 194,A00,193286,Kurle; Carolyn M.,19,0,32,13
1683726925419,BILD 1,A01,192291,Staff,15,0,32,17
1683726925419,BILD 1,A02,192292,Staff,30,0,32,2
1683726925419,BILD 1,B01,192520,Reuther; Keefe,0,1,0,0
1683726925419,BILD 1,B02,192532,Reuther; Keefe,0,1,0,0
1683726926446,BILD 3,A01,192556,Butler; Shannon Rhey,0,0,32,32
1683726926446,BILD 3,A02,192581,Butler; Shannon Rhey,0,1,32,32
1683726926446,BILD 3,A03,192611,Butler; Shannon Rhey,19,0,32,13
1683726926446,BILD 3,A04,192612,Butler; Shannon Rhey,23,0,32,9
1683726926446,BILD 3,A05,192613,Butler; Shannon Rhey,26,0,32,6
1683726926446,BILD 3,A06,192679,Butler; Shannon Rhey,27,0,32,5
1683726926446,BILD 3,A07,192682,Butler; Shannon Rhey,20,0,32,12
1683726927473,BILD 4,A01,192836,Reuther; Keefe,1,0,24,23
1683726927473,BILD 4,A02,193044,Reuther; Keefe,4,0,24,20
1683726928498,BILD 10,A01,193142,Gustafson-Brown; Cindy,29,0,32,3
1683726928498,BILD 10,A02,193149,Gustafson-Brown; Cindy,31,0,32,1
1683726929523,BIMM 100,A01,193301,Staff,0,6,32,32
1683726929523,BIMM 100,A02,193312,Staff,0,7,32,32
1683726929523,BIMM 100,A03,193323,Staff,0,10,32,32
1683726930554,BIMM 101,A01,193329,McDonnell; Lisa Marie,0,3,24,24
1683726930554,BIMM 101,A02,193339,McDonnell; Lisa Marie,0,3,24,24
1683726930554,BIMM 101,B01,193354,McDonnell; Lisa Marie,0,4,24,24
1683726930554,BIMM 101,B02,193357,McDonnell; Lisa Marie,0,3,24,24
1683726931582,BIMM 110,A01,193377,Tat; John,0,11,32,32
1683726931582,BIMM 110,A02,193378,Tat; John,0,11,32,32
1683726932610,BIMM 120,A01,206116,Staff,0,0,32,32
1683726932610,BIMM 120,A02,206117,Staff,7,0,32,25
1683726932610,BIMM 120,A03,206121,Staff,21,0,32,11
1683726933635,BIPN 100,A01,193393,Park; Ji Young,0,15,32,32
1683726933635,BIPN 100,A02,193402,Park; Ji Young,0,14,32,32
1683726933635,BIPN 100,A03,193413,Park; Ji Young,0,14,32,32
1683726933635,BIPN 100,A04,193414,Park; Ji Young,0,13,32,32
1683726934663,BIPN 102,A01,193429,Staff,0,0,32,32
1683726934663,BIPN 102,A02,193438,Staff,18,0,32,14
1683726935692,BIPN 106,A01,193450,Reyes Gonzalez; Catalina,0,2,40,40
1683726936722,BIPN 134,A01,193465,Cooke; James Edward,0,0,32,32
1683726936722,BIPN 134,A02,193474,Cooke; James Edward,25,0,32,7
1683726936722,BIPN 134,A03,193485,Cooke; James Edward,29,0,32,3
1683726936722,BIPN 134,A04,193486,Cooke; James Edward,20,0,32,12
1683726936722,BIPN 134,A05,193491,Cooke; James Edward,31,0,32,1
1683726936722,BIPN 134,A06,193501,Cooke; James Edward,30,0,32,2
1683726936722,BIPN 134,A07,193510,Cooke; James Edward,29,0,32,3
1683726938770,BISP 194,A00,222522,Staff,14,0,32,18
1683726939795,CAT 124,A01,202407,Staff,19,0,25,6
1683726940821,CAT 125,A00,202408,Marchisotto; Jennifer Anne,2,0,20,18
1683726941850,CAT 125R,A00,202409,Smith; Lauryn Alissa,0,11,20,20
1683726941850,CAT 125R,B00,202410,Morales; Celeste Georgianna,0,11,20,20
1683726941850,CAT 125R,C00,202411,Irwin; Matthew Joseph,0,12,20,20
1683726942875,CENG 15,A01,204712,Yang; Kesong,0,1,0,0
1683726943900,CENG 114,A00,202070,Jahed Motlagh; Zeinab,5,0,20,15
1683726944925,CGS 105,A00,185477,Wesling; Megan E.,24,0,40,16
1683726945949,CGS 106,A00,185494,Staff,11,0,22,11
1683726946974,CGS 108,A00,185495,Staff,14,0,20,6
1683726947999,CGS 114,A00,185496,Staff,13,0,18,5
1683726949026,CGS 119,A00,185501,Staff,15,0,20,5
1683726950055,CGS 120,A00,185511,Staff,11,0,20,9
1683726951088,CHEM 4,A01,184675,Bussey; Thomas J,97,0,100,3
1683726952117,CHEM 6A,A01,184677,Staff,32,0,60,28
1683726953141,CHEM 6B,A01,184679,Staff,63,0,100,37
1683726954173,CHEM 6C,A01,184681,Bussey; Thomas J,0,0,50,50
1683726954173,CHEM 6C,A02,184682,Bussey; Thomas J,32,0,50,18
1683726955196,CHEM 40A,A01,184684,Albizati; Kim F.,33,0,100,67
1683726956222,CHEM 40B,A01,184686,Albizati; Kim F.,0,22,100,100
1683726957248,CHEM 41B,A01,184690,Staff,51,0,100,49
1683726958276,COGS 3,A01,184715,Boyle; Mary E. T.,0,27,40,40
1683726959303,COGS 14B,A01,185172,Staff,0,14,38,38
1683726960333,COGS 18,A01,184736,Staff,14,0,80,66
1683726961363,COGS 100,A01,184932,Staff,0,8,73,73
1683726962388,COGS 101A,A01,184935,Staff,0,40,30,30
1683726963413,COGS 101B,A01,184944,Staff,0,2,30,30
1683726964439,COGS 101C,A01,184946,Staff,0,10,30,30
1683726965470,COGS 102A,A01,184951,Johnson; Christine M.,1,0,40,39
1683726966495,COGS 107B,A01,184953,Mooshagian; Eric Frederick,0,52,40,40
1683726967520,COGS 118B,A01,184959,Gupta; Anjum,0,50,40,40
1683726968545,COGS 153,A00,184961,Staff,1,16,30,29
1683726969572,COGS 177,A00,184962,Staff,0,20,30,30
1683726970596,COGS 187A,A01,184969,Boyle; Mary E. T.,0,19,40,40
1683726971623,COMM 10,A01,185174,Staff,0,5,25,25
1683726971623,COMM 10,A02,185189,Staff,0,2,25,25
1683726971623,COMM 10,A03,269821,Staff,0,1,0,0
1683726972654,COMM 100B,A02,185476,Staff,10,0,25,15
1683726972654,COMM 100B,A03,277340,Staff,25,0,25,0
1683726973680,COMM 100C,A01,185314,Staff,2,0,25,23
1683726973680,COMM 100C,A02,185327,Staff,17,0,25,8
1683726974705,COMM 110M,A00,185349,Staff,0,0,40,40
1683726975733,COMM 113T,A00,185352,Staff,25,0,40,15
1683726976762,COMM 114I,A00,185353,Staff,31,0,40,9
1683726977785,COMM 131,A00,185354,Staff,17,0,30,13
1683726978809,CSE 8A,A50,185358,Cao; Yingjun,0,46,10,10
1683726979834,CSE 8B,A01,185362,Staff,0,48,50,50
1683726980862,CSE 11,A01,185416,Cao; Yingjun,0,91,10,10
1683726981889,CSE 20,A01,185445,Briones; Jor-el Thomas Caparas,3,0,25,22
1683726982919,CSE 21,A01,185447,Staff,9,0,50,41
1683726983945,CSE 101,A01,185451,Staff,0,13,50,50
1683726983945,CSE 101,B01,185453,Jones; Miles E,0,15,50,50
1683726985993,CSE 141,A01,185458,Eldon; John,16,0,100,84
1683726987017,CSE 141L,A01,185461,Eldon; John,8,0,100,92
1683726988046,CSE 142,A01,185463,Staff,34,0,60,26
1683726988046,CSE 142,B01,201355,Staff,0,7,60,60
1683726989073,CSE 142L,A01,185470,Staff,34,0,60,26
1683726989073,CSE 142L,B01,201417,Staff,0,6,60,60
1683726990098,CSE 190,A00,201433,Staff,32,0,49,17
1683726991123,DOC 1,A01,259136,Strom; Megan C.,7,0,15,8
1683726991123,DOC 1,A02,259137,Strom; Megan C.,15,0,15,0
1683726991123,DOC 1,A03,259138,Strom; Megan C.,14,0,15,1
1683726991123,DOC 1,A04,259139,Strom; Megan C.,13,0,15,2
1683726992152,DOC 100D,A00,259140,Pass; Natalye Joann,14,0,25,11
1683726993178,DSGN 1,A01,184749,Rill; Bryan,0,26,30,30
1683726994202,DSGN 100,A01,185168,Staff,0,2,25,25
1683726995227,ECE 5,A01,185626,Morris; Karcher William,0,12,0,0
1683726996252,ECE 101,A01,185628,Staff,14,0,70,56
1683726997280,ECE 107,A01,185635,Baghdadchi; Saharnaz,0,0,20,20
1683726997280,ECE 107,A02,185638,Baghdadchi; Saharnaz,1,0,20,19
1683726998309,ECE 148,A01,185647,Silberman; Jack,0,0,16,16
1683726999339,ECON 1,A01,185537,Crane; Meredith Helen,54,0,70,16
1683727000368,ECON 3,A01,185549,Crane; Meredith Helen,30,0,70,40
1683727001392,ECON 4,A01,203354,Anderson; John Charles,0,5,10,10
1683727002416,ECON 100A,A01,185574,Staff,0,5,40,40
1683727003444,ECON 100B,A01,185576,Staff,0,12,50,50
1683727004470,ECON 100C,A01,185589,Newhouse; Herbert S,30,0,70,40
1683727005497,ECON 105,A00,185608,Vespa; Emanuel Ignacio,19,0,35,16
1683727006523,ECON 109,A01,185610,Shishkin; Denis,9,0,35,26
1683727007548,ECON 110A,A01,185612,Staff,8,0,40,32
1683727008574,ECON 120A,A01,185615,Staff,19,0,40,21
1683727009600,ECON 120C,A01,185617,Sun; Yixiao,0,21,70,70
1683727010626,ECON 144,A00,203346,Squires; Dale E,2,0,35,33
1683727011711,ECON 171,A01,203349,Newhouse; Herbert S,0,1,35,35
1683727012736,ECON 173A,A01,185621,Toda; Alexis Akira,21,0,35,14
1683727013776,EDS 25,A01,202413,Staff,0,1,0,0
1683727013776,EDS 25,A02,202414,Staff,0,1,0,0
1683727013776,EDS 25,A03,202415,Staff,0,0,0,0
1683727013776,EDS 25,A04,202416,Staff,0,1,0,0
1683727013776,EDS 25,A05,202439,Staff,0,0,0,0
1683727013776,EDS 25,A06,202440,Staff,0,0,0,0
1683727013776,EDS 25,B01,202631,Staff,0,0,0,0
1683727013776,EDS 25,B02,202632,Staff,0,0,0,0
1683727013776,EDS 25,B03,202639,Staff,0,0,0,0
1683727013776,EDS 25,B04,202640,Staff,0,0,0,0
1683727013776,EDS 25,B05,202643,Staff,0,0,0,0
1683727013776,EDS 25,B06,202644,Staff,0,0,0,0
1683727014801,EDS 38,A01,202659,Black; Alison Michelle,25,0,25,0
1683727015829,EDS 115,A00,202652,Staff,18,0,30,12
1683727016854,EDS 125,A00,202649,Staff,13,0,30,17
1683727017878,EDS 126,A01,203332,Staff,30,0,30,0
1683727018905,EDS 139,A00,202838,Staff,16,0,25,9
1683727019930,EDS 146,A01,202655,Staff,14,0,25,11
1683727020957,ENG 15,A00,185667,Staff,0,1,0,0
1683727020957,ENG 15,B00,185672,Staff,0,0,0,0
1683727020957,ENG 15,C00,185675,Staff,0,0,0,0
1683727020957,ENG 15,D00,185682,Staff,0,0,0,0
1683727020957,ENG 15,E00,185684,Staff,0,0,0,0
1683727021985,ETHN 103,A00,185710,Staff,0,8,35,35
1683727023143,ETHN 103A,A00,199228,Man; Simeon S,0,0,9,9
1683727024168,ETHN 109,A00,185711,Staff,15,0,35,20
1683727025198,ETHN 142,A00,185726,Staff,0,4,30,30
1683727026227,ETHN 163J,A00,199229,Man; Simeon S,5,0,8,3
1683727027254,ETHN 168,A00,185727,Staff,7,0,10,3
1683727028279,ETHN 182,A00,185728,Staff,0,0,35,35
1683727029304,ETHN 183,A00,185737,Staff,10,0,18,8
1683727030330,GLBH 111,A01,209361,Burgos; Jose L.,0,0,0,0
1683727032384,HIEU 104,A00,185792,Staff,14,0,20,6
1683727033410,HIEU 115,A00,185800,Staff,0,0,20,20
1683727034436,HIEU 128,A00,185801,Staff,0,9,20,20
1683727035460,HIEU 147,A00,185802,Staff,15,0,20,5
1683727036485,HIEU 154,A00,185823,Staff,11,0,20,9
1683727037510,HILA 102,A00,185826,Staff,14,0,20,6
1683727038535,HILD 2C,A01,185778,Staff,0,13,20,20
1683727039565,HILD 7B,A01,185780,Kwak; Nancy,0,17,32,32
1683727039565,HILD 7B,A02,185781,Kwak; Nancy,0,18,32,32
1683727040591,HILD 30,A01,185791,Staff,12,0,20,8
1683727041617,HISC 119,A00,185830,Golan; Tal,0,10,20,20
1683727042642,HITO 156GS,A00,185831,Patterson; Patrick H.,0,0,0,23
1683727043669,HIUS 103,A00,185832,Man; Simeon S,0,4,20,20
1683727044693,HIUS 117,A00,185836,Kwak; Nancy,2,0,20,18
1683727045720,HIUS 125,A00,185840,Man; Simeon S,0,2,23,23
1683727046750,HIUS 149,A00,185845,Staff,1,0,20,19
1683727047775,HUM 3,A01,185882,Zavodny; Tatiana Sophia,0,8,50,50
1683727047775,HUM 3,B01,185899,Caldwell; Michael Alan,0,18,50,50
1683727048800,HUM 3GS,A00,185900,Patterson; Patrick H.,0,0,0,23
1683727049825,HUM 4,A01,185938,Zroka; Amy Liane,28,0,50,22
1683727049825,HUM 4,B01,185956,Watkins; Eric,0,6,50,50
1683727049825,HUM 4,B02,202209,Watkins; Eric,0,6,50,50
1683727049825,HUM 4,B03,202210,Watkins; Eric,0,5,50,50
1683727050855,HUM 5,A01,185958,West; Geoffrey Scott,0,0,50,50
1683727050855,HUM 5,A02,202215,West; Geoffrey Scott,0,1,50,50
1683727051879,INTL 190,A00,185959,Gagnon; Jeffrey C,0,0,0,9
1683727051879,INTL 190,B00,185960,Lettieri; Michael Joseph,0,0,0,2
1683727052903,JAPN 180,A00,254509,Staff,4,0,30,26
1683727053928,LATI 10,A01,202853,Kennemore; Amy Michelle,4,0,35,31
1683727053928,LATI 10,A02,202854,Kennemore; Amy Michelle,3,0,35,32
1683727053928,LATI 10,A03,270054,Kennemore; Amy Michelle,30,0,30,0
1683727054953,LATI 180,A00,202855,Kennemore; Amy Michelle,11,0,20,9
1683727055979,LAWS 101,A00,201767,Golan; Tal,0,7,40,40
1683727057003,LIFR 1C,A00,185961,Staff,6,0,20,14
1683727058034,LIFR 1CX,A00,185962,Staff,7,0,20,13
1683727059063,LIFR 1D,A00,185963,Staff,7,0,20,13
1683727060089,LIFR 1DX,A00,185964,Staff,7,0,20,13
1683727061114,LIGN 101,A01,186039,Staff,43,0,50,7
1683727062139,LIGN 165,A00,186040,Staff,14,0,50,36
1683727063163,LTCS 108,A00,186041,Staff,5,0,10,5
1683727064190,LTCS 119,A00,186042,Staff,15,0,20,5
1683727065216,LTCS 130,A00,186043,Wesling; Megan E.,15,0,25,10
1683727067265,LTEA 138,A00,186119,Staff,13,0,40,27
1683727068290,LTEN 124,A00,186148,Staff,5,0,25,20
1683727069314,LTEN 178,A00,186149,Staff,6,0,15,9
1683727070339,LTEN 181,A00,186150,Blanco; John D,34,0,40,6
1683727071362,LTWL 120,A00,186160,Staff,19,0,25,6
1683727072391,LTWL 165,A00,186161,Staff,22,0,25,3
1683727073416,LTWR 100,A00,186162,Staff,0,5,15,15
1683727074441,LTWR 102,A00,186163,Doller; Ben,5,0,15,10
1683727075471,MAE 8,A01,186412,Staff,0,1,0,0
1683727076496,MAE 30B,A00,186445,Bahadori; Mohammad Yousef,81,0,100,19
1683727077522,MAE 40,A00,186592,Bewley; Thomas R,10,0,50,40
1683727078550,MAE 101B,A00,186593,Bahadori; Mohammad Yousef,80,0,100,20
1683727079579,MAE 105,A00,186594,Bandaru; Prabhakar,10,0,50,40
1683727080606,MAE 107,A00,186599,Pham; Hieu Tan,0,8,120,120
1683727081629,MAE 148,A01,186660,Silberman; Jack,3,0,16,13
1683727082657,MATH 10A,A01,188095,Staff,0,6,35,35
1683727083682,MATH 10B,A01,188097,Bowers; Adam R.,0,12,30,30
1683727083682,MATH 10B,A02,188099,Bowers; Adam R.,0,11,30,30
1683727083682,MATH 10B,B01,188104,Bowers; Adam R.,0,10,30,30
1683727083682,MATH 10B,B02,188106,Bowers; Adam R.,0,9,30,30
1683727084712,MATH 10C,A01,188111,Staff,0,20,30,30
1683727084712,MATH 10C,A02,188127,Staff,0,19,30,30
1683727084712,MATH 10C,A03,188131,Staff,0,19,30,30
1683727084712,MATH 10C,B01,188218,Staff,17,0,30,13
1683727084712,MATH 10C,B02,188244,Staff,13,0,30,17
1683727084712,MATH 10C,B03,188277,Staff,14,0,30,16
1683727085744,MATH 18,A01,188344,Bach; Quang Tran,18,0,30,12
1683727085744,MATH 18,A02,188345,Bach; Quang Tran,11,0,30,19
1683727085744,MATH 18,B01,188353,Bach; Quang Tran,11,0,30,19
1683727085744,MATH 18,B02,188354,Bach; Quang Tran,19,0,30,11
1683727086773,MATH 20A,A01,188374,Staff,10,0,35,25
1683727087798,MATH 20B,A01,188382,Ohm; Ko Woon,7,0,30,23
1683727087798,MATH 20B,A02,188383,Ohm; Ko Woon,22,0,30,8
1683727087798,MATH 20B,B01,188385,Ohm; Ko Woon,7,0,30,23
1683727087798,MATH 20B,B02,188392,Ohm; Ko Woon,22,0,30,8
1683727088823,MATH 20C,A01,188394,Harel; Guershon,10,0,30,20
1683727088823,MATH 20C,A02,188395,Harel; Guershon,13,0,30,17
1683727088823,MATH 20C,B01,188404,Harel; Guershon,5,0,30,25
1683727088823,MATH 20C,B02,188405,Harel; Guershon,18,0,30,12
1683727089848,MATH 20D,A01,188414,Hammock; Frances H,0,1,30,30
1683727089848,MATH 20D,A02,188415,Hammock; Frances H,0,1,30,30
1683727089848,MATH 20D,B01,188447,Hammock; Frances H,0,1,30,30
1683727089848,MATH 20D,B02,188486,Hammock; Frances H,2,0,30,28
1683727090873,MATH 20E,A01,188649,Staff,21,0,30,9
1683727090873,MATH 20E,A02,188650,Staff,20,0,30,10
1683727090873,MATH 20E,A03,188673,Staff,0,0,30,30
1683727091897,MATH 102,A01,188675,Staff,0,40,35,35
1683727092929,MATH 103B,A01,188681,Staff,3,0,35,32
1683727092929,MATH 103B,B01,188692,Staff,5,0,35,30
1683727093954,MATH 109,A01,188695,Salehi Golsefidy; Alireza,24,0,35,11
1683727093954,MATH 109,A02,188696,Salehi Golsefidy; Alireza,24,0,35,11
1683727094980,MATH 120A,A01,188698,Eggers; John Dietrich,7,0,35,28
1683727096006,MATH 142B,A01,188736,Ioana; Adrian,0,0,30,30
1683727096006,MATH 142B,A02,188741,Ioana; Adrian,0,1,30,30
1683727096006,MATH 142B,A03,188743,Ioana; Adrian,0,3,30,30
1683727097031,MATH 168A,A01,188790,Staff,0,11,35,35
1683727098056,MATH 170A,A01,188803,Nie; Jiawang,0,2,35,35
1683727098056,MATH 170A,A02,188811,Nie; Jiawang,0,1,35,35
1683727098056,MATH 170A,A03,188814,Nie; Jiawang,1,0,35,34
1683727098056,MATH 170A,A04,188815,Nie; Jiawang,5,0,35,30
1683727099084,MATH 193B,A01,188817,Staff,0,0,35,35
1683727099084,MATH 193B,A02,188818,Staff,6,0,35,29
1683727100113,MGT 4,A01,202857,Anderson; John Charles,59,0,80,21
1683727101138,MGT 12,A00,202858,Lindenberger; Wade Douglas,40,0,90,50
1683727102165,MGT 18,A00,202859,Staff,73,0,90,17
1683727103191,MGT 18GS,A00,202860,McKay; Michael J,13,0,28,15
1683727104217,MGT 45,A00,202861,Pecore; Joseph P.,8,0,90,82
1683727105243,MGT 100,A00,202863,Yavorsky; Daniel Ryan,27,0,90,63
1683727106268,MGT 103,A00,202864,Ehrich; Kristine R,0,19,90,90
1683727107296,MGT 112,A00,202865,Ehrich; Kristine R,15,0,90,75
1683727108319,MGT 121A,A00,202868,Staff,70,0,90,20
1683727109343,MGT 131B,A00,202869,Anderson; John Charles,58,0,90,32
1683727110367,MGT 136,A00,202871,Lindenberger; Wade Douglas,83,0,90,7
1683727111391,MGT 164,A00,202873,Staff,0,67,90,91
1683727112421,MGT 164GS,A00,202874,McKay; Mary A,13,0,28,15
1683727113445,MGT 180,A00,202875,Staff,0,51,90,91
1683727114475,MMW 11R,A01,205019,Herbst; Matthew,0,0,30,30
1683727114475,MMW 11R,A02,205026,Herbst; Matthew,29,0,30,1
1683727115555,MMW 15,A01,193512,Chang; Edmond Yi-Teh,0,8,28,28
1683727115555,MMW 15,A02,193513,Chang; Edmond Yi-Teh,0,5,28,28
1683727115555,MMW 15,A03,193514,Chang; Edmond Yi-Teh,0,5,28,28
1683727115555,MMW 15,A04,193515,Chang; Edmond Yi-Teh,0,5,28,28
1683727115555,MMW 15,A05,193516,Chang; Edmond Yi-Teh,0,5,28,28
1683727115555,MMW 15,A06,193517,Chang; Edmond Yi-Teh,0,6,28,28
1683727115555,MMW 15,B01,193519,Chang; Edmond Yi-Teh,0,5,28,28
1683727115555,MMW 15,B02,193520,Chang; Edmond Yi-Teh,0,5,28,28
1683727115555,MMW 15,B03,193521,Chang; Edmond Yi-Teh,0,5,28,28
1683727115555,MMW 15,B04,193522,Chang; Edmond Yi-Teh,0,6,28,28
1683727115555,MMW 15,B05,193523,Chang; Edmond Yi-Teh,0,5,28,28
1683727115555,MMW 15,B06,193524,Chang; Edmond Yi-Teh,0,5,28,28
1683727116584,MMW 122,A01,193526,Rahimi; Babak,0,16,28,28
1683727116584,MMW 122,A02,193527,Rahimi; Babak,0,15,28,28
1683727116584,MMW 122,A03,193528,Rahimi; Babak,0,0,0,0
1683727116584,MMW 122,A04,193529,Rahimi; Babak,0,0,0,0
1683727117610,MUS 1A,A01,186663,Staff,0,18,35,35
1683727118636,MUS 4,A01,186715,Staff,0,12,35,35
1683727119662,MUS 5R,A01,186796,Dubnov; Shlomo,0,17,35,35
1683727120688,MUS 6,A01,186798,Staff,0,4,25,25
1683727121712,MUS 7,A01,186830,Staff,11,0,35,24
1683727122743,MUS 8,A01,186930,Staff,0,27,35,35
1683727123768,MUS 15,A01,186932,Staff,0,15,35,35
1683727123768,MUS 15,B01,186934,Staff,0,16,35,35
1683727124797,MUS 80,A00,186935,Staff,0,0,20,20
1683727124797,MUS 80,B00,186936,Staff,24,0,25,1
1683727125826,NANO 11,A00,204702,Lipomi; Darren John,0,0,0,0
1683727126852,NANO 15,A01,204709,Yang; Kesong,0,1,0,0
1683727127878,NANO 114,A00,202069,Jahed Motlagh; Zeinab,2,0,10,8
1683727128903,PHIL 1,A00,186955,Grush; Rick Scott,31,0,40,9
1683727129927,PHIL 10,A01,186973,Grush; Rick Scott,27,0,35,8
1683727129927,PHIL 10,A02,186974,Grush; Rick Scott,33,0,35,2
1683727130953,PHIL 13,A01,186976,Staff,1,0,35,34
1683727130953,PHIL 13,A02,186977,Staff,16,0,35,19
1683727131982,PHIL 14,A01,186979,Staff,30,0,35,5
1683727131982,PHIL 14,A02,186986,Staff,32,0,35,3
1683727133009,PHIL 28,A01,186988,Staff,16,0,30,14
1683727133009,PHIL 28,A02,186989,Staff,0,0,30,30
1683727133009,PHIL 28,A03,186990,Staff,10,0,30,20
1683727133009,PHIL 28,A04,186991,Staff,26,0,30,4
1683727134037,PHIL 120,A00,186997,Staff,23,0,40,17
1683727135066,PHIL 137,A00,187003,Staff,8,0,40,32
1683727136093,PHIL 150,A00,187015,Staff,47,0,70,23
1683727137118,PHIL 167,A00,187021,Lamey; Andy M.,34,0,40,6
1683727138145,PHIL 174,A01,202226,Staff,17,0,20,3
1683727138145,PHIL 174,A02,202235,Staff,20,0,20,0
1683727139170,PHIL 191A,A00,258918,Staff,0,0,1,1
1683727140196,PHYS 1A,A00,187028,Staff,26,0,60,34
1683727141252,PHYS 1AL,001,187036,Staff,3,0,30,27
1683727141252,PHYS 1AL,002,187049,Staff,18,0,30,12
1683727142276,PHYS 1B,A00,187058,Staff,21,0,60,39
1683727143302,PHYS 1BL,001,187064,Staff,0,1,30,30
1683727143302,PHYS 1BL,002,187070,Staff,4,0,30,26
1683727144327,PHYS 1C,A00,187082,Staff,30,0,120,90
1683727145358,PHYS 1CL,001,187088,Staff,0,9,30,30
1683727145358,PHYS 1CL,002,187089,Staff,0,1,30,30
1683727145358,PHYS 1CL,009,262693,Staff,9,0,30,21
1683727146382,PHYS 2B,A01,187097,Staff,55,0,115,60
1683727147409,PHYS 2C,A01,187099,Staff,63,0,115,52
1683727148434,PHYS 2CL,A01,187101,Staff,5,0,28,23
1683727148434,PHYS 2CL,A02,187102,Staff,15,0,28,13
1683727149459,PHYS 2D,A01,187123,Shotwell; Brian,95,0,115,20
1683727150487,PHYS 4B,A01,187133,Grinstein; Benjamin,35,0,50,15
1683727151515,POLI 10,A00,188819,Staff,0,4,50,50
1683727152541,POLI 11,A00,188827,Staff,43,0,50,7
1683727153566,POLI 13R,A00,188828,Staff,0,2,20,20
1683727154591,POLI 27,A01,188830,Elgin; Samuel Zincke,0,2,70,70
1683727155621,POLI 30,A00,188832,Desposato; Scott,30,0,50,20
1683727156648,POLI 102F,A00,188834,Staff,1,0,40,39
1683727157677,POLI 104A,A00,188852,Staff,12,0,30,18
1683727158702,POLI 104I,A00,188853,Staff,0,8,20,20
1683727159728,POLI 110B,A00,188854,Wiens; David,6,0,20,14
1683727160750,POLI 112A,A00,188855,Wiens; David,3,0,30,27
1683727161774,POLI 117R,A00,188856,Forman; Fonna,0,12,20,20
1683727162799,POLI 118,A00,188857,Ingham; Sean,8,0,20,12
1683727163826,POLI 120G,A00,188858,Staff,7,0,30,23
1683727164851,POLI 131CR,A00,188863,Hoston; Germaine,20,0,50,30
1683727165875,POLI 133,A00,188864,Nellis; Gareth Hb,44,0,50,6
1683727166903,POLI 134D,A00,188865,Desposato; Scott,27,0,30,3
1683727167927,POLI 142A,A00,188871,Gartzke; Erik,21,0,50,29
1683727168952,POLI 142K,A00,188874,Staff,38,0,50,12
1683727169980,POLI 143,A00,188940,Gartzke; Erik,15,0,30,15
1683727171009,POLI 153,A00,188943,Staff,1,0,20,19
1683727172034,POLI 160AA,A00,188944,Staff,10,0,40,30
1683727173059,POLI 170A,A00,188945,Staff,10,0,30,20
1683727175113,PSYC 1,A00,188952,Staff,36,0,90,54
1683727176142,PSYC 2,B00,188953,Staff,19,0,35,16
1683727177166,PSYC 6,A00,188970,Staff,47,0,60,13
1683727178190,PSYC 7,A00,188973,Staff,35,0,45,10
1683727179216,PSYC 60,A01,188980,Rickard; Timothy C.,42,0,60,18
1683727180246,PSYC 70,A01,189001,Steiner; Eric Tomas,22,0,45,23
1683727181272,PSYC 100,A00,189005,Lacefield; Katharine I,1,98,120,119
1683727182300,PSYC 102,A00,189008,Staff,6,0,30,24
1683727183325,PSYC 106,B00,189026,Gorman; Michael R.,27,0,60,33
1683727184355,PSYC 114,B01,189033,Winkielman; Piotr,0,31,30,30
1683727185383,PSYC 131,A00,189036,Anagnostaras; Stephan,0,44,60,60
1683727186407,PSYC 136,A00,189041,Lowe; Angela Beth,0,7,25,25
1683727187432,PSYC 137,A00,189057,Winkielman; Piotr,0,36,25,25
1683727188456,PSYC 144,A00,189107,Wixted; John T,0,11,50,50
1683727190507,PSYC 162,A00,189142,Staff,0,9,85,85
1683727191534,PSYC 172,A00,189144,Gorman; Michael R.,0,6,30,30
1683727193586,PSYC 179,A00,189146,Lacefield; Katharine I,0,88,120,120
1683727194611,PSYC 181,A00,189147,Anagnostaras; Stephan,0,45,90,90
1683727195636,PSYC 190R,A00,189148,Barner; David A.,0,23,80,80
1683727196665,PSYC 191,A00,189275,Rickard; Timothy C.,0,11,25,25
1683727197694,PSYC 193,A00,189276,Chapman; Eddie Nathaniel,0,1,0,4
1683727198721,PSYC 193L,A01,189281,Lowe; Angela Beth,8,0,20,12
1683727198721,PSYC 193L,B01,189285,Staff,28,0,35,7
1683727199748,RELI 149,A00,187137,Rahimi; Babak,6,0,40,34
1683727200771,SE 9,A01,187315,Staff,0,2,18,18
1683727201795,SE 101B,A00,187409,Staff,24,0,30,6
1683727202824,SE 110B,A00,187444,Staff,10,0,40,30
1683727203848,SE 130B,A00,187449,Staff,31,0,40,9
1683727204872,SE 150A,A00,187516,Staff,8,0,20,12
1683727205905,SE 154,A00,187528,Staff,29,0,50,21
1683727206927,SIO 3,A01,258171,Staff,35,0,40,5
1683727207951,SIO 10,A00,187144,Cook; Geoffrey W,0,6,75,75
1683727208975,SIO 45,A00,187152,Cook; Geoffrey W,1,7,100,99
1683727209999,SIO 109R,A00,194486,Staff,0,4,20,20
1683727212051,SIO 187,A01,187233,Kacev; David,12,0,40,28
1683727213076,SOCI 1,A01,258656,Thorpe; Charles Robert,28,0,30,2
1683727213076,SOCI 1,A02,258658,Thorpe; Charles Robert,30,0,30,0
1683727213076,SOCI 1,A03,258661,Thorpe; Charles Robert,25,0,25,0
1683727213076,SOCI 1,A04,258666,Thorpe; Charles Robert,22,0,25,3
1683727213076,SOCI 1,A05,258897,Thorpe; Charles Robert,22,0,25,3
1683727213076,SOCI 1,A06,258898,Thorpe; Charles Robert,25,0,25,0
1683727214102,SOCI 30,A01,258903,Pardo Guerra; Juan Pablo,14,0,30,16
1683727215127,SOCI 102,A00,258904,Staff,9,0,25,16
1683727216156,SOCI 106,A00,258905,Staff,19,0,25,6
1683727217179,SOCI 111,A00,258907,Ribas Norris; Janet Vanesa,26,0,30,4
1683727218208,SOCI 121R,A00,258908,Pardo Guerra; Juan Pablo,7,0,30,23
1683727219290,SOCI 126,A01,203330,Staff,14,0,20,6
1683727220313,SOCI 131,A00,258909,Thorpe; Charles Robert,30,0,60,30
1683727221346,SOCI 135,A00,258910,Payne; Christine Anna,0,13,30,30
1683727222370,SOCI 157,A00,258911,Staff,10,0,30,20
1683727223399,SOCI 184,A00,258912,Staff,25,0,30,5
1683727224424,SOCI 188D,A00,258913,Staff,22,0,30,8
1683727225451,SYN 2,001,187529,Staff,9,0,16,7
1683727225451,SYN 2,002,201452,Staff,0,20,16,16
1683727225451,SYN 2,003,201469,Staff,1,0,16,15
1683727226475,SYN 100,A01,187531,Staff,0,9,20,20
1683727226475,SYN 100,B01,201491,Staff,0,10,20,20
1683727227507,TDAC 1,A00,189286,Walsh; Kim C.,3,0,20,17
1683727227507,TDAC 1,B00,189287,Harting; Carla Kelso,10,0,20,10
1683727228535,TDAC 101,A00,189300,Walsh; Kim C.,16,0,20,4
1683727228535,TDAC 101,B00,189301,Harting; Carla Kelso,18,0,20,2
1683727229560,TDAC 102,A00,189304,Basso; Beatrice,14,0,20,6
1683727230588,TDAC 108,A00,189305,Staff,18,0,20,2
1683727231619,TDDE 131,A00,189310,Staff,19,0,20,1
1683727231619,TDDE 131,B00,189314,Staff,19,0,20,1
1683727231619,TDDE 131,C00,189315,Staff,48,0,50,2
1683727231619,TDDE 131,D00,189316,Staff,14,0,15,1
1683727231619,TDDE 131,E00,204841,Staff,20,0,20,0
1683727232645,TDGE 10,A00,189289,Staff,26,0,50,24
1683727232645,TDGE 10,B00,189290,Havis; Allan,0,1,50,50
1683727233675,TDGE 11,A00,189291,Fulton; Julia,0,4,50,50
1683727233675,TDGE 11,B00,189292,Staff,20,0,25,5
1683727233675,TDGE 11,C00,260270,Staff,0,0,0,0
1683727234701,TDGE 25,A00,189294,Staff,1,0,20,19
1683727235726,TDGE 124,A00,189318,Fulton; Julia,0,7,50,50
1683727236753,TDGE 125,A00,189319,Staff,13,0,25,12
1683727236753,TDGE 125,B00,189320,Staff,23,0,25,2
1683727237777,TDGE 127,A00,189322,Havis; Allan,1,0,50,49
1683727238801,TDHT 101,A00,189323,Staff,18,0,25,7
1683727238801,TDHT 101,B00,189324,Staff,25,0,25,0
1683727239826,TDHT 102,A00,189325,Staff,49,0,50,1
1683727240856,TDMV 1,A00,189295,Arcidiacono; Kristin,20,0,30,10
1683727240856,TDMV 1,B00,189296,Caligagan; Maria T.,23,0,30,7
1683727241886,TDMV 2,A00,189297,Sammartano; Tonnie,27,0,30,3
1683727241886,TDMV 2,B00,189299,Arcidiacono; Kristin,23,0,30,7
1683727242917,TDMV 3,A00,204998,Rincon; Alicia,22,0,30,8
1683727243943,TDMV 120,A00,189458,Sammartano; Tonnie,28,0,30,2
1683727244970,TDMV 138,A00,189541,Jun; Grace Shin Hae,20,0,40,20
1683727246004,TDMV 142,A00,189717,Caligagan; Tony,25,0,30,5
1683727246004,TDMV 142,B00,189718,Caligagan; Maria T.,25,0,30,5
1683727247032,TMC 2,A01,187533,Staff,25,0,25,0
1683727247032,TMC 2,A02,187534,Staff,25,0,25,0
1683727248057,USP 1,A01,187536,Kwak; Nancy,0,16,25,25
1683727249082,USP 5,A01,187538,Staff,8,0,25,17
1683727250107,USP 101,A00,199253,Staff,0,4,0,0
1683727251137,USP 124,A00,187562,Boomhower; Matthew Charles,0,0,30,30
1683727252163,USP 138,A00,187582,Staff,19,0,25,6
1683727253193,USP 152,A01,187597,Staff,3,0,25,22
1683727254217,USP 153,A00,187598,Staff,18,0,25,7
1683727255244,USP 168,A00,187607,Kwak; Nancy,2,0,5,3
1683727256268,USP 173,A00,187619,Staff,4,0,25,21
1683727257292,USP 181,A00,187638,Staff,0,4,25,25
1683727258316,VIS 103,A00,187650,Cruz; Edwin Teddy,17,0,75,58
1683727259343,VIS 110D,A00,187669,Staff,13,0,22,9
1683727260368,VIS 127C,A00,187720,Shen; Kuiyi,67,0,146,79
1683727261392,VIS 149,A00,187731,Yoldas; Pinar,0,12,22,22
1683727262420,VIS 151,A01,188091,Staff,22,0,34,12
1683727262420,VIS 151,A02,188092,Staff,11,0,34,23
1683727263449,VIS 160B,A00,188093,Stalbaum; Brett,0,1,10,10
1683727265506,WCWP 10B,A00,201720,Staff,0,0,5,5
1683727265506,WCWP 10B,B00,201722,Staff,0,0,6,6
1683727266537,WCWP 100,A00,201725,Gagnon; Jeffrey C,0,0,2,2
1683727266537,WCWP 100,B00,201727,Staff,0,4,15,15
1683727269682,ANBI 133,A00,258401,Wilder; Linnea Lorene,34,0,40,6
1683727270711,ANBI 140,A00,258395,Hrvoj Mihic; Branka,18,0,25,7
1683727271735,ANSC 120,A00,258402,Bialecki; Jon Anthony,26,0,40,14
1683727272768,ANSC 144,A00,258400,Staff,12,0,40,28
1683727274822,ANSC 166,A00,258396,Parish; Steven Martin,156,0,175,19
1683727275851,ANSC 180,A00,193533,Staff,8,0,20,12
1683727276881,ANSC 188,A00,258397,Jassal; Aftab,34,0,40,6
1683727277907,ANTH 3,A01,258316,Staff,23,0,30,7
1683727278933,ANTH 5,A00,258394,Semendeferi; Ekaterini,16,0,20,4
1683727279961,ANTH 21,A01,258331,Staff,4,0,40,36
1683727280985,ANTH 103,A00,258398,Varma; Saiba,15,0,25,10
1683727282014,AWP 10,001,202034,Staff,0,0,0,0
1683727282014,AWP 10,002,202035,Staff,0,0,0,0
1683727282014,AWP 10,003,202036,Staff,0,0,0,0
1683727282014,AWP 10,004,202037,Staff,0,0,0,0
1683727282014,AWP 10,005,202038,Staff,0,0,0,0
1683727282014,AWP 10,006,202039,Staff,0,0,0,0
1683727282014,AWP 10,007,202040,Staff,0,0,0,0
1683727282014,AWP 10,008,202041,Staff,0,0,0,0
1683727282014,AWP 10,009,202042,Staff,0,0,0,0
1683727282014,AWP 10,010,202043,Staff,0,0,0,0
1683727282014,AWP 10,011,202044,Staff,0,0,0,0
1683727282014,AWP 10,012,202045,Staff,0,0,0,0
1683727282014,AWP 10,013,202046,Staff,0,0,0,0
1683727282014,AWP 10,014,202047,Staff,0,0,0,0
1683727282014,AWP 10,015,202048,Staff,0,0,0,0
1683727282014,AWP 10,016,202049,Staff,0,0,0,0
1683727282014,AWP 10,017,202050,Staff,0,0,0,0
1683727282014,AWP 10,018,202051,Staff,0,0,0,0
1683727282014,AWP 10,019,202052,Staff,0,0,0,0
1683727282014,AWP 10,020,202053,Staff,0,0,0,0
1683727282014,AWP 10,021,202054,Staff,0,0,0,0
1683727282014,AWP 10,022,202055,Staff,0,0,0,0
1683727282014,AWP 10,023,202056,Staff,0,0,0,0
1683727282014,AWP 10,024,202057,Staff,0,0,0,0
1683727282014,AWP 10,025,202058,Staff,0,0,0,0
1683727282014,AWP 10,026,202059,Staff,0,0,0,0
1683727283041,AWP 102,001,202032,Staff,0,0,0,0
1683727283041,AWP 102,002,202033,Staff,0,0,0,0
1683727284071,BENG 100,A01,254234,Taylor Amos; Alyssa C,31,0,40,9
1683727285096,BENG 196,001,270013,Engler; Adam J.,9999,0,9999,0
1683727286121,BICD 100R,A01,202018,Smith; Laurie,0,7,32,32
1683727286121,BICD 100R,A02,202019,Smith; Laurie,0,3,32,32
1683727286121,BICD 100R,A03,202020,Smith; Laurie,0,1,32,32
1683727286121,BICD 100R,A04,202021,Smith; Laurie,6,0,32,26
1683727286121,BICD 100R,A05,202022,Smith; Laurie,10,0,32,22
1683727287146,BICD 136,A01,193242,Gustafson-Brown; Cindy,0,2,32,32
1683727287146,BICD 136,A02,193244,Gustafson-Brown; Cindy,13,0,32,19
1683727288170,BIEB 102,A01,193249,Butler; Shannon Rhey,0,0,32,32
1683727288170,BIEB 102,A02,193251,Butler; Shannon Rhey,0,0,32,32
1683727288170,BIEB 102,A03,193253,Butler; Shannon Rhey,0,0,32,32
1683727288170,BIEB 102,A04,193255,Butler; Shannon Rhey,13,0,32,19
1683727288170,BIEB 102,A05,193265,Butler; Shannon Rhey,25,0,32,7
1683727288170,BIEB 102,A06,193269,Butler; Shannon Rhey,12,0,32,20
1683727290224,BIEB 150,A01,193274,Staff,0,0,32,32
1683727290224,BIEB 150,A02,193285,Staff,24,0,32,8
1683727291247,BIEB 194,A00,193286,Kurle; Carolyn M.,19,0,32,13
1683727292272,BILD 1,A01,192291,Staff,15,0,32,17
1683727292272,BILD 1,A02,192292,Staff,30,0,32,2
1683727292272,BILD 1,B01,192520,Reuther; Keefe,0,1,0,0
1683727292272,BILD 1,B02,192532,Reuther; Keefe,0,1,0,0
1683727293303,BILD 3,A01,192556,Butler; Shannon Rhey,0,0,32,32
1683727293303,BILD 3,A02,192581,Butler; Shannon Rhey,0,1,32,32
1683727293303,BILD 3,A03,192611,Butler; Shannon Rhey,19,0,32,13
1683727293303,BILD 3,A04,192612,Butler; Shannon Rhey,23,0,32,9
1683727293303,BILD 3,A05,192613,Butler; Shannon Rhey,26,0,32,6
1683727293303,BILD 3,A06,192679,Butler; Shannon Rhey,27,0,32,5
1683727293303,BILD 3,A07,192682,Butler; Shannon Rhey,20,0,32,12
1683727294330,BILD 4,A01,192836,Reuther; Keefe,1,0,24,23
1683727294330,BILD 4,A02,193044,Reuther; Keefe,4,0,24,20
1683727295359,BILD 10,A01,193142,Gustafson-Brown; Cindy,29,0,32,3
1683727295359,BILD 10,A02,193149,Gustafson-Brown; Cindy,31,0,32,1
1683727296387,BIMM 100,A01,193301,Staff,0,6,32,32
1683727296387,BIMM 100,A02,193312,Staff,0,7,32,32
1683727296387,BIMM 100,A03,193323,Staff,0,10,32,32
1683727297419,BIMM 101,A01,193329,McDonnell; Lisa Marie,0,3,24,24
1683727297419,BIMM 101,A02,193339,McDonnell; Lisa Marie,0,3,24,24
1683727297419,BIMM 101,B01,193354,McDonnell; Lisa Marie,0,4,24,24
1683727297419,BIMM 101,B02,193357,McDonnell; Lisa Marie,0,3,24,24
1683727298450,BIMM 110,A01,193377,Tat; John,0,11,32,32
1683727298450,BIMM 110,A02,193378,Tat; John,0,11,32,32
1683727299481,BIMM 120,A01,206116,Staff,0,0,32,32
1683727299481,BIMM 120,A02,206117,Staff,7,0,32,25
1683727299481,BIMM 120,A03,206121,Staff,21,0,32,11
1683727300511,BIPN 100,A01,193393,Park; Ji Young,0,15,32,32
1683727300511,BIPN 100,A02,193402,Park; Ji Young,0,14,32,32
1683727300511,BIPN 100,A03,193413,Park; Ji Young,0,14,32,32
1683727300511,BIPN 100,A04,193414,Park; Ji Young,0,13,32,32
1683727301540,BIPN 102,A01,193429,Staff,0,0,32,32
1683727301540,BIPN 102,A02,193438,Staff,18,0,32,14
1683727302566,BIPN 106,A01,193450,Reyes Gonzalez; Catalina,0,2,40,40
1683727303597,BIPN 134,A01,193465,Cooke; James Edward,0,0,32,32
1683727303597,BIPN 134,A02,193474,Cooke; James Edward,25,0,32,7
1683727303597,BIPN 134,A03,193485,Cooke; James Edward,29,0,32,3
1683727303597,BIPN 134,A04,193486,Cooke; James Edward,20,0,32,12
1683727303597,BIPN 134,A05,193491,Cooke; James Edward,31,0,32,1
1683727303597,BIPN 134,A06,193501,Cooke; James Edward,30,0,32,2
1683727303597,BIPN 134,A07,193510,Cooke; James Edward,29,0,32,3
1683727305652,BISP 194,A00,222522,Staff,14,0,32,18
1683727306682,CAT 124,A01,202407,Staff,19,0,25,6
1683727307711,CAT 125,A00,202408,Marchisotto; Jennifer Anne,2,0,20,18
1683727308737,CAT 125R,A00,202409,Smith; Lauryn Alissa,0,11,20,20
1683727308737,CAT 125R,B00,202410,Morales; Celeste Georgianna,0,11,20,20
1683727308737,CAT 125R,C00,202411,Irwin; Matthew Joseph,0,12,20,20
1683727309763,CENG 15,A01,204712,Yang; Kesong,0,1,0,0
1683727310793,CENG 114,A00,202070,Jahed Motlagh; Zeinab,5,0,20,15
1683727311824,CGS 105,A00,185477,Wesling; Megan E.,24,0,40,16
1683727312853,CGS 106,A00,185494,Staff,11,0,22,11
1683727313882,CGS 108,A00,185495,Staff,14,0,20,6
1683727314911,CGS 114,A00,185496,Staff,13,0,18,5
1683727315946,CGS 119,A00,185501,Staff,15,0,20,5
1683727316972,CGS 120,A00,185511,Staff,11,0,20,9
1683727318003,CHEM 4,A01,184675,Bussey; Thomas J,97,0,100,3
1683727319029,CHEM 6A,A01,184677,Staff,32,0,60,28
1683727320054,CHEM 6B,A01,184679,Staff,63,0,100,37
1683727321082,CHEM 6C,A01,184681,Bussey; Thomas J,0,0,50,50
1683727321082,CHEM 6C,A02,184682,Bussey; Thomas J,32,0,50,18
1683727322110,CHEM 40A,A01,184684,Albizati; Kim F.,33,0,100,67
1683727323196,CHEM 40B,A01,184686,Albizati; Kim F.,0,22,100,100
1683727324227,CHEM 41B,A01,184690,Staff,51,0,100,49
1683727325253,COGS 3,A01,184715,Boyle; Mary E. T.,0,27,40,40
1683727326282,COGS 14B,A01,185172,Staff,0,14,38,38
1683727327307,COGS 18,A01,184736,Staff,14,0,80,66
1683727328333,COGS 100,A01,184932,Staff,0,8,73,73
1683727329359,COGS 101A,A01,184935,Staff,0,40,30,30
1683727330383,COGS 101B,A01,184944,Staff,0,2,30,30
1683727331408,COGS 101C,A01,184946,Staff,0,10,30,30
1683727332434,COGS 102A,A01,184951,Johnson; Christine M.,1,0,40,39
1683727333463,COGS 107B,A01,184953,Mooshagian; Eric Frederick,0,52,40,40
1683727334487,COGS 118B,A01,184959,Gupta; Anjum,0,50,40,40
1683727335518,COGS 153,A00,184961,Staff,1,16,30,29
1683727336543,COGS 177,A00,184962,Staff,0,20,30,30
1683727337567,COGS 187A,A01,184969,Boyle; Mary E. T.,0,19,40,40
1683727338594,COMM 10,A01,185174,Staff,0,5,25,25
1683727338594,COMM 10,A02,185189,Staff,0,2,25,25
1683727338594,COMM 10,A03,269821,Staff,0,1,0,0
1683727339622,COMM 100B,A02,185476,Staff,10,0,25,15
1683727339622,COMM 100B,A03,277340,Staff,25,0,25,0
1683727340659,COMM 100C,A01,185314,Staff,2,0,25,23
1683727340659,COMM 100C,A02,185327,Staff,17,0,25,8
1683727341684,COMM 110M,A00,185349,Staff,0,0,40,40
1683727342711,COMM 113T,A00,185352,Staff,25,0,40,15
1683727343745,COMM 114I,A00,185353,Staff,31,0,40,9
1683727344774,COMM 131,A00,185354,Staff,17,0,30,13
1683727345806,CSE 8A,A50,185358,Cao; Yingjun,0,46,10,10
1683727346832,CSE 8B,A01,185362,Staff,0,48,50,50
1683727347864,CSE 11,A01,185416,Cao; Yingjun,0,91,10,10
1683727348888,CSE 20,A01,185445,Briones; Jor-el Thomas Caparas,3,0,25,22
1683727349915,CSE 21,A01,185447,Staff,9,0,50,41
1683727350942,CSE 101,A01,185451,Staff,0,13,50,50
1683727350942,CSE 101,B01,185453,Jones; Miles E,0,15,50,50
1683727352990,CSE 141,A01,185458,Eldon; John,16,0,100,84
1683727354017,CSE 141L,A01,185461,Eldon; John,8,0,100,92
1683727355049,CSE 142,A01,185463,Staff,34,0,60,26
1683727355049,CSE 142,B01,201355,Staff,0,7,60,60
1683727356075,CSE 142L,A01,185470,Staff,34,0,60,26
1683727356075,CSE 142L,B01,201417,Staff,0,6,60,60
1683727357110,CSE 190,A00,201433,Staff,32,0,49,17
1683727358140,DOC 1,A01,259136,Strom; Megan C.,7,0,15,8
1683727358140,DOC 1,A02,259137,Strom; Megan C.,15,0,15,0
1683727358140,DOC 1,A03,259138,Strom; Megan C.,14,0,15,1
1683727358140,DOC 1,A04,259139,Strom; Megan C.,13,0,15,2
1683727359165,DOC 100D,A00,259140,Pass; Natalye Joann,14,0,25,11
1683727360195,DSGN 1,A01,184749,Rill; Bryan,0,26,30,30
1683727361225,DSGN 100,A01,185168,Staff,0,2,25,25
1683727362254,ECE 5,A01,185626,Morris; Karcher William,0,12,0,0
1683727363280,ECE 101,A01,185628,Staff,14,0,70,56
1683727364311,ECE 107,A01,185635,Baghdadchi; Saharnaz,0,0,20,20
1683727364311,ECE 107,A02,185638,Baghdadchi; Saharnaz,1,0,20,19
1683727365340,ECE 148,A01,185647,Silberman; Jack,0,0,16,16
1683727366366,ECON 1,A01,185537,Crane; Meredith Helen,54,0,70,16
1683727367391,ECON 3,A01,185549,Crane; Meredith Helen,30,0,70,40
1683727368425,ECON 4,A01,203354,Anderson; John Charles,0,5,10,10
1683727369451,ECON 100A,A01,185574,Staff,0,5,40,40
1683727370477,ECON 100B,A01,185576,Staff,0,12,50,50
1683727371502,ECON 100C,A01,185589,Newhouse; Herbert S,30,0,70,40
1683727372528,ECON 105,A00,185608,Vespa; Emanuel Ignacio,19,0,35,16
1683727373557,ECON 109,A01,185610,Shishkin; Denis,9,0,35,26
1683727374582,ECON 110A,A01,185612,Staff,8,0,40,32
1683727375614,ECON 120A,A01,185615,Staff,19,0,40,21
1683727376639,ECON 120C,A01,185617,Sun; Yixiao,0,21,70,70
1683727377665,ECON 144,A00,203346,Squires; Dale E,2,0,35,33
1683727378699,ECON 171,A01,203349,Newhouse; Herbert S,0,1,35,35
1683727379728,ECON 173A,A01,185621,Toda; Alexis Akira,21,0,35,14
1683727380762,EDS 25,A01,202413,Staff,0,1,0,0
1683727380762,EDS 25,A02,202414,Staff,0,1,0,0
1683727380762,EDS 25,A03,202415,Staff,0,0,0,0
1683727380762,EDS 25,A04,202416,Staff,0,1,0,0
1683727380762,EDS 25,A05,202439,Staff,0,0,0,0
1683727380762,EDS 25,A06,202440,Staff,0,0,0,0
1683727380762,EDS 25,B01,202631,Staff,0,0,0,0
1683727380762,EDS 25,B02,202632,Staff,0,0,0,0
1683727380762,EDS 25,B03,202639,Staff,0,0,0,0
1683727380762,EDS 25,B04,202640,Staff,0,0,0,0
1683727380762,EDS 25,B05,202643,Staff,0,0,0,0
1683727380762,EDS 25,B06,202644,Staff,0,0,0,0
1683727381788,EDS 38,A01,202659,Black; Alison Michelle,25,0,25,0
1683727382822,EDS 115,A00,202652,Staff,18,0,30,12
1683727383847,EDS 125,A00,202649,Staff,13,0,30,17
1683727384877,EDS 126,A01,203332,Staff,30,0,30,0
1683727385906,EDS 139,A00,202838,Staff,16,0,25,9
1683727386935,EDS 146,A01,202655,Staff,14,0,25,11
1683727387961,ENG 15,A00,185667,Staff,0,1,0,0
1683727387961,ENG 15,B00,185672,Staff,0,0,0,0
1683727387961,ENG 15,C00,185675,Staff,0,0,0,0
1683727387961,ENG 15,D00,185682,Staff,0,0,0,0
1683727387961,ENG 15,E00,185684,Staff,0,0,0,0
1683727388986,ETHN 103,A00,185710,Staff,0,8,35,35
1683727390016,ETHN 103A,A00,199228,Man; Simeon S,0,0,9,9
1683727391047,ETHN 109,A00,185711,Staff,15,0,35,20
1683727392071,ETHN 142,A00,185726,Staff,0,4,30,30
1683727393103,ETHN 163J,A00,199229,Man; Simeon S,5,0,8,3
1683727394127,ETHN 168,A00,185727,Staff,7,0,10,3
1683727395155,ETHN 182,A00,185728,Staff,0,0,35,35
1683727396186,ETHN 183,A00,185737,Staff,10,0,18,8
1683727397210,GLBH 111,A01,209361,Burgos; Jose L.,0,0,0,0
1683727399259,HIEU 104,A00,185792,Staff,14,0,20,6
1683727400286,HIEU 115,A00,185800,Staff,0,0,20,20
1683727401310,HIEU 128,A00,185801,Staff,0,9,20,20
1683727402336,HIEU 147,A00,185802,Staff,15,0,20,5
1683727403361,HIEU 154,A00,185823,Staff,11,0,20,9
1683727404386,HILA 102,A00,185826,Staff,14,0,20,6
1683727405414,HILD 2C,A01,185778,Staff,0,13,20,20
1683727406440,HILD 7B,A01,185780,Kwak; Nancy,0,17,32,32
1683727406440,HILD 7B,A02,185781,Kwak; Nancy,0,18,32,32
1683727407472,HILD 30,A01,185791,Staff,12,0,20,8
1683727408498,HISC 119,A00,185830,Golan; Tal,0,10,20,20
1683727409527,HITO 156GS,A00,185831,Patterson; Patrick H.,0,0,0,23
1683727410553,HIUS 103,A00,185832,Man; Simeon S,0,4,20,20
1683727411581,HIUS 117,A00,185836,Kwak; Nancy,2,0,20,18
1683727412609,HIUS 125,A00,185840,Man; Simeon S,0,2,23,23
1683727413636,HIUS 149,A00,185845,Staff,1,0,20,19
1683727414661,HUM 3,A01,185882,Zavodny; Tatiana Sophia,0,8,50,50
1683727414661,HUM 3,B01,185899,Caldwell; Michael Alan,0,18,50,50
1683727415686,HUM 3GS,A00,185900,Patterson; Patrick H.,0,0,0,23
1683727416713,HUM 4,A01,185938,Zroka; Amy Liane,28,0,50,22
1683727416713,HUM 4,B01,185956,Watkins; Eric,0,6,50,50
1683727416713,HUM 4,B02,202209,Watkins; Eric,0,6,50,50
1683727416713,HUM 4,B03,202210,Watkins; Eric,0,5,50,50
1683727417745,HUM 5,A01,185958,West; Geoffrey Scott,0,0,50,50
1683727417745,HUM 5,A02,202215,West; Geoffrey Scott,0,1,50,50
1683727418774,INTL 190,A00,185959,Gagnon; Jeffrey C,0,0,0,9
1683727418774,INTL 190,B00,185960,Lettieri; Michael Joseph,0,0,0,2
1683727419806,JAPN 180,A00,254509,Staff,4,0,30,26
1683727420832,LATI 10,A01,202853,Kennemore; Amy Michelle,4,0,35,31
1683727420832,LATI 10,A02,202854,Kennemore; Amy Michelle,3,0,35,32
1683727420832,LATI 10,A03,270054,Kennemore; Amy Michelle,30,0,30,0
1683727421860,LATI 180,A00,202855,Kennemore; Amy Michelle,11,0,20,9
1683727422890,LAWS 101,A00,201767,Golan; Tal,0,7,40,40
1683727423919,LIFR 1C,A00,185961,Staff,6,0,20,14
1683727424943,LIFR 1CX,A00,185962,Staff,7,0,20,13
1683727425968,LIFR 1D,A00,185963,Staff,7,0,20,13
1683727427048,LIFR 1DX,A00,185964,Staff,7,0,20,13
1683727428078,LIGN 101,A01,186039,Staff,43,0,50,7
1683727429103,LIGN 165,A00,186040,Staff,14,0,50,36
1683727430137,LTCS 108,A00,186041,Staff,5,0,10,5
1683727431162,LTCS 119,A00,186042,Staff,15,0,20,5
1683727432193,LTCS 130,A00,186043,Wesling; Megan E.,15,0,25,10
1683727434246,LTEA 138,A00,186119,Staff,13,0,40,27
1683727435276,LTEN 124,A00,186148,Staff,5,0,25,20
1683727436301,LTEN 178,A00,186149,Staff,6,0,15,9
1683727437329,LTEN 181,A00,186150,Blanco; John D,34,0,40,6
1683727438358,LTWL 120,A00,186160,Staff,19,0,25,6
1683727439386,LTWL 165,A00,186161,Staff,22,0,25,3
1683727440410,LTWR 100,A00,186162,Staff,0,5,15,15
1683727441435,LTWR 102,A00,186163,Doller; Ben,5,0,15,10
1683727442467,MAE 8,A01,186412,Staff,0,1,0,0
1683727443495,MAE 30B,A00,186445,Bahadori; Mohammad Yousef,81,0,100,19
1683727444525,MAE 40,A00,186592,Bewley; Thomas R,10,0,50,40
1683727445550,MAE 101B,A00,186593,Bahadori; Mohammad Yousef,80,0,100,20
1683727446576,MAE 105,A00,186594,Bandaru; Prabhakar,10,0,50,40
1683727447604,MAE 107,A00,186599,Pham; Hieu Tan,0,8,120,120
1683727448629,MAE 148,A01,186660,Silberman; Jack,3,0,16,13
1683727449660,MATH 10A,A01,188095,Staff,0,6,35,35
1683727450692,MATH 10B,A01,188097,Bowers; Adam R.,0,12,30,30
1683727450692,MATH 10B,A02,188099,Bowers; Adam R.,0,11,30,30
1683727450692,MATH 10B,B01,188104,Bowers; Adam R.,0,10,30,30
1683727450692,MATH 10B,B02,188106,Bowers; Adam R.,0,9,30,30
1683727451725,MATH 10C,A01,188111,Staff,0,20,30,30
1683727451725,MATH 10C,A02,188127,Staff,0,19,30,30
1683727451725,MATH 10C,A03,188131,Staff,0,19,30,30
1683727451725,MATH 10C,B01,188218,Staff,17,0,30,13
1683727451725,MATH 10C,B02,188244,Staff,13,0,30,17
1683727451725,MATH 10C,B03,188277,Staff,14,0,30,16
1683727452752,MATH 18,A01,188344,Bach; Quang Tran,18,0,30,12
1683727452752,MATH 18,A02,188345,Bach; Quang Tran,11,0,30,19
1683727452752,MATH 18,B01,188353,Bach; Quang Tran,11,0,30,19
1683727452752,MATH 18,B02,188354,Bach; Quang Tran,19,0,30,11
1683727453782,MATH 20A,A01,188374,Staff,10,0,35,25
1683727454811,MATH 20B,A01,188382,Ohm; Ko Woon,7,0,30,23
1683727454811,MATH 20B,A02,188383,Ohm; Ko Woon,22,0,30,8
1683727454811,MATH 20B,B01,188385,Ohm; Ko Woon,7,0,30,23
1683727454811,MATH 20B,B02,188392,Ohm; Ko Woon,22,0,30,8
1683727455837,MATH 20C,A01,188394,Harel; Guershon,10,0,30,20
1683727455837,MATH 20C,A02,188395,Harel; Guershon,13,0,30,17
1683727455837,MATH 20C,B01,188404,Harel; Guershon,5,0,30,25
1683727455837,MATH 20C,B02,188405,Harel; Guershon,18,0,30,12
1683727456872,MATH 20D,A01,188414,Hammock; Frances H,0,1,30,30
1683727456872,MATH 20D,A02,188415,Hammock; Frances H,0,1,30,30
1683727456872,MATH 20D,B01,188447,Hammock; Frances H,0,1,30,30
1683727456872,MATH 20D,B02,188486,Hammock; Frances H,2,0,30,28
1683727457901,MATH 20E,A01,188649,Staff,21,0,30,9
1683727457901,MATH 20E,A02,188650,Staff,20,0,30,10
1683727457901,MATH 20E,A03,188673,Staff,0,0,30,30
1683727458926,MATH 102,A01,188675,Staff,0,40,35,35
1683727459951,MATH 103B,A01,188681,Staff,3,0,35,32
1683727459951,MATH 103B,B01,188692,Staff,5,0,35,30
1683727460979,MATH 109,A01,188695,Salehi Golsefidy; Alireza,24,0,35,11
1683727460979,MATH 109,A02,188696,Salehi Golsefidy; Alireza,24,0,35,11
1683727462010,MATH 120A,A01,188698,Eggers; John Dietrich,7,0,35,28
1683727463041,MATH 142B,A01,188736,Ioana; Adrian,0,0,30,30
1683727463041,MATH 142B,A02,188741,Ioana; Adrian,0,1,30,30
1683727463041,MATH 142B,A03,188743,Ioana; Adrian,0,3,30,30
1683727464067,MATH 168A,A01,188790,Staff,0,11,35,35
1683727465095,MATH 170A,A01,188803,Nie; Jiawang,0,2,35,35
1683727465095,MATH 170A,A02,188811,Nie; Jiawang,0,1,35,35
1683727465095,MATH 170A,A03,188814,Nie; Jiawang,1,0,35,34
1683727465095,MATH 170A,A04,188815,Nie; Jiawang,5,0,35,30
1683727466121,MATH 193B,A01,188817,Staff,0,0,35,35
1683727466121,MATH 193B,A02,188818,Staff,6,0,35,29
1683727467152,MGT 4,A01,202857,Anderson; John Charles,59,0,80,21
1683727468177,MGT 12,A00,202858,Lindenberger; Wade Douglas,40,0,90,50
1683727469205,MGT 18,A00,202859,Staff,73,0,90,17
1683727470230,MGT 18GS,A00,202860,McKay; Michael J,13,0,28,15
1683727471255,MGT 45,A00,202861,Pecore; Joseph P.,8,0,90,82
1683727472285,MGT 100,A00,202863,Yavorsky; Daniel Ryan,27,0,90,63
1683727473314,MGT 103,A00,202864,Ehrich; Kristine R,0,19,90,90
1683727474342,MGT 112,A00,202865,Ehrich; Kristine R,15,0,90,75
1683727475372,MGT 121A,A00,202868,Staff,70,0,90,20
1683727476399,MGT 131B,A00,202869,Anderson; John Charles,58,0,90,32
1683727477424,MGT 136,A00,202871,Lindenberger; Wade Douglas,83,0,90,7
1683727478449,MGT 164,A00,202873,Staff,0,67,90,91
1683727479474,MGT 164GS,A00,202874,McKay; Mary A,13,0,28,15
1683727480499,MGT 180,A00,202875,Staff,0,51,90,91
1683727481525,MMW 11R,A01,205019,Herbst; Matthew,0,0,30,30
1683727481525,MMW 11R,A02,205026,Herbst; Matthew,29,0,30,1
1683727482557,MMW 15,A01,193512,Chang; Edmond Yi-Teh,0,8,28,28
1683727482557,MMW 15,A02,193513,Chang; Edmond Yi-Teh,0,5,28,28
1683727482557,MMW 15,A03,193514,Chang; Edmond Yi-Teh,0,5,28,28
1683727482557,MMW 15,A04,193515,Chang; Edmond Yi-Teh,0,5,28,28
1683727482557,MMW 15,A05,193516,Chang; Edmond Yi-Teh,0,5,28,28
1683727482557,MMW 15,A06,193517,Chang; Edmond Yi-Teh,0,6,28,28
1683727482557,MMW 15,B01,193519,Chang; Edmond Yi-Teh,0,5,28,28
1683727482557,MMW 15,B02,193520,Chang; Edmond Yi-Teh,0,5,28,28
1683727482557,MMW 15,B03,193521,Chang; Edmond Yi-Teh,0,5,28,28
1683727482557,MMW 15,B04,193522,Chang; Edmond Yi-Teh,0,6,28,28
1683727482557,MMW 15,B05,193523,Chang; Edmond Yi-Teh,0,5,28,28
1683727482557,MMW 15,B06,193524,Chang; Edmond Yi-Teh,0,5,28,28
1683727483582,MMW 122,A01,193526,Rahimi; Babak,0,16,28,28
1683727483582,MMW 122,A02,193527,Rahimi; Babak,0,15,28,28
1683727483582,MMW 122,A03,193528,Rahimi; Babak,0,0,0,0
1683727483582,MMW 122,A04,193529,Rahimi; Babak,0,0,0,0
1683727484610,MUS 1A,A01,186663,Staff,0,18,35,35
1683727485635,MUS 4,A01,186715,Staff,0,12,35,35
1683727486667,MUS 5R,A01,186796,Dubnov; Shlomo,0,17,35,35
1683727487692,MUS 6,A01,186798,Staff,0,4,25,25
1683727488716,MUS 7,A01,186830,Staff,11,0,35,24
1683727489743,MUS 8,A01,186930,Staff,0,27,35,35
1683727490772,MUS 15,A01,186932,Staff,0,15,35,35
1683727490772,MUS 15,B01,186934,Staff,0,16,35,35
1683727491797,MUS 80,A00,186935,Staff,0,0,20,20
1683727491797,MUS 80,B00,186936,Staff,24,0,25,1
1683727492827,NANO 11,A00,204702,Lipomi; Darren John,0,0,0,0
1683727493851,NANO 15,A01,204709,Yang; Kesong,0,1,0,0
1683727494880,NANO 114,A00,202069,Jahed Motlagh; Zeinab,2,0,10,8
1683727495907,PHIL 1,A00,186955,Grush; Rick Scott,31,0,40,9
1683727496936,PHIL 10,A01,186973,Grush; Rick Scott,27,0,35,8
1683727496936,PHIL 10,A02,186974,Grush; Rick Scott,33,0,35,2
1683727497961,PHIL 13,A01,186976,Staff,1,0,35,34
1683727497961,PHIL 13,A02,186977,Staff,16,0,35,19
1683727498986,PHIL 14,A01,186979,Staff,30,0,35,5
1683727498986,PHIL 14,A02,186986,Staff,32,0,35,3
1683727500010,PHIL 28,A01,186988,Staff,16,0,30,14
1683727500010,PHIL 28,A02,186989,Staff,0,0,30,30
1683727500010,PHIL 28,A03,186990,Staff,10,0,30,20
1683727500010,PHIL 28,A04,186991,Staff,26,0,30,4
1683727501034,PHIL 120,A00,186997,Staff,23,0,40,17
1683727502059,PHIL 137,A00,187003,Staff,8,0,40,32
1683727503083,PHIL 150,A00,187015,Staff,47,0,70,23
1683727504109,PHIL 167,A00,187021,Lamey; Andy M.,34,0,40,6
1683727505139,PHIL 174,A01,202226,Staff,17,0,20,3
1683727505139,PHIL 174,A02,202235,Staff,20,0,20,0
1683727506165,PHIL 191A,A00,258918,Staff,0,0,1,1
1683727507192,PHYS 1A,A00,187028,Staff,26,0,60,34
1683727508220,PHYS 1AL,001,187036,Staff,3,0,30,27
1683727508220,PHYS 1AL,002,187049,Staff,18,0,30,12
1683727509248,PHYS 1B,A00,187058,Staff,21,0,60,39
1683727510272,PHYS 1BL,001,187064,Staff,0,1,30,30
1683727510272,PHYS 1BL,002,187070,Staff,4,0,30,26
1683727511298,PHYS 1C,A00,187082,Staff,30,0,120,90
1683727512326,PHYS 1CL,001,187088,Staff,0,9,30,30
1683727512326,PHYS 1CL,002,187089,Staff,0,1,30,30
1683727512326,PHYS 1CL,009,262693,Staff,9,0,30,21
1683727513351,PHYS 2B,A01,187097,Staff,55,0,115,60
1683727514375,PHYS 2C,A01,187099,Staff,63,0,115,52
1683727515404,PHYS 2CL,A01,187101,Staff,5,0,28,23
1683727515404,PHYS 2CL,A02,187102,Staff,15,0,28,13
1683727516428,PHYS 2D,A01,187123,Shotwell; Brian,95,0,115,20
1683727517452,PHYS 4B,A01,187133,Grinstein; Benjamin,35,0,50,15
1683727518482,POLI 10,A00,188819,Staff,0,4,50,50
1683727519507,POLI 11,A00,188827,Staff,43,0,50,7
1683727520531,POLI 13R,A00,188828,Staff,0,2,20,20
1683727521560,POLI 27,A01,188830,Elgin; Samuel Zincke,0,2,70,70
1683727522584,POLI 30,A00,188832,Desposato; Scott,30,0,50,20
1683727523609,POLI 102F,A00,188834,Staff,1,0,40,39
1683727524636,POLI 104A,A00,188852,Staff,12,0,30,18
1683727525664,POLI 104I,A00,188853,Staff,0,8,20,20
1683727526691,POLI 110B,A00,188854,Wiens; David,6,0,20,14
1683727527715,POLI 112A,A00,188855,Wiens; David,3,0,30,27
1683727528740,POLI 117R,A00,188856,Forman; Fonna,0,12,20,20
1683727529769,POLI 118,A00,188857,Ingham; Sean,8,0,20,12
1683727530853,POLI 120G,A00,188858,Staff,7,0,30,23
1683727531882,POLI 131CR,A00,188863,Hoston; Germaine,20,0,50,30
1683727532911,POLI 133,A00,188864,Nellis; Gareth Hb,44,0,50,6
1683727533940,POLI 134D,A00,188865,Desposato; Scott,27,0,30,3
1683727534971,POLI 142A,A00,188871,Gartzke; Erik,21,0,50,29
1683727536013,POLI 142K,A00,188874,Staff,38,0,50,12
1683727537038,POLI 143,A00,188940,Gartzke; Erik,15,0,30,15
1683727538061,POLI 153,A00,188943,Staff,1,0,20,19
1683727539086,POLI 160AA,A00,188944,Staff,10,0,40,30
1683727540112,POLI 170A,A00,188945,Staff,10,0,30,20
1683727542164,PSYC 1,A00,188952,Staff,36,0,90,54
1683727543192,PSYC 2,B00,188953,Staff,19,0,35,16
1683727544219,PSYC 6,A00,188970,Staff,47,0,60,13
1683727545243,PSYC 7,A00,188973,Staff,35,0,45,10
1683727546269,PSYC 60,A01,188980,Rickard; Timothy C.,42,0,60,18
1683727547298,PSYC 70,A01,189001,Steiner; Eric Tomas,22,0,45,23
1683727548323,PSYC 100,A00,189005,Lacefield; Katharine I,1,98,120,119
1683727549347,PSYC 102,A00,189008,Staff,6,0,30,24
1683727550378,PSYC 106,B00,189026,Gorman; Michael R.,27,0,60,33
1683727551403,PSYC 114,B01,189033,Winkielman; Piotr,0,31,30,30
1683727552430,PSYC 131,A00,189036,Anagnostaras; Stephan,0,44,60,60
1683727553458,PSYC 136,A00,189041,Lowe; Angela Beth,0,7,25,25
1683727554483,PSYC 137,A00,189057,Winkielman; Piotr,0,36,25,25
1683727555509,PSYC 144,A00,189107,Wixted; John T,0,11,50,50
1683727557560,PSYC 162,A00,189142,Staff,0,9,85,85
1683727558585,PSYC 172,A00,189144,Gorman; Michael R.,0,6,30,30
1683727560634,PSYC 179,A00,189146,Lacefield; Katharine I,0,88,120,120
1683727561662,PSYC 181,A00,189147,Anagnostaras; Stephan,0,45,90,90
1683727562686,PSYC 190R,A00,189148,Barner; David A.,0,23,80,80
1683727563714,PSYC 191,A00,189275,Rickard; Timothy C.,0,11,25,25
1683727564739,PSYC 193,A00,189276,Chapman; Eddie Nathaniel,0,1,0,4
1683727565769,PSYC 193L,A01,189281,Lowe; Angela Beth,8,0,20,12
1683727565769,PSYC 193L,B01,189285,Staff,28,0,35,7
1683727566795,RELI 149,A00,187137,Rahimi; Babak,6,0,40,34
1683727567821,SE 9,A01,187315,Staff,0,2,18,18
1683727568850,SE 101B,A00,187409,Staff,24,0,30,6
1683727569884,SE 110B,A00,187444,Staff,10,0,40,30
1683727570909,SE 130B,A00,187449,Staff,31,0,40,9
1683727571936,SE 150A,A00,187516,Staff,8,0,20,12
1683727572962,SE 154,A00,187528,Staff,29,0,50,21
1683727573988,SIO 3,A01,258171,Staff,35,0,40,5
1683727575015,SIO 10,A00,187144,Cook; Geoffrey W,0,6,75,75
1683727576042,SIO 45,A00,187152,Cook; Geoffrey W,1,7,100,99
1683727577066,SIO 109R,A00,194486,Staff,0,4,20,20
1683727579115,SIO 187,A01,187233,Kacev; David,12,0,40,28
1683727580144,SOCI 1,A01,258656,Thorpe; Charles Robert,28,0,30,2
1683727580144,SOCI 1,A02,258658,Thorpe; Charles Robert,30,0,30,0
1683727580144,SOCI 1,A03,258661,Thorpe; Charles Robert,25,0,25,0
1683727580144,SOCI 1,A04,258666,Thorpe; Charles Robert,22,0,25,3
1683727580144,SOCI 1,A05,258897,Thorpe; Charles Robert,22,0,25,3
1683727580144,SOCI 1,A06,258898,Thorpe; Charles Robert,25,0,25,0
1683727581170,SOCI 30,A01,258903,Pardo Guerra; Juan Pablo,14,0,30,16
1683727582194,SOCI 102,A00,258904,Staff,9,0,25,16
1683727583218,SOCI 106,A00,258905,Staff,19,0,25,6
1683727584246,SOCI 111,A00,258907,Ribas Norris; Janet Vanesa,26,0,30,4
1683727585268,SOCI 121R,A00,258908,Pardo Guerra; Juan Pablo,7,0,30,23
1683727586296,SOCI 126,A01,203330,Staff,14,0,20,6
1683727587322,SOCI 131,A00,258909,Thorpe; Charles Robert,30,0,60,30
1683727588349,SOCI 135,A00,258910,Payne; Christine Anna,0,13,30,30
1683727589372,SOCI 157,A00,258911,Staff,10,0,30,20
1683727590395,SOCI 184,A00,258912,Staff,25,0,30,5
1683727591417,SOCI 188D,A00,258913,Staff,22,0,30,8
1683727592445,SYN 2,001,187529,Staff,9,0,16,7
1683727592445,SYN 2,002,201452,Staff,0,20,16,16
1683727592445,SYN 2,003,201469,Staff,1,0,16,15
1683727593470,SYN 100,A01,187531,Staff,0,9,20,20
1683727593470,SYN 100,B01,201491,Staff,0,10,20,20
1683727594495,TDAC 1,A00,189286,Walsh; Kim C.,3,0,20,17
1683727594495,TDAC 1,B00,189287,Harting; Carla Kelso,10,0,20,10
1683727595520,TDAC 101,A00,189300,Walsh; Kim C.,16,0,20,4
1683727595520,TDAC 101,B00,189301,Harting; Carla Kelso,18,0,20,2
1683727596549,TDAC 102,A00,189304,Basso; Beatrice,14,0,20,6
1683727597578,TDAC 108,A00,189305,Staff,18,0,20,2
1683727598606,TDDE 131,A00,189310,Staff,19,0,20,1
1683727598606,TDDE 131,B00,189314,Staff,19,0,20,1
1683727598606,TDDE 131,C00,189315,Staff,48,0,50,2
1683727598606,TDDE 131,D00,189316,Staff,14,0,15,1
1683727598606,TDDE 131,E00,204841,Staff,20,0,20,0
1683727599631,TDGE 10,A00,189289,Staff,26,0,50,24
1683727599631,TDGE 10,B00,189290,Havis; Allan,0,1,50,50
1683727600664,TDGE 11,A00,189291,Fulton; Julia,0,4,50,50
1683727600664,TDGE 11,B00,189292,Staff,20,0,25,5
1683727600664,TDGE 11,C00,260270,Staff,0,0,0,0
1683727601690,TDGE 25,A00,189294,Staff,1,0,20,19
1683727602717,TDGE 124,A00,189318,Fulton; Julia,0,7,50,50
1683727603745,TDGE 125,A00,189319,Staff,13,0,25,12
1683727603745,TDGE 125,B00,189320,Staff,23,0,25,2
1683727604772,TDGE 127,A00,189322,Havis; Allan,1,0,50,49
1683727605798,TDHT 101,A00,189323,Staff,18,0,25,7
1683727605798,TDHT 101,B00,189324,Staff,25,0,25,0
1683727606825,TDHT 102,A00,189325,Staff,49,0,50,1
1683727607850,TDMV 1,A00,189295,Arcidiacono; Kristin,20,0,30,10
1683727607850,TDMV 1,B00,189296,Caligagan; Maria T.,23,0,30,7
1683727608874,TDMV 2,A00,189297,Sammartano; Tonnie,27,0,30,3
1683727608874,TDMV 2,B00,189299,Arcidiacono; Kristin,23,0,30,7
1683727609909,TDMV 3,A00,204998,Rincon; Alicia,22,0,30,8
1683727610936,TDMV 120,A00,189458,Sammartano; Tonnie,28,0,30,2
1683727611967,TDMV 138,A00,189541,Jun; Grace Shin Hae,20,0,40,20
1683727612994,TDMV 142,A00,189717,Caligagan; Tony,25,0,30,5
1683727612994,TDMV 142,B00,189718,Caligagan; Maria T.,25,0,30,5
1683727614017,TMC 2,A01,187533,Staff,25,0,25,0
1683727614017,TMC 2,A02,187534,Staff,25,0,25,0
1683727615042,USP 1,A01,187536,Kwak; Nancy,0,16,25,25
1683727616070,USP 5,A01,187538,Staff,8,0,25,17
1683727617096,USP 101,A00,199253,Staff,0,4,0,0
1683727618119,USP 124,A00,187562,Boomhower; Matthew Charles,0,0,30,30
1683727619144,USP 138,A00,187582,Staff,19,0,25,6
1683727620167,USP 152,A01,187597,Staff,3,0,25,22
1683727621192,USP 153,A00,187598,Staff,18,0,25,7
1683727622217,USP 168,A00,187607,Kwak; Nancy,2,0,5,3
1683727623240,USP 173,A00,187619,Staff,4,0,25,21
1683727624264,USP 181,A00,187638,Staff,0,4,25,25
1683727625288,VIS 103,A00,187650,Cruz; Edwin Teddy,17,0,75,58
1683727626312,VIS 110D,A00,187669,Staff,13,0,22,9
1683727627337,VIS 127C,A00,187720,Shen; Kuiyi,67,0,146,79
1683727628362,VIS 149,A00,187731,Yoldas; Pinar,0,12,22,22
1683727629390,VIS 151,A01,188091,Staff,22,0,34,12
1683727629390,VIS 151,A02,188092,Staff,11,0,34,23
1683727630418,VIS 160B,A00,188093,Stalbaum; Brett,0,1,10,10
1683727632473,WCWP 10B,A00,201720,Staff,0,0,5,5
1683727632473,WCWP 10B,B00,201722,Staff,0,0,6,6
1683727633498,WCWP 100,A00,201725,Gagnon; Jeffrey C,0,0,2,2
1683727633498,WCWP 100,B00,201727,Staff,0,4,15,15
1683727636676,ANBI 133,A00,258401,Wilder; Linnea Lorene,34,0,40,6
1683727637701,ANBI 140,A00,258395,Hrvoj Mihic; Branka,18,0,25,7
1683727638725,ANSC 120,A00,258402,Bialecki; Jon Anthony,26,0,40,14
1683727639752,ANSC 144,A00,258400,Staff,12,0,40,28
1683727641807,ANSC 166,A00,258396,Parish; Steven Martin,156,0,175,19
1683727642831,ANSC 180,A00,193533,Staff,8,0,20,12
1683727643856,ANSC 188,A00,258397,Jassal; Aftab,34,0,40,6
1683727644881,ANTH 3,A01,258316,Staff,23,0,30,7
1683727645907,ANTH 5,A00,258394,Semendeferi; Ekaterini,16,0,20,4
1683727646935,ANTH 21,A01,258331,Staff,4,0,40,36
1683727647963,ANTH 103,A00,258398,Varma; Saiba,15,0,25,10
1683727648998,AWP 10,001,202034,Staff,0,0,0,0
1683727648998,AWP 10,002,202035,Staff,0,0,0,0
1683727648998,AWP 10,003,202036,Staff,0,0,0,0
1683727648998,AWP 10,004,202037,Staff,0,0,0,0
1683727648998,AWP 10,005,202038,Staff,0,0,0,0
1683727648998,AWP 10,006,202039,Staff,0,0,0,0
1683727648998,AWP 10,007,202040,Staff,0,0,0,0
1683727648998,AWP 10,008,202041,Staff,0,0,0,0
1683727648998,AWP 10,009,202042,Staff,0,0,0,0
1683727648998,AWP 10,010,202043,Staff,0,0,0,0
1683727648998,AWP 10,011,202044,Staff,0,0,0,0
1683727648998,AWP 10,012,202045,Staff,0,0,0,0
1683727648998,AWP 10,013,202046,Staff,0,0,0,0
1683727648998,AWP 10,014,202047,Staff,0,0,0,0
1683727648998,AWP 10,015,202048,Staff,0,0,0,0
1683727648998,AWP 10,016,202049,Staff,0,0,0,0
1683727648998,AWP 10,017,202050,Staff,0,0,0,0
1683727648998,AWP 10,018,202051,Staff,0,0,0,0
1683727648998,AWP 10,019,202052,Staff,0,0,0,0
1683727648998,AWP 10,020,202053,Staff,0,0,0,0
1683727648998,AWP 10,021,202054,Staff,0,0,0,0
1683727648998,AWP 10,022,202055,Staff,0,0,0,0
1683727648998,AWP 10,023,202056,Staff,0,0,0,0
1683727648998,AWP 10,024,202057,Staff,0,0,0,0
1683727648998,AWP 10,025,202058,Staff,0,0,0,0
1683727648998,AWP 10,026,202059,Staff,0,0,0,0
1683727650027,AWP 102,001,202032,Staff,0,0,0,0
1683727650027,AWP 102,002,202033,Staff,0,0,0,0
1683727651058,BENG 100,A01,254234,Taylor Amos; Alyssa C,31,0,40,9
1683727652081,BENG 196,001,270013,Engler; Adam J.,9999,0,9999,0
1683727653109,BICD 100R,A01,202018,Smith; Laurie,0,7,32,32
1683727653109,BICD 100R,A02,202019,Smith; Laurie,0,3,32,32
1683727653109,BICD 100R,A03,202020,Smith; Laurie,0,1,32,32
1683727653109,BICD 100R,A04,202021,Smith; Laurie,6,0,32,26
1683727653109,BICD 100R,A05,202022,Smith; Laurie,10,0,32,22
1683727654137,BICD 136,A01,193242,Gustafson-Brown; Cindy,0,2,32,32
1683727654137,BICD 136,A02,193244,Gustafson-Brown; Cindy,13,0,32,19
1683727655163,BIEB 102,A01,193249,Butler; Shannon Rhey,0,0,32,32
1683727655163,BIEB 102,A02,193251,Butler; Shannon Rhey,0,0,32,32
1683727655163,BIEB 102,A03,193253,Butler; Shannon Rhey,0,0,32,32
1683727655163,BIEB 102,A04,193255,Butler; Shannon Rhey,13,0,32,19
1683727655163,BIEB 102,A05,193265,Butler; Shannon Rhey,25,0,32,7
1683727655163,BIEB 102,A06,193269,Butler; Shannon Rhey,12,0,32,20
1683727657218,BIEB 150,A01,193274,Staff,0,0,32,32
1683727657218,BIEB 150,A02,193285,Staff,24,0,32,8
1683727658247,BIEB 194,A00,193286,Kurle; Carolyn M.,19,0,32,13
1683727659278,BILD 1,A01,192291,Staff,15,0,32,17
1683727659278,BILD 1,A02,192292,Staff,30,0,32,2
1683727659278,BILD 1,B01,192520,Reuther; Keefe,0,1,0,0
1683727659278,BILD 1,B02,192532,Reuther; Keefe,0,1,0,0
1683727660304,BILD 3,A01,192556,Butler; Shannon Rhey,0,0,32,32
1683727660304,BILD 3,A02,192581,Butler; Shannon Rhey,0,1,32,32
1683727660304,BILD 3,A03,192611,Butler; Shannon Rhey,19,0,32,13
1683727660304,BILD 3,A04,192612,Butler; Shannon Rhey,23,0,32,9
1683727660304,BILD 3,A05,192613,Butler; Shannon Rhey,26,0,32,6
1683727660304,BILD 3,A06,192679,Butler; Shannon Rhey,27,0,32,5
1683727660304,BILD 3,A07,192682,Butler; Shannon Rhey,20,0,32,12
1683727661337,BILD 4,A01,192836,Reuther; Keefe,1,0,24,23
1683727661337,BILD 4,A02,193044,Reuther; Keefe,4,0,24,20
1683727662362,BILD 10,A01,193142,Gustafson-Brown; Cindy,29,0,32,3
1683727662362,BILD 10,A02,193149,Gustafson-Brown; Cindy,31,0,32,1
1683727663390,BIMM 100,A01,193301,Staff,0,6,32,32
1683727663390,BIMM 100,A02,193312,Staff,0,7,32,32
1683727663390,BIMM 100,A03,193323,Staff,0,10,32,32
1683727664426,BIMM 101,A01,193329,McDonnell; Lisa Marie,0,3,24,24
1683727664426,BIMM 101,A02,193339,McDonnell; Lisa Marie,0,3,24,24
1683727664426,BIMM 101,B01,193354,McDonnell; Lisa Marie,0,4,24,24
1683727664426,BIMM 101,B02,193357,McDonnell; Lisa Marie,0,3,24,24
1683727665456,BIMM 110,A01,193377,Tat; John,0,11,32,32
1683727665456,BIMM 110,A02,193378,Tat; John,0,11,32,32
1683727666483,BIMM 120,A01,206116,Staff,0,0,32,32
1683727666483,BIMM 120,A02,206117,Staff,7,0,32,25
1683727666483,BIMM 120,A03,206121,Staff,21,0,32,11
1683727667515,BIPN 100,A01,193393,Park; Ji Young,0,15,32,32
1683727667515,BIPN 100,A02,193402,Park; Ji Young,0,14,32,32
1683727667515,BIPN 100,A03,193413,Park; Ji Young,0,14,32,32
1683727667515,BIPN 100,A04,193414,Park; Ji Young,0,13,32,32
1683727668545,BIPN 102,A01,193429,Staff,0,0,32,32
1683727668545,BIPN 102,A02,193438,Staff,18,0,32,14
1683727669575,BIPN 106,A01,193450,Reyes Gonzalez; Catalina,0,2,40,40
1683727670601,BIPN 134,A01,193465,Cooke; James Edward,0,0,32,32
1683727670601,BIPN 134,A02,193474,Cooke; James Edward,25,0,32,7
1683727670601,BIPN 134,A03,193485,Cooke; James Edward,29,0,32,3
1683727670601,BIPN 134,A04,193486,Cooke; James Edward,20,0,32,12
1683727670601,BIPN 134,A05,193491,Cooke; James Edward,31,0,32,1
1683727670601,BIPN 134,A06,193501,Cooke; James Edward,30,0,32,2
1683727670601,BIPN 134,A07,193510,Cooke; James Edward,29,0,32,3
1683727672649,BISP 194,A00,222522,Staff,14,0,32,18
1683727673675,CAT 124,A01,202407,Staff,19,0,25,6
1683727674700,CAT 125,A00,202408,Marchisotto; Jennifer Anne,2,0,20,18
1683727675732,CAT 125R,A00,202409,Smith; Lauryn Alissa,0,11,20,20
1683727675732,CAT 125R,B00,202410,Morales; Celeste Georgianna,0,11,20,20
1683727675732,CAT 125R,C00,202411,Irwin; Matthew Joseph,0,12,20,20
1683727676758,CENG 15,A01,204712,Yang; Kesong,0,1,0,0
1683727677788,CENG 114,A00,202070,Jahed Motlagh; Zeinab,5,0,20,15
1683727678816,CGS 105,A00,185477,Wesling; Megan E.,24,0,40,16
1683727679843,CGS 106,A00,185494,Staff,11,0,22,11
1683727680869,CGS 108,A00,185495,Staff,14,0,20,6
1683727681895,CGS 114,A00,185496,Staff,13,0,18,5
1683727682919,CGS 119,A00,185501,Staff,15,0,20,5
1683727683947,CGS 120,A00,185511,Staff,11,0,20,9
1683727684971,CHEM 4,A01,184675,Bussey; Thomas J,97,0,100,3
1683727686002,CHEM 6A,A01,184677,Staff,32,0,60,28
1683727687027,CHEM 6B,A01,184679,Staff,63,0,100,37
1683727688054,CHEM 6C,A01,184681,Bussey; Thomas J,0,0,50,50
1683727688054,CHEM 6C,A02,184682,Bussey; Thomas J,32,0,50,18
1683727689084,CHEM 40A,A01,184684,Albizati; Kim F.,33,0,100,67
1683727690110,CHEM 40B,A01,184686,Albizati; Kim F.,0,22,100,100
1683727691142,CHEM 41B,A01,184690,Staff,51,0,100,49
1683727692168,COGS 3,A01,184715,Boyle; Mary E. T.,0,27,40,40
1683727693195,COGS 14B,A01,185172,Staff,0,14,38,38
1683727694220,COGS 18,A01,184736,Staff,14,0,80,66
1683727695250,COGS 100,A01,184932,Staff,0,8,73,73
1683727696276,COGS 101A,A01,184935,Staff,0,40,30,30
1683727697304,COGS 101B,A01,184944,Staff,0,2,30,30
1683727698327,COGS 101C,A01,184946,Staff,0,10,30,30
1683727699356,COGS 102A,A01,184951,Johnson; Christine M.,1,0,40,39
1683727700383,COGS 107B,A01,184953,Mooshagian; Eric Frederick,0,52,40,40
1683727701412,COGS 118B,A01,184959,Gupta; Anjum,0,50,40,40
1683727702437,COGS 153,A00,184961,Staff,1,16,30,29
1683727703462,COGS 177,A00,184962,Staff,0,20,30,30
1683727704491,COGS 187A,A01,184969,Boyle; Mary E. T.,0,19,40,40
1683727705521,COMM 10,A01,185174,Staff,0,5,25,25
1683727705521,COMM 10,A02,185189,Staff,0,2,25,25
1683727705521,COMM 10,A03,269821,Staff,0,1,0,0
1683727706546,COMM 100B,A02,185476,Staff,10,0,25,15
1683727706546,COMM 100B,A03,277340,Staff,25,0,25,0
1683727707575,COMM 100C,A01,185314,Staff,2,0,25,23
1683727707575,COMM 100C,A02,185327,Staff,17,0,25,8
1683727708600,COMM 110M,A00,185349,Staff,0,0,40,40
1683727709626,COMM 113T,A00,185352,Staff,25,0,40,15
1683727710651,COMM 114I,A00,185353,Staff,31,0,40,9
1683727711676,COMM 131,A00,185354,Staff,17,0,30,13
1683727712704,CSE 8A,A50,185358,Cao; Yingjun,0,46,10,10
1683727713727,CSE 8B,A01,185362,Staff,0,48,50,50
1683727714752,CSE 11,A01,185416,Cao; Yingjun,0,91,10,10
1683727715785,CSE 20,A01,185445,Briones; Jor-el Thomas Caparas,3,0,25,22
1683727716813,CSE 21,A01,185447,Staff,9,0,50,41
1683727717839,CSE 101,A01,185451,Staff,0,13,50,50
1683727717839,CSE 101,B01,185453,Jones; Miles E,0,15,50,50
1683727719890,CSE 141,A01,185458,Eldon; John,16,0,100,84
1683727720920,CSE 141L,A01,185461,Eldon; John,8,0,100,92
1683727721948,CSE 142,A01,185463,Staff,34,0,60,26
1683727721948,CSE 142,B01,201355,Staff,0,7,60,60
1683727722972,CSE 142L,A01,185470,Staff,34,0,60,26
1683727722972,CSE 142L,B01,201417,Staff,0,6,60,60
1683727724002,CSE 190,A00,201433,Staff,32,0,49,17
1683727725034,DOC 1,A01,259136,Strom; Megan C.,7,0,15,8
1683727725034,DOC 1,A02,259137,Strom; Megan C.,15,0,15,0
1683727725034,DOC 1,A03,259138,Strom; Megan C.,14,0,15,1
1683727725034,DOC 1,A04,259139,Strom; Megan C.,13,0,15,2
1683727726061,DOC 100D,A00,259140,Pass; Natalye Joann,14,0,25,11
1683727727086,DSGN 1,A01,184749,Rill; Bryan,0,26,30,30
1683727728115,DSGN 100,A01,185168,Staff,0,2,25,25
1683727729142,ECE 5,A01,185626,Morris; Karcher William,0,12,0,0
1683727730169,ECE 101,A01,185628,Staff,14,0,70,56
1683727731195,ECE 107,A01,185635,Baghdadchi; Saharnaz,0,0,20,20
1683727731195,ECE 107,A02,185638,Baghdadchi; Saharnaz,1,0,20,19
1683727732220,ECE 148,A01,185647,Silberman; Jack,0,0,16,16
1683727733245,ECON 1,A01,185537,Crane; Meredith Helen,54,0,70,16
1683727734269,ECON 3,A01,185549,Crane; Meredith Helen,30,0,70,40
1683727735296,ECON 4,A01,203354,Anderson; John Charles,0,5,10,10
1683727736324,ECON 100A,A01,185574,Staff,0,5,40,40
1683727737349,ECON 100B,A01,185576,Staff,0,12,50,50
1683727738446,ECON 100C,A01,185589,Newhouse; Herbert S,30,0,70,40
1683727739475,ECON 105,A00,185608,Vespa; Emanuel Ignacio,19,0,35,16
1683727740505,ECON 109,A01,185610,Shishkin; Denis,9,0,35,26
1683727741529,ECON 110A,A01,185612,Staff,8,0,40,32
1683727742561,ECON 120A,A01,185615,Staff,19,0,40,21
1683727743587,ECON 120C,A01,185617,Sun; Yixiao,0,21,70,70
1683727744612,ECON 144,A00,203346,Squires; Dale E,2,0,35,33
1683727745636,ECON 171,A01,203349,Newhouse; Herbert S,0,1,35,35
1683727746667,ECON 173A,A01,185621,Toda; Alexis Akira,21,0,35,14
1683727747690,EDS 25,A01,202413,Staff,0,1,0,0
1683727747690,EDS 25,A02,202414,Staff,0,1,0,0
1683727747690,EDS 25,A03,202415,Staff,0,0,0,0
1683727747690,EDS 25,A04,202416,Staff,0,1,0,0
1683727747690,EDS 25,A05,202439,Staff,0,0,0,0
1683727747690,EDS 25,A06,202440,Staff,0,0,0,0
1683727747690,EDS 25,B01,202631,Staff,0,0,0,0
1683727747690,EDS 25,B02,202632,Staff,0,0,0,0
1683727747690,EDS 25,B03,202639,Staff,0,0,0,0
1683727747690,EDS 25,B04,202640,Staff,0,0,0,0
1683727747690,EDS 25,B05,202643,Staff,0,0,0,0
1683727747690,EDS 25,B06,202644,Staff,0,0,0,0
1683727748722,EDS 38,A01,202659,Black; Alison Michelle,25,0,25,0
1683727749745,EDS 115,A00,202652,Staff,18,0,30,12
1683727750769,EDS 125,A00,202649,Staff,13,0,30,17
1683727751795,EDS 126,A01,203332,Staff,30,0,30,0
1683727752819,EDS 139,A00,202838,Staff,16,0,25,9
1683727753844,EDS 146,A01,202655,Staff,14,0,25,11
1683727754874,ENG 15,A00,185667,Staff,0,1,0,0
1683727754874,ENG 15,B00,185672,Staff,0,0,0,0
1683727754874,ENG 15,C00,185675,Staff,0,0,0,0
1683727754874,ENG 15,D00,185682,Staff,0,0,0,0
1683727754874,ENG 15,E00,185684,Staff,0,0,0,0
1683727755902,ETHN 103,A00,185710,Staff,0,8,35,35
1683727756926,ETHN 103A,A00,199228,Man; Simeon S,0,0,9,9
1683727757954,ETHN 109,A00,185711,Staff,15,0,35,20
1683727758981,ETHN 142,A00,185726,Staff,0,4,30,30
1683727760013,ETHN 163J,A00,199229,Man; Simeon S,5,0,8,3
1683727761038,ETHN 168,A00,185727,Staff,7,0,10,3
1683727762064,ETHN 182,A00,185728,Staff,0,0,35,35
1683727763094,ETHN 183,A00,185737,Staff,10,0,18,8
1683727764122,GLBH 111,A01,209361,Burgos; Jose L.,0,0,0,0
1683727766179,HIEU 104,A00,185792,Staff,14,0,20,6
1683727767209,HIEU 115,A00,185800,Staff,0,0,20,20
1683727768233,HIEU 128,A00,185801,Staff,0,9,20,20
1683727769258,HIEU 147,A00,185802,Staff,15,0,20,5
1683727770283,HIEU 154,A00,185823,Staff,11,0,20,9
1683727771308,HILA 102,A00,185826,Staff,14,0,20,6
1683727772336,HILD 2C,A01,185778,Staff,0,13,20,20
1683727773362,HILD 7B,A01,185780,Kwak; Nancy,0,17,32,32
1683727773362,HILD 7B,A02,185781,Kwak; Nancy,0,18,32,32
1683727774386,HILD 30,A01,185791,Staff,12,0,20,8
1683727775411,HISC 119,A00,185830,Golan; Tal,0,10,20,20
1683727776437,HITO 156GS,A00,185831,Patterson; Patrick H.,0,0,0,23
1683727777462,HIUS 103,A00,185832,Man; Simeon S,0,4,20,20
1683727778503,HIUS 117,A00,185836,Kwak; Nancy,2,0,20,18
1683727779531,HIUS 125,A00,185840,Man; Simeon S,0,2,23,23
1683727780556,HIUS 149,A00,185845,Staff,1,0,20,19
1683727781592,HUM 3,A01,185882,Zavodny; Tatiana Sophia,0,8,50,50
1683727781592,HUM 3,B01,185899,Caldwell; Michael Alan,0,18,50,50
1683727782619,HUM 3GS,A00,185900,Patterson; Patrick H.,0,0,0,23
1683727783644,HUM 4,A01,185938,Zroka; Amy Liane,28,0,50,22
1683727783644,HUM 4,B01,185956,Watkins; Eric,0,6,50,50
1683727783644,HUM 4,B02,202209,Watkins; Eric,0,6,50,50
1683727783644,HUM 4,B03,202210,Watkins; Eric,0,5,50,50
1683727784669,HUM 5,A01,185958,West; Geoffrey Scott,0,0,50,50
1683727784669,HUM 5,A02,202215,West; Geoffrey Scott,0,1,50,50
1683727785695,INTL 190,A00,185959,Gagnon; Jeffrey C,0,0,0,9
1683727785695,INTL 190,B00,185960,Lettieri; Michael Joseph,0,0,0,2
1683727786719,JAPN 180,A00,254509,Staff,4,0,30,26
1683727787745,LATI 10,A01,202853,Kennemore; Amy Michelle,4,0,35,31
1683727787745,LATI 10,A02,202854,Kennemore; Amy Michelle,3,0,35,32
1683727787745,LATI 10,A03,270054,Kennemore; Amy Michelle,30,0,30,0
1683727788773,LATI 180,A00,202855,Kennemore; Amy Michelle,11,0,20,9
1683727789798,LAWS 101,A00,201767,Golan; Tal,0,7,40,40
1683727790825,LIFR 1C,A00,185961,Staff,6,0,20,14
1683727791853,LIFR 1CX,A00,185962,Staff,7,0,20,13
1683727792877,LIFR 1D,A00,185963,Staff,7,0,20,13
1683727793904,LIFR 1DX,A00,185964,Staff,7,0,20,13
1683727794928,LIGN 101,A01,186039,Staff,43,0,50,7
1683727795952,LIGN 165,A00,186040,Staff,14,0,50,36
1683727796976,LTCS 108,A00,186041,Staff,5,0,10,5
1683727798000,LTCS 119,A00,186042,Staff,15,0,20,5
1683727799032,LTCS 130,A00,186043,Wesling; Megan E.,15,0,25,10
1683727801092,LTEA 138,A00,186119,Staff,13,0,40,27
1683727802120,LTEN 124,A00,186148,Staff,5,0,25,20
1683727803147,LTEN 178,A00,186149,Staff,6,0,15,9
1683727804171,LTEN 181,A00,186150,Blanco; John D,34,0,40,6
1683727805199,LTWL 120,A00,186160,Staff,19,0,25,6
1683727806223,LTWL 165,A00,186161,Staff,22,0,25,3
1683727807250,LTWR 100,A00,186162,Staff,0,5,15,15
1683727808274,LTWR 102,A00,186163,Doller; Ben,5,0,15,10
1683727809299,MAE 8,A01,186412,Staff,0,1,0,0
1683727810330,MAE 30B,A00,186445,Bahadori; Mohammad Yousef,81,0,100,19
1683727811355,MAE 40,A00,186592,Bewley; Thomas R,10,0,50,40
1683727812378,MAE 101B,A00,186593,Bahadori; Mohammad Yousef,80,0,100,20
1683727813401,MAE 105,A00,186594,Bandaru; Prabhakar,10,0,50,40
1683727814427,MAE 107,A00,186599,Pham; Hieu Tan,0,8,120,120
1683727815455,MAE 148,A01,186660,Silberman; Jack,3,0,16,13
1683727816481,MATH 10A,A01,188095,Staff,0,6,35,35
1683727817512,MATH 10B,A01,188097,Bowers; Adam R.,0,12,30,30
1683727817512,MATH 10B,A02,188099,Bowers; Adam R.,0,11,30,30
1683727817512,MATH 10B,B01,188104,Bowers; Adam R.,0,10,30,30
1683727817512,MATH 10B,B02,188106,Bowers; Adam R.,0,9,30,30
1683727818542,MATH 10C,A01,188111,Staff,0,20,30,30
1683727818542,MATH 10C,A02,188127,Staff,0,19,30,30
1683727818542,MATH 10C,A03,188131,Staff,0,19,30,30
1683727818542,MATH 10C,B01,188218,Staff,17,0,30,13
1683727818542,MATH 10C,B02,188244,Staff,13,0,30,17
1683727818542,MATH 10C,B03,188277,Staff,14,0,30,16
1683727819571,MATH 18,A01,188344,Bach; Quang Tran,18,0,30,12
1683727819571,MATH 18,A02,188345,Bach; Quang Tran,11,0,30,19
1683727819571,MATH 18,B01,188353,Bach; Quang Tran,11,0,30,19
1683727819571,MATH 18,B02,188354,Bach; Quang Tran,19,0,30,11
1683727820596,MATH 20A,A01,188374,Staff,10,0,35,25
1683727821621,MATH 20B,A01,188382,Ohm; Ko Woon,7,0,30,23
1683727821621,MATH 20B,A02,188383,Ohm; Ko Woon,22,0,30,8
1683727821621,MATH 20B,B01,188385,Ohm; Ko Woon,7,0,30,23
1683727821621,MATH 20B,B02,188392,Ohm; Ko Woon,22,0,30,8
1683727822646,MATH 20C,A01,188394,Harel; Guershon,10,0,30,20
1683727822646,MATH 20C,A02,188395,Harel; Guershon,13,0,30,17
1683727822646,MATH 20C,B01,188404,Harel; Guershon,5,0,30,25
1683727822646,MATH 20C,B02,188405,Harel; Guershon,18,0,30,12
1683727823677,MATH 20D,A01,188414,Hammock; Frances H,0,1,30,30
1683727823677,MATH 20D,A02,188415,Hammock; Frances H,0,1,30,30
1683727823677,MATH 20D,B01,188447,Hammock; Frances H,0,1,30,30
1683727823677,MATH 20D,B02,188486,Hammock; Frances H,2,0,30,28
1683727824705,MATH 20E,A01,188649,Staff,21,0,30,9
1683727824705,MATH 20E,A02,188650,Staff,20,0,30,10
1683727824705,MATH 20E,A03,188673,Staff,0,0,30,30
1683727825730,MATH 102,A01,188675,Staff,0,40,35,35
1683727826754,MATH 103B,A01,188681,Staff,3,0,35,32
1683727826754,MATH 103B,B01,188692,Staff,5,0,35,30
1683727827783,MATH 109,A01,188695,Salehi Golsefidy; Alireza,24,0,35,11
1683727827783,MATH 109,A02,188696,Salehi Golsefidy; Alireza,24,0,35,11
1683727828811,MATH 120A,A01,188698,Eggers; John Dietrich,7,0,35,28
1683727829840,MATH 142B,A01,188736,Ioana; Adrian,0,0,30,30
1683727829840,MATH 142B,A02,188741,Ioana; Adrian,0,1,30,30
1683727829840,MATH 142B,A03,188743,Ioana; Adrian,0,3,30,30
1683727830866,MATH 168A,A01,188790,Staff,0,11,35,35
1683727831895,MATH 170A,A01,188803,Nie; Jiawang,0,2,35,35
1683727831895,MATH 170A,A02,188811,Nie; Jiawang,0,1,35,35
1683727831895,MATH 170A,A03,188814,Nie; Jiawang,1,0,35,34
1683727831895,MATH 170A,A04,188815,Nie; Jiawang,5,0,35,30
1683727832923,MATH 193B,A01,188817,Staff,0,0,35,35
1683727832923,MATH 193B,A02,188818,Staff,6,0,35,29
1683727833951,MGT 4,A01,202857,Anderson; John Charles,59,0,80,21
1683727834981,MGT 12,A00,202858,Lindenberger; Wade Douglas,40,0,90,50
1683727836006,MGT 18,A00,202859,Staff,73,0,90,17
1683727837033,MGT 18GS,A00,202860,McKay; Michael J,13,0,28,15
1683727838058,MGT 45,A00,202861,Pecore; Joseph P.,8,0,90,82
1683727839088,MGT 100,A00,202863,Yavorsky; Daniel Ryan,27,0,90,63
1683727840111,MGT 103,A00,202864,Ehrich; Kristine R,0,19,90,90
1683727841136,MGT 112,A00,202865,Ehrich; Kristine R,15,0,90,75
1683727842218,MGT 121A,A00,202868,Staff,70,0,90,20
1683727843247,MGT 131B,A00,202869,Anderson; John Charles,58,0,90,32
1683727844276,MGT 136,A00,202871,Lindenberger; Wade Douglas,83,0,90,7
1683727845301,MGT 164,A00,202873,Staff,0,67,90,91
1683727846326,MGT 164GS,A00,202874,McKay; Mary A,13,0,28,15
1683727847354,MGT 180,A00,202875,Staff,0,51,90,91
1683727848385,MMW 11R,A01,205019,Herbst; Matthew,0,0,30,30
1683727848385,MMW 11R,A02,205026,Herbst; Matthew,29,0,30,1
1683727849416,MMW 15,A01,193512,Chang; Edmond Yi-Teh,0,8,28,28
1683727849416,MMW 15,A02,193513,Chang; Edmond Yi-Teh,0,5,28,28
1683727849416,MMW 15,A03,193514,Chang; Edmond Yi-Teh,0,5,28,28
1683727849416,MMW 15,A04,193515,Chang; Edmond Yi-Teh,0,5,28,28
1683727849416,MMW 15,A05,193516,Chang; Edmond Yi-Teh,0,5,28,28
1683727849416,MMW 15,A06,193517,Chang; Edmond Yi-Teh,0,6,28,28
1683727849416,MMW 15,B01,193519,Chang; Edmond Yi-Teh,0,5,28,28
1683727849416,MMW 15,B02,193520,Chang; Edmond Yi-Teh,0,5,28,28
1683727849416,MMW 15,B03,193521,Chang; Edmond Yi-Teh,0,5,28,28
1683727849416,MMW 15,B04,193522,Chang; Edmond Yi-Teh,0,6,28,28
1683727849416,MMW 15,B05,193523,Chang; Edmond Yi-Teh,0,5,28,28
1683727849416,MMW 15,B06,193524,Chang; Edmond Yi-Teh,0,5,28,28
1683727850439,MMW 122,A01,193526,Rahimi; Babak,0,16,28,28
1683727850439,MMW 122,A02,193527,Rahimi; Babak,0,15,28,28
1683727850439,MMW 122,A03,193528,Rahimi; Babak,0,0,0,0
1683727850439,MMW 122,A04,193529,Rahimi; Babak,0,0,0,0
1683727851464,MUS 1A,A01,186663,Staff,0,18,35,35
1683727852489,MUS 4,A01,186715,Staff,0,12,35,35
1683727853521,MUS 5R,A01,186796,Dubnov; Shlomo,0,17,35,35
1683727854546,MUS 6,A01,186798,Staff,0,4,25,25
1683727855571,MUS 7,A01,186830,Staff,11,0,35,24
1683727856596,MUS 8,A01,186930,Staff,0,27,35,35
1683727857622,MUS 15,A01,186932,Staff,0,15,35,35
1683727857622,MUS 15,B01,186934,Staff,0,16,35,35
1683727858648,MUS 80,A00,186935,Staff,0,0,20,20
1683727858648,MUS 80,B00,186936,Staff,24,0,25,1
1683727859695,NANO 11,A00,204702,Lipomi; Darren John,0,0,0,0
1683727860722,NANO 15,A01,204709,Yang; Kesong,0,1,0,0
1683727861747,NANO 114,A00,202069,Jahed Motlagh; Zeinab,2,0,10,8
1683727862773,PHIL 1,A00,186955,Grush; Rick Scott,31,0,40,9
1683727863803,PHIL 10,A01,186973,Grush; Rick Scott,27,0,35,8
1683727863803,PHIL 10,A02,186974,Grush; Rick Scott,33,0,35,2
1683727864832,PHIL 13,A01,186976,Staff,1,0,35,34
1683727864832,PHIL 13,A02,186977,Staff,16,0,35,19
1683727865855,PHIL 14,A01,186979,Staff,30,0,35,5
1683727865855,PHIL 14,A02,186986,Staff,32,0,35,3
1683727866881,PHIL 28,A01,186988,Staff,16,0,30,14
1683727866881,PHIL 28,A02,186989,Staff,0,0,30,30
1683727866881,PHIL 28,A03,186990,Staff,10,0,30,20
1683727866881,PHIL 28,A04,186991,Staff,26,0,30,4
1683727867909,PHIL 120,A00,186997,Staff,23,0,40,17
1683727868936,PHIL 137,A00,187003,Staff,8,0,40,32
1683727869961,PHIL 150,A00,187015,Staff,47,0,70,23
1683727870988,PHIL 167,A00,187021,Lamey; Andy M.,34,0,40,6
1683727872013,PHIL 174,A01,202226,Staff,17,0,20,3
1683727872013,PHIL 174,A02,202235,Staff,20,0,20,0
1683727873038,PHIL 191A,A00,258918,Staff,0,0,1,1
1683727874066,PHYS 1A,A00,187028,Staff,26,0,60,34
1683727875097,PHYS 1AL,001,187036,Staff,3,0,30,27
1683727875097,PHYS 1AL,002,187049,Staff,18,0,30,12
1683727876123,PHYS 1B,A00,187058,Staff,21,0,60,39
1683727877153,PHYS 1BL,001,187064,Staff,0,1,30,30
1683727877153,PHYS 1BL,002,187070,Staff,4,0,30,26
1683727878178,PHYS 1C,A00,187082,Staff,30,0,120,90
1683727879210,PHYS 1CL,001,187088,Staff,0,9,30,30
1683727879210,PHYS 1CL,002,187089,Staff,0,1,30,30
1683727879210,PHYS 1CL,009,262693,Staff,9,0,30,21
1683727880238,PHYS 2B,A01,187097,Staff,55,0,115,60
1683727881267,PHYS 2C,A01,187099,Staff,63,0,115,52
1683727882295,PHYS 2CL,A01,187101,Staff,5,0,28,23
1683727882295,PHYS 2CL,A02,187102,Staff,15,0,28,13
1683727883329,PHYS 2D,A01,187123,Shotwell; Brian,95,0,115,20
1683727884356,PHYS 4B,A01,187133,Grinstein; Benjamin,35,0,50,15
1683727885387,POLI 10,A00,188819,Staff,0,4,50,50
1683727886415,POLI 11,A00,188827,Staff,43,0,50,7
1683727887441,POLI 13R,A00,188828,Staff,0,2,20,20
1683727888471,POLI 27,A01,188830,Elgin; Samuel Zincke,0,2,70,70
1683727889504,POLI 30,A00,188832,Desposato; Scott,30,0,50,20
1683727890532,POLI 102F,A00,188834,Staff,1,0,40,39
1683727891558,POLI 104A,A00,188852,Staff,12,0,30,18
1683727892586,POLI 104I,A00,188853,Staff,0,8,20,20
1683727893616,POLI 110B,A00,188854,Wiens; David,6,0,20,14
1683727894646,POLI 112A,A00,188855,Wiens; David,3,0,30,27
1683727895671,POLI 117R,A00,188856,Forman; Fonna,0,12,20,20
1683727896697,POLI 118,A00,188857,Ingham; Sean,8,0,20,12
1683727897721,POLI 120G,A00,188858,Staff,7,0,30,23
1683727898747,POLI 131CR,A00,188863,Hoston; Germaine,20,0,50,30
1683727899773,POLI 133,A00,188864,Nellis; Gareth Hb,44,0,50,6
1683727900798,POLI 134D,A00,188865,Desposato; Scott,27,0,30,3
1683727901830,POLI 142A,A00,188871,Gartzke; Erik,21,0,50,29
1683727902854,POLI 142K,A00,188874,Staff,38,0,50,12
1683727903878,POLI 143,A00,188940,Gartzke; Erik,15,0,30,15
1683727904904,POLI 153,A00,188943,Staff,1,0,20,19
1683727905929,POLI 160AA,A00,188944,Staff,10,0,40,30
1683727906955,POLI 170A,A00,188945,Staff,10,0,30,20
1683727909005,PSYC 1,A00,188952,Staff,36,0,90,54
1683727910033,PSYC 2,B00,188953,Staff,19,0,35,16
1683727911058,PSYC 6,A00,188970,Staff,47,0,60,13
1683727912086,PSYC 7,A00,188973,Staff,35,0,45,10
1683727913110,PSYC 60,A01,188980,Rickard; Timothy C.,42,0,60,18
1683727914136,PSYC 70,A01,189001,Steiner; Eric Tomas,22,0,45,23
1683727915166,PSYC 100,A00,189005,Lacefield; Katharine I,1,98,120,119
1683727916194,PSYC 102,A00,189008,Staff,6,0,30,24
1683727917220,PSYC 106,B00,189026,Gorman; Michael R.,27,0,60,33
1683727918245,PSYC 114,B01,189033,Winkielman; Piotr,0,31,30,30
1683727919276,PSYC 131,A00,189036,Anagnostaras; Stephan,0,44,60,60
1683727920304,PSYC 136,A00,189041,Lowe; Angela Beth,0,7,25,25
1683727921331,PSYC 137,A00,189057,Winkielman; Piotr,0,36,25,25
1683727922356,PSYC 144,A00,189107,Wixted; John T,0,11,50,50
1683727924409,PSYC 162,A00,189142,Staff,0,9,85,85
1683727925438,PSYC 172,A00,189144,Gorman; Michael R.,0,6,30,30
1683727927489,PSYC 179,A00,189146,Lacefield; Katharine I,0,88,120,120
1683727928514,PSYC 181,A00,189147,Anagnostaras; Stephan,0,45,90,90
1683727929540,PSYC 190R,A00,189148,Barner; David A.,0,23,80,80
1683727930570,PSYC 191,A00,189275,Rickard; Timothy C.,0,11,25,25
1683727931599,PSYC 193,A00,189276,Chapman; Eddie Nathaniel,0,1,0,4
1683727932635,PSYC 193L,A01,189281,Lowe; Angela Beth,8,0,20,12
1683727932635,PSYC 193L,B01,189285,Staff,28,0,35,7
1683727933665,RELI 149,A00,187137,Rahimi; Babak,6,0,40,34
1683727934691,SE 9,A01,187315,Staff,0,2,18,18
1683727935716,SE 101B,A00,187409,Staff,24,0,30,6
1683727936742,SE 110B,A00,187444,Staff,10,0,40,30
1683727937769,SE 130B,A00,187449,Staff,31,0,40,9
1683727938795,SE 150A,A00,187516,Staff,8,0,20,12
1683727939819,SE 154,A00,187528,Staff,29,0,50,21
1683727940848,SIO 3,A01,258171,Staff,35,0,40,5
1683727941874,SIO 10,A00,187144,Cook; Geoffrey W,0,6,75,75
1683727942900,SIO 45,A00,187152,Cook; Geoffrey W,1,7,100,99
1683727943929,SIO 109R,A00,194486,Staff,0,4,20,20
1683727946042,SIO 187,A01,187233,Kacev; David,12,0,40,28
1683727947075,SOCI 1,A01,258656,Thorpe; Charles Robert,28,0,30,2
1683727947075,SOCI 1,A02,258658,Thorpe; Charles Robert,30,0,30,0
1683727947075,SOCI 1,A03,258661,Thorpe; Charles Robert,25,0,25,0
1683727947075,SOCI 1,A04,258666,Thorpe; Charles Robert,22,0,25,3
1683727947075,SOCI 1,A05,258897,Thorpe; Charles Robert,22,0,25,3
1683727947075,SOCI 1,A06,258898,Thorpe; Charles Robert,25,0,25,0
1683727948100,SOCI 30,A01,258903,Pardo Guerra; Juan Pablo,14,0,30,16
1683727949125,SOCI 102,A00,258904,Staff,9,0,25,16
1683727950151,SOCI 106,A00,258905,Staff,19,0,25,6
1683727951177,SOCI 111,A00,258907,Ribas Norris; Janet Vanesa,26,0,30,4
1683727952205,SOCI 121R,A00,258908,Pardo Guerra; Juan Pablo,7,0,30,23
1683727953237,SOCI 126,A01,203330,Staff,14,0,20,6
1683727954263,SOCI 131,A00,258909,Thorpe; Charles Robert,30,0,60,30
1683727955290,SOCI 135,A00,258910,Payne; Christine Anna,0,13,30,30
1683727956318,SOCI 157,A00,258911,Staff,10,0,30,20
1683727957348,SOCI 184,A00,258912,Staff,25,0,30,5
1683727958375,SOCI 188D,A00,258913,Staff,22,0,30,8
1683727959400,SYN 2,001,187529,Staff,9,0,16,7
1683727959400,SYN 2,002,201452,Staff,0,20,16,16
1683727959400,SYN 2,003,201469,Staff,1,0,16,15
1683727960428,SYN 100,A01,187531,Staff,0,9,20,20
1683727960428,SYN 100,B01,201491,Staff,0,10,20,20
1683727961460,TDAC 1,A00,189286,Walsh; Kim C.,3,0,20,17
1683727961460,TDAC 1,B00,189287,Harting; Carla Kelso,10,0,20,10
1683727962490,TDAC 101,A00,189300,Walsh; Kim C.,16,0,20,4
1683727962490,TDAC 101,B00,189301,Harting; Carla Kelso,18,0,20,2
1683727963522,TDAC 102,A00,189304,Basso; Beatrice,14,0,20,6
1683727964547,TDAC 108,A00,189305,Staff,18,0,20,2
1683727965579,TDDE 131,A00,189310,Staff,19,0,20,1
1683727965579,TDDE 131,B00,189314,Staff,19,0,20,1
1683727965579,TDDE 131,C00,189315,Staff,48,0,50,2
1683727965579,TDDE 131,D00,189316,Staff,14,0,15,1
1683727965579,TDDE 131,E00,204841,Staff,20,0,20,0
1683727966606,TDGE 10,A00,189289,Staff,26,0,50,24
1683727966606,TDGE 10,B00,189290,Havis; Allan,0,1,50,50
1683727967633,TDGE 11,A00,189291,Fulton; Julia,0,4,50,50
1683727967633,TDGE 11,B00,189292,Staff,20,0,25,5
1683727967633,TDGE 11,C00,260270,Staff,0,0,0,0
1683727968658,TDGE 25,A00,189294,Staff,1,0,20,19
1683727969683,TDGE 124,A00,189318,Fulton; Julia,0,7,50,50
1683727970708,TDGE 125,A00,189319,Staff,13,0,25,12
1683727970708,TDGE 125,B00,189320,Staff,23,0,25,2
1683727971738,TDGE 127,A00,189322,Havis; Allan,1,0,50,49
1683727972763,TDHT 101,A00,189323,Staff,18,0,25,7
1683727972763,TDHT 101,B00,189324,Staff,25,0,25,0
1683727973789,TDHT 102,A00,189325,Staff,49,0,50,1
1683727974815,TDMV 1,A00,189295,Arcidiacono; Kristin,20,0,30,10
1683727974815,TDMV 1,B00,189296,Caligagan; Maria T.,23,0,30,7
1683727975847,TDMV 2,A00,189297,Sammartano; Tonnie,27,0,30,3
1683727975847,TDMV 2,B00,189299,Arcidiacono; Kristin,23,0,30,7
1683727976878,TDMV 3,A00,204998,Rincon; Alicia,22,0,30,8
1683727977904,TDMV 120,A00,189458,Sammartano; Tonnie,28,0,30,2
1683727978932,TDMV 138,A00,189541,Jun; Grace Shin Hae,20,0,40,20
1683727979961,TDMV 142,A00,189717,Caligagan; Tony,25,0,30,5
1683727979961,TDMV 142,B00,189718,Caligagan; Maria T.,25,0,30,5
1683727980986,TMC 2,A01,187533,Staff,25,0,25,0
1683727980986,TMC 2,A02,187534,Staff,25,0,25,0
1683727982012,USP 1,A01,187536,Kwak; Nancy,0,16,25,25
1683727983041,USP 5,A01,187538,Staff,8,0,25,17
1683727984067,USP 101,A00,199253,Staff,0,4,0,0
1683727985092,USP 124,A00,187562,Boomhower; Matthew Charles,0,0,30,30
1683727986117,USP 138,A00,187582,Staff,19,0,25,6
1683727987147,USP 152,A01,187597,Staff,3,0,25,22
1683727988175,USP 153,A00,187598,Staff,18,0,25,7
1683727989204,USP 168,A00,187607,Kwak; Nancy,2,0,5,3
1683727990229,USP 173,A00,187619,Staff,4,0,25,21
1683727991256,USP 181,A00,187638,Staff,0,4,25,25
1683727992281,VIS 103,A00,187650,Cruz; Edwin Teddy,17,0,75,58
1683727993305,VIS 110D,A00,187669,Staff,13,0,22,9
1683727994336,VIS 127C,A00,187720,Shen; Kuiyi,67,0,146,79
1683727995361,VIS 149,A00,187731,Yoldas; Pinar,0,12,22,22
1683727996384,VIS 151,A01,188091,Staff,22,0,34,12
1683727996384,VIS 151,A02,188092,Staff,11,0,34,23
1683727997414,VIS 160B,A00,188093,Stalbaum; Brett,0,1,10,10
1683727999470,WCWP 10B,A00,201720,Staff,0,0,5,5
1683727999470,WCWP 10B,B00,201722,Staff,0,0,6,6
1683728000500,WCWP 100,A00,201725,Gagnon; Jeffrey C,0,0,2,2
1683728000500,WCWP 100,B00,201727,Staff,0,4,15,15
1683728003705,ANBI 133,A00,258401,Wilder; Linnea Lorene,34,0,40,6
1683728004731,ANBI 140,A00,258395,Hrvoj Mihic; Branka,18,0,25,7
1683728005756,ANSC 120,A00,258402,Bialecki; Jon Anthony,26,0,40,14
1683728006781,ANSC 144,A00,258400,Staff,12,0,40,28
1683728008837,ANSC 166,A00,258396,Parish; Steven Martin,156,0,175,19
1683728009862,ANSC 180,A00,193533,Staff,8,0,20,12
1683728010889,ANSC 188,A00,258397,Jassal; Aftab,34,0,40,6
1683728011914,ANTH 3,A01,258316,Staff,23,0,30,7
1683728012941,ANTH 5,A00,258394,Semendeferi; Ekaterini,16,0,20,4
1683728013968,ANTH 21,A01,258331,Staff,4,0,40,36
1683728014996,ANTH 103,A00,258398,Varma; Saiba,15,0,25,10
1683728016025,AWP 10,001,202034,Staff,0,0,0,0
1683728016025,AWP 10,002,202035,Staff,0,0,0,0
1683728016025,AWP 10,003,202036,Staff,0,0,0,0
1683728016025,AWP 10,004,202037,Staff,0,0,0,0
1683728016025,AWP 10,005,202038,Staff,0,0,0,0
1683728016025,AWP 10,006,202039,Staff,0,0,0,0
1683728016025,AWP 10,007,202040,Staff,0,0,0,0
1683728016025,AWP 10,008,202041,Staff,0,0,0,0
1683728016025,AWP 10,009,202042,Staff,0,0,0,0
1683728016025,AWP 10,010,202043,Staff,0,0,0,0
1683728016025,AWP 10,011,202044,Staff,0,0,0,0
1683728016025,AWP 10,012,202045,Staff,0,0,0,0
1683728016025,AWP 10,013,202046,Staff,0,0,0,0
1683728016025,AWP 10,014,202047,Staff,0,0,0,0
1683728016025,AWP 10,015,202048,Staff,0,0,0,0
1683728016025,AWP 10,016,202049,Staff,0,0,0,0
1683728016025,AWP 10,017,202050,Staff,0,0,0,0
1683728016025,AWP 10,018,202051,Staff,0,0,0,0
1683728016025,AWP 10,019,202052,Staff,0,0,0,0
1683728016025,AWP 10,020,202053,Staff,0,0,0,0
1683728016025,AWP 10,021,202054,Staff,0,0,0,0
1683728016025,AWP 10,022,202055,Staff,0,0,0,0
1683728016025,AWP 10,023,202056,Staff,0,0,0,0
1683728016025,AWP 10,024,202057,Staff,0,0,0,0
1683728016025,AWP 10,025,202058,Staff,0,0,0,0
1683728016025,AWP 10,026,202059,Staff,0,0,0,0
1683728017053,AWP 102,001,202032,Staff,0,0,0,0
1683728017053,AWP 102,002,202033,Staff,0,0,0,0
1683728018085,BENG 100,A01,254234,Taylor Amos; Alyssa C,31,0,40,9
1683728019114,BENG 196,001,270013,Engler; Adam J.,9999,0,9999,0
1683728020151,BICD 100R,A01,202018,Smith; Laurie,0,7,32,32
1683728020151,BICD 100R,A02,202019,Smith; Laurie,0,3,32,32
1683728020151,BICD 100R,A03,202020,Smith; Laurie,0,1,32,32
1683728020151,BICD 100R,A04,202021,Smith; Laurie,6,0,32,26
1683728020151,BICD 100R,A05,202022,Smith; Laurie,10,0,32,22
1683728021186,BICD 136,A01,193242,Gustafson-Brown; Cindy,0,2,32,32
1683728021186,BICD 136,A02,193244,Gustafson-Brown; Cindy,13,0,32,19
1683728022211,BIEB 102,A01,193249,Butler; Shannon Rhey,0,0,32,32
1683728022211,BIEB 102,A02,193251,Butler; Shannon Rhey,0,0,32,32
1683728022211,BIEB 102,A03,193253,Butler; Shannon Rhey,0,0,32,32
1683728022211,BIEB 102,A04,193255,Butler; Shannon Rhey,13,0,32,19
1683728022211,BIEB 102,A05,193265,Butler; Shannon Rhey,25,0,32,7
1683728022211,BIEB 102,A06,193269,Butler; Shannon Rhey,12,0,32,20
1683728024263,BIEB 150,A01,193274,Staff,0,0,32,32
1683728024263,BIEB 150,A02,193285,Staff,24,0,32,8
1683728025290,BIEB 194,A00,193286,Kurle; Carolyn M.,19,0,32,13
1683728026319,BILD 1,A01,192291,Staff,15,0,32,17
1683728026319,BILD 1,A02,192292,Staff,30,0,32,2
1683728026319,BILD 1,B01,192520,Reuther; Keefe,0,1,0,0
1683728026319,BILD 1,B02,192532,Reuther; Keefe,0,1,0,0
1683728027345,BILD 3,A01,192556,Butler; Shannon Rhey,0,0,32,32
1683728027345,BILD 3,A02,192581,Butler; Shannon Rhey,0,1,32,32
1683728027345,BILD 3,A03,192611,Butler; Shannon Rhey,19,0,32,13
1683728027345,BILD 3,A04,192612,Butler; Shannon Rhey,23,0,32,9
1683728027345,BILD 3,A05,192613,Butler; Shannon Rhey,26,0,32,6
1683728027345,BILD 3,A06,192679,Butler; Shannon Rhey,27,0,32,5
1683728027345,BILD 3,A07,192682,Butler; Shannon Rhey,20,0,32,12
1683728028374,BILD 4,A01,192836,Reuther; Keefe,1,0,24,23
1683728028374,BILD 4,A02,193044,Reuther; Keefe,4,0,24,20
1683728029399,BILD 10,A01,193142,Gustafson-Brown; Cindy,29,0,32,3
1683728029399,BILD 10,A02,193149,Gustafson-Brown; Cindy,31,0,32,1
1683728030428,BIMM 100,A01,193301,Staff,0,6,32,32
1683728030428,BIMM 100,A02,193312,Staff,0,7,32,32
1683728030428,BIMM 100,A03,193323,Staff,0,10,32,32
1683728031455,BIMM 101,A01,193329,McDonnell; Lisa Marie,0,3,24,24
1683728031455,BIMM 101,A02,193339,McDonnell; Lisa Marie,0,3,24,24
1683728031455,BIMM 101,B01,193354,McDonnell; Lisa Marie,0,4,24,24
1683728031455,BIMM 101,B02,193357,McDonnell; Lisa Marie,0,3,24,24
1683728032481,BIMM 110,A01,193377,Tat; John,0,11,32,32
1683728032481,BIMM 110,A02,193378,Tat; John,0,11,32,32
1683728033507,BIMM 120,A01,206116,Staff,0,0,32,32
1683728033507,BIMM 120,A02,206117,Staff,7,0,32,25
1683728033507,BIMM 120,A03,206121,Staff,21,0,32,11
1683728034532,BIPN 100,A01,193393,Park; Ji Young,0,15,32,32
1683728034532,BIPN 100,A02,193402,Park; Ji Young,0,14,32,32
1683728034532,BIPN 100,A03,193413,Park; Ji Young,0,14,32,32
1683728034532,BIPN 100,A04,193414,Park; Ji Young,0,13,32,32
1683728035561,BIPN 102,A01,193429,Staff,0,0,32,32
1683728035561,BIPN 102,A02,193438,Staff,18,0,32,14
1683728036587,BIPN 106,A01,193450,Reyes Gonzalez; Catalina,0,2,40,40
1683728037612,BIPN 134,A01,193465,Cooke; James Edward,0,0,32,32
1683728037612,BIPN 134,A02,193474,Cooke; James Edward,25,0,32,7
1683728037612,BIPN 134,A03,193485,Cooke; James Edward,29,0,32,3
1683728037612,BIPN 134,A04,193486,Cooke; James Edward,20,0,32,12
1683728037612,BIPN 134,A05,193491,Cooke; James Edward,31,0,32,1
1683728037612,BIPN 134,A06,193501,Cooke; James Edward,30,0,32,2
1683728037612,BIPN 134,A07,193510,Cooke; James Edward,29,0,32,3
1683728039662,BISP 194,A00,222522,Staff,14,0,32,18
1683728040687,CAT 124,A01,202407,Staff,19,0,25,6
1683728041714,CAT 125,A00,202408,Marchisotto; Jennifer Anne,2,0,20,18
1683728042750,CAT 125R,A00,202409,Smith; Lauryn Alissa,0,11,20,20
1683728042750,CAT 125R,B00,202410,Morales; Celeste Georgianna,0,11,20,20
1683728042750,CAT 125R,C00,202411,Irwin; Matthew Joseph,0,12,20,20
1683728043776,CENG 15,A01,204712,Yang; Kesong,0,1,0,0
1683728044806,CENG 114,A00,202070,Jahed Motlagh; Zeinab,5,0,20,15
1683728045839,CGS 105,A00,185477,Wesling; Megan E.,24,0,40,16
1683728046865,CGS 106,A00,185494,Staff,11,0,22,11
1683728047890,CGS 108,A00,185495,Staff,14,0,20,6
1683728048917,CGS 114,A00,185496,Staff,13,0,18,5
1683728050012,CGS 119,A00,185501,Staff,15,0,20,5
1683728051041,CGS 120,A00,185511,Staff,11,0,20,9
1683728052071,CHEM 4,A01,184675,Bussey; Thomas J,97,0,100,3
1683728053095,CHEM 6A,A01,184677,Staff,32,0,60,28
1683728054123,CHEM 6B,A01,184679,Staff,63,0,100,37
1683728055148,CHEM 6C,A01,184681,Bussey; Thomas J,0,0,50,50
1683728055148,CHEM 6C,A02,184682,Bussey; Thomas J,32,0,50,18
1683728056172,CHEM 40A,A01,184684,Albizati; Kim F.,33,0,100,67
1683728057196,CHEM 40B,A01,184686,Albizati; Kim F.,0,22,100,100
1683728058224,CHEM 41B,A01,184690,Staff,51,0,100,49
1683728059255,COGS 3,A01,184715,Boyle; Mary E. T.,0,27,40,40
1683728060279,COGS 14B,A01,185172,Staff,0,14,38,38
1683728061309,COGS 18,A01,184736,Staff,14,0,80,66
1683728062333,COGS 100,A01,184932,Staff,0,8,73,73
1683728063363,COGS 101A,A01,184935,Staff,0,40,30,30
1683728064392,COGS 101B,A01,184944,Staff,0,2,30,30
1683728065416,COGS 101C,A01,184946,Staff,0,10,30,30
1683728066442,COGS 102A,A01,184951,Johnson; Christine M.,1,0,40,39
1683728067468,COGS 107B,A01,184953,Mooshagian; Eric Frederick,0,52,40,40
1683728068497,COGS 118B,A01,184959,Gupta; Anjum,0,50,40,40
1683728069524,COGS 153,A00,184961,Staff,1,16,30,29
1683728070558,COGS 177,A00,184962,Staff,0,20,30,30
1683728071584,COGS 187A,A01,184969,Boyle; Mary E. T.,0,19,40,40
1683728072609,COMM 10,A01,185174,Staff,0,5,25,25
1683728072609,COMM 10,A02,185189,Staff,0,2,25,25
1683728072609,COMM 10,A03,269821,Staff,0,1,0,0
1683728073635,COMM 100B,A02,185476,Staff,10,0,25,15
1683728073635,COMM 100B,A03,277340,Staff,25,0,25,0
1683728074657,COMM 100C,A01,185314,Staff,2,0,25,23
1683728074657,COMM 100C,A02,185327,Staff,17,0,25,8
1683728075681,COMM 110M,A00,185349,Staff,0,0,40,40
1683728076708,COMM 113T,A00,185352,Staff,25,0,40,15
1683728077735,COMM 114I,A00,185353,Staff,31,0,40,9
1683728078760,COMM 131,A00,185354,Staff,17,0,30,13
1683728079788,CSE 8A,A50,185358,Cao; Yingjun,0,46,10,10
1683728080813,CSE 8B,A01,185362,Staff,0,48,50,50
1683728081837,CSE 11,A01,185416,Cao; Yingjun,0,91,10,10
1683728082862,CSE 20,A01,185445,Briones; Jor-el Thomas Caparas,3,0,25,22
1683728083887,CSE 21,A01,185447,Staff,9,0,50,41
1683728084914,CSE 101,A01,185451,Staff,0,13,50,50
1683728084914,CSE 101,B01,185453,Jones; Miles E,0,15,50,50
1683728086966,CSE 141,A01,185458,Eldon; John,16,0,100,84
1683728087993,CSE 141L,A01,185461,Eldon; John,8,0,100,92
1683728089018,CSE 142,A01,185463,Staff,34,0,60,26
1683728089018,CSE 142,B01,201355,Staff,0,7,60,60
1683728090046,CSE 142L,A01,185470,Staff,34,0,60,26
1683728090046,CSE 142L,B01,201417,Staff,0,6,60,60
1683728091070,CSE 190,A00,201433,Staff,32,0,49,17
1683728092098,DOC 1,A01,259136,Strom; Megan C.,7,0,15,8
1683728092098,DOC 1,A02,259137,Strom; Megan C.,15,0,15,0
1683728092098,DOC 1,A03,259138,Strom; Megan C.,14,0,15,1
1683728092098,DOC 1,A04,259139,Strom; Megan C.,13,0,15,2
1683728093127,DOC 100D,A00,259140,Pass; Natalye Joann,14,0,25,11
1683728094152,DSGN 1,A01,184749,Rill; Bryan,0,26,30,30
1683728095178,DSGN 100,A01,185168,Staff,0,2,25,25
1683728096207,ECE 5,A01,185626,Morris; Karcher William,0,12,0,0
1683728097234,ECE 101,A01,185628,Staff,14,0,70,56
1683728098257,ECE 107,A01,185635,Baghdadchi; Saharnaz,0,0,20,20
1683728098257,ECE 107,A02,185638,Baghdadchi; Saharnaz,1,0,20,19
1683728099284,ECE 148,A01,185647,Silberman; Jack,0,0,16,16
1683728100308,ECON 1,A01,185537,Crane; Meredith Helen,54,0,70,16
1683728101334,ECON 3,A01,185549,Crane; Meredith Helen,30,0,70,40
1683728102363,ECON 4,A01,203354,Anderson; John Charles,0,5,10,10
1683728103392,ECON 100A,A01,185574,Staff,0,5,40,40
1683728104422,ECON 100B,A01,185576,Staff,0,12,50,50
1683728105447,ECON 100C,A01,185589,Newhouse; Herbert S,30,0,70,40
1683728106472,ECON 105,A00,185608,Vespa; Emanuel Ignacio,19,0,35,16
1683728107497,ECON 109,A01,185610,Shishkin; Denis,9,0,35,26
1683728108522,ECON 110A,A01,185612,Staff,8,0,40,32
1683728109546,ECON 120A,A01,185615,Staff,19,0,40,21
1683728110570,ECON 120C,A01,185617,Sun; Yixiao,0,21,70,70
1683728111596,ECON 144,A00,203346,Squires; Dale E,2,0,35,33
1683728112623,ECON 171,A01,203349,Newhouse; Herbert S,0,1,35,35
1683728113652,ECON 173A,A01,185621,Toda; Alexis Akira,21,0,35,14
1683728114679,EDS 25,A01,202413,Staff,0,1,0,0
1683728114679,EDS 25,A02,202414,Staff,0,1,0,0
1683728114679,EDS 25,A03,202415,Staff,0,0,0,0
1683728114679,EDS 25,A04,202416,Staff,0,1,0,0
1683728114679,EDS 25,A05,202439,Staff,0,0,0,0
1683728114679,EDS 25,A06,202440,Staff,0,0,0,0
1683728114679,EDS 25,B01,202631,Staff,0,0,0,0
1683728114679,EDS 25,B02,202632,Staff,0,0,0,0
1683728114679,EDS 25,B03,202639,Staff,0,0,0,0
1683728114679,EDS 25,B04,202640,Staff,0,0,0,0
1683728114679,EDS 25,B05,202643,Staff,0,0,0,0
1683728114679,EDS 25,B06,202644,Staff,0,0,0,0
1683728115704,EDS 38,A01,202659,Black; Alison Michelle,25,0,25,0
1683728116732,EDS 115,A00,202652,Staff,18,0,30,12
1683728117758,EDS 125,A00,202649,Staff,13,0,30,17
1683728118786,EDS 126,A01,203332,Staff,30,0,30,0
1683728119811,EDS 139,A00,202838,Staff,16,0,25,9
1683728120839,EDS 146,A01,202655,Staff,14,0,25,11
1683728121863,ENG 15,A00,185667,Staff,0,1,0,0
1683728121863,ENG 15,B00,185672,Staff,0,0,0,0
1683728121863,ENG 15,C00,185675,Staff,0,0,0,0
1683728121863,ENG 15,D00,185682,Staff,0,0,0,0
1683728121863,ENG 15,E00,185684,Staff,0,0,0,0
1683728122889,ETHN 103,A00,185710,Staff,0,8,35,35
1683728123918,ETHN 103A,A00,199228,Man; Simeon S,0,0,9,9
1683728124942,ETHN 109,A00,185711,Staff,15,0,35,20
1683728125969,ETHN 142,A00,185726,Staff,0,4,30,30
1683728126993,ETHN 163J,A00,199229,Man; Simeon S,5,0,8,3
1683728128018,ETHN 168,A00,185727,Staff,7,0,10,3
1683728129044,ETHN 182,A00,185728,Staff,0,0,35,35
1683728130070,ETHN 183,A00,185737,Staff,10,0,18,8
1683728131098,GLBH 111,A01,209361,Burgos; Jose L.,0,0,0,0
1683728133153,HIEU 104,A00,185792,Staff,14,0,20,6
1683728134179,HIEU 115,A00,185800,Staff,0,0,20,20
1683728135204,HIEU 128,A00,185801,Staff,0,9,20,20
1683728136228,HIEU 147,A00,185802,Staff,15,0,20,5
1683728137256,HIEU 154,A00,185823,Staff,11,0,20,9
1683728138282,HILA 102,A00,185826,Staff,14,0,20,6
1683728139306,HILD 2C,A01,185778,Staff,0,13,20,20
1683728140331,HILD 7B,A01,185780,Kwak; Nancy,0,17,32,32
1683728140331,HILD 7B,A02,185781,Kwak; Nancy,0,18,32,32
1683728141360,HILD 30,A01,185791,Staff,12,0,20,8
1683728142384,HISC 119,A00,185830,Golan; Tal,0,10,20,20
1683728143410,HITO 156GS,A00,185831,Patterson; Patrick H.,0,0,0,23
1683728144435,HIUS 103,A00,185832,Man; Simeon S,0,4,20,20
1683728145462,HIUS 117,A00,185836,Kwak; Nancy,2,0,20,18
1683728146490,HIUS 125,A00,185840,Man; Simeon S,0,2,23,23
1683728147516,HIUS 149,A00,185845,Staff,1,0,20,19
1683728148548,HUM 3,A01,185882,Zavodny; Tatiana Sophia,0,8,50,50
1683728148548,HUM 3,B01,185899,Caldwell; Michael Alan,0,18,50,50
1683728149575,HUM 3GS,A00,185900,Patterson; Patrick H.,0,0,0,23
1683728150607,HUM 4,A01,185938,Zroka; Amy Liane,28,0,50,22
1683728150607,HUM 4,B01,185956,Watkins; Eric,0,6,50,50
1683728150607,HUM 4,B02,202209,Watkins; Eric,0,6,50,50
1683728150607,HUM 4,B03,202210,Watkins; Eric,0,5,50,50
1683728151632,HUM 5,A01,185958,West; Geoffrey Scott,0,0,50,50
1683728151632,HUM 5,A02,202215,West; Geoffrey Scott,0,1,50,50
1683728152657,INTL 190,A00,185959,Gagnon; Jeffrey C,0,0,0,9
1683728152657,INTL 190,B00,185960,Lettieri; Michael Joseph,0,0,0,2
1683728154476,JAPN 180,A00,254509,Staff,4,0,30,26
1683728155505,LATI 10,A01,202853,Kennemore; Amy Michelle,4,0,35,31
1683728155505,LATI 10,A02,202854,Kennemore; Amy Michelle,3,0,35,32
1683728155505,LATI 10,A03,270054,Kennemore; Amy Michelle,30,0,30,0
1683728156529,LATI 180,A00,202855,Kennemore; Amy Michelle,11,0,20,9
1683728157554,LAWS 101,A00,201767,Golan; Tal,0,7,40,40
1683728158580,LIFR 1C,A00,185961,Staff,6,0,20,14
1683728159609,LIFR 1CX,A00,185962,Staff,7,0,20,13
1683728160634,LIFR 1D,A00,185963,Staff,7,0,20,13
1683728161662,LIFR 1DX,A00,185964,Staff,7,0,20,13
1683728162690,LIGN 101,A01,186039,Staff,43,0,50,7
1683728163718,LIGN 165,A00,186040,Staff,14,0,50,36
1683728164742,LTCS 108,A00,186041,Staff,5,0,10,5
1683728165767,LTCS 119,A00,186042,Staff,15,0,20,5
1683728166797,LTCS 130,A00,186043,Wesling; Megan E.,15,0,25,10
1683728168855,LTEA 138,A00,186119,Staff,13,0,40,27
1683728169882,LTEN 124,A00,186148,Staff,5,0,25,20
1683728170909,LTEN 178,A00,186149,Staff,6,0,15,9
1683728171938,LTEN 181,A00,186150,Blanco; John D,34,0,40,6
1683728172963,LTWL 120,A00,186160,Staff,19,0,25,6
1683728173987,LTWL 165,A00,186161,Staff,22,0,25,3
1683728175012,LTWR 100,A00,186162,Staff,0,5,15,15
1683728176037,LTWR 102,A00,186163,Doller; Ben,5,0,15,10
1683728177063,MAE 8,A01,186412,Staff,0,1,0,0
1683728178088,MAE 30B,A00,186445,Bahadori; Mohammad Yousef,81,0,100,19
1683728179112,MAE 40,A00,186592,Bewley; Thomas R,10,0,50,40
1683728180137,MAE 101B,A00,186593,Bahadori; Mohammad Yousef,80,0,100,20
1683728181162,MAE 105,A00,186594,Bandaru; Prabhakar,10,0,50,40
1683728182186,MAE 107,A00,186599,Pham; Hieu Tan,0,8,120,120
1683728183212,MAE 148,A01,186660,Silberman; Jack,3,0,16,13
1683728184247,MATH 10A,A01,188095,Staff,0,6,35,35
1683728185274,MATH 10B,A01,188097,Bowers; Adam R.,0,12,30,30
1683728185274,MATH 10B,A02,188099,Bowers; Adam R.,0,11,30,30
1683728185274,MATH 10B,B01,188104,Bowers; Adam R.,0,10,30,30
1683728185274,MATH 10B,B02,188106,Bowers; Adam R.,0,9,30,30
1683728186299,MATH 10C,A01,188111,Staff,0,20,30,30
1683728186299,MATH 10C,A02,188127,Staff,0,19,30,30
1683728186299,MATH 10C,A03,188131,Staff,0,19,30,30
1683728186299,MATH 10C,B01,188218,Staff,17,0,30,13
1683728186299,MATH 10C,B02,188244,Staff,13,0,30,17
1683728186299,MATH 10C,B03,188277,Staff,14,0,30,16
1683728187329,MATH 18,A01,188344,Bach; Quang Tran,18,0,30,12
1683728187329,MATH 18,A02,188345,Bach; Quang Tran,11,0,30,19
1683728187329,MATH 18,B01,188353,Bach; Quang Tran,11,0,30,19
1683728187329,MATH 18,B02,188354,Bach; Quang Tran,19,0,30,11
1683728188353,MATH 20A,A01,188374,Staff,10,0,35,25
1683728189386,MATH 20B,A01,188382,Ohm; Ko Woon,7,0,30,23
1683728189386,MATH 20B,A02,188383,Ohm; Ko Woon,22,0,30,8
1683728189386,MATH 20B,B01,188385,Ohm; Ko Woon,7,0,30,23
1683728189386,MATH 20B,B02,188392,Ohm; Ko Woon,22,0,30,8
1683728190422,MATH 20C,A01,188394,Harel; Guershon,10,0,30,20
1683728190422,MATH 20C,A02,188395,Harel; Guershon,13,0,30,17
1683728190422,MATH 20C,B01,188404,Harel; Guershon,5,0,30,25
1683728190422,MATH 20C,B02,188405,Harel; Guershon,18,0,30,12
1683728191449,MATH 20D,A01,188414,Hammock; Frances H,0,1,30,30
1683728191449,MATH 20D,A02,188415,Hammock; Frances H,0,1,30,30
1683728191449,MATH 20D,B01,188447,Hammock; Frances H,0,1,30,30
1683728191449,MATH 20D,B02,188486,Hammock; Frances H,2,0,30,28
1683728192475,MATH 20E,A01,188649,Staff,21,0,30,9
1683728192475,MATH 20E,A02,188650,Staff,20,0,30,10
1683728192475,MATH 20E,A03,188673,Staff,0,0,30,30
1683728193500,MATH 102,A01,188675,Staff,0,40,35,35
1683728194526,MATH 103B,A01,188681,Staff,3,0,35,32
1683728194526,MATH 103B,B01,188692,Staff,5,0,35,30
1683728195555,MATH 109,A01,188695,Salehi Golsefidy; Alireza,24,0,35,11
1683728195555,MATH 109,A02,188696,Salehi Golsefidy; Alireza,24,0,35,11
1683728196581,MATH 120A,A01,188698,Eggers; John Dietrich,7,0,35,28
1683728197604,MATH 142B,A01,188736,Ioana; Adrian,0,0,30,30
1683728197604,MATH 142B,A02,188741,Ioana; Adrian,0,1,30,30
1683728197604,MATH 142B,A03,188743,Ioana; Adrian,0,3,30,30
1683728198629,MATH 168A,A01,188790,Staff,0,11,35,35
1683728199654,MATH 170A,A01,188803,Nie; Jiawang,0,2,35,35
1683728199654,MATH 170A,A02,188811,Nie; Jiawang,0,1,35,35
1683728199654,MATH 170A,A03,188814,Nie; Jiawang,1,0,35,34
1683728199654,MATH 170A,A04,188815,Nie; Jiawang,5,0,35,30
1683728200679,MATH 193B,A01,188817,Staff,0,0,35,35
1683728200679,MATH 193B,A02,188818,Staff,6,0,35,29
1683728201707,MGT 4,A01,202857,Anderson; John Charles,59,0,80,21
1683728202732,MGT 12,A00,202858,Lindenberger; Wade Douglas,40,0,90,50
1683728203757,MGT 18,A00,202859,Staff,73,0,90,17
1683728204783,MGT 18GS,A00,202860,McKay; Michael J,13,0,28,15
1683728205811,MGT 45,A00,202861,Pecore; Joseph P.,8,0,90,82
1683728206837,MGT 100,A00,202863,Yavorsky; Daniel Ryan,27,0,90,63
1683728207868,MGT 103,A00,202864,Ehrich; Kristine R,0,19,90,90
1683728208896,MGT 112,A00,202865,Ehrich; Kristine R,15,0,90,75
1683728209921,MGT 121A,A00,202868,Staff,70,0,90,20
1683728210946,MGT 131B,A00,202869,Anderson; John Charles,58,0,90,32
1683728211971,MGT 136,A00,202871,Lindenberger; Wade Douglas,83,0,90,7
1683728212995,MGT 164,A00,202873,Staff,0,67,90,91
1683728214023,MGT 164GS,A00,202874,McKay; Mary A,13,0,28,15
1683728215048,MGT 180,A00,202875,Staff,0,51,90,91
1683728216078,MMW 11R,A01,205019,Herbst; Matthew,0,0,30,30
1683728216078,MMW 11R,A02,205026,Herbst; Matthew,29,0,30,1
1683728217110,MMW 15,A01,193512,Chang; Edmond Yi-Teh,0,8,28,28
1683728217110,MMW 15,A02,193513,Chang; Edmond Yi-Teh,0,5,28,28
1683728217110,MMW 15,A03,193514,Chang; Edmond Yi-Teh,0,5,28,28
1683728217110,MMW 15,A04,193515,Chang; Edmond Yi-Teh,0,5,28,28
1683728217110,MMW 15,A05,193516,Chang; Edmond Yi-Teh,0,5,28,28
1683728217110,MMW 15,A06,193517,Chang; Edmond Yi-Teh,0,6,28,28
1683728217110,MMW 15,B01,193519,Chang; Edmond Yi-Teh,0,5,28,28
1683728217110,MMW 15,B02,193520,Chang; Edmond Yi-Teh,0,5,28,28
1683728217110,MMW 15,B03,193521,Chang; Edmond Yi-Teh,0,5,28,28
1683728217110,MMW 15,B04,193522,Chang; Edmond Yi-Teh,0,6,28,28
1683728217110,MMW 15,B05,193523,Chang; Edmond Yi-Teh,0,5,28,28
1683728217110,MMW 15,B06,193524,Chang; Edmond Yi-Teh,0,5,28,28
1683728218134,MMW 122,A01,193526,Rahimi; Babak,0,16,28,28
1683728218134,MMW 122,A02,193527,Rahimi; Babak,0,15,28,28
1683728218134,MMW 122,A03,193528,Rahimi; Babak,0,0,0,0
1683728218134,MMW 122,A04,193529,Rahimi; Babak,0,0,0,0
1683728219159,MUS 1A,A01,186663,Staff,0,18,35,35
1683728220186,MUS 4,A01,186715,Staff,0,12,35,35
1683728221211,MUS 5R,A01,186796,Dubnov; Shlomo,0,17,35,35
1683728222240,MUS 6,A01,186798,Staff,0,4,25,25
1683728223264,MUS 7,A01,186830,Staff,11,0,35,24
1683728224294,MUS 8,A01,186930,Staff,0,27,35,35
1683728225318,MUS 15,A01,186932,Staff,0,15,35,35
1683728225318,MUS 15,B01,186934,Staff,0,16,35,35
1683728226344,MUS 80,A00,186935,Staff,0,0,20,20
1683728226344,MUS 80,B00,186936,Staff,24,0,25,1
1683728227368,NANO 11,A00,204702,Lipomi; Darren John,0,0,0,0
1683728228394,NANO 15,A01,204709,Yang; Kesong,0,1,0,0
1683728229424,NANO 114,A00,202069,Jahed Motlagh; Zeinab,2,0,10,8
1683728230450,PHIL 1,A00,186955,Grush; Rick Scott,31,0,40,9
1683728231475,PHIL 10,A01,186973,Grush; Rick Scott,27,0,35,8
1683728231475,PHIL 10,A02,186974,Grush; Rick Scott,33,0,35,2
1683728232500,PHIL 13,A01,186976,Staff,1,0,35,34
1683728232500,PHIL 13,A02,186977,Staff,16,0,35,19
1683728233529,PHIL 14,A01,186979,Staff,30,0,35,5
1683728233529,PHIL 14,A02,186986,Staff,32,0,35,3
1683728234553,PHIL 28,A01,186988,Staff,16,0,30,14
1683728234553,PHIL 28,A02,186989,Staff,0,0,30,30
1683728234553,PHIL 28,A03,186990,Staff,10,0,30,20
1683728234553,PHIL 28,A04,186991,Staff,26,0,30,4
1683728235582,PHIL 120,A00,186997,Staff,23,0,40,17
1683728236607,PHIL 137,A00,187003,Staff,8,0,40,32
1683728237635,PHIL 150,A00,187015,Staff,47,0,70,23
1683728238666,PHIL 167,A00,187021,Lamey; Andy M.,34,0,40,6
1683728239695,PHIL 174,A01,202226,Staff,17,0,20,3
1683728239695,PHIL 174,A02,202235,Staff,20,0,20,0
1683728240722,PHIL 191A,A00,258918,Staff,0,0,1,1
1683728241751,PHYS 1A,A00,187028,Staff,26,0,60,34
1683728242777,PHYS 1AL,001,187036,Staff,3,0,30,27
1683728242777,PHYS 1AL,002,187049,Staff,18,0,30,12
1683728243802,PHYS 1B,A00,187058,Staff,21,0,60,39
1683728244831,PHYS 1BL,001,187064,Staff,0,1,30,30
1683728244831,PHYS 1BL,002,187070,Staff,4,0,30,26
1683728245859,PHYS 1C,A00,187082,Staff,30,0,120,90
1683728246889,PHYS 1CL,001,187088,Staff,0,9,30,30
1683728246889,PHYS 1CL,002,187089,Staff,0,1,30,30
1683728246889,PHYS 1CL,009,262693,Staff,9,0,30,21
1683728247914,PHYS 2B,A01,187097,Staff,55,0,115,60
1683728248940,PHYS 2C,A01,187099,Staff,63,0,115,52
1683728249966,PHYS 2CL,A01,187101,Staff,5,0,28,23
1683728249966,PHYS 2CL,A02,187102,Staff,15,0,28,13
1683728250992,PHYS 2D,A01,187123,Shotwell; Brian,95,0,115,20
1683728252021,PHYS 4B,A01,187133,Grinstein; Benjamin,35,0,50,15
1683728253045,POLI 10,A00,188819,Staff,0,4,50,50
1683728254074,POLI 11,A00,188827,Staff,43,0,50,7
1683728255103,POLI 13R,A00,188828,Staff,0,2,20,20
1683728256129,POLI 27,A01,188830,Elgin; Samuel Zincke,0,2,70,70
1683728257184,POLI 30,A00,188832,Desposato; Scott,30,0,50,20
1683728258269,POLI 102F,A00,188834,Staff,1,0,40,39
1683728259298,POLI 104A,A00,188852,Staff,12,0,30,18
1683728260324,POLI 104I,A00,188853,Staff,0,8,20,20
1683728261355,POLI 110B,A00,188854,Wiens; David,6,0,20,14
1683728262379,POLI 112A,A00,188855,Wiens; David,3,0,30,27
1683728263422,POLI 117R,A00,188856,Forman; Fonna,0,12,20,20
1683728264457,POLI 118,A00,188857,Ingham; Sean,8,0,20,12
1683728265484,POLI 120G,A00,188858,Staff,7,0,30,23
1683728266516,POLI 131CR,A00,188863,Hoston; Germaine,20,0,50,30
1683728267545,POLI 133,A00,188864,Nellis; Gareth Hb,44,0,50,6
1683728268572,POLI 134D,A00,188865,Desposato; Scott,27,0,30,3
1683728269605,POLI 142A,A00,188871,Gartzke; Erik,21,0,50,29
1683728270630,POLI 142K,A00,188874,Staff,38,0,50,12
1683728271658,POLI 143,A00,188940,Gartzke; Erik,15,0,30,15
1683728272681,POLI 153,A00,188943,Staff,1,0,20,19
1683728273710,POLI 160AA,A00,188944,Staff,10,0,40,30
1683728274735,POLI 170A,A00,188945,Staff,10,0,30,20
1683728276786,PSYC 1,A00,188952,Staff,36,0,90,54
1683728277816,PSYC 2,B00,188953,Staff,19,0,35,16
1683728278840,PSYC 6,A00,188970,Staff,47,0,60,13
1683728279868,PSYC 7,A00,188973,Staff,35,0,45,10
1683728280895,PSYC 60,A01,188980,Rickard; Timothy C.,42,0,60,18
1683728281926,PSYC 70,A01,189001,Steiner; Eric Tomas,22,0,45,23
1683728282954,PSYC 100,A00,189005,Lacefield; Katharine I,1,98,120,119
1683728283981,PSYC 102,A00,189008,Staff,6,0,30,24
1683728285006,PSYC 106,B00,189026,Gorman; Michael R.,27,0,60,33
1683728286031,PSYC 114,B01,189033,Winkielman; Piotr,0,31,30,30
1683728287060,PSYC 131,A00,189036,Anagnostaras; Stephan,0,44,60,60
1683728288084,PSYC 136,A00,189041,Lowe; Angela Beth,0,7,25,25
1683728289113,PSYC 137,A00,189057,Winkielman; Piotr,0,36,25,25
1683728290144,PSYC 144,A00,189107,Wixted; John T,0,11,50,50
1683728292226,PSYC 162,A00,189142,Staff,0,9,85,85
1683728293251,PSYC 172,A00,189144,Gorman; Michael R.,0,6,30,30
1683728295306,PSYC 179,A00,189146,Lacefield; Katharine I,0,88,120,120
1683728296354,PSYC 181,A00,189147,Anagnostaras; Stephan,0,45,90,90
1683728297380,PSYC 190R,A00,189148,Barner; David A.,0,23,80,80
1683728298412,PSYC 191,A00,189275,Rickard; Timothy C.,0,11,25,25
1683728299438,PSYC 193,A00,189276,Chapman; Eddie Nathaniel,0,1,0,4
1683728300472,PSYC 193L,A01,189281,Lowe; Angela Beth,8,0,20,12
1683728300472,PSYC 193L,B01,189285,Staff,28,0,35,7
1683728301506,RELI 149,A00,187137,Rahimi; Babak,6,0,40,34
1683728302539,SE 9,A01,187315,Staff,0,2,18,18
1683728303565,SE 101B,A00,187409,Staff,24,0,30,6
1683728304597,SE 110B,A00,187444,Staff,10,0,40,30
1683728305623,SE 130B,A00,187449,Staff,31,0,40,9
1683728306649,SE 150A,A00,187516,Staff,8,0,20,12
1683728307677,SE 154,A00,187528,Staff,29,0,50,21
1683728308706,SIO 3,A01,258171,Staff,35,0,40,5
1683728309734,SIO 10,A00,187144,Cook; Geoffrey W,0,6,75,75
1683728310765,SIO 45,A00,187152,Cook; Geoffrey W,1,7,100,99
1683728311794,SIO 109R,A00,194486,Staff,0,4,20,20
1683728313859,SIO 187,A01,187233,Kacev; David,12,0,40,28
1683728314885,SOCI 1,A01,258656,Thorpe; Charles Robert,28,0,30,2
1683728314885,SOCI 1,A02,258658,Thorpe; Charles Robert,30,0,30,0
1683728314885,SOCI 1,A03,258661,Thorpe; Charles Robert,25,0,25,0
1683728314885,SOCI 1,A04,258666,Thorpe; Charles Robert,22,0,25,3
1683728314885,SOCI 1,A05,258897,Thorpe; Charles Robert,22,0,25,3
1683728314885,SOCI 1,A06,258898,Thorpe; Charles Robert,25,0,25,0
1683728315910,SOCI 30,A01,258903,Pardo Guerra; Juan Pablo,14,0,30,16
1683728316934,SOCI 102,A00,258904,Staff,9,0,25,16
1683728317961,SOCI 106,A00,258905,Staff,19,0,25,6
1683728318991,SOCI 111,A00,258907,Ribas Norris; Janet Vanesa,26,0,30,4
1683728320020,SOCI 121R,A00,258908,Pardo Guerra; Juan Pablo,7,0,30,23
1683728321049,SOCI 126,A01,203330,Staff,14,0,20,6
1683728322078,SOCI 131,A00,258909,Thorpe; Charles Robert,30,0,60,30
1683728323106,SOCI 135,A00,258910,Payne; Christine Anna,0,13,30,30
1683728324135,SOCI 157,A00,258911,Staff,10,0,30,20
1683728325172,SOCI 184,A00,258912,Staff,25,0,30,5
1683728326196,SOCI 188D,A00,258913,Staff,22,0,30,8
1683728327226,SYN 2,001,187529,Staff,9,0,16,7
1683728327226,SYN 2,002,201452,Staff,0,20,16,16
1683728327226,SYN 2,003,201469,Staff,1,0,16,15
1683728328255,SYN 100,A01,187531,Staff,0,9,20,20
1683728328255,SYN 100,B01,201491,Staff,0,10,20,20
1683728329286,TDAC 1,A00,189286,Walsh; Kim C.,3,0,20,17
1683728329286,TDAC 1,B00,189287,Harting; Carla Kelso,10,0,20,10
1683728330315,TDAC 101,A00,189300,Walsh; Kim C.,16,0,20,4
1683728330315,TDAC 101,B00,189301,Harting; Carla Kelso,18,0,20,2
1683728331346,TDAC 102,A00,189304,Basso; Beatrice,14,0,20,6
1683728332468,TDAC 108,A00,189305,Staff,18,0,20,2
1683728333500,TDDE 131,A00,189310,Staff,19,0,20,1
1683728333500,TDDE 131,B00,189314,Staff,19,0,20,1
1683728333500,TDDE 131,C00,189315,Staff,48,0,50,2
1683728333500,TDDE 131,D00,189316,Staff,14,0,15,1
1683728333500,TDDE 131,E00,204841,Staff,20,0,20,0
1683728334530,TDGE 10,A00,189289,Staff,26,0,50,24
1683728334530,TDGE 10,B00,189290,Havis; Allan,0,1,50,50
1683728335557,TDGE 11,A00,189291,Fulton; Julia,0,4,50,50
1683728335557,TDGE 11,B00,189292,Staff,20,0,25,5
1683728335557,TDGE 11,C00,260270,Staff,0,0,0,0
1683728336581,TDGE 25,A00,189294,Staff,1,0,20,19
1683728337613,TDGE 124,A00,189318,Fulton; Julia,0,7,50,50
1683728338640,TDGE 125,A00,189319,Staff,13,0,25,12
1683728338640,TDGE 125,B00,189320,Staff,23,0,25,2
1683728339666,TDGE 127,A00,189322,Havis; Allan,1,0,50,49
1683728340690,TDHT 101,A00,189323,Staff,18,0,25,7
1683728340690,TDHT 101,B00,189324,Staff,25,0,25,0
1683728341717,TDHT 102,A00,189325,Staff,49,0,50,1
1683728342743,TDMV 1,A00,189295,Arcidiacono; Kristin,20,0,30,10
1683728342743,TDMV 1,B00,189296,Caligagan; Maria T.,23,0,30,7
1683728343774,TDMV 2,A00,189297,Sammartano; Tonnie,27,0,30,3
1683728343774,TDMV 2,B00,189299,Arcidiacono; Kristin,23,0,30,7
1683728344802,TDMV 3,A00,204998,Rincon; Alicia,22,0,30,8
1683728345834,TDMV 120,A00,189458,Sammartano; Tonnie,28,0,30,2
1683728346859,TDMV 138,A00,189541,Jun; Grace Shin Hae,20,0,40,20
1683728347886,TDMV 142,A00,189717,Caligagan; Tony,25,0,30,5
1683728347886,TDMV 142,B00,189718,Caligagan; Maria T.,25,0,30,5
1683728348912,TMC 2,A01,187533,Staff,25,0,25,0
1683728348912,TMC 2,A02,187534,Staff,25,0,25,0
1683728349942,USP 1,A01,187536,Kwak; Nancy,0,16,25,25
1683728350975,USP 5,A01,187538,Staff,8,0,25,17
1683728352006,USP 101,A00,199253,Staff,0,4,0,0
1683728353034,USP 124,A00,187562,Boomhower; Matthew Charles,0,0,30,30
1683728354059,USP 138,A00,187582,Staff,19,0,25,6
1683728355100,USP 152,A01,187597,Staff,3,0,25,22
1683728356125,USP 153,A00,187598,Staff,18,0,25,7
1683728357150,USP 168,A00,187607,Kwak; Nancy,2,0,5,3
1683728358190,USP 173,A00,187619,Staff,4,0,25,21
1683728359219,USP 181,A00,187638,Staff,0,4,25,25
1683728360247,VIS 103,A00,187650,Cruz; Edwin Teddy,17,0,75,58
1683728361272,VIS 110D,A00,187669,Staff,13,0,22,9
1683728362353,VIS 127C,A00,187720,Shen; Kuiyi,67,0,146,79
1683728363382,VIS 149,A00,187731,Yoldas; Pinar,0,12,22,22
1683728364406,VIS 151,A01,188091,Staff,22,0,34,12
1683728364406,VIS 151,A02,188092,Staff,11,0,34,23
1683728365434,VIS 160B,A00,188093,Stalbaum; Brett,0,1,10,10
1683728367483,WCWP 10B,A00,201720,Staff,0,0,5,5
1683728367483,WCWP 10B,B00,201722,Staff,0,0,6,6
1683728368507,WCWP 100,A00,201725,Gagnon; Jeffrey C,0,0,2,2
1683728368507,WCWP 100,B00,201727,Staff,0,4,15,15
1683728371647,ANBI 133,A00,258401,Wilder; Linnea Lorene,34,0,40,6
1683728372676,ANBI 140,A00,258395,Hrvoj Mihic; Branka,18,0,25,7
1683728373703,ANSC 120,A00,258402,Bialecki; Jon Anthony,26,0,40,14
1683728374732,ANSC 144,A00,258400,Staff,12,0,40,28
1683728376785,ANSC 166,A00,258396,Parish; Steven Martin,156,0,175,19
1683728377812,ANSC 180,A00,193533,Staff,8,0,20,12
1683728378842,ANSC 188,A00,258397,Jassal; Aftab,34,0,40,6
1683728379866,ANTH 3,A01,258316,Staff,23,0,30,7
1683728380898,ANTH 5,A00,258394,Semendeferi; Ekaterini,16,0,20,4
1683728381925,ANTH 21,A01,258331,Staff,4,0,40,36
1683728382955,ANTH 103,A00,258398,Varma; Saiba,15,0,25,10
1683728383984,AWP 10,001,202034,Staff,0,0,0,0
1683728383984,AWP 10,002,202035,Staff,0,0,0,0
1683728383984,AWP 10,003,202036,Staff,0,0,0,0
1683728383984,AWP 10,004,202037,Staff,0,0,0,0
1683728383984,AWP 10,005,202038,Staff,0,0,0,0
1683728383984,AWP 10,006,202039,Staff,0,0,0,0
1683728383984,AWP 10,007,202040,Staff,0,0,0,0
1683728383984,AWP 10,008,202041,Staff,0,0,0,0
1683728383984,AWP 10,009,202042,Staff,0,0,0,0
1683728383984,AWP 10,010,202043,Staff,0,0,0,0
1683728383984,AWP 10,011,202044,Staff,0,0,0,0
1683728383984,AWP 10,012,202045,Staff,0,0,0,0
1683728383984,AWP 10,013,202046,Staff,0,0,0,0
1683728383984,AWP 10,014,202047,Staff,0,0,0,0
1683728383984,AWP 10,015,202048,Staff,0,0,0,0
1683728383984,AWP 10,016,202049,Staff,0,0,0,0
1683728383984,AWP 10,017,202050,Staff,0,0,0,0
1683728383984,AWP 10,018,202051,Staff,0,0,0,0
1683728383984,AWP 10,019,202052,Staff,0,0,0,0
1683728383984,AWP 10,020,202053,Staff,0,0,0,0
1683728383984,AWP 10,021,202054,Staff,0,0,0,0
1683728383984,AWP 10,022,202055,Staff,0,0,0,0
1683728383984,AWP 10,023,202056,Staff,0,0,0,0
1683728383984,AWP 10,024,202057,Staff,0,0,0,0
1683728383984,AWP 10,025,202058,Staff,0,0,0,0
1683728383984,AWP 10,026,202059,Staff,0,0,0,0
1683728385016,AWP 102,001,202032,Staff,0,0,0,0
1683728385016,AWP 102,002,202033,Staff,0,0,0,0
1683728386042,BENG 100,A01,254234,Taylor Amos; Alyssa C,31,0,40,9
1683728387072,BENG 196,001,270013,Engler; Adam J.,9999,0,9999,0
1683728388099,BICD 100R,A01,202018,Smith; Laurie,0,7,32,32
1683728388099,BICD 100R,A02,202019,Smith; Laurie,0,3,32,32
1683728388099,BICD 100R,A03,202020,Smith; Laurie,0,1,32,32
1683728388099,BICD 100R,A04,202021,Smith; Laurie,6,0,32,26
1683728388099,BICD 100R,A05,202022,Smith; Laurie,10,0,32,22
1683728389135,BICD 136,A01,193242,Gustafson-Brown; Cindy,0,2,32,32
1683728389135,BICD 136,A02,193244,Gustafson-Brown; Cindy,13,0,32,19
1683728390162,BIEB 102,A01,193249,Butler; Shannon Rhey,0,0,32,32
1683728390162,BIEB 102,A02,193251,Butler; Shannon Rhey,0,0,32,32
1683728390162,BIEB 102,A03,193253,Butler; Shannon Rhey,0,0,32,32
1683728390162,BIEB 102,A04,193255,Butler; Shannon Rhey,13,0,32,19
1683728390162,BIEB 102,A05,193265,Butler; Shannon Rhey,25,0,32,7
1683728390162,BIEB 102,A06,193269,Butler; Shannon Rhey,12,0,32,20
1683728392219,BIEB 150,A01,193274,Staff,0,0,32,32
1683728392219,BIEB 150,A02,193285,Staff,24,0,32,8
1683728393254,BIEB 194,A00,193286,Kurle; Carolyn M.,19,0,32,13
1683728394285,BILD 1,A01,192291,Staff,15,0,32,17
1683728394285,BILD 1,A02,192292,Staff,30,0,32,2
1683728394285,BILD 1,B01,192520,Reuther; Keefe,0,1,0,0
1683728394285,BILD 1,B02,192532,Reuther; Keefe,0,1,0,0
1683728395311,BILD 3,A01,192556,Butler; Shannon Rhey,0,0,32,32
1683728395311,BILD 3,A02,192581,Butler; Shannon Rhey,0,1,32,32
1683728395311,BILD 3,A03,192611,Butler; Shannon Rhey,19,0,32,13
1683728395311,BILD 3,A04,192612,Butler; Shannon Rhey,23,0,32,9
1683728395311,BILD 3,A05,192613,Butler; Shannon Rhey,26,0,32,6
1683728395311,BILD 3,A06,192679,Butler; Shannon Rhey,27,0,32,5
1683728395311,BILD 3,A07,192682,Butler; Shannon Rhey,20,0,32,12
1683728396339,BILD 4,A01,192836,Reuther; Keefe,1,0,24,23
1683728396339,BILD 4,A02,193044,Reuther; Keefe,4,0,24,20
1683728397364,BILD 10,A01,193142,Gustafson-Brown; Cindy,29,0,32,3
1683728397364,BILD 10,A02,193149,Gustafson-Brown; Cindy,31,0,32,1
1683728398394,BIMM 100,A01,193301,Staff,0,6,32,32
1683728398394,BIMM 100,A02,193312,Staff,0,7,32,32
1683728398394,BIMM 100,A03,193323,Staff,0,10,32,32
1683728399431,BIMM 101,A01,193329,McDonnell; Lisa Marie,0,3,24,24
1683728399431,BIMM 101,A02,193339,McDonnell; Lisa Marie,0,3,24,24
1683728399431,BIMM 101,B01,193354,McDonnell; Lisa Marie,0,4,24,24
1683728399431,BIMM 101,B02,193357,McDonnell; Lisa Marie,0,3,24,24
1683728400456,BIMM 110,A01,193377,Tat; John,0,11,32,32
1683728400456,BIMM 110,A02,193378,Tat; John,0,11,32,32
1683728401487,BIMM 120,A01,206116,Staff,0,0,32,32
1683728401487,BIMM 120,A02,206117,Staff,7,0,32,25
1683728401487,BIMM 120,A03,206121,Staff,21,0,32,11
1683728402519,BIPN 100,A01,193393,Park; Ji Young,0,15,32,32
1683728402519,BIPN 100,A02,193402,Park; Ji Young,0,14,32,32
1683728402519,BIPN 100,A03,193413,Park; Ji Young,0,14,32,32
1683728402519,BIPN 100,A04,193414,Park; Ji Young,0,13,32,32
1683728403546,BIPN 102,A01,193429,Staff,0,0,32,32
1683728403546,BIPN 102,A02,193438,Staff,18,0,32,14
1683728404576,BIPN 106,A01,193450,Reyes Gonzalez; Catalina,0,2,40,40
1683728405603,BIPN 134,A01,193465,Cooke; James Edward,0,0,32,32
1683728405603,BIPN 134,A02,193474,Cooke; James Edward,25,0,32,7
1683728405603,BIPN 134,A03,193485,Cooke; James Edward,29,0,32,3
1683728405603,BIPN 134,A04,193486,Cooke; James Edward,20,0,32,12
1683728405603,BIPN 134,A05,193491,Cooke; James Edward,31,0,32,1
1683728405603,BIPN 134,A06,193501,Cooke; James Edward,30,0,32,2
1683728405603,BIPN 134,A07,193510,Cooke; James Edward,29,0,32,3
1683728407650,BISP 194,A00,222522,Staff,14,0,32,18
1683728408678,CAT 124,A01,202407,Staff,19,0,25,6
1683728409702,CAT 125,A00,202408,Marchisotto; Jennifer Anne,2,0,20,18
1683728410727,CAT 125R,A00,202409,Smith; Lauryn Alissa,0,11,20,20
1683728410727,CAT 125R,B00,202410,Morales; Celeste Georgianna,0,11,20,20
1683728410727,CAT 125R,C00,202411,Irwin; Matthew Joseph,0,12,20,20
1683728411757,CENG 15,A01,204712,Yang; Kesong,0,1,0,0
1683728412781,CENG 114,A00,202070,Jahed Motlagh; Zeinab,5,0,20,15
1683728413811,CGS 105,A00,185477,Wesling; Megan E.,24,0,40,16
1683728414836,CGS 106,A00,185494,Staff,11,0,22,11
1683728415859,CGS 108,A00,185495,Staff,14,0,20,6
1683728416883,CGS 114,A00,185496,Staff,13,0,18,5
1683728417910,CGS 119,A00,185501,Staff,15,0,20,5
1683728418937,CGS 120,A00,185511,Staff,11,0,20,9
1683728419968,CHEM 4,A01,184675,Bussey; Thomas J,97,0,100,3
1683728420994,CHEM 6A,A01,184677,Staff,32,0,60,28
1683728422020,CHEM 6B,A01,184679,Staff,63,0,100,37
1683728423044,CHEM 6C,A01,184681,Bussey; Thomas J,0,0,50,50
1683728423044,CHEM 6C,A02,184682,Bussey; Thomas J,32,0,50,18
1683728424073,CHEM 40A,A01,184684,Albizati; Kim F.,33,0,100,67
1683728425096,CHEM 40B,A01,184686,Albizati; Kim F.,0,22,100,100
1683728426124,CHEM 41B,A01,184690,Staff,51,0,100,49
1683728427153,COGS 3,A01,184715,Boyle; Mary E. T.,0,27,40,40
1683728428177,COGS 14B,A01,185172,Staff,0,14,38,38
1683728429206,COGS 18,A01,184736,Staff,14,0,80,66
1683728430234,COGS 100,A01,184932,Staff,0,8,73,73
1683728431258,COGS 101A,A01,184935,Staff,0,40,30,30
1683728432286,COGS 101B,A01,184944,Staff,0,2,30,30
1683728433311,COGS 101C,A01,184946,Staff,0,10,30,30
1683728434338,COGS 102A,A01,184951,Johnson; Christine M.,1,0,40,39
1683728435363,COGS 107B,A01,184953,Mooshagian; Eric Frederick,0,52,40,40
1683728436388,COGS 118B,A01,184959,Gupta; Anjum,0,50,40,40
1683728437412,COGS 153,A00,184961,Staff,1,16,30,29
1683728438440,COGS 177,A00,184962,Staff,0,20,30,30
1683728439464,COGS 187A,A01,184969,Boyle; Mary E. T.,0,19,40,40
1683728440495,COMM 10,A01,185174,Staff,0,5,25,25
1683728440495,COMM 10,A02,185189,Staff,0,2,25,25
1683728440495,COMM 10,A03,269821,Staff,0,1,0,0
1683728441522,COMM 100B,A02,185476,Staff,10,0,25,15
1683728441522,COMM 100B,A03,277340,Staff,25,0,25,0
1683728442554,COMM 100C,A01,185314,Staff,2,0,25,23
1683728442554,COMM 100C,A02,185327,Staff,17,0,25,8
1683728443582,COMM 110M,A00,185349,Staff,0,0,40,40
1683728444611,COMM 113T,A00,185352,Staff,25,0,40,15
1683728445637,COMM 114I,A00,185353,Staff,31,0,40,9
1683728446662,COMM 131,A00,185354,Staff,17,0,30,13
1683728447690,CSE 8A,A50,185358,Cao; Yingjun,0,46,10,10
1683728448715,CSE 8B,A01,185362,Staff,0,48,50,50
1683728449739,CSE 11,A01,185416,Cao; Yingjun,0,91,10,10
1683728450765,CSE 20,A01,185445,Briones; Jor-el Thomas Caparas,3,0,25,22
1683728451793,CSE 21,A01,185447,Staff,9,0,50,41
1683728452819,CSE 101,A01,185451,Staff,0,13,50,50
1683728452819,CSE 101,B01,185453,Jones; Miles E,0,15,50,50
1683728454873,CSE 141,A01,185458,Eldon; John,16,0,100,84
1683728455898,CSE 141L,A01,185461,Eldon; John,8,0,100,92
1683728456923,CSE 142,A01,185463,Staff,34,0,60,26
1683728456923,CSE 142,B01,201355,Staff,0,7,60,60
1683728457951,CSE 142L,A01,185470,Staff,34,0,60,26
1683728457951,CSE 142L,B01,201417,Staff,0,6,60,60
1683728458976,CSE 190,A00,201433,Staff,32,0,49,17
1683728460007,DOC 1,A01,259136,Strom; Megan C.,7,0,15,8
1683728460007,DOC 1,A02,259137,Strom; Megan C.,15,0,15,0
1683728460007,DOC 1,A03,259138,Strom; Megan C.,14,0,15,1
1683728460007,DOC 1,A04,259139,Strom; Megan C.,13,0,15,2
1683728461038,DOC 100D,A00,259140,Pass; Natalye Joann,14,0,25,11
1683728462067,DSGN 1,A01,184749,Rill; Bryan,0,26,30,30
1683728463095,DSGN 100,A01,185168,Staff,0,2,25,25
1683728464122,ECE 5,A01,185626,Morris; Karcher William,0,12,0,0
1683728465148,ECE 101,A01,185628,Staff,14,0,70,56
1683728466252,ECE 107,A01,185635,Baghdadchi; Saharnaz,0,0,20,20
1683728466252,ECE 107,A02,185638,Baghdadchi; Saharnaz,1,0,20,19
1683728467277,ECE 148,A01,185647,Silberman; Jack,0,0,16,16
1683728468305,ECON 1,A01,185537,Crane; Meredith Helen,54,0,70,16
1683728469334,ECON 3,A01,185549,Crane; Meredith Helen,30,0,70,40
1683728470363,ECON 4,A01,203354,Anderson; John Charles,0,5,10,10
1683728471391,ECON 100A,A01,185574,Staff,0,5,40,40
1683728472416,ECON 100B,A01,185576,Staff,0,12,50,50
1683728473440,ECON 100C,A01,185589,Newhouse; Herbert S,30,0,70,40
1683728474466,ECON 105,A00,185608,Vespa; Emanuel Ignacio,19,0,35,16
1683728475498,ECON 109,A01,185610,Shishkin; Denis,9,0,35,26
1683728476523,ECON 110A,A01,185612,Staff,8,0,40,32
1683728477548,ECON 120A,A01,185615,Staff,19,0,40,21
1683728478574,ECON 120C,A01,185617,Sun; Yixiao,0,21,70,70
1683728479603,ECON 144,A00,203346,Squires; Dale E,2,0,35,33
1683728480628,ECON 171,A01,203349,Newhouse; Herbert S,0,1,35,35
1683728481654,ECON 173A,A01,185621,Toda; Alexis Akira,21,0,35,14
1683728482681,EDS 25,A01,202413,Staff,0,1,0,0
1683728482681,EDS 25,A02,202414,Staff,0,1,0,0
1683728482681,EDS 25,A03,202415,Staff,0,0,0,0
1683728482681,EDS 25,A04,202416,Staff,0,1,0,0
1683728482681,EDS 25,A05,202439,Staff,0,0,0,0
1683728482681,EDS 25,A06,202440,Staff,0,0,0,0
1683728482681,EDS 25,B01,202631,Staff,0,0,0,0
1683728482681,EDS 25,B02,202632,Staff,0,0,0,0
1683728482681,EDS 25,B03,202639,Staff,0,0,0,0
1683728482681,EDS 25,B04,202640,Staff,0,0,0,0
1683728482681,EDS 25,B05,202643,Staff,0,0,0,0
1683728482681,EDS 25,B06,202644,Staff,0,0,0,0
1683728483705,EDS 38,A01,202659,Black; Alison Michelle,25,0,25,0
1683728484733,EDS 115,A00,202652,Staff,18,0,30,12
1683728485759,EDS 125,A00,202649,Staff,13,0,30,17
1683728486783,EDS 126,A01,203332,Staff,30,0,30,0
1683728487810,EDS 139,A00,202838,Staff,16,0,25,9
1683728488837,EDS 146,A01,202655,Staff,14,0,25,11
1683728489863,ENG 15,A00,185667,Staff,0,1,0,0
1683728489863,ENG 15,B00,185672,Staff,0,0,0,0
1683728489863,ENG 15,C00,185675,Staff,0,0,0,0
1683728489863,ENG 15,D00,185682,Staff,0,0,0,0
1683728489863,ENG 15,E00,185684,Staff,0,0,0,0
1683728490893,ETHN 103,A00,185710,Staff,0,8,35,35
1683728491919,ETHN 103A,A00,199228,Man; Simeon S,0,0,9,9
1683728492945,ETHN 109,A00,185711,Staff,15,0,35,20
1683728493972,ETHN 142,A00,185726,Staff,0,4,30,30
1683728494996,ETHN 163J,A00,199229,Man; Simeon S,5,0,8,3
1683728496022,ETHN 168,A00,185727,Staff,7,0,10,3
1683728497047,ETHN 182,A00,185728,Staff,0,0,35,35
1683728498071,ETHN 183,A00,185737,Staff,10,0,18,8
1683728499097,GLBH 111,A01,209361,Burgos; Jose L.,0,0,0,0
1683728501152,HIEU 104,A00,185792,Staff,14,0,20,6
1683728502180,HIEU 115,A00,185800,Staff,0,0,20,20
1683728503204,HIEU 128,A00,185801,Staff,0,9,20,20
1683728504232,HIEU 147,A00,185802,Staff,15,0,20,5
1683728505259,HIEU 154,A00,185823,Staff,11,0,20,9
1683728506284,HILA 102,A00,185826,Staff,14,0,20,6
1683728507307,HILD 2C,A01,185778,Staff,0,13,20,20
1683728508333,HILD 7B,A01,185780,Kwak; Nancy,0,17,32,32
1683728508333,HILD 7B,A02,185781,Kwak; Nancy,0,18,32,32
1683728509362,HILD 30,A01,185791,Staff,12,0,20,8
1683728510391,HISC 119,A00,185830,Golan; Tal,0,10,20,20
1683728511416,HITO 156GS,A00,185831,Patterson; Patrick H.,0,0,0,23
1683728512441,HIUS 103,A00,185832,Man; Simeon S,0,4,20,20
1683728513466,HIUS 117,A00,185836,Kwak; Nancy,2,0,20,18
1683728514496,HIUS 125,A00,185840,Man; Simeon S,0,2,23,23
1683728515527,HIUS 149,A00,185845,Staff,1,0,20,19
1683728516554,HUM 3,A01,185882,Zavodny; Tatiana Sophia,0,8,50,50
1683728516554,HUM 3,B01,185899,Caldwell; Michael Alan,0,18,50,50
1683728517579,HUM 3GS,A00,185900,Patterson; Patrick H.,0,0,0,23
1683728518607,HUM 4,A01,185938,Zroka; Amy Liane,28,0,50,22
1683728518607,HUM 4,B01,185956,Watkins; Eric,0,6,50,50
1683728518607,HUM 4,B02,202209,Watkins; Eric,0,6,50,50
1683728518607,HUM 4,B03,202210,Watkins; Eric,0,5,50,50
1683728519633,HUM 5,A01,185958,West; Geoffrey Scott,0,0,50,50
1683728519633,HUM 5,A02,202215,West; Geoffrey Scott,0,1,50,50
1683728520660,INTL 190,A00,185959,Gagnon; Jeffrey C,0,0,0,9
1683728520660,INTL 190,B00,185960,Lettieri; Michael Joseph,0,0,0,2
1683728521685,JAPN 180,A00,254509,Staff,4,0,30,26
1683728522710,LATI 10,A01,202853,Kennemore; Amy Michelle,4,0,35,31
1683728522710,LATI 10,A02,202854,Kennemore; Amy Michelle,3,0,35,32
1683728522710,LATI 10,A03,270054,Kennemore; Amy Michelle,30,0,30,0
1683728523739,LATI 180,A00,202855,Kennemore; Amy Michelle,11,0,20,9
1683728524770,LAWS 101,A00,201767,Golan; Tal,0,7,40,40
1683728525798,LIFR 1C,A00,185961,Staff,6,0,20,14
1683728526826,LIFR 1CX,A00,185962,Staff,7,0,20,13
1683728527851,LIFR 1D,A00,185963,Staff,7,0,20,13
1683728528875,LIFR 1DX,A00,185964,Staff,7,0,20,13
1683728529903,LIGN 101,A01,186039,Staff,43,0,50,7
1683728530927,LIGN 165,A00,186040,Staff,14,0,50,36
1683728531950,LTCS 108,A00,186041,Staff,5,0,10,5
1683728532975,LTCS 119,A00,186042,Staff,15,0,20,5
1683728534000,LTCS 130,A00,186043,Wesling; Megan E.,15,0,25,10
1683728536058,LTEA 138,A00,186119,Staff,13,0,40,27
1683728537087,LTEN 124,A00,186148,Staff,5,0,25,20
1683728538113,LTEN 178,A00,186149,Staff,6,0,15,9
1683728539143,LTEN 181,A00,186150,Blanco; John D,34,0,40,6
1683728540170,LTWL 120,A00,186160,Staff,19,0,25,6
1683728541195,LTWL 165,A00,186161,Staff,22,0,25,3
1683728542218,LTWR 100,A00,186162,Staff,0,5,15,15
1683728543243,LTWR 102,A00,186163,Doller; Ben,5,0,15,10
1683728544268,MAE 8,A01,186412,Staff,0,1,0,0
1683728545297,MAE 30B,A00,186445,Bahadori; Mohammad Yousef,81,0,100,19
1683728546323,MAE 40,A00,186592,Bewley; Thomas R,10,0,50,40
1683728547351,MAE 101B,A00,186593,Bahadori; Mohammad Yousef,80,0,100,20
1683728548380,MAE 105,A00,186594,Bandaru; Prabhakar,10,0,50,40
1683728549408,MAE 107,A00,186599,Pham; Hieu Tan,0,8,120,120
1683728550437,MAE 148,A01,186660,Silberman; Jack,3,0,16,13
1683728551464,MATH 10A,A01,188095,Staff,0,6,35,35
1683728552489,MATH 10B,A01,188097,Bowers; Adam R.,0,12,30,30
1683728552489,MATH 10B,A02,188099,Bowers; Adam R.,0,11,30,30
1683728552489,MATH 10B,B01,188104,Bowers; Adam R.,0,10,30,30
1683728552489,MATH 10B,B02,188106,Bowers; Adam R.,0,9,30,30
1683728553525,MATH 10C,A01,188111,Staff,0,20,30,30
1683728553525,MATH 10C,A02,188127,Staff,0,19,30,30
1683728553525,MATH 10C,A03,188131,Staff,0,19,30,30
1683728553525,MATH 10C,B01,188218,Staff,17,0,30,13
1683728553525,MATH 10C,B02,188244,Staff,13,0,30,17
1683728553525,MATH 10C,B03,188277,Staff,14,0,30,16
1683728554550,MATH 18,A01,188344,Bach; Quang Tran,18,0,30,12
1683728554550,MATH 18,A02,188345,Bach; Quang Tran,11,0,30,19
1683728554550,MATH 18,B01,188353,Bach; Quang Tran,11,0,30,19
1683728554550,MATH 18,B02,188354,Bach; Quang Tran,19,0,30,11
1683728555579,MATH 20A,A01,188374,Staff,10,0,35,25
1683728556609,MATH 20B,A01,188382,Ohm; Ko Woon,7,0,30,23
1683728556609,MATH 20B,A02,188383,Ohm; Ko Woon,22,0,30,8
1683728556609,MATH 20B,B01,188385,Ohm; Ko Woon,7,0,30,23
1683728556609,MATH 20B,B02,188392,Ohm; Ko Woon,22,0,30,8
1683728557635,MATH 20C,A01,188394,Harel; Guershon,10,0,30,20
1683728557635,MATH 20C,A02,188395,Harel; Guershon,13,0,30,17
1683728557635,MATH 20C,B01,188404,Harel; Guershon,5,0,30,25
1683728557635,MATH 20C,B02,188405,Harel; Guershon,18,0,30,12
1683728558667,MATH 20D,A01,188414,Hammock; Frances H,0,1,30,30
1683728558667,MATH 20D,A02,188415,Hammock; Frances H,0,1,30,30
1683728558667,MATH 20D,B01,188447,Hammock; Frances H,0,1,30,30
1683728558667,MATH 20D,B02,188486,Hammock; Frances H,2,0,30,28
1683728559697,MATH 20E,A01,188649,Staff,21,0,30,9
1683728559697,MATH 20E,A02,188650,Staff,20,0,30,10
1683728559697,MATH 20E,A03,188673,Staff,0,0,30,30
1683728560722,MATH 102,A01,188675,Staff,0,40,35,35
1683728561747,MATH 103B,A01,188681,Staff,3,0,35,32
1683728561747,MATH 103B,B01,188692,Staff,5,0,35,30
1683728562777,MATH 109,A01,188695,Salehi Golsefidy; Alireza,24,0,35,11
1683728562777,MATH 109,A02,188696,Salehi Golsefidy; Alireza,24,0,35,11
1683728563806,MATH 120A,A01,188698,Eggers; John Dietrich,7,0,35,28
1683728564832,MATH 142B,A01,188736,Ioana; Adrian,0,0,30,30
1683728564832,MATH 142B,A02,188741,Ioana; Adrian,0,1,30,30
1683728564832,MATH 142B,A03,188743,Ioana; Adrian,0,3,30,30
1683728565857,MATH 168A,A01,188790,Staff,0,11,35,35
1683728566888,MATH 170A,A01,188803,Nie; Jiawang,0,2,35,35
1683728566888,MATH 170A,A02,188811,Nie; Jiawang,0,1,35,35
1683728566888,MATH 170A,A03,188814,Nie; Jiawang,1,0,35,34
1683728566888,MATH 170A,A04,188815,Nie; Jiawang,5,0,35,30
1683728567915,MATH 193B,A01,188817,Staff,0,0,35,35
1683728567915,MATH 193B,A02,188818,Staff,6,0,35,29
1683728568942,MGT 4,A01,202857,Anderson; John Charles,59,0,80,21
1683728570025,MGT 12,A00,202858,Lindenberger; Wade Douglas,40,0,90,50
1683728571055,MGT 18,A00,202859,Staff,73,0,90,17
1683728572081,MGT 18GS,A00,202860,McKay; Michael J,13,0,28,15
1683728573106,MGT 45,A00,202861,Pecore; Joseph P.,8,0,90,82
1683728574133,MGT 100,A00,202863,Yavorsky; Daniel Ryan,27,0,90,63
1683728575157,MGT 103,A00,202864,Ehrich; Kristine R,0,19,90,90
1683728576182,MGT 112,A00,202865,Ehrich; Kristine R,15,0,90,75
1683728577210,MGT 121A,A00,202868,Staff,70,0,90,20
1683728578237,MGT 131B,A00,202869,Anderson; John Charles,58,0,90,32
1683728579262,MGT 136,A00,202871,Lindenberger; Wade Douglas,83,0,90,7
1683728580288,MGT 164,A00,202873,Staff,0,67,90,91
1683728581314,MGT 164GS,A00,202874,McKay; Mary A,13,0,28,15
1683728582343,MGT 180,A00,202875,Staff,0,51,90,91
1683728583370,MMW 11R,A01,205019,Herbst; Matthew,0,0,30,30
1683728583370,MMW 11R,A02,205026,Herbst; Matthew,29,0,30,1
1683728584401,MMW 15,A01,193512,Chang; Edmond Yi-Teh,0,8,28,28
1683728584401,MMW 15,A02,193513,Chang; Edmond Yi-Teh,0,5,28,28
1683728584401,MMW 15,A03,193514,Chang; Edmond Yi-Teh,0,5,28,28
1683728584401,MMW 15,A04,193515,Chang; Edmond Yi-Teh,0,5,28,28
1683728584401,MMW 15,A05,193516,Chang; Edmond Yi-Teh,0,5,28,28
1683728584401,MMW 15,A06,193517,Chang; Edmond Yi-Teh,0,6,28,28
1683728584401,MMW 15,B01,193519,Chang; Edmond Yi-Teh,0,5,28,28
1683728584401,MMW 15,B02,193520,Chang; Edmond Yi-Teh,0,5,28,28
1683728584401,MMW 15,B03,193521,Chang; Edmond Yi-Teh,0,5,28,28
1683728584401,MMW 15,B04,193522,Chang; Edmond Yi-Teh,0,6,28,28
1683728584401,MMW 15,B05,193523,Chang; Edmond Yi-Teh,0,5,28,28
1683728584401,MMW 15,B06,193524,Chang; Edmond Yi-Teh,0,5,28,28
1683728585430,MMW 122,A01,193526,Rahimi; Babak,0,16,28,28
1683728585430,MMW 122,A02,193527,Rahimi; Babak,0,15,28,28
1683728585430,MMW 122,A03,193528,Rahimi; Babak,0,0,0,0
1683728585430,MMW 122,A04,193529,Rahimi; Babak,0,0,0,0
1683728586458,MUS 1A,A01,186663,Staff,0,18,35,35
1683728587486,MUS 4,A01,186715,Staff,0,12,35,35
1683728588512,MUS 5R,A01,186796,Dubnov; Shlomo,0,17,35,35
1683728589536,MUS 6,A01,186798,Staff,0,4,25,25
1683728590564,MUS 7,A01,186830,Staff,11,0,35,24
1683728591591,MUS 8,A01,186930,Staff,0,27,35,35
1683728592619,MUS 15,A01,186932,Staff,0,15,35,35
1683728592619,MUS 15,B01,186934,Staff,0,16,35,35
1683728593644,MUS 80,A00,186935,Staff,0,0,20,20
1683728593644,MUS 80,B00,186936,Staff,24,0,25,1
1683728594670,NANO 11,A00,204702,Lipomi; Darren John,0,0,0,0
1683728595697,NANO 15,A01,204709,Yang; Kesong,0,1,0,0
1683728596722,NANO 114,A00,202069,Jahed Motlagh; Zeinab,2,0,10,8
1683728597751,PHIL 1,A00,186955,Grush; Rick Scott,31,0,40,9
1683728598776,PHIL 10,A01,186973,Grush; Rick Scott,27,0,35,8
1683728598776,PHIL 10,A02,186974,Grush; Rick Scott,33,0,35,2
1683728599802,PHIL 13,A01,186976,Staff,1,0,35,34
1683728599802,PHIL 13,A02,186977,Staff,16,0,35,19
1683728600830,PHIL 14,A01,186979,Staff,30,0,35,5
1683728600830,PHIL 14,A02,186986,Staff,32,0,35,3
1683728601857,PHIL 28,A01,186988,Staff,16,0,30,14
1683728601857,PHIL 28,A02,186989,Staff,0,0,30,30
1683728601857,PHIL 28,A03,186990,Staff,10,0,30,20
1683728601857,PHIL 28,A04,186991,Staff,26,0,30,4
1683728602882,PHIL 120,A00,186997,Staff,23,0,40,17
1683728603910,PHIL 137,A00,187003,Staff,8,0,40,32
1683728604934,PHIL 150,A00,187015,Staff,47,0,70,23
1683728605959,PHIL 167,A00,187021,Lamey; Andy M.,34,0,40,6
1683728606988,PHIL 174,A01,202226,Staff,17,0,20,3
1683728606988,PHIL 174,A02,202235,Staff,20,0,20,0
1683728608013,PHIL 191A,A00,258918,Staff,0,0,1,1
1683728609040,PHYS 1A,A00,187028,Staff,26,0,60,34
1683728610068,PHYS 1AL,001,187036,Staff,3,0,30,27
1683728610068,PHYS 1AL,002,187049,Staff,18,0,30,12
1683728611090,PHYS 1B,A00,187058,Staff,21,0,60,39
1683728612115,PHYS 1BL,001,187064,Staff,0,1,30,30
1683728612115,PHYS 1BL,002,187070,Staff,4,0,30,26
1683728613147,PHYS 1C,A00,187082,Staff,30,0,120,90
1683728614171,PHYS 1CL,001,187088,Staff,0,9,30,30
1683728614171,PHYS 1CL,002,187089,Staff,0,1,30,30
1683728614171,PHYS 1CL,009,262693,Staff,9,0,30,21
1683728615197,PHYS 2B,A01,187097,Staff,55,0,115,60
1683728616225,PHYS 2C,A01,187099,Staff,63,0,115,52
1683728617249,PHYS 2CL,A01,187101,Staff,5,0,28,23
1683728617249,PHYS 2CL,A02,187102,Staff,15,0,28,13
1683728618275,PHYS 2D,A01,187123,Shotwell; Brian,95,0,115,20
1683728619300,PHYS 4B,A01,187133,Grinstein; Benjamin,35,0,50,15
1683728620323,POLI 10,A00,188819,Staff,0,4,50,50
1683728621347,POLI 11,A00,188827,Staff,43,0,50,7
1683728622375,POLI 13R,A00,188828,Staff,0,2,20,20
1683728623400,POLI 27,A01,188830,Elgin; Samuel Zincke,0,2,70,70
1683728624431,POLI 30,A00,188832,Desposato; Scott,30,0,50,20
1683728625459,POLI 102F,A00,188834,Staff,1,0,40,39
1683728626484,POLI 104A,A00,188852,Staff,12,0,30,18
1683728627511,POLI 104I,A00,188853,Staff,0,8,20,20
1683728628536,POLI 110B,A00,188854,Wiens; David,6,0,20,14
1683728629566,POLI 112A,A00,188855,Wiens; David,3,0,30,27
1683728630591,POLI 117R,A00,188856,Forman; Fonna,0,12,20,20
1683728631622,POLI 118,A00,188857,Ingham; Sean,8,0,20,12
1683728632647,POLI 120G,A00,188858,Staff,7,0,30,23
1683728633671,POLI 131CR,A00,188863,Hoston; Germaine,20,0,50,30
1683728634696,POLI 133,A00,188864,Nellis; Gareth Hb,44,0,50,6
1683728635727,POLI 134D,A00,188865,Desposato; Scott,27,0,30,3
1683728636757,POLI 142A,A00,188871,Gartzke; Erik,21,0,50,29
1683728637786,POLI 142K,A00,188874,Staff,38,0,50,12
1683728638813,POLI 143,A00,188940,Gartzke; Erik,15,0,30,15
1683728639840,POLI 153,A00,188943,Staff,1,0,20,19
1683728640864,POLI 160AA,A00,188944,Staff,10,0,40,30
1683728641889,POLI 170A,A00,188945,Staff,10,0,30,20
1683728643942,PSYC 1,A00,188952,Staff,36,0,90,54
1683728644970,PSYC 2,B00,188953,Staff,19,0,35,16
1683728645998,PSYC 6,A00,188970,Staff,47,0,60,13
1683728647022,PSYC 7,A00,188973,Staff,35,0,45,10
1683728648049,PSYC 60,A01,188980,Rickard; Timothy C.,42,0,60,18
1683728649075,PSYC 70,A01,189001,Steiner; Eric Tomas,22,0,45,23
1683728650101,PSYC 100,A00,189005,Lacefield; Katharine I,1,98,120,119
1683728651125,PSYC 102,A00,189008,Staff,6,0,30,24
1683728652151,PSYC 106,B00,189026,Gorman; Michael R.,27,0,60,33
1683728653187,PSYC 114,B01,189033,Winkielman; Piotr,0,31,30,30
1683728654212,PSYC 131,A00,189036,Anagnostaras; Stephan,0,44,60,60
1683728655240,PSYC 136,A00,189041,Lowe; Angela Beth,0,7,25,25
1683728656269,PSYC 137,A00,189057,Winkielman; Piotr,0,36,25,25
1683728657295,PSYC 144,A00,189107,Wixted; John T,0,11,50,50
1683728659347,PSYC 162,A00,189142,Staff,0,9,85,85
1683728660372,PSYC 172,A00,189144,Gorman; Michael R.,0,6,30,30
1683728662424,PSYC 179,A00,189146,Lacefield; Katharine I,0,88,120,120
1683728663449,PSYC 181,A00,189147,Anagnostaras; Stephan,0,45,90,90
1683728664478,PSYC 190R,A00,189148,Barner; David A.,0,23,80,80
1683728665504,PSYC 191,A00,189275,Rickard; Timothy C.,0,11,25,25
1683728666528,PSYC 193,A00,189276,Chapman; Eddie Nathaniel,0,1,0,4
1683728667553,PSYC 193L,A01,189281,Lowe; Angela Beth,8,0,20,12
1683728667553,PSYC 193L,B01,189285,Staff,28,0,35,7
1683728668578,RELI 149,A00,187137,Rahimi; Babak,6,0,40,34
1683728669604,SE 9,A01,187315,Staff,0,2,18,18
1683728670631,SE 101B,A00,187409,Staff,24,0,30,6
1683728671655,SE 110B,A00,187444,Staff,10,0,40,30
1683728672683,SE 130B,A00,187449,Staff,31,0,40,9
1683728673763,SE 150A,A00,187516,Staff,8,0,20,12
1683728674789,SE 154,A00,187528,Staff,29,0,50,21
1683728675816,SIO 3,A01,258171,Staff,35,0,40,5
1683728676844,SIO 10,A00,187144,Cook; Geoffrey W,0,6,75,75
1683728677869,SIO 45,A00,187152,Cook; Geoffrey W,1,7,100,99
1683728678898,SIO 109R,A00,194486,Staff,0,4,20,20
1683728680950,SIO 187,A01,187233,Kacev; David,12,0,40,28
1683728681976,SOCI 1,A01,258656,Thorpe; Charles Robert,28,0,30,2
1683728681976,SOCI 1,A02,258658,Thorpe; Charles Robert,30,0,30,0
1683728681976,SOCI 1,A03,258661,Thorpe; Charles Robert,25,0,25,0
1683728681976,SOCI 1,A04,258666,Thorpe; Charles Robert,22,0,25,3
1683728681976,SOCI 1,A05,258897,Thorpe; Charles Robert,22,0,25,3
1683728681976,SOCI 1,A06,258898,Thorpe; Charles Robert,25,0,25,0
1683728683001,SOCI 30,A01,258903,Pardo Guerra; Juan Pablo,14,0,30,16
1683728684025,SOCI 102,A00,258904,Staff,9,0,25,16
1683728685048,SOCI 106,A00,258905,Staff,19,0,25,6
1683728686073,SOCI 111,A00,258907,Ribas Norris; Janet Vanesa,26,0,30,4
1683728687098,SOCI 121R,A00,258908,Pardo Guerra; Juan Pablo,7,0,30,23
1683728688123,SOCI 126,A01,203330,Staff,14,0,20,6
1683728689150,SOCI 131,A00,258909,Thorpe; Charles Robert,30,0,60,30
1683728690177,SOCI 135,A00,258910,Payne; Christine Anna,0,13,30,30
1683728691210,SOCI 157,A00,258911,Staff,10,0,30,20
1683728692235,SOCI 184,A00,258912,Staff,25,0,30,5
1683728693260,SOCI 188D,A00,258913,Staff,22,0,30,8
1683728694285,SYN 2,001,187529,Staff,9,0,16,7
1683728694285,SYN 2,002,201452,Staff,0,20,16,16
1683728694285,SYN 2,003,201469,Staff,1,0,16,15
1683728695312,SYN 100,A01,187531,Staff,0,9,20,20
1683728695312,SYN 100,B01,201491,Staff,0,10,20,20
1683728696338,TDAC 1,A00,189286,Walsh; Kim C.,3,0,20,17
1683728696338,TDAC 1,B00,189287,Harting; Carla Kelso,10,0,20,10
1683728697366,TDAC 101,A00,189300,Walsh; Kim C.,16,0,20,4
1683728697366,TDAC 101,B00,189301,Harting; Carla Kelso,18,0,20,2
1683728698388,TDAC 102,A00,189304,Basso; Beatrice,14,0,20,6
1683728699416,TDAC 108,A00,189305,Staff,18,0,20,2
1683728700448,TDDE 131,A00,189310,Staff,19,0,20,1
1683728700448,TDDE 131,B00,189314,Staff,19,0,20,1
1683728700448,TDDE 131,C00,189315,Staff,48,0,50,2
1683728700448,TDDE 131,D00,189316,Staff,14,0,15,1
1683728700448,TDDE 131,E00,204841,Staff,20,0,20,0
1683728701476,TDGE 10,A00,189289,Staff,26,0,50,24
1683728701476,TDGE 10,B00,189290,Havis; Allan,0,1,50,50
1683728702506,TDGE 11,A00,189291,Fulton; Julia,0,4,50,50
1683728702506,TDGE 11,B00,189292,Staff,20,0,25,5
1683728702506,TDGE 11,C00,260270,Staff,0,0,0,0
1683728703530,TDGE 25,A00,189294,Staff,1,0,20,19
1683728704558,TDGE 124,A00,189318,Fulton; Julia,0,7,50,50
1683728705583,TDGE 125,A00,189319,Staff,13,0,25,12
1683728705583,TDGE 125,B00,189320,Staff,23,0,25,2
1683728706608,TDGE 127,A00,189322,Havis; Allan,1,0,50,49
1683728707631,TDHT 101,A00,189323,Staff,18,0,25,7
1683728707631,TDHT 101,B00,189324,Staff,25,0,25,0
1683728708655,TDHT 102,A00,189325,Staff,49,0,50,1
1683728709680,TDMV 1,A00,189295,Arcidiacono; Kristin,20,0,30,10
1683728709680,TDMV 1,B00,189296,Caligagan; Maria T.,23,0,30,7
1683728710704,TDMV 2,A00,189297,Sammartano; Tonnie,27,0,30,3
1683728710704,TDMV 2,B00,189299,Arcidiacono; Kristin,23,0,30,7
1683728711734,TDMV 3,A00,204998,Rincon; Alicia,22,0,30,8
1683728712761,TDMV 120,A00,189458,Sammartano; Tonnie,28,0,30,2
1683728713786,TDMV 138,A00,189541,Jun; Grace Shin Hae,20,0,40,20
1683728714810,TDMV 142,A00,189717,Caligagan; Tony,25,0,30,5
1683728714810,TDMV 142,B00,189718,Caligagan; Maria T.,25,0,30,5
1683728715835,TMC 2,A01,187533,Staff,25,0,25,0
1683728715835,TMC 2,A02,187534,Staff,25,0,25,0
1683728716860,USP 1,A01,187536,Kwak; Nancy,0,16,25,25
1683728717884,USP 5,A01,187538,Staff,8,0,25,17
1683728718909,USP 101,A00,199253,Staff,0,4,0,0
1683728719934,USP 124,A00,187562,Boomhower; Matthew Charles,0,0,30,30
1683728720963,USP 138,A00,187582,Staff,19,0,25,6
1683728721991,USP 152,A01,187597,Staff,3,0,25,22
1683728723016,USP 153,A00,187598,Staff,18,0,25,7
1683728724044,USP 168,A00,187607,Kwak; Nancy,2,0,5,3
1683728725066,USP 173,A00,187619,Staff,4,0,25,21
1683728726091,USP 181,A00,187638,Staff,0,4,25,25
1683728727115,VIS 103,A00,187650,Cruz; Edwin Teddy,17,0,75,58
1683728728142,VIS 110D,A00,187669,Staff,13,0,22,9
1683728729167,VIS 127C,A00,187720,Shen; Kuiyi,67,0,146,79
1683728730196,VIS 149,A00,187731,Yoldas; Pinar,0,12,22,22
1683728731223,VIS 151,A01,188091,Staff,22,0,34,12
1683728731223,VIS 151,A02,188092,Staff,11,0,34,23
1683728732249,VIS 160B,A00,188093,Stalbaum; Brett,0,1,10,10
1683728734303,WCWP 10B,A00,201720,Staff,0,0,5,5
1683728734303,WCWP 10B,B00,201722,Staff,0,0,6,6
1683728735332,WCWP 100,A00,201725,Gagnon; Jeffrey C,0,0,2,2
1683728735332,WCWP 100,B00,201727,Staff,0,4,15,15
1683728738442,ANBI 133,A00,258401,Wilder; Linnea Lorene,34,0,40,6
1683728739465,ANBI 140,A00,258395,Hrvoj Mihic; Branka,18,0,25,7
1683728740490,ANSC 120,A00,258402,Bialecki; Jon Anthony,26,0,40,14
1683728741518,ANSC 144,A00,258400,Staff,12,0,40,28
1683728743569,ANSC 166,A00,258396,Parish; Steven Martin,156,0,175,19
1683728744594,ANSC 180,A00,193533,Staff,8,0,20,12
1683728745619,ANSC 188,A00,258397,Jassal; Aftab,34,0,40,6
1683728746643,ANTH 3,A01,258316,Staff,23,0,30,7
1683728747671,ANTH 5,A00,258394,Semendeferi; Ekaterini,16,0,20,4
1683728748700,ANTH 21,A01,258331,Staff,4,0,40,36
1683728749726,ANTH 103,A00,258398,Varma; Saiba,15,0,25,10
1683728750755,AWP 10,001,202034,Staff,0,0,0,0
1683728750755,AWP 10,002,202035,Staff,0,0,0,0
1683728750755,AWP 10,003,202036,Staff,0,0,0,0
1683728750755,AWP 10,004,202037,Staff,0,0,0,0
1683728750755,AWP 10,005,202038,Staff,0,0,0,0
1683728750755,AWP 10,006,202039,Staff,0,0,0,0
1683728750755,AWP 10,007,202040,Staff,0,0,0,0
1683728750755,AWP 10,008,202041,Staff,0,0,0,0
1683728750755,AWP 10,009,202042,Staff,0,0,0,0
1683728750755,AWP 10,010,202043,Staff,0,0,0,0
1683728750755,AWP 10,011,202044,Staff,0,0,0,0
1683728750755,AWP 10,012,202045,Staff,0,0,0,0
1683728750755,AWP 10,013,202046,Staff,0,0,0,0
1683728750755,AWP 10,014,202047,Staff,0,0,0,0
1683728750755,AWP 10,015,202048,Staff,0,0,0,0
1683728750755,AWP 10,016,202049,Staff,0,0,0,0
1683728750755,AWP 10,017,202050,Staff,0,0,0,0
1683728750755,AWP 10,018,202051,Staff,0,0,0,0
1683728750755,AWP 10,019,202052,Staff,0,0,0,0
1683728750755,AWP 10,020,202053,Staff,0,0,0,0
1683728750755,AWP 10,021,202054,Staff,0,0,0,0
1683728750755,AWP 10,022,202055,Staff,0,0,0,0
1683728750755,AWP 10,023,202056,Staff,0,0,0,0
1683728750755,AWP 10,024,202057,Staff,0,0,0,0
1683728750755,AWP 10,025,202058,Staff,0,0,0,0
1683728750755,AWP 10,026,202059,Staff,0,0,0,0
1683728751782,AWP 102,001,202032,Staff,0,0,0,0
1683728751782,AWP 102,002,202033,Staff,0,0,0,0
1683728752808,BENG 100,A01,254234,Taylor Amos; Alyssa C,31,0,40,9
1683728753833,BENG 196,001,270013,Engler; Adam J.,9999,0,9999,0
1683728754864,BICD 100R,A01,202018,Smith; Laurie,0,7,32,32
1683728754864,BICD 100R,A02,202019,Smith; Laurie,0,3,32,32
1683728754864,BICD 100R,A03,202020,Smith; Laurie,0,1,32,32
1683728754864,BICD 100R,A04,202021,Smith; Laurie,6,0,32,26
1683728754864,BICD 100R,A05,202022,Smith; Laurie,10,0,32,22
1683728755895,BICD 136,A01,193242,Gustafson-Brown; Cindy,0,2,32,32
1683728755895,BICD 136,A02,193244,Gustafson-Brown; Cindy,13,0,32,19
1683728756929,BIEB 102,A01,193249,Butler; Shannon Rhey,0,0,32,32
1683728756929,BIEB 102,A02,193251,Butler; Shannon Rhey,0,0,32,32
1683728756929,BIEB 102,A03,193253,Butler; Shannon Rhey,0,0,32,32
1683728756929,BIEB 102,A04,193255,Butler; Shannon Rhey,13,0,32,19
1683728756929,BIEB 102,A05,193265,Butler; Shannon Rhey,25,0,32,7
1683728756929,BIEB 102,A06,193269,Butler; Shannon Rhey,12,0,32,20
1683728758979,BIEB 150,A01,193274,Staff,0,0,32,32
1683728758979,BIEB 150,A02,193285,Staff,24,0,32,8
1683728760007,BIEB 194,A00,193286,Kurle; Carolyn M.,19,0,32,13
1683728761034,BILD 1,A01,192291,Staff,15,0,32,17
1683728761034,BILD 1,A02,192292,Staff,30,0,32,2
1683728761034,BILD 1,B01,192520,Reuther; Keefe,0,1,0,0
1683728761034,BILD 1,B02,192532,Reuther; Keefe,0,1,0,0
1683728762065,BILD 3,A01,192556,Butler; Shannon Rhey,0,0,32,32
1683728762065,BILD 3,A02,192581,Butler; Shannon Rhey,0,1,32,32
1683728762065,BILD 3,A03,192611,Butler; Shannon Rhey,19,0,32,13
1683728762065,BILD 3,A04,192612,Butler; Shannon Rhey,23,0,32,9
1683728762065,BILD 3,A05,192613,Butler; Shannon Rhey,26,0,32,6
1683728762065,BILD 3,A06,192679,Butler; Shannon Rhey,27,0,32,5
1683728762065,BILD 3,A07,192682,Butler; Shannon Rhey,20,0,32,12
1683728763092,BILD 4,A01,192836,Reuther; Keefe,1,0,24,23
1683728763092,BILD 4,A02,193044,Reuther; Keefe,4,0,24,20
1683728764117,BILD 10,A01,193142,Gustafson-Brown; Cindy,29,0,32,3
1683728764117,BILD 10,A02,193149,Gustafson-Brown; Cindy,31,0,32,1
1683728765146,BIMM 100,A01,193301,Staff,0,6,32,32
1683728765146,BIMM 100,A02,193312,Staff,0,7,32,32
1683728765146,BIMM 100,A03,193323,Staff,0,10,32,32
1683728766177,BIMM 101,A01,193329,McDonnell; Lisa Marie,0,3,24,24
1683728766177,BIMM 101,A02,193339,McDonnell; Lisa Marie,0,3,24,24
1683728766177,BIMM 101,B01,193354,McDonnell; Lisa Marie,0,4,24,24
1683728766177,BIMM 101,B02,193357,McDonnell; Lisa Marie,0,3,24,24
1683728767206,BIMM 110,A01,193377,Tat; John,0,11,32,32
1683728767206,BIMM 110,A02,193378,Tat; John,0,11,32,32
1683728768232,BIMM 120,A01,206116,Staff,0,0,32,32
1683728768232,BIMM 120,A02,206117,Staff,7,0,32,25
1683728768232,BIMM 120,A03,206121,Staff,21,0,32,11
1683728769259,BIPN 100,A01,193393,Park; Ji Young,0,15,32,32
1683728769259,BIPN 100,A02,193402,Park; Ji Young,0,14,32,32
1683728769259,BIPN 100,A03,193413,Park; Ji Young,0,14,32,32
1683728769259,BIPN 100,A04,193414,Park; Ji Young,0,13,32,32
1683728770287,BIPN 102,A01,193429,Staff,0,0,32,32
1683728770287,BIPN 102,A02,193438,Staff,18,0,32,14
1683728771317,BIPN 106,A01,193450,Reyes Gonzalez; Catalina,0,2,40,40
1683728772348,BIPN 134,A01,193465,Cooke; James Edward,0,0,32,32
1683728772348,BIPN 134,A02,193474,Cooke; James Edward,25,0,32,7
1683728772348,BIPN 134,A03,193485,Cooke; James Edward,29,0,32,3
1683728772348,BIPN 134,A04,193486,Cooke; James Edward,20,0,32,12
1683728772348,BIPN 134,A05,193491,Cooke; James Edward,31,0,32,1
1683728772348,BIPN 134,A06,193501,Cooke; James Edward,30,0,32,2
1683728772348,BIPN 134,A07,193510,Cooke; James Edward,29,0,32,3
1683728774400,BISP 194,A00,222522,Staff,14,0,32,18
1683728775427,CAT 124,A01,202407,Staff,19,0,25,6
1683728776452,CAT 125,A00,202408,Marchisotto; Jennifer Anne,2,0,20,18
1683728777550,CAT 125R,A00,202409,Smith; Lauryn Alissa,0,11,20,20
1683728777550,CAT 125R,B00,202410,Morales; Celeste Georgianna,0,11,20,20
1683728777550,CAT 125R,C00,202411,Irwin; Matthew Joseph,0,12,20,20
1683728778580,CENG 15,A01,204712,Yang; Kesong,0,1,0,0
1683728779606,CENG 114,A00,202070,Jahed Motlagh; Zeinab,5,0,20,15
1683728780637,CGS 105,A00,185477,Wesling; Megan E.,24,0,40,16
1683728781661,CGS 106,A00,185494,Staff,11,0,22,11
1683728782685,CGS 108,A00,185495,Staff,14,0,20,6
1683728783710,CGS 114,A00,185496,Staff,13,0,18,5
1683728784736,CGS 119,A00,185501,Staff,15,0,20,5
1683728785761,CGS 120,A00,185511,Staff,11,0,20,9
1683728786787,CHEM 4,A01,184675,Bussey; Thomas J,97,0,100,3
1683728787816,CHEM 6A,A01,184677,Staff,32,0,60,28
1683728788843,CHEM 6B,A01,184679,Staff,63,0,100,37
1683728789868,CHEM 6C,A01,184681,Bussey; Thomas J,0,0,50,50
1683728789868,CHEM 6C,A02,184682,Bussey; Thomas J,32,0,50,18
1683728790893,CHEM 40A,A01,184684,Albizati; Kim F.,33,0,100,67
1683728791921,CHEM 40B,A01,184686,Albizati; Kim F.,0,22,100,100
1683728792946,CHEM 41B,A01,184690,Staff,51,0,100,49
1683728793973,COGS 3,A01,184715,Boyle; Mary E. T.,0,27,40,40
1683728795002,COGS 14B,A01,185172,Staff,0,14,38,38
1683728796026,COGS 18,A01,184736,Staff,14,0,80,66
1683728797050,COGS 100,A01,184932,Staff,0,8,73,73
1683728798078,COGS 101A,A01,184935,Staff,0,40,30,30
1683728799106,COGS 101B,A01,184944,Staff,0,2,30,30
1683728800130,COGS 101C,A01,184946,Staff,0,10,30,30
1683728801155,COGS 102A,A01,184951,Johnson; Christine M.,1,0,40,39
1683728802184,COGS 107B,A01,184953,Mooshagian; Eric Frederick,0,52,40,40
1683728803218,COGS 118B,A01,184959,Gupta; Anjum,0,50,40,40
1683728804243,COGS 153,A00,184961,Staff,1,16,30,29
1683728805267,COGS 177,A00,184962,Staff,0,20,30,30
1683728806295,COGS 187A,A01,184969,Boyle; Mary E. T.,0,19,40,40
1683728807321,COMM 10,A01,185174,Staff,0,5,25,25
1683728807321,COMM 10,A02,185189,Staff,0,2,25,25
1683728807321,COMM 10,A03,269821,Staff,0,1,0,0
1683728808346,COMM 100B,A02,185476,Staff,10,0,25,15
1683728808346,COMM 100B,A03,277340,Staff,25,0,25,0
1683728809375,COMM 100C,A01,185314,Staff,2,0,25,23
1683728809375,COMM 100C,A02,185327,Staff,17,0,25,8
1683728810402,COMM 110M,A00,185349,Staff,0,0,40,40
1683728811427,COMM 113T,A00,185352,Staff,25,0,40,15
1683728812453,COMM 114I,A00,185353,Staff,31,0,40,9
1683728813480,COMM 131,A00,185354,Staff,17,0,30,13
1683728814514,CSE 8A,A50,185358,Cao; Yingjun,0,46,10,10
1683728815540,CSE 8B,A01,185362,Staff,0,48,50,50
1683728816566,CSE 11,A01,185416,Cao; Yingjun,0,91,10,10
1683728817593,CSE 20,A01,185445,Briones; Jor-el Thomas Caparas,3,0,25,22
1683728818621,CSE 21,A01,185447,Staff,9,0,50,41
1683728819651,CSE 101,A01,185451,Staff,0,13,50,50
1683728819651,CSE 101,B01,185453,Jones; Miles E,0,15,50,50
1683728821704,CSE 141,A01,185458,Eldon; John,16,0,100,84
1683728822737,CSE 141L,A01,185461,Eldon; John,8,0,100,92
1683728823761,CSE 142,A01,185463,Staff,34,0,60,26
1683728823761,CSE 142,B01,201355,Staff,0,7,60,60
1683728824786,CSE 142L,A01,185470,Staff,34,0,60,26
1683728824786,CSE 142L,B01,201417,Staff,0,6,60,60
1683728825812,CSE 190,A00,201433,Staff,32,0,49,17
1683728826842,DOC 1,A01,259136,Strom; Megan C.,7,0,15,8
1683728826842,DOC 1,A02,259137,Strom; Megan C.,15,0,15,0
1683728826842,DOC 1,A03,259138,Strom; Megan C.,14,0,15,1
1683728826842,DOC 1,A04,259139,Strom; Megan C.,13,0,15,2
1683728827867,DOC 100D,A00,259140,Pass; Natalye Joann,14,0,25,11
1683728828891,DSGN 1,A01,184749,Rill; Bryan,0,26,30,30
1683728829918,DSGN 100,A01,185168,Staff,0,2,25,25
1683728830947,ECE 5,A01,185626,Morris; Karcher William,0,12,0,0
1683728831974,ECE 101,A01,185628,Staff,14,0,70,56
1683728833007,ECE 107,A01,185635,Baghdadchi; Saharnaz,0,0,20,20
1683728833007,ECE 107,A02,185638,Baghdadchi; Saharnaz,1,0,20,19
1683728834034,ECE 148,A01,185647,Silberman; Jack,0,0,16,16
1683728835062,ECON 1,A01,185537,Crane; Meredith Helen,54,0,70,16
1683728836088,ECON 3,A01,185549,Crane; Meredith Helen,30,0,70,40
1683728837113,ECON 4,A01,203354,Anderson; John Charles,0,5,10,10
1683728838138,ECON 100A,A01,185574,Staff,0,5,40,40
1683728839163,ECON 100B,A01,185576,Staff,0,12,50,50
1683728840192,ECON 100C,A01,185589,Newhouse; Herbert S,30,0,70,40
1683728841222,ECON 105,A00,185608,Vespa; Emanuel Ignacio,19,0,35,16
1683728842249,ECON 109,A01,185610,Shishkin; Denis,9,0,35,26
1683728843275,ECON 110A,A01,185612,Staff,8,0,40,32
1683728844299,ECON 120A,A01,185615,Staff,19,0,40,21
1683728845325,ECON 120C,A01,185617,Sun; Yixiao,0,21,70,70
1683728846351,ECON 144,A00,203346,Squires; Dale E,2,0,35,33
1683728847376,ECON 171,A01,203349,Newhouse; Herbert S,0,1,35,35
1683728848405,ECON 173A,A01,185621,Toda; Alexis Akira,21,0,35,14
1683728849432,EDS 25,A01,202413,Staff,0,1,0,0
1683728849432,EDS 25,A02,202414,Staff,0,1,0,0
1683728849432,EDS 25,A03,202415,Staff,0,0,0,0
1683728849432,EDS 25,A04,202416,Staff,0,1,0,0
1683728849432,EDS 25,A05,202439,Staff,0,0,0,0
1683728849432,EDS 25,A06,202440,Staff,0,0,0,0
1683728849432,EDS 25,B01,202631,Staff,0,0,0,0
1683728849432,EDS 25,B02,202632,Staff,0,0,0,0
1683728849432,EDS 25,B03,202639,Staff,0,0,0,0
1683728849432,EDS 25,B04,202640,Staff,0,0,0,0
1683728849432,EDS 25,B05,202643,Staff,0,0,0,0
1683728849432,EDS 25,B06,202644,Staff,0,0,0,0
1683728850456,EDS 38,A01,202659,Black; Alison Michelle,25,0,25,0
1683728851481,EDS 115,A00,202652,Staff,18,0,30,12
1683728852505,EDS 125,A00,202649,Staff,13,0,30,17
1683728853529,EDS 126,A01,203332,Staff,30,0,30,0
1683728854555,EDS 139,A00,202838,Staff,16,0,25,9
1683728855582,EDS 146,A01,202655,Staff,14,0,25,11
1683728856609,ENG 15,A00,185667,Staff,0,1,0,0
1683728856609,ENG 15,B00,185672,Staff,0,0,0,0
1683728856609,ENG 15,C00,185675,Staff,0,0,0,0
1683728856609,ENG 15,D00,185682,Staff,0,0,0,0
1683728856609,ENG 15,E00,185684,Staff,0,0,0,0
1683728857645,ETHN 103,A00,185710,Staff,0,8,35,35
1683728858673,ETHN 103A,A00,199228,Man; Simeon S,0,0,9,9
1683728859702,ETHN 109,A00,185711,Staff,15,0,35,20
1683728860727,ETHN 142,A00,185726,Staff,0,4,30,30
1683728861752,ETHN 163J,A00,199229,Man; Simeon S,5,0,8,3
1683728862780,ETHN 168,A00,185727,Staff,7,0,10,3
1683728863808,ETHN 182,A00,185728,Staff,0,0,35,35
1683728864832,ETHN 183,A00,185737,Staff,10,0,18,8
1683728865862,GLBH 111,A01,209361,Burgos; Jose L.,0,0,0,0
1683728867917,HIEU 104,A00,185792,Staff,14,0,20,6
1683728868940,HIEU 115,A00,185800,Staff,0,0,20,20
1683728869963,HIEU 128,A00,185801,Staff,0,9,20,20
1683728870992,HIEU 147,A00,185802,Staff,15,0,20,5
1683728872016,HIEU 154,A00,185823,Staff,11,0,20,9
1683728873041,HILA 102,A00,185826,Staff,14,0,20,6
1683728874078,HILD 2C,A01,185778,Staff,0,13,20,20
1683728875100,HILD 7B,A01,185780,Kwak; Nancy,0,17,32,32
1683728875100,HILD 7B,A02,185781,Kwak; Nancy,0,18,32,32
1683728876125,HILD 30,A01,185791,Staff,12,0,20,8
1683728877173,HISC 119,A00,185830,Golan; Tal,0,10,20,20
1683728878198,HITO 156GS,A00,185831,Patterson; Patrick H.,0,0,0,23
1683728879249,HIUS 103,A00,185832,Man; Simeon S,0,4,20,20
1683728880275,HIUS 117,A00,185836,Kwak; Nancy,2,0,20,18
1683728881363,HIUS 125,A00,185840,Man; Simeon S,0,2,23,23
1683728882386,HIUS 149,A00,185845,Staff,1,0,20,19
1683728883416,HUM 3,A01,185882,Zavodny; Tatiana Sophia,0,8,50,50
1683728883416,HUM 3,B01,185899,Caldwell; Michael Alan,0,18,50,50
1683728884448,HUM 3GS,A00,185900,Patterson; Patrick H.,0,0,0,23
1683728885472,HUM 4,A01,185938,Zroka; Amy Liane,28,0,50,22
1683728885472,HUM 4,B01,185956,Watkins; Eric,0,6,50,50
1683728885472,HUM 4,B02,202209,Watkins; Eric,0,6,50,50
1683728885472,HUM 4,B03,202210,Watkins; Eric,0,5,50,50
1683728886502,HUM 5,A01,185958,West; Geoffrey Scott,0,0,50,50
1683728886502,HUM 5,A02,202215,West; Geoffrey Scott,0,1,50,50
1683728887526,INTL 190,A00,185959,Gagnon; Jeffrey C,0,0,0,9
1683728887526,INTL 190,B00,185960,Lettieri; Michael Joseph,0,0,0,2
1683728888551,JAPN 180,A00,254509,Staff,4,0,30,26
1683728889586,LATI 10,A01,202853,Kennemore; Amy Michelle,4,0,35,31
1683728889586,LATI 10,A02,202854,Kennemore; Amy Michelle,3,0,35,32
1683728889586,LATI 10,A03,270054,Kennemore; Amy Michelle,30,0,30,0
1683728890612,LATI 180,A00,202855,Kennemore; Amy Michelle,11,0,20,9
1683728891642,LAWS 101,A00,201767,Golan; Tal,0,7,40,40
1683728892668,LIFR 1C,A00,185961,Staff,6,0,20,14
1683728893692,LIFR 1CX,A00,185962,Staff,7,0,20,13
1683728894717,LIFR 1D,A00,185963,Staff,7,0,20,13
1683728895742,LIFR 1DX,A00,185964,Staff,7,0,20,13
1683728896767,LIGN 101,A01,186039,Staff,43,0,50,7
1683728897793,LIGN 165,A00,186040,Staff,14,0,50,36
1683728898819,LTCS 108,A00,186041,Staff,5,0,10,5
1683728899846,LTCS 119,A00,186042,Staff,15,0,20,5
1683728900871,LTCS 130,A00,186043,Wesling; Megan E.,15,0,25,10
1683728902920,LTEA 138,A00,186119,Staff,13,0,40,27
1683728903944,LTEN 124,A00,186148,Staff,5,0,25,20
1683728904968,LTEN 178,A00,186149,Staff,6,0,15,9
1683728906009,LTEN 181,A00,186150,Blanco; John D,34,0,40,6
1683728907034,LTWL 120,A00,186160,Staff,19,0,25,6
1683728908059,LTWL 165,A00,186161,Staff,22,0,25,3
1683728909086,LTWR 100,A00,186162,Staff,0,5,15,15
1683728910113,LTWR 102,A00,186163,Doller; Ben,5,0,15,10
1683728911138,MAE 8,A01,186412,Staff,0,1,0,0
1683728912168,MAE 30B,A00,186445,Bahadori; Mohammad Yousef,81,0,100,19
1683728913194,MAE 40,A00,186592,Bewley; Thomas R,10,0,50,40
1683728914247,MAE 101B,A00,186593,Bahadori; Mohammad Yousef,80,0,100,20
1683728915275,MAE 105,A00,186594,Bandaru; Prabhakar,10,0,50,40
1683728916305,MAE 107,A00,186599,Pham; Hieu Tan,0,8,120,120
1683728917330,MAE 148,A01,186660,Silberman; Jack,3,0,16,13
1683728918355,MATH 10A,A01,188095,Staff,0,6,35,35
1683728919381,MATH 10B,A01,188097,Bowers; Adam R.,0,12,30,30
1683728919381,MATH 10B,A02,188099,Bowers; Adam R.,0,11,30,30
1683728919381,MATH 10B,B01,188104,Bowers; Adam R.,0,10,30,30
1683728919381,MATH 10B,B02,188106,Bowers; Adam R.,0,9,30,30
1683728920410,MATH 10C,A01,188111,Staff,0,20,30,30
1683728920410,MATH 10C,A02,188127,Staff,0,19,30,30
1683728920410,MATH 10C,A03,188131,Staff,0,19,30,30
1683728920410,MATH 10C,B01,188218,Staff,17,0,30,13
1683728920410,MATH 10C,B02,188244,Staff,13,0,30,17
1683728920410,MATH 10C,B03,188277,Staff,14,0,30,16
1683728921439,MATH 18,A01,188344,Bach; Quang Tran,18,0,30,12
1683728921439,MATH 18,A02,188345,Bach; Quang Tran,11,0,30,19
1683728921439,MATH 18,B01,188353,Bach; Quang Tran,11,0,30,19
1683728921439,MATH 18,B02,188354,Bach; Quang Tran,19,0,30,11
1683728922464,MATH 20A,A01,188374,Staff,10,0,35,25
1683728923494,MATH 20B,A01,188382,Ohm; Ko Woon,7,0,30,23
1683728923494,MATH 20B,A02,188383,Ohm; Ko Woon,22,0,30,8
1683728923494,MATH 20B,B01,188385,Ohm; Ko Woon,7,0,30,23
1683728923494,MATH 20B,B02,188392,Ohm; Ko Woon,22,0,30,8
1683728924523,MATH 20C,A01,188394,Harel; Guershon,10,0,30,20
1683728924523,MATH 20C,A02,188395,Harel; Guershon,13,0,30,17
1683728924523,MATH 20C,B01,188404,Harel; Guershon,5,0,30,25
1683728924523,MATH 20C,B02,188405,Harel; Guershon,18,0,30,12
1683728925559,MATH 20D,A01,188414,Hammock; Frances H,0,1,30,30
1683728925559,MATH 20D,A02,188415,Hammock; Frances H,0,1,30,30
1683728925559,MATH 20D,B01,188447,Hammock; Frances H,0,1,30,30
1683728925559,MATH 20D,B02,188486,Hammock; Frances H,2,0,30,28
1683728926587,MATH 20E,A01,188649,Staff,21,0,30,9
1683728926587,MATH 20E,A02,188650,Staff,20,0,30,10
1683728926587,MATH 20E,A03,188673,Staff,0,0,30,30
1683728927614,MATH 102,A01,188675,Staff,0,40,35,35
1683728928641,MATH 103B,A01,188681,Staff,3,0,35,32
1683728928641,MATH 103B,B01,188692,Staff,5,0,35,30
1683728929667,MATH 109,A01,188695,Salehi Golsefidy; Alireza,24,0,35,11
1683728929667,MATH 109,A02,188696,Salehi Golsefidy; Alireza,24,0,35,11
1683728930692,MATH 120A,A01,188698,Eggers; John Dietrich,7,0,35,28
1683728931723,MATH 142B,A01,188736,Ioana; Adrian,0,0,30,30
1683728931723,MATH 142B,A02,188741,Ioana; Adrian,0,1,30,30
1683728931723,MATH 142B,A03,188743,Ioana; Adrian,0,3,30,30
1683728932747,MATH 168A,A01,188790,Staff,0,11,35,35
1683728933777,MATH 170A,A01,188803,Nie; Jiawang,0,2,35,35
1683728933777,MATH 170A,A02,188811,Nie; Jiawang,0,1,35,35
1683728933777,MATH 170A,A03,188814,Nie; Jiawang,1,0,35,34
1683728933777,MATH 170A,A04,188815,Nie; Jiawang,5,0,35,30
1683728934800,MATH 193B,A01,188817,Staff,0,0,35,35
1683728934800,MATH 193B,A02,188818,Staff,6,0,35,29
1683728935830,MGT 4,A01,202857,Anderson; John Charles,59,0,80,21
1683728936858,MGT 12,A00,202858,Lindenberger; Wade Douglas,40,0,90,50
1683728937886,MGT 18,A00,202859,Staff,73,0,90,17
1683728938914,MGT 18GS,A00,202860,McKay; Michael J,13,0,28,15
1683728939939,MGT 45,A00,202861,Pecore; Joseph P.,8,0,90,82
1683728940964,MGT 100,A00,202863,Yavorsky; Daniel Ryan,27,0,90,63
1683728941989,MGT 103,A00,202864,Ehrich; Kristine R,0,19,90,90
1683728943024,MGT 112,A00,202865,Ehrich; Kristine R,15,0,90,75
1683728944052,MGT 121A,A00,202868,Staff,70,0,90,20
1683728945076,MGT 131B,A00,202869,Anderson; John Charles,58,0,90,32
1683728946103,MGT 136,A00,202871,Lindenberger; Wade Douglas,83,0,90,7
1683728947128,MGT 164,A00,202873,Staff,0,67,90,91
1683728948156,MGT 164GS,A00,202874,McKay; Mary A,13,0,28,15
1683728949194,MGT 180,A00,202875,Staff,0,51,90,91
1683728950237,MMW 11R,A01,205019,Herbst; Matthew,0,0,30,30
1683728950237,MMW 11R,A02,205026,Herbst; Matthew,29,0,30,1
1683728951283,MMW 15,A01,193512,Chang; Edmond Yi-Teh,0,8,28,28
1683728951283,MMW 15,A02,193513,Chang; Edmond Yi-Teh,0,5,28,28
1683728951283,MMW 15,A03,193514,Chang; Edmond Yi-Teh,0,5,28,28
1683728951283,MMW 15,A04,193515,Chang; Edmond Yi-Teh,0,5,28,28
1683728951283,MMW 15,A05,193516,Chang; Edmond Yi-Teh,0,5,28,28
1683728951283,MMW 15,A06,193517,Chang; Edmond Yi-Teh,0,6,28,28
1683728951283,MMW 15,B01,193519,Chang; Edmond Yi-Teh,0,5,28,28
1683728951283,MMW 15,B02,193520,Chang; Edmond Yi-Teh,0,5,28,28
1683728951283,MMW 15,B03,193521,Chang; Edmond Yi-Teh,0,5,28,28
1683728951283,MMW 15,B04,193522,Chang; Edmond Yi-Teh,0,6,28,28
1683728951283,MMW 15,B05,193523,Chang; Edmond Yi-Teh,0,5,28,28
1683728951283,MMW 15,B06,193524,Chang; Edmond Yi-Teh,0,5,28,28
1683728952307,MMW 122,A01,193526,Rahimi; Babak,0,16,28,28
1683728952307,MMW 122,A02,193527,Rahimi; Babak,0,15,28,28
1683728952307,MMW 122,A03,193528,Rahimi; Babak,0,0,0,0
1683728952307,MMW 122,A04,193529,Rahimi; Babak,0,0,0,0
1683728953330,MUS 1A,A01,186663,Staff,0,18,35,35
1683728954355,MUS 4,A01,186715,Staff,0,12,35,35
1683728955380,MUS 5R,A01,186796,Dubnov; Shlomo,0,17,35,35
1683728956405,MUS 6,A01,186798,Staff,0,4,25,25
1683728957431,MUS 7,A01,186830,Staff,11,0,35,24
1683728958462,MUS 8,A01,186930,Staff,0,27,35,35
1683728959498,MUS 15,A01,186932,Staff,0,15,35,35
1683728959498,MUS 15,B01,186934,Staff,0,16,35,35
1683728960527,MUS 80,A00,186935,Staff,0,0,20,20
1683728960527,MUS 80,B00,186936,Staff,24,0,25,1
1683728961556,NANO 11,A00,204702,Lipomi; Darren John,0,0,0,0
1683728962582,NANO 15,A01,204709,Yang; Kesong,0,1,0,0
1683728963608,NANO 114,A00,202069,Jahed Motlagh; Zeinab,2,0,10,8
1683728964637,PHIL 1,A00,186955,Grush; Rick Scott,31,0,40,9
1683728965661,PHIL 10,A01,186973,Grush; Rick Scott,27,0,35,8
1683728965661,PHIL 10,A02,186974,Grush; Rick Scott,33,0,35,2
1683728966684,PHIL 13,A01,186976,Staff,1,0,35,34
1683728966684,PHIL 13,A02,186977,Staff,16,0,35,19
1683728967708,PHIL 14,A01,186979,Staff,30,0,35,5
1683728967708,PHIL 14,A02,186986,Staff,32,0,35,3
1683728968740,PHIL 28,A01,186988,Staff,16,0,30,14
1683728968740,PHIL 28,A02,186989,Staff,0,0,30,30
1683728968740,PHIL 28,A03,186990,Staff,10,0,30,20
1683728968740,PHIL 28,A04,186991,Staff,26,0,30,4
1683728969764,PHIL 120,A00,186997,Staff,23,0,40,17
1683728970798,PHIL 137,A00,187003,Staff,8,0,40,32
1683728971822,PHIL 150,A00,187015,Staff,47,0,70,23
1683728972852,PHIL 167,A00,187021,Lamey; Andy M.,34,0,40,6
1683728973878,PHIL 174,A01,202226,Staff,17,0,20,3
1683728973878,PHIL 174,A02,202235,Staff,20,0,20,0
1683728974905,PHIL 191A,A00,258918,Staff,0,0,1,1
1683728975933,PHYS 1A,A00,187028,Staff,26,0,60,34
1683728976958,PHYS 1AL,001,187036,Staff,3,0,30,27
1683728976958,PHYS 1AL,002,187049,Staff,18,0,30,12
1683728977984,PHYS 1B,A00,187058,Staff,21,0,60,39
1683728979010,PHYS 1BL,001,187064,Staff,0,1,30,30
1683728979010,PHYS 1BL,002,187070,Staff,4,0,30,26
1683728980035,PHYS 1C,A00,187082,Staff,30,0,120,90
1683728981060,PHYS 1CL,001,187088,Staff,0,9,30,30
1683728981060,PHYS 1CL,002,187089,Staff,0,1,30,30
1683728981060,PHYS 1CL,009,262693,Staff,9,0,30,21
1683728982094,PHYS 2B,A01,187097,Staff,55,0,115,60
1683728983119,PHYS 2C,A01,187099,Staff,63,0,115,52
1683728984148,PHYS 2CL,A01,187101,Staff,5,0,28,23
1683728984148,PHYS 2CL,A02,187102,Staff,15,0,28,13
1683728985247,PHYS 2D,A01,187123,Shotwell; Brian,95,0,115,20
1683728986278,PHYS 4B,A01,187133,Grinstein; Benjamin,35,0,50,15
1683728987303,POLI 10,A00,188819,Staff,0,4,50,50
1683728988328,POLI 11,A00,188827,Staff,43,0,50,7
1683728989355,POLI 13R,A00,188828,Staff,0,2,20,20
1683728990381,POLI 27,A01,188830,Elgin; Samuel Zincke,0,2,70,70
1683728991407,POLI 30,A00,188832,Desposato; Scott,30,0,50,20
1683728992432,POLI 102F,A00,188834,Staff,1,0,40,39
1683728993461,POLI 104A,A00,188852,Staff,12,0,30,18
1683728994486,POLI 104I,A00,188853,Staff,0,8,20,20
1683728995512,POLI 110B,A00,188854,Wiens; David,6,0,20,14
1683728996539,POLI 112A,A00,188855,Wiens; David,3,0,30,27
1683728997567,POLI 117R,A00,188856,Forman; Fonna,0,12,20,20
1683728998593,POLI 118,A00,188857,Ingham; Sean,8,0,20,12
1683728999619,POLI 120G,A00,188858,Staff,7,0,30,23
1683729000647,POLI 131CR,A00,188863,Hoston; Germaine,20,0,50,30
1683729001675,POLI 133,A00,188864,Nellis; Gareth Hb,44,0,50,6
1683729002705,POLI 134D,A00,188865,Desposato; Scott,27,0,30,3
1683729003734,POLI 142A,A00,188871,Gartzke; Erik,21,0,50,29
1683729004760,POLI 142K,A00,188874,Staff,38,0,50,12
1683729005785,POLI 143,A00,188940,Gartzke; Erik,15,0,30,15
1683729006815,POLI 153,A00,188943,Staff,1,0,20,19
1683729007840,POLI 160AA,A00,188944,Staff,10,0,40,30
1683729008865,POLI 170A,A00,188945,Staff,10,0,30,20
1683729010926,PSYC 1,A00,188952,Staff,36,0,90,54
1683729011953,PSYC 2,B00,188953,Staff,19,0,35,16
1683729012981,PSYC 6,A00,188970,Staff,47,0,60,13
1683729014006,PSYC 7,A00,188973,Staff,35,0,45,10
1683729015032,PSYC 60,A01,188980,Rickard; Timothy C.,42,0,60,18
1683729016057,PSYC 70,A01,189001,Steiner; Eric Tomas,22,0,45,23
1683729017085,PSYC 100,A00,189005,Lacefield; Katharine I,1,98,120,119
1683729018114,PSYC 102,A00,189008,Staff,6,0,30,24
1683729019142,PSYC 106,B00,189026,Gorman; Michael R.,27,0,60,33
1683729020167,PSYC 114,B01,189033,Winkielman; Piotr,0,31,30,30
1683729021194,PSYC 131,A00,189036,Anagnostaras; Stephan,0,44,60,60
1683729022221,PSYC 136,A00,189041,Lowe; Angela Beth,0,7,25,25
1683729023252,PSYC 137,A00,189057,Winkielman; Piotr,0,36,25,25
1683729024277,PSYC 144,A00,189107,Wixted; John T,0,11,50,50
1683729026365,PSYC 162,A00,189142,Staff,0,9,85,85
1683729027393,PSYC 172,A00,189144,Gorman; Michael R.,0,6,30,30
1683729029450,PSYC 179,A00,189146,Lacefield; Katharine I,0,88,120,120
1683729030475,PSYC 181,A00,189147,Anagnostaras; Stephan,0,45,90,90
1683729031510,PSYC 190R,A00,189148,Barner; David A.,0,23,80,80
1683729032533,PSYC 191,A00,189275,Rickard; Timothy C.,0,11,25,25
1683729033559,PSYC 193,A00,189276,Chapman; Eddie Nathaniel,0,1,0,4
1683729034586,PSYC 193L,A01,189281,Lowe; Angela Beth,8,0,20,12
1683729034586,PSYC 193L,B01,189285,Staff,28,0,35,7
1683729035611,RELI 149,A00,187137,Rahimi; Babak,6,0,40,34
1683729036640,SE 9,A01,187315,Staff,0,2,18,18
1683729037669,SE 101B,A00,187409,Staff,24,0,30,6
1683729038718,SE 110B,A00,187444,Staff,10,0,40,30
1683729039747,SE 130B,A00,187449,Staff,31,0,40,9
1683729040772,SE 150A,A00,187516,Staff,8,0,20,12
1683729041801,SE 154,A00,187528,Staff,29,0,50,21
1683729042827,SIO 3,A01,258171,Staff,35,0,40,5
1683729043855,SIO 10,A00,187144,Cook; Geoffrey W,0,6,75,75
1683729044880,SIO 45,A00,187152,Cook; Geoffrey W,1,7,100,99
1683729045904,SIO 109R,A00,194486,Staff,0,4,20,20
1683729047957,SIO 187,A01,187233,Kacev; David,12,0,40,28
1683729048989,SOCI 1,A01,258656,Thorpe; Charles Robert,28,0,30,2
1683729048989,SOCI 1,A02,258658,Thorpe; Charles Robert,30,0,30,0
1683729048989,SOCI 1,A03,258661,Thorpe; Charles Robert,25,0,25,0
1683729048989,SOCI 1,A04,258666,Thorpe; Charles Robert,22,0,25,3
1683729048989,SOCI 1,A05,258897,Thorpe; Charles Robert,22,0,25,3
1683729048989,SOCI 1,A06,258898,Thorpe; Charles Robert,25,0,25,0
1683729050019,SOCI 30,A01,258903,Pardo Guerra; Juan Pablo,14,0,30,16
1683729051043,SOCI 102,A00,258904,Staff,9,0,25,16
1683729052070,SOCI 106,A00,258905,Staff,19,0,25,6
1683729053101,SOCI 111,A00,258907,Ribas Norris; Janet Vanesa,26,0,30,4
1683729054129,SOCI 121R,A00,258908,Pardo Guerra; Juan Pablo,7,0,30,23
1683729055158,SOCI 126,A01,203330,Staff,14,0,20,6
1683729056182,SOCI 131,A00,258909,Thorpe; Charles Robert,30,0,60,30
1683729057205,SOCI 135,A00,258910,Payne; Christine Anna,0,13,30,30
1683729058255,SOCI 157,A00,258911,Staff,10,0,30,20
1683729059281,SOCI 184,A00,258912,Staff,25,0,30,5
1683729060307,SOCI 188D,A00,258913,Staff,22,0,30,8
1683729061356,SYN 2,001,187529,Staff,9,0,16,7
1683729061356,SYN 2,002,201452,Staff,0,20,16,16
1683729061356,SYN 2,003,201469,Staff,1,0,16,15
1683729062383,SYN 100,A01,187531,Staff,0,9,20,20
1683729062383,SYN 100,B01,201491,Staff,0,10,20,20
1683729063436,TDAC 1,A00,189286,Walsh; Kim C.,3,0,20,17
1683729063436,TDAC 1,B00,189287,Harting; Carla Kelso,10,0,20,10
1683729064466,TDAC 101,A00,189300,Walsh; Kim C.,16,0,20,4
1683729064466,TDAC 101,B00,189301,Harting; Carla Kelso,18,0,20,2
1683729065502,TDAC 102,A00,189304,Basso; Beatrice,14,0,20,6
1683729066527,TDAC 108,A00,189305,Staff,18,0,20,2
1683729067561,TDDE 131,A00,189310,Staff,19,0,20,1
1683729067561,TDDE 131,B00,189314,Staff,19,0,20,1
1683729067561,TDDE 131,C00,189315,Staff,48,0,50,2
1683729067561,TDDE 131,D00,189316,Staff,14,0,15,1
1683729067561,TDDE 131,E00,204841,Staff,20,0,20,0
1683729068586,TDGE 10,A00,189289,Staff,26,0,50,24
1683729068586,TDGE 10,B00,189290,Havis; Allan,0,1,50,50
1683729069618,TDGE 11,A00,189291,Fulton; Julia,0,4,50,50
1683729069618,TDGE 11,B00,189292,Staff,20,0,25,5
1683729069618,TDGE 11,C00,260270,Staff,0,0,0,0
1683729070642,TDGE 25,A00,189294,Staff,1,0,20,19
1683729071666,TDGE 124,A00,189318,Fulton; Julia,0,7,50,50
1683729072692,TDGE 125,A00,189319,Staff,13,0,25,12
1683729072692,TDGE 125,B00,189320,Staff,23,0,25,2
1683729073720,TDGE 127,A00,189322,Havis; Allan,1,0,50,49
1683729074746,TDHT 101,A00,189323,Staff,18,0,25,7
1683729074746,TDHT 101,B00,189324,Staff,25,0,25,0
1683729075772,TDHT 102,A00,189325,Staff,49,0,50,1
1683729076804,TDMV 1,A00,189295,Arcidiacono; Kristin,20,0,30,10
1683729076804,TDMV 1,B00,189296,Caligagan; Maria T.,23,0,30,7
1683729077832,TDMV 2,A00,189297,Sammartano; Tonnie,27,0,30,3
1683729077832,TDMV 2,B00,189299,Arcidiacono; Kristin,23,0,30,7
1683729078860,TDMV 3,A00,204998,Rincon; Alicia,22,0,30,8
1683729079886,TDMV 120,A00,189458,Sammartano; Tonnie,28,0,30,2
1683729080915,TDMV 138,A00,189541,Jun; Grace Shin Hae,20,0,40,20
1683729081941,TDMV 142,A00,189717,Caligagan; Tony,25,0,30,5
1683729081941,TDMV 142,B00,189718,Caligagan; Maria T.,25,0,30,5
1683729082968,TMC 2,A01,187533,Staff,25,0,25,0
1683729082968,TMC 2,A02,187534,Staff,25,0,25,0
1683729083994,USP 1,A01,187536,Kwak; Nancy,0,16,25,25
1683729085019,USP 5,A01,187538,Staff,8,0,25,17
1683729086042,USP 101,A00,199253,Staff,0,4,0,0
1683729087070,USP 124,A00,187562,Boomhower; Matthew Charles,0,0,30,30
1683729088097,USP 138,A00,187582,Staff,19,0,25,6
1683729089179,USP 152,A01,187597,Staff,3,0,25,22
1683729090208,USP 153,A00,187598,Staff,18,0,25,7
1683729091252,USP 168,A00,187607,Kwak; Nancy,2,0,5,3
1683729092279,USP 173,A00,187619,Staff,4,0,25,21
1683729093307,USP 181,A00,187638,Staff,0,4,25,25
1683729094335,VIS 103,A00,187650,Cruz; Edwin Teddy,17,0,75,58
1683729095362,VIS 110D,A00,187669,Staff,13,0,22,9
1683729096391,VIS 127C,A00,187720,Shen; Kuiyi,67,0,146,79
1683729097417,VIS 149,A00,187731,Yoldas; Pinar,0,12,22,22
1683729098442,VIS 151,A01,188091,Staff,22,0,34,12
1683729098442,VIS 151,A02,188092,Staff,11,0,34,23
1683729099467,VIS 160B,A00,188093,Stalbaum; Brett,0,1,10,10
1683729101522,WCWP 10B,A00,201720,Staff,0,0,5,5
1683729101522,WCWP 10B,B00,201722,Staff,0,0,6,6
1683729102551,WCWP 100,A00,201725,Gagnon; Jeffrey C,0,0,2,2
1683729102551,WCWP 100,B00,201727,Staff,0,4,15,15
1683729105696,ANBI 133,A00,258401,Wilder; Linnea Lorene,34,0,40,6
1683729106737,ANBI 140,A00,258395,Hrvoj Mihic; Branka,18,0,25,7
1683729107760,ANSC 120,A00,258402,Bialecki; Jon Anthony,26,0,40,14
1683729108784,ANSC 144,A00,258400,Staff,12,0,40,28
1683729110837,ANSC 166,A00,258396,Parish; Steven Martin,156,0,175,19
1683729111866,ANSC 180,A00,193533,Staff,8,0,20,12
1683729112889,ANSC 188,A00,258397,Jassal; Aftab,34,0,40,6
1683729113916,ANTH 3,A01,258316,Staff,23,0,30,7
1683729114946,ANTH 5,A00,258394,Semendeferi; Ekaterini,16,0,20,4
1683729115974,ANTH 21,A01,258331,Staff,4,0,40,36
1683729117004,ANTH 103,A00,258398,Varma; Saiba,15,0,25,10
1683729118030,AWP 10,001,202034,Staff,0,0,0,0
1683729118030,AWP 10,002,202035,Staff,0,0,0,0
1683729118030,AWP 10,003,202036,Staff,0,0,0,0
1683729118030,AWP 10,004,202037,Staff,0,0,0,0
1683729118030,AWP 10,005,202038,Staff,0,0,0,0
1683729118030,AWP 10,006,202039,Staff,0,0,0,0
1683729118030,AWP 10,007,202040,Staff,0,0,0,0
1683729118030,AWP 10,008,202041,Staff,0,0,0,0
1683729118030,AWP 10,009,202042,Staff,0,0,0,0
1683729118030,AWP 10,010,202043,Staff,0,0,0,0
1683729118030,AWP 10,011,202044,Staff,0,0,0,0
1683729118030,AWP 10,012,202045,Staff,0,0,0,0
1683729118030,AWP 10,013,202046,Staff,0,0,0,0
1683729118030,AWP 10,014,202047,Staff,0,0,0,0
1683729118030,AWP 10,015,202048,Staff,0,0,0,0
1683729118030,AWP 10,016,202049,Staff,0,0,0,0
1683729118030,AWP 10,017,202050,Staff,0,0,0,0
1683729118030,AWP 10,018,202051,Staff,0,0,0,0
1683729118030,AWP 10,019,202052,Staff,0,0,0,0
1683729118030,AWP 10,020,202053,Staff,0,0,0,0
1683729118030,AWP 10,021,202054,Staff,0,0,0,0
1683729118030,AWP 10,022,202055,Staff,0,0,0,0
1683729118030,AWP 10,023,202056,Staff,0,0,0,0
1683729118030,AWP 10,024,202057,Staff,0,0,0,0
1683729118030,AWP 10,025,202058,Staff,0,0,0,0
1683729118030,AWP 10,026,202059,Staff,0,0,0,0
1683729119058,AWP 102,001,202032,Staff,0,0,0,0
1683729119058,AWP 102,002,202033,Staff,0,0,0,0
1683729120083,BENG 100,A01,254234,Taylor Amos; Alyssa C,31,0,40,9
1683729121118,BENG 196,001,270013,Engler; Adam J.,9999,0,9999,0
1683729122144,BICD 100R,A01,202018,Smith; Laurie,0,7,32,32
1683729122144,BICD 100R,A02,202019,Smith; Laurie,0,3,32,32
1683729122144,BICD 100R,A03,202020,Smith; Laurie,0,1,32,32
1683729122144,BICD 100R,A04,202021,Smith; Laurie,6,0,32,26
1683729122144,BICD 100R,A05,202022,Smith; Laurie,10,0,32,22
1683729123169,BICD 136,A01,193242,Gustafson-Brown; Cindy,0,2,32,32
1683729123169,BICD 136,A02,193244,Gustafson-Brown; Cindy,13,0,32,19
1683729124202,BIEB 102,A01,193249,Butler; Shannon Rhey,0,0,32,32
1683729124202,BIEB 102,A02,193251,Butler; Shannon Rhey,0,0,32,32
1683729124202,BIEB 102,A03,193253,Butler; Shannon Rhey,0,0,32,32
1683729124202,BIEB 102,A04,193255,Butler; Shannon Rhey,13,0,32,19
1683729124202,BIEB 102,A05,193265,Butler; Shannon Rhey,25,0,32,7
1683729124202,BIEB 102,A06,193269,Butler; Shannon Rhey,12,0,32,20
1683729126280,BIEB 150,A01,193274,Staff,0,0,32,32
1683729126280,BIEB 150,A02,193285,Staff,24,0,32,8
1683729127304,BIEB 194,A00,193286,Kurle; Carolyn M.,19,0,32,13
1683729128331,BILD 1,A01,192291,Staff,15,0,32,17
1683729128331,BILD 1,A02,192292,Staff,30,0,32,2
1683729128331,BILD 1,B01,192520,Reuther; Keefe,0,1,0,0
1683729128331,BILD 1,B02,192532,Reuther; Keefe,0,1,0,0
1683729129357,BILD 3,A01,192556,Butler; Shannon Rhey,0,0,32,32
1683729129357,BILD 3,A02,192581,Butler; Shannon Rhey,0,1,32,32
1683729129357,BILD 3,A03,192611,Butler; Shannon Rhey,19,0,32,13
1683729129357,BILD 3,A04,192612,Butler; Shannon Rhey,23,0,32,9
1683729129357,BILD 3,A05,192613,Butler; Shannon Rhey,26,0,32,6
1683729129357,BILD 3,A06,192679,Butler; Shannon Rhey,27,0,32,5
1683729129357,BILD 3,A07,192682,Butler; Shannon Rhey,20,0,32,12
1683729130387,BILD 4,A01,192836,Reuther; Keefe,1,0,24,23
1683729130387,BILD 4,A02,193044,Reuther; Keefe,4,0,24,20
1683729131412,BILD 10,A01,193142,Gustafson-Brown; Cindy,29,0,32,3
1683729131412,BILD 10,A02,193149,Gustafson-Brown; Cindy,31,0,32,1
1683729132441,BIMM 100,A01,193301,Staff,0,6,32,32
1683729132441,BIMM 100,A02,193312,Staff,0,7,32,32
1683729132441,BIMM 100,A03,193323,Staff,0,10,32,32
1683729133478,BIMM 101,A01,193329,McDonnell; Lisa Marie,0,3,24,24
1683729133478,BIMM 101,A02,193339,McDonnell; Lisa Marie,0,3,24,24
1683729133478,BIMM 101,B01,193354,McDonnell; Lisa Marie,0,4,24,24
1683729133478,BIMM 101,B02,193357,McDonnell; Lisa Marie,0,3,24,24
1683729134504,BIMM 110,A01,193377,Tat; John,0,11,32,32
1683729134504,BIMM 110,A02,193378,Tat; John,0,11,32,32
1683729135534,BIMM 120,A01,206116,Staff,0,0,32,32
1683729135534,BIMM 120,A02,206117,Staff,7,0,32,25
1683729135534,BIMM 120,A03,206121,Staff,21,0,32,11
1683729136566,BIPN 100,A01,193393,Park; Ji Young,0,15,32,32
1683729136566,BIPN 100,A02,193402,Park; Ji Young,0,14,32,32
1683729136566,BIPN 100,A03,193413,Park; Ji Young,0,14,32,32
1683729136566,BIPN 100,A04,193414,Park; Ji Young,0,13,32,32
1683729137594,BIPN 102,A01,193429,Staff,0,0,32,32
1683729137594,BIPN 102,A02,193438,Staff,18,0,32,14
1683729138622,BIPN 106,A01,193450,Reyes Gonzalez; Catalina,0,2,40,40
1683729139651,BIPN 134,A01,193465,Cooke; James Edward,0,0,32,32
1683729139651,BIPN 134,A02,193474,Cooke; James Edward,25,0,32,7
1683729139651,BIPN 134,A03,193485,Cooke; James Edward,29,0,32,3
1683729139651,BIPN 134,A04,193486,Cooke; James Edward,20,0,32,12
1683729139651,BIPN 134,A05,193491,Cooke; James Edward,31,0,32,1
1683729139651,BIPN 134,A06,193501,Cooke; James Edward,30,0,32,2
1683729139651,BIPN 134,A07,193510,Cooke; James Edward,29,0,32,3
1683729141703,BISP 194,A00,222522,Staff,14,0,32,18
1683729142727,CAT 124,A01,202407,Staff,19,0,25,6
1683729143772,CAT 125,A00,202408,Marchisotto; Jennifer Anne,2,0,20,18
1683729144799,CAT 125R,A00,202409,Smith; Lauryn Alissa,0,11,20,20
1683729144799,CAT 125R,B00,202410,Morales; Celeste Georgianna,0,11,20,20
1683729144799,CAT 125R,C00,202411,Irwin; Matthew Joseph,0,12,20,20
1683729145834,CENG 15,A01,204712,Yang; Kesong,0,1,0,0
1683729146859,CENG 114,A00,202070,Jahed Motlagh; Zeinab,5,0,20,15
1683729147887,CGS 105,A00,185477,Wesling; Megan E.,24,0,40,16
1683729148917,CGS 106,A00,185494,Staff,11,0,22,11
1683729149950,CGS 108,A00,185495,Staff,14,0,20,6
1683729150976,CGS 114,A00,185496,Staff,13,0,18,5
1683729151999,CGS 119,A00,185501,Staff,15,0,20,5
1683729153029,CGS 120,A00,185511,Staff,11,0,20,9
1683729154055,CHEM 4,A01,184675,Bussey; Thomas J,97,0,100,3
1683729155084,CHEM 6A,A01,184677,Staff,32,0,60,28
1683729156111,CHEM 6B,A01,184679,Staff,63,0,100,37
1683729157139,CHEM 6C,A01,184681,Bussey; Thomas J,0,0,50,50
1683729157139,CHEM 6C,A02,184682,Bussey; Thomas J,32,0,50,18
1683729158163,CHEM 40A,A01,184684,Albizati; Kim F.,33,0,100,67
1683729159188,CHEM 40B,A01,184686,Albizati; Kim F.,0,22,100,100
1683729160216,CHEM 41B,A01,184690,Staff,51,0,100,49
1683729161256,COGS 3,A01,184715,Boyle; Mary E. T.,0,27,40,40
1683729162279,COGS 14B,A01,185172,Staff,0,14,38,38
1683729163303,COGS 18,A01,184736,Staff,14,0,80,66
1683729164327,COGS 100,A01,184932,Staff,0,8,73,73
1683729165352,COGS 101A,A01,184935,Staff,0,40,30,30
1683729166376,COGS 101B,A01,184944,Staff,0,2,30,30
1683729167403,COGS 101C,A01,184946,Staff,0,10,30,30
1683729168428,COGS 102A,A01,184951,Johnson; Christine M.,1,0,40,39
1683729169460,COGS 107B,A01,184953,Mooshagian; Eric Frederick,0,52,40,40
1683729170489,COGS 118B,A01,184959,Gupta; Anjum,0,50,40,40
1683729171513,COGS 153,A00,184961,Staff,1,16,30,29
1683729172537,COGS 177,A00,184962,Staff,0,20,30,30
1683729173561,COGS 187A,A01,184969,Boyle; Mary E. T.,0,19,40,40
1683729174587,COMM 10,A01,185174,Staff,0,5,25,25
1683729174587,COMM 10,A02,185189,Staff,0,2,25,25
1683729174587,COMM 10,A03,269821,Staff,0,1,0,0
1683729175616,COMM 100B,A02,185476,Staff,10,0,25,15
1683729175616,COMM 100B,A03,277340,Staff,25,0,25,0
1683729176641,COMM 100C,A01,185314,Staff,2,0,25,23
1683729176641,COMM 100C,A02,185327,Staff,17,0,25,8
1683729177667,COMM 110M,A00,185349,Staff,0,0,40,40
1683729178691,COMM 113T,A00,185352,Staff,25,0,40,15
1683729179717,COMM 114I,A00,185353,Staff,31,0,40,9
1683729180740,COMM 131,A00,185354,Staff,17,0,30,13
1683729181768,CSE 8A,A50,185358,Cao; Yingjun,0,46,10,10
1683729182797,CSE 8B,A01,185362,Staff,0,48,50,50
1683729183825,CSE 11,A01,185416,Cao; Yingjun,0,91,10,10
1683729184849,CSE 20,A01,185445,Briones; Jor-el Thomas Caparas,3,0,25,22
1683729185874,CSE 21,A01,185447,Staff,9,0,50,41
1683729186907,CSE 101,A01,185451,Staff,0,13,50,50
1683729186907,CSE 101,B01,185453,Jones; Miles E,0,15,50,50
1683729188960,CSE 141,A01,185458,Eldon; John,16,0,100,84
1683729189998,CSE 141L,A01,185461,Eldon; John,8,0,100,92
1683729191028,CSE 142,A01,185463,Staff,34,0,60,26
1683729191028,CSE 142,B01,201355,Staff,0,7,60,60
1683729192059,CSE 142L,A01,185470,Staff,34,0,60,26
1683729192059,CSE 142L,B01,201417,Staff,0,6,60,60
1683729193142,CSE 190,A00,201433,Staff,32,0,49,17
1683729194171,DOC 1,A01,259136,Strom; Megan C.,7,0,15,8
1683729194171,DOC 1,A02,259137,Strom; Megan C.,15,0,15,0
1683729194171,DOC 1,A03,259138,Strom; Megan C.,14,0,15,1
1683729194171,DOC 1,A04,259139,Strom; Megan C.,13,0,15,2
1683729195197,DOC 100D,A00,259140,Pass; Natalye Joann,14,0,25,11
1683729196224,DSGN 1,A01,184749,Rill; Bryan,0,26,30,30
1683729197260,DSGN 100,A01,185168,Staff,0,2,25,25
1683729198285,ECE 5,A01,185626,Morris; Karcher William,0,12,0,0
1683729199309,ECE 101,A01,185628,Staff,14,0,70,56
1683729200337,ECE 107,A01,185635,Baghdadchi; Saharnaz,0,0,20,20
1683729200337,ECE 107,A02,185638,Baghdadchi; Saharnaz,1,0,20,19
1683729201362,ECE 148,A01,185647,Silberman; Jack,0,0,16,16
1683729202390,ECON 1,A01,185537,Crane; Meredith Helen,54,0,70,16
1683729203416,ECON 3,A01,185549,Crane; Meredith Helen,30,0,70,40
1683729204440,ECON 4,A01,203354,Anderson; John Charles,0,5,10,10
1683729205466,ECON 100A,A01,185574,Staff,0,5,40,40
1683729206493,ECON 100B,A01,185576,Staff,0,12,50,50
1683729207521,ECON 100C,A01,185589,Newhouse; Herbert S,30,0,70,40
1683729208550,ECON 105,A00,185608,Vespa; Emanuel Ignacio,19,0,35,16
1683729209583,ECON 109,A01,185610,Shishkin; Denis,9,0,35,26
1683729210615,ECON 110A,A01,185612,Staff,8,0,40,32
1683729211643,ECON 120A,A01,185615,Staff,19,0,40,21
1683729212670,ECON 120C,A01,185617,Sun; Yixiao,0,21,70,70
1683729213696,ECON 144,A00,203346,Squires; Dale E,2,0,35,33
1683729214731,ECON 171,A01,203349,Newhouse; Herbert S,0,1,35,35
1683729215759,ECON 173A,A01,185621,Toda; Alexis Akira,21,0,35,14
1683729216788,EDS 25,A01,202413,Staff,0,1,0,0
1683729216788,EDS 25,A02,202414,Staff,0,1,0,0
1683729216788,EDS 25,A03,202415,Staff,0,0,0,0
1683729216788,EDS 25,A04,202416,Staff,0,1,0,0
1683729216788,EDS 25,A05,202439,Staff,0,0,0,0
1683729216788,EDS 25,A06,202440,Staff,0,0,0,0
1683729216788,EDS 25,B01,202631,Staff,0,0,0,0
1683729216788,EDS 25,B02,202632,Staff,0,0,0,0
1683729216788,EDS 25,B03,202639,Staff,0,0,0,0
1683729216788,EDS 25,B04,202640,Staff,0,0,0,0
1683729216788,EDS 25,B05,202643,Staff,0,0,0,0
1683729216788,EDS 25,B06,202644,Staff,0,0,0,0
1683729217814,EDS 38,A01,202659,Black; Alison Michelle,25,0,25,0
1683729218841,EDS 115,A00,202652,Staff,18,0,30,12
1683729219866,EDS 125,A00,202649,Staff,13,0,30,17
1683729220892,EDS 126,A01,203332,Staff,30,0,30,0
1683729221916,EDS 139,A00,202838,Staff,16,0,25,9
1683729222941,EDS 146,A01,202655,Staff,14,0,25,11
1683729223971,ENG 15,A00,185667,Staff,0,1,0,0
1683729223971,ENG 15,B00,185672,Staff,0,0,0,0
1683729223971,ENG 15,C00,185675,Staff,0,0,0,0
1683729223971,ENG 15,D00,185682,Staff,0,0,0,0
1683729223971,ENG 15,E00,185684,Staff,0,0,0,0
1683729224999,ETHN 103,A00,185710,Staff,0,8,35,35
1683729226024,ETHN 103A,A00,199228,Man; Simeon S,0,0,9,9
1683729227049,ETHN 109,A00,185711,Staff,15,0,35,20
1683729228079,ETHN 142,A00,185726,Staff,0,4,30,30
1683729229102,ETHN 163J,A00,199229,Man; Simeon S,5,0,8,3
1683729230130,ETHN 168,A00,185727,Staff,7,0,10,3
1683729231156,ETHN 182,A00,185728,Staff,0,0,35,35
1683729232180,ETHN 183,A00,185737,Staff,10,0,18,8
1683729233207,GLBH 111,A01,209361,Burgos; Jose L.,0,0,0,0
1683729235260,HIEU 104,A00,185792,Staff,14,0,20,6
1683729236284,HIEU 115,A00,185800,Staff,0,0,20,20
1683729237312,HIEU 128,A00,185801,Staff,0,9,20,20
1683729238335,HIEU 147,A00,185802,Staff,15,0,20,5
1683729239360,HIEU 154,A00,185823,Staff,11,0,20,9
1683729240388,HILA 102,A00,185826,Staff,14,0,20,6
1683729241414,HILD 2C,A01,185778,Staff,0,13,20,20
1683729242440,HILD 7B,A01,185780,Kwak; Nancy,0,17,32,32
1683729242440,HILD 7B,A02,185781,Kwak; Nancy,0,18,32,32
1683729243465,HILD 30,A01,185791,Staff,12,0,20,8
1683729244490,HISC 119,A00,185830,Golan; Tal,0,10,20,20
1683729245518,HITO 156GS,A00,185831,Patterson; Patrick H.,0,0,0,23
1683729246542,HIUS 103,A00,185832,Man; Simeon S,0,4,20,20
1683729247568,HIUS 117,A00,185836,Kwak; Nancy,2,0,20,18
1683729248592,HIUS 125,A00,185840,Man; Simeon S,0,2,23,23
1683729249618,HIUS 149,A00,185845,Staff,1,0,20,19
1683729250646,HUM 3,A01,185882,Zavodny; Tatiana Sophia,0,8,50,50
1683729250646,HUM 3,B01,185899,Caldwell; Michael Alan,0,18,50,50
1683729251669,HUM 3GS,A00,185900,Patterson; Patrick H.,0,0,0,23
1683729252694,HUM 4,A01,185938,Zroka; Amy Liane,28,0,50,22
1683729252694,HUM 4,B01,185956,Watkins; Eric,0,6,50,50
1683729252694,HUM 4,B02,202209,Watkins; Eric,0,6,50,50
1683729252694,HUM 4,B03,202210,Watkins; Eric,0,5,50,50
1683729253720,HUM 5,A01,185958,West; Geoffrey Scott,0,0,50,50
1683729253720,HUM 5,A02,202215,West; Geoffrey Scott,0,1,50,50
1683729254752,INTL 190,A00,185959,Gagnon; Jeffrey C,0,0,0,9
1683729254752,INTL 190,B00,185960,Lettieri; Michael Joseph,0,0,0,2
1683729255780,JAPN 180,A00,254509,Staff,4,0,30,26
1683729256810,LATI 10,A01,202853,Kennemore; Amy Michelle,4,0,35,31
1683729256810,LATI 10,A02,202854,Kennemore; Amy Michelle,3,0,35,32
1683729256810,LATI 10,A03,270054,Kennemore; Amy Michelle,30,0,30,0
1683729257840,LATI 180,A00,202855,Kennemore; Amy Michelle,11,0,20,9
1683729258869,LAWS 101,A00,201767,Golan; Tal,0,7,40,40
1683729259897,LIFR 1C,A00,185961,Staff,6,0,20,14
1683729260920,LIFR 1CX,A00,185962,Staff,7,0,20,13
1683729261947,LIFR 1D,A00,185963,Staff,7,0,20,13
1683729262972,LIFR 1DX,A00,185964,Staff,7,0,20,13
1683729263995,LIGN 101,A01,186039,Staff,43,0,50,7
1683729265023,LIGN 165,A00,186040,Staff,14,0,50,36
1683729266054,LTCS 108,A00,186041,Staff,5,0,10,5
1683729267079,LTCS 119,A00,186042,Staff,15,0,20,5
1683729268103,LTCS 130,A00,186043,Wesling; Megan E.,15,0,25,10
1683729270158,LTEA 138,A00,186119,Staff,13,0,40,27
1683729271182,LTEN 124,A00,186148,Staff,5,0,25,20
1683729272207,LTEN 178,A00,186149,Staff,6,0,15,9
1683729273232,LTEN 181,A00,186150,Blanco; John D,34,0,40,6
1683729274262,LTWL 120,A00,186160,Staff,19,0,25,6
1683729275289,LTWL 165,A00,186161,Staff,22,0,25,3
1683729276314,LTWR 100,A00,186162,Staff,0,5,15,15
1683729277347,LTWR 102,A00,186163,Doller; Ben,5,0,15,10
1683729278378,MAE 8,A01,186412,Staff,0,1,0,0
1683729279409,MAE 30B,A00,186445,Bahadori; Mohammad Yousef,81,0,100,19
1683729280438,MAE 40,A00,186592,Bewley; Thomas R,10,0,50,40
1683729281466,MAE 101B,A00,186593,Bahadori; Mohammad Yousef,80,0,100,20
1683729282495,MAE 105,A00,186594,Bandaru; Prabhakar,10,0,50,40
1683729283523,MAE 107,A00,186599,Pham; Hieu Tan,0,8,120,120
1683729284552,MAE 148,A01,186660,Silberman; Jack,3,0,16,13
1683729285578,MATH 10A,A01,188095,Staff,0,6,35,35
1683729286607,MATH 10B,A01,188097,Bowers; Adam R.,0,12,30,30
1683729286607,MATH 10B,A02,188099,Bowers; Adam R.,0,11,30,30
1683729286607,MATH 10B,B01,188104,Bowers; Adam R.,0,10,30,30
1683729286607,MATH 10B,B02,188106,Bowers; Adam R.,0,9,30,30
1683729287632,MATH 10C,A01,188111,Staff,0,20,30,30
1683729287632,MATH 10C,A02,188127,Staff,0,19,30,30
1683729287632,MATH 10C,A03,188131,Staff,0,19,30,30
1683729287632,MATH 10C,B01,188218,Staff,17,0,30,13
1683729287632,MATH 10C,B02,188244,Staff,13,0,30,17
1683729287632,MATH 10C,B03,188277,Staff,14,0,30,16
1683729288656,MATH 18,A01,188344,Bach; Quang Tran,18,0,30,12
1683729288656,MATH 18,A02,188345,Bach; Quang Tran,11,0,30,19
1683729288656,MATH 18,B01,188353,Bach; Quang Tran,11,0,30,19
1683729288656,MATH 18,B02,188354,Bach; Quang Tran,19,0,30,11
1683729289680,MATH 20A,A01,188374,Staff,10,0,35,25
1683729290706,MATH 20B,A01,188382,Ohm; Ko Woon,7,0,30,23
1683729290706,MATH 20B,A02,188383,Ohm; Ko Woon,22,0,30,8
1683729290706,MATH 20B,B01,188385,Ohm; Ko Woon,7,0,30,23
1683729290706,MATH 20B,B02,188392,Ohm; Ko Woon,22,0,30,8
1683729291733,MATH 20C,A01,188394,Harel; Guershon,10,0,30,20
1683729291733,MATH 20C,A02,188395,Harel; Guershon,13,0,30,17
1683729291733,MATH 20C,B01,188404,Harel; Guershon,5,0,30,25
1683729291733,MATH 20C,B02,188405,Harel; Guershon,18,0,30,12
1683729292766,MATH 20D,A01,188414,Hammock; Frances H,0,1,30,30
1683729292766,MATH 20D,A02,188415,Hammock; Frances H,0,1,30,30
1683729292766,MATH 20D,B01,188447,Hammock; Frances H,0,1,30,30
1683729292766,MATH 20D,B02,188486,Hammock; Frances H,2,0,30,28
1683729293793,MATH 20E,A01,188649,Staff,21,0,30,9
1683729293793,MATH 20E,A02,188650,Staff,20,0,30,10
1683729293793,MATH 20E,A03,188673,Staff,0,0,30,30
1683729294822,MATH 102,A01,188675,Staff,0,40,35,35
1683729295849,MATH 103B,A01,188681,Staff,3,0,35,32
1683729295849,MATH 103B,B01,188692,Staff,5,0,35,30
1683729296946,MATH 109,A01,188695,Salehi Golsefidy; Alireza,24,0,35,11
1683729296946,MATH 109,A02,188696,Salehi Golsefidy; Alireza,24,0,35,11
1683729297972,MATH 120A,A01,188698,Eggers; John Dietrich,7,0,35,28
1683729298996,MATH 142B,A01,188736,Ioana; Adrian,0,0,30,30
1683729298996,MATH 142B,A02,188741,Ioana; Adrian,0,1,30,30
1683729298996,MATH 142B,A03,188743,Ioana; Adrian,0,3,30,30
1683729300020,MATH 168A,A01,188790,Staff,0,11,35,35
1683729301043,MATH 170A,A01,188803,Nie; Jiawang,0,2,35,35
1683729301043,MATH 170A,A02,188811,Nie; Jiawang,0,1,35,35
1683729301043,MATH 170A,A03,188814,Nie; Jiawang,1,0,35,34
1683729301043,MATH 170A,A04,188815,Nie; Jiawang,5,0,35,30
1683729302073,MATH 193B,A01,188817,Staff,0,0,35,35
1683729302073,MATH 193B,A02,188818,Staff,6,0,35,29
1683729303099,MGT 4,A01,202857,Anderson; John Charles,59,0,80,21
1683729304127,MGT 12,A00,202858,Lindenberger; Wade Douglas,40,0,90,50
1683729305162,MGT 18,A00,202859,Staff,73,0,90,17
1683729306192,MGT 18GS,A00,202860,McKay; Michael J,13,0,28,15
1683729307227,MGT 45,A00,202861,Pecore; Joseph P.,8,0,90,82
1683729308266,MGT 100,A00,202863,Yavorsky; Daniel Ryan,27,0,90,63
1683729309293,MGT 103,A00,202864,Ehrich; Kristine R,0,19,90,90
1683729310320,MGT 112,A00,202865,Ehrich; Kristine R,15,0,90,75
1683729311345,MGT 121A,A00,202868,Staff,70,0,90,20
1683729312372,MGT 131B,A00,202869,Anderson; John Charles,58,0,90,32
1683729313396,MGT 136,A00,202871,Lindenberger; Wade Douglas,83,0,90,7
1683729314423,MGT 164,A00,202873,Staff,0,67,90,91
1683729315449,MGT 164GS,A00,202874,McKay; Mary A,13,0,28,15
1683729316475,MGT 180,A00,202875,Staff,0,51,90,91
1683729317505,MMW 11R,A01,205019,Herbst; Matthew,0,0,30,30
1683729317505,MMW 11R,A02,205026,Herbst; Matthew,29,0,30,1
1683729318534,MMW 15,A01,193512,Chang; Edmond Yi-Teh,0,8,28,28
1683729318534,MMW 15,A02,193513,Chang; Edmond Yi-Teh,0,5,28,28
1683729318534,MMW 15,A03,193514,Chang; Edmond Yi-Teh,0,5,28,28
1683729318534,MMW 15,A04,193515,Chang; Edmond Yi-Teh,0,5,28,28
1683729318534,MMW 15,A05,193516,Chang; Edmond Yi-Teh,0,5,28,28
1683729318534,MMW 15,A06,193517,Chang; Edmond Yi-Teh,0,6,28,28
1683729318534,MMW 15,B01,193519,Chang; Edmond Yi-Teh,0,5,28,28
1683729318534,MMW 15,B02,193520,Chang; Edmond Yi-Teh,0,5,28,28
1683729318534,MMW 15,B03,193521,Chang; Edmond Yi-Teh,0,5,28,28
1683729318534,MMW 15,B04,193522,Chang; Edmond Yi-Teh,0,6,28,28
1683729318534,MMW 15,B05,193523,Chang; Edmond Yi-Teh,0,5,28,28
1683729318534,MMW 15,B06,193524,Chang; Edmond Yi-Teh,0,5,28,28
1683729319564,MMW 122,A01,193526,Rahimi; Babak,0,16,28,28
1683729319564,MMW 122,A02,193527,Rahimi; Babak,0,15,28,28
1683729319564,MMW 122,A03,193528,Rahimi; Babak,0,0,0,0
1683729319564,MMW 122,A04,193529,Rahimi; Babak,0,0,0,0
1683729320588,MUS 1A,A01,186663,Staff,0,18,35,35
1683729321612,MUS 4,A01,186715,Staff,0,12,35,35
1683729322639,MUS 5R,A01,186796,Dubnov; Shlomo,0,17,35,35
1683729323665,MUS 6,A01,186798,Staff,0,4,25,25
1683729324693,MUS 7,A01,186830,Staff,11,0,35,24
1683729325720,MUS 8,A01,186930,Staff,0,27,35,35
1683729326746,MUS 15,A01,186932,Staff,0,15,35,35
1683729326746,MUS 15,B01,186934,Staff,0,16,35,35
1683729327771,MUS 80,A00,186935,Staff,0,0,20,20
1683729327771,MUS 80,B00,186936,Staff,24,0,25,1
1683729328799,NANO 11,A00,204702,Lipomi; Darren John,0,0,0,0
1683729329825,NANO 15,A01,204709,Yang; Kesong,0,1,0,0
1683729330851,NANO 114,A00,202069,Jahed Motlagh; Zeinab,2,0,10,8
1683729331879,PHIL 1,A00,186955,Grush; Rick Scott,31,0,40,9
1683729332908,PHIL 10,A01,186973,Grush; Rick Scott,27,0,35,8
1683729332908,PHIL 10,A02,186974,Grush; Rick Scott,33,0,35,2
1683729333936,PHIL 13,A01,186976,Staff,1,0,35,34
1683729333936,PHIL 13,A02,186977,Staff,16,0,35,19
1683729334963,PHIL 14,A01,186979,Staff,30,0,35,5
1683729334963,PHIL 14,A02,186986,Staff,32,0,35,3
1683729335986,PHIL 28,A01,186988,Staff,16,0,30,14
1683729335986,PHIL 28,A02,186989,Staff,0,0,30,30
1683729335986,PHIL 28,A03,186990,Staff,10,0,30,20
1683729335986,PHIL 28,A04,186991,Staff,26,0,30,4
1683729337009,PHIL 120,A00,186997,Staff,23,0,40,17
1683729338036,PHIL 137,A00,187003,Staff,8,0,40,32
1683729339061,PHIL 150,A00,187015,Staff,47,0,70,23
1683729340086,PHIL 167,A00,187021,Lamey; Andy M.,34,0,40,6
1683729341109,PHIL 174,A01,202226,Staff,17,0,20,3
1683729341109,PHIL 174,A02,202235,Staff,20,0,20,0
1683729342134,PHIL 191A,A00,258918,Staff,0,0,1,1
1683729343163,PHYS 1A,A00,187028,Staff,26,0,60,34
1683729344187,PHYS 1AL,001,187036,Staff,3,0,30,27
1683729344187,PHYS 1AL,002,187049,Staff,18,0,30,12
1683729345211,PHYS 1B,A00,187058,Staff,21,0,60,39
1683729346243,PHYS 1BL,001,187064,Staff,0,1,30,30
1683729346243,PHYS 1BL,002,187070,Staff,4,0,30,26
1683729347268,PHYS 1C,A00,187082,Staff,30,0,120,90
1683729348299,PHYS 1CL,001,187088,Staff,0,9,30,30
1683729348299,PHYS 1CL,002,187089,Staff,0,1,30,30
1683729348299,PHYS 1CL,009,262693,Staff,9,0,30,21
1683729349323,PHYS 2B,A01,187097,Staff,55,0,115,60
1683729350350,PHYS 2C,A01,187099,Staff,63,0,115,52
1683729351379,PHYS 2CL,A01,187101,Staff,5,0,28,23
1683729351379,PHYS 2CL,A02,187102,Staff,15,0,28,13
1683729352403,PHYS 2D,A01,187123,Shotwell; Brian,95,0,115,20
1683729353430,PHYS 4B,A01,187133,Grinstein; Benjamin,35,0,50,15
1683729354455,POLI 10,A00,188819,Staff,0,4,50,50
1683729355482,POLI 11,A00,188827,Staff,43,0,50,7
1683729356506,POLI 13R,A00,188828,Staff,0,2,20,20
1683729357530,POLI 27,A01,188830,Elgin; Samuel Zincke,0,2,70,70
1683729358555,POLI 30,A00,188832,Desposato; Scott,30,0,50,20
1683729359581,POLI 102F,A00,188834,Staff,1,0,40,39
1683729360608,POLI 104A,A00,188852,Staff,12,0,30,18
1683729361634,POLI 104I,A00,188853,Staff,0,8,20,20
1683729362658,POLI 110B,A00,188854,Wiens; David,6,0,20,14
1683729363681,POLI 112A,A00,188855,Wiens; David,3,0,30,27
1683729364708,POLI 117R,A00,188856,Forman; Fonna,0,12,20,20
1683729365736,POLI 118,A00,188857,Ingham; Sean,8,0,20,12
1683729366762,POLI 120G,A00,188858,Staff,7,0,30,23
1683729367787,POLI 131CR,A00,188863,Hoston; Germaine,20,0,50,30
1683729368812,POLI 133,A00,188864,Nellis; Gareth Hb,44,0,50,6
1683729369841,POLI 134D,A00,188865,Desposato; Scott,27,0,30,3
1683729370866,POLI 142A,A00,188871,Gartzke; Erik,21,0,50,29
1683729371892,POLI 142K,A00,188874,Staff,38,0,50,12
1683729372919,POLI 143,A00,188940,Gartzke; Erik,15,0,30,15
1683729373943,POLI 153,A00,188943,Staff,1,0,20,19
1683729374969,POLI 160AA,A00,188944,Staff,10,0,40,30
1683729376000,POLI 170A,A00,188945,Staff,10,0,30,20
1683729378053,PSYC 1,A00,188952,Staff,36,0,90,54
1683729379077,PSYC 2,B00,188953,Staff,19,0,35,16
1683729380102,PSYC 6,A00,188970,Staff,47,0,60,13
1683729381130,PSYC 7,A00,188973,Staff,35,0,45,10
1683729382157,PSYC 60,A01,188980,Rickard; Timothy C.,42,0,60,18
1683729383187,PSYC 70,A01,189001,Steiner; Eric Tomas,22,0,45,23
1683729384211,PSYC 100,A00,189005,Lacefield; Katharine I,1,98,120,119
1683729385242,PSYC 102,A00,189008,Staff,6,0,30,24
1683729386272,PSYC 106,B00,189026,Gorman; Michael R.,27,0,60,33
1683729387296,PSYC 114,B01,189033,Winkielman; Piotr,0,31,30,30
1683729388320,PSYC 131,A00,189036,Anagnostaras; Stephan,0,44,60,60
1683729389351,PSYC 136,A00,189041,Lowe; Angela Beth,0,7,25,25
1683729390382,PSYC 137,A00,189057,Winkielman; Piotr,0,36,25,25
1683729391409,PSYC 144,A00,189107,Wixted; John T,0,11,50,50
1683729393461,PSYC 162,A00,189142,Staff,0,9,85,85
1683729394488,PSYC 172,A00,189144,Gorman; Michael R.,0,6,30,30
1683729396537,PSYC 179,A00,189146,Lacefield; Katharine I,0,88,120,120
1683729397565,PSYC 181,A00,189147,Anagnostaras; Stephan,0,45,90,90
1683729398590,PSYC 190R,A00,189148,Barner; David A.,0,23,80,80
1683729399616,PSYC 191,A00,189275,Rickard; Timothy C.,0,11,25,25
1683729400711,PSYC 193,A00,189276,Chapman; Eddie Nathaniel,0,1,0,4
1683729401760,PSYC 193L,A01,189281,Lowe; Angela Beth,8,0,20,12
1683729401760,PSYC 193L,B01,189285,Staff,28,0,35,7
1683729402792,RELI 149,A00,187137,Rahimi; Babak,6,0,40,34
1683729403818,SE 9,A01,187315,Staff,0,2,18,18
1683729404845,SE 101B,A00,187409,Staff,24,0,30,6
1683729405872,SE 110B,A00,187444,Staff,10,0,40,30
1683729406897,SE 130B,A00,187449,Staff,31,0,40,9
1683729407922,SE 150A,A00,187516,Staff,8,0,20,12
1683729408948,SE 154,A00,187528,Staff,29,0,50,21
1683729409975,SIO 3,A01,258171,Staff,35,0,40,5
1683729410999,SIO 10,A00,187144,Cook; Geoffrey W,0,6,75,75
1683729412023,SIO 45,A00,187152,Cook; Geoffrey W,1,7,100,99
1683729413052,SIO 109R,A00,194486,Staff,0,4,20,20
1683729415104,SIO 187,A01,187233,Kacev; David,12,0,40,28
1683729416133,SOCI 1,A01,258656,Thorpe; Charles Robert,28,0,30,2
1683729416133,SOCI 1,A02,258658,Thorpe; Charles Robert,30,0,30,0
1683729416133,SOCI 1,A03,258661,Thorpe; Charles Robert,25,0,25,0
1683729416133,SOCI 1,A04,258666,Thorpe; Charles Robert,22,0,25,3
1683729416133,SOCI 1,A05,258897,Thorpe; Charles Robert,22,0,25,3
1683729416133,SOCI 1,A06,258898,Thorpe; Charles Robert,25,0,25,0
1683729417161,SOCI 30,A01,258903,Pardo Guerra; Juan Pablo,14,0,30,16
1683729418184,SOCI 102,A00,258904,Staff,9,0,25,16
1683729419208,SOCI 106,A00,258905,Staff,19,0,25,6
1683729420232,SOCI 111,A00,258907,Ribas Norris; Janet Vanesa,26,0,30,4
1683729421272,SOCI 121R,A00,258908,Pardo Guerra; Juan Pablo,7,0,30,23
1683729422305,SOCI 126,A01,203330,Staff,14,0,20,6
1683729423334,SOCI 131,A00,258909,Thorpe; Charles Robert,30,0,60,30
1683729424358,SOCI 135,A00,258910,Payne; Christine Anna,0,13,30,30
1683729425384,SOCI 157,A00,258911,Staff,10,0,30,20
1683729426414,SOCI 184,A00,258912,Staff,25,0,30,5
1683729427437,SOCI 188D,A00,258913,Staff,22,0,30,8
1683729428464,SYN 2,001,187529,Staff,9,0,16,7
1683729428464,SYN 2,002,201452,Staff,0,20,16,16
1683729428464,SYN 2,003,201469,Staff,1,0,16,15
1683729429488,SYN 100,A01,187531,Staff,0,9,20,20
1683729429488,SYN 100,B01,201491,Staff,0,10,20,20
1683729430518,TDAC 1,A00,189286,Walsh; Kim C.,3,0,20,17
1683729430518,TDAC 1,B00,189287,Harting; Carla Kelso,10,0,20,10
1683729431547,TDAC 101,A00,189300,Walsh; Kim C.,16,0,20,4
1683729431547,TDAC 101,B00,189301,Harting; Carla Kelso,18,0,20,2
1683729432570,TDAC 102,A00,189304,Basso; Beatrice,14,0,20,6
1683729433594,TDAC 108,A00,189305,Staff,18,0,20,2
1683729434622,TDDE 131,A00,189310,Staff,19,0,20,1
1683729434622,TDDE 131,B00,189314,Staff,19,0,20,1
1683729434622,TDDE 131,C00,189315,Staff,48,0,50,2
1683729434622,TDDE 131,D00,189316,Staff,14,0,15,1
1683729434622,TDDE 131,E00,204841,Staff,20,0,20,0
1683729435650,TDGE 10,A00,189289,Staff,26,0,50,24
1683729435650,TDGE 10,B00,189290,Havis; Allan,0,1,50,50
1683729436681,TDGE 11,A00,189291,Fulton; Julia,0,4,50,50
1683729436681,TDGE 11,B00,189292,Staff,20,0,25,5
1683729436681,TDGE 11,C00,260270,Staff,0,0,0,0
1683729437708,TDGE 25,A00,189294,Staff,1,0,20,19
1683729438731,TDGE 124,A00,189318,Fulton; Julia,0,7,50,50
1683729439758,TDGE 125,A00,189319,Staff,13,0,25,12
1683729439758,TDGE 125,B00,189320,Staff,23,0,25,2
1683729440786,TDGE 127,A00,189322,Havis; Allan,1,0,50,49
1683729441811,TDHT 101,A00,189323,Staff,18,0,25,7
1683729441811,TDHT 101,B00,189324,Staff,25,0,25,0
1683729442836,TDHT 102,A00,189325,Staff,49,0,50,1
1683729443862,TDMV 1,A00,189295,Arcidiacono; Kristin,20,0,30,10
1683729443862,TDMV 1,B00,189296,Caligagan; Maria T.,23,0,30,7
1683729444887,TDMV 2,A00,189297,Sammartano; Tonnie,27,0,30,3
1683729444887,TDMV 2,B00,189299,Arcidiacono; Kristin,23,0,30,7
1683729445916,TDMV 3,A00,204998,Rincon; Alicia,22,0,30,8
1683729446939,TDMV 120,A00,189458,Sammartano; Tonnie,28,0,30,2
1683729447962,TDMV 138,A00,189541,Jun; Grace Shin Hae,20,0,40,20
1683729448988,TDMV 142,A00,189717,Caligagan; Tony,25,0,30,5
1683729448988,TDMV 142,B00,189718,Caligagan; Maria T.,25,0,30,5
1683729450015,TMC 2,A01,187533,Staff,25,0,25,0
1683729450015,TMC 2,A02,187534,Staff,25,0,25,0
1683729451039,USP 1,A01,187536,Kwak; Nancy,0,16,25,25
1683729452069,USP 5,A01,187538,Staff,8,0,25,17
1683729453096,USP 101,A00,199253,Staff,0,4,0,0
1683729454122,USP 124,A00,187562,Boomhower; Matthew Charles,0,0,30,30
1683729455147,USP 138,A00,187582,Staff,19,0,25,6
1683729456178,USP 152,A01,187597,Staff,3,0,25,22
1683729457202,USP 153,A00,187598,Staff,18,0,25,7
1683729458231,USP 168,A00,187607,Kwak; Nancy,2,0,5,3
1683729459282,USP 173,A00,187619,Staff,4,0,25,21
1683729460307,USP 181,A00,187638,Staff,0,4,25,25
1683729461336,VIS 103,A00,187650,Cruz; Edwin Teddy,17,0,75,58
1683729462364,VIS 110D,A00,187669,Staff,13,0,22,9
1683729463395,VIS 127C,A00,187720,Shen; Kuiyi,67,0,146,79
1683729464423,VIS 149,A00,187731,Yoldas; Pinar,0,12,22,22
1683729465451,VIS 151,A01,188091,Staff,22,0,34,12
1683729465451,VIS 151,A02,188092,Staff,11,0,34,23
1683729466480,VIS 160B,A00,188093,Stalbaum; Brett,0,1,10,10
1683729468534,WCWP 10B,A00,201720,Staff,0,0,5,5
1683729468534,WCWP 10B,B00,201722,Staff,0,0,6,6
1683729469557,WCWP 100,A00,201725,Gagnon; Jeffrey C,0,0,2,2
1683729469557,WCWP 100,B00,201727,Staff,0,4,15,15
1683729472668,ANBI 133,A00,258401,Wilder; Linnea Lorene,34,0,40,6
1683729473696,ANBI 140,A00,258395,Hrvoj Mihic; Branka,18,0,25,7
1683729474721,ANSC 120,A00,258402,Bialecki; Jon Anthony,26,0,40,14
1683729475748,ANSC 144,A00,258400,Staff,12,0,40,28
1683729477800,ANSC 166,A00,258396,Parish; Steven Martin,156,0,175,19
1683729478826,ANSC 180,A00,193533,Staff,8,0,20,12
1683729479849,ANSC 188,A00,258397,Jassal; Aftab,34,0,40,6
1683729480880,ANTH 3,A01,258316,Staff,23,0,30,7
1683729481909,ANTH 5,A00,258394,Semendeferi; Ekaterini,16,0,20,4
1683729482934,ANTH 21,A01,258331,Staff,4,0,40,36
1683729483957,ANTH 103,A00,258398,Varma; Saiba,15,0,25,10
1683729484990,AWP 10,001,202034,Staff,0,0,0,0
1683729484990,AWP 10,002,202035,Staff,0,0,0,0
1683729484990,AWP 10,003,202036,Staff,0,0,0,0
1683729484990,AWP 10,004,202037,Staff,0,0,0,0
1683729484990,AWP 10,005,202038,Staff,0,0,0,0
1683729484990,AWP 10,006,202039,Staff,0,0,0,0
1683729484990,AWP 10,007,202040,Staff,0,0,0,0
1683729484990,AWP 10,008,202041,Staff,0,0,0,0
1683729484990,AWP 10,009,202042,Staff,0,0,0,0
1683729484990,AWP 10,010,202043,Staff,0,0,0,0
1683729484990,AWP 10,011,202044,Staff,0,0,0,0
1683729484990,AWP 10,012,202045,Staff,0,0,0,0
1683729484990,AWP 10,013,202046,Staff,0,0,0,0
1683729484990,AWP 10,014,202047,Staff,0,0,0,0
1683729484990,AWP 10,015,202048,Staff,0,0,0,0
1683729484990,AWP 10,016,202049,Staff,0,0,0,0
1683729484990,AWP 10,017,202050,Staff,0,0,0,0
1683729484990,AWP 10,018,202051,Staff,0,0,0,0
1683729484990,AWP 10,019,202052,Staff,0,0,0,0
1683729484990,AWP 10,020,202053,Staff,0,0,0,0
1683729484990,AWP 10,021,202054,Staff,0,0,0,0
1683729484990,AWP 10,022,202055,Staff,0,0,0,0
1683729484990,AWP 10,023,202056,Staff,0,0,0,0
1683729484990,AWP 10,024,202057,Staff,0,0,0,0
1683729484990,AWP 10,025,202058,Staff,0,0,0,0
1683729484990,AWP 10,026,202059,Staff,0,0,0,0
1683729486015,AWP 102,001,202032,Staff,0,0,0,0
1683729486015,AWP 102,002,202033,Staff,0,0,0,0
1683729487040,BENG 100,A01,254234,Taylor Amos; Alyssa C,31,0,40,9
1683729488065,BENG 196,001,270013,Engler; Adam J.,9999,0,9999,0
1683729489091,BICD 100R,A01,202018,Smith; Laurie,0,7,32,32
1683729489091,BICD 100R,A02,202019,Smith; Laurie,0,3,32,32
1683729489091,BICD 100R,A03,202020,Smith; Laurie,0,1,32,32
1683729489091,BICD 100R,A04,202021,Smith; Laurie,6,0,32,26
1683729489091,BICD 100R,A05,202022,Smith; Laurie,10,0,32,22
1683729490115,BICD 136,A01,193242,Gustafson-Brown; Cindy,0,2,32,32
1683729490115,BICD 136,A02,193244,Gustafson-Brown; Cindy,13,0,32,19
1683729491143,BIEB 102,A01,193249,Butler; Shannon Rhey,0,0,32,32
1683729491143,BIEB 102,A02,193251,Butler; Shannon Rhey,0,0,32,32
1683729491143,BIEB 102,A03,193253,Butler; Shannon Rhey,0,0,32,32
1683729491143,BIEB 102,A04,193255,Butler; Shannon Rhey,13,0,32,19
1683729491143,BIEB 102,A05,193265,Butler; Shannon Rhey,25,0,32,7
1683729491143,BIEB 102,A06,193269,Butler; Shannon Rhey,12,0,32,20
1683729493196,BIEB 150,A01,193274,Staff,0,0,32,32
1683729493196,BIEB 150,A02,193285,Staff,24,0,32,8
1683729494222,BIEB 194,A00,193286,Kurle; Carolyn M.,19,0,32,13
1683729495248,BILD 1,A01,192291,Staff,15,0,32,17
1683729495248,BILD 1,A02,192292,Staff,30,0,32,2
1683729495248,BILD 1,B01,192520,Reuther; Keefe,0,1,0,0
1683729495248,BILD 1,B02,192532,Reuther; Keefe,0,1,0,0
1683729496283,BILD 3,A01,192556,Butler; Shannon Rhey,0,0,32,32
1683729496283,BILD 3,A02,192581,Butler; Shannon Rhey,0,1,32,32
1683729496283,BILD 3,A03,192611,Butler; Shannon Rhey,19,0,32,13
1683729496283,BILD 3,A04,192612,Butler; Shannon Rhey,23,0,32,9
1683729496283,BILD 3,A05,192613,Butler; Shannon Rhey,26,0,32,6
1683729496283,BILD 3,A06,192679,Butler; Shannon Rhey,27,0,32,5
1683729496283,BILD 3,A07,192682,Butler; Shannon Rhey,20,0,32,12
1683729497311,BILD 4,A01,192836,Reuther; Keefe,1,0,24,23
1683729497311,BILD 4,A02,193044,Reuther; Keefe,4,0,24,20
1683729498336,BILD 10,A01,193142,Gustafson-Brown; Cindy,29,0,32,3
1683729498336,BILD 10,A02,193149,Gustafson-Brown; Cindy,31,0,32,1
1683729499364,BIMM 100,A01,193301,Staff,0,6,32,32
1683729499364,BIMM 100,A02,193312,Staff,0,7,32,32
1683729499364,BIMM 100,A03,193323,Staff,0,10,32,32
1683729500391,BIMM 101,A01,193329,McDonnell; Lisa Marie,0,3,24,24
1683729500391,BIMM 101,A02,193339,McDonnell; Lisa Marie,0,3,24,24
1683729500391,BIMM 101,B01,193354,McDonnell; Lisa Marie,0,4,24,24
1683729500391,BIMM 101,B02,193357,McDonnell; Lisa Marie,0,3,24,24
1683729501419,BIMM 110,A01,193377,Tat; John,0,11,32,32
1683729501419,BIMM 110,A02,193378,Tat; John,0,11,32,32
1683729502443,BIMM 120,A01,206116,Staff,0,0,32,32
1683729502443,BIMM 120,A02,206117,Staff,7,0,32,25
1683729502443,BIMM 120,A03,206121,Staff,21,0,32,11
1683729503469,BIPN 100,A01,193393,Park; Ji Young,0,15,32,32
1683729503469,BIPN 100,A02,193402,Park; Ji Young,0,14,32,32
1683729503469,BIPN 100,A03,193413,Park; Ji Young,0,14,32,32
1683729503469,BIPN 100,A04,193414,Park; Ji Young,0,13,32,32
1683729504550,BIPN 102,A01,193429,Staff,0,0,32,32
1683729504550,BIPN 102,A02,193438,Staff,18,0,32,14
1683729505576,BIPN 106,A01,193450,Reyes Gonzalez; Catalina,0,2,40,40
1683729506605,BIPN 134,A01,193465,Cooke; James Edward,0,0,32,32
1683729506605,BIPN 134,A02,193474,Cooke; James Edward,25,0,32,7
1683729506605,BIPN 134,A03,193485,Cooke; James Edward,29,0,32,3
1683729506605,BIPN 134,A04,193486,Cooke; James Edward,20,0,32,12
1683729506605,BIPN 134,A05,193491,Cooke; James Edward,31,0,32,1
1683729506605,BIPN 134,A06,193501,Cooke; James Edward,30,0,32,2
1683729506605,BIPN 134,A07,193510,Cooke; James Edward,29,0,32,3
1683729508654,BISP 194,A00,222522,Staff,14,0,32,18
1683729509681,CAT 124,A01,202407,Staff,19,0,25,6
1683729510708,CAT 125,A00,202408,Marchisotto; Jennifer Anne,2,0,20,18
1683729511744,CAT 125R,A00,202409,Smith; Lauryn Alissa,0,11,20,20
1683729511744,CAT 125R,B00,202410,Morales; Celeste Georgianna,0,11,20,20
1683729511744,CAT 125R,C00,202411,Irwin; Matthew Joseph,0,12,20,20
1683729512769,CENG 15,A01,204712,Yang; Kesong,0,1,0,0
1683729513799,CENG 114,A00,202070,Jahed Motlagh; Zeinab,5,0,20,15
1683729514827,CGS 105,A00,185477,Wesling; Megan E.,24,0,40,16
1683729515855,CGS 106,A00,185494,Staff,11,0,22,11
1683729516878,CGS 108,A00,185495,Staff,14,0,20,6
1683729517925,CGS 114,A00,185496,Staff,13,0,18,5
1683729518949,CGS 119,A00,185501,Staff,15,0,20,5
1683729519975,CGS 120,A00,185511,Staff,11,0,20,9
1683729521003,CHEM 4,A01,184675,Bussey; Thomas J,97,0,100,3
1683729522030,CHEM 6A,A01,184677,Staff,32,0,60,28
1683729523057,CHEM 6B,A01,184679,Staff,63,0,100,37
1683729524081,CHEM 6C,A01,184681,Bussey; Thomas J,0,0,50,50
1683729524081,CHEM 6C,A02,184682,Bussey; Thomas J,32,0,50,18
1683729525107,CHEM 40A,A01,184684,Albizati; Kim F.,33,0,100,67
1683729526133,CHEM 40B,A01,184686,Albizati; Kim F.,0,22,100,100
1683729527157,CHEM 41B,A01,184690,Staff,51,0,100,49
1683729528182,COGS 3,A01,184715,Boyle; Mary E. T.,0,27,40,40
1683729529207,COGS 14B,A01,185172,Staff,0,14,38,38
1683729530236,COGS 18,A01,184736,Staff,14,0,80,66
1683729531260,COGS 100,A01,184932,Staff,0,8,73,73
1683729532284,COGS 101A,A01,184935,Staff,0,40,30,30
1683729533312,COGS 101B,A01,184944,Staff,0,2,30,30
1683729534339,COGS 101C,A01,184946,Staff,0,10,30,30
1683729535368,COGS 102A,A01,184951,Johnson; Christine M.,1,0,40,39
1683729536393,COGS 107B,A01,184953,Mooshagian; Eric Frederick,0,52,40,40
1683729537421,COGS 118B,A01,184959,Gupta; Anjum,0,50,40,40
1683729538445,COGS 153,A00,184961,Staff,1,16,30,29
1683729539469,COGS 177,A00,184962,Staff,0,20,30,30
1683729540493,COGS 187A,A01,184969,Boyle; Mary E. T.,0,19,40,40
1683729541519,COMM 10,A01,185174,Staff,0,5,25,25
1683729541519,COMM 10,A02,185189,Staff,0,2,25,25
1683729541519,COMM 10,A03,269821,Staff,0,1,0,0
1683729542545,COMM 100B,A02,185476,Staff,10,0,25,15
1683729542545,COMM 100B,A03,277340,Staff,25,0,25,0
1683729543569,COMM 100C,A01,185314,Staff,2,0,25,23
1683729543569,COMM 100C,A02,185327,Staff,17,0,25,8
1683729544596,COMM 110M,A00,185349,Staff,0,0,40,40
1683729545623,COMM 113T,A00,185352,Staff,25,0,40,15
1683729546648,COMM 114I,A00,185353,Staff,31,0,40,9
1683729547672,COMM 131,A00,185354,Staff,17,0,30,13
1683729548696,CSE 8A,A50,185358,Cao; Yingjun,0,46,10,10
1683729549720,CSE 8B,A01,185362,Staff,0,48,50,50
1683729550744,CSE 11,A01,185416,Cao; Yingjun,0,91,10,10
1683729551771,CSE 20,A01,185445,Briones; Jor-el Thomas Caparas,3,0,25,22
1683729552799,CSE 21,A01,185447,Staff,9,0,50,41
1683729553826,CSE 101,A01,185451,Staff,0,13,50,50
1683729553826,CSE 101,B01,185453,Jones; Miles E,0,15,50,50
1683729555880,CSE 141,A01,185458,Eldon; John,16,0,100,84
1683729556903,CSE 141L,A01,185461,Eldon; John,8,0,100,92
1683729557927,CSE 142,A01,185463,Staff,34,0,60,26
1683729557927,CSE 142,B01,201355,Staff,0,7,60,60
1683729558952,CSE 142L,A01,185470,Staff,34,0,60,26
1683729558952,CSE 142L,B01,201417,Staff,0,6,60,60
1683729559978,CSE 190,A00,201433,Staff,32,0,49,17
1683729561006,DOC 1,A01,259136,Strom; Megan C.,7,0,15,8
1683729561006,DOC 1,A02,259137,Strom; Megan C.,15,0,15,0
1683729561006,DOC 1,A03,259138,Strom; Megan C.,14,0,15,1
1683729561006,DOC 1,A04,259139,Strom; Megan C.,13,0,15,2
1683729562031,DOC 100D,A00,259140,Pass; Natalye Joann,14,0,25,11
1683729563068,DSGN 1,A01,184749,Rill; Bryan,0,26,30,30
1683729564110,DSGN 100,A01,185168,Staff,0,2,25,25
1683729565136,ECE 5,A01,185626,Morris; Karcher William,0,12,0,0
1683729566177,ECE 101,A01,185628,Staff,14,0,70,56
1683729567205,ECE 107,A01,185635,Baghdadchi; Saharnaz,0,0,20,20
1683729567205,ECE 107,A02,185638,Baghdadchi; Saharnaz,1,0,20,19
1683729568230,ECE 148,A01,185647,Silberman; Jack,0,0,16,16
1683729569258,ECON 1,A01,185537,Crane; Meredith Helen,54,0,70,16
1683729570281,ECON 3,A01,185549,Crane; Meredith Helen,30,0,70,40
1683729571306,ECON 4,A01,203354,Anderson; John Charles,0,5,10,10
1683729572330,ECON 100A,A01,185574,Staff,0,5,40,40
1683729573356,ECON 100B,A01,185576,Staff,0,12,50,50
1683729574380,ECON 100C,A01,185589,Newhouse; Herbert S,30,0,70,40
1683729575405,ECON 105,A00,185608,Vespa; Emanuel Ignacio,19,0,35,16
1683729576429,ECON 109,A01,185610,Shishkin; Denis,9,0,35,26
1683729577452,ECON 110A,A01,185612,Staff,8,0,40,32
1683729578476,ECON 120A,A01,185615,Staff,19,0,40,21
1683729579505,ECON 120C,A01,185617,Sun; Yixiao,0,21,70,70
1683729580531,ECON 144,A00,203346,Squires; Dale E,2,0,35,33
1683729581559,ECON 171,A01,203349,Newhouse; Herbert S,0,1,35,35
1683729582586,ECON 173A,A01,185621,Toda; Alexis Akira,21,0,35,14
1683729583613,EDS 25,A01,202413,Staff,0,1,0,0
1683729583613,EDS 25,A02,202414,Staff,0,1,0,0
1683729583613,EDS 25,A03,202415,Staff,0,0,0,0
1683729583613,EDS 25,A04,202416,Staff,0,1,0,0
1683729583613,EDS 25,A05,202439,Staff,0,0,0,0
1683729583613,EDS 25,A06,202440,Staff,0,0,0,0
1683729583613,EDS 25,B01,202631,Staff,0,0,0,0
1683729583613,EDS 25,B02,202632,Staff,0,0,0,0
1683729583613,EDS 25,B03,202639,Staff,0,0,0,0
1683729583613,EDS 25,B04,202640,Staff,0,0,0,0
1683729583613,EDS 25,B05,202643,Staff,0,0,0,0
1683729583613,EDS 25,B06,202644,Staff,0,0,0,0
1683729584642,EDS 38,A01,202659,Black; Alison Michelle,25,0,25,0
1683729585666,EDS 115,A00,202652,Staff,18,0,30,12
1683729586694,EDS 125,A00,202649,Staff,13,0,30,17
1683729587722,EDS 126,A01,203332,Staff,30,0,30,0
1683729588747,EDS 139,A00,202838,Staff,16,0,25,9
1683729589778,EDS 146,A01,202655,Staff,14,0,25,11
1683729590803,ENG 15,A00,185667,Staff,0,1,0,0
1683729590803,ENG 15,B00,185672,Staff,0,0,0,0
1683729590803,ENG 15,C00,185675,Staff,0,0,0,0
1683729590803,ENG 15,D00,185682,Staff,0,0,0,0
1683729590803,ENG 15,E00,185684,Staff,0,0,0,0
1683729591829,ETHN 103,A00,185710,Staff,0,8,35,35
1683729592854,ETHN 103A,A00,199228,Man; Simeon S,0,0,9,9
1683729593881,ETHN 109,A00,185711,Staff,15,0,35,20
1683729594909,ETHN 142,A00,185726,Staff,0,4,30,30
1683729595933,ETHN 163J,A00,199229,Man; Simeon S,5,0,8,3
1683729596958,ETHN 168,A00,185727,Staff,7,0,10,3
1683729597985,ETHN 182,A00,185728,Staff,0,0,35,35
1683729599012,ETHN 183,A00,185737,Staff,10,0,18,8
1683729600038,GLBH 111,A01,209361,Burgos; Jose L.,0,0,0,0
1683729602087,HIEU 104,A00,185792,Staff,14,0,20,6
1683729603115,HIEU 115,A00,185800,Staff,0,0,20,20
1683729604140,HIEU 128,A00,185801,Staff,0,9,20,20
1683729605164,HIEU 147,A00,185802,Staff,15,0,20,5
1683729606201,HIEU 154,A00,185823,Staff,11,0,20,9
1683729607224,HILA 102,A00,185826,Staff,14,0,20,6
1683729608311,HILD 2C,A01,185778,Staff,0,13,20,20
1683729609341,HILD 7B,A01,185780,Kwak; Nancy,0,17,32,32
1683729609341,HILD 7B,A02,185781,Kwak; Nancy,0,18,32,32
1683729610366,HILD 30,A01,185791,Staff,12,0,20,8
1683729611390,HISC 119,A00,185830,Golan; Tal,0,10,20,20
1683729612417,HITO 156GS,A00,185831,Patterson; Patrick H.,0,0,0,23
1683729613454,HIUS 103,A00,185832,Man; Simeon S,0,4,20,20
1683729614480,HIUS 117,A00,185836,Kwak; Nancy,2,0,20,18
1683729615504,HIUS 125,A00,185840,Man; Simeon S,0,2,23,23
1683729616531,HIUS 149,A00,185845,Staff,1,0,20,19
1683729617564,HUM 3,A01,185882,Zavodny; Tatiana Sophia,0,8,50,50
1683729617564,HUM 3,B01,185899,Caldwell; Michael Alan,0,18,50,50
1683729618588,HUM 3GS,A00,185900,Patterson; Patrick H.,0,0,0,23
1683729619614,HUM 4,A01,185938,Zroka; Amy Liane,28,0,50,22
1683729619614,HUM 4,B01,185956,Watkins; Eric,0,6,50,50
1683729619614,HUM 4,B02,202209,Watkins; Eric,0,6,50,50
1683729619614,HUM 4,B03,202210,Watkins; Eric,0,5,50,50
1683729620640,HUM 5,A01,185958,West; Geoffrey Scott,0,0,50,50
1683729620640,HUM 5,A02,202215,West; Geoffrey Scott,0,1,50,50
1683729621671,INTL 190,A00,185959,Gagnon; Jeffrey C,0,0,0,9
1683729621671,INTL 190,B00,185960,Lettieri; Michael Joseph,0,0,0,2
1683729622698,JAPN 180,A00,254509,Staff,4,0,30,26
1683729623728,LATI 10,A01,202853,Kennemore; Amy Michelle,4,0,35,31
1683729623728,LATI 10,A02,202854,Kennemore; Amy Michelle,3,0,35,32
1683729623728,LATI 10,A03,270054,Kennemore; Amy Michelle,30,0,30,0
1683729624752,LATI 180,A00,202855,Kennemore; Amy Michelle,11,0,20,9
1683729625778,LAWS 101,A00,201767,Golan; Tal,0,7,40,40
1683729626802,LIFR 1C,A00,185961,Staff,6,0,20,14
1683729627826,LIFR 1CX,A00,185962,Staff,7,0,20,13
1683729628853,LIFR 1D,A00,185963,Staff,7,0,20,13
1683729629877,LIFR 1DX,A00,185964,Staff,7,0,20,13
1683729630905,LIGN 101,A01,186039,Staff,43,0,50,7
1683729631929,LIGN 165,A00,186040,Staff,14,0,50,36
1683729632958,LTCS 108,A00,186041,Staff,5,0,10,5
1683729633989,LTCS 119,A00,186042,Staff,15,0,20,5
1683729635015,LTCS 130,A00,186043,Wesling; Megan E.,15,0,25,10
1683729637066,LTEA 138,A00,186119,Staff,13,0,40,27
1683729638089,LTEN 124,A00,186148,Staff,5,0,25,20
1683729639113,LTEN 178,A00,186149,Staff,6,0,15,9
1683729640137,LTEN 181,A00,186150,Blanco; John D,34,0,40,6
1683729641162,LTWL 120,A00,186160,Staff,19,0,25,6
1683729642188,LTWL 165,A00,186161,Staff,22,0,25,3
1683729643212,LTWR 100,A00,186162,Staff,0,5,15,15
1683729644238,LTWR 102,A00,186163,Doller; Ben,5,0,15,10
1683729645267,MAE 8,A01,186412,Staff,0,1,0,0
1683729646298,MAE 30B,A00,186445,Bahadori; Mohammad Yousef,81,0,100,19
1683729647325,MAE 40,A00,186592,Bewley; Thomas R,10,0,50,40
1683729648352,MAE 101B,A00,186593,Bahadori; Mohammad Yousef,80,0,100,20
1683729649382,MAE 105,A00,186594,Bandaru; Prabhakar,10,0,50,40
1683729650412,MAE 107,A00,186599,Pham; Hieu Tan,0,8,120,120
1683729651438,MAE 148,A01,186660,Silberman; Jack,3,0,16,13
1683729652463,MATH 10A,A01,188095,Staff,0,6,35,35
1683729653487,MATH 10B,A01,188097,Bowers; Adam R.,0,12,30,30
1683729653487,MATH 10B,A02,188099,Bowers; Adam R.,0,11,30,30
1683729653487,MATH 10B,B01,188104,Bowers; Adam R.,0,10,30,30
1683729653487,MATH 10B,B02,188106,Bowers; Adam R.,0,9,30,30
1683729654513,MATH 10C,A01,188111,Staff,0,20,30,30
1683729654513,MATH 10C,A02,188127,Staff,0,19,30,30
1683729654513,MATH 10C,A03,188131,Staff,0,19,30,30
1683729654513,MATH 10C,B01,188218,Staff,17,0,30,13
1683729654513,MATH 10C,B02,188244,Staff,13,0,30,17
1683729654513,MATH 10C,B03,188277,Staff,14,0,30,16
1683729655540,MATH 18,A01,188344,Bach; Quang Tran,18,0,30,12
1683729655540,MATH 18,A02,188345,Bach; Quang Tran,11,0,30,19
1683729655540,MATH 18,B01,188353,Bach; Quang Tran,11,0,30,19
1683729655540,MATH 18,B02,188354,Bach; Quang Tran,19,0,30,11
1683729656565,MATH 20A,A01,188374,Staff,10,0,35,25
1683729657598,MATH 20B,A01,188382,Ohm; Ko Woon,7,0,30,23
1683729657598,MATH 20B,A02,188383,Ohm; Ko Woon,22,0,30,8
1683729657598,MATH 20B,B01,188385,Ohm; Ko Woon,7,0,30,23
1683729657598,MATH 20B,B02,188392,Ohm; Ko Woon,22,0,30,8
1683729658622,MATH 20C,A01,188394,Harel; Guershon,10,0,30,20
1683729658622,MATH 20C,A02,188395,Harel; Guershon,13,0,30,17
1683729658622,MATH 20C,B01,188404,Harel; Guershon,5,0,30,25
1683729658622,MATH 20C,B02,188405,Harel; Guershon,18,0,30,12
1683729659652,MATH 20D,A01,188414,Hammock; Frances H,0,1,30,30
1683729659652,MATH 20D,A02,188415,Hammock; Frances H,0,1,30,30
1683729659652,MATH 20D,B01,188447,Hammock; Frances H,0,1,30,30
1683729659652,MATH 20D,B02,188486,Hammock; Frances H,2,0,30,28
1683729660679,MATH 20E,A01,188649,Staff,21,0,30,9
1683729660679,MATH 20E,A02,188650,Staff,20,0,30,10
1683729660679,MATH 20E,A03,188673,Staff,0,0,30,30
1683729661706,MATH 102,A01,188675,Staff,0,40,35,35
1683729662730,MATH 103B,A01,188681,Staff,3,0,35,32
1683729662730,MATH 103B,B01,188692,Staff,5,0,35,30
1683729663758,MATH 109,A01,188695,Salehi Golsefidy; Alireza,24,0,35,11
1683729663758,MATH 109,A02,188696,Salehi Golsefidy; Alireza,24,0,35,11
1683729664783,MATH 120A,A01,188698,Eggers; John Dietrich,7,0,35,28
1683729665814,MATH 142B,A01,188736,Ioana; Adrian,0,0,30,30
1683729665814,MATH 142B,A02,188741,Ioana; Adrian,0,1,30,30
1683729665814,MATH 142B,A03,188743,Ioana; Adrian,0,3,30,30
1683729666838,MATH 168A,A01,188790,Staff,0,11,35,35
1683729667863,MATH 170A,A01,188803,Nie; Jiawang,0,2,35,35
1683729667863,MATH 170A,A02,188811,Nie; Jiawang,0,1,35,35
1683729667863,MATH 170A,A03,188814,Nie; Jiawang,1,0,35,34
1683729667863,MATH 170A,A04,188815,Nie; Jiawang,5,0,35,30
1683729668887,MATH 193B,A01,188817,Staff,0,0,35,35
1683729668887,MATH 193B,A02,188818,Staff,6,0,35,29
1683729669911,MGT 4,A01,202857,Anderson; John Charles,59,0,80,21
1683729670938,MGT 12,A00,202858,Lindenberger; Wade Douglas,40,0,90,50
1683729671965,MGT 18,A00,202859,Staff,73,0,90,17
1683729672990,MGT 18GS,A00,202860,McKay; Michael J,13,0,28,15
1683729674014,MGT 45,A00,202861,Pecore; Joseph P.,8,0,90,82
1683729675044,MGT 100,A00,202863,Yavorsky; Daniel Ryan,27,0,90,63
1683729676070,MGT 103,A00,202864,Ehrich; Kristine R,0,19,90,90
1683729677098,MGT 112,A00,202865,Ehrich; Kristine R,15,0,90,75
1683729678124,MGT 121A,A00,202868,Staff,70,0,90,20
1683729679151,MGT 131B,A00,202869,Anderson; John Charles,58,0,90,32
1683729680179,MGT 136,A00,202871,Lindenberger; Wade Douglas,83,0,90,7
1683729681203,MGT 164,A00,202873,Staff,0,67,90,91
1683729682232,MGT 164GS,A00,202874,McKay; Mary A,13,0,28,15
1683729683275,MGT 180,A00,202875,Staff,0,51,90,91
1683729684309,MMW 11R,A01,205019,Herbst; Matthew,0,0,30,30
1683729684309,MMW 11R,A02,205026,Herbst; Matthew,29,0,30,1
1683729685335,MMW 15,A01,193512,Chang; Edmond Yi-Teh,0,8,28,28
1683729685335,MMW 15,A02,193513,Chang; Edmond Yi-Teh,0,5,28,28
1683729685335,MMW 15,A03,193514,Chang; Edmond Yi-Teh,0,5,28,28
1683729685335,MMW 15,A04,193515,Chang; Edmond Yi-Teh,0,5,28,28
1683729685335,MMW 15,A05,193516,Chang; Edmond Yi-Teh,0,5,28,28
1683729685335,MMW 15,A06,193517,Chang; Edmond Yi-Teh,0,6,28,28
1683729685335,MMW 15,B01,193519,Chang; Edmond Yi-Teh,0,5,28,28
1683729685335,MMW 15,B02,193520,Chang; Edmond Yi-Teh,0,5,28,28
1683729685335,MMW 15,B03,193521,Chang; Edmond Yi-Teh,0,5,28,28
1683729685335,MMW 15,B04,193522,Chang; Edmond Yi-Teh,0,6,28,28
1683729685335,MMW 15,B05,193523,Chang; Edmond Yi-Teh,0,5,28,28
1683729685335,MMW 15,B06,193524,Chang; Edmond Yi-Teh,0,5,28,28
1683729686361,MMW 122,A01,193526,Rahimi; Babak,0,16,28,28
1683729686361,MMW 122,A02,193527,Rahimi; Babak,0,15,28,28
1683729686361,MMW 122,A03,193528,Rahimi; Babak,0,0,0,0
1683729686361,MMW 122,A04,193529,Rahimi; Babak,0,0,0,0
1683729687387,MUS 1A,A01,186663,Staff,0,18,35,35
1683729688412,MUS 4,A01,186715,Staff,0,12,35,35
1683729689437,MUS 5R,A01,186796,Dubnov; Shlomo,0,17,35,35
1683729690461,MUS 6,A01,186798,Staff,0,4,25,25
1683729691487,MUS 7,A01,186830,Staff,11,0,35,24
1683729692512,MUS 8,A01,186930,Staff,0,27,35,35
1683729693536,MUS 15,A01,186932,Staff,0,15,35,35
1683729693536,MUS 15,B01,186934,Staff,0,16,35,35
1683729694560,MUS 80,A00,186935,Staff,0,0,20,20
1683729694560,MUS 80,B00,186936,Staff,24,0,25,1
1683729695589,NANO 11,A00,204702,Lipomi; Darren John,0,0,0,0
1683729696612,NANO 15,A01,204709,Yang; Kesong,0,1,0,0
1683729697635,NANO 114,A00,202069,Jahed Motlagh; Zeinab,2,0,10,8
1683729698659,PHIL 1,A00,186955,Grush; Rick Scott,31,0,40,9
1683729699688,PHIL 10,A01,186973,Grush; Rick Scott,27,0,35,8
1683729699688,PHIL 10,A02,186974,Grush; Rick Scott,33,0,35,2
1683729700717,PHIL 13,A01,186976,Staff,1,0,35,34
1683729700717,PHIL 13,A02,186977,Staff,16,0,35,19
1683729701740,PHIL 14,A01,186979,Staff,30,0,35,5
1683729701740,PHIL 14,A02,186986,Staff,32,0,35,3
1683729702767,PHIL 28,A01,186988,Staff,16,0,30,14
1683729702767,PHIL 28,A02,186989,Staff,0,0,30,30
1683729702767,PHIL 28,A03,186990,Staff,10,0,30,20
1683729702767,PHIL 28,A04,186991,Staff,26,0,30,4
1683729703793,PHIL 120,A00,186997,Staff,23,0,40,17
1683729704816,PHIL 137,A00,187003,Staff,8,0,40,32
1683729705841,PHIL 150,A00,187015,Staff,47,0,70,23
1683729706865,PHIL 167,A00,187021,Lamey; Andy M.,34,0,40,6
1683729707889,PHIL 174,A01,202226,Staff,17,0,20,3
1683729707889,PHIL 174,A02,202235,Staff,20,0,20,0
1683729708913,PHIL 191A,A00,258918,Staff,0,0,1,1
1683729709937,PHYS 1A,A00,187028,Staff,26,0,60,34
1683729710965,PHYS 1AL,001,187036,Staff,3,0,30,27
1683729710965,PHYS 1AL,002,187049,Staff,18,0,30,12
1683729712053,PHYS 1B,A00,187058,Staff,21,0,60,39
1683729713080,PHYS 1BL,001,187064,Staff,0,1,30,30
1683729713080,PHYS 1BL,002,187070,Staff,4,0,30,26
1683729714113,PHYS 1C,A00,187082,Staff,30,0,120,90
1683729715136,PHYS 1CL,001,187088,Staff,0,9,30,30
1683729715136,PHYS 1CL,002,187089,Staff,0,1,30,30
1683729715136,PHYS 1CL,009,262693,Staff,9,0,30,21
1683729716161,PHYS 2B,A01,187097,Staff,55,0,115,60
1683729717188,PHYS 2C,A01,187099,Staff,63,0,115,52
1683729718215,PHYS 2CL,A01,187101,Staff,5,0,28,23
1683729718215,PHYS 2CL,A02,187102,Staff,15,0,28,13
1683729719242,PHYS 2D,A01,187123,Shotwell; Brian,95,0,115,20
1683729720269,PHYS 4B,A01,187133,Grinstein; Benjamin,35,0,50,15
1683729721296,POLI 10,A00,188819,Staff,0,4,50,50
1683729722322,POLI 11,A00,188827,Staff,43,0,50,7
1683729723349,POLI 13R,A00,188828,Staff,0,2,20,20
1683729724372,POLI 27,A01,188830,Elgin; Samuel Zincke,0,2,70,70
1683729725401,POLI 30,A00,188832,Desposato; Scott,30,0,50,20
1683729726438,POLI 102F,A00,188834,Staff,1,0,40,39
1683729727461,POLI 104A,A00,188852,Staff,12,0,30,18
1683729728488,POLI 104I,A00,188853,Staff,0,8,20,20
1683729729528,POLI 110B,A00,188854,Wiens; David,6,0,20,14
1683729730558,POLI 112A,A00,188855,Wiens; David,3,0,30,27
1683729731585,POLI 117R,A00,188856,Forman; Fonna,0,12,20,20
1683729732612,POLI 118,A00,188857,Ingham; Sean,8,0,20,12
1683729733643,POLI 120G,A00,188858,Staff,7,0,30,23
1683729734670,POLI 131CR,A00,188863,Hoston; Germaine,20,0,50,30
1683729735698,POLI 133,A00,188864,Nellis; Gareth Hb,44,0,50,6
1683729736723,POLI 134D,A00,188865,Desposato; Scott,27,0,30,3
1683729737747,POLI 142A,A00,188871,Gartzke; Erik,21,0,50,29
1683729738775,POLI 142K,A00,188874,Staff,38,0,50,12
1683729739802,POLI 143,A00,188940,Gartzke; Erik,15,0,30,15
1683729740834,POLI 153,A00,188943,Staff,1,0,20,19
1683729741859,POLI 160AA,A00,188944,Staff,10,0,40,30
1683729742884,POLI 170A,A00,188945,Staff,10,0,30,20
1683729744934,PSYC 1,A00,188952,Staff,36,0,90,54
1683729745958,PSYC 2,B00,188953,Staff,19,0,35,16
1683729746984,PSYC 6,A00,188970,Staff,47,0,60,13
1683729748009,PSYC 7,A00,188973,Staff,35,0,45,10
1683729749040,PSYC 60,A01,188980,Rickard; Timothy C.,42,0,60,18
1683729750068,PSYC 70,A01,189001,Steiner; Eric Tomas,22,0,45,23
1683729751100,PSYC 100,A00,189005,Lacefield; Katharine I,1,98,120,119
1683729752126,PSYC 102,A00,189008,Staff,6,0,30,24
1683729753154,PSYC 106,B00,189026,Gorman; Michael R.,27,0,60,33
1683729754183,PSYC 114,B01,189033,Winkielman; Piotr,0,31,30,30
1683729755210,PSYC 131,A00,189036,Anagnostaras; Stephan,0,44,60,60
1683729756238,PSYC 136,A00,189041,Lowe; Angela Beth,0,7,25,25
1683729757263,PSYC 137,A00,189057,Winkielman; Piotr,0,36,25,25
1683729758296,PSYC 144,A00,189107,Wixted; John T,0,11,50,50
1683729760350,PSYC 162,A00,189142,Staff,0,9,85,85
1683729761383,PSYC 172,A00,189144,Gorman; Michael R.,0,6,30,30
1683729763430,PSYC 179,A00,189146,Lacefield; Katharine I,0,88,120,120
1683729764456,PSYC 181,A00,189147,Anagnostaras; Stephan,0,45,90,90
1683729765486,PSYC 190R,A00,189148,Barner; David A.,0,23,80,80
1683729766510,PSYC 191,A00,189275,Rickard; Timothy C.,0,11,25,25
1683729767535,PSYC 193,A00,189276,Chapman; Eddie Nathaniel,0,1,0,4
1683729768561,PSYC 193L,A01,189281,Lowe; Angela Beth,8,0,20,12
1683729768561,PSYC 193L,B01,189285,Staff,28,0,35,7
1683729769586,RELI 149,A00,187137,Rahimi; Babak,6,0,40,34
1683729770621,SE 9,A01,187315,Staff,0,2,18,18
1683729771650,SE 101B,A00,187409,Staff,24,0,30,6
1683729772674,SE 110B,A00,187444,Staff,10,0,40,30
1683729773704,SE 130B,A00,187449,Staff,31,0,40,9
1683729774729,SE 150A,A00,187516,Staff,8,0,20,12
1683729775755,SE 154,A00,187528,Staff,29,0,50,21
1683729776779,SIO 3,A01,258171,Staff,35,0,40,5
1683729777806,SIO 10,A00,187144,Cook; Geoffrey W,0,6,75,75
1683729778831,SIO 45,A00,187152,Cook; Geoffrey W,1,7,100,99
1683729779858,SIO 109R,A00,194486,Staff,0,4,20,20
1683729781912,SIO 187,A01,187233,Kacev; David,12,0,40,28
1683729782939,SOCI 1,A01,258656,Thorpe; Charles Robert,28,0,30,2
1683729782939,SOCI 1,A02,258658,Thorpe; Charles Robert,30,0,30,0
1683729782939,SOCI 1,A03,258661,Thorpe; Charles Robert,25,0,25,0
1683729782939,SOCI 1,A04,258666,Thorpe; Charles Robert,22,0,25,3
1683729782939,SOCI 1,A05,258897,Thorpe; Charles Robert,22,0,25,3
1683729782939,SOCI 1,A06,258898,Thorpe; Charles Robert,25,0,25,0
1683729783963,SOCI 30,A01,258903,Pardo Guerra; Juan Pablo,14,0,30,16
1683729784987,SOCI 102,A00,258904,Staff,9,0,25,16
1683729786011,SOCI 106,A00,258905,Staff,19,0,25,6
1683729787039,SOCI 111,A00,258907,Ribas Norris; Janet Vanesa,26,0,30,4
1683729788066,SOCI 121R,A00,258908,Pardo Guerra; Juan Pablo,7,0,30,23
1683729789091,SOCI 126,A01,203330,Staff,14,0,20,6
1683729790119,SOCI 131,A00,258909,Thorpe; Charles Robert,30,0,60,30
1683729791145,SOCI 135,A00,258910,Payne; Christine Anna,0,13,30,30
1683729792170,SOCI 157,A00,258911,Staff,10,0,30,20
1683729793192,SOCI 184,A00,258912,Staff,25,0,30,5
1683729794219,SOCI 188D,A00,258913,Staff,22,0,30,8
1683729795247,SYN 2,001,187529,Staff,9,0,16,7
1683729795247,SYN 2,002,201452,Staff,0,20,16,16
1683729795247,SYN 2,003,201469,Staff,1,0,16,15
1683729796270,SYN 100,A01,187531,Staff,0,9,20,20
1683729796270,SYN 100,B01,201491,Staff,0,10,20,20
1683729797306,TDAC 1,A00,189286,Walsh; Kim C.,3,0,20,17
1683729797306,TDAC 1,B00,189287,Harting; Carla Kelso,10,0,20,10
1683729798334,TDAC 101,A00,189300,Walsh; Kim C.,16,0,20,4
1683729798334,TDAC 101,B00,189301,Harting; Carla Kelso,18,0,20,2
1683729799358,TDAC 102,A00,189304,Basso; Beatrice,14,0,20,6
1683729800388,TDAC 108,A00,189305,Staff,18,0,20,2
1683729801418,TDDE 131,A00,189310,Staff,19,0,20,1
1683729801418,TDDE 131,B00,189314,Staff,19,0,20,1
1683729801418,TDDE 131,C00,189315,Staff,48,0,50,2
1683729801418,TDDE 131,D00,189316,Staff,14,0,15,1
1683729801418,TDDE 131,E00,204841,Staff,20,0,20,0
1683729802444,TDGE 10,A00,189289,Staff,26,0,50,24
1683729802444,TDGE 10,B00,189290,Havis; Allan,0,1,50,50
1683729803470,TDGE 11,A00,189291,Fulton; Julia,0,4,50,50
1683729803470,TDGE 11,B00,189292,Staff,20,0,25,5
1683729803470,TDGE 11,C00,260270,Staff,0,0,0,0
1683729804493,TDGE 25,A00,189294,Staff,1,0,20,19
1683729805518,TDGE 124,A00,189318,Fulton; Julia,0,7,50,50
1683729806544,TDGE 125,A00,189319,Staff,13,0,25,12
1683729806544,TDGE 125,B00,189320,Staff,23,0,25,2
1683729807567,TDGE 127,A00,189322,Havis; Allan,1,0,50,49
1683729808595,TDHT 101,A00,189323,Staff,18,0,25,7
1683729808595,TDHT 101,B00,189324,Staff,25,0,25,0
1683729809619,TDHT 102,A00,189325,Staff,49,0,50,1
1683729810644,TDMV 1,A00,189295,Arcidiacono; Kristin,20,0,30,10
1683729810644,TDMV 1,B00,189296,Caligagan; Maria T.,23,0,30,7
1683729811668,TDMV 2,A00,189297,Sammartano; Tonnie,27,0,30,3
1683729811668,TDMV 2,B00,189299,Arcidiacono; Kristin,23,0,30,7
1683729812693,TDMV 3,A00,204998,Rincon; Alicia,22,0,30,8
1683729813721,TDMV 120,A00,189458,Sammartano; Tonnie,28,0,30,2
1683729814756,TDMV 138,A00,189541,Jun; Grace Shin Hae,20,0,40,20
1683729815845,TDMV 142,A00,189717,Caligagan; Tony,25,0,30,5
1683729815845,TDMV 142,B00,189718,Caligagan; Maria T.,25,0,30,5
1683729816870,TMC 2,A01,187533,Staff,25,0,25,0
1683729816870,TMC 2,A02,187534,Staff,25,0,25,0
1683729817893,USP 1,A01,187536,Kwak; Nancy,0,16,25,25
1683729818918,USP 5,A01,187538,Staff,8,0,25,17
1683729819946,USP 101,A00,199253,Staff,0,4,0,0
1683729820969,USP 124,A00,187562,Boomhower; Matthew Charles,0,0,30,30
1683729821995,USP 138,A00,187582,Staff,19,0,25,6
1683729823021,USP 152,A01,187597,Staff,3,0,25,22
1683729824050,USP 153,A00,187598,Staff,18,0,25,7
1683729825075,USP 168,A00,187607,Kwak; Nancy,2,0,5,3
1683729826100,USP 173,A00,187619,Staff,4,0,25,21
1683729827126,USP 181,A00,187638,Staff,0,4,25,25
1683729828150,VIS 103,A00,187650,Cruz; Edwin Teddy,17,0,75,58
1683729829176,VIS 110D,A00,187669,Staff,13,0,22,9
1683729830205,VIS 127C,A00,187720,Shen; Kuiyi,67,0,146,79
1683729831231,VIS 149,A00,187731,Yoldas; Pinar,0,12,22,22
1683729832254,VIS 151,A01,188091,Staff,22,0,34,12
1683729832254,VIS 151,A02,188092,Staff,11,0,34,23
1683729833278,VIS 160B,A00,188093,Stalbaum; Brett,0,1,10,10
1683729835332,WCWP 10B,A00,201720,Staff,0,0,5,5
1683729835332,WCWP 10B,B00,201722,Staff,0,0,6,6
1683729836358,WCWP 100,A00,201725,Gagnon; Jeffrey C,0,0,2,2
1683729836358,WCWP 100,B00,201727,Staff,0,4,15,15
1683729839467,ANBI 133,A00,258401,Wilder; Linnea Lorene,34,0,40,6
1683729840495,ANBI 140,A00,258395,Hrvoj Mihic; Branka,18,0,25,7
1683729841523,ANSC 120,A00,258402,Bialecki; Jon Anthony,26,0,40,14
1683729842548,ANSC 144,A00,258400,Staff,12,0,40,28
1683729844599,ANSC 166,A00,258396,Parish; Steven Martin,156,0,175,19
1683729845630,ANSC 180,A00,193533,Staff,8,0,20,12
1683729846658,ANSC 188,A00,258397,Jassal; Aftab,34,0,40,6
1683729847684,ANTH 3,A01,258316,Staff,23,0,30,7
1683729848715,ANTH 5,A00,258394,Semendeferi; Ekaterini,16,0,20,4
1683729849745,ANTH 21,A01,258331,Staff,4,0,40,36
1683729850770,ANTH 103,A00,258398,Varma; Saiba,15,0,25,10
1683729851805,AWP 10,001,202034,Staff,0,0,0,0
1683729851805,AWP 10,002,202035,Staff,0,0,0,0
1683729851805,AWP 10,003,202036,Staff,0,0,0,0
1683729851805,AWP 10,004,202037,Staff,0,0,0,0
1683729851805,AWP 10,005,202038,Staff,0,0,0,0
1683729851805,AWP 10,006,202039,Staff,0,0,0,0
1683729851805,AWP 10,007,202040,Staff,0,0,0,0
1683729851805,AWP 10,008,202041,Staff,0,0,0,0
1683729851805,AWP 10,009,202042,Staff,0,0,0,0
1683729851805,AWP 10,010,202043,Staff,0,0,0,0
1683729851805,AWP 10,011,202044,Staff,0,0,0,0
1683729851805,AWP 10,012,202045,Staff,0,0,0,0
1683729851805,AWP 10,013,202046,Staff,0,0,0,0
1683729851805,AWP 10,014,202047,Staff,0,0,0,0
1683729851805,AWP 10,015,202048,Staff,0,0,0,0
1683729851805,AWP 10,016,202049,Staff,0,0,0,0
1683729851805,AWP 10,017,202050,Staff,0,0,0,0
1683729851805,AWP 10,018,202051,Staff,0,0,0,0
1683729851805,AWP 10,019,202052,Staff,0,0,0,0
1683729851805,AWP 10,020,202053,Staff,0,0,0,0
1683729851805,AWP 10,021,202054,Staff,0,0,0,0
1683729851805,AWP 10,022,202055,Staff,0,0,0,0
1683729851805,AWP 10,023,202056,Staff,0,0,0,0
1683729851805,AWP 10,024,202057,Staff,0,0,0,0
1683729851805,AWP 10,025,202058,Staff,0,0,0,0
1683729851805,AWP 10,026,202059,Staff,0,0,0,0
1683729852828,AWP 102,001,202032,Staff,0,0,0,0
1683729852828,AWP 102,002,202033,Staff,0,0,0,0
1683729853860,BENG 100,A01,254234,Taylor Amos; Alyssa C,31,0,40,9
1683729854889,BENG 196,001,270013,Engler; Adam J.,9999,0,9999,0
1683729855916,BICD 100R,A01,202018,Smith; Laurie,0,7,32,32
1683729855916,BICD 100R,A02,202019,Smith; Laurie,0,3,32,32
1683729855916,BICD 100R,A03,202020,Smith; Laurie,0,1,32,32
1683729855916,BICD 100R,A04,202021,Smith; Laurie,6,0,32,26
1683729855916,BICD 100R,A05,202022,Smith; Laurie,10,0,32,22
1683729856940,BICD 136,A01,193242,Gustafson-Brown; Cindy,0,2,32,32
1683729856940,BICD 136,A02,193244,Gustafson-Brown; Cindy,13,0,32,19
1683729857972,BIEB 102,A01,193249,Butler; Shannon Rhey,0,0,32,32
1683729857972,BIEB 102,A02,193251,Butler; Shannon Rhey,0,0,32,32
1683729857972,BIEB 102,A03,193253,Butler; Shannon Rhey,0,0,32,32
1683729857972,BIEB 102,A04,193255,Butler; Shannon Rhey,13,0,32,19
1683729857972,BIEB 102,A05,193265,Butler; Shannon Rhey,25,0,32,7
1683729857972,BIEB 102,A06,193269,Butler; Shannon Rhey,12,0,32,20
1683729860028,BIEB 150,A01,193274,Staff,0,0,32,32
1683729860028,BIEB 150,A02,193285,Staff,24,0,32,8
1683729861053,BIEB 194,A00,193286,Kurle; Carolyn M.,19,0,32,13
1683729862079,BILD 1,A01,192291,Staff,15,0,32,17
1683729862079,BILD 1,A02,192292,Staff,30,0,32,2
1683729862079,BILD 1,B01,192520,Reuther; Keefe,0,1,0,0
1683729862079,BILD 1,B02,192532,Reuther; Keefe,0,1,0,0
1683729863120,BILD 3,A01,192556,Butler; Shannon Rhey,0,0,32,32
1683729863120,BILD 3,A02,192581,Butler; Shannon Rhey,0,1,32,32
1683729863120,BILD 3,A03,192611,Butler; Shannon Rhey,19,0,32,13
1683729863120,BILD 3,A04,192612,Butler; Shannon Rhey,23,0,32,9
1683729863120,BILD 3,A05,192613,Butler; Shannon Rhey,26,0,32,6
1683729863120,BILD 3,A06,192679,Butler; Shannon Rhey,27,0,32,5
1683729863120,BILD 3,A07,192682,Butler; Shannon Rhey,20,0,32,12
1683729864147,BILD 4,A01,192836,Reuther; Keefe,1,0,24,23
1683729864147,BILD 4,A02,193044,Reuther; Keefe,4,0,24,20
1683729865174,BILD 10,A01,193142,Gustafson-Brown; Cindy,29,0,32,3
1683729865174,BILD 10,A02,193149,Gustafson-Brown; Cindy,31,0,32,1
1683729866199,BIMM 100,A01,193301,Staff,0,6,32,32
1683729866199,BIMM 100,A02,193312,Staff,0,7,32,32
1683729866199,BIMM 100,A03,193323,Staff,0,10,32,32
1683729867226,BIMM 101,A01,193329,McDonnell; Lisa Marie,0,3,24,24
1683729867226,BIMM 101,A02,193339,McDonnell; Lisa Marie,0,3,24,24
1683729867226,BIMM 101,B01,193354,McDonnell; Lisa Marie,0,4,24,24
1683729867226,BIMM 101,B02,193357,McDonnell; Lisa Marie,0,3,24,24
1683729868250,BIMM 110,A01,193377,Tat; John,0,11,32,32
1683729868250,BIMM 110,A02,193378,Tat; John,0,11,32,32
1683729869280,BIMM 120,A01,206116,Staff,0,0,32,32
1683729869280,BIMM 120,A02,206117,Staff,7,0,32,25
1683729869280,BIMM 120,A03,206121,Staff,21,0,32,11
1683729870305,BIPN 100,A01,193393,Park; Ji Young,0,15,32,32
1683729870305,BIPN 100,A02,193402,Park; Ji Young,0,14,32,32
1683729870305,BIPN 100,A03,193413,Park; Ji Young,0,14,32,32
1683729870305,BIPN 100,A04,193414,Park; Ji Young,0,13,32,32
1683729871330,BIPN 102,A01,193429,Staff,0,0,32,32
1683729871330,BIPN 102,A02,193438,Staff,18,0,32,14
1683729872356,BIPN 106,A01,193450,Reyes Gonzalez; Catalina,0,2,40,40
1683729873382,BIPN 134,A01,193465,Cooke; James Edward,0,0,32,32
1683729873382,BIPN 134,A02,193474,Cooke; James Edward,25,0,32,7
1683729873382,BIPN 134,A03,193485,Cooke; James Edward,29,0,32,3
1683729873382,BIPN 134,A04,193486,Cooke; James Edward,20,0,32,12
1683729873382,BIPN 134,A05,193491,Cooke; James Edward,31,0,32,1
1683729873382,BIPN 134,A06,193501,Cooke; James Edward,30,0,32,2
1683729873382,BIPN 134,A07,193510,Cooke; James Edward,29,0,32,3
1683729875430,BISP 194,A00,222522,Staff,14,0,32,18
1683729876457,CAT 124,A01,202407,Staff,19,0,25,6
1683729877485,CAT 125,A00,202408,Marchisotto; Jennifer Anne,2,0,20,18
1683729878512,CAT 125R,A00,202409,Smith; Lauryn Alissa,0,11,20,20
1683729878512,CAT 125R,B00,202410,Morales; Celeste Georgianna,0,11,20,20
1683729878512,CAT 125R,C00,202411,Irwin; Matthew Joseph,0,12,20,20
1683729879543,CENG 15,A01,204712,Yang; Kesong,0,1,0,0
1683729880567,CENG 114,A00,202070,Jahed Motlagh; Zeinab,5,0,20,15
1683729881595,CGS 105,A00,185477,Wesling; Megan E.,24,0,40,16
1683729882622,CGS 106,A00,185494,Staff,11,0,22,11
1683729883647,CGS 108,A00,185495,Staff,14,0,20,6
1683729884671,CGS 114,A00,185496,Staff,13,0,18,5
1683729885696,CGS 119,A00,185501,Staff,15,0,20,5
1683729886736,CGS 120,A00,185511,Staff,11,0,20,9
1683729887763,CHEM 4,A01,184675,Bussey; Thomas J,97,0,100,3
1683729888793,CHEM 6A,A01,184677,Staff,32,0,60,28
1683729889819,CHEM 6B,A01,184679,Staff,63,0,100,37
1683729890848,CHEM 6C,A01,184681,Bussey; Thomas J,0,0,50,50
1683729890848,CHEM 6C,A02,184682,Bussey; Thomas J,32,0,50,18
1683729891874,CHEM 40A,A01,184684,Albizati; Kim F.,33,0,100,67
1683729892898,CHEM 40B,A01,184686,Albizati; Kim F.,0,22,100,100
1683729893923,CHEM 41B,A01,184690,Staff,51,0,100,49
1683729894951,COGS 3,A01,184715,Boyle; Mary E. T.,0,27,40,40
1683729895976,COGS 14B,A01,185172,Staff,0,14,38,38
1683729897004,COGS 18,A01,184736,Staff,14,0,80,66
1683729898031,COGS 100,A01,184932,Staff,0,8,73,73
1683729899056,COGS 101A,A01,184935,Staff,0,40,30,30
1683729900079,COGS 101B,A01,184944,Staff,0,2,30,30
1683729901107,COGS 101C,A01,184946,Staff,0,10,30,30
1683729902134,COGS 102A,A01,184951,Johnson; Christine M.,1,0,40,39
1683729903166,COGS 107B,A01,184953,Mooshagian; Eric Frederick,0,52,40,40
1683729904192,COGS 118B,A01,184959,Gupta; Anjum,0,50,40,40
1683729905215,COGS 153,A00,184961,Staff,1,16,30,29
1683729906239,COGS 177,A00,184962,Staff,0,20,30,30
1683729907266,COGS 187A,A01,184969,Boyle; Mary E. T.,0,19,40,40
1683729908295,COMM 10,A01,185174,Staff,0,5,25,25
1683729908295,COMM 10,A02,185189,Staff,0,2,25,25
1683729908295,COMM 10,A03,269821,Staff,0,1,0,0
1683729909320,COMM 100B,A02,185476,Staff,10,0,25,15
1683729909320,COMM 100B,A03,277340,Staff,25,0,25,0
1683729910349,COMM 100C,A01,185314,Staff,2,0,25,23
1683729910349,COMM 100C,A02,185327,Staff,17,0,25,8
1683729911374,COMM 110M,A00,185349,Staff,0,0,40,40
1683729912398,COMM 113T,A00,185352,Staff,25,0,40,15
1683729913425,COMM 114I,A00,185353,Staff,31,0,40,9
1683729914450,COMM 131,A00,185354,Staff,17,0,30,13
1683729915474,CSE 8A,A50,185358,Cao; Yingjun,0,46,10,10
1683729916498,CSE 8B,A01,185362,Staff,0,48,50,50
1683729917525,CSE 11,A01,185416,Cao; Yingjun,0,91,10,10
1683729918549,CSE 20,A01,185445,Briones; Jor-el Thomas Caparas,3,0,25,22
1683729919627,CSE 21,A01,185447,Staff,9,0,50,41
1683729920652,CSE 101,A01,185451,Staff,0,13,50,50
1683729920652,CSE 101,B01,185453,Jones; Miles E,0,15,50,50
1683729922701,CSE 141,A01,185458,Eldon; John,16,0,100,84
1683729923728,CSE 141L,A01,185461,Eldon; John,8,0,100,92
1683729924755,CSE 142,A01,185463,Staff,34,0,60,26
1683729924755,CSE 142,B01,201355,Staff,0,7,60,60
1683729925778,CSE 142L,A01,185470,Staff,34,0,60,26
1683729925778,CSE 142L,B01,201417,Staff,0,6,60,60
1683729926805,CSE 190,A00,201433,Staff,32,0,49,17
1683729927836,DOC 1,A01,259136,Strom; Megan C.,7,0,15,8
1683729927836,DOC 1,A02,259137,Strom; Megan C.,15,0,15,0
1683729927836,DOC 1,A03,259138,Strom; Megan C.,14,0,15,1
1683729927836,DOC 1,A04,259139,Strom; Megan C.,13,0,15,2
1683729928862,DOC 100D,A00,259140,Pass; Natalye Joann,14,0,25,11
1683729929887,DSGN 1,A01,184749,Rill; Bryan,0,26,30,30
1683729930946,DSGN 100,A01,185168,Staff,0,2,25,25
1683729931975,ECE 5,A01,185626,Morris; Karcher William,0,12,0,0
1683729933001,ECE 101,A01,185628,Staff,14,0,70,56
1683729934026,ECE 107,A01,185635,Baghdadchi; Saharnaz,0,0,20,20
1683729934026,ECE 107,A02,185638,Baghdadchi; Saharnaz,1,0,20,19
1683729935051,ECE 148,A01,185647,Silberman; Jack,0,0,16,16
1683729936076,ECON 1,A01,185537,Crane; Meredith Helen,54,0,70,16
1683729937102,ECON 3,A01,185549,Crane; Meredith Helen,30,0,70,40
1683729938130,ECON 4,A01,203354,Anderson; John Charles,0,5,10,10
1683729939171,ECON 100A,A01,185574,Staff,0,5,40,40
1683729940195,ECON 100B,A01,185576,Staff,0,12,50,50
1683729941220,ECON 100C,A01,185589,Newhouse; Herbert S,30,0,70,40
1683729942244,ECON 105,A00,185608,Vespa; Emanuel Ignacio,19,0,35,16
1683729943269,ECON 109,A01,185610,Shishkin; Denis,9,0,35,26
1683729944292,ECON 110A,A01,185612,Staff,8,0,40,32
1683729945317,ECON 120A,A01,185615,Staff,19,0,40,21
1683729946342,ECON 120C,A01,185617,Sun; Yixiao,0,21,70,70
1683729947367,ECON 144,A00,203346,Squires; Dale E,2,0,35,33
1683729948393,ECON 171,A01,203349,Newhouse; Herbert S,0,1,35,35
1683729949422,ECON 173A,A01,185621,Toda; Alexis Akira,21,0,35,14
1683729950446,EDS 25,A01,202413,Staff,0,1,0,0
1683729950446,EDS 25,A02,202414,Staff,0,1,0,0
1683729950446,EDS 25,A03,202415,Staff,0,0,0,0
1683729950446,EDS 25,A04,202416,Staff,0,1,0,0
1683729950446,EDS 25,A05,202439,Staff,0,0,0,0
1683729950446,EDS 25,A06,202440,Staff,0,0,0,0
1683729950446,EDS 25,B01,202631,Staff,0,0,0,0
1683729950446,EDS 25,B02,202632,Staff,0,0,0,0
1683729950446,EDS 25,B03,202639,Staff,0,0,0,0
1683729950446,EDS 25,B04,202640,Staff,0,0,0,0
1683729950446,EDS 25,B05,202643,Staff,0,0,0,0
1683729950446,EDS 25,B06,202644,Staff,0,0,0,0
1683729951471,EDS 38,A01,202659,Black; Alison Michelle,25,0,25,0
1683729952495,EDS 115,A00,202652,Staff,18,0,30,12
1683729953522,EDS 125,A00,202649,Staff,13,0,30,17
1683729954555,EDS 126,A01,203332,Staff,30,0,30,0
1683729955579,EDS 139,A00,202838,Staff,16,0,25,9
1683729956602,EDS 146,A01,202655,Staff,14,0,25,11
1683729957631,ENG 15,A00,185667,Staff,0,1,0,0
1683729957631,ENG 15,B00,185672,Staff,0,0,0,0
1683729957631,ENG 15,C00,185675,Staff,0,0,0,0
1683729957631,ENG 15,D00,185682,Staff,0,0,0,0
1683729957631,ENG 15,E00,185684,Staff,0,0,0,0
1683729958656,ETHN 103,A00,185710,Staff,0,8,35,35
1683729959684,ETHN 103A,A00,199228,Man; Simeon S,0,0,9,9
1683729960708,ETHN 109,A00,185711,Staff,15,0,35,20
1683729961736,ETHN 142,A00,185726,Staff,0,4,30,30
1683729962772,ETHN 163J,A00,199229,Man; Simeon S,5,0,8,3
1683729963798,ETHN 168,A00,185727,Staff,7,0,10,3
1683729964826,ETHN 182,A00,185728,Staff,0,0,35,35
1683729965849,ETHN 183,A00,185737,Staff,10,0,18,8
1683729966874,GLBH 111,A01,209361,Burgos; Jose L.,0,0,0,0
1683729968928,HIEU 104,A00,185792,Staff,14,0,20,6
1683729969958,HIEU 115,A00,185800,Staff,0,0,20,20
1683729970983,HIEU 128,A00,185801,Staff,0,9,20,20
1683729972012,HIEU 147,A00,185802,Staff,15,0,20,5
1683729973041,HIEU 154,A00,185823,Staff,11,0,20,9
1683729974071,HILA 102,A00,185826,Staff,14,0,20,6
1683729975098,HILD 2C,A01,185778,Staff,0,13,20,20
1683729976126,HILD 7B,A01,185780,Kwak; Nancy,0,17,32,32
1683729976126,HILD 7B,A02,185781,Kwak; Nancy,0,18,32,32
1683729977151,HILD 30,A01,185791,Staff,12,0,20,8
1683729978178,HISC 119,A00,185830,Golan; Tal,0,10,20,20
1683729979209,HITO 156GS,A00,185831,Patterson; Patrick H.,0,0,0,23
1683729980231,HIUS 103,A00,185832,Man; Simeon S,0,4,20,20
1683729981258,HIUS 117,A00,185836,Kwak; Nancy,2,0,20,18
1683729982285,HIUS 125,A00,185840,Man; Simeon S,0,2,23,23
1683729983328,HIUS 149,A00,185845,Staff,1,0,20,19
1683729984358,HUM 3,A01,185882,Zavodny; Tatiana Sophia,0,8,50,50
1683729984358,HUM 3,B01,185899,Caldwell; Michael Alan,0,18,50,50
1683729985382,HUM 3GS,A00,185900,Patterson; Patrick H.,0,0,0,23
1683729986409,HUM 4,A01,185938,Zroka; Amy Liane,28,0,50,22
1683729986409,HUM 4,B01,185956,Watkins; Eric,0,6,50,50
1683729986409,HUM 4,B02,202209,Watkins; Eric,0,6,50,50
1683729986409,HUM 4,B03,202210,Watkins; Eric,0,5,50,50
1683729987434,HUM 5,A01,185958,West; Geoffrey Scott,0,0,50,50
1683729987434,HUM 5,A02,202215,West; Geoffrey Scott,0,1,50,50
1683729988459,INTL 190,A00,185959,Gagnon; Jeffrey C,0,0,0,9
1683729988459,INTL 190,B00,185960,Lettieri; Michael Joseph,0,0,0,2
1683729989487,JAPN 180,A00,254509,Staff,4,0,30,26
1683729990516,LATI 10,A01,202853,Kennemore; Amy Michelle,4,0,35,31
1683729990516,LATI 10,A02,202854,Kennemore; Amy Michelle,3,0,35,32
1683729990516,LATI 10,A03,270054,Kennemore; Amy Michelle,30,0,30,0
1683729991542,LATI 180,A00,202855,Kennemore; Amy Michelle,11,0,20,9
1683729992571,LAWS 101,A00,201767,Golan; Tal,0,7,40,40
1683729993598,LIFR 1C,A00,185961,Staff,6,0,20,14
1683729994626,LIFR 1CX,A00,185962,Staff,7,0,20,13
1683729995649,LIFR 1D,A00,185963,Staff,7,0,20,13
1683729996673,LIFR 1DX,A00,185964,Staff,7,0,20,13
1683729997700,LIGN 101,A01,186039,Staff,43,0,50,7
1683729998735,LIGN 165,A00,186040,Staff,14,0,50,36
1683729999759,LTCS 108,A00,186041,Staff,5,0,10,5
1683730000783,LTCS 119,A00,186042,Staff,15,0,20,5
1683730001811,LTCS 130,A00,186043,Wesling; Megan E.,15,0,25,10
1683730003860,LTEA 138,A00,186119,Staff,13,0,40,27
1683730004890,LTEN 124,A00,186148,Staff,5,0,25,20
1683730005917,LTEN 178,A00,186149,Staff,6,0,15,9
1683730006942,LTEN 181,A00,186150,Blanco; John D,34,0,40,6
1683730007966,LTWL 120,A00,186160,Staff,19,0,25,6
1683730008990,LTWL 165,A00,186161,Staff,22,0,25,3
1683730010014,LTWR 100,A00,186162,Staff,0,5,15,15
1683730011040,LTWR 102,A00,186163,Doller; Ben,5,0,15,10
1683730012064,MAE 8,A01,186412,Staff,0,1,0,0
1683730013093,MAE 30B,A00,186445,Bahadori; Mohammad Yousef,81,0,100,19
1683730014120,MAE 40,A00,186592,Bewley; Thomas R,10,0,50,40
1683730015146,MAE 101B,A00,186593,Bahadori; Mohammad Yousef,80,0,100,20
1683730016170,MAE 105,A00,186594,Bandaru; Prabhakar,10,0,50,40
1683730017205,MAE 107,A00,186599,Pham; Hieu Tan,0,8,120,120
1683730018232,MAE 148,A01,186660,Silberman; Jack,3,0,16,13
1683730019260,MATH 10A,A01,188095,Staff,0,6,35,35
1683730020291,MATH 10B,A01,188097,Bowers; Adam R.,0,12,30,30
1683730020291,MATH 10B,A02,188099,Bowers; Adam R.,0,11,30,30
1683730020291,MATH 10B,B01,188104,Bowers; Adam R.,0,10,30,30
1683730020291,MATH 10B,B02,188106,Bowers; Adam R.,0,9,30,30
1683730021316,MATH 10C,A01,188111,Staff,0,20,30,30
1683730021316,MATH 10C,A02,188127,Staff,0,19,30,30
1683730021316,MATH 10C,A03,188131,Staff,0,19,30,30
1683730021316,MATH 10C,B01,188218,Staff,17,0,30,13
1683730021316,MATH 10C,B02,188244,Staff,13,0,30,17
1683730021316,MATH 10C,B03,188277,Staff,14,0,30,16
1683730022346,MATH 18,A01,188344,Bach; Quang Tran,18,0,30,12
1683730022346,MATH 18,A02,188345,Bach; Quang Tran,11,0,30,19
1683730022346,MATH 18,B01,188353,Bach; Quang Tran,11,0,30,19
1683730022346,MATH 18,B02,188354,Bach; Quang Tran,19,0,30,11
1683730023431,MATH 20A,A01,188374,Staff,10,0,35,25
1683730024461,MATH 20B,A01,188382,Ohm; Ko Woon,7,0,30,23
1683730024461,MATH 20B,A02,188383,Ohm; Ko Woon,22,0,30,8
1683730024461,MATH 20B,B01,188385,Ohm; Ko Woon,7,0,30,23
1683730024461,MATH 20B,B02,188392,Ohm; Ko Woon,22,0,30,8
1683730025486,MATH 20C,A01,188394,Harel; Guershon,10,0,30,20
1683730025486,MATH 20C,A02,188395,Harel; Guershon,13,0,30,17
1683730025486,MATH 20C,B01,188404,Harel; Guershon,5,0,30,25
1683730025486,MATH 20C,B02,188405,Harel; Guershon,18,0,30,12
1683730026515,MATH 20D,A01,188414,Hammock; Frances H,0,1,30,30
1683730026515,MATH 20D,A02,188415,Hammock; Frances H,0,1,30,30
1683730026515,MATH 20D,B01,188447,Hammock; Frances H,0,1,30,30
1683730026515,MATH 20D,B02,188486,Hammock; Frances H,2,0,30,28
1683730027540,MATH 20E,A01,188649,Staff,21,0,30,9
1683730027540,MATH 20E,A02,188650,Staff,20,0,30,10
1683730027540,MATH 20E,A03,188673,Staff,0,0,30,30
1683730028562,MATH 102,A01,188675,Staff,0,40,35,35
1683730029591,MATH 103B,A01,188681,Staff,3,0,35,32
1683730029591,MATH 103B,B01,188692,Staff,5,0,35,30
1683730030624,MATH 109,A01,188695,Salehi Golsefidy; Alireza,24,0,35,11
1683730030624,MATH 109,A02,188696,Salehi Golsefidy; Alireza,24,0,35,11
1683730031652,MATH 120A,A01,188698,Eggers; John Dietrich,7,0,35,28
1683730032678,MATH 142B,A01,188736,Ioana; Adrian,0,0,30,30
1683730032678,MATH 142B,A02,188741,Ioana; Adrian,0,1,30,30
1683730032678,MATH 142B,A03,188743,Ioana; Adrian,0,3,30,30
1683730033705,MATH 168A,A01,188790,Staff,0,11,35,35
1683730034733,MATH 170A,A01,188803,Nie; Jiawang,0,2,35,35
1683730034733,MATH 170A,A02,188811,Nie; Jiawang,0,1,35,35
1683730034733,MATH 170A,A03,188814,Nie; Jiawang,1,0,35,34
1683730034733,MATH 170A,A04,188815,Nie; Jiawang,5,0,35,30
1683730035765,MATH 193B,A01,188817,Staff,0,0,35,35
1683730035765,MATH 193B,A02,188818,Staff,6,0,35,29
1683730036794,MGT 4,A01,202857,Anderson; John Charles,59,0,80,21
1683730037845,MGT 12,A00,202858,Lindenberger; Wade Douglas,40,0,90,50
1683730038871,MGT 18,A00,202859,Staff,73,0,90,17
1683730039897,MGT 18GS,A00,202860,McKay; Michael J,13,0,28,15
1683730040926,MGT 45,A00,202861,Pecore; Joseph P.,8,0,90,82
1683730041953,MGT 100,A00,202863,Yavorsky; Daniel Ryan,27,0,90,63
1683730042978,MGT 103,A00,202864,Ehrich; Kristine R,0,19,90,90
1683730044005,MGT 112,A00,202865,Ehrich; Kristine R,15,0,90,75
1683730045035,MGT 121A,A00,202868,Staff,70,0,90,20
1683730046059,MGT 131B,A00,202869,Anderson; John Charles,58,0,90,32
1683730047084,MGT 136,A00,202871,Lindenberger; Wade Douglas,83,0,90,7
1683730048110,MGT 164,A00,202873,Staff,0,67,90,91
1683730049140,MGT 164GS,A00,202874,McKay; Mary A,13,0,28,15
1683730050179,MGT 180,A00,202875,Staff,0,51,90,91
1683730051211,MMW 11R,A01,205019,Herbst; Matthew,0,0,30,30
1683730051211,MMW 11R,A02,205026,Herbst; Matthew,29,0,30,1
1683730052241,MMW 15,A01,193512,Chang; Edmond Yi-Teh,0,8,28,28
1683730052241,MMW 15,A02,193513,Chang; Edmond Yi-Teh,0,5,28,28
1683730052241,MMW 15,A03,193514,Chang; Edmond Yi-Teh,0,5,28,28
1683730052241,MMW 15,A04,193515,Chang; Edmond Yi-Teh,0,5,28,28
1683730052241,MMW 15,A05,193516,Chang; Edmond Yi-Teh,0,5,28,28
1683730052241,MMW 15,A06,193517,Chang; Edmond Yi-Teh,0,6,28,28
1683730052241,MMW 15,B01,193519,Chang; Edmond Yi-Teh,0,5,28,28
1683730052241,MMW 15,B02,193520,Chang; Edmond Yi-Teh,0,5,28,28
1683730052241,MMW 15,B03,193521,Chang; Edmond Yi-Teh,0,5,28,28
1683730052241,MMW 15,B04,193522,Chang; Edmond Yi-Teh,0,6,28,28
1683730052241,MMW 15,B05,193523,Chang; Edmond Yi-Teh,0,5,28,28
1683730052241,MMW 15,B06,193524,Chang; Edmond Yi-Teh,0,5,28,28
1683730053270,MMW 122,A01,193526,Rahimi; Babak,0,16,28,28
1683730053270,MMW 122,A02,193527,Rahimi; Babak,0,15,28,28
1683730053270,MMW 122,A03,193528,Rahimi; Babak,0,0,0,0
1683730053270,MMW 122,A04,193529,Rahimi; Babak,0,0,0,0
1683730054295,MUS 1A,A01,186663,Staff,0,18,35,35
1683730055333,MUS 4,A01,186715,Staff,0,12,35,35
1683730056358,MUS 5R,A01,186796,Dubnov; Shlomo,0,17,35,35
1683730057386,MUS 6,A01,186798,Staff,0,4,25,25
1683730058412,MUS 7,A01,186830,Staff,11,0,35,24
1683730059441,MUS 8,A01,186930,Staff,0,27,35,35
1683730060467,MUS 15,A01,186932,Staff,0,15,35,35
1683730060467,MUS 15,B01,186934,Staff,0,16,35,35
1683730061492,MUS 80,A00,186935,Staff,0,0,20,20
1683730061492,MUS 80,B00,186936,Staff,24,0,25,1
1683730062517,NANO 11,A00,204702,Lipomi; Darren John,0,0,0,0
1683730063547,NANO 15,A01,204709,Yang; Kesong,0,1,0,0
1683730064577,NANO 114,A00,202069,Jahed Motlagh; Zeinab,2,0,10,8
1683730065604,PHIL 1,A00,186955,Grush; Rick Scott,31,0,40,9
1683730066633,PHIL 10,A01,186973,Grush; Rick Scott,27,0,35,8
1683730066633,PHIL 10,A02,186974,Grush; Rick Scott,33,0,35,2
1683730067665,PHIL 13,A01,186976,Staff,1,0,35,34
1683730067665,PHIL 13,A02,186977,Staff,16,0,35,19
1683730068691,PHIL 14,A01,186979,Staff,30,0,35,5
1683730068691,PHIL 14,A02,186986,Staff,32,0,35,3
1683730069716,PHIL 28,A01,186988,Staff,16,0,30,14
1683730069716,PHIL 28,A02,186989,Staff,0,0,30,30
1683730069716,PHIL 28,A03,186990,Staff,10,0,30,20
1683730069716,PHIL 28,A04,186991,Staff,26,0,30,4
1683730070743,PHIL 120,A00,186997,Staff,23,0,40,17
1683730071769,PHIL 137,A00,187003,Staff,8,0,40,32
1683730072793,PHIL 150,A00,187015,Staff,47,0,70,23
1683730073818,PHIL 167,A00,187021,Lamey; Andy M.,34,0,40,6
1683730074847,PHIL 174,A01,202226,Staff,17,0,20,3
1683730074847,PHIL 174,A02,202235,Staff,20,0,20,0
1683730075874,PHIL 191A,A00,258918,Staff,0,0,1,1
1683730076902,PHYS 1A,A00,187028,Staff,26,0,60,34
1683730077933,PHYS 1AL,001,187036,Staff,3,0,30,27
1683730077933,PHYS 1AL,002,187049,Staff,18,0,30,12
1683730078964,PHYS 1B,A00,187058,Staff,21,0,60,39
1683730079992,PHYS 1BL,001,187064,Staff,0,1,30,30
1683730079992,PHYS 1BL,002,187070,Staff,4,0,30,26
1683730081019,PHYS 1C,A00,187082,Staff,30,0,120,90
1683730082048,PHYS 1CL,001,187088,Staff,0,9,30,30
1683730082048,PHYS 1CL,002,187089,Staff,0,1,30,30
1683730082048,PHYS 1CL,009,262693,Staff,9,0,30,21
1683730083074,PHYS 2B,A01,187097,Staff,55,0,115,60
1683730084098,PHYS 2C,A01,187099,Staff,63,0,115,52
1683730085142,PHYS 2CL,A01,187101,Staff,5,0,28,23
1683730085142,PHYS 2CL,A02,187102,Staff,15,0,28,13
1683730086168,PHYS 2D,A01,187123,Shotwell; Brian,95,0,115,20
1683730087196,PHYS 4B,A01,187133,Grinstein; Benjamin,35,0,50,15
1683730088234,POLI 10,A00,188819,Staff,0,4,50,50
1683730089259,POLI 11,A00,188827,Staff,43,0,50,7
1683730090282,POLI 13R,A00,188828,Staff,0,2,20,20
1683730091311,POLI 27,A01,188830,Elgin; Samuel Zincke,0,2,70,70
1683730092339,POLI 30,A00,188832,Desposato; Scott,30,0,50,20
1683730093364,POLI 102F,A00,188834,Staff,1,0,40,39
1683730094388,POLI 104A,A00,188852,Staff,12,0,30,18
1683730095416,POLI 104I,A00,188853,Staff,0,8,20,20
1683730096440,POLI 110B,A00,188854,Wiens; David,6,0,20,14
1683730097466,POLI 112A,A00,188855,Wiens; David,3,0,30,27
1683730098492,POLI 117R,A00,188856,Forman; Fonna,0,12,20,20
1683730099520,POLI 118,A00,188857,Ingham; Sean,8,0,20,12
1683730100546,POLI 120G,A00,188858,Staff,7,0,30,23
1683730101574,POLI 131CR,A00,188863,Hoston; Germaine,20,0,50,30
1683730102602,POLI 133,A00,188864,Nellis; Gareth Hb,44,0,50,6
1683730103630,POLI 134D,A00,188865,Desposato; Scott,27,0,30,3
1683730104654,POLI 142A,A00,188871,Gartzke; Erik,21,0,50,29
1683730105679,POLI 142K,A00,188874,Staff,38,0,50,12
1683730106706,POLI 143,A00,188940,Gartzke; Erik,15,0,30,15
1683730107734,POLI 153,A00,188943,Staff,1,0,20,19
1683730108761,POLI 160AA,A00,188944,Staff,10,0,40,30
1683730109784,POLI 170A,A00,188945,Staff,10,0,30,20
1683730111838,PSYC 1,A00,188952,Staff,36,0,90,54
1683730112863,PSYC 2,B00,188953,Staff,19,0,35,16
1683730113891,PSYC 6,A00,188970,Staff,47,0,60,13
1683730114918,PSYC 7,A00,188973,Staff,35,0,45,10
1683730115942,PSYC 60,A01,188980,Rickard; Timothy C.,42,0,60,18
1683730116966,PSYC 70,A01,189001,Steiner; Eric Tomas,21,0,45,24
1683730117991,PSYC 100,A00,189005,Lacefield; Katharine I,1,98,120,119
1683730119017,PSYC 102,A00,189008,Staff,6,0,30,24
1683730120044,PSYC 106,B00,189026,Gorman; Michael R.,27,0,60,33
1683730121071,PSYC 114,B01,189033,Winkielman; Piotr,0,31,30,30
1683730122096,PSYC 131,A00,189036,Anagnostaras; Stephan,0,44,60,60
1683730123128,PSYC 136,A00,189041,Lowe; Angela Beth,0,7,25,25
1683730124158,PSYC 137,A00,189057,Winkielman; Piotr,0,36,25,25
1683730125184,PSYC 144,A00,189107,Wixted; John T,0,11,50,50
1683730127294,PSYC 162,A00,189142,Staff,0,9,85,85
1683730128325,PSYC 172,A00,189144,Gorman; Michael R.,0,6,30,30
1683730130374,PSYC 179,A00,189146,Lacefield; Katharine I,0,88,120,120
1683730131399,PSYC 181,A00,189147,Anagnostaras; Stephan,0,45,90,90
1683730132427,PSYC 190R,A00,189148,Barner; David A.,0,23,80,80
1683730133449,PSYC 191,A00,189275,Rickard; Timothy C.,0,11,25,25
1683730134476,PSYC 193,A00,189276,Chapman; Eddie Nathaniel,0,1,0,4
1683730135501,PSYC 193L,A01,189281,Lowe; Angela Beth,8,0,20,12
1683730135501,PSYC 193L,B01,189285,Staff,28,0,35,7
1683730136526,RELI 149,A00,187137,Rahimi; Babak,6,0,40,34
1683730137551,SE 9,A01,187315,Staff,0,2,18,18
1683730138576,SE 101B,A00,187409,Staff,24,0,30,6
1683730139601,SE 110B,A00,187444,Staff,10,0,40,30
1683730140627,SE 130B,A00,187449,Staff,31,0,40,9
1683730141658,SE 150A,A00,187516,Staff,8,0,20,12
1683730142683,SE 154,A00,187528,Staff,29,0,50,21
1683730143714,SIO 3,A01,258171,Staff,35,0,40,5
1683730144743,SIO 10,A00,187144,Cook; Geoffrey W,0,6,75,75
1683730145768,SIO 45,A00,187152,Cook; Geoffrey W,1,7,100,99
1683730146794,SIO 109R,A00,194486,Staff,0,4,20,20
1683730148854,SIO 187,A01,187233,Kacev; David,12,0,40,28
1683730149883,SOCI 1,A01,258656,Thorpe; Charles Robert,28,0,30,2
1683730149883,SOCI 1,A02,258658,Thorpe; Charles Robert,30,0,30,0
1683730149883,SOCI 1,A03,258661,Thorpe; Charles Robert,25,0,25,0
1683730149883,SOCI 1,A04,258666,Thorpe; Charles Robert,22,0,25,3
1683730149883,SOCI 1,A05,258897,Thorpe; Charles Robert,22,0,25,3
1683730149883,SOCI 1,A06,258898,Thorpe; Charles Robert,25,0,25,0
1683730150913,SOCI 30,A01,258903,Pardo Guerra; Juan Pablo,14,0,30,16
1683730151941,SOCI 102,A00,258904,Staff,9,0,25,16
1683730152965,SOCI 106,A00,258905,Staff,19,0,25,6
1683730153991,SOCI 111,A00,258907,Ribas Norris; Janet Vanesa,26,0,30,4
1683730155019,SOCI 121R,A00,258908,Pardo Guerra; Juan Pablo,7,0,30,23
1683730156044,SOCI 126,A01,203330,Staff,14,0,20,6
1683730157068,SOCI 131,A00,258909,Thorpe; Charles Robert,30,0,60,30
1683730158098,SOCI 135,A00,258910,Payne; Christine Anna,0,13,30,30
1683730159125,SOCI 157,A00,258911,Staff,10,0,30,20
1683730160148,SOCI 184,A00,258912,Staff,25,0,30,5
1683730161175,SOCI 188D,A00,258913,Staff,22,0,30,8
1683730162201,SYN 2,001,187529,Staff,9,0,16,7
1683730162201,SYN 2,002,201452,Staff,0,20,16,16
1683730162201,SYN 2,003,201469,Staff,1,0,16,15
1683730163230,SYN 100,A01,187531,Staff,0,9,20,20
1683730163230,SYN 100,B01,201491,Staff,0,10,20,20
1683730164261,TDAC 1,A00,189286,Walsh; Kim C.,3,0,20,17
1683730164261,TDAC 1,B00,189287,Harting; Carla Kelso,10,0,20,10
1683730165288,TDAC 101,A00,189300,Walsh; Kim C.,16,0,20,4
1683730165288,TDAC 101,B00,189301,Harting; Carla Kelso,18,0,20,2
1683730166314,TDAC 102,A00,189304,Basso; Beatrice,14,0,20,6
1683730167340,TDAC 108,A00,189305,Staff,18,0,20,2
1683730168370,TDDE 131,A00,189310,Staff,19,0,20,1
1683730168370,TDDE 131,B00,189314,Staff,19,0,20,1
1683730168370,TDDE 131,C00,189315,Staff,48,0,50,2
1683730168370,TDDE 131,D00,189316,Staff,14,0,15,1
1683730168370,TDDE 131,E00,204841,Staff,20,0,20,0
1683730169397,TDGE 10,A00,189289,Staff,26,0,50,24
1683730169397,TDGE 10,B00,189290,Havis; Allan,0,1,50,50
1683730170422,TDGE 11,A00,189291,Fulton; Julia,0,4,50,50
1683730170422,TDGE 11,B00,189292,Staff,20,0,25,5
1683730170422,TDGE 11,C00,260270,Staff,0,0,0,0
1683730171449,TDGE 25,A00,189294,Staff,1,0,20,19
1683730172476,TDGE 124,A00,189318,Fulton; Julia,0,7,50,50
1683730173500,TDGE 125,A00,189319,Staff,13,0,25,12
1683730173500,TDGE 125,B00,189320,Staff,23,0,25,2
1683730174528,TDGE 127,A00,189322,Havis; Allan,1,0,50,49
1683730175553,TDHT 101,A00,189323,Staff,18,0,25,7
1683730175553,TDHT 101,B00,189324,Staff,25,0,25,0
1683730176576,TDHT 102,A00,189325,Staff,49,0,50,1
1683730177601,TDMV 1,A00,189295,Arcidiacono; Kristin,20,0,30,10
1683730177601,TDMV 1,B00,189296,Caligagan; Maria T.,23,0,30,7
1683730178630,TDMV 2,A00,189297,Sammartano; Tonnie,27,0,30,3
1683730178630,TDMV 2,B00,189299,Arcidiacono; Kristin,23,0,30,7
1683730179654,TDMV 3,A00,204998,Rincon; Alicia,22,0,30,8
1683730180676,TDMV 120,A00,189458,Sammartano; Tonnie,28,0,30,2
1683730181704,TDMV 138,A00,189541,Jun; Grace Shin Hae,20,0,40,20
1683730182732,TDMV 142,A00,189717,Caligagan; Tony,25,0,30,5
1683730182732,TDMV 142,B00,189718,Caligagan; Maria T.,25,0,30,5
1683730183757,TMC 2,A01,187533,Staff,25,0,25,0
1683730183757,TMC 2,A02,187534,Staff,25,0,25,0
1683730184786,USP 1,A01,187536,Kwak; Nancy,0,16,25,25
1683730185813,USP 5,A01,187538,Staff,8,0,25,17
1683730186838,USP 101,A00,199253,Staff,0,4,0,0
1683730187866,USP 124,A00,187562,Boomhower; Matthew Charles,0,0,30,30
1683730188894,USP 138,A00,187582,Staff,19,0,25,6
1683730189920,USP 152,A01,187597,Staff,3,0,25,22
1683730190946,USP 153,A00,187598,Staff,18,0,25,7
1683730191977,USP 168,A00,187607,Kwak; Nancy,2,0,5,3
1683730193006,USP 173,A00,187619,Staff,4,0,25,21
1683730194031,USP 181,A00,187638,Staff,0,4,25,25
1683730195055,VIS 103,A00,187650,Cruz; Edwin Teddy,17,0,75,58
1683730196080,VIS 110D,A00,187669,Staff,13,0,22,9
1683730197108,VIS 127C,A00,187720,Shen; Kuiyi,67,0,146,79
1683730198133,VIS 149,A00,187731,Yoldas; Pinar,0,12,22,22
1683730199159,VIS 151,A01,188091,Staff,22,0,34,12
1683730199159,VIS 151,A02,188092,Staff,11,0,34,23
1683730200188,VIS 160B,A00,188093,Stalbaum; Brett,0,1,10,10
1683730202237,WCWP 10B,A00,201720,Staff,0,0,5,5
1683730202237,WCWP 10B,B00,201722,Staff,0,0,6,6
1683730203265,WCWP 100,A00,201725,Gagnon; Jeffrey C,0,0,2,2
1683730203265,WCWP 100,B00,201727,Staff,0,4,15,15
1683730206402,ANBI 133,A00,258401,Wilder; Linnea Lorene,34,0,40,6
1683730207426,ANBI 140,A00,258395,Hrvoj Mihic; Branka,18,0,25,7
1683730208450,ANSC 120,A00,258402,Bialecki; Jon Anthony,26,0,40,14
1683730209473,ANSC 144,A00,258400,Staff,12,0,40,28
1683730211531,ANSC 166,A00,258396,Parish; Steven Martin,156,0,175,19
1683730212556,ANSC 180,A00,193533,Staff,8,0,20,12
1683730213581,ANSC 188,A00,258397,Jassal; Aftab,34,0,40,6
1683730214607,ANTH 3,A01,258316,Staff,23,0,30,7
1683730215632,ANTH 5,A00,258394,Semendeferi; Ekaterini,16,0,20,4
1683730216657,ANTH 21,A01,258331,Staff,4,0,40,36
1683730217686,ANTH 103,A00,258398,Varma; Saiba,15,0,25,10
1683730218714,AWP 10,001,202034,Staff,0,0,0,0
1683730218714,AWP 10,002,202035,Staff,0,0,0,0
1683730218714,AWP 10,003,202036,Staff,0,0,0,0
1683730218714,AWP 10,004,202037,Staff,0,0,0,0
1683730218714,AWP 10,005,202038,Staff,0,0,0,0
1683730218714,AWP 10,006,202039,Staff,0,0,0,0
1683730218714,AWP 10,007,202040,Staff,0,0,0,0
1683730218714,AWP 10,008,202041,Staff,0,0,0,0
1683730218714,AWP 10,009,202042,Staff,0,0,0,0
1683730218714,AWP 10,010,202043,Staff,0,0,0,0
1683730218714,AWP 10,011,202044,Staff,0,0,0,0
1683730218714,AWP 10,012,202045,Staff,0,0,0,0
1683730218714,AWP 10,013,202046,Staff,0,0,0,0
1683730218714,AWP 10,014,202047,Staff,0,0,0,0
1683730218714,AWP 10,015,202048,Staff,0,0,0,0
1683730218714,AWP 10,016,202049,Staff,0,0,0,0
1683730218714,AWP 10,017,202050,Staff,0,0,0,0
1683730218714,AWP 10,018,202051,Staff,0,0,0,0
1683730218714,AWP 10,019,202052,Staff,0,0,0,0
1683730218714,AWP 10,020,202053,Staff,0,0,0,0
1683730218714,AWP 10,021,202054,Staff,0,0,0,0
1683730218714,AWP 10,022,202055,Staff,0,0,0,0
1683730218714,AWP 10,023,202056,Staff,0,0,0,0
1683730218714,AWP 10,024,202057,Staff,0,0,0,0
1683730218714,AWP 10,025,202058,Staff,0,0,0,0
1683730218714,AWP 10,026,202059,Staff,0,0,0,0
1683730219740,AWP 102,001,202032,Staff,0,0,0,0
1683730219740,AWP 102,002,202033,Staff,0,0,0,0
1683730220765,BENG 100,A01,254234,Taylor Amos; Alyssa C,31,0,40,9
1683730221788,BENG 196,001,270013,Engler; Adam J.,9999,0,9999,0
1683730222815,BICD 100R,A01,202018,Smith; Laurie,0,7,32,32
1683730222815,BICD 100R,A02,202019,Smith; Laurie,0,3,32,32
1683730222815,BICD 100R,A03,202020,Smith; Laurie,0,1,32,32
1683730222815,BICD 100R,A04,202021,Smith; Laurie,6,0,32,26
1683730222815,BICD 100R,A05,202022,Smith; Laurie,10,0,32,22
1683730223843,BICD 136,A01,193242,Gustafson-Brown; Cindy,0,2,32,32
1683730223843,BICD 136,A02,193244,Gustafson-Brown; Cindy,13,0,32,19
1683730224873,BIEB 102,A01,193249,Butler; Shannon Rhey,0,0,32,32
1683730224873,BIEB 102,A02,193251,Butler; Shannon Rhey,0,0,32,32
1683730224873,BIEB 102,A03,193253,Butler; Shannon Rhey,0,0,32,32
1683730224873,BIEB 102,A04,193255,Butler; Shannon Rhey,13,0,32,19
1683730224873,BIEB 102,A05,193265,Butler; Shannon Rhey,25,0,32,7
1683730224873,BIEB 102,A06,193269,Butler; Shannon Rhey,12,0,32,20
1683730226922,BIEB 150,A01,193274,Staff,0,0,32,32
1683730226922,BIEB 150,A02,193285,Staff,24,0,32,8
1683730227948,BIEB 194,A00,193286,Kurle; Carolyn M.,19,0,32,13
1683730228974,BILD 1,A01,192291,Staff,15,0,32,17
1683730228974,BILD 1,A02,192292,Staff,30,0,32,2
1683730228974,BILD 1,B01,192520,Reuther; Keefe,0,1,0,0
1683730228974,BILD 1,B02,192532,Reuther; Keefe,0,1,0,0
1683730229999,BILD 3,A01,192556,Butler; Shannon Rhey,0,0,32,32
1683730229999,BILD 3,A02,192581,Butler; Shannon Rhey,0,1,32,32
1683730229999,BILD 3,A03,192611,Butler; Shannon Rhey,19,0,32,13
1683730229999,BILD 3,A04,192612,Butler; Shannon Rhey,23,0,32,9
1683730229999,BILD 3,A05,192613,Butler; Shannon Rhey,26,0,32,6
1683730229999,BILD 3,A06,192679,Butler; Shannon Rhey,27,0,32,5
1683730229999,BILD 3,A07,192682,Butler; Shannon Rhey,20,0,32,12
1683730231084,BILD 4,A01,192836,Reuther; Keefe,1,0,24,23
1683730231084,BILD 4,A02,193044,Reuther; Keefe,4,0,24,20
1683730232109,BILD 10,A01,193142,Gustafson-Brown; Cindy,29,0,32,3
1683730232109,BILD 10,A02,193149,Gustafson-Brown; Cindy,31,0,32,1
1683730233134,BIMM 100,A01,193301,Staff,0,6,32,32
1683730233134,BIMM 100,A02,193312,Staff,0,7,32,32
1683730233134,BIMM 100,A03,193323,Staff,0,10,32,32
1683730234163,BIMM 101,A01,193329,McDonnell; Lisa Marie,0,3,24,24
1683730234163,BIMM 101,A02,193339,McDonnell; Lisa Marie,0,3,24,24
1683730234163,BIMM 101,B01,193354,McDonnell; Lisa Marie,0,4,24,24
1683730234163,BIMM 101,B02,193357,McDonnell; Lisa Marie,0,3,24,24
1683730235188,BIMM 110,A01,193377,Tat; John,0,11,32,32
1683730235188,BIMM 110,A02,193378,Tat; John,0,11,32,32
1683730236213,BIMM 120,A01,206116,Staff,0,0,32,32
1683730236213,BIMM 120,A02,206117,Staff,7,0,32,25
1683730236213,BIMM 120,A03,206121,Staff,21,0,32,11
1683730237240,BIPN 100,A01,193393,Park; Ji Young,0,15,32,32
1683730237240,BIPN 100,A02,193402,Park; Ji Young,0,14,32,32
1683730237240,BIPN 100,A03,193413,Park; Ji Young,0,14,32,32
1683730237240,BIPN 100,A04,193414,Park; Ji Young,0,13,32,32
1683730238266,BIPN 102,A01,193429,Staff,0,0,32,32
1683730238266,BIPN 102,A02,193438,Staff,18,0,32,14
1683730239295,BIPN 106,A01,193450,Reyes Gonzalez; Catalina,0,2,40,40
1683730240324,BIPN 134,A01,193465,Cooke; James Edward,0,0,32,32
1683730240324,BIPN 134,A02,193474,Cooke; James Edward,25,0,32,7
1683730240324,BIPN 134,A03,193485,Cooke; James Edward,29,0,32,3
1683730240324,BIPN 134,A04,193486,Cooke; James Edward,20,0,32,12
1683730240324,BIPN 134,A05,193491,Cooke; James Edward,31,0,32,1
1683730240324,BIPN 134,A06,193501,Cooke; James Edward,30,0,32,2
1683730240324,BIPN 134,A07,193510,Cooke; James Edward,29,0,32,3
1683730242379,BISP 194,A00,222522,Staff,14,0,32,18
1683730243403,CAT 124,A01,202407,Staff,19,0,25,6
1683730244427,CAT 125,A00,202408,Marchisotto; Jennifer Anne,2,0,20,18
1683730245452,CAT 125R,A00,202409,Smith; Lauryn Alissa,0,11,20,20
1683730245452,CAT 125R,B00,202410,Morales; Celeste Georgianna,0,11,20,20
1683730245452,CAT 125R,C00,202411,Irwin; Matthew Joseph,0,12,20,20
1683730246476,CENG 15,A01,204712,Yang; Kesong,0,1,0,0
1683730247500,CENG 114,A00,202070,Jahed Motlagh; Zeinab,5,0,20,15
1683730248524,CGS 105,A00,185477,Wesling; Megan E.,24,0,40,16
1683730249550,CGS 106,A00,185494,Staff,11,0,22,11
1683730250575,CGS 108,A00,185495,Staff,14,0,20,6
1683730251602,CGS 114,A00,185496,Staff,13,0,18,5
1683730252626,CGS 119,A00,185501,Staff,15,0,20,5
1683730253651,CGS 120,A00,185511,Staff,11,0,20,9
1683730254676,CHEM 4,A01,184675,Bussey; Thomas J,97,0,100,3
1683730255704,CHEM 6A,A01,184677,Staff,32,0,60,28
1683730256728,CHEM 6B,A01,184679,Staff,63,0,100,37
1683730257756,CHEM 6C,A01,184681,Bussey; Thomas J,0,0,50,50
1683730257756,CHEM 6C,A02,184682,Bussey; Thomas J,32,0,50,18
1683730258785,CHEM 40A,A01,184684,Albizati; Kim F.,33,0,100,67
1683730259812,CHEM 40B,A01,184686,Albizati; Kim F.,0,22,100,100
1683730260838,CHEM 41B,A01,184690,Staff,51,0,100,49
1683730261866,COGS 3,A01,184715,Boyle; Mary E. T.,0,27,40,40
1683730262892,COGS 14B,A01,185172,Staff,0,14,38,38
1683730263918,COGS 18,A01,184736,Staff,14,0,80,66
1683730264943,COGS 100,A01,184932,Staff,0,8,73,73
1683730265970,COGS 101A,A01,184935,Staff,0,40,30,30
1683730266997,COGS 101B,A01,184944,Staff,0,2,30,30
1683730268022,COGS 101C,A01,184946,Staff,0,10,30,30
1683730269050,COGS 102A,A01,184951,Johnson; Christine M.,1,0,40,39
1683730270077,COGS 107B,A01,184953,Mooshagian; Eric Frederick,0,52,40,40
1683730271102,COGS 118B,A01,184959,Gupta; Anjum,0,50,40,40
1683730272131,COGS 153,A00,184961,Staff,1,16,30,29
1683730273156,COGS 177,A00,184962,Staff,0,20,30,30
1683730274190,COGS 187A,A01,184969,Boyle; Mary E. T.,0,19,40,40
1683730275216,COMM 10,A01,185174,Staff,0,5,25,25
1683730275216,COMM 10,A02,185189,Staff,0,2,25,25
1683730275216,COMM 10,A03,269821,Staff,0,1,0,0
1683730276244,COMM 100B,A02,185476,Staff,10,0,25,15
1683730276244,COMM 100B,A03,277340,Staff,25,0,25,0
1683730277272,COMM 100C,A01,185314,Staff,2,0,25,23
1683730277272,COMM 100C,A02,185327,Staff,17,0,25,8
1683730278302,COMM 110M,A00,185349,Staff,0,0,40,40
1683730279329,COMM 113T,A00,185352,Staff,25,0,40,15
1683730280355,COMM 114I,A00,185353,Staff,31,0,40,9
1683730281379,COMM 131,A00,185354,Staff,17,0,30,13
1683730282406,CSE 8A,A50,185358,Cao; Yingjun,0,46,10,10
1683730283432,CSE 8B,A01,185362,Staff,0,48,50,50
1683730284459,CSE 11,A01,185416,Cao; Yingjun,0,91,10,10
1683730285483,CSE 20,A01,185445,Briones; Jor-el Thomas Caparas,3,0,25,22
1683730286507,CSE 21,A01,185447,Staff,9,0,50,41
1683730287536,CSE 101,A01,185451,Staff,0,13,50,50
1683730287536,CSE 101,B01,185453,Jones; Miles E,0,15,50,50
1683730289588,CSE 141,A01,185458,Eldon; John,16,0,100,84
1683730290611,CSE 141L,A01,185461,Eldon; John,8,0,100,92
1683730291638,CSE 142,A01,185463,Staff,34,0,60,26
1683730291638,CSE 142,B01,201355,Staff,0,7,60,60
1683730292661,CSE 142L,A01,185470,Staff,34,0,60,26
1683730292661,CSE 142L,B01,201417,Staff,0,6,60,60
1683730293686,CSE 190,A00,201433,Staff,32,0,49,17
1683730294715,DOC 1,A01,259136,Strom; Megan C.,7,0,15,8
1683730294715,DOC 1,A02,259137,Strom; Megan C.,15,0,15,0
1683730294715,DOC 1,A03,259138,Strom; Megan C.,14,0,15,1
1683730294715,DOC 1,A04,259139,Strom; Megan C.,13,0,15,2
1683730295743,DOC 100D,A00,259140,Pass; Natalye Joann,14,0,25,11
1683730296769,DSGN 1,A01,184749,Rill; Bryan,0,26,30,30
1683730297795,DSGN 100,A01,185168,Staff,0,2,25,25
1683730298820,ECE 5,A01,185626,Morris; Karcher William,0,12,0,0
1683730299847,ECE 101,A01,185628,Staff,14,0,70,56
1683730300874,ECE 107,A01,185635,Baghdadchi; Saharnaz,0,0,20,20
1683730300874,ECE 107,A02,185638,Baghdadchi; Saharnaz,1,0,20,19
1683730301903,ECE 148,A01,185647,Silberman; Jack,0,0,16,16
1683730302928,ECON 1,A01,185537,Crane; Meredith Helen,54,0,70,16
1683730303953,ECON 3,A01,185549,Crane; Meredith Helen,30,0,70,40
1683730304978,ECON 4,A01,203354,Anderson; John Charles,0,5,10,10
1683730306015,ECON 100A,A01,185574,Staff,0,5,40,40
1683730307040,ECON 100B,A01,185576,Staff,0,12,50,50
1683730308064,ECON 100C,A01,185589,Newhouse; Herbert S,30,0,70,40
1683730309092,ECON 105,A00,185608,Vespa; Emanuel Ignacio,19,0,35,16
1683730310126,ECON 109,A01,185610,Shishkin; Denis,9,0,35,26
1683730311153,ECON 110A,A01,185612,Staff,8,0,40,32
1683730312180,ECON 120A,A01,185615,Staff,19,0,40,21
1683730313205,ECON 120C,A01,185617,Sun; Yixiao,0,21,70,70
1683730314230,ECON 144,A00,203346,Squires; Dale E,2,0,35,33
1683730315253,ECON 171,A01,203349,Newhouse; Herbert S,0,1,35,35
1683730316277,ECON 173A,A01,185621,Toda; Alexis Akira,21,0,35,14
1683730317304,EDS 25,A01,202413,Staff,0,1,0,0
1683730317304,EDS 25,A02,202414,Staff,0,1,0,0
1683730317304,EDS 25,A03,202415,Staff,0,0,0,0
1683730317304,EDS 25,A04,202416,Staff,0,1,0,0
1683730317304,EDS 25,A05,202439,Staff,0,0,0,0
1683730317304,EDS 25,A06,202440,Staff,0,0,0,0
1683730317304,EDS 25,B01,202631,Staff,0,0,0,0
1683730317304,EDS 25,B02,202632,Staff,0,0,0,0
1683730317304,EDS 25,B03,202639,Staff,0,0,0,0
1683730317304,EDS 25,B04,202640,Staff,0,0,0,0
1683730317304,EDS 25,B05,202643,Staff,0,0,0,0
1683730317304,EDS 25,B06,202644,Staff,0,0,0,0
1683730318332,EDS 38,A01,202659,Black; Alison Michelle,25,0,25,0
1683730319356,EDS 115,A00,202652,Staff,18,0,30,12
1683730320382,EDS 125,A00,202649,Staff,13,0,30,17
1683730321407,EDS 126,A01,203332,Staff,30,0,30,0
1683730322434,EDS 139,A00,202838,Staff,16,0,25,9
1683730323458,EDS 146,A01,202655,Staff,14,0,25,11
1683730324482,ENG 15,A00,185667,Staff,0,1,0,0
1683730324482,ENG 15,B00,185672,Staff,0,0,0,0
1683730324482,ENG 15,C00,185675,Staff,0,0,0,0
1683730324482,ENG 15,D00,185682,Staff,0,0,0,0
1683730324482,ENG 15,E00,185684,Staff,0,0,0,0
1683730325507,ETHN 103,A00,185710,Staff,0,8,35,35
1683730326544,ETHN 103A,A00,199228,Man; Simeon S,0,0,9,9
1683730327569,ETHN 109,A00,185711,Staff,15,0,35,20
1683730328598,ETHN 142,A00,185726,Staff,0,4,30,30
1683730329622,ETHN 163J,A00,199229,Man; Simeon S,5,0,8,3
1683730330647,ETHN 168,A00,185727,Staff,7,0,10,3
1683730331670,ETHN 182,A00,185728,Staff,0,0,35,35
1683730332695,ETHN 183,A00,185737,Staff,10,0,18,8
1683730333720,GLBH 111,A01,209361,Burgos; Jose L.,0,0,0,0
1683730335827,HIEU 104,A00,185792,Staff,14,0,20,6
1683730336852,HIEU 115,A00,185800,Staff,0,0,20,20
1683730337876,HIEU 128,A00,185801,Staff,0,9,20,20
1683730338900,HIEU 147,A00,185802,Staff,15,0,20,5
1683730339930,HIEU 154,A00,185823,Staff,11,0,20,9
1683730340956,HILA 102,A00,185826,Staff,14,0,20,6
1683730341983,HILD 2C,A01,185778,Staff,0,13,20,20
1683730343008,HILD 7B,A01,185780,Kwak; Nancy,0,17,32,32
1683730343008,HILD 7B,A02,185781,Kwak; Nancy,0,18,32,32
1683730344032,HILD 30,A01,185791,Staff,12,0,20,8
1683730345060,HISC 119,A00,185830,Golan; Tal,0,10,20,20
1683730346087,HITO 156GS,A00,185831,Patterson; Patrick H.,0,0,0,23
1683730347115,HIUS 103,A00,185832,Man; Simeon S,0,4,20,20
1683730348143,HIUS 117,A00,185836,Kwak; Nancy,2,0,20,18
1683730349172,HIUS 125,A00,185840,Man; Simeon S,0,2,23,23
1683730350197,HIUS 149,A00,185845,Staff,1,0,20,19
1683730351226,HUM 3,A01,185882,Zavodny; Tatiana Sophia,0,8,50,50
1683730351226,HUM 3,B01,185899,Caldwell; Michael Alan,0,18,50,50
1683730352250,HUM 3GS,A00,185900,Patterson; Patrick H.,0,0,0,23
1683730353276,HUM 4,A01,185938,Zroka; Amy Liane,28,0,50,22
1683730353276,HUM 4,B01,185956,Watkins; Eric,0,6,50,50
1683730353276,HUM 4,B02,202209,Watkins; Eric,0,6,50,50
1683730353276,HUM 4,B03,202210,Watkins; Eric,0,5,50,50
1683730354304,HUM 5,A01,185958,West; Geoffrey Scott,0,0,50,50
1683730354304,HUM 5,A02,202215,West; Geoffrey Scott,0,1,50,50
1683730355336,INTL 190,A00,185959,Gagnon; Jeffrey C,0,0,0,9
1683730355336,INTL 190,B00,185960,Lettieri; Michael Joseph,0,0,0,2
1683730356362,JAPN 180,A00,254509,Staff,4,0,30,26
1683730357390,LATI 10,A01,202853,Kennemore; Amy Michelle,4,0,35,31
1683730357390,LATI 10,A02,202854,Kennemore; Amy Michelle,3,0,35,32
1683730357390,LATI 10,A03,270054,Kennemore; Amy Michelle,30,0,30,0
1683730358417,LATI 180,A00,202855,Kennemore; Amy Michelle,11,0,20,9
1683730359442,LAWS 101,A00,201767,Golan; Tal,0,7,40,40
1683730360466,LIFR 1C,A00,185961,Staff,6,0,20,14
1683730361492,LIFR 1CX,A00,185962,Staff,7,0,20,13
1683730362517,LIFR 1D,A00,185963,Staff,7,0,20,13
1683730363542,LIFR 1DX,A00,185964,Staff,7,0,20,13
1683730364568,LIGN 101,A01,186039,Staff,43,0,50,7
1683730365591,LIGN 165,A00,186040,Staff,14,0,50,36
1683730366616,LTCS 108,A00,186041,Staff,5,0,10,5
1683730367641,LTCS 119,A00,186042,Staff,15,0,20,5
1683730368671,LTCS 130,A00,186043,Wesling; Megan E.,15,0,25,10
1683730370720,LTEA 138,A00,186119,Staff,13,0,40,27
1683730371744,LTEN 124,A00,186148,Staff,5,0,25,20
1683730372770,LTEN 178,A00,186149,Staff,6,0,15,9
1683730373795,LTEN 181,A00,186150,Blanco; John D,34,0,40,6
1683730374824,LTWL 120,A00,186160,Staff,19,0,25,6
1683730375852,LTWL 165,A00,186161,Staff,22,0,25,3
1683730376876,LTWR 100,A00,186162,Staff,0,5,15,15
1683730377899,LTWR 102,A00,186163,Doller; Ben,5,0,15,10
1683730378927,MAE 8,A01,186412,Staff,0,1,0,0
1683730379957,MAE 30B,A00,186445,Bahadori; Mohammad Yousef,81,0,100,19
1683730380983,MAE 40,A00,186592,Bewley; Thomas R,10,0,50,40
1683730382009,MAE 101B,A00,186593,Bahadori; Mohammad Yousef,80,0,100,20
1683730383038,MAE 105,A00,186594,Bandaru; Prabhakar,10,0,50,40
1683730384064,MAE 107,A00,186599,Pham; Hieu Tan,0,8,120,120
1683730385089,MAE 148,A01,186660,Silberman; Jack,3,0,16,13
1683730386117,MATH 10A,A01,188095,Staff,0,6,35,35
1683730387141,MATH 10B,A01,188097,Bowers; Adam R.,0,12,30,30
1683730387141,MATH 10B,A02,188099,Bowers; Adam R.,0,11,30,30
1683730387141,MATH 10B,B01,188104,Bowers; Adam R.,0,10,30,30
1683730387141,MATH 10B,B02,188106,Bowers; Adam R.,0,9,30,30
1683730388173,MATH 10C,A01,188111,Staff,0,20,30,30
1683730388173,MATH 10C,A02,188127,Staff,0,19,30,30
1683730388173,MATH 10C,A03,188131,Staff,0,19,30,30
1683730388173,MATH 10C,B01,188218,Staff,17,0,30,13
1683730388173,MATH 10C,B02,188244,Staff,13,0,30,17
1683730388173,MATH 10C,B03,188277,Staff,14,0,30,16
1683730389204,MATH 18,A01,188344,Bach; Quang Tran,18,0,30,12
1683730389204,MATH 18,A02,188345,Bach; Quang Tran,11,0,30,19
1683730389204,MATH 18,B01,188353,Bach; Quang Tran,11,0,30,19
1683730389204,MATH 18,B02,188354,Bach; Quang Tran,19,0,30,11
1683730390226,MATH 20A,A01,188374,Staff,10,0,35,25
1683730391256,MATH 20B,A01,188382,Ohm; Ko Woon,7,0,30,23
1683730391256,MATH 20B,A02,188383,Ohm; Ko Woon,22,0,30,8
1683730391256,MATH 20B,B01,188385,Ohm; Ko Woon,7,0,30,23
1683730391256,MATH 20B,B02,188392,Ohm; Ko Woon,22,0,30,8
1683730392280,MATH 20C,A01,188394,Harel; Guershon,10,0,30,20
1683730392280,MATH 20C,A02,188395,Harel; Guershon,13,0,30,17
1683730392280,MATH 20C,B01,188404,Harel; Guershon,5,0,30,25
1683730392280,MATH 20C,B02,188405,Harel; Guershon,18,0,30,12
1683730393312,MATH 20D,A01,188414,Hammock; Frances H,0,1,30,30
1683730393312,MATH 20D,A02,188415,Hammock; Frances H,0,1,30,30
1683730393312,MATH 20D,B01,188447,Hammock; Frances H,0,1,30,30
1683730393312,MATH 20D,B02,188486,Hammock; Frances H,2,0,30,28
1683730394338,MATH 20E,A01,188649,Staff,21,0,30,9
1683730394338,MATH 20E,A02,188650,Staff,20,0,30,10
1683730394338,MATH 20E,A03,188673,Staff,0,0,30,30
1683730395363,MATH 102,A01,188675,Staff,0,40,35,35
1683730396388,MATH 103B,A01,188681,Staff,3,0,35,32
1683730396388,MATH 103B,B01,188692,Staff,5,0,35,30
1683730397415,MATH 109,A01,188695,Salehi Golsefidy; Alireza,24,0,35,11
1683730397415,MATH 109,A02,188696,Salehi Golsefidy; Alireza,24,0,35,11
1683730398440,MATH 120A,A01,188698,Eggers; John Dietrich,7,0,35,28
1683730399465,MATH 142B,A01,188736,Ioana; Adrian,0,0,30,30
1683730399465,MATH 142B,A02,188741,Ioana; Adrian,0,1,30,30
1683730399465,MATH 142B,A03,188743,Ioana; Adrian,0,3,30,30
1683730400494,MATH 168A,A01,188790,Staff,0,11,35,35
1683730401519,MATH 170A,A01,188803,Nie; Jiawang,0,2,35,35
1683730401519,MATH 170A,A02,188811,Nie; Jiawang,0,1,35,35
1683730401519,MATH 170A,A03,188814,Nie; Jiawang,1,0,35,34
1683730401519,MATH 170A,A04,188815,Nie; Jiawang,5,0,35,30
1683730402545,MATH 193B,A01,188817,Staff,0,0,35,35
1683730402545,MATH 193B,A02,188818,Staff,6,0,35,29
1683730403575,MGT 4,A01,202857,Anderson; John Charles,59,0,80,21
1683730404602,MGT 12,A00,202858,Lindenberger; Wade Douglas,40,0,90,50
1683730405628,MGT 18,A00,202859,Staff,73,0,90,17
1683730406654,MGT 18GS,A00,202860,McKay; Michael J,13,0,28,15
1683730407681,MGT 45,A00,202861,Pecore; Joseph P.,8,0,90,82
1683730408706,MGT 100,A00,202863,Yavorsky; Daniel Ryan,27,0,90,63
1683730409730,MGT 103,A00,202864,Ehrich; Kristine R,0,19,90,90
1683730410758,MGT 112,A00,202865,Ehrich; Kristine R,15,0,90,75
1683730411785,MGT 121A,A00,202868,Staff,70,0,90,20
1683730412812,MGT 131B,A00,202869,Anderson; John Charles,58,0,90,32
1683730413840,MGT 136,A00,202871,Lindenberger; Wade Douglas,83,0,90,7
1683730414865,MGT 164,A00,202873,Staff,0,67,90,91
1683730415894,MGT 164GS,A00,202874,McKay; Mary A,13,0,28,15
1683730416923,MGT 180,A00,202875,Staff,0,51,90,91
1683730417948,MMW 11R,A01,205019,Herbst; Matthew,0,0,30,30
1683730417948,MMW 11R,A02,205026,Herbst; Matthew,29,0,30,1
1683730418979,MMW 15,A01,193512,Chang; Edmond Yi-Teh,0,8,28,28
1683730418979,MMW 15,A02,193513,Chang; Edmond Yi-Teh,0,5,28,28
1683730418979,MMW 15,A03,193514,Chang; Edmond Yi-Teh,0,5,28,28
1683730418979,MMW 15,A04,193515,Chang; Edmond Yi-Teh,0,5,28,28
1683730418979,MMW 15,A05,193516,Chang; Edmond Yi-Teh,0,5,28,28
1683730418979,MMW 15,A06,193517,Chang; Edmond Yi-Teh,0,6,28,28
1683730418979,MMW 15,B01,193519,Chang; Edmond Yi-Teh,0,5,28,28
1683730418979,MMW 15,B02,193520,Chang; Edmond Yi-Teh,0,5,28,28
1683730418979,MMW 15,B03,193521,Chang; Edmond Yi-Teh,0,5,28,28
1683730418979,MMW 15,B04,193522,Chang; Edmond Yi-Teh,0,6,28,28
1683730418979,MMW 15,B05,193523,Chang; Edmond Yi-Teh,0,5,28,28
1683730418979,MMW 15,B06,193524,Chang; Edmond Yi-Teh,0,5,28,28
1683730420010,MMW 122,A01,193526,Rahimi; Babak,0,16,28,28
1683730420010,MMW 122,A02,193527,Rahimi; Babak,0,15,28,28
1683730420010,MMW 122,A03,193528,Rahimi; Babak,0,0,0,0
1683730420010,MMW 122,A04,193529,Rahimi; Babak,0,0,0,0
1683730421039,MUS 1A,A01,186663,Staff,0,18,35,35
1683730422064,MUS 4,A01,186715,Staff,0,12,35,35
1683730423094,MUS 5R,A01,186796,Dubnov; Shlomo,0,17,35,35
1683730424121,MUS 6,A01,186798,Staff,0,4,25,25
1683730425146,MUS 7,A01,186830,Staff,11,0,35,24
1683730426175,MUS 8,A01,186930,Staff,0,27,35,35
1683730427202,MUS 15,A01,186932,Staff,0,15,35,35
1683730427202,MUS 15,B01,186934,Staff,0,16,35,35
1683730428232,MUS 80,A00,186935,Staff,0,0,20,20
1683730428232,MUS 80,B00,186936,Staff,24,0,25,1
1683730429258,NANO 11,A00,204702,Lipomi; Darren John,0,0,0,0
1683730430292,NANO 15,A01,204709,Yang; Kesong,0,1,0,0
1683730431319,NANO 114,A00,202069,Jahed Motlagh; Zeinab,2,0,10,8
1683730432350,PHIL 1,A00,186955,Grush; Rick Scott,31,0,40,9
1683730433375,PHIL 10,A01,186973,Grush; Rick Scott,27,0,35,8
1683730433375,PHIL 10,A02,186974,Grush; Rick Scott,33,0,35,2
1683730434401,PHIL 13,A01,186976,Staff,1,0,35,34
1683730434401,PHIL 13,A02,186977,Staff,16,0,35,19
1683730435426,PHIL 14,A01,186979,Staff,30,0,35,5
1683730435426,PHIL 14,A02,186986,Staff,32,0,35,3
1683730436453,PHIL 28,A01,186988,Staff,16,0,30,14
1683730436453,PHIL 28,A02,186989,Staff,0,0,30,30
1683730436453,PHIL 28,A03,186990,Staff,10,0,30,20
1683730436453,PHIL 28,A04,186991,Staff,26,0,30,4
1683730437477,PHIL 120,A00,186997,Staff,23,0,40,17
1683730438558,PHIL 137,A00,187003,Staff,8,0,40,32
1683730439583,PHIL 150,A00,187015,Staff,47,0,70,23
1683730440609,PHIL 167,A00,187021,Lamey; Andy M.,34,0,40,6
1683730441637,PHIL 174,A01,202226,Staff,17,0,20,3
1683730441637,PHIL 174,A02,202235,Staff,20,0,20,0
1683730442666,PHIL 191A,A00,258918,Staff,0,0,1,1
1683730443690,PHYS 1A,A00,187028,Staff,26,0,60,34
1683730444730,PHYS 1AL,001,187036,Staff,3,0,30,27
1683730444730,PHYS 1AL,002,187049,Staff,18,0,30,12
1683730445754,PHYS 1B,A00,187058,Staff,21,0,60,39
1683730446784,PHYS 1BL,001,187064,Staff,0,1,30,30
1683730446784,PHYS 1BL,002,187070,Staff,4,0,30,26
1683730447813,PHYS 1C,A00,187082,Staff,30,0,120,90
1683730448840,PHYS 1CL,001,187088,Staff,0,9,30,30
1683730448840,PHYS 1CL,002,187089,Staff,0,1,30,30
1683730448840,PHYS 1CL,009,262693,Staff,9,0,30,21
1683730449868,PHYS 2B,A01,187097,Staff,55,0,115,60
1683730450891,PHYS 2C,A01,187099,Staff,63,0,115,52
1683730451918,PHYS 2CL,A01,187101,Staff,5,0,28,23
1683730451918,PHYS 2CL,A02,187102,Staff,15,0,28,13
1683730452944,PHYS 2D,A01,187123,Shotwell; Brian,95,0,115,20
1683730453970,PHYS 4B,A01,187133,Grinstein; Benjamin,35,0,50,15
1683730454996,POLI 10,A00,188819,Staff,0,4,50,50
1683730456022,POLI 11,A00,188827,Staff,43,0,50,7
1683730457049,POLI 13R,A00,188828,Staff,0,2,20,20
1683730458077,POLI 27,A01,188830,Elgin; Samuel Zincke,0,2,70,70
1683730459101,POLI 30,A00,188832,Desposato; Scott,30,0,50,20
1683730460129,POLI 102F,A00,188834,Staff,1,0,40,39
1683730461156,POLI 104A,A00,188852,Staff,12,0,30,18
1683730462179,POLI 104I,A00,188853,Staff,0,8,20,20
1683730463206,POLI 110B,A00,188854,Wiens; David,6,0,20,14
1683730464232,POLI 112A,A00,188855,Wiens; David,3,0,30,27
1683730465256,POLI 117R,A00,188856,Forman; Fonna,0,12,20,20
1683730466284,POLI 118,A00,188857,Ingham; Sean,8,0,20,12
1683730467310,POLI 120G,A00,188858,Staff,7,0,30,23
1683730468335,POLI 131CR,A00,188863,Hoston; Germaine,20,0,50,30
1683730469364,POLI 133,A00,188864,Nellis; Gareth Hb,44,0,50,6
1683730470388,POLI 134D,A00,188865,Desposato; Scott,27,0,30,3
1683730471413,POLI 142A,A00,188871,Gartzke; Erik,21,0,50,29
1683730472438,POLI 142K,A00,188874,Staff,38,0,50,12
1683730473462,POLI 143,A00,188940,Gartzke; Erik,15,0,30,15
1683730474486,POLI 153,A00,188943,Staff,1,0,20,19
1683730475510,POLI 160AA,A00,188944,Staff,10,0,40,30
1683730476535,POLI 170A,A00,188945,Staff,10,0,30,20
1683730478586,PSYC 1,A00,188952,Staff,36,0,90,54
1683730479614,PSYC 2,B00,188953,Staff,19,0,35,16
1683730480642,PSYC 6,A00,188970,Staff,47,0,60,13
1683730481666,PSYC 7,A00,188973,Staff,35,0,45,10
1683730482694,PSYC 60,A01,188980,Rickard; Timothy C.,42,0,60,18
1683730483721,PSYC 70,A01,189001,Steiner; Eric Tomas,21,0,45,24
1683730484749,PSYC 100,A00,189005,Lacefield; Katharine I,1,98,120,119
1683730485778,PSYC 102,A00,189008,Staff,6,0,30,24
1683730486807,PSYC 106,B00,189026,Gorman; Michael R.,27,0,60,33
1683730487832,PSYC 114,B01,189033,Winkielman; Piotr,0,31,30,30
1683730488858,PSYC 131,A00,189036,Anagnostaras; Stephan,0,44,60,60
1683730489886,PSYC 136,A00,189041,Lowe; Angela Beth,0,7,25,25
1683730490912,PSYC 137,A00,189057,Winkielman; Piotr,0,36,25,25
1683730491942,PSYC 144,A00,189107,Wixted; John T,0,11,50,50
1683730493992,PSYC 162,A00,189142,Staff,0,9,85,85
1683730495016,PSYC 172,A00,189144,Gorman; Michael R.,0,6,30,30
1683730497071,PSYC 179,A00,189146,Lacefield; Katharine I,0,88,120,120
1683730498094,PSYC 181,A00,189147,Anagnostaras; Stephan,0,45,90,90
1683730499120,PSYC 190R,A00,189148,Barner; David A.,0,23,80,80
1683730500146,PSYC 191,A00,189275,Rickard; Timothy C.,0,11,25,25
1683730501179,PSYC 193,A00,189276,Chapman; Eddie Nathaniel,0,1,0,4
1683730502210,PSYC 193L,A01,189281,Lowe; Angela Beth,8,0,20,12
1683730502210,PSYC 193L,B01,189285,Staff,28,0,35,7
1683730503234,RELI 149,A00,187137,Rahimi; Babak,6,0,40,34
1683730504262,SE 9,A01,187315,Staff,0,2,18,18
1683730505288,SE 101B,A00,187409,Staff,24,0,30,6
1683730506316,SE 110B,A00,187444,Staff,10,0,40,30
1683730507343,SE 130B,A00,187449,Staff,31,0,40,9
1683730508367,SE 150A,A00,187516,Staff,8,0,20,12
1683730509391,SE 154,A00,187528,Staff,29,0,50,21
1683730510420,SIO 3,A01,258171,Staff,35,0,40,5
1683730511447,SIO 10,A00,187144,Cook; Geoffrey W,0,6,75,75
1683730512472,SIO 45,A00,187152,Cook; Geoffrey W,1,7,100,99
1683730513495,SIO 109R,A00,194486,Staff,0,4,20,20
1683730515547,SIO 187,A01,187233,Kacev; David,12,0,40,28
1683730516573,SOCI 1,A01,258656,Thorpe; Charles Robert,28,0,30,2
1683730516573,SOCI 1,A02,258658,Thorpe; Charles Robert,30,0,30,0
1683730516573,SOCI 1,A03,258661,Thorpe; Charles Robert,25,0,25,0
1683730516573,SOCI 1,A04,258666,Thorpe; Charles Robert,22,0,25,3
1683730516573,SOCI 1,A05,258897,Thorpe; Charles Robert,22,0,25,3
1683730516573,SOCI 1,A06,258898,Thorpe; Charles Robert,25,0,25,0
1683730517599,SOCI 30,A01,258903,Pardo Guerra; Juan Pablo,14,0,30,16
1683730518627,SOCI 102,A00,258904,Staff,9,0,25,16
1683730519652,SOCI 106,A00,258905,Staff,19,0,25,6
1683730520677,SOCI 111,A00,258907,Ribas Norris; Janet Vanesa,26,0,30,4
1683730521705,SOCI 121R,A00,258908,Pardo Guerra; Juan Pablo,7,0,30,23
1683730522732,SOCI 126,A01,203330,Staff,14,0,20,6
1683730523756,SOCI 131,A00,258909,Thorpe; Charles Robert,30,0,60,30
1683730524780,SOCI 135,A00,258910,Payne; Christine Anna,0,13,30,30
1683730525805,SOCI 157,A00,258911,Staff,10,0,30,20
1683730526829,SOCI 184,A00,258912,Staff,25,0,30,5
1683730527857,SOCI 188D,A00,258913,Staff,22,0,30,8
1683730528885,SYN 2,001,187529,Staff,9,0,16,7
1683730528885,SYN 2,002,201452,Staff,0,20,16,16
1683730528885,SYN 2,003,201469,Staff,1,0,16,15
1683730529911,SYN 100,A01,187531,Staff,0,9,20,20
1683730529911,SYN 100,B01,201491,Staff,0,10,20,20
1683730530941,TDAC 1,A00,189286,Walsh; Kim C.,3,0,20,17
1683730530941,TDAC 1,B00,189287,Harting; Carla Kelso,10,0,20,10
1683730531967,TDAC 101,A00,189300,Walsh; Kim C.,16,0,20,4
1683730531967,TDAC 101,B00,189301,Harting; Carla Kelso,18,0,20,2
1683730532994,TDAC 102,A00,189304,Basso; Beatrice,14,0,20,6
1683730534021,TDAC 108,A00,189305,Staff,18,0,20,2
1683730535056,TDDE 131,A00,189310,Staff,19,0,20,1
1683730535056,TDDE 131,B00,189314,Staff,19,0,20,1
1683730535056,TDDE 131,C00,189315,Staff,48,0,50,2
1683730535056,TDDE 131,D00,189316,Staff,14,0,15,1
1683730535056,TDDE 131,E00,204841,Staff,20,0,20,0
1683730536084,TDGE 10,A00,189289,Staff,26,0,50,24
1683730536084,TDGE 10,B00,189290,Havis; Allan,0,1,50,50
1683730537113,TDGE 11,A00,189291,Fulton; Julia,0,4,50,50
1683730537113,TDGE 11,B00,189292,Staff,20,0,25,5
1683730537113,TDGE 11,C00,260270,Staff,0,0,0,0
1683730538138,TDGE 25,A00,189294,Staff,1,0,20,19
1683730539166,TDGE 124,A00,189318,Fulton; Julia,0,7,50,50
1683730540198,TDGE 125,A00,189319,Staff,13,0,25,12
1683730540198,TDGE 125,B00,189320,Staff,23,0,25,2
1683730541223,TDGE 127,A00,189322,Havis; Allan,1,0,50,49
1683730542305,TDHT 101,A00,189323,Staff,18,0,25,7
1683730542305,TDHT 101,B00,189324,Staff,25,0,25,0
1683730543333,TDHT 102,A00,189325,Staff,49,0,50,1
1683730544359,TDMV 1,A00,189295,Arcidiacono; Kristin,20,0,30,10
1683730544359,TDMV 1,B00,189296,Caligagan; Maria T.,23,0,30,7
1683730545389,TDMV 2,A00,189297,Sammartano; Tonnie,27,0,30,3
1683730545389,TDMV 2,B00,189299,Arcidiacono; Kristin,23,0,30,7
1683730546421,TDMV 3,A00,204998,Rincon; Alicia,22,0,30,8
1683730547447,TDMV 120,A00,189458,Sammartano; Tonnie,28,0,30,2
1683730548475,TDMV 138,A00,189541,Jun; Grace Shin Hae,20,0,40,20
1683730549500,TDMV 142,A00,189717,Caligagan; Tony,25,0,30,5
1683730549500,TDMV 142,B00,189718,Caligagan; Maria T.,25,0,30,5
1683730550526,TMC 2,A01,187533,Staff,25,0,25,0
1683730550526,TMC 2,A02,187534,Staff,25,0,25,0
1683730551555,USP 1,A01,187536,Kwak; Nancy,0,16,25,25
1683730552584,USP 5,A01,187538,Staff,8,0,25,17
1683730553612,USP 101,A00,199253,Staff,0,4,0,0
1683730554638,USP 124,A00,187562,Boomhower; Matthew Charles,0,0,30,30
1683730555664,USP 138,A00,187582,Staff,19,0,25,6
1683730556742,USP 152,A01,187597,Staff,3,0,25,22
1683730557766,USP 153,A00,187598,Staff,18,0,25,7
1683730558791,USP 168,A00,187607,Kwak; Nancy,2,0,5,3
1683730559819,USP 173,A00,187619,Staff,4,0,25,21
1683730560847,USP 181,A00,187638,Staff,0,4,25,25
1683730561986,VIS 103,A00,187650,Cruz; Edwin Teddy,17,0,75,58
1683730563011,VIS 110D,A00,187669,Staff,13,0,22,9
1683730564043,VIS 127C,A00,187720,Shen; Kuiyi,67,0,146,79
1683730565070,VIS 149,A00,187731,Yoldas; Pinar,0,12,22,22
1683730566097,VIS 151,A01,188091,Staff,22,0,34,12
1683730566097,VIS 151,A02,188092,Staff,11,0,34,23
1683730567125,VIS 160B,A00,188093,Stalbaum; Brett,0,1,10,10
1683730569177,WCWP 10B,A00,201720,Staff,0,0,5,5
1683730569177,WCWP 10B,B00,201722,Staff,0,0,6,6
1683730570204,WCWP 100,A00,201725,Gagnon; Jeffrey C,0,0,2,2
1683730570204,WCWP 100,B00,201727,Staff,0,4,15,15
1683730573347,ANBI 133,A00,258401,Wilder; Linnea Lorene,34,0,40,6
1683730574385,ANBI 140,A00,258395,Hrvoj Mihic; Branka,18,0,25,7
1683730575411,ANSC 120,A00,258402,Bialecki; Jon Anthony,26,0,40,14
1683730576439,ANSC 144,A00,258400,Staff,12,0,40,28
1683730578502,ANSC 166,A00,258396,Parish; Steven Martin,156,0,175,19
1683730579529,ANSC 180,A00,193533,Staff,8,0,20,12
1683730580562,ANSC 188,A00,258397,Jassal; Aftab,34,0,40,6
1683730581589,ANTH 3,A01,258316,Staff,23,0,30,7
1683730582615,ANTH 5,A00,258394,Semendeferi; Ekaterini,16,0,20,4
1683730583641,ANTH 21,A01,258331,Staff,4,0,40,36
1683730584669,ANTH 103,A00,258398,Varma; Saiba,15,0,25,10
1683730585710,AWP 10,001,202034,Staff,0,0,0,0
1683730585710,AWP 10,002,202035,Staff,0,0,0,0
1683730585710,AWP 10,003,202036,Staff,0,0,0,0
1683730585710,AWP 10,004,202037,Staff,0,0,0,0
1683730585710,AWP 10,005,202038,Staff,0,0,0,0
1683730585710,AWP 10,006,202039,Staff,0,0,0,0
1683730585710,AWP 10,007,202040,Staff,0,0,0,0
1683730585710,AWP 10,008,202041,Staff,0,0,0,0
1683730585710,AWP 10,009,202042,Staff,0,0,0,0
1683730585710,AWP 10,010,202043,Staff,0,0,0,0
1683730585710,AWP 10,011,202044,Staff,0,0,0,0
1683730585710,AWP 10,012,202045,Staff,0,0,0,0
1683730585710,AWP 10,013,202046,Staff,0,0,0,0
1683730585710,AWP 10,014,202047,Staff,0,0,0,0
1683730585710,AWP 10,015,202048,Staff,0,0,0,0
1683730585710,AWP 10,016,202049,Staff,0,0,0,0
1683730585710,AWP 10,017,202050,Staff,0,0,0,0
1683730585710,AWP 10,018,202051,Staff,0,0,0,0
1683730585710,AWP 10,019,202052,Staff,0,0,0,0
1683730585710,AWP 10,020,202053,Staff,0,0,0,0
1683730585710,AWP 10,021,202054,Staff,0,0,0,0
1683730585710,AWP 10,022,202055,Staff,0,0,0,0
1683730585710,AWP 10,023,202056,Staff,0,0,0,0
1683730585710,AWP 10,024,202057,Staff,0,0,0,0
1683730585710,AWP 10,025,202058,Staff,0,0,0,0
1683730585710,AWP 10,026,202059,Staff,0,0,0,0
1683730586749,AWP 102,001,202032,Staff,0,0,0,0
1683730586749,AWP 102,002,202033,Staff,0,0,0,0
1683730587809,BENG 100,A01,254234,Taylor Amos; Alyssa C,31,0,40,9
1683730588835,BENG 196,001,270013,Engler; Adam J.,9999,0,9999,0
1683730589866,BICD 100R,A01,202018,Smith; Laurie,0,7,32,32
1683730589866,BICD 100R,A02,202019,Smith; Laurie,0,3,32,32
1683730589866,BICD 100R,A03,202020,Smith; Laurie,0,1,32,32
1683730589866,BICD 100R,A04,202021,Smith; Laurie,6,0,32,26
1683730589866,BICD 100R,A05,202022,Smith; Laurie,10,0,32,22
1683730590894,BICD 136,A01,193242,Gustafson-Brown; Cindy,0,2,32,32
1683730590894,BICD 136,A02,193244,Gustafson-Brown; Cindy,13,0,32,19
1683730591949,BIEB 102,A01,193249,Butler; Shannon Rhey,0,0,32,32
1683730591949,BIEB 102,A02,193251,Butler; Shannon Rhey,0,0,32,32
1683730591949,BIEB 102,A03,193253,Butler; Shannon Rhey,0,0,32,32
1683730591949,BIEB 102,A04,193255,Butler; Shannon Rhey,13,0,32,19
1683730591949,BIEB 102,A05,193265,Butler; Shannon Rhey,25,0,32,7
1683730591949,BIEB 102,A06,193269,Butler; Shannon Rhey,12,0,32,20
1683730594003,BIEB 150,A01,193274,Staff,0,0,32,32
1683730594003,BIEB 150,A02,193285,Staff,24,0,32,8
1683730595033,BIEB 194,A00,193286,Kurle; Carolyn M.,19,0,32,13
1683730596066,BILD 1,A01,192291,Staff,15,0,32,17
1683730596066,BILD 1,A02,192292,Staff,30,0,32,2
1683730596066,BILD 1,B01,192520,Reuther; Keefe,0,1,0,0
1683730596066,BILD 1,B02,192532,Reuther; Keefe,0,1,0,0
1683730597097,BILD 3,A01,192556,Butler; Shannon Rhey,0,0,32,32
1683730597097,BILD 3,A02,192581,Butler; Shannon Rhey,0,1,32,32
1683730597097,BILD 3,A03,192611,Butler; Shannon Rhey,19,0,32,13
1683730597097,BILD 3,A04,192612,Butler; Shannon Rhey,23,0,32,9
1683730597097,BILD 3,A05,192613,Butler; Shannon Rhey,26,0,32,6
1683730597097,BILD 3,A06,192679,Butler; Shannon Rhey,27,0,32,5
1683730597097,BILD 3,A07,192682,Butler; Shannon Rhey,20,0,32,12
1683730598128,BILD 4,A01,192836,Reuther; Keefe,1,0,24,23
1683730598128,BILD 4,A02,193044,Reuther; Keefe,4,0,24,20
1683730599153,BILD 10,A01,193142,Gustafson-Brown; Cindy,29,0,32,3
1683730599153,BILD 10,A02,193149,Gustafson-Brown; Cindy,31,0,32,1
1683730600181,BIMM 100,A01,193301,Staff,0,6,32,32
1683730600181,BIMM 100,A02,193312,Staff,0,7,32,32
1683730600181,BIMM 100,A03,193323,Staff,0,10,32,32
1683730601220,BIMM 101,A01,193329,McDonnell; Lisa Marie,0,3,24,24
1683730601220,BIMM 101,A02,193339,McDonnell; Lisa Marie,0,3,24,24
1683730601220,BIMM 101,B01,193354,McDonnell; Lisa Marie,0,4,24,24
1683730601220,BIMM 101,B02,193357,McDonnell; Lisa Marie,0,3,24,24
1683730602247,BIMM 110,A01,193377,Tat; John,0,11,32,32
1683730602247,BIMM 110,A02,193378,Tat; John,0,11,32,32
1683730603334,BIMM 120,A01,206116,Staff,0,0,32,32
1683730603334,BIMM 120,A02,206117,Staff,7,0,32,25
1683730603334,BIMM 120,A03,206121,Staff,21,0,32,11
1683730604365,BIPN 100,A01,193393,Park; Ji Young,0,15,32,32
1683730604365,BIPN 100,A02,193402,Park; Ji Young,0,14,32,32
1683730604365,BIPN 100,A03,193413,Park; Ji Young,0,14,32,32
1683730604365,BIPN 100,A04,193414,Park; Ji Young,0,13,32,32
1683730605391,BIPN 102,A01,193429,Staff,0,0,32,32
1683730605391,BIPN 102,A02,193438,Staff,18,0,32,14
1683730606419,BIPN 106,A01,193450,Reyes Gonzalez; Catalina,0,2,40,40
1683730607446,BIPN 134,A01,193465,Cooke; James Edward,0,0,32,32
1683730607446,BIPN 134,A02,193474,Cooke; James Edward,25,0,32,7
1683730607446,BIPN 134,A03,193485,Cooke; James Edward,29,0,32,3
1683730607446,BIPN 134,A04,193486,Cooke; James Edward,20,0,32,12
1683730607446,BIPN 134,A05,193491,Cooke; James Edward,31,0,32,1
1683730607446,BIPN 134,A06,193501,Cooke; James Edward,30,0,32,2
1683730607446,BIPN 134,A07,193510,Cooke; James Edward,29,0,32,3
1683730609498,BISP 194,A00,222522,Staff,14,0,32,18
1683730610527,CAT 124,A01,202407,Staff,19,0,25,6
1683730611557,CAT 125,A00,202408,Marchisotto; Jennifer Anne,2,0,20,18
1683730612591,CAT 125R,A00,202409,Smith; Lauryn Alissa,0,11,20,20
1683730612591,CAT 125R,B00,202410,Morales; Celeste Georgianna,0,11,20,20
1683730612591,CAT 125R,C00,202411,Irwin; Matthew Joseph,0,12,20,20
1683730613626,CENG 15,A01,204712,Yang; Kesong,0,1,0,0
1683730614652,CENG 114,A00,202070,Jahed Motlagh; Zeinab,5,0,20,15
1683730615686,CGS 105,A00,185477,Wesling; Megan E.,24,0,40,16
1683730616714,CGS 106,A00,185494,Staff,11,0,22,11
1683730617739,CGS 108,A00,185495,Staff,14,0,20,6
1683730618768,CGS 114,A00,185496,Staff,13,0,18,5
1683730619794,CGS 119,A00,185501,Staff,15,0,20,5
1683730620820,CGS 120,A00,185511,Staff,11,0,20,9
1683730621846,CHEM 4,A01,184675,Bussey; Thomas J,97,0,100,3
1683730622872,CHEM 6A,A01,184677,Staff,32,0,60,28
1683730623902,CHEM 6B,A01,184679,Staff,63,0,100,37
1683730624927,CHEM 6C,A01,184681,Bussey; Thomas J,0,0,50,50
1683730624927,CHEM 6C,A02,184682,Bussey; Thomas J,32,0,50,18
1683730625960,CHEM 40A,A01,184684,Albizati; Kim F.,33,0,100,67
1683730626987,CHEM 40B,A01,184686,Albizati; Kim F.,0,22,100,100
1683730628012,CHEM 41B,A01,184690,Staff,51,0,100,49
1683730629043,COGS 3,A01,184715,Boyle; Mary E. T.,0,27,40,40
1683730630073,COGS 14B,A01,185172,Staff,0,14,38,38
1683730631102,COGS 18,A01,184736,Staff,14,0,80,66
1683730632128,COGS 100,A01,184932,Staff,0,8,73,73
1683730633152,COGS 101A,A01,184935,Staff,0,40,30,30
1683730634178,COGS 101B,A01,184944,Staff,0,2,30,30
1683730635207,COGS 101C,A01,184946,Staff,0,10,30,30
1683730636230,COGS 102A,A01,184951,Johnson; Christine M.,1,0,40,39
1683730637261,COGS 107B,A01,184953,Mooshagian; Eric Frederick,0,52,40,40
1683730638291,COGS 118B,A01,184959,Gupta; Anjum,0,50,40,40
1683730639316,COGS 153,A00,184961,Staff,1,16,30,29
1683730640345,COGS 177,A00,184962,Staff,0,20,30,30
1683730641389,COGS 187A,A01,184969,Boyle; Mary E. T.,0,19,40,40
1683730642416,COMM 10,A01,185174,Staff,0,5,25,25
1683730642416,COMM 10,A02,185189,Staff,0,2,25,25
1683730642416,COMM 10,A03,269821,Staff,0,1,0,0
1683730643447,COMM 100B,A02,185476,Staff,10,0,25,15
1683730643447,COMM 100B,A03,277340,Staff,25,0,25,0
1683730644474,COMM 100C,A01,185314,Staff,2,0,25,23
1683730644474,COMM 100C,A02,185327,Staff,17,0,25,8
1683730645499,COMM 110M,A00,185349,Staff,0,0,40,40
1683730646583,COMM 113T,A00,185352,Staff,25,0,40,15
1683730647610,COMM 114I,A00,185353,Staff,31,0,40,9
1683730648638,COMM 131,A00,185354,Staff,17,0,30,13
1683730649663,CSE 8A,A50,185358,Cao; Yingjun,0,46,10,10
1683730650695,CSE 8B,A01,185362,Staff,0,48,50,50
1683730651724,CSE 11,A01,185416,Cao; Yingjun,0,91,10,10
1683730652749,CSE 20,A01,185445,Briones; Jor-el Thomas Caparas,3,0,25,22
1683730653774,CSE 21,A01,185447,Staff,9,0,50,41
1683730654801,CSE 101,A01,185451,Staff,0,13,50,50
1683730654801,CSE 101,B01,185453,Jones; Miles E,0,15,50,50
1683730656855,CSE 141,A01,185458,Eldon; John,16,0,100,84
1683730657879,CSE 141L,A01,185461,Eldon; John,8,0,100,92
1683730658911,CSE 142,A01,185463,Staff,34,0,60,26
1683730658911,CSE 142,B01,201355,Staff,0,7,60,60
1683730659943,CSE 142L,A01,185470,Staff,34,0,60,26
1683730659943,CSE 142L,B01,201417,Staff,0,6,60,60
1683730660972,CSE 190,A00,201433,Staff,32,0,49,17
1683730662000,DOC 1,A01,259136,Strom; Megan C.,7,0,15,8
1683730662000,DOC 1,A02,259137,Strom; Megan C.,15,0,15,0
1683730662000,DOC 1,A03,259138,Strom; Megan C.,14,0,15,1
1683730662000,DOC 1,A04,259139,Strom; Megan C.,13,0,15,2
1683730663029,DOC 100D,A00,259140,Pass; Natalye Joann,14,0,25,11
1683730664052,DSGN 1,A01,184749,Rill; Bryan,0,26,30,30
1683730665081,DSGN 100,A01,185168,Staff,0,2,25,25
1683730666112,ECE 5,A01,185626,Morris; Karcher William,0,12,0,0
1683730667138,ECE 101,A01,185628,Staff,14,0,70,56
1683730668165,ECE 107,A01,185635,Baghdadchi; Saharnaz,0,0,20,20
1683730668165,ECE 107,A02,185638,Baghdadchi; Saharnaz,1,0,20,19
1683730669189,ECE 148,A01,185647,Silberman; Jack,0,0,16,16
1683730670215,ECON 1,A01,185537,Crane; Meredith Helen,54,0,70,16
1683730671241,ECON 3,A01,185549,Crane; Meredith Helen,30,0,70,40
1683730672269,ECON 4,A01,203354,Anderson; John Charles,0,5,10,10
1683730673300,ECON 100A,A01,185574,Staff,0,5,40,40
1683730674329,ECON 100B,A01,185576,Staff,0,12,50,50
1683730675354,ECON 100C,A01,185589,Newhouse; Herbert S,30,0,70,40
1683730676387,ECON 105,A00,185608,Vespa; Emanuel Ignacio,19,0,35,16
1683730677413,ECON 109,A01,185610,Shishkin; Denis,9,0,35,26
1683730678438,ECON 110A,A01,185612,Staff,8,0,40,32
1683730679462,ECON 120A,A01,185615,Staff,19,0,40,21
1683730680489,ECON 120C,A01,185617,Sun; Yixiao,0,21,70,70
1683730681519,ECON 144,A00,203346,Squires; Dale E,2,0,35,33
1683730682545,ECON 171,A01,203349,Newhouse; Herbert S,0,1,35,35
1683730683578,ECON 173A,A01,185621,Toda; Alexis Akira,21,0,35,14
1683730684603,EDS 25,A01,202413,Staff,0,1,0,0
1683730684603,EDS 25,A02,202414,Staff,0,1,0,0
1683730684603,EDS 25,A03,202415,Staff,0,0,0,0
1683730684603,EDS 25,A04,202416,Staff,0,1,0,0
1683730684603,EDS 25,A05,202439,Staff,0,0,0,0
1683730684603,EDS 25,A06,202440,Staff,0,0,0,0
1683730684603,EDS 25,B01,202631,Staff,0,0,0,0
1683730684603,EDS 25,B02,202632,Staff,0,0,0,0
1683730684603,EDS 25,B03,202639,Staff,0,0,0,0
1683730684603,EDS 25,B04,202640,Staff,0,0,0,0
1683730684603,EDS 25,B05,202643,Staff,0,0,0,0
1683730684603,EDS 25,B06,202644,Staff,0,0,0,0
1683730685628,EDS 38,A01,202659,Black; Alison Michelle,25,0,25,0
1683730686655,EDS 115,A00,202652,Staff,18,0,30,12
1683730687679,EDS 125,A00,202649,Staff,13,0,30,17
1683730688710,EDS 126,A01,203332,Staff,30,0,30,0
1683730689737,EDS 139,A00,202838,Staff,16,0,25,9
1683730690764,EDS 146,A01,202655,Staff,14,0,25,11
1683730691790,ENG 15,A00,185667,Staff,0,1,0,0
1683730691790,ENG 15,B00,185672,Staff,0,0,0,0
1683730691790,ENG 15,C00,185675,Staff,0,0,0,0
1683730691790,ENG 15,D00,185682,Staff,0,0,0,0
1683730691790,ENG 15,E00,185684,Staff,0,0,0,0
1683730692814,ETHN 103,A00,185710,Staff,0,8,35,35
1683730693839,ETHN 103A,A00,199228,Man; Simeon S,0,0,9,9
1683730694867,ETHN 109,A00,185711,Staff,15,0,35,20
1683730695893,ETHN 142,A00,185726,Staff,0,4,30,30
1683730696919,ETHN 163J,A00,199229,Man; Simeon S,5,0,8,3
1683730697949,ETHN 168,A00,185727,Staff,7,0,10,3
1683730698975,ETHN 182,A00,185728,Staff,0,0,35,35
1683730700001,ETHN 183,A00,185737,Staff,10,0,18,8
1683730701029,GLBH 111,A01,209361,Burgos; Jose L.,0,0,0,0
1683730703085,HIEU 104,A00,185792,Staff,14,0,20,6
1683730704113,HIEU 115,A00,185800,Staff,0,0,20,20
1683730705139,HIEU 128,A00,185801,Staff,0,9,20,20
1683730706165,HIEU 147,A00,185802,Staff,15,0,20,5
1683730707196,HIEU 154,A00,185823,Staff,11,0,20,9
1683730708221,HILA 102,A00,185826,Staff,14,0,20,6
1683730709247,HILD 2C,A01,185778,Staff,0,13,20,20
1683730710276,HILD 7B,A01,185780,Kwak; Nancy,0,17,32,32
1683730710276,HILD 7B,A02,185781,Kwak; Nancy,0,18,32,32
1683730711300,HILD 30,A01,185791,Staff,12,0,20,8
1683730712330,HISC 119,A00,185830,Golan; Tal,0,10,20,20
1683730713355,HITO 156GS,A00,185831,Patterson; Patrick H.,0,0,0,23
1683730714390,HIUS 103,A00,185832,Man; Simeon S,0,4,20,20
1683730715417,HIUS 117,A00,185836,Kwak; Nancy,2,0,20,18
1683730716444,HIUS 125,A00,185840,Man; Simeon S,0,2,23,23
1683730717481,HIUS 149,A00,185845,Staff,1,0,20,19
1683730718513,HUM 3,A01,185882,Zavodny; Tatiana Sophia,0,8,50,50
1683730718513,HUM 3,B01,185899,Caldwell; Michael Alan,0,18,50,50
1683730719539,HUM 3GS,A00,185900,Patterson; Patrick H.,0,0,0,23
1683730720566,HUM 4,A01,185938,Zroka; Amy Liane,28,0,50,22
1683730720566,HUM 4,B01,185956,Watkins; Eric,0,6,50,50
1683730720566,HUM 4,B02,202209,Watkins; Eric,0,6,50,50
1683730720566,HUM 4,B03,202210,Watkins; Eric,0,5,50,50
1683730721595,HUM 5,A01,185958,West; Geoffrey Scott,0,0,50,50
1683730721595,HUM 5,A02,202215,West; Geoffrey Scott,0,1,50,50
1683730722622,INTL 190,A00,185959,Gagnon; Jeffrey C,0,0,0,9
1683730722622,INTL 190,B00,185960,Lettieri; Michael Joseph,0,0,0,2
1683730723648,JAPN 180,A00,254509,Staff,4,0,30,26
1683730724680,LATI 10,A01,202853,Kennemore; Amy Michelle,4,0,35,31
1683730724680,LATI 10,A02,202854,Kennemore; Amy Michelle,3,0,35,32
1683730724680,LATI 10,A03,270054,Kennemore; Amy Michelle,30,0,30,0
1683730725705,LATI 180,A00,202855,Kennemore; Amy Michelle,11,0,20,9
1683730726731,LAWS 101,A00,201767,Golan; Tal,0,7,40,40
1683730727757,LIFR 1C,A00,185961,Staff,6,0,20,14
1683730728783,LIFR 1CX,A00,185962,Staff,7,0,20,13
1683730729809,LIFR 1D,A00,185963,Staff,7,0,20,13
1683730730835,LIFR 1DX,A00,185964,Staff,7,0,20,13
1683730731863,LIGN 101,A01,186039,Staff,43,0,50,7
1683730732888,LIGN 165,A00,186040,Staff,14,0,50,36
1683730733914,LTCS 108,A00,186041,Staff,5,0,10,5
1683730734940,LTCS 119,A00,186042,Staff,15,0,20,5
1683730735970,LTCS 130,A00,186043,Wesling; Megan E.,15,0,25,10
1683730738024,LTEA 138,A00,186119,Staff,13,0,40,27
1683730739052,LTEN 124,A00,186148,Staff,5,0,25,20
1683730740078,LTEN 178,A00,186149,Staff,6,0,15,9
1683730741103,LTEN 181,A00,186150,Blanco; John D,34,0,40,6
1683730742128,LTWL 120,A00,186160,Staff,19,0,25,6
1683730743157,LTWL 165,A00,186161,Staff,22,0,25,3
1683730744182,LTWR 100,A00,186162,Staff,0,5,15,15
1683730745220,LTWR 102,A00,186163,Doller; Ben,5,0,15,10
1683730746251,MAE 8,A01,186412,Staff,0,1,0,0
1683730747279,MAE 30B,A00,186445,Bahadori; Mohammad Yousef,81,0,100,19
1683730748304,MAE 40,A00,186592,Bewley; Thomas R,10,0,50,40
1683730749332,MAE 101B,A00,186593,Bahadori; Mohammad Yousef,80,0,100,20
1683730750411,MAE 105,A00,186594,Bandaru; Prabhakar,10,0,50,40
1683730751437,MAE 107,A00,186599,Pham; Hieu Tan,0,8,120,120
1683730752466,MAE 148,A01,186660,Silberman; Jack,3,0,16,13
1683730753492,MATH 10A,A01,188095,Staff,0,6,35,35
1683730754521,MATH 10B,A01,188097,Bowers; Adam R.,0,12,30,30
1683730754521,MATH 10B,A02,188099,Bowers; Adam R.,0,11,30,30
1683730754521,MATH 10B,B01,188104,Bowers; Adam R.,0,10,30,30
1683730754521,MATH 10B,B02,188106,Bowers; Adam R.,0,9,30,30
1683730755547,MATH 10C,A01,188111,Staff,0,20,30,30
1683730755547,MATH 10C,A02,188127,Staff,0,19,30,30
1683730755547,MATH 10C,A03,188131,Staff,0,19,30,30
1683730755547,MATH 10C,B01,188218,Staff,17,0,30,13
1683730755547,MATH 10C,B02,188244,Staff,13,0,30,17
1683730755547,MATH 10C,B03,188277,Staff,14,0,30,16
1683730756577,MATH 18,A01,188344,Bach; Quang Tran,18,0,30,12
1683730756577,MATH 18,A02,188345,Bach; Quang Tran,11,0,30,19
1683730756577,MATH 18,B01,188353,Bach; Quang Tran,11,0,30,19
1683730756577,MATH 18,B02,188354,Bach; Quang Tran,19,0,30,11
1683730757602,MATH 20A,A01,188374,Staff,10,0,35,25
1683730758628,MATH 20B,A01,188382,Ohm; Ko Woon,7,0,30,23
1683730758628,MATH 20B,A02,188383,Ohm; Ko Woon,22,0,30,8
1683730758628,MATH 20B,B01,188385,Ohm; Ko Woon,7,0,30,23
1683730758628,MATH 20B,B02,188392,Ohm; Ko Woon,22,0,30,8
1683730759658,MATH 20C,A01,188394,Harel; Guershon,10,0,30,20
1683730759658,MATH 20C,A02,188395,Harel; Guershon,13,0,30,17
1683730759658,MATH 20C,B01,188404,Harel; Guershon,5,0,30,25
1683730759658,MATH 20C,B02,188405,Harel; Guershon,18,0,30,12
1683730760686,MATH 20D,A01,188414,Hammock; Frances H,0,1,30,30
1683730760686,MATH 20D,A02,188415,Hammock; Frances H,0,1,30,30
1683730760686,MATH 20D,B01,188447,Hammock; Frances H,0,1,30,30
1683730760686,MATH 20D,B02,188486,Hammock; Frances H,2,0,30,28
1683730761715,MATH 20E,A01,188649,Staff,21,0,30,9
1683730761715,MATH 20E,A02,188650,Staff,20,0,30,10
1683730761715,MATH 20E,A03,188673,Staff,0,0,30,30
1683730762740,MATH 102,A01,188675,Staff,0,40,35,35
1683730763766,MATH 103B,A01,188681,Staff,3,0,35,32
1683730763766,MATH 103B,B01,188692,Staff,5,0,35,30
1683730764793,MATH 109,A01,188695,Salehi Golsefidy; Alireza,24,0,35,11
1683730764793,MATH 109,A02,188696,Salehi Golsefidy; Alireza,24,0,35,11
1683730765819,MATH 120A,A01,188698,Eggers; John Dietrich,7,0,35,28
1683730766847,MATH 142B,A01,188736,Ioana; Adrian,0,0,30,30
1683730766847,MATH 142B,A02,188741,Ioana; Adrian,0,1,30,30
1683730766847,MATH 142B,A03,188743,Ioana; Adrian,0,3,30,30
1683730767873,MATH 168A,A01,188790,Staff,0,11,35,35
1683730768899,MATH 170A,A01,188803,Nie; Jiawang,0,2,35,35
1683730768899,MATH 170A,A02,188811,Nie; Jiawang,0,1,35,35
1683730768899,MATH 170A,A03,188814,Nie; Jiawang,1,0,35,34
1683730768899,MATH 170A,A04,188815,Nie; Jiawang,5,0,35,30
1683730769929,MATH 193B,A01,188817,Staff,0,0,35,35
1683730769929,MATH 193B,A02,188818,Staff,6,0,35,29
1683730770955,MGT 4,A01,202857,Anderson; John Charles,59,0,80,21
1683730771982,MGT 12,A00,202858,Lindenberger; Wade Douglas,40,0,90,50
1683730773009,MGT 18,A00,202859,Staff,73,0,90,17
1683730774035,MGT 18GS,A00,202860,McKay; Michael J,13,0,28,15
1683730775063,MGT 45,A00,202861,Pecore; Joseph P.,8,0,90,82
1683730776086,MGT 100,A00,202863,Yavorsky; Daniel Ryan,27,0,90,63
1683730777110,MGT 103,A00,202864,Ehrich; Kristine R,0,19,90,90
1683730778134,MGT 112,A00,202865,Ehrich; Kristine R,15,0,90,75
1683730779159,MGT 121A,A00,202868,Staff,70,0,90,20
1683730780187,MGT 131B,A00,202869,Anderson; John Charles,58,0,90,32
1683730781213,MGT 136,A00,202871,Lindenberger; Wade Douglas,83,0,90,7
1683730782237,MGT 164,A00,202873,Staff,0,67,90,91
1683730783265,MGT 164GS,A00,202874,McKay; Mary A,13,0,28,15
1683730784290,MGT 180,A00,202875,Staff,0,51,90,91
1683730785317,MMW 11R,A01,205019,Herbst; Matthew,0,0,30,30
1683730785317,MMW 11R,A02,205026,Herbst; Matthew,29,0,30,1
1683730786346,MMW 15,A01,193512,Chang; Edmond Yi-Teh,0,8,28,28
1683730786346,MMW 15,A02,193513,Chang; Edmond Yi-Teh,0,5,28,28
1683730786346,MMW 15,A03,193514,Chang; Edmond Yi-Teh,0,5,28,28
1683730786346,MMW 15,A04,193515,Chang; Edmond Yi-Teh,0,5,28,28
1683730786346,MMW 15,A05,193516,Chang; Edmond Yi-Teh,0,5,28,28
1683730786346,MMW 15,A06,193517,Chang; Edmond Yi-Teh,0,6,28,28
1683730786346,MMW 15,B01,193519,Chang; Edmond Yi-Teh,0,5,28,28
1683730786346,MMW 15,B02,193520,Chang; Edmond Yi-Teh,0,5,28,28
1683730786346,MMW 15,B03,193521,Chang; Edmond Yi-Teh,0,5,28,28
1683730786346,MMW 15,B04,193522,Chang; Edmond Yi-Teh,0,6,28,28
1683730786346,MMW 15,B05,193523,Chang; Edmond Yi-Teh,0,5,28,28
1683730786346,MMW 15,B06,193524,Chang; Edmond Yi-Teh,0,5,28,28
1683730787373,MMW 122,A01,193526,Rahimi; Babak,0,16,28,28
1683730787373,MMW 122,A02,193527,Rahimi; Babak,0,15,28,28
1683730787373,MMW 122,A03,193528,Rahimi; Babak,0,0,0,0
1683730787373,MMW 122,A04,193529,Rahimi; Babak,0,0,0,0
1683730788397,MUS 1A,A01,186663,Staff,0,18,35,35
1683730789422,MUS 4,A01,186715,Staff,0,12,35,35
1683730790454,MUS 5R,A01,186796,Dubnov; Shlomo,0,17,35,35
1683730791480,MUS 6,A01,186798,Staff,0,4,25,25
1683730792504,MUS 7,A01,186830,Staff,11,0,35,24
1683730793531,MUS 8,A01,186930,Staff,0,27,35,35
1683730794556,MUS 15,A01,186932,Staff,0,15,35,35
1683730794556,MUS 15,B01,186934,Staff,0,16,35,35
1683730795583,MUS 80,A00,186935,Staff,0,0,20,20
1683730795583,MUS 80,B00,186936,Staff,24,0,25,1
1683730796612,NANO 11,A00,204702,Lipomi; Darren John,0,0,0,0
1683730797640,NANO 15,A01,204709,Yang; Kesong,0,1,0,0
1683730798664,NANO 114,A00,202069,Jahed Motlagh; Zeinab,2,0,10,8
1683730799688,PHIL 1,A00,186955,Grush; Rick Scott,31,0,40,9
1683730800716,PHIL 10,A01,186973,Grush; Rick Scott,27,0,35,8
1683730800716,PHIL 10,A02,186974,Grush; Rick Scott,33,0,35,2
1683730801742,PHIL 13,A01,186976,Staff,1,0,35,34
1683730801742,PHIL 13,A02,186977,Staff,16,0,35,19
1683730802767,PHIL 14,A01,186979,Staff,30,0,35,5
1683730802767,PHIL 14,A02,186986,Staff,32,0,35,3
1683730803795,PHIL 28,A01,186988,Staff,16,0,30,14
1683730803795,PHIL 28,A02,186989,Staff,0,0,30,30
1683730803795,PHIL 28,A03,186990,Staff,10,0,30,20
1683730803795,PHIL 28,A04,186991,Staff,26,0,30,4
1683730804822,PHIL 120,A00,186997,Staff,23,0,40,17
1683730805845,PHIL 137,A00,187003,Staff,8,0,40,32
1683730806869,PHIL 150,A00,187015,Staff,47,0,70,23
1683730807895,PHIL 167,A00,187021,Lamey; Andy M.,34,0,40,6
1683730808920,PHIL 174,A01,202226,Staff,17,0,20,3
1683730808920,PHIL 174,A02,202235,Staff,20,0,20,0
1683730813276,PHIL 191A,A00,258918,Staff,0,0,1,1
1683730814307,PHYS 1A,A00,187028,Staff,26,0,60,34
1683730815335,PHYS 1AL,001,187036,Staff,3,0,30,27
1683730815335,PHYS 1AL,002,187049,Staff,18,0,30,12
1683730816359,PHYS 1B,A00,187058,Staff,21,0,60,39
1683730817386,PHYS 1BL,001,187064,Staff,0,1,30,30
1683730817386,PHYS 1BL,002,187070,Staff,4,0,30,26
1683730818410,PHYS 1C,A00,187082,Staff,30,0,120,90
1683730819435,PHYS 1CL,001,187088,Staff,0,9,30,30
1683730819435,PHYS 1CL,002,187089,Staff,0,1,30,30
1683730819435,PHYS 1CL,009,262693,Staff,9,0,30,21
1683730820458,PHYS 2B,A01,187097,Staff,55,0,115,60
1683730821483,PHYS 2C,A01,187099,Staff,63,0,115,52
1683730822511,PHYS 2CL,A01,187101,Staff,5,0,28,23
1683730822511,PHYS 2CL,A02,187102,Staff,15,0,28,13
1683730823538,PHYS 2D,A01,187123,Shotwell; Brian,95,0,115,20
1683730824566,PHYS 4B,A01,187133,Grinstein; Benjamin,35,0,50,15
1683730825589,POLI 10,A00,188819,Staff,0,4,50,50
1683730826618,POLI 11,A00,188827,Staff,43,0,50,7
1683730827640,POLI 13R,A00,188828,Staff,0,2,20,20
1683730828664,POLI 27,A01,188830,Elgin; Samuel Zincke,0,2,70,70
1683730829688,POLI 30,A00,188832,Desposato; Scott,30,0,50,20
1683730830716,POLI 102F,A00,188834,Staff,1,0,40,39
1683730831743,POLI 104A,A00,188852,Staff,12,0,30,18
1683730832770,POLI 104I,A00,188853,Staff,0,8,20,20
1683730833794,POLI 110B,A00,188854,Wiens; David,6,0,20,14
1683730834820,POLI 112A,A00,188855,Wiens; David,3,0,30,27
1683730835844,POLI 117R,A00,188856,Forman; Fonna,0,12,20,20
1683730836872,POLI 118,A00,188857,Ingham; Sean,8,0,20,12
1683730837897,POLI 120G,A00,188858,Staff,7,0,30,23
1683730838921,POLI 131CR,A00,188863,Hoston; Germaine,20,0,50,30
1683730839944,POLI 133,A00,188864,Nellis; Gareth Hb,44,0,50,6
1683730840968,POLI 134D,A00,188865,Desposato; Scott,27,0,30,3
1683730841993,POLI 142A,A00,188871,Gartzke; Erik,21,0,50,29
1683730843017,POLI 142K,A00,188874,Staff,38,0,50,12
1683730844044,POLI 143,A00,188940,Gartzke; Erik,15,0,30,15
1683730845068,POLI 153,A00,188943,Staff,1,0,20,19
1683730846095,POLI 160AA,A00,188944,Staff,10,0,40,30
1683730847118,POLI 170A,A00,188945,Staff,10,0,30,20
1683730849167,PSYC 1,A00,188952,Staff,36,0,90,54
1683730850190,PSYC 2,B00,188953,Staff,19,0,35,16
1683730851216,PSYC 6,A00,188970,Staff,47,0,60,13
1683730852243,PSYC 7,A00,188973,Staff,35,0,45,10
1683730853267,PSYC 60,A01,188980,Rickard; Timothy C.,42,0,60,18
1683730854293,PSYC 70,A01,189001,Steiner; Eric Tomas,21,0,45,24
1683730855323,PSYC 100,A00,189005,Lacefield; Katharine I,1,98,120,119
1683730856349,PSYC 102,A00,189008,Staff,6,0,30,24
1683730857427,PSYC 106,B00,189026,Gorman; Michael R.,27,0,60,33
1683730858455,PSYC 114,B01,189033,Winkielman; Piotr,0,31,30,30
1683730859478,PSYC 131,A00,189036,Anagnostaras; Stephan,0,44,60,60
1683730860504,PSYC 136,A00,189041,Lowe; Angela Beth,0,7,25,25
1683730861533,PSYC 137,A00,189057,Winkielman; Piotr,0,36,25,25
1683730862558,PSYC 144,A00,189107,Wixted; John T,0,11,50,50
1683730864610,PSYC 162,A00,189142,Staff,0,9,85,85
1683730865633,PSYC 172,A00,189144,Gorman; Michael R.,0,6,30,30
1683730867686,PSYC 179,A00,189146,Lacefield; Katharine I,0,88,120,120
1683730868714,PSYC 181,A00,189147,Anagnostaras; Stephan,0,45,90,90
1683730869738,PSYC 190R,A00,189148,Barner; David A.,0,23,80,80
1683730870773,PSYC 191,A00,189275,Rickard; Timothy C.,0,11,25,25
1683730871797,PSYC 193,A00,189276,Chapman; Eddie Nathaniel,0,1,0,4
1683730872822,PSYC 193L,A01,189281,Lowe; Angela Beth,8,0,20,12
1683730872822,PSYC 193L,B01,189285,Staff,28,0,35,7
1683730873849,RELI 149,A00,187137,Rahimi; Babak,6,0,40,34
1683730874875,SE 9,A01,187315,Staff,0,2,18,18
1683730875900,SE 101B,A00,187409,Staff,24,0,30,6
1683730876924,SE 110B,A00,187444,Staff,10,0,40,30
1683730877952,SE 130B,A00,187449,Staff,31,0,40,9
1683730878979,SE 150A,A00,187516,Staff,8,0,20,12
1683730880006,SE 154,A00,187528,Staff,29,0,50,21
1683730881030,SIO 3,A01,258171,Staff,35,0,40,5
1683730882053,SIO 10,A00,187144,Cook; Geoffrey W,0,6,75,75
1683730883080,SIO 45,A00,187152,Cook; Geoffrey W,1,7,100,99
1683730884104,SIO 109R,A00,194486,Staff,0,4,20,20
1683730886158,SIO 187,A01,187233,Kacev; David,12,0,40,28
1683730887188,SOCI 1,A01,258656,Thorpe; Charles Robert,28,0,30,2
1683730887188,SOCI 1,A02,258658,Thorpe; Charles Robert,30,0,30,0
1683730887188,SOCI 1,A03,258661,Thorpe; Charles Robert,25,0,25,0
1683730887188,SOCI 1,A04,258666,Thorpe; Charles Robert,22,0,25,3
1683730887188,SOCI 1,A05,258897,Thorpe; Charles Robert,22,0,25,3
1683730887188,SOCI 1,A06,258898,Thorpe; Charles Robert,25,0,25,0
1683730888215,SOCI 30,A01,258903,Pardo Guerra; Juan Pablo,14,0,30,16
1683730889240,SOCI 102,A00,258904,Staff,9,0,25,16
1683730890265,SOCI 106,A00,258905,Staff,19,0,25,6
1683730891289,SOCI 111,A00,258907,Ribas Norris; Janet Vanesa,26,0,30,4
1683730892316,SOCI 121R,A00,258908,Pardo Guerra; Juan Pablo,7,0,30,23
1683730893340,SOCI 126,A01,203330,Staff,14,0,20,6
1683730894364,SOCI 131,A00,258909,Thorpe; Charles Robert,30,0,60,30
1683730895391,SOCI 135,A00,258910,Payne; Christine Anna,0,13,30,30
1683730896418,SOCI 157,A00,258911,Staff,10,0,30,20
1683730897442,SOCI 184,A00,258912,Staff,25,0,30,5
1683730898466,SOCI 188D,A00,258913,Staff,22,0,30,8
1683730899490,SYN 2,001,187529,Staff,9,0,16,7
1683730899490,SYN 2,002,201452,Staff,0,20,16,16
1683730899490,SYN 2,003,201469,Staff,1,0,16,15
1683730900515,SYN 100,A01,187531,Staff,0,9,20,20
1683730900515,SYN 100,B01,201491,Staff,0,10,20,20
1683730901544,TDAC 1,A00,189286,Walsh; Kim C.,3,0,20,17
1683730901544,TDAC 1,B00,189287,Harting; Carla Kelso,10,0,20,10
1683730902571,TDAC 101,A00,189300,Walsh; Kim C.,16,0,20,4
1683730902571,TDAC 101,B00,189301,Harting; Carla Kelso,18,0,20,2
1683730903595,TDAC 102,A00,189304,Basso; Beatrice,14,0,20,6
1683730904622,TDAC 108,A00,189305,Staff,18,0,20,2
1683730905649,TDDE 131,A00,189310,Staff,19,0,20,1
1683730905649,TDDE 131,B00,189314,Staff,19,0,20,1
1683730905649,TDDE 131,C00,189315,Staff,48,0,50,2
1683730905649,TDDE 131,D00,189316,Staff,14,0,15,1
1683730905649,TDDE 131,E00,204841,Staff,20,0,20,0
1683730906678,TDGE 10,A00,189289,Staff,26,0,50,24
1683730906678,TDGE 10,B00,189290,Havis; Allan,0,1,50,50
1683730907707,TDGE 11,A00,189291,Fulton; Julia,0,4,50,50
1683730907707,TDGE 11,B00,189292,Staff,20,0,25,5
1683730907707,TDGE 11,C00,260270,Staff,0,0,0,0
1683730908732,TDGE 25,A00,189294,Staff,1,0,20,19
1683730909760,TDGE 124,A00,189318,Fulton; Julia,0,7,50,50
1683730910785,TDGE 125,A00,189319,Staff,13,0,25,12
1683730910785,TDGE 125,B00,189320,Staff,23,0,25,2
1683730911811,TDGE 127,A00,189322,Havis; Allan,1,0,50,49
1683730912837,TDHT 101,A00,189323,Staff,18,0,25,7
1683730912837,TDHT 101,B00,189324,Staff,25,0,25,0
1683730913862,TDHT 102,A00,189325,Staff,49,0,50,1
1683730914890,TDMV 1,A00,189295,Arcidiacono; Kristin,20,0,30,10
1683730914890,TDMV 1,B00,189296,Caligagan; Maria T.,23,0,30,7
1683730915918,TDMV 2,A00,189297,Sammartano; Tonnie,27,0,30,3
1683730915918,TDMV 2,B00,189299,Arcidiacono; Kristin,23,0,30,7
1683730916949,TDMV 3,A00,204998,Rincon; Alicia,22,0,30,8
1683730917972,TDMV 120,A00,189458,Sammartano; Tonnie,28,0,30,2
1683730919000,TDMV 138,A00,189541,Jun; Grace Shin Hae,20,0,40,20
1683730920026,TDMV 142,A00,189717,Caligagan; Tony,25,0,30,5
1683730920026,TDMV 142,B00,189718,Caligagan; Maria T.,25,0,30,5
1683730921056,TMC 2,A01,187533,Staff,25,0,25,0
1683730921056,TMC 2,A02,187534,Staff,25,0,25,0
1683730922082,USP 1,A01,187536,Kwak; Nancy,0,16,25,25
1683730923106,USP 5,A01,187538,Staff,8,0,25,17
1683730924129,USP 101,A00,199253,Staff,0,4,0,0
1683730925154,USP 124,A00,187562,Boomhower; Matthew Charles,0,0,30,30
1683730926182,USP 138,A00,187582,Staff,19,0,25,6
1683730927214,USP 152,A01,187597,Staff,3,0,25,22
1683730928239,USP 153,A00,187598,Staff,18,0,25,7
1683730929267,USP 168,A00,187607,Kwak; Nancy,2,0,5,3
1683730930292,USP 173,A00,187619,Staff,4,0,25,21
1683730931320,USP 181,A00,187638,Staff,0,4,25,25
1683730932344,VIS 103,A00,187650,Cruz; Edwin Teddy,17,0,75,58
1683730933368,VIS 110D,A00,187669,Staff,13,0,22,9
1683730934402,VIS 127C,A00,187720,Shen; Kuiyi,67,0,146,79
1683730935430,VIS 149,A00,187731,Yoldas; Pinar,0,12,22,22
1683730936460,VIS 151,A01,188091,Staff,22,0,34,12
1683730936460,VIS 151,A02,188092,Staff,11,0,34,23
1683730937495,VIS 160B,A00,188093,Stalbaum; Brett,0,1,10,10
1683730939544,WCWP 10B,A00,201720,Staff,0,0,5,5
1683730939544,WCWP 10B,B00,201722,Staff,0,0,6,6
1683730940569,WCWP 100,A00,201725,Gagnon; Jeffrey C,0,0,2,2
1683730940569,WCWP 100,B00,201727,Staff,0,4,15,15
1683730943685,ANBI 133,A00,258401,Wilder; Linnea Lorene,34,0,40,6
1683730944709,ANBI 140,A00,258395,Hrvoj Mihic; Branka,18,0,25,7
1683730945737,ANSC 120,A00,258402,Bialecki; Jon Anthony,26,0,40,14
1683730946765,ANSC 144,A00,258400,Staff,12,0,40,28
1683730948817,ANSC 166,A00,258396,Parish; Steven Martin,156,0,175,19
1683730949842,ANSC 180,A00,193533,Staff,8,0,20,12
1683730950867,ANSC 188,A00,258397,Jassal; Aftab,34,0,40,6
1683730951892,ANTH 3,A01,258316,Staff,23,0,30,7
1683730952918,ANTH 5,A00,258394,Semendeferi; Ekaterini,16,0,20,4
1683730953946,ANTH 21,A01,258331,Staff,4,0,40,36
1683730954971,ANTH 103,A00,258398,Varma; Saiba,15,0,25,10
1683730955998,AWP 10,001,202034,Staff,0,0,0,0
1683730955998,AWP 10,002,202035,Staff,0,0,0,0
1683730955998,AWP 10,003,202036,Staff,0,0,0,0
1683730955998,AWP 10,004,202037,Staff,0,0,0,0
1683730955998,AWP 10,005,202038,Staff,0,0,0,0
1683730955998,AWP 10,006,202039,Staff,0,0,0,0
1683730955998,AWP 10,007,202040,Staff,0,0,0,0
1683730955998,AWP 10,008,202041,Staff,0,0,0,0
1683730955998,AWP 10,009,202042,Staff,0,0,0,0
1683730955998,AWP 10,010,202043,Staff,0,0,0,0
1683730955998,AWP 10,011,202044,Staff,0,0,0,0
1683730955998,AWP 10,012,202045,Staff,0,0,0,0
1683730955998,AWP 10,013,202046,Staff,0,0,0,0
1683730955998,AWP 10,014,202047,Staff,0,0,0,0
1683730955998,AWP 10,015,202048,Staff,0,0,0,0
1683730955998,AWP 10,016,202049,Staff,0,0,0,0
1683730955998,AWP 10,017,202050,Staff,0,0,0,0
1683730955998,AWP 10,018,202051,Staff,0,0,0,0
1683730955998,AWP 10,019,202052,Staff,0,0,0,0
1683730955998,AWP 10,020,202053,Staff,0,0,0,0
1683730955998,AWP 10,021,202054,Staff,0,0,0,0
1683730955998,AWP 10,022,202055,Staff,0,0,0,0
1683730955998,AWP 10,023,202056,Staff,0,0,0,0
1683730955998,AWP 10,024,202057,Staff,0,0,0,0
1683730955998,AWP 10,025,202058,Staff,0,0,0,0
1683730955998,AWP 10,026,202059,Staff,0,0,0,0
1683730957026,AWP 102,001,202032,Staff,0,0,0,0
1683730957026,AWP 102,002,202033,Staff,0,0,0,0
1683730958053,BENG 100,A01,254234,Taylor Amos; Alyssa C,31,0,40,9
1683730959079,BENG 196,001,270013,Engler; Adam J.,9999,0,9999,0
1683730960105,BICD 100R,A01,202018,Smith; Laurie,0,7,32,32
1683730960105,BICD 100R,A02,202019,Smith; Laurie,0,3,32,32
1683730960105,BICD 100R,A03,202020,Smith; Laurie,0,1,32,32
1683730960105,BICD 100R,A04,202021,Smith; Laurie,6,0,32,26
1683730960105,BICD 100R,A05,202022,Smith; Laurie,10,0,32,22
1683730961206,BICD 136,A01,193242,Gustafson-Brown; Cindy,0,2,32,32
1683730961206,BICD 136,A02,193244,Gustafson-Brown; Cindy,13,0,32,19
1683730962231,BIEB 102,A01,193249,Butler; Shannon Rhey,0,0,32,32
1683730962231,BIEB 102,A02,193251,Butler; Shannon Rhey,0,0,32,32
1683730962231,BIEB 102,A03,193253,Butler; Shannon Rhey,0,0,32,32
1683730962231,BIEB 102,A04,193255,Butler; Shannon Rhey,13,0,32,19
1683730962231,BIEB 102,A05,193265,Butler; Shannon Rhey,25,0,32,7
1683730962231,BIEB 102,A06,193269,Butler; Shannon Rhey,12,0,32,20
1683730964285,BIEB 150,A01,193274,Staff,0,0,32,32
1683730964285,BIEB 150,A02,193285,Staff,24,0,32,8
1683730965310,BIEB 194,A00,193286,Kurle; Carolyn M.,19,0,32,13
1683730966336,BILD 1,A01,192291,Staff,15,0,32,17
1683730966336,BILD 1,A02,192292,Staff,30,0,32,2
1683730966336,BILD 1,B01,192520,Reuther; Keefe,0,1,0,0
1683730966336,BILD 1,B02,192532,Reuther; Keefe,0,1,0,0
1683730967362,BILD 3,A01,192556,Butler; Shannon Rhey,0,0,32,32
1683730967362,BILD 3,A02,192581,Butler; Shannon Rhey,0,1,32,32
1683730967362,BILD 3,A03,192611,Butler; Shannon Rhey,19,0,32,13
1683730967362,BILD 3,A04,192612,Butler; Shannon Rhey,23,0,32,9
1683730967362,BILD 3,A05,192613,Butler; Shannon Rhey,26,0,32,6
1683730967362,BILD 3,A06,192679,Butler; Shannon Rhey,27,0,32,5
1683730967362,BILD 3,A07,192682,Butler; Shannon Rhey,20,0,32,12
1683730968407,BILD 4,A01,192836,Reuther; Keefe,1,0,24,23
1683730968407,BILD 4,A02,193044,Reuther; Keefe,4,0,24,20
1683730969431,BILD 10,A01,193142,Gustafson-Brown; Cindy,29,0,32,3
1683730969431,BILD 10,A02,193149,Gustafson-Brown; Cindy,31,0,32,1
1683730970457,BIMM 100,A01,193301,Staff,0,6,32,32
1683730970457,BIMM 100,A02,193312,Staff,0,7,32,32
1683730970457,BIMM 100,A03,193323,Staff,0,10,32,32
1683730971483,BIMM 101,A01,193329,McDonnell; Lisa Marie,0,3,24,24
1683730971483,BIMM 101,A02,193339,McDonnell; Lisa Marie,0,3,24,24
1683730971483,BIMM 101,B01,193354,McDonnell; Lisa Marie,0,4,24,24
1683730971483,BIMM 101,B02,193357,McDonnell; Lisa Marie,0,3,24,24
1683730972512,BIMM 110,A01,193377,Tat; John,0,11,32,32
1683730972512,BIMM 110,A02,193378,Tat; John,0,11,32,32
1683730973537,BIMM 120,A01,206116,Staff,0,0,32,32
1683730973537,BIMM 120,A02,206117,Staff,7,0,32,25
1683730973537,BIMM 120,A03,206121,Staff,21,0,32,11
1683730974567,BIPN 100,A01,193393,Park; Ji Young,0,15,32,32
1683730974567,BIPN 100,A02,193402,Park; Ji Young,0,14,32,32
1683730974567,BIPN 100,A03,193413,Park; Ji Young,0,14,32,32
1683730974567,BIPN 100,A04,193414,Park; Ji Young,0,13,32,32
1683730975592,BIPN 102,A01,193429,Staff,0,0,32,32
1683730975592,BIPN 102,A02,193438,Staff,18,0,32,14
1683730976620,BIPN 106,A01,193450,Reyes Gonzalez; Catalina,0,2,40,40
1683730977648,BIPN 134,A01,193465,Cooke; James Edward,0,0,32,32
1683730977648,BIPN 134,A02,193474,Cooke; James Edward,25,0,32,7
1683730977648,BIPN 134,A03,193485,Cooke; James Edward,29,0,32,3
1683730977648,BIPN 134,A04,193486,Cooke; James Edward,20,0,32,12
1683730977648,BIPN 134,A05,193491,Cooke; James Edward,31,0,32,1
1683730977648,BIPN 134,A06,193501,Cooke; James Edward,30,0,32,2
1683730977648,BIPN 134,A07,193510,Cooke; James Edward,29,0,32,3
1683730979698,BISP 194,A00,222522,Staff,14,0,32,18
1683730980724,CAT 124,A01,202407,Staff,19,0,25,6
1683730981749,CAT 125,A00,202408,Marchisotto; Jennifer Anne,2,0,20,18
1683730982774,CAT 125R,A00,202409,Smith; Lauryn Alissa,0,11,20,20
1683730982774,CAT 125R,B00,202410,Morales; Celeste Georgianna,0,11,20,20
1683730982774,CAT 125R,C00,202411,Irwin; Matthew Joseph,0,12,20,20
1683730983800,CENG 15,A01,204712,Yang; Kesong,0,1,0,0
1683730984825,CENG 114,A00,202070,Jahed Motlagh; Zeinab,5,0,20,15
1683730985853,CGS 105,A00,185477,Wesling; Megan E.,24,0,40,16
1683730986878,CGS 106,A00,185494,Staff,11,0,22,11
1683730987904,CGS 108,A00,185495,Staff,14,0,20,6
1683730988929,CGS 114,A00,185496,Staff,13,0,18,5
1683730989953,CGS 119,A00,185501,Staff,15,0,20,5
1683730990978,CGS 120,A00,185511,Staff,11,0,20,9
1683730992007,CHEM 4,A01,184675,Bussey; Thomas J,97,0,100,3
1683730993035,CHEM 6A,A01,184677,Staff,32,0,60,28
1683730994062,CHEM 6B,A01,184679,Staff,63,0,100,37
1683730995088,CHEM 6C,A01,184681,Bussey; Thomas J,0,0,50,50
1683730995088,CHEM 6C,A02,184682,Bussey; Thomas J,32,0,50,18
1683730996111,CHEM 40A,A01,184684,Albizati; Kim F.,33,0,100,67
1683730997136,CHEM 40B,A01,184686,Albizati; Kim F.,0,22,100,100
1683730998160,CHEM 41B,A01,184690,Staff,51,0,100,49
1683730999188,COGS 3,A01,184715,Boyle; Mary E. T.,0,27,40,40
1683731000213,COGS 14B,A01,185172,Staff,0,14,38,38
1683731001238,COGS 18,A01,184736,Staff,14,0,80,66
1683731002266,COGS 100,A01,184932,Staff,0,8,73,73
1683731003294,COGS 101A,A01,184935,Staff,0,40,30,30
1683731004322,COGS 101B,A01,184944,Staff,0,2,30,30
1683731005347,COGS 101C,A01,184946,Staff,0,10,30,30
1683731006371,COGS 102A,A01,184951,Johnson; Christine M.,1,0,40,39
1683731007397,COGS 107B,A01,184953,Mooshagian; Eric Frederick,0,52,40,40
1683731008423,COGS 118B,A01,184959,Gupta; Anjum,0,50,40,40
1683731009453,COGS 153,A00,184961,Staff,1,16,30,29
1683731010483,COGS 177,A00,184962,Staff,0,20,30,30
1683731011512,COGS 187A,A01,184969,Boyle; Mary E. T.,0,19,40,40
1683731012537,COMM 10,A01,185174,Staff,0,5,25,25
1683731012537,COMM 10,A02,185189,Staff,0,2,25,25
1683731012537,COMM 10,A03,269821,Staff,0,1,0,0
1683731013562,COMM 100B,A02,185476,Staff,10,0,25,15
1683731013562,COMM 100B,A03,277340,Staff,25,0,25,0
1683731014589,COMM 100C,A01,185314,Staff,2,0,25,23
1683731014589,COMM 100C,A02,185327,Staff,17,0,25,8
1683731015613,COMM 110M,A00,185349,Staff,0,0,40,40
1683731016641,COMM 113T,A00,185352,Staff,25,0,40,15
1683731017668,COMM 114I,A00,185353,Staff,31,0,40,9
1683731018691,COMM 131,A00,185354,Staff,17,0,30,13
1683731019716,CSE 8A,A50,185358,Cao; Yingjun,0,46,10,10
1683731020741,CSE 8B,A01,185362,Staff,0,48,50,50
1683731021769,CSE 11,A01,185416,Cao; Yingjun,0,91,10,10
1683731022794,CSE 20,A01,185445,Briones; Jor-el Thomas Caparas,3,0,25,22
1683731023821,CSE 21,A01,185447,Staff,9,0,50,41
1683731024846,CSE 101,A01,185451,Staff,0,13,50,50
1683731024846,CSE 101,B01,185453,Jones; Miles E,0,15,50,50
1683731026896,CSE 141,A01,185458,Eldon; John,16,0,100,84
1683731027921,CSE 141L,A01,185461,Eldon; John,8,0,100,92
1683731028949,CSE 142,A01,185463,Staff,34,0,60,26
1683731028949,CSE 142,B01,201355,Staff,0,7,60,60
1683731029976,CSE 142L,A01,185470,Staff,34,0,60,26
1683731029976,CSE 142L,B01,201417,Staff,0,6,60,60
1683731031001,CSE 190,A00,201433,Staff,32,0,49,17
1683731032027,DOC 1,A01,259136,Strom; Megan C.,7,0,15,8
1683731032027,DOC 1,A02,259137,Strom; Megan C.,15,0,15,0
1683731032027,DOC 1,A03,259138,Strom; Megan C.,14,0,15,1
1683731032027,DOC 1,A04,259139,Strom; Megan C.,13,0,15,2
1683731033059,DOC 100D,A00,259140,Pass; Natalye Joann,14,0,25,11
1683731034087,DSGN 1,A01,184749,Rill; Bryan,0,26,30,30
1683731035112,DSGN 100,A01,185168,Staff,0,2,25,25
1683731036137,ECE 5,A01,185626,Morris; Karcher William,0,12,0,0
1683731037166,ECE 101,A01,185628,Staff,14,0,70,56
1683731038190,ECE 107,A01,185635,Baghdadchi; Saharnaz,0,0,20,20
1683731038190,ECE 107,A02,185638,Baghdadchi; Saharnaz,1,0,20,19
1683731039218,ECE 148,A01,185647,Silberman; Jack,0,0,16,16
1683731040243,ECON 1,A01,185537,Crane; Meredith Helen,54,0,70,16
1683731041268,ECON 3,A01,185549,Crane; Meredith Helen,30,0,70,40
1683731042293,ECON 4,A01,203354,Anderson; John Charles,0,5,10,10
1683731043318,ECON 100A,A01,185574,Staff,0,5,40,40
1683731044345,ECON 100B,A01,185576,Staff,0,12,50,50
1683731045372,ECON 100C,A01,185589,Newhouse; Herbert S,30,0,70,40
1683731046396,ECON 105,A00,185608,Vespa; Emanuel Ignacio,19,0,35,16
1683731047420,ECON 109,A01,185610,Shishkin; Denis,9,0,35,26
1683731048451,ECON 110A,A01,185612,Staff,8,0,40,32
1683731049476,ECON 120A,A01,185615,Staff,19,0,40,21
1683731050501,ECON 120C,A01,185617,Sun; Yixiao,0,21,70,70
1683731051534,ECON 144,A00,203346,Squires; Dale E,2,0,35,33
1683731052560,ECON 171,A01,203349,Newhouse; Herbert S,0,1,35,35
1683731053587,ECON 173A,A01,185621,Toda; Alexis Akira,21,0,35,14
1683731054612,EDS 25,A01,202413,Staff,0,1,0,0
1683731054612,EDS 25,A02,202414,Staff,0,1,0,0
1683731054612,EDS 25,A03,202415,Staff,0,0,0,0
1683731054612,EDS 25,A04,202416,Staff,0,1,0,0
1683731054612,EDS 25,A05,202439,Staff,0,0,0,0
1683731054612,EDS 25,A06,202440,Staff,0,0,0,0
1683731054612,EDS 25,B01,202631,Staff,0,0,0,0
1683731054612,EDS 25,B02,202632,Staff,0,0,0,0
1683731054612,EDS 25,B03,202639,Staff,0,0,0,0
1683731054612,EDS 25,B04,202640,Staff,0,0,0,0
1683731054612,EDS 25,B05,202643,Staff,0,0,0,0
1683731054612,EDS 25,B06,202644,Staff,0,0,0,0
1683731055639,EDS 38,A01,202659,Black; Alison Michelle,25,0,25,0
1683731056667,EDS 115,A00,202652,Staff,18,0,30,12
1683731057693,EDS 125,A00,202649,Staff,13,0,30,17
1683731058720,EDS 126,A01,203332,Staff,30,0,30,0
1683731059747,EDS 139,A00,202838,Staff,16,0,25,9
1683731060775,EDS 146,A01,202655,Staff,14,0,25,11
1683731061799,ENG 15,A00,185667,Staff,0,1,0,0
1683731061799,ENG 15,B00,185672,Staff,0,0,0,0
1683731061799,ENG 15,C00,185675,Staff,0,0,0,0
1683731061799,ENG 15,D00,185682,Staff,0,0,0,0
1683731061799,ENG 15,E00,185684,Staff,0,0,0,0
1683731062828,ETHN 103,A00,185710,Staff,0,8,35,35
1683731063853,ETHN 103A,A00,199228,Man; Simeon S,0,0,9,9
1683731064937,ETHN 109,A00,185711,Staff,15,0,35,20
1683731065961,ETHN 142,A00,185726,Staff,0,4,30,30
1683731066985,ETHN 163J,A00,199229,Man; Simeon S,5,0,8,3
1683731068012,ETHN 168,A00,185727,Staff,7,0,10,3
1683731069039,ETHN 182,A00,185728,Staff,0,0,35,35
1683731070068,ETHN 183,A00,185737,Staff,10,0,18,8
1683731071092,GLBH 111,A01,209361,Burgos; Jose L.,0,0,0,0
1683731073146,HIEU 104,A00,185792,Staff,14,0,20,6
1683731074174,HIEU 115,A00,185800,Staff,0,0,20,20
1683731075202,HIEU 128,A00,185801,Staff,0,9,20,20
1683731076228,HIEU 147,A00,185802,Staff,15,0,20,5
1683731077254,HIEU 154,A00,185823,Staff,11,0,20,9
1683731078281,HILA 102,A00,185826,Staff,14,0,20,6
1683731079305,HILD 2C,A01,185778,Staff,0,13,20,20
1683731080331,HILD 7B,A01,185780,Kwak; Nancy,0,17,32,32
1683731080331,HILD 7B,A02,185781,Kwak; Nancy,0,18,32,32
1683731081356,HILD 30,A01,185791,Staff,12,0,20,8
1683731082379,HISC 119,A00,185830,Golan; Tal,0,10,20,20
1683731083404,HITO 156GS,A00,185831,Patterson; Patrick H.,0,0,0,23
1683731084433,HIUS 103,A00,185832,Man; Simeon S,0,4,20,20
1683731085459,HIUS 117,A00,185836,Kwak; Nancy,2,0,20,18
1683731086483,HIUS 125,A00,185840,Man; Simeon S,0,2,23,23
1683731087507,HIUS 149,A00,185845,Staff,1,0,20,19
1683731088536,HUM 3,A01,185882,Zavodny; Tatiana Sophia,0,8,50,50
1683731088536,HUM 3,B01,185899,Caldwell; Michael Alan,0,18,50,50
1683731089561,HUM 3GS,A00,185900,Patterson; Patrick H.,0,0,0,23
1683731090590,HUM 4,A01,185938,Zroka; Amy Liane,28,0,50,22
1683731090590,HUM 4,B01,185956,Watkins; Eric,0,6,50,50
1683731090590,HUM 4,B02,202209,Watkins; Eric,0,6,50,50
1683731090590,HUM 4,B03,202210,Watkins; Eric,0,5,50,50
1683731091615,HUM 5,A01,185958,West; Geoffrey Scott,0,0,50,50
1683731091615,HUM 5,A02,202215,West; Geoffrey Scott,0,1,50,50
1683731092641,INTL 190,A00,185959,Gagnon; Jeffrey C,0,0,0,9
1683731092641,INTL 190,B00,185960,Lettieri; Michael Joseph,0,0,0,2
1683731093666,JAPN 180,A00,254509,Staff,4,0,30,26
1683731094694,LATI 10,A01,202853,Kennemore; Amy Michelle,4,0,35,31
1683731094694,LATI 10,A02,202854,Kennemore; Amy Michelle,3,0,35,32
1683731094694,LATI 10,A03,270054,Kennemore; Amy Michelle,30,0,30,0
1683731095720,LATI 180,A00,202855,Kennemore; Amy Michelle,11,0,20,9
1683731096749,LAWS 101,A00,201767,Golan; Tal,0,7,40,40
1683731097774,LIFR 1C,A00,185961,Staff,6,0,20,14
1683731098801,LIFR 1CX,A00,185962,Staff,7,0,20,13
1683731099829,LIFR 1D,A00,185963,Staff,7,0,20,13
1683731100865,LIFR 1DX,A00,185964,Staff,7,0,20,13
1683731101890,LIGN 101,A01,186039,Staff,43,0,50,7
1683731102914,LIGN 165,A00,186040,Staff,14,0,50,36
1683731103938,LTCS 108,A00,186041,Staff,5,0,10,5
1683731104961,LTCS 119,A00,186042,Staff,15,0,20,5
1683731105989,LTCS 130,A00,186043,Wesling; Megan E.,15,0,25,10
1683731108040,LTEA 138,A00,186119,Staff,13,0,40,27
1683731109064,LTEN 124,A00,186148,Staff,5,0,25,20
1683731110088,LTEN 178,A00,186149,Staff,6,0,15,9
1683731111113,LTEN 181,A00,186150,Blanco; John D,34,0,40,6
1683731112141,LTWL 120,A00,186160,Staff,19,0,25,6
1683731113165,LTWL 165,A00,186161,Staff,22,0,25,3
1683731114191,LTWR 100,A00,186162,Staff,0,5,15,15
1683731115218,LTWR 102,A00,186163,Doller; Ben,5,0,15,10
1683731116241,MAE 8,A01,186412,Staff,0,1,0,0
1683731117268,MAE 30B,A00,186445,Bahadori; Mohammad Yousef,81,0,100,19
1683731118292,MAE 40,A00,186592,Bewley; Thomas R,10,0,50,40
1683731119320,MAE 101B,A00,186593,Bahadori; Mohammad Yousef,80,0,100,20
1683731120348,MAE 105,A00,186594,Bandaru; Prabhakar,10,0,50,40
1683731121376,MAE 107,A00,186599,Pham; Hieu Tan,0,8,120,120
1683731122402,MAE 148,A01,186660,Silberman; Jack,3,0,16,13
1683731123430,MATH 10A,A01,188095,Staff,0,6,35,35
1683731124461,MATH 10B,A01,188097,Bowers; Adam R.,0,12,30,30
1683731124461,MATH 10B,A02,188099,Bowers; Adam R.,0,11,30,30
1683731124461,MATH 10B,B01,188104,Bowers; Adam R.,0,10,30,30
1683731124461,MATH 10B,B02,188106,Bowers; Adam R.,0,9,30,30
1683731125489,MATH 10C,A01,188111,Staff,0,20,30,30
1683731125489,MATH 10C,A02,188127,Staff,0,19,30,30
1683731125489,MATH 10C,A03,188131,Staff,0,19,30,30
1683731125489,MATH 10C,B01,188218,Staff,17,0,30,13
1683731125489,MATH 10C,B02,188244,Staff,13,0,30,17
1683731125489,MATH 10C,B03,188277,Staff,14,0,30,16
1683731126513,MATH 18,A01,188344,Bach; Quang Tran,18,0,30,12
1683731126513,MATH 18,A02,188345,Bach; Quang Tran,11,0,30,19
1683731126513,MATH 18,B01,188353,Bach; Quang Tran,11,0,30,19
1683731126513,MATH 18,B02,188354,Bach; Quang Tran,19,0,30,11
1683731127536,MATH 20A,A01,188374,Staff,10,0,35,25
1683731128569,MATH 20B,A01,188382,Ohm; Ko Woon,7,0,30,23
1683731128569,MATH 20B,A02,188383,Ohm; Ko Woon,22,0,30,8
1683731128569,MATH 20B,B01,188385,Ohm; Ko Woon,7,0,30,23
1683731128569,MATH 20B,B02,188392,Ohm; Ko Woon,22,0,30,8
1683731129598,MATH 20C,A01,188394,Harel; Guershon,10,0,30,20
1683731129598,MATH 20C,A02,188395,Harel; Guershon,13,0,30,17
1683731129598,MATH 20C,B01,188404,Harel; Guershon,5,0,30,25
1683731129598,MATH 20C,B02,188405,Harel; Guershon,18,0,30,12
1683731130625,MATH 20D,A01,188414,Hammock; Frances H,0,1,30,30
1683731130625,MATH 20D,A02,188415,Hammock; Frances H,0,1,30,30
1683731130625,MATH 20D,B01,188447,Hammock; Frances H,0,1,30,30
1683731130625,MATH 20D,B02,188486,Hammock; Frances H,2,0,30,28
1683731131654,MATH 20E,A01,188649,Staff,21,0,30,9
1683731131654,MATH 20E,A02,188650,Staff,20,0,30,10
1683731131654,MATH 20E,A03,188673,Staff,0,0,30,30
1683731132678,MATH 102,A01,188675,Staff,0,40,35,35
1683731133706,MATH 103B,A01,188681,Staff,3,0,35,32
1683731133706,MATH 103B,B01,188692,Staff,5,0,35,30
1683731134730,MATH 109,A01,188695,Salehi Golsefidy; Alireza,24,0,35,11
1683731134730,MATH 109,A02,188696,Salehi Golsefidy; Alireza,24,0,35,11
1683731135753,MATH 120A,A01,188698,Eggers; John Dietrich,7,0,35,28
1683731136781,MATH 142B,A01,188736,Ioana; Adrian,0,0,30,30
1683731136781,MATH 142B,A02,188741,Ioana; Adrian,0,1,30,30
1683731136781,MATH 142B,A03,188743,Ioana; Adrian,0,3,30,30
1683731137808,MATH 168A,A01,188790,Staff,0,11,35,35
1683731138832,MATH 170A,A01,188803,Nie; Jiawang,0,2,35,35
1683731138832,MATH 170A,A02,188811,Nie; Jiawang,0,1,35,35
1683731138832,MATH 170A,A03,188814,Nie; Jiawang,1,0,35,34
1683731138832,MATH 170A,A04,188815,Nie; Jiawang,5,0,35,30
1683731139860,MATH 193B,A01,188817,Staff,0,0,35,35
1683731139860,MATH 193B,A02,188818,Staff,6,0,35,29
1683731140884,MGT 4,A01,202857,Anderson; John Charles,59,0,80,21
1683731141909,MGT 12,A00,202858,Lindenberger; Wade Douglas,40,0,90,50
1683731142933,MGT 18,A00,202859,Staff,73,0,90,17
1683731143957,MGT 18GS,A00,202860,McKay; Michael J,13,0,28,15
1683731144985,MGT 45,A00,202861,Pecore; Joseph P.,8,0,90,82
1683731146009,MGT 100,A00,202863,Yavorsky; Daniel Ryan,27,0,90,63
1683731147038,MGT 103,A00,202864,Ehrich; Kristine R,0,19,90,90
1683731148066,MGT 112,A00,202865,Ehrich; Kristine R,15,0,90,75
1683731149089,MGT 121A,A00,202868,Staff,70,0,90,20
1683731150114,MGT 131B,A00,202869,Anderson; John Charles,58,0,90,32
1683731151138,MGT 136,A00,202871,Lindenberger; Wade Douglas,83,0,90,7
1683731152161,MGT 164,A00,202873,Staff,0,67,90,91
1683731153187,MGT 164GS,A00,202874,McKay; Mary A,13,0,28,15
1683731154210,MGT 180,A00,202875,Staff,0,51,90,91
1683731155234,MMW 11R,A01,205019,Herbst; Matthew,0,0,30,30
1683731155234,MMW 11R,A02,205026,Herbst; Matthew,29,0,30,1
1683731156267,MMW 15,A01,193512,Chang; Edmond Yi-Teh,0,8,28,28
1683731156267,MMW 15,A02,193513,Chang; Edmond Yi-Teh,0,5,28,28
1683731156267,MMW 15,A03,193514,Chang; Edmond Yi-Teh,0,5,28,28
1683731156267,MMW 15,A04,193515,Chang; Edmond Yi-Teh,0,5,28,28
1683731156267,MMW 15,A05,193516,Chang; Edmond Yi-Teh,0,5,28,28
1683731156267,MMW 15,A06,193517,Chang; Edmond Yi-Teh,0,6,28,28
1683731156267,MMW 15,B01,193519,Chang; Edmond Yi-Teh,0,5,28,28
1683731156267,MMW 15,B02,193520,Chang; Edmond Yi-Teh,0,5,28,28
1683731156267,MMW 15,B03,193521,Chang; Edmond Yi-Teh,0,5,28,28
1683731156267,MMW 15,B04,193522,Chang; Edmond Yi-Teh,0,6,28,28
1683731156267,MMW 15,B05,193523,Chang; Edmond Yi-Teh,0,5,28,28
1683731156267,MMW 15,B06,193524,Chang; Edmond Yi-Teh,0,5,28,28
1683731157291,MMW 122,A01,193526,Rahimi; Babak,0,16,28,28
1683731157291,MMW 122,A02,193527,Rahimi; Babak,0,15,28,28
1683731157291,MMW 122,A03,193528,Rahimi; Babak,0,0,0,0
1683731157291,MMW 122,A04,193529,Rahimi; Babak,0,0,0,0
1683731158317,MUS 1A,A01,186663,Staff,0,18,35,35
1683731159341,MUS 4,A01,186715,Staff,0,12,35,35
1683731160367,MUS 5R,A01,186796,Dubnov; Shlomo,0,17,35,35
1683731161391,MUS 6,A01,186798,Staff,0,4,25,25
1683731162424,MUS 7,A01,186830,Staff,11,0,35,24
1683731163451,MUS 8,A01,186930,Staff,0,27,35,35
1683731164479,MUS 15,A01,186932,Staff,0,15,35,35
1683731164479,MUS 15,B01,186934,Staff,0,16,35,35
1683731165503,MUS 80,A00,186935,Staff,0,0,20,20
1683731165503,MUS 80,B00,186936,Staff,24,0,25,1
1683731166532,NANO 11,A00,204702,Lipomi; Darren John,0,0,0,0
1683731167558,NANO 15,A01,204709,Yang; Kesong,0,1,0,0
1683731168641,NANO 114,A00,202069,Jahed Motlagh; Zeinab,2,0,10,8
1683731169665,PHIL 1,A00,186955,Grush; Rick Scott,31,0,40,9
1683731170698,PHIL 10,A01,186973,Grush; Rick Scott,27,0,35,8
1683731170698,PHIL 10,A02,186974,Grush; Rick Scott,33,0,35,2
1683731171723,PHIL 13,A01,186976,Staff,1,0,35,34
1683731171723,PHIL 13,A02,186977,Staff,16,0,35,19
1683731172756,PHIL 14,A01,186979,Staff,30,0,35,5
1683731172756,PHIL 14,A02,186986,Staff,32,0,35,3
1683731173782,PHIL 28,A01,186988,Staff,16,0,30,14
1683731173782,PHIL 28,A02,186989,Staff,0,0,30,30
1683731173782,PHIL 28,A03,186990,Staff,10,0,30,20
1683731173782,PHIL 28,A04,186991,Staff,26,0,30,4
1683731174806,PHIL 120,A00,186997,Staff,23,0,40,17
1683731175834,PHIL 137,A00,187003,Staff,8,0,40,32
1683731176858,PHIL 150,A00,187015,Staff,47,0,70,23
1683731177885,PHIL 167,A00,187021,Lamey; Andy M.,34,0,40,6
1683731178913,PHIL 174,A01,202226,Staff,17,0,20,3
1683731178913,PHIL 174,A02,202235,Staff,20,0,20,0
1683731179937,PHIL 191A,A00,258918,Staff,0,0,1,1
1683731180966,PHYS 1A,A00,187028,Staff,26,0,60,34
1683731181995,PHYS 1AL,001,187036,Staff,3,0,30,27
1683731181995,PHYS 1AL,002,187049,Staff,18,0,30,12
1683731183020,PHYS 1B,A00,187058,Staff,21,0,60,39
1683731184045,PHYS 1BL,001,187064,Staff,0,1,30,30
1683731184045,PHYS 1BL,002,187070,Staff,4,0,30,26
1683731185071,PHYS 1C,A00,187082,Staff,30,0,120,90
1683731186096,PHYS 1CL,001,187088,Staff,0,9,30,30
1683731186096,PHYS 1CL,002,187089,Staff,0,1,30,30
1683731186096,PHYS 1CL,009,262693,Staff,9,0,30,21
1683731187126,PHYS 2B,A01,187097,Staff,55,0,115,60
1683731188153,PHYS 2C,A01,187099,Staff,63,0,115,52
1683731189182,PHYS 2CL,A01,187101,Staff,5,0,28,23
1683731189182,PHYS 2CL,A02,187102,Staff,15,0,28,13
1683731190205,PHYS 2D,A01,187123,Shotwell; Brian,95,0,115,20
1683731191233,PHYS 4B,A01,187133,Grinstein; Benjamin,35,0,50,15
1683731192258,POLI 10,A00,188819,Staff,0,4,50,50
1683731193286,POLI 11,A00,188827,Staff,43,0,50,7
1683731194311,POLI 13R,A00,188828,Staff,0,2,20,20
1683731195337,POLI 27,A01,188830,Elgin; Samuel Zincke,0,2,70,70
1683731196367,POLI 30,A00,188832,Desposato; Scott,30,0,50,20
1683731197392,POLI 102F,A00,188834,Staff,1,0,40,39
1683731198426,POLI 104A,A00,188852,Staff,12,0,30,18
1683731199454,POLI 104I,A00,188853,Staff,0,8,20,20
1683731200482,POLI 110B,A00,188854,Wiens; David,6,0,20,14
1683731201506,POLI 112A,A00,188855,Wiens; David,3,0,30,27
1683731202533,POLI 117R,A00,188856,Forman; Fonna,0,12,20,20
1683731203558,POLI 118,A00,188857,Ingham; Sean,8,0,20,12
1683731204586,POLI 120G,A00,188858,Staff,7,0,30,23
1683731205613,POLI 131CR,A00,188863,Hoston; Germaine,20,0,50,30
1683731206638,POLI 133,A00,188864,Nellis; Gareth Hb,44,0,50,6
1683731207663,POLI 134D,A00,188865,Desposato; Scott,27,0,30,3
1683731208691,POLI 142A,A00,188871,Gartzke; Erik,21,0,50,29
1683731209716,POLI 142K,A00,188874,Staff,38,0,50,12
1683731210745,POLI 143,A00,188940,Gartzke; Erik,15,0,30,15
1683731211772,POLI 153,A00,188943,Staff,1,0,20,19
1683731212799,POLI 160AA,A00,188944,Staff,10,0,40,30
1683731213824,POLI 170A,A00,188945,Staff,10,0,30,20
1683731215876,PSYC 1,A00,188952,Staff,36,0,90,54
1683731216904,PSYC 2,B00,188953,Staff,19,0,35,16
1683731217928,PSYC 6,A00,188970,Staff,47,0,60,13
1683731218954,PSYC 7,A00,188973,Staff,35,0,45,10
1683731219982,PSYC 60,A01,188980,Rickard; Timothy C.,42,0,60,18
1683731221012,PSYC 70,A01,189001,Steiner; Eric Tomas,21,0,45,24
1683731222036,PSYC 100,A00,189005,Lacefield; Katharine I,1,98,120,119
1683731223061,PSYC 102,A00,189008,Staff,6,0,30,24
1683731224084,PSYC 106,B00,189026,Gorman; Michael R.,27,0,60,33
1683731225113,PSYC 114,B01,189033,Winkielman; Piotr,0,31,30,30
1683731226138,PSYC 131,A00,189036,Anagnostaras; Stephan,0,44,60,60
1683731227161,PSYC 136,A00,189041,Lowe; Angela Beth,0,7,25,25
1683731228189,PSYC 137,A00,189057,Winkielman; Piotr,0,36,25,25
1683731229216,PSYC 144,A00,189107,Wixted; John T,0,11,50,50
1683731231267,PSYC 162,A00,189142,Staff,0,9,85,85
1683731232290,PSYC 172,A00,189144,Gorman; Michael R.,0,6,30,30
1683731234341,PSYC 179,A00,189146,Lacefield; Katharine I,0,88,120,120
1683731235368,PSYC 181,A00,189147,Anagnostaras; Stephan,110,45,200,90
1683731236392,PSYC 190R,A00,189148,Barner; David A.,0,23,80,80
1683731237422,PSYC 191,A00,189275,Rickard; Timothy C.,0,11,25,25
1683731238447,PSYC 193,A00,189276,Chapman; Eddie Nathaniel,0,1,0,4
1683731239475,PSYC 193L,A01,189281,Lowe; Angela Beth,8,0,20,12
1683731239475,PSYC 193L,B01,189285,Staff,28,0,35,7
1683731240499,RELI 149,A00,187137,Rahimi; Babak,6,0,40,34
1683731241525,SE 9,A01,187315,Staff,0,2,18,18
1683731242549,SE 101B,A00,187409,Staff,24,0,30,6
1683731243575,SE 110B,A00,187444,Staff,10,0,40,30
1683731244599,SE 130B,A00,187449,Staff,31,0,40,9
1683731245628,SE 150A,A00,187516,Staff,8,0,20,12
1683731246653,SE 154,A00,187528,Staff,29,0,50,21
1683731247678,SIO 3,A01,258171,Staff,35,0,40,5
1683731248706,SIO 10,A00,187144,Cook; Geoffrey W,0,6,75,75
1683731249734,SIO 45,A00,187152,Cook; Geoffrey W,1,7,100,99
1683731250758,SIO 109R,A00,194486,Staff,0,4,20,20
1683731252814,SIO 187,A01,187233,Kacev; David,12,0,40,28
1683731253844,SOCI 1,A01,258656,Thorpe; Charles Robert,28,0,30,2
1683731253844,SOCI 1,A02,258658,Thorpe; Charles Robert,30,0,30,0
1683731253844,SOCI 1,A03,258661,Thorpe; Charles Robert,25,0,25,0
1683731253844,SOCI 1,A04,258666,Thorpe; Charles Robert,22,0,25,3
1683731253844,SOCI 1,A05,258897,Thorpe; Charles Robert,22,0,25,3
1683731253844,SOCI 1,A06,258898,Thorpe; Charles Robert,25,0,25,0
1683731254872,SOCI 30,A01,258903,Pardo Guerra; Juan Pablo,14,0,30,16
1683731255900,SOCI 102,A00,258904,Staff,9,0,25,16
1683731256925,SOCI 106,A00,258905,Staff,19,0,25,6
1683731257953,SOCI 111,A00,258907,Ribas Norris; Janet Vanesa,26,0,30,4
1683731258981,SOCI 121R,A00,258908,Pardo Guerra; Juan Pablo,7,0,30,23
1683731260009,SOCI 126,A01,203330,Staff,14,0,20,6
1683731261034,SOCI 131,A00,258909,Thorpe; Charles Robert,30,0,60,30
1683731262059,SOCI 135,A00,258910,Payne; Christine Anna,0,13,30,30
1683731263083,SOCI 157,A00,258911,Staff,10,0,30,20
1683731264108,SOCI 184,A00,258912,Staff,25,0,30,5
1683731265132,SOCI 188D,A00,258913,Staff,22,0,30,8
1683731266157,SYN 2,001,187529,Staff,9,0,16,7
1683731266157,SYN 2,002,201452,Staff,0,20,16,16
1683731266157,SYN 2,003,201469,Staff,1,0,16,15
1683731267183,SYN 100,A01,187531,Staff,0,9,20,20
1683731267183,SYN 100,B01,201491,Staff,0,10,20,20
1683731268209,TDAC 1,A00,189286,Walsh; Kim C.,3,0,20,17
1683731268209,TDAC 1,B00,189287,Harting; Carla Kelso,10,0,20,10
1683731269236,TDAC 101,A00,189300,Walsh; Kim C.,16,0,20,4
1683731269236,TDAC 101,B00,189301,Harting; Carla Kelso,18,0,20,2
1683731270261,TDAC 102,A00,189304,Basso; Beatrice,14,0,20,6
1683731271286,TDAC 108,A00,189305,Staff,18,0,20,2
1683731272379,TDDE 131,A00,189310,Staff,19,0,20,1
1683731272379,TDDE 131,B00,189314,Staff,19,0,20,1
1683731272379,TDDE 131,C00,189315,Staff,48,0,50,2
1683731272379,TDDE 131,D00,189316,Staff,14,0,15,1
1683731272379,TDDE 131,E00,204841,Staff,20,0,20,0
1683731273403,TDGE 10,A00,189289,Staff,26,0,50,24
1683731273403,TDGE 10,B00,189290,Havis; Allan,0,1,50,50
1683731274439,TDGE 11,A00,189291,Fulton; Julia,0,4,50,50
1683731274439,TDGE 11,B00,189292,Staff,20,0,25,5
1683731274439,TDGE 11,C00,260270,Staff,0,0,0,0
1683731275466,TDGE 25,A00,189294,Staff,1,0,20,19
1683731276490,TDGE 124,A00,189318,Fulton; Julia,0,7,50,50
1683731277513,TDGE 125,A00,189319,Staff,13,0,25,12
1683731277513,TDGE 125,B00,189320,Staff,23,0,25,2
1683731278541,TDGE 127,A00,189322,Havis; Allan,1,0,50,49
1683731279566,TDHT 101,A00,189323,Staff,18,0,25,7
1683731279566,TDHT 101,B00,189324,Staff,25,0,25,0
1683731280599,TDHT 102,A00,189325,Staff,49,0,50,1
1683731281627,TDMV 1,A00,189295,Arcidiacono; Kristin,20,0,30,10
1683731281627,TDMV 1,B00,189296,Caligagan; Maria T.,23,0,30,7
1683731282656,TDMV 2,A00,189297,Sammartano; Tonnie,27,0,30,3
1683731282656,TDMV 2,B00,189299,Arcidiacono; Kristin,23,0,30,7
1683731283684,TDMV 3,A00,204998,Rincon; Alicia,22,0,30,8
1683731284718,TDMV 120,A00,189458,Sammartano; Tonnie,28,0,30,2
1683731285740,TDMV 138,A00,189541,Jun; Grace Shin Hae,20,0,40,20
1683731286766,TDMV 142,A00,189717,Caligagan; Tony,25,0,30,5
1683731286766,TDMV 142,B00,189718,Caligagan; Maria T.,25,0,30,5
1683731287790,TMC 2,A01,187533,Staff,25,0,25,0
1683731287790,TMC 2,A02,187534,Staff,25,0,25,0
1683731288818,USP 1,A01,187536,Kwak; Nancy,0,16,25,25
1683731289842,USP 5,A01,187538,Staff,8,0,25,17
1683731290866,USP 101,A00,199253,Staff,0,4,0,0
1683731291891,USP 124,A00,187562,Boomhower; Matthew Charles,0,0,30,30
1683731292920,USP 138,A00,187582,Staff,19,0,25,6
1683731293945,USP 152,A01,187597,Staff,3,0,25,22
1683731294970,USP 153,A00,187598,Staff,18,0,25,7
1683731296000,USP 168,A00,187607,Kwak; Nancy,2,0,5,3
1683731297028,USP 173,A00,187619,Staff,4,0,25,21
1683731298050,USP 181,A00,187638,Staff,0,4,25,25
1683731299077,VIS 103,A00,187650,Cruz; Edwin Teddy,17,0,75,58
1683731300104,VIS 110D,A00,187669,Staff,13,0,22,9
1683731301130,VIS 127C,A00,187720,Shen; Kuiyi,67,0,146,79
1683731302155,VIS 149,A00,187731,Yoldas; Pinar,0,12,22,22
1683731303184,VIS 151,A01,188091,Staff,22,0,34,12
1683731303184,VIS 151,A02,188092,Staff,11,0,34,23
1683731304212,VIS 160B,A00,188093,Stalbaum; Brett,0,1,10,10
1683731306260,WCWP 10B,A00,201720,Staff,0,0,5,5
1683731306260,WCWP 10B,B00,201722,Staff,0,0,6,6
1683731307287,WCWP 100,A00,201725,Gagnon; Jeffrey C,0,0,2,2
1683731307287,WCWP 100,B00,201727,Staff,0,4,15,15
1683731310623,ANBI 133,A00,258401,Wilder; Linnea Lorene,34,0,40,6
1683731311651,ANBI 140,A00,258395,Hrvoj Mihic; Branka,18,0,25,7
1683731312678,ANSC 120,A00,258402,Bialecki; Jon Anthony,26,0,40,14
1683731313706,ANSC 144,A00,258400,Staff,12,0,40,28
1683731315756,ANSC 166,A00,258396,Parish; Steven Martin,156,0,175,19
1683731316780,ANSC 180,A00,193533,Staff,8,0,20,12
1683731317805,ANSC 188,A00,258397,Jassal; Aftab,34,0,40,6
1683731318828,ANTH 3,A01,258316,Staff,23,0,30,7
1683731319857,ANTH 5,A00,258394,Semendeferi; Ekaterini,16,0,20,4
1683731320882,ANTH 21,A01,258331,Staff,4,0,40,36
1683731321907,ANTH 103,A00,258398,Varma; Saiba,15,0,25,10
1683731322940,AWP 10,001,202034,Staff,0,0,0,0
1683731322940,AWP 10,002,202035,Staff,0,0,0,0
1683731322940,AWP 10,003,202036,Staff,0,0,0,0
1683731322940,AWP 10,004,202037,Staff,0,0,0,0
1683731322940,AWP 10,005,202038,Staff,0,0,0,0
1683731322940,AWP 10,006,202039,Staff,0,0,0,0
1683731322940,AWP 10,007,202040,Staff,0,0,0,0
1683731322940,AWP 10,008,202041,Staff,0,0,0,0
1683731322940,AWP 10,009,202042,Staff,0,0,0,0
1683731322940,AWP 10,010,202043,Staff,0,0,0,0
1683731322940,AWP 10,011,202044,Staff,0,0,0,0
1683731322940,AWP 10,012,202045,Staff,0,0,0,0
1683731322940,AWP 10,013,202046,Staff,0,0,0,0
1683731322940,AWP 10,014,202047,Staff,0,0,0,0
1683731322940,AWP 10,015,202048,Staff,0,0,0,0
1683731322940,AWP 10,016,202049,Staff,0,0,0,0
1683731322940,AWP 10,017,202050,Staff,0,0,0,0
1683731322940,AWP 10,018,202051,Staff,0,0,0,0
1683731322940,AWP 10,019,202052,Staff,0,0,0,0
1683731322940,AWP 10,020,202053,Staff,0,0,0,0
1683731322940,AWP 10,021,202054,Staff,0,0,0,0
1683731322940,AWP 10,022,202055,Staff,0,0,0,0
1683731322940,AWP 10,023,202056,Staff,0,0,0,0
1683731322940,AWP 10,024,202057,Staff,0,0,0,0
1683731322940,AWP 10,025,202058,Staff,0,0,0,0
1683731322940,AWP 10,026,202059,Staff,0,0,0,0
1683731323966,AWP 102,001,202032,Staff,0,0,0,0
1683731323966,AWP 102,002,202033,Staff,0,0,0,0
1683731324994,BENG 100,A01,254234,Taylor Amos; Alyssa C,31,0,40,9
1683731326020,BENG 196,001,270013,Engler; Adam J.,9999,0,9999,0
1683731327045,BICD 100R,A01,202018,Smith; Laurie,0,7,32,32
1683731327045,BICD 100R,A02,202019,Smith; Laurie,0,3,32,32
1683731327045,BICD 100R,A03,202020,Smith; Laurie,0,1,32,32
1683731327045,BICD 100R,A04,202021,Smith; Laurie,6,0,32,26
1683731327045,BICD 100R,A05,202022,Smith; Laurie,10,0,32,22
1683731328074,BICD 136,A01,193242,Gustafson-Brown; Cindy,0,2,32,32
1683731328074,BICD 136,A02,193244,Gustafson-Brown; Cindy,13,0,32,19
1683731329096,BIEB 102,A01,193249,Butler; Shannon Rhey,0,0,32,32
1683731329096,BIEB 102,A02,193251,Butler; Shannon Rhey,0,0,32,32
1683731329096,BIEB 102,A03,193253,Butler; Shannon Rhey,0,0,32,32
1683731329096,BIEB 102,A04,193255,Butler; Shannon Rhey,13,0,32,19
1683731329096,BIEB 102,A05,193265,Butler; Shannon Rhey,25,0,32,7
1683731329096,BIEB 102,A06,193269,Butler; Shannon Rhey,12,0,32,20
1683731331150,BIEB 150,A01,193274,Staff,0,0,32,32
1683731331150,BIEB 150,A02,193285,Staff,24,0,32,8
1683731332173,BIEB 194,A00,193286,Kurle; Carolyn M.,19,0,32,13
1683731333202,BILD 1,A01,192291,Staff,15,0,32,17
1683731333202,BILD 1,A02,192292,Staff,30,0,32,2
1683731333202,BILD 1,B01,192520,Reuther; Keefe,0,1,0,0
1683731333202,BILD 1,B02,192532,Reuther; Keefe,0,1,0,0
1683731334233,BILD 3,A01,192556,Butler; Shannon Rhey,0,0,32,32
1683731334233,BILD 3,A02,192581,Butler; Shannon Rhey,0,1,32,32
1683731334233,BILD 3,A03,192611,Butler; Shannon Rhey,19,0,32,13
1683731334233,BILD 3,A04,192612,Butler; Shannon Rhey,23,0,32,9
1683731334233,BILD 3,A05,192613,Butler; Shannon Rhey,26,0,32,6
1683731334233,BILD 3,A06,192679,Butler; Shannon Rhey,27,0,32,5
1683731334233,BILD 3,A07,192682,Butler; Shannon Rhey,20,0,32,12
1683731335259,BILD 4,A01,192836,Reuther; Keefe,1,0,24,23
1683731335259,BILD 4,A02,193044,Reuther; Keefe,4,0,24,20
1683731336288,BILD 10,A01,193142,Gustafson-Brown; Cindy,29,0,32,3
1683731336288,BILD 10,A02,193149,Gustafson-Brown; Cindy,31,0,32,1
1683731337313,BIMM 100,A01,193301,Staff,0,6,32,32
1683731337313,BIMM 100,A02,193312,Staff,0,7,32,32
1683731337313,BIMM 100,A03,193323,Staff,0,10,32,32
1683731338337,BIMM 101,A01,193329,McDonnell; Lisa Marie,0,3,24,24
1683731338337,BIMM 101,A02,193339,McDonnell; Lisa Marie,0,3,24,24
1683731338337,BIMM 101,B01,193354,McDonnell; Lisa Marie,0,4,24,24
1683731338337,BIMM 101,B02,193357,McDonnell; Lisa Marie,0,3,24,24
1683731339365,BIMM 110,A01,193377,Tat; John,0,11,32,32
1683731339365,BIMM 110,A02,193378,Tat; John,0,11,32,32
1683731340391,BIMM 120,A01,206116,Staff,0,0,32,32
1683731340391,BIMM 120,A02,206117,Staff,7,0,32,25
1683731340391,BIMM 120,A03,206121,Staff,21,0,32,11
1683731341422,BIPN 100,A01,193393,Park; Ji Young,0,15,32,32
1683731341422,BIPN 100,A02,193402,Park; Ji Young,0,14,32,32
1683731341422,BIPN 100,A03,193413,Park; Ji Young,0,14,32,32
1683731341422,BIPN 100,A04,193414,Park; Ji Young,0,13,32,32
1683731342451,BIPN 102,A01,193429,Staff,0,0,32,32
1683731342451,BIPN 102,A02,193438,Staff,18,0,32,14
1683731343478,BIPN 106,A01,193450,Reyes Gonzalez; Catalina,0,2,40,40
1683731344505,BIPN 134,A01,193465,Cooke; James Edward,0,0,32,32
1683731344505,BIPN 134,A02,193474,Cooke; James Edward,25,0,32,7
1683731344505,BIPN 134,A03,193485,Cooke; James Edward,29,0,32,3
1683731344505,BIPN 134,A04,193486,Cooke; James Edward,20,0,32,12
1683731344505,BIPN 134,A05,193491,Cooke; James Edward,31,0,32,1
1683731344505,BIPN 134,A06,193501,Cooke; James Edward,30,0,32,2
1683731344505,BIPN 134,A07,193510,Cooke; James Edward,29,0,32,3
1683731346561,BISP 194,A00,222522,Staff,14,0,32,18
1683731347585,CAT 124,A01,202407,Staff,19,0,25,6
1683731348610,CAT 125,A00,202408,Marchisotto; Jennifer Anne,2,0,20,18
1683731349640,CAT 125R,A00,202409,Smith; Lauryn Alissa,0,11,20,20
1683731349640,CAT 125R,B00,202410,Morales; Celeste Georgianna,0,11,20,20
1683731349640,CAT 125R,C00,202411,Irwin; Matthew Joseph,0,12,20,20
1683731350668,CENG 15,A01,204712,Yang; Kesong,0,1,0,0
1683731351698,CENG 114,A00,202070,Jahed Motlagh; Zeinab,5,0,20,15
1683731352725,CGS 105,A00,185477,Wesling; Megan E.,24,0,40,16
1683731353748,CGS 106,A00,185494,Staff,11,0,22,11
1683731354773,CGS 108,A00,185495,Staff,14,0,20,6
1683731355797,CGS 114,A00,185496,Staff,13,0,18,5
1683731356820,CGS 119,A00,185501,Staff,15,0,20,5
1683731357845,CGS 120,A00,185511,Staff,11,0,20,9
1683731358869,CHEM 4,A01,184675,Bussey; Thomas J,97,0,100,3
1683731359895,CHEM 6A,A01,184677,Staff,32,0,60,28
1683731360919,CHEM 6B,A01,184679,Staff,63,0,100,37
1683731361942,CHEM 6C,A01,184681,Bussey; Thomas J,0,0,50,50
1683731361942,CHEM 6C,A02,184682,Bussey; Thomas J,32,0,50,18
1683731362974,CHEM 40A,A01,184684,Albizati; Kim F.,33,0,100,67
1683731363996,CHEM 40B,A01,184686,Albizati; Kim F.,0,22,100,100
1683731365019,CHEM 41B,A01,184690,Staff,51,0,100,49
1683731366050,COGS 3,A01,184715,Boyle; Mary E. T.,0,27,40,40
1683731367076,COGS 14B,A01,185172,Staff,0,14,38,38
1683731368101,COGS 18,A01,184736,Staff,14,0,80,66
1683731369130,COGS 100,A01,184932,Staff,0,8,73,73
1683731370158,COGS 101A,A01,184935,Staff,0,40,30,30
1683731371182,COGS 101B,A01,184944,Staff,0,2,30,30
1683731372212,COGS 101C,A01,184946,Staff,0,10,30,30
1683731373237,COGS 102A,A01,184951,Johnson; Christine M.,1,0,40,39
1683731374261,COGS 107B,A01,184953,Mooshagian; Eric Frederick,0,52,40,40
1683731375287,COGS 118B,A01,184959,Gupta; Anjum,0,50,40,40
1683731376367,COGS 153,A00,184961,Staff,1,16,30,29
1683731377391,COGS 177,A00,184962,Staff,0,20,30,30
1683731378416,COGS 187A,A01,184969,Boyle; Mary E. T.,0,19,40,40
1683731379446,COMM 10,A01,185174,Staff,0,5,25,25
1683731379446,COMM 10,A02,185189,Staff,0,2,25,25
1683731379446,COMM 10,A03,269821,Staff,0,1,0,0
1683731380471,COMM 100B,A02,185476,Staff,10,0,25,15
1683731380471,COMM 100B,A03,277340,Staff,25,0,25,0
1683731381495,COMM 100C,A01,185314,Staff,2,0,25,23
1683731381495,COMM 100C,A02,185327,Staff,17,0,25,8
1683731382521,COMM 110M,A00,185349,Staff,0,0,40,40
1683731383546,COMM 113T,A00,185352,Staff,25,0,40,15
1683731384570,COMM 114I,A00,185353,Staff,31,0,40,9
1683731385595,COMM 131,A00,185354,Staff,17,0,30,13
1683731386619,CSE 8A,A50,185358,Cao; Yingjun,0,46,10,10
1683731387644,CSE 8B,A01,185362,Staff,0,48,50,50
1683731388668,CSE 11,A01,185416,Cao; Yingjun,0,91,10,10
1683731389699,CSE 20,A01,185445,Briones; Jor-el Thomas Caparas,3,0,25,22
1683731390727,CSE 21,A01,185447,Staff,9,0,50,41
1683731391750,CSE 101,A01,185451,Staff,0,13,50,50
1683731391750,CSE 101,B01,185453,Jones; Miles E,0,15,50,50
1683731393804,CSE 141,A01,185458,Eldon; John,16,0,100,84
1683731394829,CSE 141L,A01,185461,Eldon; John,8,0,100,92
1683731395858,CSE 142,A01,185463,Staff,34,0,60,26
1683731395858,CSE 142,B01,201355,Staff,0,7,60,60
1683731396881,CSE 142L,A01,185470,Staff,34,0,60,26
1683731396881,CSE 142L,B01,201417,Staff,0,6,60,60
1683731397905,CSE 190,A00,201433,Staff,32,0,49,17
1683731398935,DOC 1,A01,259136,Strom; Megan C.,7,0,15,8
1683731398935,DOC 1,A02,259137,Strom; Megan C.,15,0,15,0
1683731398935,DOC 1,A03,259138,Strom; Megan C.,14,0,15,1
1683731398935,DOC 1,A04,259139,Strom; Megan C.,13,0,15,2
1683731399967,DOC 100D,A00,259140,Pass; Natalye Joann,14,0,25,11
1683731400993,DSGN 1,A01,184749,Rill; Bryan,0,26,30,30
1683731402017,DSGN 100,A01,185168,Staff,0,2,25,25
1683731403042,ECE 5,A01,185626,Morris; Karcher William,0,12,0,0
1683731404070,ECE 101,A01,185628,Staff,14,0,70,56
1683731405092,ECE 107,A01,185635,Baghdadchi; Saharnaz,0,0,20,20
1683731405092,ECE 107,A02,185638,Baghdadchi; Saharnaz,1,0,20,19
1683731406120,ECE 148,A01,185647,Silberman; Jack,0,0,16,16
1683731407146,ECON 1,A01,185537,Crane; Meredith Helen,54,0,70,16
1683731408173,ECON 3,A01,185549,Crane; Meredith Helen,30,0,70,40
1683731409202,ECON 4,A01,203354,Anderson; John Charles,0,5,10,10
1683731410225,ECON 100A,A01,185574,Staff,0,5,40,40
1683731411252,ECON 100B,A01,185576,Staff,0,12,50,50
1683731412278,ECON 100C,A01,185589,Newhouse; Herbert S,30,0,70,40
1683731413305,ECON 105,A00,185608,Vespa; Emanuel Ignacio,19,0,35,16
1683731414332,ECON 109,A01,185610,Shishkin; Denis,9,0,35,26
1683731415361,ECON 110A,A01,185612,Staff,8,0,40,32
1683731416385,ECON 120A,A01,185615,Staff,19,0,40,21
1683731417413,ECON 120C,A01,185617,Sun; Yixiao,0,21,70,70
1683731418445,ECON 144,A00,203346,Squires; Dale E,2,0,35,33
1683731419470,ECON 171,A01,203349,Newhouse; Herbert S,0,1,35,35
1683731420494,ECON 173A,A01,185621,Toda; Alexis Akira,21,0,35,14
1683731421523,EDS 25,A01,202413,Staff,0,1,0,0
1683731421523,EDS 25,A02,202414,Staff,0,1,0,0
1683731421523,EDS 25,A03,202415,Staff,0,0,0,0
1683731421523,EDS 25,A04,202416,Staff,0,1,0,0
1683731421523,EDS 25,A05,202439,Staff,0,0,0,0
1683731421523,EDS 25,A06,202440,Staff,0,0,0,0
1683731421523,EDS 25,B01,202631,Staff,0,0,0,0
1683731421523,EDS 25,B02,202632,Staff,0,0,0,0
1683731421523,EDS 25,B03,202639,Staff,0,0,0,0
1683731421523,EDS 25,B04,202640,Staff,0,0,0,0
1683731421523,EDS 25,B05,202643,Staff,0,0,0,0
1683731421523,EDS 25,B06,202644,Staff,0,0,0,0
1683731422551,EDS 38,A01,202659,Black; Alison Michelle,25,0,25,0
1683731423575,EDS 115,A00,202652,Staff,18,0,30,12
1683731424607,EDS 125,A00,202649,Staff,13,0,30,17
1683731425634,EDS 126,A01,203332,Staff,30,0,30,0
1683731426657,EDS 139,A00,202838,Staff,16,0,25,9
1683731427681,EDS 146,A01,202655,Staff,14,0,25,11
1683731428709,ENG 15,A00,185667,Staff,0,1,0,0
1683731428709,ENG 15,B00,185672,Staff,0,0,0,0
1683731428709,ENG 15,C00,185675,Staff,0,0,0,0
1683731428709,ENG 15,D00,185682,Staff,0,0,0,0
1683731428709,ENG 15,E00,185684,Staff,0,0,0,0
1683731429736,ETHN 103,A00,185710,Staff,0,8,35,35
1683731430765,ETHN 103A,A00,199228,Man; Simeon S,0,0,9,9
1683731431790,ETHN 109,A00,185711,Staff,15,0,35,20
1683731432821,ETHN 142,A00,185726,Staff,0,4,30,30
1683731433844,ETHN 163J,A00,199229,Man; Simeon S,5,0,8,3
1683731434869,ETHN 168,A00,185727,Staff,7,0,10,3
1683731435893,ETHN 182,A00,185728,Staff,0,0,35,35
1683731436918,ETHN 183,A00,185737,Staff,10,0,18,8
1683731437945,GLBH 111,A01,209361,Burgos; Jose L.,0,0,0,0
1683731439993,HIEU 104,A00,185792,Staff,14,0,20,6
1683731441021,HIEU 115,A00,185800,Staff,0,0,20,20
1683731442044,HIEU 128,A00,185801,Staff,0,9,20,20
1683731443069,HIEU 147,A00,185802,Staff,15,0,20,5
1683731444093,HIEU 154,A00,185823,Staff,11,0,20,9
1683731445118,HILA 102,A00,185826,Staff,14,0,20,6
1683731446146,HILD 2C,A01,185778,Staff,0,13,20,20
1683731447171,HILD 7B,A01,185780,Kwak; Nancy,0,17,32,32
1683731447171,HILD 7B,A02,185781,Kwak; Nancy,0,18,32,32
1683731448199,HILD 30,A01,185791,Staff,12,0,20,8
1683731449225,HISC 119,A00,185830,Golan; Tal,0,10,20,20
1683731450252,HITO 156GS,A00,185831,Patterson; Patrick H.,0,0,0,23
1683731451280,HIUS 103,A00,185832,Man; Simeon S,0,4,20,20
1683731452302,HIUS 117,A00,185836,Kwak; Nancy,2,0,20,18
1683731453330,HIUS 125,A00,185840,Man; Simeon S,0,2,23,23
1683731454357,HIUS 149,A00,185845,Staff,1,0,20,19
1683731455385,HUM 3,A01,185882,Zavodny; Tatiana Sophia,0,8,50,50
1683731455385,HUM 3,B01,185899,Caldwell; Michael Alan,0,18,50,50
1683731456410,HUM 3GS,A00,185900,Patterson; Patrick H.,0,0,0,23
1683731457439,HUM 4,A01,185938,Zroka; Amy Liane,28,0,50,22
1683731457439,HUM 4,B01,185956,Watkins; Eric,0,6,50,50
1683731457439,HUM 4,B02,202209,Watkins; Eric,0,6,50,50
1683731457439,HUM 4,B03,202210,Watkins; Eric,0,5,50,50
1683731458465,HUM 5,A01,185958,West; Geoffrey Scott,0,0,50,50
1683731458465,HUM 5,A02,202215,West; Geoffrey Scott,0,1,50,50
1683731459493,INTL 190,A00,185959,Gagnon; Jeffrey C,0,0,0,9
1683731459493,INTL 190,B00,185960,Lettieri; Michael Joseph,0,0,0,2
1683731460517,JAPN 180,A00,254509,Staff,4,0,30,26
1683731461543,LATI 10,A01,202853,Kennemore; Amy Michelle,4,0,35,31
1683731461543,LATI 10,A02,202854,Kennemore; Amy Michelle,3,0,35,32
1683731461543,LATI 10,A03,270054,Kennemore; Amy Michelle,30,0,30,0
1683731462570,LATI 180,A00,202855,Kennemore; Amy Michelle,11,0,20,9
1683731463594,LAWS 101,A00,201767,Golan; Tal,0,7,40,40
1683731464620,LIFR 1C,A00,185961,Staff,6,0,20,14
1683731465644,LIFR 1CX,A00,185962,Staff,7,0,20,13
1683731466673,LIFR 1D,A00,185963,Staff,7,0,20,13
1683731467698,LIFR 1DX,A00,185964,Staff,7,0,20,13
1683731468722,LIGN 101,A01,186039,Staff,43,0,50,7
1683731469749,LIGN 165,A00,186040,Staff,14,0,50,36
1683731470781,LTCS 108,A00,186041,Staff,5,0,10,5
1683731471805,LTCS 119,A00,186042,Staff,15,0,20,5
1683731472829,LTCS 130,A00,186043,Wesling; Megan E.,15,0,25,10
1683731474882,LTEA 138,A00,186119,Staff,13,0,40,27
1683731475908,LTEN 124,A00,186148,Staff,5,0,25,20
1683731476935,LTEN 178,A00,186149,Staff,6,0,15,9
1683731477962,LTEN 181,A00,186150,Blanco; John D,34,0,40,6
1683731478988,LTWL 120,A00,186160,Staff,19,0,25,6
1683731480069,LTWL 165,A00,186161,Staff,22,0,25,3
1683731481099,LTWR 100,A00,186162,Staff,0,5,15,15
1683731482126,LTWR 102,A00,186163,Doller; Ben,5,0,15,10
1683731483150,MAE 8,A01,186412,Staff,0,1,0,0
1683731484177,MAE 30B,A00,186445,Bahadori; Mohammad Yousef,81,0,100,19
1683731485206,MAE 40,A00,186592,Bewley; Thomas R,10,0,50,40
1683731486231,MAE 101B,A00,186593,Bahadori; Mohammad Yousef,80,0,100,20
1683731487258,MAE 105,A00,186594,Bandaru; Prabhakar,10,0,50,40
1683731488284,MAE 107,A00,186599,Pham; Hieu Tan,0,8,120,120
1683731489310,MAE 148,A01,186660,Silberman; Jack,3,0,16,13
1683731490333,MATH 10A,A01,188095,Staff,0,6,35,35
1683731491359,MATH 10B,A01,188097,Bowers; Adam R.,0,12,30,30
1683731491359,MATH 10B,A02,188099,Bowers; Adam R.,0,11,30,30
1683731491359,MATH 10B,B01,188104,Bowers; Adam R.,0,10,30,30
1683731491359,MATH 10B,B02,188106,Bowers; Adam R.,0,9,30,30
1683731492389,MATH 10C,A01,188111,Staff,0,20,30,30
1683731492389,MATH 10C,A02,188127,Staff,0,19,30,30
1683731492389,MATH 10C,A03,188131,Staff,0,19,30,30
1683731492389,MATH 10C,B01,188218,Staff,17,0,30,13
1683731492389,MATH 10C,B02,188244,Staff,13,0,30,17
1683731492389,MATH 10C,B03,188277,Staff,14,0,30,16
1683731493414,MATH 18,A01,188344,Bach; Quang Tran,18,0,30,12
1683731493414,MATH 18,A02,188345,Bach; Quang Tran,11,0,30,19
1683731493414,MATH 18,B01,188353,Bach; Quang Tran,11,0,30,19
1683731493414,MATH 18,B02,188354,Bach; Quang Tran,19,0,30,11
1683731494438,MATH 20A,A01,188374,Staff,10,0,35,25
1683731495462,MATH 20B,A01,188382,Ohm; Ko Woon,7,0,30,23
1683731495462,MATH 20B,A02,188383,Ohm; Ko Woon,22,0,30,8
1683731495462,MATH 20B,B01,188385,Ohm; Ko Woon,7,0,30,23
1683731495462,MATH 20B,B02,188392,Ohm; Ko Woon,22,0,30,8
1683731496487,MATH 20C,A01,188394,Harel; Guershon,10,0,30,20
1683731496487,MATH 20C,A02,188395,Harel; Guershon,13,0,30,17
1683731496487,MATH 20C,B01,188404,Harel; Guershon,5,0,30,25
1683731496487,MATH 20C,B02,188405,Harel; Guershon,18,0,30,12
1683731497513,MATH 20D,A01,188414,Hammock; Frances H,0,1,30,30
1683731497513,MATH 20D,A02,188415,Hammock; Frances H,0,1,30,30
1683731497513,MATH 20D,B01,188447,Hammock; Frances H,0,1,30,30
1683731497513,MATH 20D,B02,188486,Hammock; Frances H,2,0,30,28
1683731498538,MATH 20E,A01,188649,Staff,21,0,30,9
1683731498538,MATH 20E,A02,188650,Staff,20,0,30,10
1683731498538,MATH 20E,A03,188673,Staff,0,0,30,30
1683731499562,MATH 102,A01,188675,Staff,0,40,35,35
1683731500587,MATH 103B,A01,188681,Staff,3,0,35,32
1683731500587,MATH 103B,B01,188692,Staff,5,0,35,30
1683731501613,MATH 109,A01,188695,Salehi Golsefidy; Alireza,24,0,35,11
1683731501613,MATH 109,A02,188696,Salehi Golsefidy; Alireza,24,0,35,11
1683731502641,MATH 120A,A01,188698,Eggers; John Dietrich,7,0,35,28
1683731503667,MATH 142B,A01,188736,Ioana; Adrian,0,0,30,30
1683731503667,MATH 142B,A02,188741,Ioana; Adrian,0,1,30,30
1683731503667,MATH 142B,A03,188743,Ioana; Adrian,0,3,30,30
1683731504693,MATH 168A,A01,188790,Staff,0,11,35,35
1683731505719,MATH 170A,A01,188803,Nie; Jiawang,0,2,35,35
1683731505719,MATH 170A,A02,188811,Nie; Jiawang,0,1,35,35
1683731505719,MATH 170A,A03,188814,Nie; Jiawang,1,0,35,34
1683731505719,MATH 170A,A04,188815,Nie; Jiawang,5,0,35,30
1683731506744,MATH 193B,A01,188817,Staff,0,0,35,35
1683731506744,MATH 193B,A02,188818,Staff,6,0,35,29
1683731507775,MGT 4,A01,202857,Anderson; John Charles,59,0,80,21
1683731508806,MGT 12,A00,202858,Lindenberger; Wade Douglas,40,0,90,50
1683731509830,MGT 18,A00,202859,Staff,73,0,90,17
1683731510858,MGT 18GS,A00,202860,McKay; Michael J,13,0,28,15
1683731511882,MGT 45,A00,202861,Pecore; Joseph P.,8,0,90,82
1683731512907,MGT 100,A00,202863,Yavorsky; Daniel Ryan,27,0,90,63
1683731513935,MGT 103,A00,202864,Ehrich; Kristine R,0,19,90,90
1683731514961,MGT 112,A00,202865,Ehrich; Kristine R,15,0,90,75
1683731515991,MGT 121A,A00,202868,Staff,70,0,90,20
1683731517017,MGT 131B,A00,202869,Anderson; John Charles,58,0,90,32
1683731518044,MGT 136,A00,202871,Lindenberger; Wade Douglas,83,0,90,7
1683731519073,MGT 164,A00,202873,Staff,0,67,90,91
1683731520101,MGT 164GS,A00,202874,McKay; Mary A,13,0,28,15
1683731521125,MGT 180,A00,202875,Staff,0,51,90,91
1683731522149,MMW 11R,A01,205019,Herbst; Matthew,0,0,30,30
1683731522149,MMW 11R,A02,205026,Herbst; Matthew,29,0,30,1
1683731523177,MMW 15,A01,193512,Chang; Edmond Yi-Teh,0,8,28,28
1683731523177,MMW 15,A02,193513,Chang; Edmond Yi-Teh,0,5,28,28
1683731523177,MMW 15,A03,193514,Chang; Edmond Yi-Teh,0,5,28,28
1683731523177,MMW 15,A04,193515,Chang; Edmond Yi-Teh,0,5,28,28
1683731523177,MMW 15,A05,193516,Chang; Edmond Yi-Teh,0,5,28,28
1683731523177,MMW 15,A06,193517,Chang; Edmond Yi-Teh,0,6,28,28
1683731523177,MMW 15,B01,193519,Chang; Edmond Yi-Teh,0,5,28,28
1683731523177,MMW 15,B02,193520,Chang; Edmond Yi-Teh,0,5,28,28
1683731523177,MMW 15,B03,193521,Chang; Edmond Yi-Teh,0,5,28,28
1683731523177,MMW 15,B04,193522,Chang; Edmond Yi-Teh,0,6,28,28
1683731523177,MMW 15,B05,193523,Chang; Edmond Yi-Teh,0,5,28,28
1683731523177,MMW 15,B06,193524,Chang; Edmond Yi-Teh,0,5,28,28
1683731524201,MMW 122,A01,193526,Rahimi; Babak,0,16,28,28
1683731524201,MMW 122,A02,193527,Rahimi; Babak,0,15,28,28
1683731524201,MMW 122,A03,193528,Rahimi; Babak,0,0,0,0
1683731524201,MMW 122,A04,193529,Rahimi; Babak,0,0,0,0
1683731525224,MUS 1A,A01,186663,Staff,0,18,35,35
1683731526248,MUS 4,A01,186715,Staff,0,12,35,35
1683731527272,MUS 5R,A01,186796,Dubnov; Shlomo,0,17,35,35
1683731528297,MUS 6,A01,186798,Staff,0,4,25,25
1683731529321,MUS 7,A01,186830,Staff,11,0,35,24
1683731530348,MUS 8,A01,186930,Staff,0,27,35,35
1683731531377,MUS 15,A01,186932,Staff,0,15,35,35
1683731531377,MUS 15,B01,186934,Staff,0,16,35,35
1683731532400,MUS 80,A00,186935,Staff,0,0,20,20
1683731532400,MUS 80,B00,186936,Staff,24,0,25,1
1683731533425,NANO 11,A00,204702,Lipomi; Darren John,0,0,0,0
1683731534460,NANO 15,A01,204709,Yang; Kesong,0,1,0,0
1683731535484,NANO 114,A00,202069,Jahed Motlagh; Zeinab,2,0,10,8
1683731536512,PHIL 1,A00,186955,Grush; Rick Scott,31,0,40,9
1683731537540,PHIL 10,A01,186973,Grush; Rick Scott,27,0,35,8
1683731537540,PHIL 10,A02,186974,Grush; Rick Scott,33,0,35,2
1683731538564,PHIL 13,A01,186976,Staff,1,0,35,34
1683731538564,PHIL 13,A02,186977,Staff,16,0,35,19
1683731539588,PHIL 14,A01,186979,Staff,30,0,35,5
1683731539588,PHIL 14,A02,186986,Staff,32,0,35,3
1683731540612,PHIL 28,A01,186988,Staff,16,0,30,14
1683731540612,PHIL 28,A02,186989,Staff,0,0,30,30
1683731540612,PHIL 28,A03,186990,Staff,10,0,30,20
1683731540612,PHIL 28,A04,186991,Staff,26,0,30,4
1683731541635,PHIL 120,A00,186997,Staff,23,0,40,17
1683731542659,PHIL 137,A00,187003,Staff,8,0,40,32
1683731543685,PHIL 150,A00,187015,Staff,47,0,70,23
1683731544709,PHIL 167,A00,187021,Lamey; Andy M.,34,0,40,6
1683731545734,PHIL 174,A01,202226,Staff,17,0,20,3
1683731545734,PHIL 174,A02,202235,Staff,20,0,20,0
1683731546762,PHIL 191A,A00,258918,Staff,0,0,1,1
1683731547789,PHYS 1A,A00,187028,Staff,26,0,60,34
1683731548814,PHYS 1AL,001,187036,Staff,3,0,30,27
1683731548814,PHYS 1AL,002,187049,Staff,18,0,30,12
1683731549839,PHYS 1B,A00,187058,Staff,21,0,60,39
1683731550864,PHYS 1BL,001,187064,Staff,0,1,30,30
1683731550864,PHYS 1BL,002,187070,Staff,4,0,30,26
1683731551888,PHYS 1C,A00,187082,Staff,30,0,120,90
1683731552913,PHYS 1CL,001,187088,Staff,0,9,30,30
1683731552913,PHYS 1CL,002,187089,Staff,0,1,30,30
1683731552913,PHYS 1CL,009,262693,Staff,9,0,30,21
1683731553938,PHYS 2B,A01,187097,Staff,55,0,115,60
1683731554963,PHYS 2C,A01,187099,Staff,63,0,115,52
1683731555987,PHYS 2CL,A01,187101,Staff,5,0,28,23
1683731555987,PHYS 2CL,A02,187102,Staff,15,0,28,13
1683731557011,PHYS 2D,A01,187123,Shotwell; Brian,95,0,115,20
1683731558039,PHYS 4B,A01,187133,Grinstein; Benjamin,35,0,50,15
1683731559067,POLI 10,A00,188819,Staff,0,4,50,50
1683731560091,POLI 11,A00,188827,Staff,43,0,50,7
1683731561118,POLI 13R,A00,188828,Staff,0,2,20,20
1683731562143,POLI 27,A01,188830,Elgin; Samuel Zincke,0,2,70,70
1683731563167,POLI 30,A00,188832,Desposato; Scott,30,0,50,20
1683731564199,POLI 102F,A00,188834,Staff,1,0,40,39
1683731565226,POLI 104A,A00,188852,Staff,12,0,30,18
1683731566254,POLI 104I,A00,188853,Staff,0,8,20,20
1683731567280,POLI 110B,A00,188854,Wiens; David,6,0,20,14
1683731568308,POLI 112A,A00,188855,Wiens; David,3,0,30,27
1683731569335,POLI 117R,A00,188856,Forman; Fonna,0,12,20,20
1683731570362,POLI 118,A00,188857,Ingham; Sean,8,0,20,12
1683731571390,POLI 120G,A00,188858,Staff,7,0,30,23
1683731572414,POLI 131CR,A00,188863,Hoston; Germaine,20,0,50,30
1683731573442,POLI 133,A00,188864,Nellis; Gareth Hb,44,0,50,6
1683731574470,POLI 134D,A00,188865,Desposato; Scott,27,0,30,3
1683731575498,POLI 142A,A00,188871,Gartzke; Erik,21,0,50,29
1683731576522,POLI 142K,A00,188874,Staff,38,0,50,12
1683731577546,POLI 143,A00,188940,Gartzke; Erik,15,0,30,15
1683731578571,POLI 153,A00,188943,Staff,1,0,20,19
1683731579597,POLI 160AA,A00,188944,Staff,10,0,40,30
1683731580621,POLI 170A,A00,188945,Staff,10,0,30,20
1683731582670,PSYC 1,A00,188952,Staff,36,0,90,54
1683731583755,PSYC 2,B00,188953,Staff,19,0,35,16
1683731584780,PSYC 6,A00,188970,Staff,47,0,60,13
1683731585807,PSYC 7,A00,188973,Staff,35,0,45,10
1683731586833,PSYC 60,A01,188980,Rickard; Timothy C.,42,0,60,18
1683731587858,PSYC 70,A01,189001,Steiner; Eric Tomas,21,0,45,24
1683731588892,PSYC 100,A00,189005,Lacefield; Katharine I,1,98,120,119
1683731589917,PSYC 102,A00,189008,Staff,6,0,30,24
1683731590943,PSYC 106,B00,189026,Gorman; Michael R.,27,0,60,33
1683731591971,PSYC 114,B01,189033,Winkielman; Piotr,0,31,30,30
1683731592998,PSYC 131,A00,189036,Anagnostaras; Stephan,0,44,60,60
1683731594022,PSYC 136,A00,189041,Lowe; Angela Beth,0,7,25,25
1683731595050,PSYC 137,A00,189057,Winkielman; Piotr,0,36,25,25
1683731596078,PSYC 144,A00,189107,Wixted; John T,0,11,50,50
1683731598132,PSYC 162,A00,189142,Staff,0,9,85,85
1683731599156,PSYC 172,A00,189144,Gorman; Michael R.,0,6,30,30
1683731601205,PSYC 179,A00,189146,Lacefield; Katharine I,0,88,120,120
1683731602233,PSYC 181,A00,189147,Anagnostaras; Stephan,110,45,200,90
1683731603261,PSYC 190R,A00,189148,Barner; David A.,0,23,80,80
1683731604293,PSYC 191,A00,189275,Rickard; Timothy C.,0,11,25,25
1683731605322,PSYC 193,A00,189276,Chapman; Eddie Nathaniel,0,1,0,4
1683731606349,PSYC 193L,A01,189281,Lowe; Angela Beth,8,0,20,12
1683731606349,PSYC 193L,B01,189285,Staff,28,0,35,7
1683731607373,RELI 149,A00,187137,Rahimi; Babak,6,0,40,34
1683731608402,SE 9,A01,187315,Staff,0,2,18,18
1683731609426,SE 101B,A00,187409,Staff,24,0,30,6
1683731610460,SE 110B,A00,187444,Staff,10,0,40,30
1683731611484,SE 130B,A00,187449,Staff,31,0,40,9
1683731612508,SE 150A,A00,187516,Staff,8,0,20,12
1683731613537,SE 154,A00,187528,Staff,29,0,50,21
1683731614562,SIO 3,A01,258171,Staff,35,0,40,5
1683731615590,SIO 10,A00,187144,Cook; Geoffrey W,0,6,75,75
1683731616615,SIO 45,A00,187152,Cook; Geoffrey W,1,7,100,99
1683731617637,SIO 109R,A00,194486,Staff,0,4,20,20
1683731619697,SIO 187,A01,187233,Kacev; David,12,0,40,28
1683731620726,SOCI 1,A01,258656,Thorpe; Charles Robert,28,0,30,2
1683731620726,SOCI 1,A02,258658,Thorpe; Charles Robert,30,0,30,0
1683731620726,SOCI 1,A03,258661,Thorpe; Charles Robert,25,0,25,0
1683731620726,SOCI 1,A04,258666,Thorpe; Charles Robert,22,0,25,3
1683731620726,SOCI 1,A05,258897,Thorpe; Charles Robert,22,0,25,3
1683731620726,SOCI 1,A06,258898,Thorpe; Charles Robert,25,0,25,0
1683731621751,SOCI 30,A01,258903,Pardo Guerra; Juan Pablo,14,0,30,16
1683731622776,SOCI 102,A00,258904,Staff,9,0,25,16
1683731623800,SOCI 106,A00,258905,Staff,19,0,25,6
1683731624828,SOCI 111,A00,258907,Ribas Norris; Janet Vanesa,26,0,30,4
1683731625855,SOCI 121R,A00,258908,Pardo Guerra; Juan Pablo,7,0,30,23
1683731626884,SOCI 126,A01,203330,Staff,14,0,20,6
1683731627908,SOCI 131,A00,258909,Thorpe; Charles Robert,30,0,60,30
1683731628931,SOCI 135,A00,258910,Payne; Christine Anna,0,13,30,30
1683731629955,SOCI 157,A00,258911,Staff,10,0,30,20
1683731630982,SOCI 184,A00,258912,Staff,25,0,30,5
1683731632005,SOCI 188D,A00,258913,Staff,22,0,30,8
1683731633030,SYN 2,001,187529,Staff,9,0,16,7
1683731633030,SYN 2,002,201452,Staff,0,20,16,16
1683731633030,SYN 2,003,201469,Staff,1,0,16,15
1683731634055,SYN 100,A01,187531,Staff,0,9,20,20
1683731634055,SYN 100,B01,201491,Staff,0,10,20,20
1683731635085,TDAC 1,A00,189286,Walsh; Kim C.,3,0,20,17
1683731635085,TDAC 1,B00,189287,Harting; Carla Kelso,10,0,20,10
1683731636113,TDAC 101,A00,189300,Walsh; Kim C.,16,0,20,4
1683731636113,TDAC 101,B00,189301,Harting; Carla Kelso,18,0,20,2
1683731637142,TDAC 102,A00,189304,Basso; Beatrice,14,0,20,6
1683731638166,TDAC 108,A00,189305,Staff,18,0,20,2
1683731639192,TDDE 131,A00,189310,Staff,19,0,20,1
1683731639192,TDDE 131,B00,189314,Staff,19,0,20,1
1683731639192,TDDE 131,C00,189315,Staff,48,0,50,2
1683731639192,TDDE 131,D00,189316,Staff,14,0,15,1
1683731639192,TDDE 131,E00,204841,Staff,20,0,20,0
1683731640219,TDGE 10,A00,189289,Staff,26,0,50,24
1683731640219,TDGE 10,B00,189290,Havis; Allan,0,1,50,50
1683731641249,TDGE 11,A00,189291,Fulton; Julia,0,4,50,50
1683731641249,TDGE 11,B00,189292,Staff,20,0,25,5
1683731641249,TDGE 11,C00,260270,Staff,0,0,0,0
1683731642275,TDGE 25,A00,189294,Staff,1,0,20,19
1683731643302,TDGE 124,A00,189318,Fulton; Julia,0,7,50,50
1683731644329,TDGE 125,A00,189319,Staff,13,0,25,12
1683731644329,TDGE 125,B00,189320,Staff,23,0,25,2
1683731645357,TDGE 127,A00,189322,Havis; Allan,1,0,50,49
1683731646385,TDHT 101,A00,189323,Staff,18,0,25,7
1683731646385,TDHT 101,B00,189324,Staff,25,0,25,0
1683731647408,TDHT 102,A00,189325,Staff,49,0,50,1
1683731648433,TDMV 1,A00,189295,Arcidiacono; Kristin,20,0,30,10
1683731648433,TDMV 1,B00,189296,Caligagan; Maria T.,23,0,30,7
1683731649463,TDMV 2,A00,189297,Sammartano; Tonnie,27,0,30,3
1683731649463,TDMV 2,B00,189299,Arcidiacono; Kristin,23,0,30,7
1683731650486,TDMV 3,A00,204998,Rincon; Alicia,22,0,30,8
1683731651510,TDMV 120,A00,189458,Sammartano; Tonnie,28,0,30,2
1683731652537,TDMV 138,A00,189541,Jun; Grace Shin Hae,20,0,40,20
1683731653562,TDMV 142,A00,189717,Caligagan; Tony,25,0,30,5
1683731653562,TDMV 142,B00,189718,Caligagan; Maria T.,25,0,30,5
1683731654588,TMC 2,A01,187533,Staff,25,0,25,0
1683731654588,TMC 2,A02,187534,Staff,25,0,25,0
1683731655613,USP 1,A01,187536,Kwak; Nancy,0,16,25,25
1683731656638,USP 5,A01,187538,Staff,8,0,25,17
1683731657663,USP 101,A00,199253,Staff,0,4,0,0
1683731658691,USP 124,A00,187562,Boomhower; Matthew Charles,0,0,30,30
1683731659724,USP 138,A00,187582,Staff,19,0,25,6
1683731660752,USP 152,A01,187597,Staff,3,0,25,22
1683731661783,USP 153,A00,187598,Staff,18,0,25,7
1683731662810,USP 168,A00,187607,Kwak; Nancy,2,0,5,3
1683731663834,USP 173,A00,187619,Staff,4,0,25,21
1683731664859,USP 181,A00,187638,Staff,0,4,25,25
1683731665883,VIS 103,A00,187650,Cruz; Edwin Teddy,17,0,75,58
1683731666908,VIS 110D,A00,187669,Staff,13,0,22,9
1683731667936,VIS 127C,A00,187720,Shen; Kuiyi,67,0,146,79
1683731668963,VIS 149,A00,187731,Yoldas; Pinar,0,12,22,22
1683731669990,VIS 151,A01,188091,Staff,22,0,34,12
1683731669990,VIS 151,A02,188092,Staff,11,0,34,23
1683731671017,VIS 160B,A00,188093,Stalbaum; Brett,0,1,10,10
1683731673073,WCWP 10B,A00,201720,Staff,0,0,5,5
1683731673073,WCWP 10B,B00,201722,Staff,0,0,6,6
1683731674101,WCWP 100,A00,201725,Gagnon; Jeffrey C,0,0,2,2
1683731674101,WCWP 100,B00,201727,Staff,0,4,15,15
1683731677193,ANBI 133,A00,258401,Wilder; Linnea Lorene,34,0,40,6
1683731678222,ANBI 140,A00,258395,Hrvoj Mihic; Branka,18,0,25,7
1683731679245,ANSC 120,A00,258402,Bialecki; Jon Anthony,26,0,40,14
1683731680275,ANSC 144,A00,258400,Staff,12,0,40,28
1683731682328,ANSC 166,A00,258396,Parish; Steven Martin,156,0,175,19
1683731683352,ANSC 180,A00,193533,Staff,8,0,20,12
1683731684379,ANSC 188,A00,258397,Jassal; Aftab,34,0,40,6
1683731685407,ANTH 3,A01,258316,Staff,23,0,30,7
1683731686435,ANTH 5,A00,258394,Semendeferi; Ekaterini,16,0,20,4
1683731687519,ANTH 21,A01,258331,Staff,4,0,40,36
1683731688548,ANTH 103,A00,258398,Varma; Saiba,15,0,25,10
1683731689578,AWP 10,001,202034,Staff,0,0,0,0
1683731689578,AWP 10,002,202035,Staff,0,0,0,0
1683731689578,AWP 10,003,202036,Staff,0,0,0,0
1683731689578,AWP 10,004,202037,Staff,0,0,0,0
1683731689578,AWP 10,005,202038,Staff,0,0,0,0
1683731689578,AWP 10,006,202039,Staff,0,0,0,0
1683731689578,AWP 10,007,202040,Staff,0,0,0,0
1683731689578,AWP 10,008,202041,Staff,0,0,0,0
1683731689578,AWP 10,009,202042,Staff,0,0,0,0
1683731689578,AWP 10,010,202043,Staff,0,0,0,0
1683731689578,AWP 10,011,202044,Staff,0,0,0,0
1683731689578,AWP 10,012,202045,Staff,0,0,0,0
1683731689578,AWP 10,013,202046,Staff,0,0,0,0
1683731689578,AWP 10,014,202047,Staff,0,0,0,0
1683731689578,AWP 10,015,202048,Staff,0,0,0,0
1683731689578,AWP 10,016,202049,Staff,0,0,0,0
1683731689578,AWP 10,017,202050,Staff,0,0,0,0
1683731689578,AWP 10,018,202051,Staff,0,0,0,0
1683731689578,AWP 10,019,202052,Staff,0,0,0,0
1683731689578,AWP 10,020,202053,Staff,0,0,0,0
1683731689578,AWP 10,021,202054,Staff,0,0,0,0
1683731689578,AWP 10,022,202055,Staff,0,0,0,0
1683731689578,AWP 10,023,202056,Staff,0,0,0,0
1683731689578,AWP 10,024,202057,Staff,0,0,0,0
1683731689578,AWP 10,025,202058,Staff,0,0,0,0
1683731689578,AWP 10,026,202059,Staff,0,0,0,0
1683731690602,AWP 102,001,202032,Staff,0,0,0,0
1683731690602,AWP 102,002,202033,Staff,0,0,0,0
1683731691627,BENG 100,A01,254234,Taylor Amos; Alyssa C,31,0,40,9
1683731692654,BENG 196,001,270013,Engler; Adam J.,9999,0,9999,0
1683731693680,BICD 100R,A01,202018,Smith; Laurie,0,7,32,32
1683731693680,BICD 100R,A02,202019,Smith; Laurie,0,3,32,32
1683731693680,BICD 100R,A03,202020,Smith; Laurie,0,1,32,32
1683731693680,BICD 100R,A04,202021,Smith; Laurie,6,0,32,26
1683731693680,BICD 100R,A05,202022,Smith; Laurie,10,0,32,22
1683731694708,BICD 136,A01,193242,Gustafson-Brown; Cindy,0,2,32,32
1683731694708,BICD 136,A02,193244,Gustafson-Brown; Cindy,13,0,32,19
1683731695735,BIEB 102,A01,193249,Butler; Shannon Rhey,0,0,32,32
1683731695735,BIEB 102,A02,193251,Butler; Shannon Rhey,0,0,32,32
1683731695735,BIEB 102,A03,193253,Butler; Shannon Rhey,0,0,32,32
1683731695735,BIEB 102,A04,193255,Butler; Shannon Rhey,13,0,32,19
1683731695735,BIEB 102,A05,193265,Butler; Shannon Rhey,25,0,32,7
1683731695735,BIEB 102,A06,193269,Butler; Shannon Rhey,12,0,32,20
1683731697786,BIEB 150,A01,193274,Staff,0,0,32,32
1683731697786,BIEB 150,A02,193285,Staff,24,0,32,8
1683731698811,BIEB 194,A00,193286,Kurle; Carolyn M.,19,0,32,13
1683731699836,BILD 1,A01,192291,Staff,15,0,32,17
1683731699836,BILD 1,A02,192292,Staff,30,0,32,2
1683731699836,BILD 1,B01,192520,Reuther; Keefe,0,1,0,0
1683731699836,BILD 1,B02,192532,Reuther; Keefe,0,1,0,0
1683731700860,BILD 3,A01,192556,Butler; Shannon Rhey,0,0,32,32
1683731700860,BILD 3,A02,192581,Butler; Shannon Rhey,0,1,32,32
1683731700860,BILD 3,A03,192611,Butler; Shannon Rhey,19,0,32,13
1683731700860,BILD 3,A04,192612,Butler; Shannon Rhey,23,0,32,9
1683731700860,BILD 3,A05,192613,Butler; Shannon Rhey,26,0,32,6
1683731700860,BILD 3,A06,192679,Butler; Shannon Rhey,27,0,32,5
1683731700860,BILD 3,A07,192682,Butler; Shannon Rhey,20,0,32,12
1683731701885,BILD 4,A01,192836,Reuther; Keefe,1,0,24,23
1683731701885,BILD 4,A02,193044,Reuther; Keefe,4,0,24,20
1683731702913,BILD 10,A01,193142,Gustafson-Brown; Cindy,29,0,32,3
1683731702913,BILD 10,A02,193149,Gustafson-Brown; Cindy,31,0,32,1
1683731703940,BIMM 100,A01,193301,Staff,0,6,32,32
1683731703940,BIMM 100,A02,193312,Staff,0,7,32,32
1683731703940,BIMM 100,A03,193323,Staff,0,10,32,32
1683731704977,BIMM 101,A01,193329,McDonnell; Lisa Marie,0,3,24,24
1683731704977,BIMM 101,A02,193339,McDonnell; Lisa Marie,0,3,24,24
1683731704977,BIMM 101,B01,193354,McDonnell; Lisa Marie,0,4,24,24
1683731704977,BIMM 101,B02,193357,McDonnell; Lisa Marie,0,3,24,24
1683731706001,BIMM 110,A01,193377,Tat; John,0,11,32,32
1683731706001,BIMM 110,A02,193378,Tat; John,0,11,32,32
1683731707029,BIMM 120,A01,206116,Staff,1,0,32,31
1683731707029,BIMM 120,A02,206117,Staff,7,0,32,25
1683731707029,BIMM 120,A03,206121,Staff,21,0,32,11
1683731708058,BIPN 100,A01,193393,Park; Ji Young,0,15,32,32
1683731708058,BIPN 100,A02,193402,Park; Ji Young,0,14,32,32
1683731708058,BIPN 100,A03,193413,Park; Ji Young,0,14,32,32
1683731708058,BIPN 100,A04,193414,Park; Ji Young,0,13,32,32
1683731709085,BIPN 102,A01,193429,Staff,0,0,32,32
1683731709085,BIPN 102,A02,193438,Staff,18,0,32,14
1683731710109,BIPN 106,A01,193450,Reyes Gonzalez; Catalina,0,2,40,40
1683731711136,BIPN 134,A01,193465,Cooke; James Edward,0,0,32,32
1683731711136,BIPN 134,A02,193474,Cooke; James Edward,25,0,32,7
1683731711136,BIPN 134,A03,193485,Cooke; James Edward,29,0,32,3
1683731711136,BIPN 134,A04,193486,Cooke; James Edward,20,0,32,12
1683731711136,BIPN 134,A05,193491,Cooke; James Edward,31,0,32,1
1683731711136,BIPN 134,A06,193501,Cooke; James Edward,30,0,32,2
1683731711136,BIPN 134,A07,193510,Cooke; James Edward,29,0,32,3
1683731713189,BISP 194,A00,222522,Staff,14,0,32,18
1683731714213,CAT 124,A01,202407,Staff,19,0,25,6
1683731715237,CAT 125,A00,202408,Marchisotto; Jennifer Anne,2,0,20,18
1683731716261,CAT 125R,A00,202409,Smith; Lauryn Alissa,0,11,20,20
1683731716261,CAT 125R,B00,202410,Morales; Celeste Georgianna,0,11,20,20
1683731716261,CAT 125R,C00,202411,Irwin; Matthew Joseph,0,12,20,20
1683731717286,CENG 15,A01,204712,Yang; Kesong,0,1,0,0
1683731718310,CENG 114,A00,202070,Jahed Motlagh; Zeinab,5,0,20,15
1683731719338,CGS 105,A00,185477,Wesling; Megan E.,24,0,40,16
1683731720362,CGS 106,A00,185494,Staff,11,0,22,11
1683731721389,CGS 108,A00,185495,Staff,14,0,20,6
1683731722413,CGS 114,A00,185496,Staff,13,0,18,5
1683731723441,CGS 119,A00,185501,Staff,15,0,20,5
1683731724471,CGS 120,A00,185511,Staff,11,0,20,9
1683731725494,CHEM 4,A01,184675,Bussey; Thomas J,97,0,100,3
1683731726518,CHEM 6A,A01,184677,Staff,32,0,60,28
1683731727542,CHEM 6B,A01,184679,Staff,63,0,100,37
1683731728566,CHEM 6C,A01,184681,Bussey; Thomas J,0,0,50,50
1683731728566,CHEM 6C,A02,184682,Bussey; Thomas J,32,0,50,18
1683731729590,CHEM 40A,A01,184684,Albizati; Kim F.,33,0,100,67
1683731730617,CHEM 40B,A01,184686,Albizati; Kim F.,0,22,100,100
1683731731642,CHEM 41B,A01,184690,Staff,51,0,100,49
1683731732670,COGS 3,A01,184715,Boyle; Mary E. T.,0,27,40,40
1683731733694,COGS 14B,A01,185172,Staff,0,14,38,38
1683731734720,COGS 18,A01,184736,Staff,14,0,80,66
1683731735743,COGS 100,A01,184932,Staff,0,8,73,73
1683731736767,COGS 101A,A01,184935,Staff,0,40,30,30
1683731737791,COGS 101B,A01,184944,Staff,0,2,30,30
1683731738817,COGS 101C,A01,184946,Staff,0,10,30,30
1683731739846,COGS 102A,A01,184951,Johnson; Christine M.,1,0,40,39
1683731740870,COGS 107B,A01,184953,Mooshagian; Eric Frederick,0,52,40,40
1683731741895,COGS 118B,A01,184959,Gupta; Anjum,0,50,40,40
1683731742922,COGS 153,A00,184961,Staff,1,16,30,29
1683731743946,COGS 177,A00,184962,Staff,0,20,30,30
1683731744971,COGS 187A,A01,184969,Boyle; Mary E. T.,0,19,40,40
1683731746003,COMM 10,A01,185174,Staff,0,5,25,25
1683731746003,COMM 10,A02,185189,Staff,0,2,25,25
1683731746003,COMM 10,A03,269821,Staff,0,1,0,0
1683731747032,COMM 100B,A02,185476,Staff,10,0,25,15
1683731747032,COMM 100B,A03,277340,Staff,25,0,25,0
1683731748057,COMM 100C,A01,185314,Staff,2,0,25,23
1683731748057,COMM 100C,A02,185327,Staff,17,0,25,8
1683731749081,COMM 110M,A00,185349,Staff,0,0,40,40
1683731750113,COMM 113T,A00,185352,Staff,25,0,40,15
1683731751139,COMM 114I,A00,185353,Staff,31,0,40,9
1683731752167,COMM 131,A00,185354,Staff,17,0,30,13
1683731753197,CSE 8A,A50,185358,Cao; Yingjun,0,46,10,10
1683731754222,CSE 8B,A01,185362,Staff,0,48,50,50
1683731755245,CSE 11,A01,185416,Cao; Yingjun,0,91,10,10
1683731756274,CSE 20,A01,185445,Briones; Jor-el Thomas Caparas,3,0,25,22
1683731757300,CSE 21,A01,185447,Staff,9,0,50,41
1683731758323,CSE 101,A01,185451,Staff,0,13,50,50
1683731758323,CSE 101,B01,185453,Jones; Miles E,0,15,50,50
1683731760372,CSE 141,A01,185458,Eldon; John,16,0,100,84
1683731761400,CSE 141L,A01,185461,Eldon; John,8,0,100,92
1683731762458,CSE 142,A01,185463,Staff,34,0,60,26
1683731762458,CSE 142,B01,201355,Staff,0,7,60,60
1683731763486,CSE 142L,A01,185470,Staff,34,0,60,26
1683731763486,CSE 142L,B01,201417,Staff,0,6,60,60
1683731764514,CSE 190,A00,201433,Staff,32,0,49,17
1683731765540,DOC 1,A01,259136,Strom; Megan C.,7,0,15,8
1683731765540,DOC 1,A02,259137,Strom; Megan C.,15,0,15,0
1683731765540,DOC 1,A03,259138,Strom; Megan C.,14,0,15,1
1683731765540,DOC 1,A04,259139,Strom; Megan C.,13,0,15,2
1683731766565,DOC 100D,A00,259140,Pass; Natalye Joann,14,0,25,11
1683731767589,DSGN 1,A01,184749,Rill; Bryan,0,26,30,30
1683731768614,DSGN 100,A01,185168,Staff,0,2,25,25
1683731769642,ECE 5,A01,185626,Morris; Karcher William,0,12,0,0
1683731770674,ECE 101,A01,185628,Staff,14,0,70,56
1683731771718,ECE 107,A01,185635,Baghdadchi; Saharnaz,0,0,20,20
1683731771718,ECE 107,A02,185638,Baghdadchi; Saharnaz,1,0,20,19
1683731772743,ECE 148,A01,185647,Silberman; Jack,0,0,16,16
1683731773767,ECON 1,A01,185537,Crane; Meredith Helen,54,0,70,16
1683731774796,ECON 3,A01,185549,Crane; Meredith Helen,30,0,70,40
1683731775825,ECON 4,A01,203354,Anderson; John Charles,0,5,10,10
1683731776849,ECON 100A,A01,185574,Staff,0,5,40,40
1683731777881,ECON 100B,A01,185576,Staff,0,12,50,50
1683731778913,ECON 100C,A01,185589,Newhouse; Herbert S,30,0,70,40
1683731779938,ECON 105,A00,185608,Vespa; Emanuel Ignacio,19,0,35,16
1683731780965,ECON 109,A01,185610,Shishkin; Denis,9,0,35,26
1683731781989,ECON 110A,A01,185612,Staff,8,0,40,32
1683731783015,ECON 120A,A01,185615,Staff,19,0,40,21
1683731784040,ECON 120C,A01,185617,Sun; Yixiao,0,21,70,70
1683731785070,ECON 144,A00,203346,Squires; Dale E,2,0,35,33
1683731786099,ECON 171,A01,203349,Newhouse; Herbert S,0,1,35,35
1683731787127,ECON 173A,A01,185621,Toda; Alexis Akira,21,0,35,14
1683731788156,EDS 25,A01,202413,Staff,0,1,0,0
1683731788156,EDS 25,A02,202414,Staff,0,1,0,0
1683731788156,EDS 25,A03,202415,Staff,0,0,0,0
1683731788156,EDS 25,A04,202416,Staff,0,1,0,0
1683731788156,EDS 25,A05,202439,Staff,0,0,0,0
1683731788156,EDS 25,A06,202440,Staff,0,0,0,0
1683731788156,EDS 25,B01,202631,Staff,0,0,0,0
1683731788156,EDS 25,B02,202632,Staff,0,0,0,0
1683731788156,EDS 25,B03,202639,Staff,0,0,0,0
1683731788156,EDS 25,B04,202640,Staff,0,0,0,0
1683731788156,EDS 25,B05,202643,Staff,0,0,0,0
1683731788156,EDS 25,B06,202644,Staff,0,0,0,0
1683731789181,EDS 38,A01,202659,Black; Alison Michelle,25,0,25,0
1683731790209,EDS 115,A00,202652,Staff,18,0,30,12
1683731791293,EDS 125,A00,202649,Staff,13,0,30,17
1683731792317,EDS 126,A01,203332,Staff,30,0,30,0
1683731793343,EDS 139,A00,202838,Staff,16,0,25,9
1683731794367,EDS 146,A01,202655,Staff,14,0,25,11
1683731795395,ENG 15,A00,185667,Staff,0,1,0,0
1683731795395,ENG 15,B00,185672,Staff,0,0,0,0
1683731795395,ENG 15,C00,185675,Staff,0,0,0,0
1683731795395,ENG 15,D00,185682,Staff,0,0,0,0
1683731795395,ENG 15,E00,185684,Staff,0,0,0,0
1683731796420,ETHN 103,A00,185710,Staff,0,8,35,35
1683731797446,ETHN 103A,A00,199228,Man; Simeon S,0,0,9,9
1683731798491,ETHN 109,A00,185711,Staff,15,0,35,20
1683731799516,ETHN 142,A00,185726,Staff,0,4,30,30
1683731800542,ETHN 163J,A00,199229,Man; Simeon S,5,0,8,3
1683731801566,ETHN 168,A00,185727,Staff,7,0,10,3
1683731802593,ETHN 182,A00,185728,Staff,0,0,35,35
1683731803621,ETHN 183,A00,185737,Staff,10,0,18,8
1683731804645,GLBH 111,A01,209361,Burgos; Jose L.,0,0,0,0
1683731806698,HIEU 104,A00,185792,Staff,14,0,20,6
1683731807723,HIEU 115,A00,185800,Staff,0,0,20,20
1683731808747,HIEU 128,A00,185801,Staff,0,9,20,20
1683731809773,HIEU 147,A00,185802,Staff,15,0,20,5
1683731810800,HIEU 154,A00,185823,Staff,11,0,20,9
1683731811827,HILA 102,A00,185826,Staff,14,0,20,6
1683731812852,HILD 2C,A01,185778,Staff,0,13,20,20
1683731813877,HILD 7B,A01,185780,Kwak; Nancy,0,17,32,32
1683731813877,HILD 7B,A02,185781,Kwak; Nancy,0,18,32,32
1683731814905,HILD 30,A01,185791,Staff,12,0,20,8
1683731815933,HISC 119,A00,185830,Golan; Tal,0,10,20,20
1683731816961,HITO 156GS,A00,185831,Patterson; Patrick H.,0,0,0,23
1683731817989,HIUS 103,A00,185832,Man; Simeon S,0,4,20,20
1683731819018,HIUS 117,A00,185836,Kwak; Nancy,2,0,20,18
1683731820046,HIUS 125,A00,185840,Man; Simeon S,0,2,23,23
1683731821072,HIUS 149,A00,185845,Staff,1,0,20,19
1683731822101,HUM 3,A01,185882,Zavodny; Tatiana Sophia,0,8,50,50
1683731822101,HUM 3,B01,185899,Caldwell; Michael Alan,0,18,50,50
1683731823131,HUM 3GS,A00,185900,Patterson; Patrick H.,0,0,0,23
1683731824160,HUM 4,A01,185938,Zroka; Amy Liane,28,0,50,22
1683731824160,HUM 4,B01,185956,Watkins; Eric,0,6,50,50
1683731824160,HUM 4,B02,202209,Watkins; Eric,0,6,50,50
1683731824160,HUM 4,B03,202210,Watkins; Eric,0,5,50,50
1683731825187,HUM 5,A01,185958,West; Geoffrey Scott,0,0,50,50
1683731825187,HUM 5,A02,202215,West; Geoffrey Scott,0,1,50,50
1683731826210,INTL 190,A00,185959,Gagnon; Jeffrey C,0,0,0,9
1683731826210,INTL 190,B00,185960,Lettieri; Michael Joseph,0,0,0,2
1683731827232,JAPN 180,A00,254509,Staff,4,0,30,26
1683731828261,LATI 10,A01,202853,Kennemore; Amy Michelle,4,0,35,31
1683731828261,LATI 10,A02,202854,Kennemore; Amy Michelle,3,0,35,32
1683731828261,LATI 10,A03,270054,Kennemore; Amy Michelle,30,0,30,0
1683731829285,LATI 180,A00,202855,Kennemore; Amy Michelle,11,0,20,9
1683731830313,LAWS 101,A00,201767,Golan; Tal,0,7,40,40
1683731831340,LIFR 1C,A00,185961,Staff,6,0,20,14
1683731832367,LIFR 1CX,A00,185962,Staff,7,0,20,13
1683731833398,LIFR 1D,A00,185963,Staff,7,0,20,13
1683731834425,LIFR 1DX,A00,185964,Staff,7,0,20,13
1683731835449,LIGN 101,A01,186039,Staff,43,0,50,7
1683731836481,LIGN 165,A00,186040,Staff,14,0,50,36
1683731837509,LTCS 108,A00,186041,Staff,5,0,10,5
1683731838534,LTCS 119,A00,186042,Staff,15,0,20,5
1683731839558,LTCS 130,A00,186043,Wesling; Megan E.,15,0,25,10
1683731841610,LTEA 138,A00,186119,Staff,13,0,40,27
1683731842635,LTEN 124,A00,186148,Staff,5,0,25,20
1683731843664,LTEN 178,A00,186149,Staff,6,0,15,9
1683731844689,LTEN 181,A00,186150,Blanco; John D,34,0,40,6
1683731845725,LTWL 120,A00,186160,Staff,19,0,25,6
1683731846753,LTWL 165,A00,186161,Staff,22,0,25,3
1683731847781,LTWR 100,A00,186162,Staff,0,5,15,15
1683731848807,LTWR 102,A00,186163,Doller; Ben,5,0,15,10
1683731849832,MAE 8,A01,186412,Staff,0,1,0,0
1683731850861,MAE 30B,A00,186445,Bahadori; Mohammad Yousef,81,0,100,19
1683731851889,MAE 40,A00,186592,Bewley; Thomas R,10,0,50,40
1683731852915,MAE 101B,A00,186593,Bahadori; Mohammad Yousef,80,0,100,20
1683731853943,MAE 105,A00,186594,Bandaru; Prabhakar,10,0,50,40
1683731854971,MAE 107,A00,186599,Pham; Hieu Tan,0,8,120,120
1683731855996,MAE 148,A01,186660,Silberman; Jack,3,0,16,13
1683731857021,MATH 10A,A01,188095,Staff,0,6,35,35
1683731858047,MATH 10B,A01,188097,Bowers; Adam R.,0,12,30,30
1683731858047,MATH 10B,A02,188099,Bowers; Adam R.,0,11,30,30
1683731858047,MATH 10B,B01,188104,Bowers; Adam R.,0,10,30,30
1683731858047,MATH 10B,B02,188106,Bowers; Adam R.,0,9,30,30
1683731859074,MATH 10C,A01,188111,Staff,0,20,30,30
1683731859074,MATH 10C,A02,188127,Staff,0,19,30,30
1683731859074,MATH 10C,A03,188131,Staff,0,19,30,30
1683731859074,MATH 10C,B01,188218,Staff,17,0,30,13
1683731859074,MATH 10C,B02,188244,Staff,13,0,30,17
1683731859074,MATH 10C,B03,188277,Staff,14,0,30,16
1683731860104,MATH 18,A01,188344,Bach; Quang Tran,18,0,30,12
1683731860104,MATH 18,A02,188345,Bach; Quang Tran,11,0,30,19
1683731860104,MATH 18,B01,188353,Bach; Quang Tran,11,0,30,19
1683731860104,MATH 18,B02,188354,Bach; Quang Tran,19,0,30,11
1683731861128,MATH 20A,A01,188374,Staff,10,0,35,25
1683731862154,MATH 20B,A01,188382,Ohm; Ko Woon,7,0,30,23
1683731862154,MATH 20B,A02,188383,Ohm; Ko Woon,22,0,30,8
1683731862154,MATH 20B,B01,188385,Ohm; Ko Woon,7,0,30,23
1683731862154,MATH 20B,B02,188392,Ohm; Ko Woon,22,0,30,8
1683731863182,MATH 20C,A01,188394,Harel; Guershon,10,0,30,20
1683731863182,MATH 20C,A02,188395,Harel; Guershon,13,0,30,17
1683731863182,MATH 20C,B01,188404,Harel; Guershon,5,0,30,25
1683731863182,MATH 20C,B02,188405,Harel; Guershon,18,0,30,12
1683731864212,MATH 20D,A01,188414,Hammock; Frances H,0,1,30,30
1683731864212,MATH 20D,A02,188415,Hammock; Frances H,0,1,30,30
1683731864212,MATH 20D,B01,188447,Hammock; Frances H,0,1,30,30
1683731864212,MATH 20D,B02,188486,Hammock; Frances H,2,0,30,28
1683731865238,MATH 20E,A01,188649,Staff,21,0,30,9
1683731865238,MATH 20E,A02,188650,Staff,20,0,30,10
1683731865238,MATH 20E,A03,188673,Staff,0,0,30,30
1683731866262,MATH 102,A01,188675,Staff,0,40,35,35
1683731867291,MATH 103B,A01,188681,Staff,3,0,35,32
1683731867291,MATH 103B,B01,188692,Staff,5,0,35,30
1683731868323,MATH 109,A01,188695,Salehi Golsefidy; Alireza,24,0,35,11
1683731868323,MATH 109,A02,188696,Salehi Golsefidy; Alireza,24,0,35,11
1683731869350,MATH 120A,A01,188698,Eggers; John Dietrich,7,0,35,28
1683731870378,MATH 142B,A01,188736,Ioana; Adrian,0,0,30,30
1683731870378,MATH 142B,A02,188741,Ioana; Adrian,0,1,30,30
1683731870378,MATH 142B,A03,188743,Ioana; Adrian,0,3,30,30
1683731871406,MATH 168A,A01,188790,Staff,0,11,35,35
1683731872429,MATH 170A,A01,188803,Nie; Jiawang,0,2,35,35
1683731872429,MATH 170A,A02,188811,Nie; Jiawang,0,1,35,35
1683731872429,MATH 170A,A03,188814,Nie; Jiawang,1,0,35,34
1683731872429,MATH 170A,A04,188815,Nie; Jiawang,5,0,35,30
1683731873455,MATH 193B,A01,188817,Staff,0,0,35,35
1683731873455,MATH 193B,A02,188818,Staff,6,0,35,29
1683731874487,MGT 4,A01,202857,Anderson; John Charles,59,0,80,21
1683731875513,MGT 12,A00,202858,Lindenberger; Wade Douglas,40,0,90,50
1683731876537,MGT 18,A00,202859,Staff,73,0,90,17
1683731877564,MGT 18GS,A00,202860,McKay; Michael J,13,0,28,15
1683731878588,MGT 45,A00,202861,Pecore; Joseph P.,8,0,90,82
1683731879611,MGT 100,A00,202863,Yavorsky; Daniel Ryan,27,0,90,63
1683731880638,MGT 103,A00,202864,Ehrich; Kristine R,0,19,90,90
1683731881661,MGT 112,A00,202865,Ehrich; Kristine R,15,0,90,75
1683731882687,MGT 121A,A00,202868,Staff,70,0,90,20
1683731883712,MGT 131B,A00,202869,Anderson; John Charles,58,0,90,32
1683731884735,MGT 136,A00,202871,Lindenberger; Wade Douglas,83,0,90,7
1683731885760,MGT 164,A00,202873,Staff,0,67,90,91
1683731886786,MGT 164GS,A00,202874,McKay; Mary A,13,0,28,15
1683731887815,MGT 180,A00,202875,Staff,0,51,90,91
1683731888840,MMW 11R,A01,205019,Herbst; Matthew,0,0,30,30
1683731888840,MMW 11R,A02,205026,Herbst; Matthew,29,0,30,1
1683731889867,MMW 15,A01,193512,Chang; Edmond Yi-Teh,0,8,28,28
1683731889867,MMW 15,A02,193513,Chang; Edmond Yi-Teh,0,5,28,28
1683731889867,MMW 15,A03,193514,Chang; Edmond Yi-Teh,0,5,28,28
1683731889867,MMW 15,A04,193515,Chang; Edmond Yi-Teh,0,5,28,28
1683731889867,MMW 15,A05,193516,Chang; Edmond Yi-Teh,0,5,28,28
1683731889867,MMW 15,A06,193517,Chang; Edmond Yi-Teh,0,6,28,28
1683731889867,MMW 15,B01,193519,Chang; Edmond Yi-Teh,0,5,28,28
1683731889867,MMW 15,B02,193520,Chang; Edmond Yi-Teh,0,5,28,28
1683731889867,MMW 15,B03,193521,Chang; Edmond Yi-Teh,0,5,28,28
1683731889867,MMW 15,B04,193522,Chang; Edmond Yi-Teh,0,6,28,28
1683731889867,MMW 15,B05,193523,Chang; Edmond Yi-Teh,0,5,28,28
1683731889867,MMW 15,B06,193524,Chang; Edmond Yi-Teh,0,5,28,28
1683731890895,MMW 122,A01,193526,Rahimi; Babak,0,16,28,28
1683731890895,MMW 122,A02,193527,Rahimi; Babak,0,15,28,28
1683731890895,MMW 122,A03,193528,Rahimi; Babak,0,0,0,0
1683731890895,MMW 122,A04,193529,Rahimi; Babak,0,0,0,0
1683731891919,MUS 1A,A01,186663,Staff,0,18,35,35
1683731892948,MUS 4,A01,186715,Staff,0,12,35,35
1683731893971,MUS 5R,A01,186796,Dubnov; Shlomo,0,17,35,35
1683731895063,MUS 6,A01,186798,Staff,0,4,25,25
1683731896087,MUS 7,A01,186830,Staff,11,0,35,24
1683731897114,MUS 8,A01,186930,Staff,0,27,35,35
1683731898139,MUS 15,A01,186932,Staff,0,15,35,35
1683731898139,MUS 15,B01,186934,Staff,0,16,35,35
1683731899163,MUS 80,A00,186935,Staff,0,0,20,20
1683731899163,MUS 80,B00,186936,Staff,24,0,25,1
1683731900188,NANO 11,A00,204702,Lipomi; Darren John,0,0,0,0
1683731901217,NANO 15,A01,204709,Yang; Kesong,0,1,0,0
1683731902240,NANO 114,A00,202069,Jahed Motlagh; Zeinab,2,0,10,8
1683731903267,PHIL 1,A00,186955,Grush; Rick Scott,31,0,40,9
1683731904292,PHIL 10,A01,186973,Grush; Rick Scott,27,0,35,8
1683731904292,PHIL 10,A02,186974,Grush; Rick Scott,33,0,35,2
1683731905317,PHIL 13,A01,186976,Staff,1,0,35,34
1683731905317,PHIL 13,A02,186977,Staff,16,0,35,19
1683731906344,PHIL 14,A01,186979,Staff,30,0,35,5
1683731906344,PHIL 14,A02,186986,Staff,32,0,35,3
1683731907372,PHIL 28,A01,186988,Staff,16,0,30,14
1683731907372,PHIL 28,A02,186989,Staff,0,0,30,30
1683731907372,PHIL 28,A03,186990,Staff,10,0,30,20
1683731907372,PHIL 28,A04,186991,Staff,26,0,30,4
1683731908396,PHIL 120,A00,186997,Staff,23,0,40,17
1683731909424,PHIL 137,A00,187003,Staff,8,0,40,32
1683731910448,PHIL 150,A00,187015,Staff,47,0,70,23
1683731911471,PHIL 167,A00,187021,Lamey; Andy M.,34,0,40,6
1683731912506,PHIL 174,A01,202226,Staff,17,0,20,3
1683731912506,PHIL 174,A02,202235,Staff,20,0,20,0
1683731913530,PHIL 191A,A00,258918,Staff,0,0,1,1
1683731914558,PHYS 1A,A00,187028,Staff,26,0,60,34
1683731915584,PHYS 1AL,001,187036,Staff,3,0,30,27
1683731915584,PHYS 1AL,002,187049,Staff,18,0,30,12
1683731916609,PHYS 1B,A00,187058,Staff,21,0,60,39
1683731917634,PHYS 1BL,001,187064,Staff,0,1,30,30
1683731917634,PHYS 1BL,002,187070,Staff,4,0,30,26
1683731918659,PHYS 1C,A00,187082,Staff,30,0,120,90
1683731919685,PHYS 1CL,001,187088,Staff,0,9,30,30
1683731919685,PHYS 1CL,002,187089,Staff,0,1,30,30
1683731919685,PHYS 1CL,009,262693,Staff,9,0,30,21
1683731920714,PHYS 2B,A01,187097,Staff,55,0,115,60
1683731921742,PHYS 2C,A01,187099,Staff,63,0,115,52
1683731922766,PHYS 2CL,A01,187101,Staff,5,0,28,23
1683731922766,PHYS 2CL,A02,187102,Staff,15,0,28,13
1683731923794,PHYS 2D,A01,187123,Shotwell; Brian,95,0,115,20
1683731924819,PHYS 4B,A01,187133,Grinstein; Benjamin,35,0,50,15
1683731925846,POLI 10,A00,188819,Staff,0,4,50,50
1683731926877,POLI 11,A00,188827,Staff,43,0,50,7
1683731927905,POLI 13R,A00,188828,Staff,0,2,20,20
1683731928930,POLI 27,A01,188830,Elgin; Samuel Zincke,0,2,70,70
1683731929953,POLI 30,A00,188832,Desposato; Scott,30,0,50,20
1683731930980,POLI 102F,A00,188834,Staff,1,0,40,39
1683731932005,POLI 104A,A00,188852,Staff,12,0,30,18
1683731933033,POLI 104I,A00,188853,Staff,0,8,20,20
1683731934058,POLI 110B,A00,188854,Wiens; David,6,0,20,14
1683731935083,POLI 112A,A00,188855,Wiens; David,3,0,30,27
1683731936109,POLI 117R,A00,188856,Forman; Fonna,0,12,20,20
1683731937138,POLI 118,A00,188857,Ingham; Sean,8,0,20,12
1683731938163,POLI 120G,A00,188858,Staff,7,0,30,23
1683731939190,POLI 131CR,A00,188863,Hoston; Germaine,20,0,50,30
1683731940217,POLI 133,A00,188864,Nellis; Gareth Hb,44,0,50,6
1683731941242,POLI 134D,A00,188865,Desposato; Scott,27,0,30,3
1683731942269,POLI 142A,A00,188871,Gartzke; Erik,21,0,50,29
1683731943296,POLI 142K,A00,188874,Staff,38,0,50,12
1683731944320,POLI 143,A00,188940,Gartzke; Erik,15,0,30,15
1683731945343,POLI 153,A00,188943,Staff,1,0,20,19
1683731946377,POLI 160AA,A00,188944,Staff,10,0,40,30
1683731947406,POLI 170A,A00,188945,Staff,10,0,30,20
1683731949463,PSYC 1,A00,188952,Staff,36,0,90,54
1683731950495,PSYC 2,B00,188953,Staff,19,0,35,16
1683731951519,PSYC 6,A00,188970,Staff,47,0,60,13
1683731952545,PSYC 7,A00,188973,Staff,35,0,45,10
1683731953569,PSYC 60,A01,188980,Rickard; Timothy C.,42,0,60,18
1683731954594,PSYC 70,A01,189001,Steiner; Eric Tomas,21,0,45,24
1683731955619,PSYC 100,A00,189005,Lacefield; Katharine I,1,98,120,119
1683731956644,PSYC 102,A00,189008,Staff,6,0,30,24
1683731957671,PSYC 106,B00,189026,Gorman; Michael R.,27,0,60,33
1683731958695,PSYC 114,B01,189033,Winkielman; Piotr,0,31,30,30
1683731959724,PSYC 131,A00,189036,Anagnostaras; Stephan,0,44,60,60
1683731960749,PSYC 136,A00,189041,Lowe; Angela Beth,0,7,25,25
1683731961777,PSYC 137,A00,189057,Winkielman; Piotr,0,36,25,25
1683731962805,PSYC 144,A00,189107,Wixted; John T,0,11,50,50
1683731964853,PSYC 162,A00,189142,Staff,0,9,85,85
1683731965878,PSYC 172,A00,189144,Gorman; Michael R.,0,6,30,30
1683731967933,PSYC 179,A00,189146,Lacefield; Katharine I,0,88,120,120
1683731968962,PSYC 181,A00,189147,Anagnostaras; Stephan,110,45,200,90
1683731969987,PSYC 190R,A00,189148,Barner; David A.,0,23,80,80
1683731971011,PSYC 191,A00,189275,Rickard; Timothy C.,0,11,25,25
1683731972039,PSYC 193,A00,189276,Chapman; Eddie Nathaniel,0,1,0,4
1683731973067,PSYC 193L,A01,189281,Lowe; Angela Beth,8,0,20,12
1683731973067,PSYC 193L,B01,189285,Staff,28,0,35,7
1683731974093,RELI 149,A00,187137,Rahimi; Babak,6,0,40,34
1683731975118,SE 9,A01,187315,Staff,0,2,18,18
1683731976142,SE 101B,A00,187409,Staff,24,0,30,6
1683731977170,SE 110B,A00,187444,Staff,10,0,40,30
1683731978196,SE 130B,A00,187449,Staff,31,0,40,9
1683731979220,SE 150A,A00,187516,Staff,8,0,20,12
1683731980246,SE 154,A00,187528,Staff,29,0,50,21
1683731981270,SIO 3,A01,258171,Staff,35,0,40,5
1683731982295,SIO 10,A00,187144,Cook; Geoffrey W,0,6,75,75
1683731983323,SIO 45,A00,187152,Cook; Geoffrey W,1,7,100,99
1683731984349,SIO 109R,A00,194486,Staff,0,4,20,20
1683731986405,SIO 187,A01,187233,Kacev; David,12,0,40,28
1683731987436,SOCI 1,A01,258656,Thorpe; Charles Robert,28,0,30,2
1683731987436,SOCI 1,A02,258658,Thorpe; Charles Robert,30,0,30,0
1683731987436,SOCI 1,A03,258661,Thorpe; Charles Robert,25,0,25,0
1683731987436,SOCI 1,A04,258666,Thorpe; Charles Robert,22,0,25,3
1683731987436,SOCI 1,A05,258897,Thorpe; Charles Robert,22,0,25,3
1683731987436,SOCI 1,A06,258898,Thorpe; Charles Robert,25,0,25,0
1683731988464,SOCI 30,A01,258903,Pardo Guerra; Juan Pablo,14,0,30,16
1683731989495,SOCI 102,A00,258904,Staff,9,0,25,16
1683731990521,SOCI 106,A00,258905,Staff,19,0,25,6
1683731991549,SOCI 111,A00,258907,Ribas Norris; Janet Vanesa,26,0,30,4
1683731992574,SOCI 121R,A00,258908,Pardo Guerra; Juan Pablo,7,0,30,23
1683731993599,SOCI 126,A01,203330,Staff,14,0,20,6
1683731994623,SOCI 131,A00,258909,Thorpe; Charles Robert,30,0,60,30
1683731995650,SOCI 135,A00,258910,Payne; Christine Anna,0,13,30,30
1683731996676,SOCI 157,A00,258911,Staff,10,0,30,20
1683731997705,SOCI 184,A00,258912,Staff,25,0,30,5
1683731998800,SOCI 188D,A00,258913,Staff,22,0,30,8
1683731999825,SYN 2,001,187529,Staff,9,0,16,7
1683731999825,SYN 2,002,201452,Staff,0,20,16,16
1683731999825,SYN 2,003,201469,Staff,1,0,16,15
1683732000850,SYN 100,A01,187531,Staff,0,9,20,20
1683732000850,SYN 100,B01,201491,Staff,0,10,20,20
1683732001873,TDAC 1,A00,189286,Walsh; Kim C.,3,0,20,17
1683732001873,TDAC 1,B00,189287,Harting; Carla Kelso,10,0,20,10
1683732002897,TDAC 101,A00,189300,Walsh; Kim C.,16,0,20,4
1683732002897,TDAC 101,B00,189301,Harting; Carla Kelso,18,0,20,2
1683732003921,TDAC 102,A00,189304,Basso; Beatrice,14,0,20,6
1683732004946,TDAC 108,A00,189305,Staff,18,0,20,2
1683732005975,TDDE 131,A00,189310,Staff,19,0,20,1
1683732005975,TDDE 131,B00,189314,Staff,19,0,20,1
1683732005975,TDDE 131,C00,189315,Staff,48,0,50,2
1683732005975,TDDE 131,D00,189316,Staff,14,0,15,1
1683732005975,TDDE 131,E00,204841,Staff,20,0,20,0
1683732007003,TDGE 10,A00,189289,Staff,26,0,50,24
1683732007003,TDGE 10,B00,189290,Havis; Allan,0,1,50,50
1683732008035,TDGE 11,A00,189291,Fulton; Julia,0,4,50,50
1683732008035,TDGE 11,B00,189292,Staff,20,0,25,5
1683732008035,TDGE 11,C00,260270,Staff,0,0,0,0
1683732009060,TDGE 25,A00,189294,Staff,1,0,20,19
1683732010085,TDGE 124,A00,189318,Fulton; Julia,0,7,50,50
1683732011112,TDGE 125,A00,189319,Staff,13,0,25,12
1683732011112,TDGE 125,B00,189320,Staff,23,0,25,2
1683732012137,TDGE 127,A00,189322,Havis; Allan,1,0,50,49
1683732013162,TDHT 101,A00,189323,Staff,18,0,25,7
1683732013162,TDHT 101,B00,189324,Staff,25,0,25,0
1683732014188,TDHT 102,A00,189325,Staff,49,0,50,1
1683732015216,TDMV 1,A00,189295,Arcidiacono; Kristin,20,0,30,10
1683732015216,TDMV 1,B00,189296,Caligagan; Maria T.,23,0,30,7
1683732016241,TDMV 2,A00,189297,Sammartano; Tonnie,27,0,30,3
1683732016241,TDMV 2,B00,189299,Arcidiacono; Kristin,23,0,30,7
1683732017265,TDMV 3,A00,204998,Rincon; Alicia,22,0,30,8
1683732018292,TDMV 120,A00,189458,Sammartano; Tonnie,28,0,30,2
1683732019322,TDMV 138,A00,189541,Jun; Grace Shin Hae,20,0,40,20
1683732020348,TDMV 142,A00,189717,Caligagan; Tony,25,0,30,5
1683732020348,TDMV 142,B00,189718,Caligagan; Maria T.,25,0,30,5
1683732021375,TMC 2,A01,187533,Staff,25,0,25,0
1683732021375,TMC 2,A02,187534,Staff,25,0,25,0
1683732022399,USP 1,A01,187536,Kwak; Nancy,0,16,25,25
1683732023423,USP 5,A01,187538,Staff,8,0,25,17
1683732024447,USP 101,A00,199253,Staff,0,4,0,0
1683732025470,USP 124,A00,187562,Boomhower; Matthew Charles,0,0,30,30
1683732026500,USP 138,A00,187582,Staff,19,0,25,6
1683732027526,USP 152,A01,187597,Staff,3,0,25,22
1683732028553,USP 153,A00,187598,Staff,18,0,25,7
1683732029578,USP 168,A00,187607,Kwak; Nancy,2,0,5,3
1683732030602,USP 173,A00,187619,Staff,4,0,25,21
1683732031628,USP 181,A00,187638,Staff,0,4,25,25
1683732032655,VIS 103,A00,187650,Cruz; Edwin Teddy,17,0,75,58
1683732033682,VIS 110D,A00,187669,Staff,13,0,22,9
1683732034706,VIS 127C,A00,187720,Shen; Kuiyi,67,0,146,79
1683732035730,VIS 149,A00,187731,Yoldas; Pinar,0,12,22,22
1683732036757,VIS 151,A01,188091,Staff,22,0,34,12
1683732036757,VIS 151,A02,188092,Staff,11,0,34,23
1683732037782,VIS 160B,A00,188093,Stalbaum; Brett,0,1,10,10
1683732039834,WCWP 10B,A00,201720,Staff,0,0,5,5
1683732039834,WCWP 10B,B00,201722,Staff,0,0,6,6
1683732040859,WCWP 100,A00,201725,Gagnon; Jeffrey C,0,0,2,2
1683732040859,WCWP 100,B00,201727,Staff,0,4,15,15
1683732043990,ANBI 133,A00,258401,Wilder; Linnea Lorene,34,0,40,6
1683732045013,ANBI 140,A00,258395,Hrvoj Mihic; Branka,18,0,25,7
1683732046036,ANSC 120,A00,258402,Bialecki; Jon Anthony,26,0,40,14
1683732047060,ANSC 144,A00,258400,Staff,12,0,40,28
1683732049108,ANSC 166,A00,258396,Parish; Steven Martin,156,0,175,19
1683732050133,ANSC 180,A00,193533,Staff,8,0,20,12
1683732051163,ANSC 188,A00,258397,Jassal; Aftab,34,0,40,6
1683732052190,ANTH 3,A01,258316,Staff,23,0,30,7
1683732053215,ANTH 5,A00,258394,Semendeferi; Ekaterini,16,0,20,4
1683732054239,ANTH 21,A01,258331,Staff,4,0,40,36
1683732055267,ANTH 103,A00,258398,Varma; Saiba,15,0,25,10
1683732056301,AWP 10,001,202034,Staff,0,0,0,0
1683732056301,AWP 10,002,202035,Staff,0,0,0,0
1683732056301,AWP 10,003,202036,Staff,0,0,0,0
1683732056301,AWP 10,004,202037,Staff,0,0,0,0
1683732056301,AWP 10,005,202038,Staff,0,0,0,0
1683732056301,AWP 10,006,202039,Staff,0,0,0,0
1683732056301,AWP 10,007,202040,Staff,0,0,0,0
1683732056301,AWP 10,008,202041,Staff,0,0,0,0
1683732056301,AWP 10,009,202042,Staff,0,0,0,0
1683732056301,AWP 10,010,202043,Staff,0,0,0,0
1683732056301,AWP 10,011,202044,Staff,0,0,0,0
1683732056301,AWP 10,012,202045,Staff,0,0,0,0
1683732056301,AWP 10,013,202046,Staff,0,0,0,0
1683732056301,AWP 10,014,202047,Staff,0,0,0,0
1683732056301,AWP 10,015,202048,Staff,0,0,0,0
1683732056301,AWP 10,016,202049,Staff,0,0,0,0
1683732056301,AWP 10,017,202050,Staff,0,0,0,0
1683732056301,AWP 10,018,202051,Staff,0,0,0,0
1683732056301,AWP 10,019,202052,Staff,0,0,0,0
1683732056301,AWP 10,020,202053,Staff,0,0,0,0
1683732056301,AWP 10,021,202054,Staff,0,0,0,0
1683732056301,AWP 10,022,202055,Staff,0,0,0,0
1683732056301,AWP 10,023,202056,Staff,0,0,0,0
1683732056301,AWP 10,024,202057,Staff,0,0,0,0
1683732056301,AWP 10,025,202058,Staff,0,0,0,0
1683732056301,AWP 10,026,202059,Staff,0,0,0,0
1683732057330,AWP 102,001,202032,Staff,0,0,0,0
1683732057330,AWP 102,002,202033,Staff,0,0,0,0
1683732058357,BENG 100,A01,254234,Taylor Amos; Alyssa C,31,0,40,9
1683732059385,BENG 196,001,270013,Engler; Adam J.,9999,0,9999,0
1683732060413,BICD 100R,A01,202018,Smith; Laurie,0,7,32,32
1683732060413,BICD 100R,A02,202019,Smith; Laurie,0,3,32,32
1683732060413,BICD 100R,A03,202020,Smith; Laurie,0,1,32,32
1683732060413,BICD 100R,A04,202021,Smith; Laurie,6,0,32,26
1683732060413,BICD 100R,A05,202022,Smith; Laurie,10,0,32,22
1683732061443,BICD 136,A01,193242,Gustafson-Brown; Cindy,0,2,32,32
1683732061443,BICD 136,A02,193244,Gustafson-Brown; Cindy,13,0,32,19
1683732062468,BIEB 102,A01,193249,Butler; Shannon Rhey,0,0,32,32
1683732062468,BIEB 102,A02,193251,Butler; Shannon Rhey,0,0,32,32
1683732062468,BIEB 102,A03,193253,Butler; Shannon Rhey,0,0,32,32
1683732062468,BIEB 102,A04,193255,Butler; Shannon Rhey,13,0,32,19
1683732062468,BIEB 102,A05,193265,Butler; Shannon Rhey,25,0,32,7
1683732062468,BIEB 102,A06,193269,Butler; Shannon Rhey,12,0,32,20
1683732064529,BIEB 150,A01,193274,Staff,0,0,32,32
1683732064529,BIEB 150,A02,193285,Staff,24,0,32,8
1683732065556,BIEB 194,A00,193286,Kurle; Carolyn M.,19,0,32,13
1683732066587,BILD 1,A01,192291,Staff,15,0,32,17
1683732066587,BILD 1,A02,192292,Staff,30,0,32,2
1683732066587,BILD 1,B01,192520,Reuther; Keefe,0,1,0,0
1683732066587,BILD 1,B02,192532,Reuther; Keefe,0,1,0,0
1683732067614,BILD 3,A01,192556,Butler; Shannon Rhey,0,0,32,32
1683732067614,BILD 3,A02,192581,Butler; Shannon Rhey,0,1,32,32
1683732067614,BILD 3,A03,192611,Butler; Shannon Rhey,19,0,32,13
1683732067614,BILD 3,A04,192612,Butler; Shannon Rhey,23,0,32,9
1683732067614,BILD 3,A05,192613,Butler; Shannon Rhey,26,0,32,6
1683732067614,BILD 3,A06,192679,Butler; Shannon Rhey,27,0,32,5
1683732067614,BILD 3,A07,192682,Butler; Shannon Rhey,20,0,32,12
1683732068640,BILD 4,A01,192836,Reuther; Keefe,1,0,24,23
1683732068640,BILD 4,A02,193044,Reuther; Keefe,4,0,24,20
1683732069666,BILD 10,A01,193142,Gustafson-Brown; Cindy,29,0,32,3
1683732069666,BILD 10,A02,193149,Gustafson-Brown; Cindy,31,0,32,1
1683732070692,BIMM 100,A01,193301,Staff,0,6,32,32
1683732070692,BIMM 100,A02,193312,Staff,0,7,32,32
1683732070692,BIMM 100,A03,193323,Staff,0,10,32,32
1683732071721,BIMM 101,A01,193329,McDonnell; Lisa Marie,0,3,24,24
1683732071721,BIMM 101,A02,193339,McDonnell; Lisa Marie,0,3,24,24
1683732071721,BIMM 101,B01,193354,McDonnell; Lisa Marie,0,4,24,24
1683732071721,BIMM 101,B02,193357,McDonnell; Lisa Marie,0,3,24,24
1683732072745,BIMM 110,A01,193377,Tat; John,0,11,32,32
1683732072745,BIMM 110,A02,193378,Tat; John,0,11,32,32
1683732073770,BIMM 120,A01,206116,Staff,1,0,32,31
1683732073770,BIMM 120,A02,206117,Staff,7,0,32,25
1683732073770,BIMM 120,A03,206121,Staff,21,0,32,11
1683732074801,BIPN 100,A01,193393,Park; Ji Young,0,15,32,32
1683732074801,BIPN 100,A02,193402,Park; Ji Young,0,14,32,32
1683732074801,BIPN 100,A03,193413,Park; Ji Young,0,14,32,32
1683732074801,BIPN 100,A04,193414,Park; Ji Young,0,13,32,32
1683732075828,BIPN 102,A01,193429,Staff,0,0,32,32
1683732075828,BIPN 102,A02,193438,Staff,18,0,32,14
1683732076857,BIPN 106,A01,193450,Reyes Gonzalez; Catalina,0,2,40,40
1683732077882,BIPN 134,A01,193465,Cooke; James Edward,0,0,32,32
1683732077882,BIPN 134,A02,193474,Cooke; James Edward,25,0,32,7
1683732077882,BIPN 134,A03,193485,Cooke; James Edward,29,0,32,3
1683732077882,BIPN 134,A04,193486,Cooke; James Edward,20,0,32,12
1683732077882,BIPN 134,A05,193491,Cooke; James Edward,31,0,32,1
1683732077882,BIPN 134,A06,193501,Cooke; James Edward,30,0,32,2
1683732077882,BIPN 134,A07,193510,Cooke; James Edward,29,0,32,3
1683732079931,BISP 194,A00,222522,Staff,14,0,32,18
1683732080958,CAT 124,A01,202407,Staff,19,0,25,6
1683732081982,CAT 125,A00,202408,Marchisotto; Jennifer Anne,2,0,20,18
1683732083008,CAT 125R,A00,202409,Smith; Lauryn Alissa,0,11,20,20
1683732083008,CAT 125R,B00,202410,Morales; Celeste Georgianna,0,11,20,20
1683732083008,CAT 125R,C00,202411,Irwin; Matthew Joseph,0,12,20,20
1683732084036,CENG 15,A01,204712,Yang; Kesong,0,1,0,0
1683732085061,CENG 114,A00,202070,Jahed Motlagh; Zeinab,5,0,20,15
1683732086088,CGS 105,A00,185477,Wesling; Megan E.,24,0,40,16
1683732087115,CGS 106,A00,185494,Staff,11,0,22,11
1683732088138,CGS 108,A00,185495,Staff,14,0,20,6
1683732089162,CGS 114,A00,185496,Staff,13,0,18,5
1683732090196,CGS 119,A00,185501,Staff,15,0,20,5
1683732091219,CGS 120,A00,185511,Staff,11,0,20,9
1683732092244,CHEM 4,A01,184675,Bussey; Thomas J,97,0,100,3
1683732093266,CHEM 6A,A01,184677,Staff,32,0,60,28
1683732094291,CHEM 6B,A01,184679,Staff,63,0,100,37
1683732095315,CHEM 6C,A01,184681,Bussey; Thomas J,0,0,50,50
1683732095315,CHEM 6C,A02,184682,Bussey; Thomas J,32,0,50,18
1683732096341,CHEM 40A,A01,184684,Albizati; Kim F.,33,0,100,67
1683732097366,CHEM 40B,A01,184686,Albizati; Kim F.,0,22,100,100
1683732098392,CHEM 41B,A01,184690,Staff,51,0,100,49
1683732099418,COGS 3,A01,184715,Boyle; Mary E. T.,0,27,40,40
1683732100442,COGS 14B,A01,185172,Staff,0,14,38,38
1683732101465,COGS 18,A01,184736,Staff,14,0,80,66
1683732102553,COGS 100,A01,184932,Staff,0,8,73,73
1683732103579,COGS 101A,A01,184935,Staff,0,40,30,30
1683732104607,COGS 101B,A01,184944,Staff,0,2,30,30
1683732105636,COGS 101C,A01,184946,Staff,0,10,30,30
1683732106665,COGS 102A,A01,184951,Johnson; Christine M.,1,0,40,39
1683732107693,COGS 107B,A01,184953,Mooshagian; Eric Frederick,0,52,40,40
1683732108721,COGS 118B,A01,184959,Gupta; Anjum,0,50,40,40
1683732109746,COGS 153,A00,184961,Staff,1,16,30,29
1683732110774,COGS 177,A00,184962,Staff,0,20,30,30
1683732111802,COGS 187A,A01,184969,Boyle; Mary E. T.,0,19,40,40
1683732112827,COMM 10,A01,185174,Staff,0,5,25,25
1683732112827,COMM 10,A02,185189,Staff,0,2,25,25
1683732112827,COMM 10,A03,269821,Staff,0,1,0,0
1683732113852,COMM 100B,A02,185476,Staff,10,0,25,15
1683732113852,COMM 100B,A03,277340,Staff,25,0,25,0
1683732114879,COMM 100C,A01,185314,Staff,2,0,25,23
1683732114879,COMM 100C,A02,185327,Staff,17,0,25,8
1683732115905,COMM 110M,A00,185349,Staff,0,0,40,40
1683732116930,COMM 113T,A00,185352,Staff,25,0,40,15
1683732117956,COMM 114I,A00,185353,Staff,31,0,40,9
1683732118983,COMM 131,A00,185354,Staff,17,0,30,13
1683732120009,CSE 8A,A50,185358,Cao; Yingjun,0,46,10,10
1683732121034,CSE 8B,A01,185362,Staff,0,48,50,50
1683732122059,CSE 11,A01,185416,Cao; Yingjun,0,91,10,10
1683732123084,CSE 20,A01,185445,Briones; Jor-el Thomas Caparas,3,0,25,22
1683732124109,CSE 21,A01,185447,Staff,9,0,50,41
1683732125134,CSE 101,A01,185451,Staff,0,13,50,50
1683732125134,CSE 101,B01,185453,Jones; Miles E,0,15,50,50
1683732127188,CSE 141,A01,185458,Eldon; John,16,0,100,84
1683732128213,CSE 141L,A01,185461,Eldon; John,8,0,100,92
1683732129243,CSE 142,A01,185463,Staff,34,0,60,26
1683732129243,CSE 142,B01,201355,Staff,0,7,60,60
1683732130270,CSE 142L,A01,185470,Staff,34,0,60,26
1683732130270,CSE 142L,B01,201417,Staff,0,6,60,60
1683732131297,CSE 190,A00,201433,Staff,32,0,49,17
1683732132326,DOC 1,A01,259136,Strom; Megan C.,7,0,15,8
1683732132326,DOC 1,A02,259137,Strom; Megan C.,15,0,15,0
1683732132326,DOC 1,A03,259138,Strom; Megan C.,14,0,15,1
1683732132326,DOC 1,A04,259139,Strom; Megan C.,13,0,15,2
1683732133351,DOC 100D,A00,259140,Pass; Natalye Joann,14,0,25,11
1683732134376,DSGN 1,A01,184749,Rill; Bryan,0,26,30,30
1683732135405,DSGN 100,A01,185168,Staff,0,2,25,25
1683732136428,ECE 5,A01,185626,Morris; Karcher William,0,12,0,0
1683732137456,ECE 101,A01,185628,Staff,14,0,70,56
1683732138481,ECE 107,A01,185635,Baghdadchi; Saharnaz,0,0,20,20
1683732138481,ECE 107,A02,185638,Baghdadchi; Saharnaz,1,0,20,19
1683732139517,ECE 148,A01,185647,Silberman; Jack,0,0,16,16
1683732140545,ECON 1,A01,185537,Crane; Meredith Helen,54,0,70,16
1683732141575,ECON 3,A01,185549,Crane; Meredith Helen,30,0,70,40
1683732142600,ECON 4,A01,203354,Anderson; John Charles,0,5,10,10
1683732143631,ECON 100A,A01,185574,Staff,0,5,40,40
1683732144655,ECON 100B,A01,185576,Staff,0,12,50,50
1683732145680,ECON 100C,A01,185589,Newhouse; Herbert S,30,0,70,40
1683732146706,ECON 105,A00,185608,Vespa; Emanuel Ignacio,19,0,35,16
1683732147735,ECON 109,A01,185610,Shishkin; Denis,9,0,35,26
1683732148763,ECON 110A,A01,185612,Staff,8,0,40,32
1683732149788,ECON 120A,A01,185615,Staff,19,0,40,21
1683732150813,ECON 120C,A01,185617,Sun; Yixiao,0,21,70,70
1683732151839,ECON 144,A00,203346,Squires; Dale E,2,0,35,33
1683732152865,ECON 171,A01,203349,Newhouse; Herbert S,0,1,35,35
1683732153891,ECON 173A,A01,185621,Toda; Alexis Akira,21,0,35,14
1683732154922,EDS 25,A01,202413,Staff,0,1,0,0
1683732154922,EDS 25,A02,202414,Staff,0,1,0,0
1683732154922,EDS 25,A03,202415,Staff,0,0,0,0
1683732154922,EDS 25,A04,202416,Staff,0,1,0,0
1683732154922,EDS 25,A05,202439,Staff,0,0,0,0
1683732154922,EDS 25,A06,202440,Staff,0,0,0,0
1683732154922,EDS 25,B01,202631,Staff,0,0,0,0
1683732154922,EDS 25,B02,202632,Staff,0,0,0,0
1683732154922,EDS 25,B03,202639,Staff,0,0,0,0
1683732154922,EDS 25,B04,202640,Staff,0,0,0,0
1683732154922,EDS 25,B05,202643,Staff,0,0,0,0
1683732154922,EDS 25,B06,202644,Staff,0,0,0,0
1683732155950,EDS 38,A01,202659,Black; Alison Michelle,25,0,25,0
1683732156974,EDS 115,A00,202652,Staff,18,0,30,12
1683732158003,EDS 125,A00,202649,Staff,13,0,30,17
1683732159027,EDS 126,A01,203332,Staff,30,0,30,0
1683732160051,EDS 139,A00,202838,Staff,16,0,25,9
1683732161076,EDS 146,A01,202655,Staff,14,0,25,11
1683732162109,ENG 15,A00,185667,Staff,0,1,0,0
1683732162109,ENG 15,B00,185672,Staff,0,0,0,0
1683732162109,ENG 15,C00,185675,Staff,0,0,0,0
1683732162109,ENG 15,D00,185682,Staff,0,0,0,0
1683732162109,ENG 15,E00,185684,Staff,0,0,0,0
1683732163133,ETHN 103,A00,185710,Staff,0,8,35,35
1683732164158,ETHN 103A,A00,199228,Man; Simeon S,0,0,9,9
1683732165183,ETHN 109,A00,185711,Staff,15,0,35,20
1683732166208,ETHN 142,A00,185726,Staff,0,4,30,30
1683732167235,ETHN 163J,A00,199229,Man; Simeon S,5,0,8,3
1683732168261,ETHN 168,A00,185727,Staff,7,0,10,3
1683732169285,ETHN 182,A00,185728,Staff,0,0,35,35
1683732170310,ETHN 183,A00,185737,Staff,10,0,18,8
1683732171335,GLBH 111,A01,209361,Burgos; Jose L.,0,0,0,0
1683732173387,HIEU 104,A00,185792,Staff,14,0,20,6
1683732174412,HIEU 115,A00,185800,Staff,0,0,20,20
1683732175438,HIEU 128,A00,185801,Staff,0,9,20,20
1683732176461,HIEU 147,A00,185802,Staff,15,0,20,5
1683732177495,HIEU 154,A00,185823,Staff,11,0,20,9
1683732178521,HILA 102,A00,185826,Staff,14,0,20,6
1683732179545,HILD 2C,A01,185778,Staff,0,13,20,20
1683732180569,HILD 7B,A01,185780,Kwak; Nancy,0,17,32,32
1683732180569,HILD 7B,A02,185781,Kwak; Nancy,0,18,32,32
1683732181599,HILD 30,A01,185791,Staff,12,0,20,8
1683732182626,HISC 119,A00,185830,Golan; Tal,0,10,20,20
1683732183650,HITO 156GS,A00,185831,Patterson; Patrick H.,0,0,0,23
1683732184680,HIUS 103,A00,185832,Man; Simeon S,0,4,20,20
1683732185708,HIUS 117,A00,185836,Kwak; Nancy,2,0,20,18
1683732186735,HIUS 125,A00,185840,Man; Simeon S,0,2,23,23
1683732187763,HIUS 149,A00,185845,Staff,1,0,20,19
1683732188793,HUM 3,A01,185882,Zavodny; Tatiana Sophia,0,8,50,50
1683732188793,HUM 3,B01,185899,Caldwell; Michael Alan,0,18,50,50
1683732189824,HUM 3GS,A00,185900,Patterson; Patrick H.,0,0,0,23
1683732190850,HUM 4,A01,185938,Zroka; Amy Liane,28,0,50,22
1683732190850,HUM 4,B01,185956,Watkins; Eric,0,6,50,50
1683732190850,HUM 4,B02,202209,Watkins; Eric,0,6,50,50
1683732190850,HUM 4,B03,202210,Watkins; Eric,0,5,50,50
1683732191875,HUM 5,A01,185958,West; Geoffrey Scott,0,0,50,50
1683732191875,HUM 5,A02,202215,West; Geoffrey Scott,0,1,50,50
1683732192901,INTL 190,A00,185959,Gagnon; Jeffrey C,0,0,0,9
1683732192901,INTL 190,B00,185960,Lettieri; Michael Joseph,0,0,0,2
1683732193928,JAPN 180,A00,254509,Staff,4,0,30,26
1683732194959,LATI 10,A01,202853,Kennemore; Amy Michelle,4,0,35,31
1683732194959,LATI 10,A02,202854,Kennemore; Amy Michelle,3,0,35,32
1683732194959,LATI 10,A03,270054,Kennemore; Amy Michelle,30,0,30,0
1683732195992,LATI 180,A00,202855,Kennemore; Amy Michelle,11,0,20,9
1683732197023,LAWS 101,A00,201767,Golan; Tal,0,7,40,40
1683732198049,LIFR 1C,A00,185961,Staff,6,0,20,14
1683732199078,LIFR 1CX,A00,185962,Staff,7,0,20,13
1683732200101,LIFR 1D,A00,185963,Staff,7,0,20,13
1683732201126,LIFR 1DX,A00,185964,Staff,7,0,20,13
1683732202150,LIGN 101,A01,186039,Staff,43,0,50,7
1683732203175,LIGN 165,A00,186040,Staff,14,0,50,36
1683732204204,LTCS 108,A00,186041,Staff,5,0,10,5
1683732205229,LTCS 119,A00,186042,Staff,15,0,20,5
1683732206316,LTCS 130,A00,186043,Wesling; Megan E.,15,0,25,10
1683732208366,LTEA 138,A00,186119,Staff,13,0,40,27
1683732209391,LTEN 124,A00,186148,Staff,5,0,25,20
1683732210418,LTEN 178,A00,186149,Staff,6,0,15,9
1683732211443,LTEN 181,A00,186150,Blanco; John D,34,0,40,6
1683732212471,LTWL 120,A00,186160,Staff,19,0,25,6
1683732213496,LTWL 165,A00,186161,Staff,22,0,25,3
1683732214521,LTWR 100,A00,186162,Staff,0,5,15,15
1683732215545,LTWR 102,A00,186163,Doller; Ben,5,0,15,10
1683732216571,MAE 8,A01,186412,Staff,0,1,0,0
1683732217598,MAE 30B,A00,186445,Bahadori; Mohammad Yousef,81,0,100,19
1683732218624,MAE 40,A00,186592,Bewley; Thomas R,10,0,50,40
1683732219649,MAE 101B,A00,186593,Bahadori; Mohammad Yousef,80,0,100,20
1683732220674,MAE 105,A00,186594,Bandaru; Prabhakar,10,0,50,40
1683732221698,MAE 107,A00,186599,Pham; Hieu Tan,0,8,120,120
1683732222723,MAE 148,A01,186660,Silberman; Jack,3,0,16,13
1683732223753,MATH 10A,A01,188095,Staff,0,6,35,35
1683732224784,MATH 10B,A01,188097,Bowers; Adam R.,0,12,30,30
1683732224784,MATH 10B,A02,188099,Bowers; Adam R.,0,11,30,30
1683732224784,MATH 10B,B01,188104,Bowers; Adam R.,0,10,30,30
1683732224784,MATH 10B,B02,188106,Bowers; Adam R.,0,9,30,30
1683732225817,MATH 10C,A01,188111,Staff,0,20,30,30
1683732225817,MATH 10C,A02,188127,Staff,0,19,30,30
1683732225817,MATH 10C,A03,188131,Staff,0,19,30,30
1683732225817,MATH 10C,B01,188218,Staff,17,0,30,13
1683732225817,MATH 10C,B02,188244,Staff,13,0,30,17
1683732225817,MATH 10C,B03,188277,Staff,14,0,30,16
1683732226843,MATH 18,A01,188344,Bach; Quang Tran,18,0,30,12
1683732226843,MATH 18,A02,188345,Bach; Quang Tran,11,0,30,19
1683732226843,MATH 18,B01,188353,Bach; Quang Tran,11,0,30,19
1683732226843,MATH 18,B02,188354,Bach; Quang Tran,19,0,30,11
1683732227868,MATH 20A,A01,188374,Staff,10,0,35,25
1683732228893,MATH 20B,A01,188382,Ohm; Ko Woon,7,0,30,23
1683732228893,MATH 20B,A02,188383,Ohm; Ko Woon,22,0,30,8
1683732228893,MATH 20B,B01,188385,Ohm; Ko Woon,7,0,30,23
1683732228893,MATH 20B,B02,188392,Ohm; Ko Woon,22,0,30,8
1683732229923,MATH 20C,A01,188394,Harel; Guershon,10,0,30,20
1683732229923,MATH 20C,A02,188395,Harel; Guershon,13,0,30,17
1683732229923,MATH 20C,B01,188404,Harel; Guershon,5,0,30,25
1683732229923,MATH 20C,B02,188405,Harel; Guershon,18,0,30,12
1683732230955,MATH 20D,A01,188414,Hammock; Frances H,0,1,30,30
1683732230955,MATH 20D,A02,188415,Hammock; Frances H,0,1,30,30
1683732230955,MATH 20D,B01,188447,Hammock; Frances H,0,1,30,30
1683732230955,MATH 20D,B02,188486,Hammock; Frances H,2,0,30,28
1683732231979,MATH 20E,A01,188649,Staff,21,0,30,9
1683732231979,MATH 20E,A02,188650,Staff,20,0,30,10
1683732231979,MATH 20E,A03,188673,Staff,0,0,30,30
1683732233011,MATH 102,A01,188675,Staff,0,40,35,35
1683732234036,MATH 103B,A01,188681,Staff,3,0,35,32
1683732234036,MATH 103B,B01,188692,Staff,5,0,35,30
1683732235065,MATH 109,A01,188695,Salehi Golsefidy; Alireza,24,0,35,11
1683732235065,MATH 109,A02,188696,Salehi Golsefidy; Alireza,24,0,35,11
1683732236093,MATH 120A,A01,188698,Eggers; John Dietrich,7,0,35,28
1683732237122,MATH 142B,A01,188736,Ioana; Adrian,0,0,30,30
1683732237122,MATH 142B,A02,188741,Ioana; Adrian,0,1,30,30
1683732237122,MATH 142B,A03,188743,Ioana; Adrian,0,3,30,30
1683732238147,MATH 168A,A01,188790,Staff,0,11,35,35
1683732239173,MATH 170A,A01,188803,Nie; Jiawang,0,2,35,35
1683732239173,MATH 170A,A02,188811,Nie; Jiawang,0,1,35,35
1683732239173,MATH 170A,A03,188814,Nie; Jiawang,1,0,35,34
1683732239173,MATH 170A,A04,188815,Nie; Jiawang,5,0,35,30
1683732240200,MATH 193B,A01,188817,Staff,0,0,35,35
1683732240200,MATH 193B,A02,188818,Staff,6,0,35,29
1683732241233,MGT 4,A01,202857,Anderson; John Charles,59,0,80,21
1683732242259,MGT 12,A00,202858,Lindenberger; Wade Douglas,40,0,90,50
1683732243283,MGT 18,A00,202859,Staff,73,0,90,17
1683732244309,MGT 18GS,A00,202860,McKay; Michael J,13,0,28,15
1683732245338,MGT 45,A00,202861,Pecore; Joseph P.,8,0,90,82
1683732246363,MGT 100,A00,202863,Yavorsky; Daniel Ryan,27,0,90,63
1683732247388,MGT 103,A00,202864,Ehrich; Kristine R,0,19,90,90
1683732248417,MGT 112,A00,202865,Ehrich; Kristine R,15,0,90,75
1683732249449,MGT 121A,A00,202868,Staff,70,0,90,20
1683732250475,MGT 131B,A00,202869,Anderson; John Charles,58,0,90,32
1683732251502,MGT 136,A00,202871,Lindenberger; Wade Douglas,83,0,90,7
1683732252529,MGT 164,A00,202873,Staff,0,67,90,91
1683732253559,MGT 164GS,A00,202874,McKay; Mary A,13,0,28,15
1683732254589,MGT 180,A00,202875,Staff,0,51,90,91
1683732255616,MMW 11R,A01,205019,Herbst; Matthew,0,0,30,30
1683732255616,MMW 11R,A02,205026,Herbst; Matthew,29,0,30,1
1683732256646,MMW 15,A01,193512,Chang; Edmond Yi-Teh,0,8,28,28
1683732256646,MMW 15,A02,193513,Chang; Edmond Yi-Teh,0,5,28,28
1683732256646,MMW 15,A03,193514,Chang; Edmond Yi-Teh,0,5,28,28
1683732256646,MMW 15,A04,193515,Chang; Edmond Yi-Teh,0,5,28,28
1683732256646,MMW 15,A05,193516,Chang; Edmond Yi-Teh,0,5,28,28
1683732256646,MMW 15,A06,193517,Chang; Edmond Yi-Teh,0,6,28,28
1683732256646,MMW 15,B01,193519,Chang; Edmond Yi-Teh,0,5,28,28
1683732256646,MMW 15,B02,193520,Chang; Edmond Yi-Teh,0,5,28,28
1683732256646,MMW 15,B03,193521,Chang; Edmond Yi-Teh,0,5,28,28
1683732256646,MMW 15,B04,193522,Chang; Edmond Yi-Teh,0,6,28,28
1683732256646,MMW 15,B05,193523,Chang; Edmond Yi-Teh,0,5,28,28
1683732256646,MMW 15,B06,193524,Chang; Edmond Yi-Teh,0,5,28,28
1683732257674,MMW 122,A01,193526,Rahimi; Babak,0,16,28,28
1683732257674,MMW 122,A02,193527,Rahimi; Babak,0,15,28,28
1683732257674,MMW 122,A03,193528,Rahimi; Babak,0,0,0,0
1683732257674,MMW 122,A04,193529,Rahimi; Babak,0,0,0,0
1683732258700,MUS 1A,A01,186663,Staff,0,18,35,35
1683732259729,MUS 4,A01,186715,Staff,0,12,35,35
1683732260754,MUS 5R,A01,186796,Dubnov; Shlomo,0,17,35,35
1683732261778,MUS 6,A01,186798,Staff,0,4,25,25
1683732262802,MUS 7,A01,186830,Staff,11,0,35,24
1683732263827,MUS 8,A01,186930,Staff,0,27,35,35
1683732264853,MUS 15,A01,186932,Staff,0,15,35,35
1683732264853,MUS 15,B01,186934,Staff,0,16,35,35
1683732265881,MUS 80,A00,186935,Staff,0,0,20,20
1683732265881,MUS 80,B00,186936,Staff,24,0,25,1
1683732266905,NANO 11,A00,204702,Lipomi; Darren John,0,0,0,0
1683732267932,NANO 15,A01,204709,Yang; Kesong,0,1,0,0
1683732268956,NANO 114,A00,202069,Jahed Motlagh; Zeinab,2,0,10,8
1683732269981,PHIL 1,A00,186955,Grush; Rick Scott,31,0,40,9
1683732271005,PHIL 10,A01,186973,Grush; Rick Scott,27,0,35,8
1683732271005,PHIL 10,A02,186974,Grush; Rick Scott,33,0,35,2
1683732272032,PHIL 13,A01,186976,Staff,1,0,35,34
1683732272032,PHIL 13,A02,186977,Staff,16,0,35,19
1683732273060,PHIL 14,A01,186979,Staff,30,0,35,5
1683732273060,PHIL 14,A02,186986,Staff,32,0,35,3
1683732274085,PHIL 28,A01,186988,Staff,16,0,30,14
1683732274085,PHIL 28,A02,186989,Staff,0,0,30,30
1683732274085,PHIL 28,A03,186990,Staff,10,0,30,20
1683732274085,PHIL 28,A04,186991,Staff,26,0,30,4
1683732275110,PHIL 120,A00,186997,Staff,23,0,40,17
1683732276135,PHIL 137,A00,187003,Staff,8,0,40,32
1683732277159,PHIL 150,A00,187015,Staff,47,0,70,23
1683732278184,PHIL 167,A00,187021,Lamey; Andy M.,34,0,40,6
1683732279210,PHIL 174,A01,202226,Staff,17,0,20,3
1683732279210,PHIL 174,A02,202235,Staff,20,0,20,0
1683732280234,PHIL 191A,A00,258918,Staff,0,0,1,1
1683732281259,PHYS 1A,A00,187028,Staff,26,0,60,34
1683732282285,PHYS 1AL,001,187036,Staff,3,0,30,27
1683732282285,PHYS 1AL,002,187049,Staff,18,0,30,12
1683732283310,PHYS 1B,A00,187058,Staff,21,0,60,39
1683732284335,PHYS 1BL,001,187064,Staff,0,1,30,30
1683732284335,PHYS 1BL,002,187070,Staff,4,0,30,26
1683732285363,PHYS 1C,A00,187082,Staff,30,0,120,90
1683732286387,PHYS 1CL,001,187088,Staff,0,9,30,30
1683732286387,PHYS 1CL,002,187089,Staff,0,1,30,30
1683732286387,PHYS 1CL,009,262693,Staff,9,0,30,21
1683732287410,PHYS 2B,A01,187097,Staff,55,0,115,60
1683732288438,PHYS 2C,A01,187099,Staff,63,0,115,52
1683732289462,PHYS 2CL,A01,187101,Staff,5,0,28,23
1683732289462,PHYS 2CL,A02,187102,Staff,15,0,28,13
1683732290496,PHYS 2D,A01,187123,Shotwell; Brian,95,0,115,20
1683732291521,PHYS 4B,A01,187133,Grinstein; Benjamin,35,0,50,15
1683732292548,POLI 10,A00,188819,Staff,0,4,50,50
1683732293576,POLI 11,A00,188827,Staff,43,0,50,7
1683732294599,POLI 13R,A00,188828,Staff,0,2,20,20
1683732295626,POLI 27,A01,188830,Elgin; Samuel Zincke,0,2,70,70
1683732296651,POLI 30,A00,188832,Desposato; Scott,30,0,50,20
1683732297677,POLI 102F,A00,188834,Staff,1,0,40,39
1683732298704,POLI 104A,A00,188852,Staff,12,0,30,18
1683732299727,POLI 104I,A00,188853,Staff,0,8,20,20
1683732300751,POLI 110B,A00,188854,Wiens; David,6,0,20,14
1683732301775,POLI 112A,A00,188855,Wiens; David,3,0,30,27
1683732302817,POLI 117R,A00,188856,Forman; Fonna,0,12,20,20
1683732303844,POLI 118,A00,188857,Ingham; Sean,8,0,20,12
1683732304868,POLI 120G,A00,188858,Staff,7,0,30,23
1683732305896,POLI 131CR,A00,188863,Hoston; Germaine,20,0,50,30
1683732306919,POLI 133,A00,188864,Nellis; Gareth Hb,44,0,50,6
1683732307942,POLI 134D,A00,188865,Desposato; Scott,27,0,30,3
1683732308969,POLI 142A,A00,188871,Gartzke; Erik,21,0,50,29
1683732310047,POLI 142K,A00,188874,Staff,38,0,50,12
1683732311073,POLI 143,A00,188940,Gartzke; Erik,15,0,30,15
1683732312098,POLI 153,A00,188943,Staff,1,0,20,19
1683732313123,POLI 160AA,A00,188944,Staff,10,0,40,30
1683732314148,POLI 170A,A00,188945,Staff,10,0,30,20
1683732316200,PSYC 1,A00,188952,Staff,36,0,90,54
1683732317227,PSYC 2,B00,188953,Staff,19,0,35,16
1683732318253,PSYC 6,A00,188970,Staff,47,0,60,13
1683732319277,PSYC 7,A00,188973,Staff,35,0,45,10
1683732320303,PSYC 60,A01,188980,Rickard; Timothy C.,42,0,60,18
1683732321329,PSYC 70,A01,189001,Steiner; Eric Tomas,21,0,45,24
1683732322356,PSYC 100,A00,189005,Lacefield; Katharine I,1,98,120,119
1683732323389,PSYC 102,A00,189008,Staff,6,0,30,24
1683732324420,PSYC 106,B00,189026,Gorman; Michael R.,26,0,60,34
1683732325445,PSYC 114,B01,189033,Winkielman; Piotr,0,31,30,30
1683732326469,PSYC 131,A00,189036,Anagnostaras; Stephan,0,44,60,60
1683732327498,PSYC 136,A00,189041,Lowe; Angela Beth,0,7,25,25
1683732328537,PSYC 137,A00,189057,Winkielman; Piotr,0,36,25,25
1683732329565,PSYC 144,A00,189107,Wixted; John T,0,11,50,50
1683732331616,PSYC 162,A00,189142,Staff,0,9,85,85
1683732332642,PSYC 172,A00,189144,Gorman; Michael R.,0,6,30,30
1683732334696,PSYC 179,A00,189146,Lacefield; Katharine I,0,88,120,120
1683732335725,PSYC 181,A00,189147,Anagnostaras; Stephan,110,45,200,90
1683732336754,PSYC 190R,A00,189148,Barner; David A.,0,23,80,80
1683732337779,PSYC 191,A00,189275,Rickard; Timothy C.,0,11,25,25
1683732338811,PSYC 193,A00,189276,Chapman; Eddie Nathaniel,0,1,0,4
1683732339841,PSYC 193L,A01,189281,Lowe; Angela Beth,8,0,20,12
1683732339841,PSYC 193L,B01,189285,Staff,28,0,35,7
1683732340866,RELI 149,A00,187137,Rahimi; Babak,6,0,40,34
1683732341895,SE 9,A01,187315,Staff,0,2,18,18
1683732342922,SE 101B,A00,187409,Staff,24,0,30,6
1683732343947,SE 110B,A00,187444,Staff,10,0,40,30
1683732344972,SE 130B,A00,187449,Staff,31,0,40,9
1683732345997,SE 150A,A00,187516,Staff,8,0,20,12
1683732347021,SE 154,A00,187528,Staff,29,0,50,21
1683732348045,SIO 3,A01,258171,Staff,35,0,40,5
1683732349074,SIO 10,A00,187144,Cook; Geoffrey W,0,6,75,75
1683732350101,SIO 45,A00,187152,Cook; Geoffrey W,1,7,100,99
1683732351126,SIO 109R,A00,194486,Staff,0,4,20,20
1683732353179,SIO 187,A01,187233,Kacev; David,12,0,40,28
1683732354206,SOCI 1,A01,258656,Thorpe; Charles Robert,28,0,30,2
1683732354206,SOCI 1,A02,258658,Thorpe; Charles Robert,30,0,30,0
1683732354206,SOCI 1,A03,258661,Thorpe; Charles Robert,25,0,25,0
1683732354206,SOCI 1,A04,258666,Thorpe; Charles Robert,22,0,25,3
1683732354206,SOCI 1,A05,258897,Thorpe; Charles Robert,22,0,25,3
1683732354206,SOCI 1,A06,258898,Thorpe; Charles Robert,25,0,25,0
1683732355232,SOCI 30,A01,258903,Pardo Guerra; Juan Pablo,14,0,30,16
1683732356256,SOCI 102,A00,258904,Staff,9,0,25,16
1683732357280,SOCI 106,A00,258905,Staff,19,0,25,6
1683732358308,SOCI 111,A00,258907,Ribas Norris; Janet Vanesa,26,0,30,4
1683732359333,SOCI 121R,A00,258908,Pardo Guerra; Juan Pablo,7,0,30,23
1683732360361,SOCI 126,A01,203330,Staff,14,0,20,6
1683732361390,SOCI 131,A00,258909,Thorpe; Charles Robert,30,0,60,30
1683732362419,SOCI 135,A00,258910,Payne; Christine Anna,0,13,30,30
1683732363444,SOCI 157,A00,258911,Staff,10,0,30,20
1683732364468,SOCI 184,A00,258912,Staff,25,0,30,5
1683732365496,SOCI 188D,A00,258913,Staff,22,0,30,8
1683732366531,SYN 2,001,187529,Staff,9,0,16,7
1683732366531,SYN 2,002,201452,Staff,0,20,16,16
1683732366531,SYN 2,003,201469,Staff,1,0,16,15
1683732367559,SYN 100,A01,187531,Staff,0,9,20,20
1683732367559,SYN 100,B01,201491,Staff,0,10,20,20
1683732368590,TDAC 1,A00,189286,Walsh; Kim C.,3,0,20,17
1683732368590,TDAC 1,B00,189287,Harting; Carla Kelso,10,0,20,10
1683732369617,TDAC 101,A00,189300,Walsh; Kim C.,16,0,20,4
1683732369617,TDAC 101,B00,189301,Harting; Carla Kelso,18,0,20,2
1683732370647,TDAC 102,A00,189304,Basso; Beatrice,14,0,20,6
1683732371673,TDAC 108,A00,189305,Staff,18,0,20,2
1683732372704,TDDE 131,A00,189310,Staff,19,0,20,1
1683732372704,TDDE 131,B00,189314,Staff,19,0,20,1
1683732372704,TDDE 131,C00,189315,Staff,48,0,50,2
1683732372704,TDDE 131,D00,189316,Staff,14,0,15,1
1683732372704,TDDE 131,E00,204841,Staff,20,0,20,0
1683732373731,TDGE 10,A00,189289,Staff,26,0,50,24
1683732373731,TDGE 10,B00,189290,Havis; Allan,0,1,50,50
1683732374761,TDGE 11,A00,189291,Fulton; Julia,0,4,50,50
1683732374761,TDGE 11,B00,189292,Staff,20,0,25,5
1683732374761,TDGE 11,C00,260270,Staff,0,0,0,0
1683732375787,TDGE 25,A00,189294,Staff,1,0,20,19
1683732376813,TDGE 124,A00,189318,Fulton; Julia,0,7,50,50
1683732377836,TDGE 125,A00,189319,Staff,13,0,25,12
1683732377836,TDGE 125,B00,189320,Staff,23,0,25,2
1683732378859,TDGE 127,A00,189322,Havis; Allan,1,0,50,49
1683732379888,TDHT 101,A00,189323,Staff,18,0,25,7
1683732379888,TDHT 101,B00,189324,Staff,25,0,25,0
1683732380915,TDHT 102,A00,189325,Staff,49,0,50,1
1683732381940,TDMV 1,A00,189295,Arcidiacono; Kristin,20,0,30,10
1683732381940,TDMV 1,B00,189296,Caligagan; Maria T.,23,0,30,7
1683732382966,TDMV 2,A00,189297,Sammartano; Tonnie,27,0,30,3
1683732382966,TDMV 2,B00,189299,Arcidiacono; Kristin,23,0,30,7
1683732383992,TDMV 3,A00,204998,Rincon; Alicia,22,0,30,8
1683732385020,TDMV 120,A00,189458,Sammartano; Tonnie,28,0,30,2
1683732386048,TDMV 138,A00,189541,Jun; Grace Shin Hae,20,0,40,20
1683732387072,TDMV 142,A00,189717,Caligagan; Tony,25,0,30,5
1683732387072,TDMV 142,B00,189718,Caligagan; Maria T.,25,0,30,5
1683732388094,TMC 2,A01,187533,Staff,25,0,25,0
1683732388094,TMC 2,A02,187534,Staff,25,0,25,0
1683732389119,USP 1,A01,187536,Kwak; Nancy,0,16,25,25
1683732390145,USP 5,A01,187538,Staff,8,0,25,17
1683732391169,USP 101,A00,199253,Staff,0,4,0,0
1683732392194,USP 124,A00,187562,Boomhower; Matthew Charles,0,0,30,30
1683732393217,USP 138,A00,187582,Staff,19,0,25,6
1683732394244,USP 152,A01,187597,Staff,3,0,25,22
1683732395271,USP 153,A00,187598,Staff,18,0,25,7
1683732396298,USP 168,A00,187607,Kwak; Nancy,2,0,5,3
1683732397323,USP 173,A00,187619,Staff,4,0,25,21
1683732398348,USP 181,A00,187638,Staff,0,4,25,25
1683732399379,VIS 103,A00,187650,Cruz; Edwin Teddy,17,0,75,58
1683732400406,VIS 110D,A00,187669,Staff,13,0,22,9
1683732401432,VIS 127C,A00,187720,Shen; Kuiyi,67,0,146,79
1683732402459,VIS 149,A00,187731,Yoldas; Pinar,0,12,22,22
1683732403484,VIS 151,A01,188091,Staff,22,0,34,12
1683732403484,VIS 151,A02,188092,Staff,11,0,34,23
1683732404511,VIS 160B,A00,188093,Stalbaum; Brett,0,1,10,10
1683732406563,WCWP 10B,A00,201720,Staff,0,0,5,5
1683732406563,WCWP 10B,B00,201722,Staff,0,0,6,6
1683732407588,WCWP 100,A00,201725,Gagnon; Jeffrey C,0,0,2,2
1683732407588,WCWP 100,B00,201727,Staff,0,4,15,15
1683732410716,ANBI 133,A00,258401,Wilder; Linnea Lorene,34,0,40,6
1683732411745,ANBI 140,A00,258395,Hrvoj Mihic; Branka,18,0,25,7
1683732412769,ANSC 120,A00,258402,Bialecki; Jon Anthony,26,0,40,14
1683732413848,ANSC 144,A00,258400,Staff,12,0,40,28
1683732415904,ANSC 166,A00,258396,Parish; Steven Martin,156,0,175,19
1683732416929,ANSC 180,A00,193533,Staff,8,0,20,12
1683732417953,ANSC 188,A00,258397,Jassal; Aftab,34,0,40,6
1683732418976,ANTH 3,A01,258316,Staff,23,0,30,7
1683732420003,ANTH 5,A00,258394,Semendeferi; Ekaterini,16,0,20,4
1683732421032,ANTH 21,A01,258331,Staff,4,0,40,36
1683732422055,ANTH 103,A00,258398,Varma; Saiba,15,0,25,10
1683732423081,AWP 10,001,202034,Staff,0,0,0,0
1683732423081,AWP 10,002,202035,Staff,0,0,0,0
1683732423081,AWP 10,003,202036,Staff,0,0,0,0
1683732423081,AWP 10,004,202037,Staff,0,0,0,0
1683732423081,AWP 10,005,202038,Staff,0,0,0,0
1683732423081,AWP 10,006,202039,Staff,0,0,0,0
1683732423081,AWP 10,007,202040,Staff,0,0,0,0
1683732423081,AWP 10,008,202041,Staff,0,0,0,0
1683732423081,AWP 10,009,202042,Staff,0,0,0,0
1683732423081,AWP 10,010,202043,Staff,0,0,0,0
1683732423081,AWP 10,011,202044,Staff,0,0,0,0
1683732423081,AWP 10,012,202045,Staff,0,0,0,0
1683732423081,AWP 10,013,202046,Staff,0,0,0,0
1683732423081,AWP 10,014,202047,Staff,0,0,0,0
1683732423081,AWP 10,015,202048,Staff,0,0,0,0
1683732423081,AWP 10,016,202049,Staff,0,0,0,0
1683732423081,AWP 10,017,202050,Staff,0,0,0,0
1683732423081,AWP 10,018,202051,Staff,0,0,0,0
1683732423081,AWP 10,019,202052,Staff,0,0,0,0
1683732423081,AWP 10,020,202053,Staff,0,0,0,0
1683732423081,AWP 10,021,202054,Staff,0,0,0,0
1683732423081,AWP 10,022,202055,Staff,0,0,0,0
1683732423081,AWP 10,023,202056,Staff,0,0,0,0
1683732423081,AWP 10,024,202057,Staff,0,0,0,0
1683732423081,AWP 10,025,202058,Staff,0,0,0,0
1683732423081,AWP 10,026,202059,Staff,0,0,0,0
1683732424104,AWP 102,001,202032,Staff,0,0,0,0
1683732424104,AWP 102,002,202033,Staff,0,0,0,0
1683732425131,BENG 100,A01,254234,Taylor Amos; Alyssa C,31,0,40,9
1683732426157,BENG 196,001,270013,Engler; Adam J.,9999,0,9999,0
1683732427183,BICD 100R,A01,202018,Smith; Laurie,0,7,32,32
1683732427183,BICD 100R,A02,202019,Smith; Laurie,0,3,32,32
1683732427183,BICD 100R,A03,202020,Smith; Laurie,0,1,32,32
1683732427183,BICD 100R,A04,202021,Smith; Laurie,6,0,32,26
1683732427183,BICD 100R,A05,202022,Smith; Laurie,10,0,32,22
1683732428207,BICD 136,A01,193242,Gustafson-Brown; Cindy,0,2,32,32
1683732428207,BICD 136,A02,193244,Gustafson-Brown; Cindy,13,0,32,19
1683732429237,BIEB 102,A01,193249,Butler; Shannon Rhey,0,0,32,32
1683732429237,BIEB 102,A02,193251,Butler; Shannon Rhey,0,0,32,32
1683732429237,BIEB 102,A03,193253,Butler; Shannon Rhey,0,0,32,32
1683732429237,BIEB 102,A04,193255,Butler; Shannon Rhey,13,0,32,19
1683732429237,BIEB 102,A05,193265,Butler; Shannon Rhey,25,0,32,7
1683732429237,BIEB 102,A06,193269,Butler; Shannon Rhey,12,0,32,20
1683732431287,BIEB 150,A01,193274,Staff,0,0,32,32
1683732431287,BIEB 150,A02,193285,Staff,24,0,32,8
1683732432316,BIEB 194,A00,193286,Kurle; Carolyn M.,19,0,32,13
1683732433344,BILD 1,A01,192291,Staff,15,0,32,17
1683732433344,BILD 1,A02,192292,Staff,30,0,32,2
1683732433344,BILD 1,B01,192520,Reuther; Keefe,0,1,0,0
1683732433344,BILD 1,B02,192532,Reuther; Keefe,0,1,0,0
1683732434371,BILD 3,A01,192556,Butler; Shannon Rhey,0,0,32,32
1683732434371,BILD 3,A02,192581,Butler; Shannon Rhey,0,1,32,32
1683732434371,BILD 3,A03,192611,Butler; Shannon Rhey,19,0,32,13
1683732434371,BILD 3,A04,192612,Butler; Shannon Rhey,23,0,32,9
1683732434371,BILD 3,A05,192613,Butler; Shannon Rhey,26,0,32,6
1683732434371,BILD 3,A06,192679,Butler; Shannon Rhey,27,0,32,5
1683732434371,BILD 3,A07,192682,Butler; Shannon Rhey,20,0,32,12
1683732435396,BILD 4,A01,192836,Reuther; Keefe,1,0,24,23
1683732435396,BILD 4,A02,193044,Reuther; Keefe,4,0,24,20
1683732436424,BILD 10,A01,193142,Gustafson-Brown; Cindy,29,0,32,3
1683732436424,BILD 10,A02,193149,Gustafson-Brown; Cindy,31,0,32,1
1683732437449,BIMM 100,A01,193301,Staff,0,6,32,32
1683732437449,BIMM 100,A02,193312,Staff,0,7,32,32
1683732437449,BIMM 100,A03,193323,Staff,0,10,32,32
1683732438474,BIMM 101,A01,193329,McDonnell; Lisa Marie,0,3,24,24
1683732438474,BIMM 101,A02,193339,McDonnell; Lisa Marie,0,3,24,24
1683732438474,BIMM 101,B01,193354,McDonnell; Lisa Marie,0,4,24,24
1683732438474,BIMM 101,B02,193357,McDonnell; Lisa Marie,0,3,24,24
1683732439501,BIMM 110,A01,193377,Tat; John,0,11,32,32
1683732439501,BIMM 110,A02,193378,Tat; John,0,11,32,32
1683732440533,BIMM 120,A01,206116,Staff,1,0,32,31
1683732440533,BIMM 120,A02,206117,Staff,7,0,32,25
1683732440533,BIMM 120,A03,206121,Staff,21,0,32,11
1683732441559,BIPN 100,A01,193393,Park; Ji Young,0,15,32,32
1683732441559,BIPN 100,A02,193402,Park; Ji Young,0,14,32,32
1683732441559,BIPN 100,A03,193413,Park; Ji Young,0,14,32,32
1683732441559,BIPN 100,A04,193414,Park; Ji Young,0,13,32,32
1683732442589,BIPN 102,A01,193429,Staff,0,0,32,32
1683732442589,BIPN 102,A02,193438,Staff,18,0,32,14
1683732443615,BIPN 106,A01,193450,Reyes Gonzalez; Catalina,0,2,40,40
1683732444646,BIPN 134,A01,193465,Cooke; James Edward,0,0,32,32
1683732444646,BIPN 134,A02,193474,Cooke; James Edward,25,0,32,7
1683732444646,BIPN 134,A03,193485,Cooke; James Edward,29,0,32,3
1683732444646,BIPN 134,A04,193486,Cooke; James Edward,20,0,32,12
1683732444646,BIPN 134,A05,193491,Cooke; James Edward,31,0,32,1
1683732444646,BIPN 134,A06,193501,Cooke; James Edward,30,0,32,2
1683732444646,BIPN 134,A07,193510,Cooke; James Edward,29,0,32,3
1683732446695,BISP 194,A00,222522,Staff,14,0,32,18
1683732447724,CAT 124,A01,202407,Staff,19,0,25,6
1683732448751,CAT 125,A00,202408,Marchisotto; Jennifer Anne,2,0,20,18
1683732449776,CAT 125R,A00,202409,Smith; Lauryn Alissa,0,11,20,20
1683732449776,CAT 125R,B00,202410,Morales; Celeste Georgianna,0,11,20,20
1683732449776,CAT 125R,C00,202411,Irwin; Matthew Joseph,0,12,20,20
1683732450802,CENG 15,A01,204712,Yang; Kesong,0,1,0,0
1683732451828,CENG 114,A00,202070,Jahed Motlagh; Zeinab,5,0,20,15
1683732452855,CGS 105,A00,185477,Wesling; Megan E.,24,0,40,16
1683732453881,CGS 106,A00,185494,Staff,11,0,22,11
1683732454907,CGS 108,A00,185495,Staff,14,0,20,6
1683732455934,CGS 114,A00,185496,Staff,13,0,18,5
1683732456961,CGS 119,A00,185501,Staff,15,0,20,5
1683732457988,CGS 120,A00,185511,Staff,11,0,20,9
1683732459013,CHEM 4,A01,184675,Bussey; Thomas J,97,0,100,3
1683732460040,CHEM 6A,A01,184677,Staff,32,0,60,28
1683732461065,CHEM 6B,A01,184679,Staff,63,0,100,37
1683732462093,CHEM 6C,A01,184681,Bussey; Thomas J,0,0,50,50
1683732462093,CHEM 6C,A02,184682,Bussey; Thomas J,32,0,50,18
1683732463117,CHEM 40A,A01,184684,Albizati; Kim F.,33,0,100,67
1683732464142,CHEM 40B,A01,184686,Albizati; Kim F.,0,22,100,100
1683732465170,CHEM 41B,A01,184690,Staff,51,0,100,49
1683732466195,COGS 3,A01,184715,Boyle; Mary E. T.,0,27,40,40
1683732467221,COGS 14B,A01,185172,Staff,0,14,38,38
1683732468251,COGS 18,A01,184736,Staff,14,0,80,66
1683732469280,COGS 100,A01,184932,Staff,0,8,73,73
1683732470306,COGS 101A,A01,184935,Staff,0,40,30,30
1683732471334,COGS 101B,A01,184944,Staff,0,2,30,30
1683732472359,COGS 101C,A01,184946,Staff,0,10,30,30
1683732473384,COGS 102A,A01,184951,Johnson; Christine M.,1,0,40,39
1683732474409,COGS 107B,A01,184953,Mooshagian; Eric Frederick,0,52,40,40
1683732475438,COGS 118B,A01,184959,Gupta; Anjum,0,50,40,40
1683732476463,COGS 153,A00,184961,Staff,1,16,30,29
1683732477489,COGS 177,A00,184962,Staff,0,20,30,30
1683732478519,COGS 187A,A01,184969,Boyle; Mary E. T.,0,19,40,40
1683732479544,COMM 10,A01,185174,Staff,0,5,25,25
1683732479544,COMM 10,A02,185189,Staff,0,2,25,25
1683732479544,COMM 10,A03,269821,Staff,0,1,0,0
1683732480576,COMM 100B,A02,185476,Staff,10,0,25,15
1683732480576,COMM 100B,A03,277340,Staff,25,0,25,0
1683732481604,COMM 100C,A01,185314,Staff,2,0,25,23
1683732481604,COMM 100C,A02,185327,Staff,17,0,25,8
1683732482629,COMM 110M,A00,185349,Staff,0,0,40,40
1683732483655,COMM 113T,A00,185352,Staff,25,0,40,15
1683732484679,COMM 114I,A00,185353,Staff,31,0,40,9
1683732485707,COMM 131,A00,185354,Staff,17,0,30,13
1683732486741,CSE 8A,A50,185358,Cao; Yingjun,0,46,10,10
1683732487767,CSE 8B,A01,185362,Staff,0,48,50,50
1683732488804,CSE 11,A01,185416,Cao; Yingjun,0,91,10,10
1683732489833,CSE 20,A01,185445,Briones; Jor-el Thomas Caparas,3,0,25,22
1683732490857,CSE 21,A01,185447,Staff,9,0,50,41
1683732491882,CSE 101,A01,185451,Staff,0,13,50,50
1683732491882,CSE 101,B01,185453,Jones; Miles E,0,15,50,50
1683732493932,CSE 141,A01,185458,Eldon; John,16,0,100,84
1683732494955,CSE 141L,A01,185461,Eldon; John,8,0,100,92
1683732495979,CSE 142,A01,185463,Staff,34,0,60,26
1683732495979,CSE 142,B01,201355,Staff,0,7,60,60
1683732497003,CSE 142L,A01,185470,Staff,34,0,60,26
1683732497003,CSE 142L,B01,201417,Staff,0,6,60,60
1683732498031,CSE 190,A00,201433,Staff,32,0,49,17
1683732499062,DOC 1,A01,259136,Strom; Megan C.,7,0,15,8
1683732499062,DOC 1,A02,259137,Strom; Megan C.,15,0,15,0
1683732499062,DOC 1,A03,259138,Strom; Megan C.,14,0,15,1
1683732499062,DOC 1,A04,259139,Strom; Megan C.,13,0,15,2
1683732500090,DOC 100D,A00,259140,Pass; Natalye Joann,14,0,25,11
1683732501119,DSGN 1,A01,184749,Rill; Bryan,0,26,30,30
1683732502144,DSGN 100,A01,185168,Staff,0,2,25,25
1683732503168,ECE 5,A01,185626,Morris; Karcher William,0,12,0,0
1683732504192,ECE 101,A01,185628,Staff,14,0,70,56
1683732505218,ECE 107,A01,185635,Baghdadchi; Saharnaz,0,0,20,20
1683732505218,ECE 107,A02,185638,Baghdadchi; Saharnaz,1,0,20,19
1683732506243,ECE 148,A01,185647,Silberman; Jack,0,0,16,16
1683732507267,ECON 1,A01,185537,Crane; Meredith Helen,54,0,70,16
1683732508292,ECON 3,A01,185549,Crane; Meredith Helen,30,0,70,40
1683732509320,ECON 4,A01,203354,Anderson; John Charles,0,5,10,10
1683732510347,ECON 100A,A01,185574,Staff,0,5,40,40
1683732511375,ECON 100B,A01,185576,Staff,0,12,50,50
1683732512403,ECON 100C,A01,185589,Newhouse; Herbert S,30,0,70,40
1683732513428,ECON 105,A00,185608,Vespa; Emanuel Ignacio,19,0,35,16
1683732514456,ECON 109,A01,185610,Shishkin; Denis,9,0,35,26
1683732515481,ECON 110A,A01,185612,Staff,8,0,40,32
1683732516506,ECON 120A,A01,185615,Staff,19,0,40,21
1683732517589,ECON 120C,A01,185617,Sun; Yixiao,0,21,70,70
1683732518617,ECON 144,A00,203346,Squires; Dale E,2,0,35,33
1683732519642,ECON 171,A01,203349,Newhouse; Herbert S,0,1,35,35
1683732520673,ECON 173A,A01,185621,Toda; Alexis Akira,21,0,35,14
1683732521698,EDS 25,A01,202413,Staff,0,1,0,0
1683732521698,EDS 25,A02,202414,Staff,0,1,0,0
1683732521698,EDS 25,A03,202415,Staff,0,0,0,0
1683732521698,EDS 25,A04,202416,Staff,0,1,0,0
1683732521698,EDS 25,A05,202439,Staff,0,0,0,0
1683732521698,EDS 25,A06,202440,Staff,0,0,0,0
1683732521698,EDS 25,B01,202631,Staff,0,0,0,0
1683732521698,EDS 25,B02,202632,Staff,0,0,0,0
1683732521698,EDS 25,B03,202639,Staff,0,0,0,0
1683732521698,EDS 25,B04,202640,Staff,0,0,0,0
1683732521698,EDS 25,B05,202643,Staff,0,0,0,0
1683732521698,EDS 25,B06,202644,Staff,0,0,0,0
1683732522725,EDS 38,A01,202659,Black; Alison Michelle,25,0,25,0
1683732523752,EDS 115,A00,202652,Staff,18,0,30,12
1683732524777,EDS 125,A00,202649,Staff,13,0,30,17
1683732525802,EDS 126,A01,203332,Staff,30,0,30,0
1683732526829,EDS 139,A00,202838,Staff,16,0,25,9
1683732527856,EDS 146,A01,202655,Staff,14,0,25,11
1683732528884,ENG 15,A00,185667,Staff,0,1,0,0
1683732528884,ENG 15,B00,185672,Staff,0,0,0,0
1683732528884,ENG 15,C00,185675,Staff,0,0,0,0
1683732528884,ENG 15,D00,185682,Staff,0,0,0,0
1683732528884,ENG 15,E00,185684,Staff,0,0,0,0
1683732529908,ETHN 103,A00,185710,Staff,0,8,35,35
1683732530934,ETHN 103A,A00,199228,Man; Simeon S,0,0,9,9
1683732531963,ETHN 109,A00,185711,Staff,15,0,35,20
1683732532988,ETHN 142,A00,185726,Staff,0,4,30,30
1683732534013,ETHN 163J,A00,199229,Man; Simeon S,5,0,8,3
1683732535039,ETHN 168,A00,185727,Staff,7,0,10,3
1683732536067,ETHN 182,A00,185728,Staff,0,0,35,35
1683732537091,ETHN 183,A00,185737,Staff,10,0,18,8
1683732538118,GLBH 111,A01,209361,Burgos; Jose L.,0,0,0,0
1683732540169,HIEU 104,A00,185792,Staff,14,0,20,6
1683732541213,HIEU 115,A00,185800,Staff,0,0,20,20
1683732542241,HIEU 128,A00,185801,Staff,0,9,20,20
1683732543267,HIEU 147,A00,185802,Staff,15,0,20,5
1683732544293,HIEU 154,A00,185823,Staff,11,0,20,9
1683732545317,HILA 102,A00,185826,Staff,14,0,20,6
1683732546345,HILD 2C,A01,185778,Staff,0,13,20,20
1683732547370,HILD 7B,A01,185780,Kwak; Nancy,0,17,32,32
1683732547370,HILD 7B,A02,185781,Kwak; Nancy,0,18,32,32
1683732548394,HILD 30,A01,185791,Staff,12,0,20,8
1683732549419,HISC 119,A00,185830,Golan; Tal,0,10,20,20
1683732550442,HITO 156GS,A00,185831,Patterson; Patrick H.,0,0,0,23
1683732551470,HIUS 103,A00,185832,Man; Simeon S,0,4,20,20
1683732552495,HIUS 117,A00,185836,Kwak; Nancy,2,0,20,18
1683732553519,HIUS 125,A00,185840,Man; Simeon S,0,2,23,23
1683732554547,HIUS 149,A00,185845,Staff,1,0,20,19
1683732555578,HUM 3,A01,185882,Zavodny; Tatiana Sophia,0,8,50,50
1683732555578,HUM 3,B01,185899,Caldwell; Michael Alan,0,18,50,50
1683732556606,HUM 3GS,A00,185900,Patterson; Patrick H.,0,0,0,23
1683732557631,HUM 4,A01,185938,Zroka; Amy Liane,28,0,50,22
1683732557631,HUM 4,B01,185956,Watkins; Eric,0,6,50,50
1683732557631,HUM 4,B02,202209,Watkins; Eric,0,6,50,50
1683732557631,HUM 4,B03,202210,Watkins; Eric,0,5,50,50
1683732558659,HUM 5,A01,185958,West; Geoffrey Scott,0,0,50,50
1683732558659,HUM 5,A02,202215,West; Geoffrey Scott,0,1,50,50
1683732559683,INTL 190,A00,185959,Gagnon; Jeffrey C,0,0,0,9
1683732559683,INTL 190,B00,185960,Lettieri; Michael Joseph,0,0,0,2
1683732560709,JAPN 180,A00,254509,Staff,4,0,30,26
1683732561735,LATI 10,A01,202853,Kennemore; Amy Michelle,4,0,35,31
1683732561735,LATI 10,A02,202854,Kennemore; Amy Michelle,3,0,35,32
1683732561735,LATI 10,A03,270054,Kennemore; Amy Michelle,30,0,30,0
1683732562765,LATI 180,A00,202855,Kennemore; Amy Michelle,11,0,20,9
1683732563793,LAWS 101,A00,201767,Golan; Tal,0,7,40,40
1683732564819,LIFR 1C,A00,185961,Staff,6,0,20,14
1683732565848,LIFR 1CX,A00,185962,Staff,7,0,20,13
1683732566873,LIFR 1D,A00,185963,Staff,7,0,20,13
1683732567898,LIFR 1DX,A00,185964,Staff,7,0,20,13
1683732568929,LIGN 101,A01,186039,Staff,43,0,50,7
1683732569955,LIGN 165,A00,186040,Staff,14,0,50,36
1683732570983,LTCS 108,A00,186041,Staff,5,0,10,5
1683732572007,LTCS 119,A00,186042,Staff,15,0,20,5
1683732573036,LTCS 130,A00,186043,Wesling; Megan E.,15,0,25,10
1683732575090,LTEA 138,A00,186119,Staff,13,0,40,27
1683732576114,LTEN 124,A00,186148,Staff,5,0,25,20
1683732577141,LTEN 178,A00,186149,Staff,6,0,15,9
1683732578179,LTEN 181,A00,186150,Blanco; John D,34,0,40,6
1683732579206,LTWL 120,A00,186160,Staff,19,0,25,6
1683732580232,LTWL 165,A00,186161,Staff,22,0,25,3
1683732581257,LTWR 100,A00,186162,Staff,0,5,15,15
1683732582283,LTWR 102,A00,186163,Doller; Ben,5,0,15,10
1683732583311,MAE 8,A01,186412,Staff,0,1,0,0
1683732584335,MAE 30B,A00,186445,Bahadori; Mohammad Yousef,81,0,100,19
1683732585362,MAE 40,A00,186592,Bewley; Thomas R,10,0,50,40
1683732586390,MAE 101B,A00,186593,Bahadori; Mohammad Yousef,80,0,100,20
1683732587419,MAE 105,A00,186594,Bandaru; Prabhakar,10,0,50,40
1683732588447,MAE 107,A00,186599,Pham; Hieu Tan,0,8,120,120
1683732589471,MAE 148,A01,186660,Silberman; Jack,3,0,16,13
1683732590497,MATH 10A,A01,188095,Staff,0,6,35,35
1683732591523,MATH 10B,A01,188097,Bowers; Adam R.,0,12,30,30
1683732591523,MATH 10B,A02,188099,Bowers; Adam R.,0,11,30,30
1683732591523,MATH 10B,B01,188104,Bowers; Adam R.,0,10,30,30
1683732591523,MATH 10B,B02,188106,Bowers; Adam R.,0,9,30,30
1683732592548,MATH 10C,A01,188111,Staff,0,20,30,30
1683732592548,MATH 10C,A02,188127,Staff,0,19,30,30
1683732592548,MATH 10C,A03,188131,Staff,0,19,30,30
1683732592548,MATH 10C,B01,188218,Staff,17,0,30,13
1683732592548,MATH 10C,B02,188244,Staff,13,0,30,17
1683732592548,MATH 10C,B03,188277,Staff,14,0,30,16
1683732593575,MATH 18,A01,188344,Bach; Quang Tran,18,0,30,12
1683732593575,MATH 18,A02,188345,Bach; Quang Tran,11,0,30,19
1683732593575,MATH 18,B01,188353,Bach; Quang Tran,11,0,30,19
1683732593575,MATH 18,B02,188354,Bach; Quang Tran,19,0,30,11
1683732594601,MATH 20A,A01,188374,Staff,10,0,35,25
1683732595626,MATH 20B,A01,188382,Ohm; Ko Woon,7,0,30,23
1683732595626,MATH 20B,A02,188383,Ohm; Ko Woon,22,0,30,8
1683732595626,MATH 20B,B01,188385,Ohm; Ko Woon,7,0,30,23
1683732595626,MATH 20B,B02,188392,Ohm; Ko Woon,22,0,30,8
1683732596655,MATH 20C,A01,188394,Harel; Guershon,10,0,30,20
1683732596655,MATH 20C,A02,188395,Harel; Guershon,13,0,30,17
1683732596655,MATH 20C,B01,188404,Harel; Guershon,5,0,30,25
1683732596655,MATH 20C,B02,188405,Harel; Guershon,18,0,30,12
1683732597683,MATH 20D,A01,188414,Hammock; Frances H,0,1,30,30
1683732597683,MATH 20D,A02,188415,Hammock; Frances H,0,1,30,30
1683732597683,MATH 20D,B01,188447,Hammock; Frances H,0,1,30,30
1683732597683,MATH 20D,B02,188486,Hammock; Frances H,2,0,30,28
1683732598708,MATH 20E,A01,188649,Staff,21,0,30,9
1683732598708,MATH 20E,A02,188650,Staff,20,0,30,10
1683732598708,MATH 20E,A03,188673,Staff,0,0,30,30
1683732599733,MATH 102,A01,188675,Staff,0,40,35,35
1683732600759,MATH 103B,A01,188681,Staff,3,0,35,32
1683732600759,MATH 103B,B01,188692,Staff,5,0,35,30
1683732601783,MATH 109,A01,188695,Salehi Golsefidy; Alireza,24,0,35,11
1683732601783,MATH 109,A02,188696,Salehi Golsefidy; Alireza,24,0,35,11
1683732602812,MATH 120A,A01,188698,Eggers; John Dietrich,7,0,35,28
1683732603842,MATH 142B,A01,188736,Ioana; Adrian,0,0,30,30
1683732603842,MATH 142B,A02,188741,Ioana; Adrian,0,1,30,30
1683732603842,MATH 142B,A03,188743,Ioana; Adrian,0,3,30,30
1683732604868,MATH 168A,A01,188790,Staff,0,11,35,35
1683732605894,MATH 170A,A01,188803,Nie; Jiawang,0,2,35,35
1683732605894,MATH 170A,A02,188811,Nie; Jiawang,0,1,35,35
1683732605894,MATH 170A,A03,188814,Nie; Jiawang,1,0,35,34
1683732605894,MATH 170A,A04,188815,Nie; Jiawang,5,0,35,30
1683732606920,MATH 193B,A01,188817,Staff,0,0,35,35
1683732606920,MATH 193B,A02,188818,Staff,6,0,35,29
1683732607944,MGT 4,A01,202857,Anderson; John Charles,59,0,80,21
1683732608968,MGT 12,A00,202858,Lindenberger; Wade Douglas,40,0,90,50
1683732609993,MGT 18,A00,202859,Staff,73,0,90,17
1683732611017,MGT 18GS,A00,202860,McKay; Michael J,13,0,28,15
1683732612045,MGT 45,A00,202861,Pecore; Joseph P.,8,0,90,82
1683732613075,MGT 100,A00,202863,Yavorsky; Daniel Ryan,27,0,90,63
1683732614103,MGT 103,A00,202864,Ehrich; Kristine R,0,19,90,90
1683732615128,MGT 112,A00,202865,Ehrich; Kristine R,15,0,90,75
1683732616157,MGT 121A,A00,202868,Staff,70,0,90,20
1683732617186,MGT 131B,A00,202869,Anderson; John Charles,58,0,90,32
1683732618209,MGT 136,A00,202871,Lindenberger; Wade Douglas,83,0,90,7
1683732619235,MGT 164,A00,202873,Staff,0,67,90,91
1683732620263,MGT 164GS,A00,202874,McKay; Mary A,13,0,28,15
1683732621344,MGT 180,A00,202875,Staff,0,51,90,91
1683732622368,MMW 11R,A01,205019,Herbst; Matthew,0,0,30,30
1683732622368,MMW 11R,A02,205026,Herbst; Matthew,29,0,30,1
1683732623402,MMW 15,A01,193512,Chang; Edmond Yi-Teh,0,8,28,28
1683732623402,MMW 15,A02,193513,Chang; Edmond Yi-Teh,0,5,28,28
1683732623402,MMW 15,A03,193514,Chang; Edmond Yi-Teh,0,5,28,28
1683732623402,MMW 15,A04,193515,Chang; Edmond Yi-Teh,0,5,28,28
1683732623402,MMW 15,A05,193516,Chang; Edmond Yi-Teh,0,5,28,28
1683732623402,MMW 15,A06,193517,Chang; Edmond Yi-Teh,0,6,28,28
1683732623402,MMW 15,B01,193519,Chang; Edmond Yi-Teh,0,5,28,28
1683732623402,MMW 15,B02,193520,Chang; Edmond Yi-Teh,0,5,28,28
1683732623402,MMW 15,B03,193521,Chang; Edmond Yi-Teh,0,5,28,28
1683732623402,MMW 15,B04,193522,Chang; Edmond Yi-Teh,0,6,28,28
1683732623402,MMW 15,B05,193523,Chang; Edmond Yi-Teh,0,5,28,28
1683732623402,MMW 15,B06,193524,Chang; Edmond Yi-Teh,0,5,28,28
1683732624427,MMW 122,A01,193526,Rahimi; Babak,0,16,28,28
1683732624427,MMW 122,A02,193527,Rahimi; Babak,0,15,28,28
1683732624427,MMW 122,A03,193528,Rahimi; Babak,0,0,0,0
1683732624427,MMW 122,A04,193529,Rahimi; Babak,0,0,0,0
1683732625451,MUS 1A,A01,186663,Staff,0,18,35,35
1683732626475,MUS 4,A01,186715,Staff,0,12,35,35
1683732627501,MUS 5R,A01,186796,Dubnov; Shlomo,0,17,35,35
1683732628526,MUS 6,A01,186798,Staff,0,4,25,25
1683732629569,MUS 7,A01,186830,Staff,11,0,35,24
1683732630593,MUS 8,A01,186930,Staff,0,27,35,35
1683732631619,MUS 15,A01,186932,Staff,0,15,35,35
1683732631619,MUS 15,B01,186934,Staff,0,16,35,35
1683732632644,MUS 80,A00,186935,Staff,0,0,20,20
1683732632644,MUS 80,B00,186936,Staff,24,0,25,1
1683732633669,NANO 11,A00,204702,Lipomi; Darren John,0,0,0,0
1683732634695,NANO 15,A01,204709,Yang; Kesong,0,1,0,0
1683732635721,NANO 114,A00,202069,Jahed Motlagh; Zeinab,2,0,10,8
1683732636745,PHIL 1,A00,186955,Grush; Rick Scott,31,0,40,9
1683732637772,PHIL 10,A01,186973,Grush; Rick Scott,27,0,35,8
1683732637772,PHIL 10,A02,186974,Grush; Rick Scott,33,0,35,2
1683732638800,PHIL 13,A01,186976,Staff,1,0,35,34
1683732638800,PHIL 13,A02,186977,Staff,16,0,35,19
1683732639825,PHIL 14,A01,186979,Staff,30,0,35,5
1683732639825,PHIL 14,A02,186986,Staff,32,0,35,3
1683732640854,PHIL 28,A01,186988,Staff,16,0,30,14
1683732640854,PHIL 28,A02,186989,Staff,0,0,30,30
1683732640854,PHIL 28,A03,186990,Staff,10,0,30,20
1683732640854,PHIL 28,A04,186991,Staff,26,0,30,4
1683732641880,PHIL 120,A00,186997,Staff,23,0,40,17
1683732642933,PHIL 137,A00,187003,Staff,8,0,40,32
1683732643959,PHIL 150,A00,187015,Staff,47,0,70,23
1683732644987,PHIL 167,A00,187021,Lamey; Andy M.,34,0,40,6
1683732646011,PHIL 174,A01,202226,Staff,17,0,20,3
1683732646011,PHIL 174,A02,202235,Staff,20,0,20,0
1683732647035,PHIL 191A,A00,258918,Staff,0,0,1,1
1683732648059,PHYS 1A,A00,187028,Staff,26,0,60,34
1683732649086,PHYS 1AL,001,187036,Staff,3,0,30,27
1683732649086,PHYS 1AL,002,187049,Staff,18,0,30,12
1683732650112,PHYS 1B,A00,187058,Staff,21,0,60,39
1683732651136,PHYS 1BL,001,187064,Staff,0,1,30,30
1683732651136,PHYS 1BL,002,187070,Staff,4,0,30,26
1683732652161,PHYS 1C,A00,187082,Staff,30,0,120,90
1683732653190,PHYS 1CL,001,187088,Staff,0,9,30,30
1683732653190,PHYS 1CL,002,187089,Staff,0,1,30,30
1683732653190,PHYS 1CL,009,262693,Staff,9,0,30,21
1683732654216,PHYS 2B,A01,187097,Staff,55,0,115,60
1683732655239,PHYS 2C,A01,187099,Staff,63,0,115,52
1683732656265,PHYS 2CL,A01,187101,Staff,5,0,28,23
1683732656265,PHYS 2CL,A02,187102,Staff,15,0,28,13
1683732657293,PHYS 2D,A01,187123,Shotwell; Brian,95,0,115,20
1683732658316,PHYS 4B,A01,187133,Grinstein; Benjamin,35,0,50,15
1683732659342,POLI 10,A00,188819,Staff,0,4,50,50
1683732660371,POLI 11,A00,188827,Staff,43,0,50,7
1683732661398,POLI 13R,A00,188828,Staff,0,2,20,20
1683732662423,POLI 27,A01,188830,Elgin; Samuel Zincke,0,2,70,70
1683732663447,POLI 30,A00,188832,Desposato; Scott,30,0,50,20
1683732664474,POLI 102F,A00,188834,Staff,1,0,40,39
1683732665500,POLI 104A,A00,188852,Staff,12,0,30,18
1683732666528,POLI 104I,A00,188853,Staff,0,8,20,20
1683732667565,POLI 110B,A00,188854,Wiens; David,6,0,20,14
1683732668592,POLI 112A,A00,188855,Wiens; David,3,0,30,27
1683732669619,POLI 117R,A00,188856,Forman; Fonna,0,12,20,20
1683732670645,POLI 118,A00,188857,Ingham; Sean,8,0,20,12
1683732671671,POLI 120G,A00,188858,Staff,7,0,30,23
1683732672699,POLI 131CR,A00,188863,Hoston; Germaine,20,0,50,30
1683732673723,POLI 133,A00,188864,Nellis; Gareth Hb,44,0,50,6
1683732674747,POLI 134D,A00,188865,Desposato; Scott,27,0,30,3
1683732675771,POLI 142A,A00,188871,Gartzke; Erik,21,0,50,29
1683732676799,POLI 142K,A00,188874,Staff,38,0,50,12
1683732677827,POLI 143,A00,188940,Gartzke; Erik,15,0,30,15
1683732678853,POLI 153,A00,188943,Staff,1,0,20,19
1683732679879,POLI 160AA,A00,188944,Staff,10,0,40,30
1683732680905,POLI 170A,A00,188945,Staff,10,0,30,20
1683732682954,PSYC 1,A00,188952,Staff,36,0,90,54
1683732683977,PSYC 2,B00,188953,Staff,19,0,35,16
1683732685002,PSYC 6,A00,188970,Staff,47,0,60,13
1683732686026,PSYC 7,A00,188973,Staff,35,0,45,10
1683732687050,PSYC 60,A01,188980,Rickard; Timothy C.,42,0,60,18
1683732688077,PSYC 70,A01,189001,Steiner; Eric Tomas,21,0,45,24
1683732689102,PSYC 100,A00,189005,Lacefield; Katharine I,1,98,120,119
1683732690126,PSYC 102,A00,189008,Staff,6,0,30,24
1683732691151,PSYC 106,B00,189026,Gorman; Michael R.,26,0,60,34
1683732692182,PSYC 114,B01,189033,Winkielman; Piotr,0,31,30,30
1683732693209,PSYC 131,A00,189036,Anagnostaras; Stephan,0,44,60,60
1683732694232,PSYC 136,A00,189041,Lowe; Angela Beth,0,7,25,25
1683732695256,PSYC 137,A00,189057,Winkielman; Piotr,0,36,25,25
1683732696284,PSYC 144,A00,189107,Wixted; John T,0,11,50,50
1683732698333,PSYC 162,A00,189142,Staff,0,9,85,85
1683732699357,PSYC 172,A00,189144,Gorman; Michael R.,0,6,30,30
1683732701409,PSYC 179,A00,189146,Lacefield; Katharine I,0,88,120,120
1683732702436,PSYC 181,A00,189147,Anagnostaras; Stephan,110,45,200,90
1683732703460,PSYC 190R,A00,189148,Barner; David A.,0,23,80,80
1683732704485,PSYC 191,A00,189275,Rickard; Timothy C.,0,11,25,25
1683732705513,PSYC 193,A00,189276,Chapman; Eddie Nathaniel,0,1,0,4
1683732706538,PSYC 193L,A01,189281,Lowe; Angela Beth,8,0,20,12
1683732706538,PSYC 193L,B01,189285,Staff,28,0,35,7
1683732707562,RELI 149,A00,187137,Rahimi; Babak,6,0,40,34
1683732708589,SE 9,A01,187315,Staff,0,2,18,18
1683732709613,SE 101B,A00,187409,Staff,24,0,30,6
1683732710636,SE 110B,A00,187444,Staff,10,0,40,30
1683732711660,SE 130B,A00,187449,Staff,31,0,40,9
1683732712685,SE 150A,A00,187516,Staff,8,0,20,12
1683732713709,SE 154,A00,187528,Staff,29,0,50,21
1683732714736,SIO 3,A01,258171,Staff,35,0,40,5
1683732715760,SIO 10,A00,187144,Cook; Geoffrey W,0,6,75,75
1683732716786,SIO 45,A00,187152,Cook; Geoffrey W,1,7,100,99
1683732717812,SIO 109R,A00,194486,Staff,0,4,20,20
1683732719859,SIO 187,A01,187233,Kacev; David,12,0,40,28
1683732720885,SOCI 1,A01,258656,Thorpe; Charles Robert,28,0,30,2
1683732720885,SOCI 1,A02,258658,Thorpe; Charles Robert,30,0,30,0
1683732720885,SOCI 1,A03,258661,Thorpe; Charles Robert,25,0,25,0
1683732720885,SOCI 1,A04,258666,Thorpe; Charles Robert,22,0,25,3
1683732720885,SOCI 1,A05,258897,Thorpe; Charles Robert,22,0,25,3
1683732720885,SOCI 1,A06,258898,Thorpe; Charles Robert,25,0,25,0
1683732721914,SOCI 30,A01,258903,Pardo Guerra; Juan Pablo,14,0,30,16
1683732722939,SOCI 102,A00,258904,Staff,9,0,25,16
1683732723965,SOCI 106,A00,258905,Staff,19,0,25,6
1683732725046,SOCI 111,A00,258907,Ribas Norris; Janet Vanesa,26,0,30,4
1683732726073,SOCI 121R,A00,258908,Pardo Guerra; Juan Pablo,7,0,30,23
1683732727100,SOCI 126,A01,203330,Staff,14,0,20,6
1683732728124,SOCI 131,A00,258909,Thorpe; Charles Robert,30,0,60,30
1683732729152,SOCI 135,A00,258910,Payne; Christine Anna,0,13,30,30
1683732730176,SOCI 157,A00,258911,Staff,10,0,30,20
1683732731203,SOCI 184,A00,258912,Staff,25,0,30,5
1683732732228,SOCI 188D,A00,258913,Staff,22,0,30,8
1683732733251,SYN 2,001,187529,Staff,9,0,16,7
1683732733251,SYN 2,002,201452,Staff,0,20,16,16
1683732733251,SYN 2,003,201469,Staff,1,0,16,15
1683732734274,SYN 100,A01,187531,Staff,0,9,20,20
1683732734274,SYN 100,B01,201491,Staff,0,10,20,20
1683732735299,TDAC 1,A00,189286,Walsh; Kim C.,3,0,20,17
1683732735299,TDAC 1,B00,189287,Harting; Carla Kelso,10,0,20,10
1683732736323,TDAC 101,A00,189300,Walsh; Kim C.,16,0,20,4
1683732736323,TDAC 101,B00,189301,Harting; Carla Kelso,18,0,20,2
1683732737348,TDAC 102,A00,189304,Basso; Beatrice,14,0,20,6
1683732738371,TDAC 108,A00,189305,Staff,18,0,20,2
1683732739396,TDDE 131,A00,189310,Staff,19,0,20,1
1683732739396,TDDE 131,B00,189314,Staff,19,0,20,1
1683732739396,TDDE 131,C00,189315,Staff,48,0,50,2
1683732739396,TDDE 131,D00,189316,Staff,14,0,15,1
1683732739396,TDDE 131,E00,204841,Staff,20,0,20,0
1683732740425,TDGE 10,A00,189289,Staff,26,0,50,24
1683732740425,TDGE 10,B00,189290,Havis; Allan,0,1,50,50
1683732741450,TDGE 11,A00,189291,Fulton; Julia,0,4,50,50
1683732741450,TDGE 11,B00,189292,Staff,20,0,25,5
1683732741450,TDGE 11,C00,260270,Staff,0,0,0,0
1683732742475,TDGE 25,A00,189294,Staff,1,0,20,19
1683732743499,TDGE 124,A00,189318,Fulton; Julia,0,7,50,50
1683732744526,TDGE 125,A00,189319,Staff,13,0,25,12
1683732744526,TDGE 125,B00,189320,Staff,23,0,25,2
1683732745558,TDGE 127,A00,189322,Havis; Allan,1,0,50,49
1683732746583,TDHT 101,A00,189323,Staff,18,0,25,7
1683732746583,TDHT 101,B00,189324,Staff,25,0,25,0
1683732747607,TDHT 102,A00,189325,Staff,49,0,50,1
1683732748636,TDMV 1,A00,189295,Arcidiacono; Kristin,20,0,30,10
1683732748636,TDMV 1,B00,189296,Caligagan; Maria T.,23,0,30,7
1683732749663,TDMV 2,A00,189297,Sammartano; Tonnie,27,0,30,3
1683732749663,TDMV 2,B00,189299,Arcidiacono; Kristin,23,0,30,7
1683732750690,TDMV 3,A00,204998,Rincon; Alicia,22,0,30,8
1683732751718,TDMV 120,A00,189458,Sammartano; Tonnie,28,0,30,2
1683732752745,TDMV 138,A00,189541,Jun; Grace Shin Hae,20,0,40,20
1683732753769,TDMV 142,A00,189717,Caligagan; Tony,25,0,30,5
1683732753769,TDMV 142,B00,189718,Caligagan; Maria T.,25,0,30,5
1683732754796,TMC 2,A01,187533,Staff,25,0,25,0
1683732754796,TMC 2,A02,187534,Staff,25,0,25,0
1683732755820,USP 1,A01,187536,Kwak; Nancy,0,16,25,25
1683732756847,USP 5,A01,187538,Staff,8,0,25,17
1683732757872,USP 101,A00,199253,Staff,0,4,0,0
1683732758897,USP 124,A00,187562,Boomhower; Matthew Charles,0,0,30,30
1683732759923,USP 138,A00,187582,Staff,19,0,25,6
1683732760950,USP 152,A01,187597,Staff,3,0,25,22
1683732761973,USP 153,A00,187598,Staff,18,0,25,7
1683732762997,USP 168,A00,187607,Kwak; Nancy,2,0,5,3
1683732764023,USP 173,A00,187619,Staff,4,0,25,21
1683732765049,USP 181,A00,187638,Staff,0,4,25,25
1683732766076,VIS 103,A00,187650,Cruz; Edwin Teddy,17,0,75,58
1683732767101,VIS 110D,A00,187669,Staff,13,0,22,9
1683732768129,VIS 127C,A00,187720,Shen; Kuiyi,67,0,146,79
1683732769154,VIS 149,A00,187731,Yoldas; Pinar,0,12,22,22
1683732770183,VIS 151,A01,188091,Staff,22,0,34,12
1683732770183,VIS 151,A02,188092,Staff,11,0,34,23
1683732771208,VIS 160B,A00,188093,Stalbaum; Brett,0,1,10,10
1683732773263,WCWP 10B,A00,201720,Staff,0,0,5,5
1683732773263,WCWP 10B,B00,201722,Staff,0,0,6,6
1683732774287,WCWP 100,A00,201725,Gagnon; Jeffrey C,0,0,2,2
1683732774287,WCWP 100,B00,201727,Staff,0,4,15,15
1683732777419,ANBI 133,A00,258401,Wilder; Linnea Lorene,34,0,40,6
1683732778444,ANBI 140,A00,258395,Hrvoj Mihic; Branka,18,0,25,7
1683732779471,ANSC 120,A00,258402,Bialecki; Jon Anthony,26,0,40,14
1683732780497,ANSC 144,A00,258400,Staff,12,0,40,28
1683732782545,ANSC 166,A00,258396,Parish; Steven Martin,156,0,175,19
1683732783570,ANSC 180,A00,193533,Staff,8,0,20,12
1683732784596,ANSC 188,A00,258397,Jassal; Aftab,34,0,40,6
1683732785624,ANTH 3,A01,258316,Staff,23,0,30,7
1683732786665,ANTH 5,A00,258394,Semendeferi; Ekaterini,16,0,20,4
1683732787694,ANTH 21,A01,258331,Staff,4,0,40,36
1683732788719,ANTH 103,A00,258398,Varma; Saiba,15,0,25,10
1683732789747,AWP 10,001,202034,Staff,0,0,0,0
1683732789747,AWP 10,002,202035,Staff,0,0,0,0
1683732789747,AWP 10,003,202036,Staff,0,0,0,0
1683732789747,AWP 10,004,202037,Staff,0,0,0,0
1683732789747,AWP 10,005,202038,Staff,0,0,0,0
1683732789747,AWP 10,006,202039,Staff,0,0,0,0
1683732789747,AWP 10,007,202040,Staff,0,0,0,0
1683732789747,AWP 10,008,202041,Staff,0,0,0,0
1683732789747,AWP 10,009,202042,Staff,0,0,0,0
1683732789747,AWP 10,010,202043,Staff,0,0,0,0
1683732789747,AWP 10,011,202044,Staff,0,0,0,0
1683732789747,AWP 10,012,202045,Staff,0,0,0,0
1683732789747,AWP 10,013,202046,Staff,0,0,0,0
1683732789747,AWP 10,014,202047,Staff,0,0,0,0
1683732789747,AWP 10,015,202048,Staff,0,0,0,0
1683732789747,AWP 10,016,202049,Staff,0,0,0,0
1683732789747,AWP 10,017,202050,Staff,0,0,0,0
1683732789747,AWP 10,018,202051,Staff,0,0,0,0
1683732789747,AWP 10,019,202052,Staff,0,0,0,0
1683732789747,AWP 10,020,202053,Staff,0,0,0,0
1683732789747,AWP 10,021,202054,Staff,0,0,0,0
1683732789747,AWP 10,022,202055,Staff,0,0,0,0
1683732789747,AWP 10,023,202056,Staff,0,0,0,0
1683732789747,AWP 10,024,202057,Staff,0,0,0,0
1683732789747,AWP 10,025,202058,Staff,0,0,0,0
1683732789747,AWP 10,026,202059,Staff,0,0,0,0
1683732790774,AWP 102,001,202032,Staff,0,0,0,0
1683732790774,AWP 102,002,202033,Staff,0,0,0,0
1683732791803,BENG 100,A01,254234,Taylor Amos; Alyssa C,31,0,40,9
1683732792833,BENG 196,001,270013,Engler; Adam J.,9999,0,9999,0
1683732793860,BICD 100R,A01,202018,Smith; Laurie,0,7,32,32
1683732793860,BICD 100R,A02,202019,Smith; Laurie,0,3,32,32
1683732793860,BICD 100R,A03,202020,Smith; Laurie,0,1,32,32
1683732793860,BICD 100R,A04,202021,Smith; Laurie,6,0,32,26
1683732793860,BICD 100R,A05,202022,Smith; Laurie,10,0,32,22
1683732794887,BICD 136,A01,193242,Gustafson-Brown; Cindy,0,2,32,32
1683732794887,BICD 136,A02,193244,Gustafson-Brown; Cindy,13,0,32,19
1683732795916,BIEB 102,A01,193249,Butler; Shannon Rhey,0,0,32,32
1683732795916,BIEB 102,A02,193251,Butler; Shannon Rhey,0,0,32,32
1683732795916,BIEB 102,A03,193253,Butler; Shannon Rhey,0,0,32,32
1683732795916,BIEB 102,A04,193255,Butler; Shannon Rhey,13,0,32,19
1683732795916,BIEB 102,A05,193265,Butler; Shannon Rhey,25,0,32,7
1683732795916,BIEB 102,A06,193269,Butler; Shannon Rhey,12,0,32,20
1683732797967,BIEB 150,A01,193274,Staff,0,0,32,32
1683732797967,BIEB 150,A02,193285,Staff,24,0,32,8
1683732798993,BIEB 194,A00,193286,Kurle; Carolyn M.,19,0,32,13
1683732800023,BILD 1,A01,192291,Staff,15,0,32,17
1683732800023,BILD 1,A02,192292,Staff,30,0,32,2
1683732800023,BILD 1,B01,192520,Reuther; Keefe,0,1,0,0
1683732800023,BILD 1,B02,192532,Reuther; Keefe,0,1,0,0
1683732801055,BILD 3,A01,192556,Butler; Shannon Rhey,0,0,32,32
1683732801055,BILD 3,A02,192581,Butler; Shannon Rhey,0,1,32,32
1683732801055,BILD 3,A03,192611,Butler; Shannon Rhey,19,0,32,13
1683732801055,BILD 3,A04,192612,Butler; Shannon Rhey,23,0,32,9
1683732801055,BILD 3,A05,192613,Butler; Shannon Rhey,26,0,32,6
1683732801055,BILD 3,A06,192679,Butler; Shannon Rhey,27,0,32,5
1683732801055,BILD 3,A07,192682,Butler; Shannon Rhey,20,0,32,12
1683732802079,BILD 4,A01,192836,Reuther; Keefe,1,0,24,23
1683732802079,BILD 4,A02,193044,Reuther; Keefe,4,0,24,20
1683732803112,BILD 10,A01,193142,Gustafson-Brown; Cindy,29,0,32,3
1683732803112,BILD 10,A02,193149,Gustafson-Brown; Cindy,31,0,32,1
1683732804141,BIMM 100,A01,193301,Staff,0,6,32,32
1683732804141,BIMM 100,A02,193312,Staff,0,7,32,32
1683732804141,BIMM 100,A03,193323,Staff,0,10,32,32
1683732805172,BIMM 101,A01,193329,McDonnell; Lisa Marie,0,3,24,24
1683732805172,BIMM 101,A02,193339,McDonnell; Lisa Marie,0,3,24,24
1683732805172,BIMM 101,B01,193354,McDonnell; Lisa Marie,0,4,24,24
1683732805172,BIMM 101,B02,193357,McDonnell; Lisa Marie,0,3,24,24
1683732806200,BIMM 110,A01,193377,Tat; John,0,11,32,32
1683732806200,BIMM 110,A02,193378,Tat; John,0,11,32,32
1683732807225,BIMM 120,A01,206116,Staff,1,0,32,31
1683732807225,BIMM 120,A02,206117,Staff,7,0,32,25
1683732807225,BIMM 120,A03,206121,Staff,21,0,32,11
1683732808248,BIPN 100,A01,193393,Park; Ji Young,0,15,32,32
1683732808248,BIPN 100,A02,193402,Park; Ji Young,0,14,32,32
1683732808248,BIPN 100,A03,193413,Park; Ji Young,0,14,32,32
1683732808248,BIPN 100,A04,193414,Park; Ji Young,0,13,32,32
1683732809274,BIPN 102,A01,193429,Staff,0,0,32,32
1683732809274,BIPN 102,A02,193438,Staff,18,0,32,14
1683732810304,BIPN 106,A01,193450,Reyes Gonzalez; Catalina,0,2,40,40
1683732811331,BIPN 134,A01,193465,Cooke; James Edward,0,0,32,32
1683732811331,BIPN 134,A02,193474,Cooke; James Edward,25,0,32,7
1683732811331,BIPN 134,A03,193485,Cooke; James Edward,29,0,32,3
1683732811331,BIPN 134,A04,193486,Cooke; James Edward,20,0,32,12
1683732811331,BIPN 134,A05,193491,Cooke; James Edward,31,0,32,1
1683732811331,BIPN 134,A06,193501,Cooke; James Edward,30,0,32,2
1683732811331,BIPN 134,A07,193510,Cooke; James Edward,29,0,32,3
1683732813382,BISP 194,A00,222522,Staff,14,0,32,18
1683732814409,CAT 124,A01,202407,Staff,19,0,25,6
1683732815438,CAT 125,A00,202408,Marchisotto; Jennifer Anne,2,0,20,18
1683732816466,CAT 125R,A00,202409,Smith; Lauryn Alissa,0,11,20,20
1683732816466,CAT 125R,B00,202410,Morales; Celeste Georgianna,0,11,20,20
1683732816466,CAT 125R,C00,202411,Irwin; Matthew Joseph,0,12,20,20
1683732817493,CENG 15,A01,204712,Yang; Kesong,0,1,0,0
1683732818518,CENG 114,A00,202070,Jahed Motlagh; Zeinab,5,0,20,15
1683732819546,CGS 105,A00,185477,Wesling; Megan E.,24,0,40,16
1683732820573,CGS 106,A00,185494,Staff,11,0,22,11
1683732821603,CGS 108,A00,185495,Staff,14,0,20,6
1683732822627,CGS 114,A00,185496,Staff,13,0,18,5
1683732823651,CGS 119,A00,185501,Staff,15,0,20,5
1683732824677,CGS 120,A00,185511,Staff,11,0,20,9
1683732825702,CHEM 4,A01,184675,Bussey; Thomas J,97,0,100,3
1683732826731,CHEM 6A,A01,184677,Staff,32,0,60,28
1683732827760,CHEM 6B,A01,184679,Staff,63,0,100,37
1683732828838,CHEM 6C,A01,184681,Bussey; Thomas J,0,0,50,50
1683732828838,CHEM 6C,A02,184682,Bussey; Thomas J,32,0,50,18
1683732829865,CHEM 40A,A01,184684,Albizati; Kim F.,33,0,100,67
1683732830893,CHEM 40B,A01,184686,Albizati; Kim F.,0,22,100,100
1683732831918,CHEM 41B,A01,184690,Staff,51,0,100,49
1683732832943,COGS 3,A01,184715,Boyle; Mary E. T.,0,27,40,40
1683732833967,COGS 14B,A01,185172,Staff,0,14,38,38
1683732834994,COGS 18,A01,184736,Staff,14,0,80,66
1683732836019,COGS 100,A01,184932,Staff,0,8,73,73
1683732837043,COGS 101A,A01,184935,Staff,0,40,30,30
1683732838068,COGS 101B,A01,184944,Staff,0,2,30,30
1683732839094,COGS 101C,A01,184946,Staff,0,10,30,30
1683732840123,COGS 102A,A01,184951,Johnson; Christine M.,1,0,40,39
1683732841148,COGS 107B,A01,184953,Mooshagian; Eric Frederick,0,52,40,40
1683732842173,COGS 118B,A01,184959,Gupta; Anjum,0,50,40,40
1683732843197,COGS 153,A00,184961,Staff,1,16,30,29
1683732844222,COGS 177,A00,184962,Staff,0,20,30,30
1683732845246,COGS 187A,A01,184969,Boyle; Mary E. T.,0,19,40,40
1683732846271,COMM 10,A01,185174,Staff,0,5,25,25
1683732846271,COMM 10,A02,185189,Staff,0,2,25,25
1683732846271,COMM 10,A03,269821,Staff,0,1,0,0
1683732847297,COMM 100B,A02,185476,Staff,10,0,25,15
1683732847297,COMM 100B,A03,277340,Staff,25,0,25,0
1683732848325,COMM 100C,A01,185314,Staff,2,0,25,23
1683732848325,COMM 100C,A02,185327,Staff,17,0,25,8
1683732849357,COMM 110M,A00,185349,Staff,0,0,40,40
1683732850382,COMM 113T,A00,185352,Staff,25,0,40,15
1683732851407,COMM 114I,A00,185353,Staff,31,0,40,9
1683732852435,COMM 131,A00,185354,Staff,17,0,30,13
1683732853460,CSE 8A,A50,185358,Cao; Yingjun,0,46,10,10
1683732854486,CSE 8B,A01,185362,Staff,0,48,50,50
1683732855516,CSE 11,A01,185416,Cao; Yingjun,0,91,10,10
1683732856545,CSE 20,A01,185445,Briones; Jor-el Thomas Caparas,3,0,25,22
1683732857575,CSE 21,A01,185447,Staff,9,0,50,41
1683732858603,CSE 101,A01,185451,Staff,0,13,50,50
1683732858603,CSE 101,B01,185453,Jones; Miles E,0,15,50,50
1683732860658,CSE 141,A01,185458,Eldon; John,16,0,100,84
1683732861687,CSE 141L,A01,185461,Eldon; John,8,0,100,92
1683732862718,CSE 142,A01,185463,Staff,34,0,60,26
1683732862718,CSE 142,B01,201355,Staff,0,7,60,60
1683732863761,CSE 142L,A01,185470,Staff,34,0,60,26
1683732863761,CSE 142L,B01,201417,Staff,0,6,60,60
1683732864786,CSE 190,A00,201433,Staff,32,0,49,17
1683732865814,DOC 1,A01,259136,Strom; Megan C.,7,0,15,8
1683732865814,DOC 1,A02,259137,Strom; Megan C.,15,0,15,0
1683732865814,DOC 1,A03,259138,Strom; Megan C.,14,0,15,1
1683732865814,DOC 1,A04,259139,Strom; Megan C.,13,0,15,2
1683732866840,DOC 100D,A00,259140,Pass; Natalye Joann,14,0,25,11
1683732867866,DSGN 1,A01,184749,Rill; Bryan,0,26,30,30
1683732868891,DSGN 100,A01,185168,Staff,0,2,25,25
1683732869919,ECE 5,A01,185626,Morris; Karcher William,0,12,0,0
1683732870943,ECE 101,A01,185628,Staff,14,0,70,56
1683732871970,ECE 107,A01,185635,Baghdadchi; Saharnaz,0,0,20,20
1683732871970,ECE 107,A02,185638,Baghdadchi; Saharnaz,1,0,20,19
1683732872995,ECE 148,A01,185647,Silberman; Jack,0,0,16,16
1683732874022,ECON 1,A01,185537,Crane; Meredith Helen,54,0,70,16
1683732875047,ECON 3,A01,185549,Crane; Meredith Helen,30,0,70,40
1683732876075,ECON 4,A01,203354,Anderson; John Charles,0,5,10,10
1683732877103,ECON 100A,A01,185574,Staff,0,5,40,40
1683732878129,ECON 100B,A01,185576,Staff,0,12,50,50
1683732879158,ECON 100C,A01,185589,Newhouse; Herbert S,30,0,70,40
1683732880185,ECON 105,A00,185608,Vespa; Emanuel Ignacio,19,0,35,16
1683732881213,ECON 109,A01,185610,Shishkin; Denis,9,0,35,26
1683732882242,ECON 110A,A01,185612,Staff,8,0,40,32
1683732883268,ECON 120A,A01,185615,Staff,19,0,40,21
1683732884293,ECON 120C,A01,185617,Sun; Yixiao,0,21,70,70
1683732885323,ECON 144,A00,203346,Squires; Dale E,2,0,35,33
1683732886349,ECON 171,A01,203349,Newhouse; Herbert S,0,1,35,35
1683732887377,ECON 173A,A01,185621,Toda; Alexis Akira,21,0,35,14
1683732888403,EDS 25,A01,202413,Staff,0,1,0,0
1683732888403,EDS 25,A02,202414,Staff,0,1,0,0
1683732888403,EDS 25,A03,202415,Staff,0,0,0,0
1683732888403,EDS 25,A04,202416,Staff,0,1,0,0
1683732888403,EDS 25,A05,202439,Staff,0,0,0,0
1683732888403,EDS 25,A06,202440,Staff,0,0,0,0
1683732888403,EDS 25,B01,202631,Staff,0,0,0,0
1683732888403,EDS 25,B02,202632,Staff,0,0,0,0
1683732888403,EDS 25,B03,202639,Staff,0,0,0,0
1683732888403,EDS 25,B04,202640,Staff,0,0,0,0
1683732888403,EDS 25,B05,202643,Staff,0,0,0,0
1683732888403,EDS 25,B06,202644,Staff,0,0,0,0
1683732889433,EDS 38,A01,202659,Black; Alison Michelle,25,0,25,0
1683732890461,EDS 115,A00,202652,Staff,18,0,30,12
1683732891486,EDS 125,A00,202649,Staff,13,0,30,17
1683732892511,EDS 126,A01,203332,Staff,30,0,30,0
1683732893539,EDS 139,A00,202838,Staff,16,0,25,9
1683732894572,EDS 146,A01,202655,Staff,14,0,25,11
1683732895601,ENG 15,A00,185667,Staff,0,1,0,2
1683732895601,ENG 15,B00,185672,Staff,0,0,0,1
1683732895601,ENG 15,C00,185675,Staff,0,0,0,0
1683732895601,ENG 15,D00,185682,Staff,0,0,0,0
1683732895601,ENG 15,E00,185684,Staff,0,0,0,0
1683732896624,ETHN 103,A00,185710,Staff,0,8,35,35
1683732897652,ETHN 103A,A00,199228,Man; Simeon S,0,0,9,9
1683732898683,ETHN 109,A00,185711,Staff,15,0,35,20
1683732899707,ETHN 142,A00,185726,Staff,0,4,30,30
1683732900731,ETHN 163J,A00,199229,Man; Simeon S,5,0,8,3
1683732901756,ETHN 168,A00,185727,Staff,7,0,10,3
1683732902786,ETHN 182,A00,185728,Staff,0,0,35,35
1683732903812,ETHN 183,A00,185737,Staff,10,0,18,8
1683732904839,GLBH 111,A01,209361,Burgos; Jose L.,0,0,0,0
1683732906892,HIEU 104,A00,185792,Staff,14,0,20,6
1683732907921,HIEU 115,A00,185800,Staff,0,0,20,20
1683732908947,HIEU 128,A00,185801,Staff,0,9,20,20
1683732909973,HIEU 147,A00,185802,Staff,15,0,20,5
1683732910998,HIEU 154,A00,185823,Staff,11,0,20,9
1683732912023,HILA 102,A00,185826,Staff,14,0,20,6
1683732913047,HILD 2C,A01,185778,Staff,0,13,20,20
1683732914073,HILD 7B,A01,185780,Kwak; Nancy,0,17,32,32
1683732914073,HILD 7B,A02,185781,Kwak; Nancy,0,18,32,32
1683732915102,HILD 30,A01,185791,Staff,12,0,20,8
1683732916130,HISC 119,A00,185830,Golan; Tal,0,10,20,20
1683732917155,HITO 156GS,A00,185831,Patterson; Patrick H.,0,0,0,23
1683732918181,HIUS 103,A00,185832,Man; Simeon S,0,4,20,20
1683732919206,HIUS 117,A00,185836,Kwak; Nancy,2,0,20,18
1683732920231,HIUS 125,A00,185840,Man; Simeon S,0,2,23,23
1683732921254,HIUS 149,A00,185845,Staff,1,0,20,19
1683732922278,HUM 3,A01,185882,Zavodny; Tatiana Sophia,0,8,50,50
1683732922278,HUM 3,B01,185899,Caldwell; Michael Alan,0,18,50,50
1683732923306,HUM 3GS,A00,185900,Patterson; Patrick H.,0,0,0,23
1683732924335,HUM 4,A01,185938,Zroka; Amy Liane,28,0,50,22
1683732924335,HUM 4,B01,185956,Watkins; Eric,0,6,50,50
1683732924335,HUM 4,B02,202209,Watkins; Eric,0,6,50,50
1683732924335,HUM 4,B03,202210,Watkins; Eric,0,5,50,50
1683732925359,HUM 5,A01,185958,West; Geoffrey Scott,0,0,50,50
1683732925359,HUM 5,A02,202215,West; Geoffrey Scott,0,1,50,50
1683732926387,INTL 190,A00,185959,Gagnon; Jeffrey C,0,0,0,9
1683732926387,INTL 190,B00,185960,Lettieri; Michael Joseph,0,0,0,2
1683732927413,JAPN 180,A00,254509,Staff,4,0,30,26
1683732928435,LATI 10,A01,202853,Kennemore; Amy Michelle,4,0,35,31
1683732928435,LATI 10,A02,202854,Kennemore; Amy Michelle,3,0,35,32
1683732928435,LATI 10,A03,270054,Kennemore; Amy Michelle,30,0,30,0
1683732929465,LATI 180,A00,202855,Kennemore; Amy Michelle,11,0,20,9
1683732930492,LAWS 101,A00,201767,Golan; Tal,0,7,40,40
1683732931519,LIFR 1C,A00,185961,Staff,6,0,20,14
1683732932604,LIFR 1CX,A00,185962,Staff,7,0,20,13
1683732933629,LIFR 1D,A00,185963,Staff,7,0,20,13
1683732934655,LIFR 1DX,A00,185964,Staff,7,0,20,13
1683732935678,LIGN 101,A01,186039,Staff,43,0,50,7
1683732936702,LIGN 165,A00,186040,Staff,14,0,50,36
1683732937726,LTCS 108,A00,186041,Staff,5,0,10,5
1683732938749,LTCS 119,A00,186042,Staff,15,0,20,5
1683732939773,LTCS 130,A00,186043,Wesling; Megan E.,15,0,25,10
1683732941823,LTEA 138,A00,186119,Staff,13,0,40,27
1683732942849,LTEN 124,A00,186148,Staff,5,0,25,20
1683732943876,LTEN 178,A00,186149,Staff,6,0,15,9
1683732944899,LTEN 181,A00,186150,Blanco; John D,34,0,40,6
1683732945926,LTWL 120,A00,186160,Staff,19,0,25,6
1683732946949,LTWL 165,A00,186161,Staff,22,0,25,3
1683732947973,LTWR 100,A00,186162,Staff,0,5,15,15
1683732948998,LTWR 102,A00,186163,Doller; Ben,5,0,15,10
1683732950023,MAE 8,A01,186412,Staff,0,1,0,1
1683732951047,MAE 30B,A00,186445,Bahadori; Mohammad Yousef,81,0,100,19
1683732952074,MAE 40,A00,186592,Bewley; Thomas R,10,0,50,40
1683732953102,MAE 101B,A00,186593,Bahadori; Mohammad Yousef,80,0,100,20
1683732954126,MAE 105,A00,186594,Bandaru; Prabhakar,10,0,50,40
1683732955153,MAE 107,A00,186599,Pham; Hieu Tan,0,8,120,120
1683732956179,MAE 148,A01,186660,Silberman; Jack,3,0,16,13
1683732957204,MATH 10A,A01,188095,Staff,0,6,35,35
1683732958227,MATH 10B,A01,188097,Bowers; Adam R.,0,12,30,30
1683732958227,MATH 10B,A02,188099,Bowers; Adam R.,0,11,30,30
1683732958227,MATH 10B,B01,188104,Bowers; Adam R.,0,10,30,30
1683732958227,MATH 10B,B02,188106,Bowers; Adam R.,0,9,30,30
1683732959252,MATH 10C,A01,188111,Staff,0,20,30,30
1683732959252,MATH 10C,A02,188127,Staff,0,19,30,30
1683732959252,MATH 10C,A03,188131,Staff,0,19,30,30
1683732959252,MATH 10C,B01,188218,Staff,17,0,30,13
1683732959252,MATH 10C,B02,188244,Staff,13,0,30,17
1683732959252,MATH 10C,B03,188277,Staff,14,0,30,16
1683732960280,MATH 18,A01,188344,Bach; Quang Tran,18,0,30,12
1683732960280,MATH 18,A02,188345,Bach; Quang Tran,11,0,30,19
1683732960280,MATH 18,B01,188353,Bach; Quang Tran,11,0,30,19
1683732960280,MATH 18,B02,188354,Bach; Quang Tran,19,0,30,11
1683732961305,MATH 20A,A01,188374,Staff,10,0,35,25
1683732962330,MATH 20B,A01,188382,Ohm; Ko Woon,7,0,30,23
1683732962330,MATH 20B,A02,188383,Ohm; Ko Woon,22,0,30,8
1683732962330,MATH 20B,B01,188385,Ohm; Ko Woon,7,0,30,23
1683732962330,MATH 20B,B02,188392,Ohm; Ko Woon,22,0,30,8
1683732963354,MATH 20C,A01,188394,Harel; Guershon,10,0,30,20
1683732963354,MATH 20C,A02,188395,Harel; Guershon,13,0,30,17
1683732963354,MATH 20C,B01,188404,Harel; Guershon,5,0,30,25
1683732963354,MATH 20C,B02,188405,Harel; Guershon,18,0,30,12
1683732964377,MATH 20D,A01,188414,Hammock; Frances H,0,1,30,30
1683732964377,MATH 20D,A02,188415,Hammock; Frances H,0,1,30,30
1683732964377,MATH 20D,B01,188447,Hammock; Frances H,0,1,30,30
1683732964377,MATH 20D,B02,188486,Hammock; Frances H,2,0,30,28
1683732965401,MATH 20E,A01,188649,Staff,21,0,30,9
1683732965401,MATH 20E,A02,188650,Staff,20,0,30,10
1683732965401,MATH 20E,A03,188673,Staff,0,0,30,30
1683732966426,MATH 102,A01,188675,Staff,0,40,35,35
1683732967454,MATH 103B,A01,188681,Staff,3,0,35,32
1683732967454,MATH 103B,B01,188692,Staff,5,0,35,30
1683732968482,MATH 109,A01,188695,Salehi Golsefidy; Alireza,24,0,35,11
1683732968482,MATH 109,A02,188696,Salehi Golsefidy; Alireza,24,0,35,11
1683732969509,MATH 120A,A01,188698,Eggers; John Dietrich,7,0,35,28
1683732970535,MATH 142B,A01,188736,Ioana; Adrian,0,0,30,30
1683732970535,MATH 142B,A02,188741,Ioana; Adrian,0,1,30,30
1683732970535,MATH 142B,A03,188743,Ioana; Adrian,0,3,30,30
1683732971561,MATH 168A,A01,188790,Staff,0,11,35,35
1683732972585,MATH 170A,A01,188803,Nie; Jiawang,0,2,35,35
1683732972585,MATH 170A,A02,188811,Nie; Jiawang,0,1,35,35
1683732972585,MATH 170A,A03,188814,Nie; Jiawang,1,0,35,34
1683732972585,MATH 170A,A04,188815,Nie; Jiawang,5,0,35,30
1683732973613,MATH 193B,A01,188817,Staff,0,0,35,35
1683732973613,MATH 193B,A02,188818,Staff,6,0,35,29
1683732974637,MGT 4,A01,202857,Anderson; John Charles,59,0,80,21
1683732975665,MGT 12,A00,202858,Lindenberger; Wade Douglas,40,0,90,50
1683732976690,MGT 18,A00,202859,Staff,73,0,90,17
1683732977717,MGT 18GS,A00,202860,McKay; Michael J,13,0,28,15
1683732978742,MGT 45,A00,202861,Pecore; Joseph P.,8,0,90,82
1683732979766,MGT 100,A00,202863,Yavorsky; Daniel Ryan,27,0,90,63
1683732980793,MGT 103,A00,202864,Ehrich; Kristine R,0,19,90,90
1683732981817,MGT 112,A00,202865,Ehrich; Kristine R,15,0,90,75
1683732982840,MGT 121A,A00,202868,Staff,70,0,90,20
1683732983869,MGT 131B,A00,202869,Anderson; John Charles,58,0,90,32
1683732984893,MGT 136,A00,202871,Lindenberger; Wade Douglas,83,0,90,7
1683732985924,MGT 164,A00,202873,Staff,0,67,90,91
1683732986950,MGT 164GS,A00,202874,McKay; Mary A,13,0,28,15
1683732987973,MGT 180,A00,202875,Staff,0,51,90,91
1683732988997,MMW 11R,A01,205019,Herbst; Matthew,0,0,30,30
1683732988997,MMW 11R,A02,205026,Herbst; Matthew,29,0,30,1
1683732990020,MMW 15,A01,193512,Chang; Edmond Yi-Teh,0,8,28,28
1683732990020,MMW 15,A02,193513,Chang; Edmond Yi-Teh,0,5,28,28
1683732990020,MMW 15,A03,193514,Chang; Edmond Yi-Teh,0,5,28,28
1683732990020,MMW 15,A04,193515,Chang; Edmond Yi-Teh,0,5,28,28
1683732990020,MMW 15,A05,193516,Chang; Edmond Yi-Teh,0,5,28,28
1683732990020,MMW 15,A06,193517,Chang; Edmond Yi-Teh,0,6,28,28
1683732990020,MMW 15,B01,193519,Chang; Edmond Yi-Teh,0,5,28,28
1683732990020,MMW 15,B02,193520,Chang; Edmond Yi-Teh,0,5,28,28
1683732990020,MMW 15,B03,193521,Chang; Edmond Yi-Teh,0,5,28,28
1683732990020,MMW 15,B04,193522,Chang; Edmond Yi-Teh,0,6,28,28
1683732990020,MMW 15,B05,193523,Chang; Edmond Yi-Teh,0,5,28,28
1683732990020,MMW 15,B06,193524,Chang; Edmond Yi-Teh,0,5,28,28
1683732991047,MMW 122,A01,193526,Rahimi; Babak,0,16,28,28
1683732991047,MMW 122,A02,193527,Rahimi; Babak,0,15,28,28
1683732991047,MMW 122,A03,193528,Rahimi; Babak,0,0,0,0
1683732991047,MMW 122,A04,193529,Rahimi; Babak,0,0,0,0
1683732992076,MUS 1A,A01,186663,Staff,0,18,35,35
1683732993101,MUS 4,A01,186715,Staff,0,12,35,35
1683732994125,MUS 5R,A01,186796,Dubnov; Shlomo,0,17,35,35
1683732995153,MUS 6,A01,186798,Staff,0,4,25,25
1683732996177,MUS 7,A01,186830,Staff,11,0,35,24
1683732997201,MUS 8,A01,186930,Staff,0,27,35,35
1683732998227,MUS 15,A01,186932,Staff,0,15,35,35
1683732998227,MUS 15,B01,186934,Staff,0,16,35,35
1683732999253,MUS 80,A00,186935,Staff,0,0,20,20
1683732999253,MUS 80,B00,186936,Staff,24,0,25,1
1683733000278,NANO 11,A00,204702,Lipomi; Darren John,0,0,0,0
1683733001307,NANO 15,A01,204709,Yang; Kesong,0,1,0,0
1683733002332,NANO 114,A00,202069,Jahed Motlagh; Zeinab,2,0,10,8
1683733003358,PHIL 1,A00,186955,Grush; Rick Scott,31,0,40,9
1683733004386,PHIL 10,A01,186973,Grush; Rick Scott,27,0,35,8
1683733004386,PHIL 10,A02,186974,Grush; Rick Scott,33,0,35,2
1683733005410,PHIL 13,A01,186976,Staff,1,0,35,34
1683733005410,PHIL 13,A02,186977,Staff,16,0,35,19
1683733006435,PHIL 14,A01,186979,Staff,30,0,35,5
1683733006435,PHIL 14,A02,186986,Staff,32,0,35,3
1683733007460,PHIL 28,A01,186988,Staff,16,0,30,14
1683733007460,PHIL 28,A02,186989,Staff,0,0,30,30
1683733007460,PHIL 28,A03,186990,Staff,10,0,30,20
1683733007460,PHIL 28,A04,186991,Staff,26,0,30,4
1683733008485,PHIL 120,A00,186997,Staff,23,0,40,17
1683733009510,PHIL 137,A00,187003,Staff,8,0,40,32
1683733010536,PHIL 150,A00,187015,Staff,47,0,70,23
1683733011564,PHIL 167,A00,187021,Lamey; Andy M.,34,0,40,6
1683733012602,PHIL 174,A01,202226,Staff,17,0,20,3
1683733012602,PHIL 174,A02,202235,Staff,20,0,20,0
1683733013629,PHIL 191A,A00,258918,Staff,0,0,1,1
1683733014657,PHYS 1A,A00,187028,Staff,26,0,60,34
1683733015684,PHYS 1AL,001,187036,Staff,3,0,30,27
1683733015684,PHYS 1AL,002,187049,Staff,18,0,30,12
1683733016709,PHYS 1B,A00,187058,Staff,21,0,60,39
1683733017733,PHYS 1BL,001,187064,Staff,0,1,30,30
1683733017733,PHYS 1BL,002,187070,Staff,4,0,30,26
1683733018757,PHYS 1C,A00,187082,Staff,30,0,120,90
1683733019785,PHYS 1CL,001,187088,Staff,0,9,30,30
1683733019785,PHYS 1CL,002,187089,Staff,0,1,30,30
1683733019785,PHYS 1CL,009,262693,Staff,9,0,30,21
1683733020813,PHYS 2B,A01,187097,Staff,55,0,115,60
1683733021836,PHYS 2C,A01,187099,Staff,63,0,115,52
1683733022869,PHYS 2CL,A01,187101,Staff,5,0,28,23
1683733022869,PHYS 2CL,A02,187102,Staff,15,0,28,13
1683733023898,PHYS 2D,A01,187123,Shotwell; Brian,95,0,115,20
1683733024927,PHYS 4B,A01,187133,Grinstein; Benjamin,35,0,50,15
1683733025952,POLI 10,A00,188819,Staff,0,4,50,50
1683733026979,POLI 11,A00,188827,Staff,43,0,50,7
1683733028005,POLI 13R,A00,188828,Staff,0,2,20,20
1683733029031,POLI 27,A01,188830,Elgin; Samuel Zincke,0,2,70,70
1683733030057,POLI 30,A00,188832,Desposato; Scott,30,0,50,20
1683733031083,POLI 102F,A00,188834,Staff,1,0,40,39
1683733032109,POLI 104A,A00,188852,Staff,12,0,30,18
1683733033137,POLI 104I,A00,188853,Staff,0,8,20,20
1683733034162,POLI 110B,A00,188854,Wiens; David,6,0,20,14
1683733035186,POLI 112A,A00,188855,Wiens; David,3,0,30,27
1683733036279,POLI 117R,A00,188856,Forman; Fonna,0,12,20,20
1683733037306,POLI 118,A00,188857,Ingham; Sean,8,0,20,12
1683733038330,POLI 120G,A00,188858,Staff,7,0,30,23
1683733039355,POLI 131CR,A00,188863,Hoston; Germaine,20,0,50,30
1683733040382,POLI 133,A00,188864,Nellis; Gareth Hb,44,0,50,6
1683733041410,POLI 134D,A00,188865,Desposato; Scott,27,0,30,3
1683733042434,POLI 142A,A00,188871,Gartzke; Erik,21,0,50,29
1683733043461,POLI 142K,A00,188874,Staff,38,0,50,12
1683733044486,POLI 143,A00,188940,Gartzke; Erik,15,0,30,15
1683733045511,POLI 153,A00,188943,Staff,1,0,20,19
1683733046534,POLI 160AA,A00,188944,Staff,10,0,40,30
1683733047561,POLI 170A,A00,188945,Staff,10,0,30,20
1683733049626,PSYC 1,A00,188952,Staff,36,0,90,54
1683733050651,PSYC 2,B00,188953,Staff,19,0,35,16
1683733051675,PSYC 6,A00,188970,Staff,47,0,60,13
1683733052703,PSYC 7,A00,188973,Staff,35,0,45,10
1683733053729,PSYC 60,A01,188980,Rickard; Timothy C.,42,0,60,18
1683733054757,PSYC 70,A01,189001,Steiner; Eric Tomas,21,0,45,24
1683733055781,PSYC 100,A00,189005,Lacefield; Katharine I,1,98,120,119
1683733056806,PSYC 102,A00,189008,Staff,6,0,30,24
1683733057831,PSYC 106,B00,189026,Gorman; Michael R.,26,0,60,34
1683733058860,PSYC 114,B01,189033,Winkielman; Piotr,0,31,30,30
1683733059885,PSYC 131,A00,189036,Anagnostaras; Stephan,0,44,60,60
1683733060909,PSYC 136,A00,189041,Lowe; Angela Beth,0,7,25,25
1683733061933,PSYC 137,A00,189057,Winkielman; Piotr,0,36,25,25
1683733062962,PSYC 144,A00,189107,Wixted; John T,0,11,50,50
1683733065010,PSYC 162,A00,189142,Staff,0,9,85,85
1683733066038,PSYC 172,A00,189144,Gorman; Michael R.,0,6,30,30
1683733068093,PSYC 179,A00,189146,Lacefield; Katharine I,0,88,120,120
1683733069115,PSYC 181,A00,189147,Anagnostaras; Stephan,110,45,200,90
1683733070154,PSYC 190R,A00,189148,Barner; David A.,0,23,80,80
1683733071179,PSYC 191,A00,189275,Rickard; Timothy C.,0,11,25,25
1683733072203,PSYC 193,A00,189276,Chapman; Eddie Nathaniel,0,1,0,4
1683733073227,PSYC 193L,A01,189281,Lowe; Angela Beth,8,0,20,12
1683733073227,PSYC 193L,B01,189285,Staff,28,0,35,7
1683733074257,RELI 149,A00,187137,Rahimi; Babak,6,0,40,34
1683733075285,SE 9,A01,187315,Staff,0,2,18,18
1683733076313,SE 101B,A00,187409,Staff,24,0,30,6
1683733077338,SE 110B,A00,187444,Staff,10,0,40,30
1683733078367,SE 130B,A00,187449,Staff,31,0,40,9
1683733079393,SE 150A,A00,187516,Staff,8,0,20,12
1683733080420,SE 154,A00,187528,Staff,29,0,50,21
1683733081447,SIO 3,A01,258171,Staff,35,0,40,5
1683733082472,SIO 10,A00,187144,Cook; Geoffrey W,0,6,75,75
1683733083496,SIO 45,A00,187152,Cook; Geoffrey W,1,7,100,99
1683733084521,SIO 109R,A00,194486,Staff,0,4,20,20
1683733086580,SIO 187,A01,187233,Kacev; David,12,0,40,28
1683733087611,SOCI 1,A01,258656,Thorpe; Charles Robert,28,0,30,2
1683733087611,SOCI 1,A02,258658,Thorpe; Charles Robert,30,0,30,0
1683733087611,SOCI 1,A03,258661,Thorpe; Charles Robert,25,0,25,0
1683733087611,SOCI 1,A04,258666,Thorpe; Charles Robert,22,0,25,3
1683733087611,SOCI 1,A05,258897,Thorpe; Charles Robert,22,0,25,3
1683733087611,SOCI 1,A06,258898,Thorpe; Charles Robert,25,0,25,0
1683733088637,SOCI 30,A01,258903,Pardo Guerra; Juan Pablo,14,0,30,16
1683733089661,SOCI 102,A00,258904,Staff,9,0,25,16
1683733090689,SOCI 106,A00,258905,Staff,19,0,25,6
1683733091716,SOCI 111,A00,258907,Ribas Norris; Janet Vanesa,26,0,30,4
1683733092743,SOCI 121R,A00,258908,Pardo Guerra; Juan Pablo,7,0,30,23
1683733093767,SOCI 126,A01,203330,Staff,14,0,20,6
1683733094794,SOCI 131,A00,258909,Thorpe; Charles Robert,30,0,60,30
1683733095817,SOCI 135,A00,258910,Payne; Christine Anna,0,13,30,30
1683733096846,SOCI 157,A00,258911,Staff,10,0,30,20
1683733097872,SOCI 184,A00,258912,Staff,25,0,30,5
1683733098901,SOCI 188D,A00,258913,Staff,22,0,30,8
1683733099927,SYN 2,001,187529,Staff,9,0,16,7
1683733099927,SYN 2,002,201452,Staff,0,20,16,16
1683733099927,SYN 2,003,201469,Staff,1,0,16,15
1683733100955,SYN 100,A01,187531,Staff,0,9,20,20
1683733100955,SYN 100,B01,201491,Staff,0,10,20,20
1683733101983,TDAC 1,A00,189286,Walsh; Kim C.,3,0,20,17
1683733101983,TDAC 1,B00,189287,Harting; Carla Kelso,10,0,20,10
1683733103013,TDAC 101,A00,189300,Walsh; Kim C.,16,0,20,4
1683733103013,TDAC 101,B00,189301,Harting; Carla Kelso,18,0,20,2
1683733104040,TDAC 102,A00,189304,Basso; Beatrice,14,0,20,6
1683733105065,TDAC 108,A00,189305,Staff,18,0,20,2
1683733106094,TDDE 131,A00,189310,Staff,19,0,20,1
1683733106094,TDDE 131,B00,189314,Staff,19,0,20,1
1683733106094,TDDE 131,C00,189315,Staff,48,0,50,2
1683733106094,TDDE 131,D00,189316,Staff,14,0,15,1
1683733106094,TDDE 131,E00,204841,Staff,20,0,20,0
1683733107121,TDGE 10,A00,189289,Staff,26,0,50,24
1683733107121,TDGE 10,B00,189290,Havis; Allan,0,1,50,50
1683733108146,TDGE 11,A00,189291,Fulton; Julia,0,4,50,50
1683733108146,TDGE 11,B00,189292,Staff,20,0,25,5
1683733108146,TDGE 11,C00,260270,Staff,0,0,0,0
1683733109171,TDGE 25,A00,189294,Staff,1,0,20,19
1683733110198,TDGE 124,A00,189318,Fulton; Julia,0,7,50,50
1683733111225,TDGE 125,A00,189319,Staff,13,0,25,12
1683733111225,TDGE 125,B00,189320,Staff,23,0,25,2
1683733112251,TDGE 127,A00,189322,Havis; Allan,1,0,50,49
1683733113275,TDHT 101,A00,189323,Staff,18,0,25,7
1683733113275,TDHT 101,B00,189324,Staff,25,0,25,0
1683733114299,TDHT 102,A00,189325,Staff,49,0,50,1
1683733115326,TDMV 1,A00,189295,Arcidiacono; Kristin,20,0,30,10
1683733115326,TDMV 1,B00,189296,Caligagan; Maria T.,23,0,30,7
1683733116353,TDMV 2,A00,189297,Sammartano; Tonnie,27,0,30,3
1683733116353,TDMV 2,B00,189299,Arcidiacono; Kristin,23,0,30,7
1683733117379,TDMV 3,A00,204998,Rincon; Alicia,22,0,30,8
1683733118403,TDMV 120,A00,189458,Sammartano; Tonnie,28,0,30,2
1683733119429,TDMV 138,A00,189541,Jun; Grace Shin Hae,20,0,40,20
1683733120455,TDMV 142,A00,189717,Caligagan; Tony,25,0,30,5
1683733120455,TDMV 142,B00,189718,Caligagan; Maria T.,25,0,30,5
1683733121484,TMC 2,A01,187533,Staff,25,0,25,0
1683733121484,TMC 2,A02,187534,Staff,25,0,25,0
1683733122508,USP 1,A01,187536,Kwak; Nancy,0,16,25,25
1683733123535,USP 5,A01,187538,Staff,8,0,25,17
1683733124560,USP 101,A00,199253,Staff,0,4,0,0
1683733125597,USP 124,A00,187562,Boomhower; Matthew Charles,0,0,30,30
1683733126624,USP 138,A00,187582,Staff,19,0,25,6
1683733127652,USP 152,A01,187597,Staff,3,0,25,22
1683733128682,USP 153,A00,187598,Staff,18,0,25,7
1683733129711,USP 168,A00,187607,Kwak; Nancy,2,0,5,3
1683733130738,USP 173,A00,187619,Staff,4,0,25,21
1683733131763,USP 181,A00,187638,Staff,0,4,25,25
1683733132787,VIS 103,A00,187650,Cruz; Edwin Teddy,17,0,75,58
1683733133815,VIS 110D,A00,187669,Staff,13,0,22,9
1683733134842,VIS 127C,A00,187720,Shen; Kuiyi,67,0,146,79
1683733135867,VIS 149,A00,187731,Yoldas; Pinar,0,12,22,22
1683733136892,VIS 151,A01,188091,Staff,22,0,34,12
1683733136892,VIS 151,A02,188092,Staff,11,0,34,23
1683733137920,VIS 160B,A00,188093,Stalbaum; Brett,0,1,10,10
1683733140025,WCWP 10B,A00,201720,Staff,0,0,5,5
1683733140025,WCWP 10B,B00,201722,Staff,0,0,6,6
1683733141049,WCWP 100,A00,201725,Gagnon; Jeffrey C,0,0,2,2
1683733141049,WCWP 100,B00,201727,Staff,0,4,15,15
1683733144180,ANBI 133,A00,258401,Wilder; Linnea Lorene,34,0,40,6
1683733145212,ANBI 140,A00,258395,Hrvoj Mihic; Branka,18,0,25,7
1683733146236,ANSC 120,A00,258402,Bialecki; Jon Anthony,26,0,40,14
1683733147263,ANSC 144,A00,258400,Staff,12,0,40,28
1683733149315,ANSC 166,A00,258396,Parish; Steven Martin,156,0,175,19
1683733150340,ANSC 180,A00,193533,Staff,8,0,20,12
1683733151369,ANSC 188,A00,258397,Jassal; Aftab,34,0,40,6
1683733152397,ANTH 3,A01,258316,Staff,23,0,30,7
1683733153421,ANTH 5,A00,258394,Semendeferi; Ekaterini,16,0,20,4
1683733154449,ANTH 21,A01,258331,Staff,4,0,40,36
1683733155475,ANTH 103,A00,258398,Varma; Saiba,15,0,25,10
1683733156507,AWP 10,001,202034,Staff,0,0,0,0
1683733156507,AWP 10,002,202035,Staff,0,0,0,0
1683733156507,AWP 10,003,202036,Staff,0,0,0,0
1683733156507,AWP 10,004,202037,Staff,0,0,0,0
1683733156507,AWP 10,005,202038,Staff,0,0,0,0
1683733156507,AWP 10,006,202039,Staff,0,0,0,0
1683733156507,AWP 10,007,202040,Staff,0,0,0,0
1683733156507,AWP 10,008,202041,Staff,0,0,0,0
1683733156507,AWP 10,009,202042,Staff,0,0,0,0
1683733156507,AWP 10,010,202043,Staff,0,0,0,0
1683733156507,AWP 10,011,202044,Staff,0,0,0,0
1683733156507,AWP 10,012,202045,Staff,0,0,0,0
1683733156507,AWP 10,013,202046,Staff,0,0,0,0
1683733156507,AWP 10,014,202047,Staff,0,0,0,0
1683733156507,AWP 10,015,202048,Staff,0,0,0,0
1683733156507,AWP 10,016,202049,Staff,0,0,0,0
1683733156507,AWP 10,017,202050,Staff,0,0,0,0
1683733156507,AWP 10,018,202051,Staff,0,0,0,0
1683733156507,AWP 10,019,202052,Staff,0,0,0,0
1683733156507,AWP 10,020,202053,Staff,0,0,0,0
1683733156507,AWP 10,021,202054,Staff,0,0,0,0
1683733156507,AWP 10,022,202055,Staff,0,0,0,0
1683733156507,AWP 10,023,202056,Staff,0,0,0,0
1683733156507,AWP 10,024,202057,Staff,0,0,0,0
1683733156507,AWP 10,025,202058,Staff,0,0,0,0
1683733156507,AWP 10,026,202059,Staff,0,0,0,0
1683733157533,AWP 102,001,202032,Staff,0,0,0,0
1683733157533,AWP 102,002,202033,Staff,0,0,0,0
1683733158562,BENG 100,A01,254234,Taylor Amos; Alyssa C,31,0,40,9
1683733159603,BENG 196,001,270013,Engler; Adam J.,9999,0,9999,0
1683733160629,BICD 100R,A01,202018,Smith; Laurie,0,7,32,32
1683733160629,BICD 100R,A02,202019,Smith; Laurie,0,3,32,32
1683733160629,BICD 100R,A03,202020,Smith; Laurie,0,1,32,32
1683733160629,BICD 100R,A04,202021,Smith; Laurie,6,0,32,26
1683733160629,BICD 100R,A05,202022,Smith; Laurie,10,0,32,22
1683733161658,BICD 136,A01,193242,Gustafson-Brown; Cindy,0,2,32,32
1683733161658,BICD 136,A02,193244,Gustafson-Brown; Cindy,13,0,32,19
1683733162685,BIEB 102,A01,193249,Butler; Shannon Rhey,0,0,32,32
1683733162685,BIEB 102,A02,193251,Butler; Shannon Rhey,0,0,32,32
1683733162685,BIEB 102,A03,193253,Butler; Shannon Rhey,0,0,32,32
1683733162685,BIEB 102,A04,193255,Butler; Shannon Rhey,13,0,32,19
1683733162685,BIEB 102,A05,193265,Butler; Shannon Rhey,25,0,32,7
1683733162685,BIEB 102,A06,193269,Butler; Shannon Rhey,12,0,32,20
1683733164735,BIEB 150,A01,193274,Staff,0,0,32,32
1683733164735,BIEB 150,A02,193285,Staff,24,0,32,8
1683733165759,BIEB 194,A00,193286,Kurle; Carolyn M.,19,0,32,13
1683733166785,BILD 1,A01,192291,Staff,15,0,32,17
1683733166785,BILD 1,A02,192292,Staff,30,0,32,2
1683733166785,BILD 1,B01,192520,Reuther; Keefe,0,1,0,0
1683733166785,BILD 1,B02,192532,Reuther; Keefe,0,1,0,0
1683733167811,BILD 3,A01,192556,Butler; Shannon Rhey,0,0,32,32
1683733167811,BILD 3,A02,192581,Butler; Shannon Rhey,0,1,32,32
1683733167811,BILD 3,A03,192611,Butler; Shannon Rhey,19,0,32,13
1683733167811,BILD 3,A04,192612,Butler; Shannon Rhey,23,0,32,9
1683733167811,BILD 3,A05,192613,Butler; Shannon Rhey,26,0,32,6
1683733167811,BILD 3,A06,192679,Butler; Shannon Rhey,27,0,32,5
1683733167811,BILD 3,A07,192682,Butler; Shannon Rhey,20,0,32,12
1683733168840,BILD 4,A01,192836,Reuther; Keefe,1,0,24,23
1683733168840,BILD 4,A02,193044,Reuther; Keefe,4,0,24,20
1683733169865,BILD 10,A01,193142,Gustafson-Brown; Cindy,29,0,32,3
1683733169865,BILD 10,A02,193149,Gustafson-Brown; Cindy,31,0,32,1
1683733170896,BIMM 100,A01,193301,Staff,0,6,32,32
1683733170896,BIMM 100,A02,193312,Staff,0,7,32,32
1683733170896,BIMM 100,A03,193323,Staff,0,10,32,32
1683733171919,BIMM 101,A01,193329,McDonnell; Lisa Marie,0,3,24,24
1683733171919,BIMM 101,A02,193339,McDonnell; Lisa Marie,0,3,24,24
1683733171919,BIMM 101,B01,193354,McDonnell; Lisa Marie,0,4,24,24
1683733171919,BIMM 101,B02,193357,McDonnell; Lisa Marie,0,3,24,24
1683733172946,BIMM 110,A01,193377,Tat; John,0,11,32,32
1683733172946,BIMM 110,A02,193378,Tat; John,0,11,32,32
1683733173970,BIMM 120,A01,206116,Staff,1,0,32,31
1683733173970,BIMM 120,A02,206117,Staff,7,0,32,25
1683733173970,BIMM 120,A03,206121,Staff,21,0,32,11
1683733175002,BIPN 100,A01,193393,Park; Ji Young,0,15,32,32
1683733175002,BIPN 100,A02,193402,Park; Ji Young,0,14,32,32
1683733175002,BIPN 100,A03,193413,Park; Ji Young,0,14,32,32
1683733175002,BIPN 100,A04,193414,Park; Ji Young,0,13,32,32
1683733176030,BIPN 102,A01,193429,Staff,0,0,32,32
1683733176030,BIPN 102,A02,193438,Staff,18,0,32,14
1683733177055,BIPN 106,A01,193450,Reyes Gonzalez; Catalina,0,2,40,40
1683733178080,BIPN 134,A01,193465,Cooke; James Edward,0,0,32,32
1683733178080,BIPN 134,A02,193474,Cooke; James Edward,25,0,32,7
1683733178080,BIPN 134,A03,193485,Cooke; James Edward,29,0,32,3
1683733178080,BIPN 134,A04,193486,Cooke; James Edward,20,0,32,12
1683733178080,BIPN 134,A05,193491,Cooke; James Edward,31,0,32,1
1683733178080,BIPN 134,A06,193501,Cooke; James Edward,30,0,32,2
1683733178080,BIPN 134,A07,193510,Cooke; James Edward,29,0,32,3
1683733180133,BISP 194,A00,222522,Staff,14,0,32,18
1683733181157,CAT 124,A01,202407,Staff,19,0,25,6
1683733182185,CAT 125,A00,202408,Marchisotto; Jennifer Anne,2,0,20,18
1683733183213,CAT 125R,A00,202409,Smith; Lauryn Alissa,0,11,20,20
1683733183213,CAT 125R,B00,202410,Morales; Celeste Georgianna,0,11,20,20
1683733183213,CAT 125R,C00,202411,Irwin; Matthew Joseph,0,12,20,20
1683733184242,CENG 15,A01,204712,Yang; Kesong,0,1,0,0
1683733185267,CENG 114,A00,202070,Jahed Motlagh; Zeinab,5,0,20,15
1683733186291,CGS 105,A00,185477,Wesling; Megan E.,24,0,40,16
1683733187315,CGS 106,A00,185494,Staff,11,0,22,11
1683733188339,CGS 108,A00,185495,Staff,14,0,20,6
1683733189364,CGS 114,A00,185496,Staff,13,0,18,5
1683733190389,CGS 119,A00,185501,Staff,15,0,20,5
1683733191419,CGS 120,A00,185511,Staff,11,0,20,9
1683733192446,CHEM 4,A01,184675,Bussey; Thomas J,97,0,100,3
1683733193471,CHEM 6A,A01,184677,Staff,32,0,60,28
1683733194496,CHEM 6B,A01,184679,Staff,63,0,100,37
1683733195522,CHEM 6C,A01,184681,Bussey; Thomas J,0,0,50,50
1683733195522,CHEM 6C,A02,184682,Bussey; Thomas J,32,0,50,18
1683733196545,CHEM 40A,A01,184684,Albizati; Kim F.,33,0,100,67
1683733197567,CHEM 40B,A01,184686,Albizati; Kim F.,0,22,100,100
1683733198609,CHEM 41B,A01,184690,Staff,51,0,100,49
1683733199635,COGS 3,A01,184715,Boyle; Mary E. T.,0,27,40,40
1683733200659,COGS 14B,A01,185172,Staff,0,14,38,38
1683733201695,COGS 18,A01,184736,Staff,14,0,80,66
1683733202720,COGS 100,A01,184932,Staff,0,8,73,73
1683733203745,COGS 101A,A01,184935,Staff,0,40,30,30
1683733204770,COGS 101B,A01,184944,Staff,0,2,30,30
1683733205798,COGS 101C,A01,184946,Staff,0,10,30,30
1683733206820,COGS 102A,A01,184951,Johnson; Christine M.,1,0,40,39
1683733207846,COGS 107B,A01,184953,Mooshagian; Eric Frederick,0,52,40,40
1683733208873,COGS 118B,A01,184959,Gupta; Anjum,0,50,40,40
1683733209900,COGS 153,A00,184961,Staff,1,16,30,29
1683733210928,COGS 177,A00,184962,Staff,0,20,30,30
1683733211953,COGS 187A,A01,184969,Boyle; Mary E. T.,0,19,40,40
1683733212978,COMM 10,A01,185174,Staff,0,5,25,25
1683733212978,COMM 10,A02,185189,Staff,0,2,25,25
1683733212978,COMM 10,A03,269821,Staff,0,1,0,0
1683733214003,COMM 100B,A02,185476,Staff,10,0,25,15
1683733214003,COMM 100B,A03,277340,Staff,25,0,25,0
1683733215031,COMM 100C,A01,185314,Staff,2,0,25,23
1683733215031,COMM 100C,A02,185327,Staff,17,0,25,8
1683733216061,COMM 110M,A00,185349,Staff,0,0,40,40
1683733217090,COMM 113T,A00,185352,Staff,25,0,40,15
1683733218119,COMM 114I,A00,185353,Staff,31,0,40,9
1683733219142,COMM 131,A00,185354,Staff,17,0,30,13
1683733220166,CSE 8A,A50,185358,Cao; Yingjun,0,46,10,10
1683733221195,CSE 8B,A01,185362,Staff,0,48,50,50
1683733222219,CSE 11,A01,185416,Cao; Yingjun,0,91,10,10
1683733223244,CSE 20,A01,185445,Briones; Jor-el Thomas Caparas,3,0,25,22
1683733224268,CSE 21,A01,185447,Staff,9,0,50,41
1683733225295,CSE 101,A01,185451,Staff,0,13,50,50
1683733225295,CSE 101,B01,185453,Jones; Miles E,0,15,50,50
1683733227343,CSE 141,A01,185458,Eldon; John,16,0,100,84
1683733228367,CSE 141L,A01,185461,Eldon; John,8,0,100,92
1683733229394,CSE 142,A01,185463,Staff,34,0,60,26
1683733229394,CSE 142,B01,201355,Staff,0,7,60,60
1683733230419,CSE 142L,A01,185470,Staff,34,0,60,26
1683733230419,CSE 142L,B01,201417,Staff,0,6,60,60
1683733231442,CSE 190,A00,201433,Staff,32,0,49,17
1683733232466,DOC 1,A01,259136,Strom; Megan C.,7,0,15,8
1683733232466,DOC 1,A02,259137,Strom; Megan C.,15,0,15,0
1683733232466,DOC 1,A03,259138,Strom; Megan C.,14,0,15,1
1683733232466,DOC 1,A04,259139,Strom; Megan C.,13,0,15,2
1683733233495,DOC 100D,A00,259140,Pass; Natalye Joann,14,0,25,11
1683733234519,DSGN 1,A01,184749,Rill; Bryan,0,26,30,30
1683733235544,DSGN 100,A01,185168,Staff,0,2,25,25
1683733236568,ECE 5,A01,185626,Morris; Karcher William,0,12,0,0
1683733237605,ECE 101,A01,185628,Staff,14,0,70,56
1683733238630,ECE 107,A01,185635,Baghdadchi; Saharnaz,0,0,20,20
1683733238630,ECE 107,A02,185638,Baghdadchi; Saharnaz,1,0,20,19
1683733239657,ECE 148,A01,185647,Silberman; Jack,0,0,16,16
1683733240691,ECON 1,A01,185537,Crane; Meredith Helen,54,0,70,16
1683733241721,ECON 3,A01,185549,Crane; Meredith Helen,30,0,70,40
1683733242746,ECON 4,A01,203354,Anderson; John Charles,0,5,10,10
1683733243844,ECON 100A,A01,185574,Staff,0,5,40,40
1683733244871,ECON 100B,A01,185576,Staff,0,12,50,50
1683733245896,ECON 100C,A01,185589,Newhouse; Herbert S,30,0,70,40
1683733246930,ECON 105,A00,185608,Vespa; Emanuel Ignacio,19,0,35,16
1683733247953,ECON 109,A01,185610,Shishkin; Denis,9,0,35,26
1683733248979,ECON 110A,A01,185612,Staff,8,0,40,32
1683733250007,ECON 120A,A01,185615,Staff,19,0,40,21
1683733251039,ECON 120C,A01,185617,Sun; Yixiao,0,21,70,70
1683733252067,ECON 144,A00,203346,Squires; Dale E,2,0,35,33
1683733253093,ECON 171,A01,203349,Newhouse; Herbert S,0,1,35,35
1683733254117,ECON 173A,A01,185621,Toda; Alexis Akira,21,0,35,14
1683733255147,EDS 25,A01,202413,Staff,0,1,0,0
1683733255147,EDS 25,A02,202414,Staff,0,1,0,0
1683733255147,EDS 25,A03,202415,Staff,0,0,0,0
1683733255147,EDS 25,A04,202416,Staff,0,1,0,0
1683733255147,EDS 25,A05,202439,Staff,0,0,0,0
1683733255147,EDS 25,A06,202440,Staff,0,0,0,0
1683733255147,EDS 25,B01,202631,Staff,0,0,0,0
1683733255147,EDS 25,B02,202632,Staff,0,0,0,0
1683733255147,EDS 25,B03,202639,Staff,0,0,0,0
1683733255147,EDS 25,B04,202640,Staff,0,0,0,0
1683733255147,EDS 25,B05,202643,Staff,0,0,0,0
1683733255147,EDS 25,B06,202644,Staff,0,0,0,0
1683733256172,EDS 38,A01,202659,Black; Alison Michelle,25,0,25,0
1683733257197,EDS 115,A00,202652,Staff,18,0,30,12
1683733258221,EDS 125,A00,202649,Staff,13,0,30,17
1683733259246,EDS 126,A01,203332,Staff,30,0,30,0
1683733260271,EDS 139,A00,202838,Staff,16,0,25,9
1683733261310,EDS 146,A01,202655,Staff,14,0,25,11
1683733262343,ENG 15,A00,185667,Staff,0,1,0,2
1683733262343,ENG 15,B00,185672,Staff,0,0,0,1
1683733262343,ENG 15,C00,185675,Staff,0,0,0,0
1683733262343,ENG 15,D00,185682,Staff,0,0,0,0
1683733262343,ENG 15,E00,185684,Staff,0,0,0,0
1683733263370,ETHN 103,A00,185710,Staff,0,8,35,35
1683733264398,ETHN 103A,A00,199228,Man; Simeon S,0,0,9,9
1683733265422,ETHN 109,A00,185711,Staff,15,0,35,20
1683733266449,ETHN 142,A00,185726,Staff,0,4,30,30
1683733267474,ETHN 163J,A00,199229,Man; Simeon S,5,0,8,3
1683733268498,ETHN 168,A00,185727,Staff,7,0,10,3
1683733269522,ETHN 182,A00,185728,Staff,0,0,35,35
1683733270547,ETHN 183,A00,185737,Staff,10,0,18,8
1683733271575,GLBH 111,A01,209361,Burgos; Jose L.,0,0,0,0
1683733273631,HIEU 104,A00,185792,Staff,14,0,20,6
1683733274656,HIEU 115,A00,185800,Staff,0,0,20,20
1683733275684,HIEU 128,A00,185801,Staff,0,9,20,20
1683733276707,HIEU 147,A00,185802,Staff,15,0,20,5
1683733277732,HIEU 154,A00,185823,Staff,11,0,20,9
1683733278758,HILA 102,A00,185826,Staff,14,0,20,6
1683733279790,HILD 2C,A01,185778,Staff,0,13,20,20
1683733280818,HILD 7B,A01,185780,Kwak; Nancy,0,17,32,32
1683733280818,HILD 7B,A02,185781,Kwak; Nancy,0,18,32,32
1683733281843,HILD 30,A01,185791,Staff,12,0,20,8
1683733282867,HISC 119,A00,185830,Golan; Tal,0,10,20,20
1683733283893,HITO 156GS,A00,185831,Patterson; Patrick H.,0,0,0,23
1683733284922,HIUS 103,A00,185832,Man; Simeon S,0,4,20,20
1683733285949,HIUS 117,A00,185836,Kwak; Nancy,2,0,20,18
1683733286974,HIUS 125,A00,185840,Man; Simeon S,0,2,23,23
1683733287999,HIUS 149,A00,185845,Staff,1,0,20,19
1683733289027,HUM 3,A01,185882,Zavodny; Tatiana Sophia,0,8,50,50
1683733289027,HUM 3,B01,185899,Caldwell; Michael Alan,0,18,50,50
1683733290051,HUM 3GS,A00,185900,Patterson; Patrick H.,0,0,0,23
1683733291077,HUM 4,A01,185938,Zroka; Amy Liane,28,0,50,22
1683733291077,HUM 4,B01,185956,Watkins; Eric,0,6,50,50
1683733291077,HUM 4,B02,202209,Watkins; Eric,0,6,50,50
1683733291077,HUM 4,B03,202210,Watkins; Eric,0,5,50,50
1683733292103,HUM 5,A01,185958,West; Geoffrey Scott,0,0,50,50
1683733292103,HUM 5,A02,202215,West; Geoffrey Scott,0,1,50,50
1683733293131,INTL 190,A00,185959,Gagnon; Jeffrey C,0,0,0,9
1683733293131,INTL 190,B00,185960,Lettieri; Michael Joseph,0,0,0,2
1683733294159,JAPN 180,A00,254509,Staff,4,0,30,26
1683733295183,LATI 10,A01,202853,Kennemore; Amy Michelle,4,0,35,31
1683733295183,LATI 10,A02,202854,Kennemore; Amy Michelle,3,0,35,32
1683733295183,LATI 10,A03,270054,Kennemore; Amy Michelle,30,0,30,0
1683733296210,LATI 180,A00,202855,Kennemore; Amy Michelle,11,0,20,9
1683733297238,LAWS 101,A00,201767,Golan; Tal,0,7,40,40
1683733298265,LIFR 1C,A00,185961,Staff,6,0,20,14
1683733299291,LIFR 1CX,A00,185962,Staff,7,0,20,13
1683733300318,LIFR 1D,A00,185963,Staff,7,0,20,13
1683733301344,LIFR 1DX,A00,185964,Staff,7,0,20,13
1683733302371,LIGN 101,A01,186039,Staff,43,0,50,7
1683733303399,LIGN 165,A00,186040,Staff,14,0,50,36
1683733304425,LTCS 108,A00,186041,Staff,5,0,10,5
1683733305450,LTCS 119,A00,186042,Staff,15,0,20,5
1683733306477,LTCS 130,A00,186043,Wesling; Megan E.,15,0,25,10
1683733308531,LTEA 138,A00,186119,Staff,13,0,40,27
1683733309556,LTEN 124,A00,186148,Staff,5,0,25,20
1683733310579,LTEN 178,A00,186149,Staff,6,0,15,9
1683733311613,LTEN 181,A00,186150,Blanco; John D,34,0,40,6
1683733312642,LTWL 120,A00,186160,Staff,19,0,25,6
1683733313668,LTWL 165,A00,186161,Staff,22,0,25,3
1683733314692,LTWR 100,A00,186162,Staff,0,5,15,15
1683733315716,LTWR 102,A00,186163,Doller; Ben,5,0,15,10
1683733316744,MAE 8,A01,186412,Staff,0,1,0,1
1683733317769,MAE 30B,A00,186445,Bahadori; Mohammad Yousef,81,0,100,19
1683733318792,MAE 40,A00,186592,Bewley; Thomas R,10,0,50,40
1683733319820,MAE 101B,A00,186593,Bahadori; Mohammad Yousef,80,0,100,20
1683733320848,MAE 105,A00,186594,Bandaru; Prabhakar,10,0,50,40
1683733321872,MAE 107,A00,186599,Pham; Hieu Tan,0,8,120,120
1683733322897,MAE 148,A01,186660,Silberman; Jack,3,0,16,13
1683733323925,MATH 10A,A01,188095,Staff,0,6,35,35
1683733324951,MATH 10B,A01,188097,Bowers; Adam R.,0,12,30,30
1683733324951,MATH 10B,A02,188099,Bowers; Adam R.,0,11,30,30
1683733324951,MATH 10B,B01,188104,Bowers; Adam R.,0,10,30,30
1683733324951,MATH 10B,B02,188106,Bowers; Adam R.,0,9,30,30
1683733325980,MATH 10C,A01,188111,Staff,0,20,30,30
1683733325980,MATH 10C,A02,188127,Staff,0,19,30,30
1683733325980,MATH 10C,A03,188131,Staff,0,19,30,30
1683733325980,MATH 10C,B01,188218,Staff,17,0,30,13
1683733325980,MATH 10C,B02,188244,Staff,13,0,30,17
1683733325980,MATH 10C,B03,188277,Staff,14,0,30,16
1683733327007,MATH 18,A01,188344,Bach; Quang Tran,18,0,30,12
1683733327007,MATH 18,A02,188345,Bach; Quang Tran,11,0,30,19
1683733327007,MATH 18,B01,188353,Bach; Quang Tran,11,0,30,19
1683733327007,MATH 18,B02,188354,Bach; Quang Tran,19,0,30,11
1683733328033,MATH 20A,A01,188374,Staff,10,0,35,25
1683733329062,MATH 20B,A01,188382,Ohm; Ko Woon,7,0,30,23
1683733329062,MATH 20B,A02,188383,Ohm; Ko Woon,22,0,30,8
1683733329062,MATH 20B,B01,188385,Ohm; Ko Woon,7,0,30,23
1683733329062,MATH 20B,B02,188392,Ohm; Ko Woon,22,0,30,8
1683733330093,MATH 20C,A01,188394,Harel; Guershon,10,0,30,20
1683733330093,MATH 20C,A02,188395,Harel; Guershon,13,0,30,17
1683733330093,MATH 20C,B01,188404,Harel; Guershon,5,0,30,25
1683733330093,MATH 20C,B02,188405,Harel; Guershon,18,0,30,12
1683733331120,MATH 20D,A01,188414,Hammock; Frances H,0,1,30,30
1683733331120,MATH 20D,A02,188415,Hammock; Frances H,0,1,30,30
1683733331120,MATH 20D,B01,188447,Hammock; Frances H,0,1,30,30
1683733331120,MATH 20D,B02,188486,Hammock; Frances H,2,0,30,28
1683733332147,MATH 20E,A01,188649,Staff,21,0,30,9
1683733332147,MATH 20E,A02,188650,Staff,20,0,30,10
1683733332147,MATH 20E,A03,188673,Staff,0,0,30,30
1683733333171,MATH 102,A01,188675,Staff,0,40,35,35
1683733334201,MATH 103B,A01,188681,Staff,3,0,35,32
1683733334201,MATH 103B,B01,188692,Staff,5,0,35,30
1683733335228,MATH 109,A01,188695,Salehi Golsefidy; Alireza,24,0,35,11
1683733335228,MATH 109,A02,188696,Salehi Golsefidy; Alireza,24,0,35,11
1683733336257,MATH 120A,A01,188698,Eggers; John Dietrich,7,0,35,28
1683733337285,MATH 142B,A01,188736,Ioana; Adrian,0,0,30,30
1683733337285,MATH 142B,A02,188741,Ioana; Adrian,0,1,30,30
1683733337285,MATH 142B,A03,188743,Ioana; Adrian,0,3,30,30
1683733338309,MATH 168A,A01,188790,Staff,0,11,35,35
1683733339336,MATH 170A,A01,188803,Nie; Jiawang,0,2,35,35
1683733339336,MATH 170A,A02,188811,Nie; Jiawang,0,1,35,35
1683733339336,MATH 170A,A03,188814,Nie; Jiawang,1,0,35,34
1683733339336,MATH 170A,A04,188815,Nie; Jiawang,5,0,35,30
1683733340361,MATH 193B,A01,188817,Staff,0,0,35,35
1683733340361,MATH 193B,A02,188818,Staff,6,0,35,29
1683733341388,MGT 4,A01,202857,Anderson; John Charles,59,0,80,21
1683733342415,MGT 12,A00,202858,Lindenberger; Wade Douglas,40,0,90,50
1683733343441,MGT 18,A00,202859,Staff,73,0,90,17
1683733344465,MGT 18GS,A00,202860,McKay; Michael J,13,0,28,15
1683733345489,MGT 45,A00,202861,Pecore; Joseph P.,8,0,90,82
1683733346514,MGT 100,A00,202863,Yavorsky; Daniel Ryan,27,0,90,63
1683733347597,MGT 103,A00,202864,Ehrich; Kristine R,0,19,90,90
1683733348627,MGT 112,A00,202865,Ehrich; Kristine R,15,0,90,75
1683733349652,MGT 121A,A00,202868,Staff,70,0,90,20
1683733350677,MGT 131B,A00,202869,Anderson; John Charles,58,0,90,32
1683733351707,MGT 136,A00,202871,Lindenberger; Wade Douglas,83,0,90,7
1683733352731,MGT 164,A00,202873,Staff,0,67,90,91
1683733353758,MGT 164GS,A00,202874,McKay; Mary A,13,0,28,15
1683733354788,MGT 180,A00,202875,Staff,0,51,90,91
1683733355814,MMW 11R,A01,205019,Herbst; Matthew,0,0,30,30
1683733355814,MMW 11R,A02,205026,Herbst; Matthew,29,0,30,1
1683733356839,MMW 15,A01,193512,Chang; Edmond Yi-Teh,0,8,28,28
1683733356839,MMW 15,A02,193513,Chang; Edmond Yi-Teh,0,5,28,28
1683733356839,MMW 15,A03,193514,Chang; Edmond Yi-Teh,0,5,28,28
1683733356839,MMW 15,A04,193515,Chang; Edmond Yi-Teh,0,5,28,28
1683733356839,MMW 15,A05,193516,Chang; Edmond Yi-Teh,0,5,28,28
1683733356839,MMW 15,A06,193517,Chang; Edmond Yi-Teh,0,6,28,28
1683733356839,MMW 15,B01,193519,Chang; Edmond Yi-Teh,0,5,28,28
1683733356839,MMW 15,B02,193520,Chang; Edmond Yi-Teh,0,5,28,28
1683733356839,MMW 15,B03,193521,Chang; Edmond Yi-Teh,0,5,28,28
1683733356839,MMW 15,B04,193522,Chang; Edmond Yi-Teh,0,6,28,28
1683733356839,MMW 15,B05,193523,Chang; Edmond Yi-Teh,0,5,28,28
1683733356839,MMW 15,B06,193524,Chang; Edmond Yi-Teh,0,5,28,28
1683733357864,MMW 122,A01,193526,Rahimi; Babak,0,16,28,28
1683733357864,MMW 122,A02,193527,Rahimi; Babak,0,15,28,28
1683733357864,MMW 122,A03,193528,Rahimi; Babak,0,0,0,0
1683733357864,MMW 122,A04,193529,Rahimi; Babak,0,0,0,0
1683733358890,MUS 1A,A01,186663,Staff,0,18,35,35
1683733359918,MUS 4,A01,186715,Staff,0,12,35,35
1683733360943,MUS 5R,A01,186796,Dubnov; Shlomo,0,17,35,35
1683733361969,MUS 6,A01,186798,Staff,0,4,25,25
1683733362994,MUS 7,A01,186830,Staff,11,0,35,24
1683733364017,MUS 8,A01,186930,Staff,0,27,35,35
1683733365040,MUS 15,A01,186932,Staff,0,15,35,35
1683733365040,MUS 15,B01,186934,Staff,0,16,35,35
1683733366071,MUS 80,A00,186935,Staff,0,0,20,20
1683733366071,MUS 80,B00,186936,Staff,24,0,25,1
1683733367095,NANO 11,A00,204702,Lipomi; Darren John,0,0,0,0
1683733368121,NANO 15,A01,204709,Yang; Kesong,0,1,0,0
1683733369148,NANO 114,A00,202069,Jahed Motlagh; Zeinab,2,0,10,8
1683733370174,PHIL 1,A00,186955,Grush; Rick Scott,31,0,40,9
1683733371199,PHIL 10,A01,186973,Grush; Rick Scott,27,0,35,8
1683733371199,PHIL 10,A02,186974,Grush; Rick Scott,33,0,35,2
1683733372227,PHIL 13,A01,186976,Staff,1,0,35,34
1683733372227,PHIL 13,A02,186977,Staff,16,0,35,19
1683733373257,PHIL 14,A01,186979,Staff,30,0,35,5
1683733373257,PHIL 14,A02,186986,Staff,32,0,35,3
1683733374285,PHIL 28,A01,186988,Staff,16,0,30,14
1683733374285,PHIL 28,A02,186989,Staff,0,0,30,30
1683733374285,PHIL 28,A03,186990,Staff,10,0,30,20
1683733374285,PHIL 28,A04,186991,Staff,26,0,30,4
1683733375311,PHIL 120,A00,186997,Staff,23,0,40,17
1683733376336,PHIL 137,A00,187003,Staff,8,0,40,32
1683733377360,PHIL 150,A00,187015,Staff,47,0,70,23
1683733378386,PHIL 167,A00,187021,Lamey; Andy M.,34,0,40,6
1683733379415,PHIL 174,A01,202226,Staff,17,0,20,3
1683733379415,PHIL 174,A02,202235,Staff,20,0,20,0
1683733380442,PHIL 191A,A00,258918,Staff,0,0,1,1
1683733381467,PHYS 1A,A00,187028,Staff,26,0,60,34
1683733382494,PHYS 1AL,001,187036,Staff,3,0,30,27
1683733382494,PHYS 1AL,002,187049,Staff,18,0,30,12
1683733383519,PHYS 1B,A00,187058,Staff,21,0,60,39
1683733384550,PHYS 1BL,001,187064,Staff,0,1,30,30
1683733384550,PHYS 1BL,002,187070,Staff,4,0,30,26
1683733385574,PHYS 1C,A00,187082,Staff,30,0,120,90
1683733386599,PHYS 1CL,001,187088,Staff,0,9,30,30
1683733386599,PHYS 1CL,002,187089,Staff,0,1,30,30
1683733386599,PHYS 1CL,009,262693,Staff,9,0,30,21
1683733387622,PHYS 2B,A01,187097,Staff,55,0,115,60
1683733388649,PHYS 2C,A01,187099,Staff,63,0,115,52
1683733389677,PHYS 2CL,A01,187101,Staff,5,0,28,23
1683733389677,PHYS 2CL,A02,187102,Staff,15,0,28,13
1683733390727,PHYS 2D,A01,187123,Shotwell; Brian,95,0,115,20
1683733391753,PHYS 4B,A01,187133,Grinstein; Benjamin,35,0,50,15
1683733392779,POLI 10,A00,188819,Staff,0,4,50,50
1683733393806,POLI 11,A00,188827,Staff,43,0,50,7
1683733394831,POLI 13R,A00,188828,Staff,0,2,20,20
1683733395859,POLI 27,A01,188830,Elgin; Samuel Zincke,0,2,70,70
1683733396884,POLI 30,A00,188832,Desposato; Scott,30,0,50,20
1683733397911,POLI 102F,A00,188834,Staff,1,0,40,39
1683733398941,POLI 104A,A00,188852,Staff,12,0,30,18
1683733399968,POLI 104I,A00,188853,Staff,0,8,20,20
1683733400993,POLI 110B,A00,188854,Wiens; David,6,0,20,14
1683733402021,POLI 112A,A00,188855,Wiens; David,3,0,30,27
1683733403049,POLI 117R,A00,188856,Forman; Fonna,0,12,20,20
1683733404074,POLI 118,A00,188857,Ingham; Sean,8,0,20,12
1683733405098,POLI 120G,A00,188858,Staff,7,0,30,23
1683733406125,POLI 131CR,A00,188863,Hoston; Germaine,20,0,50,30
1683733407151,POLI 133,A00,188864,Nellis; Gareth Hb,44,0,50,6
1683733408178,POLI 134D,A00,188865,Desposato; Scott,27,0,30,3
1683733409202,POLI 142A,A00,188871,Gartzke; Erik,21,0,50,29
1683733410231,POLI 142K,A00,188874,Staff,38,0,50,12
1683733411255,POLI 143,A00,188940,Gartzke; Erik,15,0,30,15
1683733412280,POLI 153,A00,188943,Staff,1,0,20,19
1683733413306,POLI 160AA,A00,188944,Staff,10,0,40,30
1683733414331,POLI 170A,A00,188945,Staff,10,0,30,20
1683733416383,PSYC 1,A00,188952,Staff,36,0,90,54
1683733417409,PSYC 2,B00,188953,Staff,19,0,35,16
1683733418433,PSYC 6,A00,188970,Staff,47,0,60,13
1683733419457,PSYC 7,A00,188973,Staff,35,0,45,10
1683733420481,PSYC 60,A01,188980,Rickard; Timothy C.,42,0,60,18
1683733421505,PSYC 70,A01,189001,Steiner; Eric Tomas,21,0,45,24
1683733422529,PSYC 100,A00,189005,Lacefield; Katharine I,1,98,120,119
1683733423555,PSYC 102,A00,189008,Staff,6,0,30,24
1683733424587,PSYC 106,B00,189026,Gorman; Michael R.,26,0,60,34
1683733425623,PSYC 114,B01,189033,Winkielman; Piotr,0,31,30,30
1683733426648,PSYC 131,A00,189036,Anagnostaras; Stephan,0,44,60,60
1683733427673,PSYC 136,A00,189041,Lowe; Angela Beth,0,7,25,25
1683733428703,PSYC 137,A00,189057,Winkielman; Piotr,0,36,25,25
1683733429731,PSYC 144,A00,189107,Wixted; John T,0,11,50,50
1683733431784,PSYC 162,A00,189142,Staff,0,9,85,85
1683733432811,PSYC 172,A00,189144,Gorman; Michael R.,0,6,30,30
1683733434863,PSYC 179,A00,189146,Lacefield; Katharine I,0,88,120,120
1683733435892,PSYC 181,A00,189147,Anagnostaras; Stephan,110,45,200,90
1683733436919,PSYC 190R,A00,189148,Barner; David A.,0,23,80,80
1683733437945,PSYC 191,A00,189275,Rickard; Timothy C.,0,11,25,25
1683733438970,PSYC 193,A00,189276,Chapman; Eddie Nathaniel,0,1,0,4
1683733439995,PSYC 193L,A01,189281,Lowe; Angela Beth,8,0,20,12
1683733439995,PSYC 193L,B01,189285,Staff,28,0,35,7
1683733441021,RELI 149,A00,187137,Rahimi; Babak,6,0,40,34
1683733442049,SE 9,A01,187315,Staff,0,2,18,18
1683733443075,SE 101B,A00,187409,Staff,24,0,30,6
1683733444102,SE 110B,A00,187444,Staff,10,0,40,30
1683733445129,SE 130B,A00,187449,Staff,31,0,40,9
1683733446153,SE 150A,A00,187516,Staff,8,0,20,12
1683733447178,SE 154,A00,187528,Staff,29,0,50,21
1683733448202,SIO 3,A01,258171,Staff,35,0,40,5
1683733449232,SIO 10,A00,187144,Cook; Geoffrey W,0,6,75,75
1683733450256,SIO 45,A00,187152,Cook; Geoffrey W,1,7,100,99
1683733451341,SIO 109R,A00,194486,Staff,0,4,20,20
1683733453390,SIO 187,A01,187233,Kacev; David,12,0,40,28
1683733454420,SOCI 1,A01,258656,Thorpe; Charles Robert,28,0,30,2
1683733454420,SOCI 1,A02,258658,Thorpe; Charles Robert,30,0,30,0
1683733454420,SOCI 1,A03,258661,Thorpe; Charles Robert,25,0,25,0
1683733454420,SOCI 1,A04,258666,Thorpe; Charles Robert,22,0,25,3
1683733454420,SOCI 1,A05,258897,Thorpe; Charles Robert,22,0,25,3
1683733454420,SOCI 1,A06,258898,Thorpe; Charles Robert,25,0,25,0
1683733455444,SOCI 30,A01,258903,Pardo Guerra; Juan Pablo,14,0,30,16
1683733456467,SOCI 102,A00,258904,Staff,9,0,25,16
1683733457498,SOCI 106,A00,258905,Staff,19,0,25,6
1683733458524,SOCI 111,A00,258907,Ribas Norris; Janet Vanesa,26,0,30,4
1683733459553,SOCI 121R,A00,258908,Pardo Guerra; Juan Pablo,7,0,30,23
1683733460626,SOCI 126,A01,203330,Staff,14,0,20,6
1683733461653,SOCI 131,A00,258909,Thorpe; Charles Robert,30,0,60,30
1683733462678,SOCI 135,A00,258910,Payne; Christine Anna,0,13,30,30
1683733463703,SOCI 157,A00,258911,Staff,10,0,30,20
1683733464733,SOCI 184,A00,258912,Staff,25,0,30,5
1683733465760,SOCI 188D,A00,258913,Staff,22,0,30,8
1683733466788,SYN 2,001,187529,Staff,9,0,16,7
1683733466788,SYN 2,002,201452,Staff,0,20,16,16
1683733466788,SYN 2,003,201469,Staff,1,0,16,15
1683733467812,SYN 100,A01,187531,Staff,0,9,20,20
1683733467812,SYN 100,B01,201491,Staff,0,10,20,20
1683733468838,TDAC 1,A00,189286,Walsh; Kim C.,3,0,20,17
1683733468838,TDAC 1,B00,189287,Harting; Carla Kelso,10,0,20,10
1683733469862,TDAC 101,A00,189300,Walsh; Kim C.,16,0,20,4
1683733469862,TDAC 101,B00,189301,Harting; Carla Kelso,18,0,20,2
1683733470887,TDAC 102,A00,189304,Basso; Beatrice,14,0,20,6
1683733471912,TDAC 108,A00,189305,Staff,18,0,20,2
1683733472945,TDDE 131,A00,189310,Staff,19,0,20,1
1683733472945,TDDE 131,B00,189314,Staff,19,0,20,1
1683733472945,TDDE 131,C00,189315,Staff,48,0,50,2
1683733472945,TDDE 131,D00,189316,Staff,14,0,15,1
1683733472945,TDDE 131,E00,204841,Staff,20,0,20,0
1683733473973,TDGE 10,A00,189289,Staff,26,0,50,24
1683733473973,TDGE 10,B00,189290,Havis; Allan,0,1,50,50
1683733475003,TDGE 11,A00,189291,Fulton; Julia,0,4,50,50
1683733475003,TDGE 11,B00,189292,Staff,20,0,25,5
1683733475003,TDGE 11,C00,260270,Staff,0,0,0,0
1683733476031,TDGE 25,A00,189294,Staff,1,0,20,19
1683733477057,TDGE 124,A00,189318,Fulton; Julia,0,7,50,50
1683733478083,TDGE 125,A00,189319,Staff,13,0,25,12
1683733478083,TDGE 125,B00,189320,Staff,23,0,25,2
1683733479108,TDGE 127,A00,189322,Havis; Allan,1,0,50,49
1683733480137,TDHT 101,A00,189323,Staff,18,0,25,7
1683733480137,TDHT 101,B00,189324,Staff,25,0,25,0
1683733481162,TDHT 102,A00,189325,Staff,49,0,50,1
1683733482190,TDMV 1,A00,189295,Arcidiacono; Kristin,20,0,30,10
1683733482190,TDMV 1,B00,189296,Caligagan; Maria T.,23,0,30,7
1683733483216,TDMV 2,A00,189297,Sammartano; Tonnie,27,0,30,3
1683733483216,TDMV 2,B00,189299,Arcidiacono; Kristin,23,0,30,7
1683733492871,TDMV 3,A00,204998,Rincon; Alicia,22,0,30,8
1683733493900,TDMV 120,A00,189458,Sammartano; Tonnie,28,0,30,2
1683733494925,TDMV 138,A00,189541,Jun; Grace Shin Hae,20,0,40,20
1683733495954,TDMV 142,A00,189717,Caligagan; Tony,25,0,30,5
1683733495954,TDMV 142,B00,189718,Caligagan; Maria T.,25,0,30,5
1683733496978,TMC 2,A01,187533,Staff,25,0,25,0
1683733496978,TMC 2,A02,187534,Staff,25,0,25,0
1683733498004,USP 1,A01,187536,Kwak; Nancy,0,16,25,25
1683733499032,USP 5,A01,187538,Staff,8,0,25,17
1683733500062,USP 101,A00,199253,Staff,0,4,0,0
1683733501090,USP 124,A00,187562,Boomhower; Matthew Charles,0,0,30,30
1683733502115,USP 138,A00,187582,Staff,19,0,25,6
1683733503142,USP 152,A01,187597,Staff,3,0,25,22
1683733504170,USP 153,A00,187598,Staff,18,0,25,7
1683733505198,USP 168,A00,187607,Kwak; Nancy,2,0,5,3
1683733506223,USP 173,A00,187619,Staff,4,0,25,21
1683733507245,USP 181,A00,187638,Staff,0,4,25,25
1683733508272,VIS 103,A00,187650,Cruz; Edwin Teddy,17,0,75,58
1683733509299,VIS 110D,A00,187669,Staff,13,0,22,9
1683733510324,VIS 127C,A00,187720,Shen; Kuiyi,67,0,146,79
1683733511349,VIS 149,A00,187731,Yoldas; Pinar,0,12,22,22
1683733512375,VIS 151,A01,188091,Staff,22,0,34,12
1683733512375,VIS 151,A02,188092,Staff,11,0,34,23
1683733513399,VIS 160B,A00,188093,Stalbaum; Brett,0,1,10,10
1683733515451,WCWP 10B,A00,201720,Staff,0,0,5,5
1683733515451,WCWP 10B,B00,201722,Staff,0,0,6,6
1683733516479,WCWP 100,A00,201725,Gagnon; Jeffrey C,0,0,2,2
1683733516479,WCWP 100,B00,201727,Staff,0,4,15,15
1683733519623,ANBI 133,A00,258401,Wilder; Linnea Lorene,34,0,40,6
1683733520649,ANBI 140,A00,258395,Hrvoj Mihic; Branka,18,0,25,7
1683733521680,ANSC 120,A00,258402,Bialecki; Jon Anthony,26,0,40,14
1683733522709,ANSC 144,A00,258400,Staff,12,0,40,28
1683733524761,ANSC 166,A00,258396,Parish; Steven Martin,156,0,175,19
1683733525786,ANSC 180,A00,193533,Staff,8,0,20,12
1683733526815,ANSC 188,A00,258397,Jassal; Aftab,34,0,40,6
1683733527843,ANTH 3,A01,258316,Staff,23,0,30,7
1683733528868,ANTH 5,A00,258394,Semendeferi; Ekaterini,16,0,20,4
1683733529893,ANTH 21,A01,258331,Staff,4,0,40,36
1683733530921,ANTH 103,A00,258398,Varma; Saiba,15,0,25,10
1683733531954,AWP 10,001,202034,Staff,0,0,0,0
1683733531954,AWP 10,002,202035,Staff,0,0,0,0
1683733531954,AWP 10,003,202036,Staff,0,0,0,0
1683733531954,AWP 10,004,202037,Staff,0,0,0,0
1683733531954,AWP 10,005,202038,Staff,0,0,0,0
1683733531954,AWP 10,006,202039,Staff,0,0,0,0
1683733531954,AWP 10,007,202040,Staff,0,0,0,0
1683733531954,AWP 10,008,202041,Staff,0,0,0,0
1683733531954,AWP 10,009,202042,Staff,0,0,0,0
1683733531954,AWP 10,010,202043,Staff,0,0,0,0
1683733531954,AWP 10,011,202044,Staff,0,0,0,0
1683733531954,AWP 10,012,202045,Staff,0,0,0,0
1683733531954,AWP 10,013,202046,Staff,0,0,0,0
1683733531954,AWP 10,014,202047,Staff,0,0,0,0
1683733531954,AWP 10,015,202048,Staff,0,0,0,0
1683733531954,AWP 10,016,202049,Staff,0,0,0,0
1683733531954,AWP 10,017,202050,Staff,0,0,0,0
1683733531954,AWP 10,018,202051,Staff,0,0,0,0
1683733531954,AWP 10,019,202052,Staff,0,0,0,0
1683733531954,AWP 10,020,202053,Staff,0,0,0,0
1683733531954,AWP 10,021,202054,Staff,0,0,0,0
1683733531954,AWP 10,022,202055,Staff,0,0,0,0
1683733531954,AWP 10,023,202056,Staff,0,0,0,0
1683733531954,AWP 10,024,202057,Staff,0,0,0,0
1683733531954,AWP 10,025,202058,Staff,0,0,0,0
1683733531954,AWP 10,026,202059,Staff,0,0,0,0
1683733532978,AWP 102,001,202032,Staff,0,0,0,0
1683733532978,AWP 102,002,202033,Staff,0,0,0,0
1683733534005,BENG 100,A01,254234,Taylor Amos; Alyssa C,31,0,40,9
1683733535029,BENG 196,001,270013,Engler; Adam J.,9999,0,9999,0
1683733536054,BICD 100R,A01,202018,Smith; Laurie,0,7,32,32
1683733536054,BICD 100R,A02,202019,Smith; Laurie,0,3,32,32
1683733536054,BICD 100R,A03,202020,Smith; Laurie,0,1,32,32
1683733536054,BICD 100R,A04,202021,Smith; Laurie,6,0,32,26
1683733536054,BICD 100R,A05,202022,Smith; Laurie,10,0,32,22
1683733537082,BICD 136,A01,193242,Gustafson-Brown; Cindy,0,2,32,32
1683733537082,BICD 136,A02,193244,Gustafson-Brown; Cindy,13,0,32,19
1683733538121,BIEB 102,A01,193249,Butler; Shannon Rhey,0,0,32,32
1683733538121,BIEB 102,A02,193251,Butler; Shannon Rhey,0,0,32,32
1683733538121,BIEB 102,A03,193253,Butler; Shannon Rhey,0,0,32,32
1683733538121,BIEB 102,A04,193255,Butler; Shannon Rhey,13,0,32,19
1683733538121,BIEB 102,A05,193265,Butler; Shannon Rhey,25,0,32,7
1683733538121,BIEB 102,A06,193269,Butler; Shannon Rhey,12,0,32,20
1683733540174,BIEB 150,A01,193274,Staff,0,0,32,32
1683733540174,BIEB 150,A02,193285,Staff,24,0,32,8
1683733541198,BIEB 194,A00,193286,Kurle; Carolyn M.,19,0,32,13
1683733542222,BILD 1,A01,192291,Staff,15,0,32,17
1683733542222,BILD 1,A02,192292,Staff,30,0,32,2
1683733542222,BILD 1,B01,192520,Reuther; Keefe,0,1,0,0
1683733542222,BILD 1,B02,192532,Reuther; Keefe,0,1,0,0
1683733543248,BILD 3,A01,192556,Butler; Shannon Rhey,0,0,32,32
1683733543248,BILD 3,A02,192581,Butler; Shannon Rhey,0,1,32,32
1683733543248,BILD 3,A03,192611,Butler; Shannon Rhey,19,0,32,13
1683733543248,BILD 3,A04,192612,Butler; Shannon Rhey,23,0,32,9
1683733543248,BILD 3,A05,192613,Butler; Shannon Rhey,26,0,32,6
1683733543248,BILD 3,A06,192679,Butler; Shannon Rhey,27,0,32,5
1683733543248,BILD 3,A07,192682,Butler; Shannon Rhey,20,0,32,12
1683733544272,BILD 4,A01,192836,Reuther; Keefe,1,0,24,23
1683733544272,BILD 4,A02,193044,Reuther; Keefe,4,0,24,20
1683733545296,BILD 10,A01,193142,Gustafson-Brown; Cindy,29,0,32,3
1683733545296,BILD 10,A02,193149,Gustafson-Brown; Cindy,31,0,32,1
1683733546321,BIMM 100,A01,193301,Staff,0,6,32,32
1683733546321,BIMM 100,A02,193312,Staff,0,7,32,32
1683733546321,BIMM 100,A03,193323,Staff,0,10,32,32
1683733547346,BIMM 101,A01,193329,McDonnell; Lisa Marie,0,3,24,24
1683733547346,BIMM 101,A02,193339,McDonnell; Lisa Marie,0,3,24,24
1683733547346,BIMM 101,B01,193354,McDonnell; Lisa Marie,0,4,24,24
1683733547346,BIMM 101,B02,193357,McDonnell; Lisa Marie,0,3,24,24
1683733548374,BIMM 110,A01,193377,Tat; John,0,11,32,32
1683733548374,BIMM 110,A02,193378,Tat; John,0,11,32,32
1683733549402,BIMM 120,A01,206116,Staff,1,0,32,31
1683733549402,BIMM 120,A02,206117,Staff,7,0,32,25
1683733549402,BIMM 120,A03,206121,Staff,21,0,32,11
1683733550431,BIPN 100,A01,193393,Park; Ji Young,0,15,32,32
1683733550431,BIPN 100,A02,193402,Park; Ji Young,0,14,32,32
1683733550431,BIPN 100,A03,193413,Park; Ji Young,0,14,32,32
1683733550431,BIPN 100,A04,193414,Park; Ji Young,0,13,32,32
1683733551456,BIPN 102,A01,193429,Staff,0,0,32,32
1683733551456,BIPN 102,A02,193438,Staff,18,0,32,14
1683733552481,BIPN 106,A01,193450,Reyes Gonzalez; Catalina,0,2,40,40
1683733553507,BIPN 134,A01,193465,Cooke; James Edward,0,0,32,32
1683733553507,BIPN 134,A02,193474,Cooke; James Edward,25,0,32,7
1683733553507,BIPN 134,A03,193485,Cooke; James Edward,29,0,32,3
1683733553507,BIPN 134,A04,193486,Cooke; James Edward,20,0,32,12
1683733553507,BIPN 134,A05,193491,Cooke; James Edward,31,0,32,1
1683733553507,BIPN 134,A06,193501,Cooke; James Edward,30,0,32,2
1683733553507,BIPN 134,A07,193510,Cooke; James Edward,29,0,32,3
1683733555559,BISP 194,A00,222522,Staff,14,0,32,18
1683733556587,CAT 124,A01,202407,Staff,19,0,25,6
1683733557614,CAT 125,A00,202408,Marchisotto; Jennifer Anne,2,0,20,18
1683733558643,CAT 125R,A00,202409,Smith; Lauryn Alissa,0,11,20,20
1683733558643,CAT 125R,B00,202410,Morales; Celeste Georgianna,0,11,20,20
1683733558643,CAT 125R,C00,202411,Irwin; Matthew Joseph,0,12,20,20
1683733559669,CENG 15,A01,204712,Yang; Kesong,0,1,0,0
1683733560694,CENG 114,A00,202070,Jahed Motlagh; Zeinab,5,0,20,15
1683733561721,CGS 105,A00,185477,Wesling; Megan E.,24,0,40,16
1683733562749,CGS 106,A00,185494,Staff,11,0,22,11
1683733563846,CGS 108,A00,185495,Staff,14,0,20,6
1683733564870,CGS 114,A00,185496,Staff,13,0,18,5
1683733565894,CGS 119,A00,185501,Staff,15,0,20,5
1683733566920,CGS 120,A00,185511,Staff,11,0,20,9
1683733567949,CHEM 4,A01,184675,Bussey; Thomas J,97,0,100,3
1683733568976,CHEM 6A,A01,184677,Staff,32,0,60,28
1683733570001,CHEM 6B,A01,184679,Staff,63,0,100,37
1683733571029,CHEM 6C,A01,184681,Bussey; Thomas J,0,0,50,50
1683733571029,CHEM 6C,A02,184682,Bussey; Thomas J,32,0,50,18
1683733572053,CHEM 40A,A01,184684,Albizati; Kim F.,33,0,100,67
1683733573081,CHEM 40B,A01,184686,Albizati; Kim F.,0,22,100,100
1683733574106,CHEM 41B,A01,184690,Staff,51,0,100,49
1683733575131,COGS 3,A01,184715,Boyle; Mary E. T.,0,27,40,40
1683733576153,COGS 14B,A01,185172,Staff,0,14,38,38
1683733577180,COGS 18,A01,184736,Staff,14,0,80,66
1683733578205,COGS 100,A01,184932,Staff,0,8,73,73
1683733579228,COGS 101A,A01,184935,Staff,0,40,30,30
1683733580253,COGS 101B,A01,184944,Staff,0,2,30,30
1683733581279,COGS 101C,A01,184946,Staff,0,10,30,30
1683733582303,COGS 102A,A01,184951,Johnson; Christine M.,1,0,40,39
1683733583331,COGS 107B,A01,184953,Mooshagian; Eric Frederick,0,52,40,40
1683733584356,COGS 118B,A01,184959,Gupta; Anjum,0,50,40,40
1683733585384,COGS 153,A00,184961,Staff,1,16,30,29
1683733586412,COGS 177,A00,184962,Staff,0,20,30,30
1683733587440,COGS 187A,A01,184969,Boyle; Mary E. T.,0,19,40,40
1683733588465,COMM 10,A01,185174,Staff,0,5,25,25
1683733588465,COMM 10,A02,185189,Staff,0,2,25,25
1683733588465,COMM 10,A03,269821,Staff,0,1,0,0
1683733589494,COMM 100B,A02,185476,Staff,10,0,25,15
1683733589494,COMM 100B,A03,277340,Staff,25,0,25,0
1683733590521,COMM 100C,A01,185314,Staff,2,0,25,23
1683733590521,COMM 100C,A02,185327,Staff,17,0,25,8
1683733591546,COMM 110M,A00,185349,Staff,0,0,40,40
1683733592576,COMM 113T,A00,185352,Staff,25,0,40,15
1683733593600,COMM 114I,A00,185353,Staff,31,0,40,9
1683733594631,COMM 131,A00,185354,Staff,17,0,30,13
1683733595655,CSE 8A,A50,185358,Cao; Yingjun,0,46,10,10
1683733596682,CSE 8B,A01,185362,Staff,0,48,50,50
1683733597708,CSE 11,A01,185416,Cao; Yingjun,0,91,10,10
1683733598737,CSE 20,A01,185445,Briones; Jor-el Thomas Caparas,3,0,25,22
1683733599763,CSE 21,A01,185447,Staff,9,0,50,41
1683733600793,CSE 101,A01,185451,Staff,0,13,50,50
1683733600793,CSE 101,B01,185453,Jones; Miles E,0,15,50,50
1683733602848,CSE 141,A01,185458,Eldon; John,16,0,100,84
1683733603873,CSE 141L,A01,185461,Eldon; John,8,0,100,92
1683733604898,CSE 142,A01,185463,Staff,34,0,60,26
1683733604898,CSE 142,B01,201355,Staff,0,7,60,60
1683733605924,CSE 142L,A01,185470,Staff,34,0,60,26
1683733605924,CSE 142L,B01,201417,Staff,0,6,60,60
1683733606949,CSE 190,A00,201433,Staff,32,0,49,17
1683733607975,DOC 1,A01,259136,Strom; Megan C.,7,0,15,8
1683733607975,DOC 1,A02,259137,Strom; Megan C.,15,0,15,0
1683733607975,DOC 1,A03,259138,Strom; Megan C.,14,0,15,1
1683733607975,DOC 1,A04,259139,Strom; Megan C.,13,0,15,2
1683733609002,DOC 100D,A00,259140,Pass; Natalye Joann,14,0,25,11
1683733610031,DSGN 1,A01,184749,Rill; Bryan,0,26,30,30
1683733611056,DSGN 100,A01,185168,Staff,0,2,25,25
1683733612078,ECE 5,A01,185626,Morris; Karcher William,0,12,0,0
1683733613102,ECE 101,A01,185628,Staff,14,0,70,56
1683733614127,ECE 107,A01,185635,Baghdadchi; Saharnaz,0,0,20,20
1683733614127,ECE 107,A02,185638,Baghdadchi; Saharnaz,1,0,20,19
1683733615150,ECE 148,A01,185647,Silberman; Jack,0,0,16,16
1683733616175,ECON 1,A01,185537,Crane; Meredith Helen,54,0,70,16
1683733617200,ECON 3,A01,185549,Crane; Meredith Helen,30,0,70,40
1683733618221,ECON 4,A01,203354,Anderson; John Charles,0,5,10,10
1683733619249,ECON 100A,A01,185574,Staff,0,5,40,40
1683733620274,ECON 100B,A01,185576,Staff,0,12,50,50
1683733621298,ECON 100C,A01,185589,Newhouse; Herbert S,30,0,70,40
1683733622325,ECON 105,A00,185608,Vespa; Emanuel Ignacio,19,0,35,16
1683733623349,ECON 109,A01,185610,Shishkin; Denis,9,0,35,26
1683733624378,ECON 110A,A01,185612,Staff,8,0,40,32
1683733625401,ECON 120A,A01,185615,Staff,19,0,40,21
1683733626426,ECON 120C,A01,185617,Sun; Yixiao,0,21,70,70
1683733627451,ECON 144,A00,203346,Squires; Dale E,2,0,35,33
1683733628476,ECON 171,A01,203349,Newhouse; Herbert S,0,1,35,35
1683733629506,ECON 173A,A01,185621,Toda; Alexis Akira,21,0,35,14
1683733630531,EDS 25,A01,202413,Staff,0,1,0,0
1683733630531,EDS 25,A02,202414,Staff,0,1,0,0
1683733630531,EDS 25,A03,202415,Staff,0,0,0,0
1683733630531,EDS 25,A04,202416,Staff,0,1,0,0
1683733630531,EDS 25,A05,202439,Staff,0,0,0,0
1683733630531,EDS 25,A06,202440,Staff,0,0,0,0
1683733630531,EDS 25,B01,202631,Staff,0,0,0,0
1683733630531,EDS 25,B02,202632,Staff,0,0,0,0
1683733630531,EDS 25,B03,202639,Staff,0,0,0,0
1683733630531,EDS 25,B04,202640,Staff,0,0,0,0
1683733630531,EDS 25,B05,202643,Staff,0,0,0,0
1683733630531,EDS 25,B06,202644,Staff,0,0,0,0
1683733631557,EDS 38,A01,202659,Black; Alison Michelle,25,0,25,0
1683733632581,EDS 115,A00,202652,Staff,18,0,30,12
1683733633609,EDS 125,A00,202649,Staff,13,0,30,17
1683733634642,EDS 126,A01,203332,Staff,30,0,30,0
1683733635667,EDS 139,A00,202838,Staff,16,0,25,9
1683733636691,EDS 146,A01,202655,Staff,14,0,25,11
1683733637717,ENG 15,A00,185667,Staff,0,1,0,2
1683733637717,ENG 15,B00,185672,Staff,0,0,0,1
1683733637717,ENG 15,C00,185675,Staff,0,0,0,0
1683733637717,ENG 15,D00,185682,Staff,0,0,0,0
1683733637717,ENG 15,E00,185684,Staff,0,0,0,0
1683733638742,ETHN 103,A00,185710,Staff,0,8,35,35
1683733639771,ETHN 103A,A00,199228,Man; Simeon S,0,0,9,9
1683733640801,ETHN 109,A00,185711,Staff,15,0,35,20
1683733641830,ETHN 142,A00,185726,Staff,0,4,30,30
1683733642855,ETHN 163J,A00,199229,Man; Simeon S,5,0,8,3
1683733643885,ETHN 168,A00,185727,Staff,7,0,10,3
1683733644910,ETHN 182,A00,185728,Staff,0,0,35,35
1683733645938,ETHN 183,A00,185737,Staff,10,0,18,8
1683733646969,GLBH 111,A01,209361,Burgos; Jose L.,0,0,0,0
1683733649023,HIEU 104,A00,185792,Staff,14,0,20,6
1683733650047,HIEU 115,A00,185800,Staff,0,0,20,20
1683733651072,HIEU 128,A00,185801,Staff,0,9,20,20
1683733652098,HIEU 147,A00,185802,Staff,15,0,20,5
1683733653126,HIEU 154,A00,185823,Staff,11,0,20,9
1683733654153,HILA 102,A00,185826,Staff,14,0,20,6
1683733655179,HILD 2C,A01,185778,Staff,0,13,20,20
1683733656206,HILD 7B,A01,185780,Kwak; Nancy,0,17,32,32
1683733656206,HILD 7B,A02,185781,Kwak; Nancy,0,18,32,32
1683733657230,HILD 30,A01,185791,Staff,12,0,20,8
1683733658255,HISC 119,A00,185830,Golan; Tal,0,10,20,20
1683733659280,HITO 156GS,A00,185831,Patterson; Patrick H.,0,0,0,23
1683733660305,HIUS 103,A00,185832,Man; Simeon S,0,4,20,20
1683733661330,HIUS 117,A00,185836,Kwak; Nancy,2,0,20,18
1683733662357,HIUS 125,A00,185840,Man; Simeon S,0,2,23,23
1683733663382,HIUS 149,A00,185845,Staff,1,0,20,19
1683733664409,HUM 3,A01,185882,Zavodny; Tatiana Sophia,0,8,50,50
1683733664409,HUM 3,B01,185899,Caldwell; Michael Alan,0,18,50,50
1683733665435,HUM 3GS,A00,185900,Patterson; Patrick H.,0,0,0,23
1683733666460,HUM 4,A01,185938,Zroka; Amy Liane,28,0,50,22
1683733666460,HUM 4,B01,185956,Watkins; Eric,0,6,50,50
1683733666460,HUM 4,B02,202209,Watkins; Eric,0,6,50,50
1683733666460,HUM 4,B03,202210,Watkins; Eric,0,5,50,50
1683733667550,HUM 5,A01,185958,West; Geoffrey Scott,0,0,50,50
1683733667550,HUM 5,A02,202215,West; Geoffrey Scott,0,1,50,50
1683733668575,INTL 190,A00,185959,Gagnon; Jeffrey C,0,0,0,9
1683733668575,INTL 190,B00,185960,Lettieri; Michael Joseph,0,0,0,2
1683733669600,JAPN 180,A00,254509,Staff,4,0,30,26
1683733670626,LATI 10,A01,202853,Kennemore; Amy Michelle,4,0,35,31
1683733670626,LATI 10,A02,202854,Kennemore; Amy Michelle,3,0,35,32
1683733670626,LATI 10,A03,270054,Kennemore; Amy Michelle,30,0,30,0
1683733671654,LATI 180,A00,202855,Kennemore; Amy Michelle,11,0,20,9
1683733672679,LAWS 101,A00,201767,Golan; Tal,0,7,40,40
1683733673703,LIFR 1C,A00,185961,Staff,6,0,20,14
1683733674731,LIFR 1CX,A00,185962,Staff,7,0,20,13
1683733675759,LIFR 1D,A00,185963,Staff,7,0,20,13
1683733676786,LIFR 1DX,A00,185964,Staff,7,0,20,13
1683733677811,LIGN 101,A01,186039,Staff,43,0,50,7
1683733678839,LIGN 165,A00,186040,Staff,14,0,50,36
1683733679867,LTCS 108,A00,186041,Staff,5,0,10,5
1683733680892,LTCS 119,A00,186042,Staff,15,0,20,5
1683733681917,LTCS 130,A00,186043,Wesling; Megan E.,15,0,25,10
1683733683969,LTEA 138,A00,186119,Staff,13,0,40,27
1683733684997,LTEN 124,A00,186148,Staff,5,0,25,20
1683733686024,LTEN 178,A00,186149,Staff,6,0,15,9
1683733687052,LTEN 181,A00,186150,Blanco; John D,34,0,40,6
1683733688081,LTWL 120,A00,186160,Staff,19,0,25,6
1683733689106,LTWL 165,A00,186161,Staff,22,0,25,3
1683733690131,LTWR 100,A00,186162,Staff,0,5,15,15
1683733691164,LTWR 102,A00,186163,Doller; Ben,5,0,15,10
1683733692189,MAE 8,A01,186412,Staff,0,1,0,1
1683733693222,MAE 30B,A00,186445,Bahadori; Mohammad Yousef,81,0,100,19
1683733694245,MAE 40,A00,186592,Bewley; Thomas R,10,0,50,40
1683733695270,MAE 101B,A00,186593,Bahadori; Mohammad Yousef,80,0,100,20
1683733696297,MAE 105,A00,186594,Bandaru; Prabhakar,10,0,50,40
1683733697323,MAE 107,A00,186599,Pham; Hieu Tan,0,8,120,120
1683733698354,MAE 148,A01,186660,Silberman; Jack,3,0,16,13
1683733699378,MATH 10A,A01,188095,Staff,0,6,35,35
1683733700409,MATH 10B,A01,188097,Bowers; Adam R.,0,12,30,30
1683733700409,MATH 10B,A02,188099,Bowers; Adam R.,0,11,30,30
1683733700409,MATH 10B,B01,188104,Bowers; Adam R.,0,10,30,30
1683733700409,MATH 10B,B02,188106,Bowers; Adam R.,0,9,30,30
1683733701435,MATH 10C,A01,188111,Staff,0,20,30,30
1683733701435,MATH 10C,A02,188127,Staff,0,19,30,30
1683733701435,MATH 10C,A03,188131,Staff,0,19,30,30
1683733701435,MATH 10C,B01,188218,Staff,17,0,30,13
1683733701435,MATH 10C,B02,188244,Staff,13,0,30,17
1683733701435,MATH 10C,B03,188277,Staff,14,0,30,16
1683733702459,MATH 18,A01,188344,Bach; Quang Tran,18,0,30,12
1683733702459,MATH 18,A02,188345,Bach; Quang Tran,11,0,30,19
1683733702459,MATH 18,B01,188353,Bach; Quang Tran,11,0,30,19
1683733702459,MATH 18,B02,188354,Bach; Quang Tran,19,0,30,11
1683733703484,MATH 20A,A01,188374,Staff,10,0,35,25
1683733704509,MATH 20B,A01,188382,Ohm; Ko Woon,7,0,30,23
1683733704509,MATH 20B,A02,188383,Ohm; Ko Woon,22,0,30,8
1683733704509,MATH 20B,B01,188385,Ohm; Ko Woon,7,0,30,23
1683733704509,MATH 20B,B02,188392,Ohm; Ko Woon,22,0,30,8
1683733705537,MATH 20C,A01,188394,Harel; Guershon,10,0,30,20
1683733705537,MATH 20C,A02,188395,Harel; Guershon,13,0,30,17
1683733705537,MATH 20C,B01,188404,Harel; Guershon,5,0,30,25
1683733705537,MATH 20C,B02,188405,Harel; Guershon,18,0,30,12
1683733706567,MATH 20D,A01,188414,Hammock; Frances H,0,1,30,30
1683733706567,MATH 20D,A02,188415,Hammock; Frances H,0,1,30,30
1683733706567,MATH 20D,B01,188447,Hammock; Frances H,0,1,30,30
1683733706567,MATH 20D,B02,188486,Hammock; Frances H,2,0,30,28
1683733707593,MATH 20E,A01,188649,Staff,21,0,30,9
1683733707593,MATH 20E,A02,188650,Staff,20,0,30,10
1683733707593,MATH 20E,A03,188673,Staff,0,0,30,30
1683733708618,MATH 102,A01,188675,Staff,0,40,35,35
1683733709643,MATH 103B,A01,188681,Staff,3,0,35,32
1683733709643,MATH 103B,B01,188692,Staff,5,0,35,30
1683733710668,MATH 109,A01,188695,Salehi Golsefidy; Alireza,24,0,35,11
1683733710668,MATH 109,A02,188696,Salehi Golsefidy; Alireza,24,0,35,11
1683733711697,MATH 120A,A01,188698,Eggers; John Dietrich,7,0,35,28
1683733712722,MATH 142B,A01,188736,Ioana; Adrian,0,0,30,30
1683733712722,MATH 142B,A02,188741,Ioana; Adrian,0,1,30,30
1683733712722,MATH 142B,A03,188743,Ioana; Adrian,0,3,30,30
1683733713747,MATH 168A,A01,188790,Staff,0,11,35,35
1683733714772,MATH 170A,A01,188803,Nie; Jiawang,0,2,35,35
1683733714772,MATH 170A,A02,188811,Nie; Jiawang,0,1,35,35
1683733714772,MATH 170A,A03,188814,Nie; Jiawang,1,0,35,34
1683733714772,MATH 170A,A04,188815,Nie; Jiawang,5,0,35,30
1683733715800,MATH 193B,A01,188817,Staff,0,0,35,35
1683733715800,MATH 193B,A02,188818,Staff,6,0,35,29
1683733716827,MGT 4,A01,202857,Anderson; John Charles,59,0,80,21
1683733717856,MGT 12,A00,202858,Lindenberger; Wade Douglas,40,0,90,50
1683733718880,MGT 18,A00,202859,Staff,73,0,90,17
1683733719905,MGT 18GS,A00,202860,McKay; Michael J,13,0,28,15
1683733720933,MGT 45,A00,202861,Pecore; Joseph P.,8,0,90,82
1683733721960,MGT 100,A00,202863,Yavorsky; Daniel Ryan,27,0,90,63
1683733722988,MGT 103,A00,202864,Ehrich; Kristine R,0,19,90,90
1683733724012,MGT 112,A00,202865,Ehrich; Kristine R,15,0,90,75
1683733725037,MGT 121A,A00,202868,Staff,70,0,90,20
1683733726065,MGT 131B,A00,202869,Anderson; John Charles,58,0,90,32
1683733727092,MGT 136,A00,202871,Lindenberger; Wade Douglas,83,0,90,7
1683733728115,MGT 164,A00,202873,Staff,0,67,90,91
1683733729142,MGT 164GS,A00,202874,McKay; Mary A,13,0,28,15
1683733730170,MGT 180,A00,202875,Staff,0,51,90,91
1683733731197,MMW 11R,A01,205019,Herbst; Matthew,0,0,30,30
1683733731197,MMW 11R,A02,205026,Herbst; Matthew,29,0,30,1
1683733732225,MMW 15,A01,193512,Chang; Edmond Yi-Teh,0,8,28,28
1683733732225,MMW 15,A02,193513,Chang; Edmond Yi-Teh,0,5,28,28
1683733732225,MMW 15,A03,193514,Chang; Edmond Yi-Teh,0,5,28,28
1683733732225,MMW 15,A04,193515,Chang; Edmond Yi-Teh,0,5,28,28
1683733732225,MMW 15,A05,193516,Chang; Edmond Yi-Teh,0,5,28,28
1683733732225,MMW 15,A06,193517,Chang; Edmond Yi-Teh,0,6,28,28
1683733732225,MMW 15,B01,193519,Chang; Edmond Yi-Teh,0,5,28,28
1683733732225,MMW 15,B02,193520,Chang; Edmond Yi-Teh,0,5,28,28
1683733732225,MMW 15,B03,193521,Chang; Edmond Yi-Teh,0,5,28,28
1683733732225,MMW 15,B04,193522,Chang; Edmond Yi-Teh,0,6,28,28
1683733732225,MMW 15,B05,193523,Chang; Edmond Yi-Teh,0,5,28,28
1683733732225,MMW 15,B06,193524,Chang; Edmond Yi-Teh,0,5,28,28
1683733733249,MMW 122,A01,193526,Rahimi; Babak,0,16,28,28
1683733733249,MMW 122,A02,193527,Rahimi; Babak,0,15,28,28
1683733733249,MMW 122,A03,193528,Rahimi; Babak,0,0,0,0
1683733733249,MMW 122,A04,193529,Rahimi; Babak,0,0,0,0
1683733734279,MUS 1A,A01,186663,Staff,0,18,35,35
1683733735308,MUS 4,A01,186715,Staff,0,12,35,35
1683733736334,MUS 5R,A01,186796,Dubnov; Shlomo,0,17,35,35
1683733737361,MUS 6,A01,186798,Staff,0,4,25,25
1683733738387,MUS 7,A01,186830,Staff,11,0,35,24
1683733739412,MUS 8,A01,186930,Staff,0,27,35,35
1683733740437,MUS 15,A01,186932,Staff,0,15,35,35
1683733740437,MUS 15,B01,186934,Staff,0,16,35,35
1683733741461,MUS 80,A00,186935,Staff,0,0,20,20
1683733741461,MUS 80,B00,186936,Staff,24,0,25,1
1683733742496,NANO 11,A00,204702,Lipomi; Darren John,0,0,0,0
1683733743521,NANO 15,A01,204709,Yang; Kesong,0,1,0,0
1683733744546,NANO 114,A00,202069,Jahed Motlagh; Zeinab,2,0,10,8
1683733745571,PHIL 1,A00,186955,Grush; Rick Scott,31,0,40,9
1683733746596,PHIL 10,A01,186973,Grush; Rick Scott,27,0,35,8
1683733746596,PHIL 10,A02,186974,Grush; Rick Scott,33,0,35,2
1683733747621,PHIL 13,A01,186976,Staff,1,0,35,34
1683733747621,PHIL 13,A02,186977,Staff,16,0,35,19
1683733748647,PHIL 14,A01,186979,Staff,30,0,35,5
1683733748647,PHIL 14,A02,186986,Staff,32,0,35,3
1683733749672,PHIL 28,A01,186988,Staff,16,0,30,14
1683733749672,PHIL 28,A02,186989,Staff,0,0,30,30
1683733749672,PHIL 28,A03,186990,Staff,10,0,30,20
1683733749672,PHIL 28,A04,186991,Staff,26,0,30,4
1683733750700,PHIL 120,A00,186997,Staff,23,0,40,17
1683733751724,PHIL 137,A00,187003,Staff,8,0,40,32
1683733752751,PHIL 150,A00,187015,Staff,47,0,70,23
1683733753775,PHIL 167,A00,187021,Lamey; Andy M.,34,0,40,6
1683733754803,PHIL 174,A01,202226,Staff,17,0,20,3
1683733754803,PHIL 174,A02,202235,Staff,20,0,20,0
1683733755827,PHIL 191A,A00,258918,Staff,0,0,1,1
1683733756855,PHYS 1A,A00,187028,Staff,26,0,60,34
1683733757879,PHYS 1AL,001,187036,Staff,3,0,30,27
1683733757879,PHYS 1AL,002,187049,Staff,18,0,30,12
1683733758908,PHYS 1B,A00,187058,Staff,21,0,60,39
1683733759936,PHYS 1BL,001,187064,Staff,0,1,30,30
1683733759936,PHYS 1BL,002,187070,Staff,4,0,30,26
1683733760961,PHYS 1C,A00,187082,Staff,30,0,120,90
1683733761987,PHYS 1CL,001,187088,Staff,0,9,30,30
1683733761987,PHYS 1CL,002,187089,Staff,0,1,30,30
1683733761987,PHYS 1CL,009,262693,Staff,9,0,30,21
1683733763015,PHYS 2B,A01,187097,Staff,55,0,115,60
1683733764041,PHYS 2C,A01,187099,Staff,63,0,115,52
1683733765068,PHYS 2CL,A01,187101,Staff,5,0,28,23
1683733765068,PHYS 2CL,A02,187102,Staff,15,0,28,13
1683733766096,PHYS 2D,A01,187123,Shotwell; Brian,95,0,115,20
1683733767125,PHYS 4B,A01,187133,Grinstein; Benjamin,35,0,50,15
1683733768148,POLI 10,A00,188819,Staff,0,4,50,50
1683733769173,POLI 11,A00,188827,Staff,43,0,50,7
1683733770198,POLI 13R,A00,188828,Staff,0,2,20,20
1683733771297,POLI 27,A01,188830,Elgin; Samuel Zincke,0,2,70,70
1683733772322,POLI 30,A00,188832,Desposato; Scott,30,0,50,20
1683733773352,POLI 102F,A00,188834,Staff,1,0,40,39
1683733774374,POLI 104A,A00,188852,Staff,12,0,30,18
1683733775400,POLI 104I,A00,188853,Staff,0,8,20,20
1683733776422,POLI 110B,A00,188854,Wiens; David,6,0,20,14
1683733777446,POLI 112A,A00,188855,Wiens; David,3,0,30,27
1683733778470,POLI 117R,A00,188856,Forman; Fonna,0,12,20,20
1683733779527,POLI 118,A00,188857,Ingham; Sean,8,0,20,12
1683733780549,POLI 120G,A00,188858,Staff,7,0,30,23
1683733781574,POLI 131CR,A00,188863,Hoston; Germaine,20,0,50,30
1683733782597,POLI 133,A00,188864,Nellis; Gareth Hb,44,0,50,6
1683733783621,POLI 134D,A00,188865,Desposato; Scott,27,0,30,3
1683733784651,POLI 142A,A00,188871,Gartzke; Erik,21,0,50,29
1683733785676,POLI 142K,A00,188874,Staff,38,0,50,12
1683733786700,POLI 143,A00,188940,Gartzke; Erik,15,0,30,15
1683733787725,POLI 153,A00,188943,Staff,1,0,20,19
1683733788748,POLI 160AA,A00,188944,Staff,10,0,40,30
1683733789772,POLI 170A,A00,188945,Staff,10,0,30,20
1683733791825,PSYC 1,A00,188952,Staff,36,0,90,54
1683733792855,PSYC 2,B00,188953,Staff,19,0,35,16
1683733793882,PSYC 6,A00,188970,Staff,47,0,60,13
1683733794910,PSYC 7,A00,188973,Staff,35,0,45,10
1683733795939,PSYC 60,A01,188980,Rickard; Timothy C.,42,0,60,18
1683733796964,PSYC 70,A01,189001,Steiner; Eric Tomas,21,0,45,24
1683733797989,PSYC 100,A00,189005,Lacefield; Katharine I,1,98,120,119
1683733799017,PSYC 102,A00,189008,Staff,6,0,30,24
1683733800040,PSYC 106,B00,189026,Gorman; Michael R.,26,0,60,34
1683733801068,PSYC 114,B01,189033,Winkielman; Piotr,0,31,30,30
1683733802093,PSYC 131,A00,189036,Anagnostaras; Stephan,0,44,60,60
1683733803121,PSYC 136,A00,189041,Lowe; Angela Beth,0,7,25,25
1683733804151,PSYC 137,A00,189057,Winkielman; Piotr,0,36,25,25
1683733805178,PSYC 144,A00,189107,Wixted; John T,0,11,50,50
1683733807231,PSYC 162,A00,189142,Staff,0,9,85,85
1683733808254,PSYC 172,A00,189144,Gorman; Michael R.,0,6,30,30
1683733810305,PSYC 179,A00,189146,Lacefield; Katharine I,0,88,120,120
1683733811331,PSYC 181,A00,189147,Anagnostaras; Stephan,110,45,200,90
1683733812359,PSYC 190R,A00,189148,Barner; David A.,0,23,80,80
1683733813384,PSYC 191,A00,189275,Rickard; Timothy C.,0,11,25,25
1683733814412,PSYC 193,A00,189276,Chapman; Eddie Nathaniel,0,1,0,4
1683733815439,PSYC 193L,A01,189281,Lowe; Angela Beth,8,0,20,12
1683733815439,PSYC 193L,B01,189285,Staff,28,0,35,7
1683733816463,RELI 149,A00,187137,Rahimi; Babak,6,0,40,34
1683733817490,SE 9,A01,187315,Staff,0,2,18,18
1683733818518,SE 101B,A00,187409,Staff,24,0,30,6
1683733819545,SE 110B,A00,187444,Staff,10,0,40,30
1683733820573,SE 130B,A00,187449,Staff,31,0,40,9
1683733821605,SE 150A,A00,187516,Staff,8,0,20,12
1683733822630,SE 154,A00,187528,Staff,29,0,50,21
1683733823655,SIO 3,A01,258171,Staff,35,0,40,5
1683733824678,SIO 10,A00,187144,Cook; Geoffrey W,0,6,75,75
1683733825705,SIO 45,A00,187152,Cook; Geoffrey W,1,7,100,99
1683733826729,SIO 109R,A00,194486,Staff,0,4,20,20
1683733828786,SIO 187,A01,187233,Kacev; David,12,0,40,28
1683733829817,SOCI 1,A01,258656,Thorpe; Charles Robert,28,0,30,2
1683733829817,SOCI 1,A02,258658,Thorpe; Charles Robert,30,0,30,0
1683733829817,SOCI 1,A03,258661,Thorpe; Charles Robert,25,0,25,0
1683733829817,SOCI 1,A04,258666,Thorpe; Charles Robert,22,0,25,3
1683733829817,SOCI 1,A05,258897,Thorpe; Charles Robert,22,0,25,3
1683733829817,SOCI 1,A06,258898,Thorpe; Charles Robert,25,0,25,0
1683733830844,SOCI 30,A01,258903,Pardo Guerra; Juan Pablo,14,0,30,16
1683733831869,SOCI 102,A00,258904,Staff,9,0,25,16
1683733832895,SOCI 106,A00,258905,Staff,19,0,25,6
1683733833923,SOCI 111,A00,258907,Ribas Norris; Janet Vanesa,26,0,30,4
1683733834950,SOCI 121R,A00,258908,Pardo Guerra; Juan Pablo,7,0,30,23
1683733835977,SOCI 126,A01,203330,Staff,14,0,20,6
1683733837006,SOCI 131,A00,258909,Thorpe; Charles Robert,30,0,60,30
1683733838033,SOCI 135,A00,258910,Payne; Christine Anna,0,13,30,30
1683733839058,SOCI 157,A00,258911,Staff,10,0,30,20
1683733840088,SOCI 184,A00,258912,Staff,25,0,30,5
1683733841112,SOCI 188D,A00,258913,Staff,22,0,30,8
1683733842139,SYN 2,001,187529,Staff,9,0,16,7
1683733842139,SYN 2,002,201452,Staff,0,20,16,16
1683733842139,SYN 2,003,201469,Staff,1,0,16,15
1683733843166,SYN 100,A01,187531,Staff,0,9,20,20
1683733843166,SYN 100,B01,201491,Staff,0,10,20,20
1683733844193,TDAC 1,A00,189286,Walsh; Kim C.,3,0,20,17
1683733844193,TDAC 1,B00,189287,Harting; Carla Kelso,10,0,20,10
1683733845219,TDAC 101,A00,189300,Walsh; Kim C.,16,0,20,4
1683733845219,TDAC 101,B00,189301,Harting; Carla Kelso,18,0,20,2
1683733846241,TDAC 102,A00,189304,Basso; Beatrice,14,0,20,6
1683733847265,TDAC 108,A00,189305,Staff,18,0,20,2
1683733848294,TDDE 131,A00,189310,Staff,19,0,20,1
1683733848294,TDDE 131,B00,189314,Staff,19,0,20,1
1683733848294,TDDE 131,C00,189315,Staff,48,0,50,2
1683733848294,TDDE 131,D00,189316,Staff,14,0,15,1
1683733848294,TDDE 131,E00,204841,Staff,20,0,20,0
1683733849322,TDGE 10,A00,189289,Staff,26,0,50,24
1683733849322,TDGE 10,B00,189290,Havis; Allan,0,1,50,50
1683733850348,TDGE 11,A00,189291,Fulton; Julia,0,4,50,50
1683733850348,TDGE 11,B00,189292,Staff,20,0,25,5
1683733850348,TDGE 11,C00,260270,Staff,0,0,0,0
1683733851371,TDGE 25,A00,189294,Staff,1,0,20,19
1683733852398,TDGE 124,A00,189318,Fulton; Julia,0,7,50,50
1683733853425,TDGE 125,A00,189319,Staff,13,0,25,12
1683733853425,TDGE 125,B00,189320,Staff,23,0,25,2
1683733854452,TDGE 127,A00,189322,Havis; Allan,1,0,50,49
1683733855479,TDHT 101,A00,189323,Staff,18,0,25,7
1683733855479,TDHT 101,B00,189324,Staff,25,0,25,0
1683733856503,TDHT 102,A00,189325,Staff,49,0,50,1
1683733857526,TDMV 1,A00,189295,Arcidiacono; Kristin,20,0,30,10
1683733857526,TDMV 1,B00,189296,Caligagan; Maria T.,23,0,30,7
1683733858558,TDMV 2,A00,189297,Sammartano; Tonnie,27,0,30,3
1683733858558,TDMV 2,B00,189299,Arcidiacono; Kristin,23,0,30,7
1683733859582,TDMV 3,A00,204998,Rincon; Alicia,22,0,30,8
1683733860610,TDMV 120,A00,189458,Sammartano; Tonnie,28,0,30,2
1683733861634,TDMV 138,A00,189541,Jun; Grace Shin Hae,20,0,40,20
1683733862662,TDMV 142,A00,189717,Caligagan; Tony,25,0,30,5
1683733862662,TDMV 142,B00,189718,Caligagan; Maria T.,25,0,30,5
1683733863701,TMC 2,A01,187533,Staff,25,0,25,0
1683733863701,TMC 2,A02,187534,Staff,25,0,25,0
1683733864726,USP 1,A01,187536,Kwak; Nancy,0,16,25,25
1683733865749,USP 5,A01,187538,Staff,8,0,25,17
1683733866776,USP 101,A00,199253,Staff,0,4,0,0
1683733867800,USP 124,A00,187562,Boomhower; Matthew Charles,0,0,30,30
1683733868824,USP 138,A00,187582,Staff,19,0,25,6
1683733869848,USP 152,A01,187597,Staff,3,0,25,22
1683733870874,USP 153,A00,187598,Staff,18,0,25,7
1683733871898,USP 168,A00,187607,Kwak; Nancy,2,0,5,3
1683733872923,USP 173,A00,187619,Staff,4,0,25,21
1683733873951,USP 181,A00,187638,Staff,0,4,25,25
1683733875048,VIS 103,A00,187650,Cruz; Edwin Teddy,17,0,75,58
1683733876077,VIS 110D,A00,187669,Staff,13,0,22,9
1683733877105,VIS 127C,A00,187720,Shen; Kuiyi,67,0,146,79
1683733878128,VIS 149,A00,187731,Yoldas; Pinar,0,12,22,22
1683733879154,VIS 151,A01,188091,Staff,22,0,34,12
1683733879154,VIS 151,A02,188092,Staff,11,0,34,23
1683733880177,VIS 160B,A00,188093,Stalbaum; Brett,0,1,10,10
1683733882227,WCWP 10B,A00,201720,Staff,0,0,5,5
1683733882227,WCWP 10B,B00,201722,Staff,0,0,6,6
1683733883250,WCWP 100,A00,201725,Gagnon; Jeffrey C,0,0,2,2
1683733883250,WCWP 100,B00,201727,Staff,0,4,15,15
1683733886370,ANBI 133,A00,258401,Wilder; Linnea Lorene,34,0,40,6
1683733887395,ANBI 140,A00,258395,Hrvoj Mihic; Branka,18,0,25,7
1683733888421,ANSC 120,A00,258402,Bialecki; Jon Anthony,26,0,40,14
1683733889444,ANSC 144,A00,258400,Staff,12,0,40,28
1683733891492,ANSC 166,A00,258396,Parish; Steven Martin,156,0,175,19
1683733892516,ANSC 180,A00,193533,Staff,8,0,20,12
1683733893545,ANSC 188,A00,258397,Jassal; Aftab,34,0,40,6
1683733894570,ANTH 3,A01,258316,Staff,23,0,30,7
1683733895595,ANTH 5,A00,258394,Semendeferi; Ekaterini,16,0,20,4
1683733896619,ANTH 21,A01,258331,Staff,4,0,40,36
1683733897654,ANTH 103,A00,258398,Varma; Saiba,15,0,25,10
1683733898680,AWP 10,001,202034,Staff,0,0,0,0
1683733898680,AWP 10,002,202035,Staff,0,0,0,0
1683733898680,AWP 10,003,202036,Staff,0,0,0,0
1683733898680,AWP 10,004,202037,Staff,0,0,0,0
1683733898680,AWP 10,005,202038,Staff,0,0,0,0
1683733898680,AWP 10,006,202039,Staff,0,0,0,0
1683733898680,AWP 10,007,202040,Staff,0,0,0,0
1683733898680,AWP 10,008,202041,Staff,0,0,0,0
1683733898680,AWP 10,009,202042,Staff,0,0,0,0
1683733898680,AWP 10,010,202043,Staff,0,0,0,0
1683733898680,AWP 10,011,202044,Staff,0,0,0,0
1683733898680,AWP 10,012,202045,Staff,0,0,0,0
1683733898680,AWP 10,013,202046,Staff,0,0,0,0
1683733898680,AWP 10,014,202047,Staff,0,0,0,0
1683733898680,AWP 10,015,202048,Staff,0,0,0,0
1683733898680,AWP 10,016,202049,Staff,0,0,0,0
1683733898680,AWP 10,017,202050,Staff,0,0,0,0
1683733898680,AWP 10,018,202051,Staff,0,0,0,0
1683733898680,AWP 10,019,202052,Staff,0,0,0,0
1683733898680,AWP 10,020,202053,Staff,0,0,0,0
1683733898680,AWP 10,021,202054,Staff,0,0,0,0
1683733898680,AWP 10,022,202055,Staff,0,0,0,0
1683733898680,AWP 10,023,202056,Staff,0,0,0,0
1683733898680,AWP 10,024,202057,Staff,0,0,0,0
1683733898680,AWP 10,025,202058,Staff,0,0,0,0
1683733898680,AWP 10,026,202059,Staff,0,0,0,0
1683733899706,AWP 102,001,202032,Staff,0,0,0,0
1683733899706,AWP 102,002,202033,Staff,0,0,0,0
1683733900731,BENG 100,A01,254234,Taylor Amos; Alyssa C,31,0,40,9
1683733901758,BENG 196,001,270013,Engler; Adam J.,9999,0,9999,0
1683733902791,BICD 100R,A01,202018,Smith; Laurie,0,7,32,32
1683733902791,BICD 100R,A02,202019,Smith; Laurie,0,3,32,32
1683733902791,BICD 100R,A03,202020,Smith; Laurie,0,1,32,32
1683733902791,BICD 100R,A04,202021,Smith; Laurie,6,0,32,26
1683733902791,BICD 100R,A05,202022,Smith; Laurie,10,0,32,22
1683733903816,BICD 136,A01,193242,Gustafson-Brown; Cindy,0,2,32,32
1683733903816,BICD 136,A02,193244,Gustafson-Brown; Cindy,13,0,32,19
1683733904846,BIEB 102,A01,193249,Butler; Shannon Rhey,0,0,32,32
1683733904846,BIEB 102,A02,193251,Butler; Shannon Rhey,0,0,32,32
1683733904846,BIEB 102,A03,193253,Butler; Shannon Rhey,0,0,32,32
1683733904846,BIEB 102,A04,193255,Butler; Shannon Rhey,13,0,32,19
1683733904846,BIEB 102,A05,193265,Butler; Shannon Rhey,25,0,32,7
1683733904846,BIEB 102,A06,193269,Butler; Shannon Rhey,12,0,32,20
1683733906899,BIEB 150,A01,193274,Staff,0,0,32,32
1683733906899,BIEB 150,A02,193285,Staff,24,0,32,8
1683733907926,BIEB 194,A00,193286,Kurle; Carolyn M.,19,0,32,13
1683733908951,BILD 1,A01,192291,Staff,15,0,32,17
1683733908951,BILD 1,A02,192292,Staff,30,0,32,2
1683733908951,BILD 1,B01,192520,Reuther; Keefe,0,1,0,0
1683733908951,BILD 1,B02,192532,Reuther; Keefe,0,1,0,0
1683733909982,BILD 3,A01,192556,Butler; Shannon Rhey,0,0,32,32
1683733909982,BILD 3,A02,192581,Butler; Shannon Rhey,0,1,32,32
1683733909982,BILD 3,A03,192611,Butler; Shannon Rhey,19,0,32,13
1683733909982,BILD 3,A04,192612,Butler; Shannon Rhey,23,0,32,9
1683733909982,BILD 3,A05,192613,Butler; Shannon Rhey,26,0,32,6
1683733909982,BILD 3,A06,192679,Butler; Shannon Rhey,27,0,32,5
1683733909982,BILD 3,A07,192682,Butler; Shannon Rhey,20,0,32,12
1683733911007,BILD 4,A01,192836,Reuther; Keefe,1,0,24,23
1683733911007,BILD 4,A02,193044,Reuther; Keefe,4,0,24,20
1683733912036,BILD 10,A01,193142,Gustafson-Brown; Cindy,29,0,32,3
1683733912036,BILD 10,A02,193149,Gustafson-Brown; Cindy,31,0,32,1
1683733913060,BIMM 100,A01,193301,Staff,0,6,32,32
1683733913060,BIMM 100,A02,193312,Staff,0,7,32,32
1683733913060,BIMM 100,A03,193323,Staff,0,10,32,32
1683733914086,BIMM 101,A01,193329,McDonnell; Lisa Marie,0,3,24,24
1683733914086,BIMM 101,A02,193339,McDonnell; Lisa Marie,0,3,24,24
1683733914086,BIMM 101,B01,193354,McDonnell; Lisa Marie,0,4,24,24
1683733914086,BIMM 101,B02,193357,McDonnell; Lisa Marie,0,3,24,24
1683733915112,BIMM 110,A01,193377,Tat; John,0,11,32,32
1683733915112,BIMM 110,A02,193378,Tat; John,0,11,32,32
1683733916138,BIMM 120,A01,206116,Staff,1,0,32,31
1683733916138,BIMM 120,A02,206117,Staff,7,0,32,25
1683733916138,BIMM 120,A03,206121,Staff,21,0,32,11
1683733917163,BIPN 100,A01,193393,Park; Ji Young,0,15,32,32
1683733917163,BIPN 100,A02,193402,Park; Ji Young,0,14,32,32
1683733917163,BIPN 100,A03,193413,Park; Ji Young,0,14,32,32
1683733917163,BIPN 100,A04,193414,Park; Ji Young,0,13,32,32
1683733918190,BIPN 102,A01,193429,Staff,0,0,32,32
1683733918190,BIPN 102,A02,193438,Staff,18,0,32,14
1683733919216,BIPN 106,A01,193450,Reyes Gonzalez; Catalina,0,2,40,40
1683733920246,BIPN 134,A01,193465,Cooke; James Edward,0,0,32,32
1683733920246,BIPN 134,A02,193474,Cooke; James Edward,25,0,32,7
1683733920246,BIPN 134,A03,193485,Cooke; James Edward,29,0,32,3
1683733920246,BIPN 134,A04,193486,Cooke; James Edward,20,0,32,12
1683733920246,BIPN 134,A05,193491,Cooke; James Edward,31,0,32,1
1683733920246,BIPN 134,A06,193501,Cooke; James Edward,30,0,32,2
1683733920246,BIPN 134,A07,193510,Cooke; James Edward,29,0,32,3
1683733922303,BISP 194,A00,222522,Staff,14,0,32,18
1683733923331,CAT 124,A01,202407,Staff,19,0,25,6
1683733924359,CAT 125,A00,202408,Marchisotto; Jennifer Anne,2,0,20,18
1683733925385,CAT 125R,A00,202409,Smith; Lauryn Alissa,0,11,20,20
1683733925385,CAT 125R,B00,202410,Morales; Celeste Georgianna,0,11,20,20
1683733925385,CAT 125R,C00,202411,Irwin; Matthew Joseph,0,12,20,20
1683733926414,CENG 15,A01,204712,Yang; Kesong,0,1,0,0
1683733927437,CENG 114,A00,202070,Jahed Motlagh; Zeinab,5,0,20,15
1683733928465,CGS 105,A00,185477,Wesling; Megan E.,24,0,40,16
1683733929493,CGS 106,A00,185494,Staff,11,0,22,11
1683733930520,CGS 108,A00,185495,Staff,14,0,20,6
1683733931546,CGS 114,A00,185496,Staff,13,0,18,5
1683733932574,CGS 119,A00,185501,Staff,15,0,20,5
1683733933600,CGS 120,A00,185511,Staff,11,0,20,9
1683733934625,CHEM 4,A01,184675,Bussey; Thomas J,97,0,100,3
1683733935650,CHEM 6A,A01,184677,Staff,32,0,60,28
1683733936679,CHEM 6B,A01,184679,Staff,63,0,100,37
1683733937708,CHEM 6C,A01,184681,Bussey; Thomas J,0,0,50,50
1683733937708,CHEM 6C,A02,184682,Bussey; Thomas J,32,0,50,18
1683733938737,CHEM 40A,A01,184684,Albizati; Kim F.,33,0,100,67
1683733939763,CHEM 40B,A01,184686,Albizati; Kim F.,0,22,100,100
1683733940791,CHEM 41B,A01,184690,Staff,51,0,100,49
1683733941817,COGS 3,A01,184715,Boyle; Mary E. T.,0,27,40,40
1683733942854,COGS 14B,A01,185172,Staff,0,14,38,38
1683733943889,COGS 18,A01,184736,Staff,14,0,80,66
1683733944913,COGS 100,A01,184932,Staff,0,8,73,73
1683733945941,COGS 101A,A01,184935,Staff,0,40,30,30
1683733946965,COGS 101B,A01,184944,Staff,0,2,30,30
1683733947992,COGS 101C,A01,184946,Staff,0,10,30,30
1683733949015,COGS 102A,A01,184951,Johnson; Christine M.,1,0,40,39
1683733950045,COGS 107B,A01,184953,Mooshagian; Eric Frederick,0,52,40,40
1683733951069,COGS 118B,A01,184959,Gupta; Anjum,0,50,40,40
1683733952094,COGS 153,A00,184961,Staff,1,16,30,29
1683733953120,COGS 177,A00,184962,Staff,0,20,30,30
1683733954147,COGS 187A,A01,184969,Boyle; Mary E. T.,0,19,40,40
1683733955173,COMM 10,A01,185174,Staff,0,5,25,25
1683733955173,COMM 10,A02,185189,Staff,0,2,25,25
1683733955173,COMM 10,A03,269821,Staff,0,1,0,0
1683733956201,COMM 100B,A02,185476,Staff,10,0,25,15
1683733956201,COMM 100B,A03,277340,Staff,25,0,25,0
1683733957228,COMM 100C,A01,185314,Staff,2,0,25,23
1683733957228,COMM 100C,A02,185327,Staff,17,0,25,8
1683733958252,COMM 110M,A00,185349,Staff,0,0,40,40
1683733959275,COMM 113T,A00,185352,Staff,25,0,40,15
1683733960303,COMM 114I,A00,185353,Staff,31,0,40,9
1683733961329,COMM 131,A00,185354,Staff,17,0,30,13
1683733962358,CSE 8A,A50,185358,Cao; Yingjun,0,46,10,10
1683733963382,CSE 8B,A01,185362,Staff,0,48,50,50
1683733964407,CSE 11,A01,185416,Cao; Yingjun,0,91,10,10
1683733965435,CSE 20,A01,185445,Briones; Jor-el Thomas Caparas,3,0,25,22
1683733966464,CSE 21,A01,185447,Staff,9,0,50,41
1683733967493,CSE 101,A01,185451,Staff,0,13,50,50
1683733967493,CSE 101,B01,185453,Jones; Miles E,0,15,50,50
1683733969543,CSE 141,A01,185458,Eldon; John,16,0,100,84
1683733970568,CSE 141L,A01,185461,Eldon; John,8,0,100,92
1683733971592,CSE 142,A01,185463,Staff,34,0,60,26
1683733971592,CSE 142,B01,201355,Staff,0,7,60,60
1683733972617,CSE 142L,A01,185470,Staff,34,0,60,26
1683733972617,CSE 142L,B01,201417,Staff,0,6,60,60
1683733973645,CSE 190,A00,201433,Staff,32,0,49,17
1683733974671,DOC 1,A01,259136,Strom; Megan C.,7,0,15,8
1683733974671,DOC 1,A02,259137,Strom; Megan C.,15,0,15,0
1683733974671,DOC 1,A03,259138,Strom; Megan C.,14,0,15,1
1683733974671,DOC 1,A04,259139,Strom; Megan C.,13,0,15,2
1683733975699,DOC 100D,A00,259140,Pass; Natalye Joann,14,0,25,11
1683733976723,DSGN 1,A01,184749,Rill; Bryan,0,26,30,30
1683733977752,DSGN 100,A01,185168,Staff,0,2,25,25
1683733978835,ECE 5,A01,185626,Morris; Karcher William,0,12,0,0
1683733979859,ECE 101,A01,185628,Staff,14,0,70,56
1683733980885,ECE 107,A01,185635,Baghdadchi; Saharnaz,0,0,20,20
1683733980885,ECE 107,A02,185638,Baghdadchi; Saharnaz,1,0,20,19
1683733981916,ECE 148,A01,185647,Silberman; Jack,0,0,16,16
1683733982944,ECON 1,A01,185537,Crane; Meredith Helen,54,0,70,16
1683733983972,ECON 3,A01,185549,Crane; Meredith Helen,30,0,70,40
1683733984998,ECON 4,A01,203354,Anderson; John Charles,0,5,10,10
1683733986022,ECON 100A,A01,185574,Staff,0,5,40,40
1683733987046,ECON 100B,A01,185576,Staff,0,12,50,50
1683733988072,ECON 100C,A01,185589,Newhouse; Herbert S,30,0,70,40
1683733989096,ECON 105,A00,185608,Vespa; Emanuel Ignacio,19,0,35,16
1683733990125,ECON 109,A01,185610,Shishkin; Denis,9,0,35,26
1683733991150,ECON 110A,A01,185612,Staff,8,0,40,32
1683733992177,ECON 120A,A01,185615,Staff,19,0,40,21
1683733993200,ECON 120C,A01,185617,Sun; Yixiao,0,21,70,70
1683733994225,ECON 144,A00,203346,Squires; Dale E,2,0,35,33
1683733995253,ECON 171,A01,203349,Newhouse; Herbert S,0,1,35,35
1683733996277,ECON 173A,A01,185621,Toda; Alexis Akira,21,0,35,14
1683733997303,EDS 25,A01,202413,Staff,0,1,0,0
1683733997303,EDS 25,A02,202414,Staff,0,1,0,0
1683733997303,EDS 25,A03,202415,Staff,0,0,0,0
1683733997303,EDS 25,A04,202416,Staff,0,1,0,0
1683733997303,EDS 25,A05,202439,Staff,0,0,0,0
1683733997303,EDS 25,A06,202440,Staff,0,0,0,0
1683733997303,EDS 25,B01,202631,Staff,0,0,0,0
1683733997303,EDS 25,B02,202632,Staff,0,0,0,0
1683733997303,EDS 25,B03,202639,Staff,0,0,0,0
1683733997303,EDS 25,B04,202640,Staff,0,0,0,0
1683733997303,EDS 25,B05,202643,Staff,0,0,0,0
1683733997303,EDS 25,B06,202644,Staff,0,0,0,0
1683733998329,EDS 38,A01,202659,Black; Alison Michelle,25,0,25,0
1683733999355,EDS 115,A00,202652,Staff,18,0,30,12
1683734000380,EDS 125,A00,202649,Staff,13,0,30,17
1683734001407,EDS 126,A01,203332,Staff,30,0,30,0
1683734002430,EDS 139,A00,202838,Staff,16,0,25,9
1683734003461,EDS 146,A01,202655,Staff,14,0,25,11
1683734004493,ENG 15,A00,185667,Staff,0,1,0,2
1683734004493,ENG 15,B00,185672,Staff,0,0,0,1
1683734004493,ENG 15,C00,185675,Staff,0,0,0,0
1683734004493,ENG 15,D00,185682,Staff,0,0,0,0
1683734004493,ENG 15,E00,185684,Staff,0,0,0,0
1683734005517,ETHN 103,A00,185710,Staff,0,8,35,35
1683734006541,ETHN 103A,A00,199228,Man; Simeon S,0,0,9,9
1683734007565,ETHN 109,A00,185711,Staff,15,0,35,20
1683734008589,ETHN 142,A00,185726,Staff,0,4,30,30
1683734009613,ETHN 163J,A00,199229,Man; Simeon S,5,0,8,3
1683734010637,ETHN 168,A00,185727,Staff,7,0,10,3
1683734011662,ETHN 182,A00,185728,Staff,0,0,35,35
1683734012686,ETHN 183,A00,185737,Staff,10,0,18,8
1683734013709,GLBH 111,A01,209361,Burgos; Jose L.,0,0,0,0
1683734015761,HIEU 104,A00,185792,Staff,14,0,20,6
1683734016788,HIEU 115,A00,185800,Staff,0,0,20,20
1683734017812,HIEU 128,A00,185801,Staff,0,9,20,20
1683734018840,HIEU 147,A00,185802,Staff,15,0,20,5
1683734019866,HIEU 154,A00,185823,Staff,11,0,20,9
1683734020904,HILA 102,A00,185826,Staff,14,0,20,6
1683734021929,HILD 2C,A01,185778,Staff,0,13,20,20
1683734022957,HILD 7B,A01,185780,Kwak; Nancy,0,17,32,32
1683734022957,HILD 7B,A02,185781,Kwak; Nancy,0,18,32,32
1683734023984,HILD 30,A01,185791,Staff,12,0,20,8
1683734025011,HISC 119,A00,185830,Golan; Tal,0,10,20,20
1683734026035,HITO 156GS,A00,185831,Patterson; Patrick H.,0,0,0,23
1683734027059,HIUS 103,A00,185832,Man; Simeon S,0,4,20,20
1683734028086,HIUS 117,A00,185836,Kwak; Nancy,2,0,20,18
1683734029111,HIUS 125,A00,185840,Man; Simeon S,0,2,23,23
1683734030135,HIUS 149,A00,185845,Staff,1,0,20,19
1683734031161,HUM 3,A01,185882,Zavodny; Tatiana Sophia,0,8,50,50
1683734031161,HUM 3,B01,185899,Caldwell; Michael Alan,0,18,50,50
1683734032186,HUM 3GS,A00,185900,Patterson; Patrick H.,0,0,0,23
1683734033225,HUM 4,A01,185938,Zroka; Amy Liane,28,0,50,22
1683734033225,HUM 4,B01,185956,Watkins; Eric,0,6,50,50
1683734033225,HUM 4,B02,202209,Watkins; Eric,0,6,50,50
1683734033225,HUM 4,B03,202210,Watkins; Eric,0,5,50,50
1683734034251,HUM 5,A01,185958,West; Geoffrey Scott,0,0,50,50
1683734034251,HUM 5,A02,202215,West; Geoffrey Scott,0,1,50,50
1683734035280,INTL 190,A00,185959,Gagnon; Jeffrey C,0,0,0,9
1683734035280,INTL 190,B00,185960,Lettieri; Michael Joseph,0,0,0,2
1683734036305,JAPN 180,A00,254509,Staff,4,0,30,26
1683734037331,LATI 10,A01,202853,Kennemore; Amy Michelle,4,0,35,31
1683734037331,LATI 10,A02,202854,Kennemore; Amy Michelle,3,0,35,32
1683734037331,LATI 10,A03,270054,Kennemore; Amy Michelle,30,0,30,0
1683734038353,LATI 180,A00,202855,Kennemore; Amy Michelle,11,0,20,9
1683734039378,LAWS 101,A00,201767,Golan; Tal,0,7,40,40
1683734040404,LIFR 1C,A00,185961,Staff,6,0,20,14
1683734041429,LIFR 1CX,A00,185962,Staff,7,0,20,13
1683734042454,LIFR 1D,A00,185963,Staff,7,0,20,13
1683734043481,LIFR 1DX,A00,185964,Staff,7,0,20,13
1683734044506,LIGN 101,A01,186039,Staff,43,0,50,7
1683734045532,LIGN 165,A00,186040,Staff,14,0,50,36
1683734046557,LTCS 108,A00,186041,Staff,5,0,10,5
1683734047584,LTCS 119,A00,186042,Staff,15,0,20,5
1683734048610,LTCS 130,A00,186043,Wesling; Megan E.,15,0,25,10
1683734050666,LTEA 138,A00,186119,Staff,13,0,40,27
1683734051690,LTEN 124,A00,186148,Staff,5,0,25,20
1683734052713,LTEN 178,A00,186149,Staff,6,0,15,9
1683734053737,LTEN 181,A00,186150,Blanco; John D,34,0,40,6
1683734054762,LTWL 120,A00,186160,Staff,19,0,25,6
1683734055789,LTWL 165,A00,186161,Staff,22,0,25,3
1683734056817,LTWR 100,A00,186162,Staff,0,5,15,15
1683734057846,LTWR 102,A00,186163,Doller; Ben,5,0,15,10
1683734058873,MAE 8,A01,186412,Staff,0,1,0,1
1683734059900,MAE 30B,A00,186445,Bahadori; Mohammad Yousef,81,0,100,19
1683734060924,MAE 40,A00,186592,Bewley; Thomas R,10,0,50,40
1683734061948,MAE 101B,A00,186593,Bahadori; Mohammad Yousef,80,0,100,20
1683734062972,MAE 105,A00,186594,Bandaru; Prabhakar,10,0,50,40
1683734063998,MAE 107,A00,186599,Pham; Hieu Tan,0,8,120,120
1683734065024,MAE 148,A01,186660,Silberman; Jack,3,0,16,13
1683734066049,MATH 10A,A01,188095,Staff,0,6,35,35
1683734067078,MATH 10B,A01,188097,Bowers; Adam R.,0,12,30,30
1683734067078,MATH 10B,A02,188099,Bowers; Adam R.,0,11,30,30
1683734067078,MATH 10B,B01,188104,Bowers; Adam R.,0,10,30,30
1683734067078,MATH 10B,B02,188106,Bowers; Adam R.,0,9,30,30
1683734068101,MATH 10C,A01,188111,Staff,0,20,30,30
1683734068101,MATH 10C,A02,188127,Staff,0,19,30,30
1683734068101,MATH 10C,A03,188131,Staff,0,19,30,30
1683734068101,MATH 10C,B01,188218,Staff,17,0,30,13
1683734068101,MATH 10C,B02,188244,Staff,13,0,30,17
1683734068101,MATH 10C,B03,188277,Staff,14,0,30,16
1683734069130,MATH 18,A01,188344,Bach; Quang Tran,18,0,30,12
1683734069130,MATH 18,A02,188345,Bach; Quang Tran,11,0,30,19
1683734069130,MATH 18,B01,188353,Bach; Quang Tran,11,0,30,19
1683734069130,MATH 18,B02,188354,Bach; Quang Tran,19,0,30,11
1683734070159,MATH 20A,A01,188374,Staff,10,0,35,25
1683734071186,MATH 20B,A01,188382,Ohm; Ko Woon,7,0,30,23
1683734071186,MATH 20B,A02,188383,Ohm; Ko Woon,22,0,30,8
1683734071186,MATH 20B,B01,188385,Ohm; Ko Woon,7,0,30,23
1683734071186,MATH 20B,B02,188392,Ohm; Ko Woon,22,0,30,8
1683734072212,MATH 20C,A01,188394,Harel; Guershon,10,0,30,20
1683734072212,MATH 20C,A02,188395,Harel; Guershon,13,0,30,17
1683734072212,MATH 20C,B01,188404,Harel; Guershon,5,0,30,25
1683734072212,MATH 20C,B02,188405,Harel; Guershon,18,0,30,12
1683734073244,MATH 20D,A01,188414,Hammock; Frances H,0,1,30,30
1683734073244,MATH 20D,A02,188415,Hammock; Frances H,0,1,30,30
1683734073244,MATH 20D,B01,188447,Hammock; Frances H,0,1,30,30
1683734073244,MATH 20D,B02,188486,Hammock; Frances H,2,0,30,28
1683734074270,MATH 20E,A01,188649,Staff,21,0,30,9
1683734074270,MATH 20E,A02,188650,Staff,20,0,30,10
1683734074270,MATH 20E,A03,188673,Staff,0,0,30,30
1683734075296,MATH 102,A01,188675,Staff,0,40,35,35
1683734076322,MATH 103B,A01,188681,Staff,3,0,35,32
1683734076322,MATH 103B,B01,188692,Staff,5,0,35,30
1683734077350,MATH 109,A01,188695,Salehi Golsefidy; Alireza,24,0,35,11
1683734077350,MATH 109,A02,188696,Salehi Golsefidy; Alireza,24,0,35,11
1683734078379,MATH 120A,A01,188698,Eggers; John Dietrich,7,0,35,28
1683734079403,MATH 142B,A01,188736,Ioana; Adrian,0,0,30,30
1683734079403,MATH 142B,A02,188741,Ioana; Adrian,0,1,30,30
1683734079403,MATH 142B,A03,188743,Ioana; Adrian,0,3,30,30
1683734080430,MATH 168A,A01,188790,Staff,0,11,35,35
1683734081456,MATH 170A,A01,188803,Nie; Jiawang,0,2,35,35
1683734081456,MATH 170A,A02,188811,Nie; Jiawang,0,1,35,35
1683734081456,MATH 170A,A03,188814,Nie; Jiawang,1,0,35,34
1683734081456,MATH 170A,A04,188815,Nie; Jiawang,5,0,35,30
1683734082549,MATH 193B,A01,188817,Staff,0,0,35,35
1683734082549,MATH 193B,A02,188818,Staff,6,0,35,29
1683734083575,MGT 4,A01,202857,Anderson; John Charles,59,0,80,21
1683734084603,MGT 12,A00,202858,Lindenberger; Wade Douglas,40,0,90,50
1683734085630,MGT 18,A00,202859,Staff,73,0,90,17
1683734086654,MGT 18GS,A00,202860,McKay; Michael J,13,0,28,15
1683734087681,MGT 45,A00,202861,Pecore; Joseph P.,8,0,90,82
1683734088705,MGT 100,A00,202863,Yavorsky; Daniel Ryan,27,0,90,63
1683734089735,MGT 103,A00,202864,Ehrich; Kristine R,0,19,90,90
1683734090759,MGT 112,A00,202865,Ehrich; Kristine R,15,0,90,75
1683734091786,MGT 121A,A00,202868,Staff,70,0,90,20
1683734092810,MGT 131B,A00,202869,Anderson; John Charles,58,0,90,32
1683734093834,MGT 136,A00,202871,Lindenberger; Wade Douglas,83,0,90,7
1683734094859,MGT 164,A00,202873,Staff,0,67,90,91
1683734095886,MGT 164GS,A00,202874,McKay; Mary A,13,0,28,15
1683734096913,MGT 180,A00,202875,Staff,0,51,90,91
1683734097938,MMW 11R,A01,205019,Herbst; Matthew,0,0,30,30
1683734097938,MMW 11R,A02,205026,Herbst; Matthew,29,0,30,1
1683734098973,MMW 15,A01,193512,Chang; Edmond Yi-Teh,0,8,28,28
1683734098973,MMW 15,A02,193513,Chang; Edmond Yi-Teh,0,5,28,28
1683734098973,MMW 15,A03,193514,Chang; Edmond Yi-Teh,0,5,28,28
1683734098973,MMW 15,A04,193515,Chang; Edmond Yi-Teh,0,5,28,28
1683734098973,MMW 15,A05,193516,Chang; Edmond Yi-Teh,0,5,28,28
1683734098973,MMW 15,A06,193517,Chang; Edmond Yi-Teh,0,6,28,28
1683734098973,MMW 15,B01,193519,Chang; Edmond Yi-Teh,0,5,28,28
1683734098973,MMW 15,B02,193520,Chang; Edmond Yi-Teh,0,5,28,28
1683734098973,MMW 15,B03,193521,Chang; Edmond Yi-Teh,0,5,28,28
1683734098973,MMW 15,B04,193522,Chang; Edmond Yi-Teh,0,6,28,28
1683734098973,MMW 15,B05,193523,Chang; Edmond Yi-Teh,0,5,28,28
1683734098973,MMW 15,B06,193524,Chang; Edmond Yi-Teh,0,5,28,28
1683734099998,MMW 122,A01,193526,Rahimi; Babak,0,16,28,28
1683734099998,MMW 122,A02,193527,Rahimi; Babak,0,15,28,28
1683734099998,MMW 122,A03,193528,Rahimi; Babak,0,0,0,0
1683734099998,MMW 122,A04,193529,Rahimi; Babak,0,0,0,0
1683734101021,MUS 1A,A01,186663,Staff,0,18,35,35
1683734102043,MUS 4,A01,186715,Staff,0,12,35,35
1683734103069,MUS 5R,A01,186796,Dubnov; Shlomo,0,17,35,35
1683734104091,MUS 6,A01,186798,Staff,0,4,25,25
1683734105122,MUS 7,A01,186830,Staff,11,0,35,24
1683734106149,MUS 8,A01,186930,Staff,0,27,35,35
1683734107174,MUS 15,A01,186932,Staff,0,15,35,35
1683734107174,MUS 15,B01,186934,Staff,0,16,35,35
1683734108203,MUS 80,A00,186935,Staff,0,0,20,20
1683734108203,MUS 80,B00,186936,Staff,24,0,25,1
1683734109228,NANO 11,A00,204702,Lipomi; Darren John,0,0,0,0
1683734110252,NANO 15,A01,204709,Yang; Kesong,0,1,0,0
1683734111280,NANO 114,A00,202069,Jahed Motlagh; Zeinab,2,0,10,8
1683734112302,PHIL 1,A00,186955,Grush; Rick Scott,31,0,40,9
1683734113325,PHIL 10,A01,186973,Grush; Rick Scott,27,0,35,8
1683734113325,PHIL 10,A02,186974,Grush; Rick Scott,33,0,35,2
1683734114354,PHIL 13,A01,186976,Staff,1,0,35,34
1683734114354,PHIL 13,A02,186977,Staff,16,0,35,19
1683734115378,PHIL 14,A01,186979,Staff,30,0,35,5
1683734115378,PHIL 14,A02,186986,Staff,32,0,35,3
1683734116405,PHIL 28,A01,186988,Staff,16,0,30,14
1683734116405,PHIL 28,A02,186989,Staff,0,0,30,30
1683734116405,PHIL 28,A03,186990,Staff,10,0,30,20
1683734116405,PHIL 28,A04,186991,Staff,26,0,30,4
1683734117432,PHIL 120,A00,186997,Staff,23,0,40,17
1683734118456,PHIL 137,A00,187003,Staff,8,0,40,32
1683734119481,PHIL 150,A00,187015,Staff,47,0,70,23
1683734120505,PHIL 167,A00,187021,Lamey; Andy M.,34,0,40,6
1683734121534,PHIL 174,A01,202226,Staff,17,0,20,3
1683734121534,PHIL 174,A02,202235,Staff,20,0,20,0
1683734122560,PHIL 191A,A00,258918,Staff,0,0,1,1
1683734123587,PHYS 1A,A00,187028,Staff,26,0,60,34
1683734124613,PHYS 1AL,001,187036,Staff,3,0,30,27
1683734124613,PHYS 1AL,002,187049,Staff,18,0,30,12
1683734125637,PHYS 1B,A00,187058,Staff,21,0,60,39
1683734126662,PHYS 1BL,001,187064,Staff,0,1,30,30
1683734126662,PHYS 1BL,002,187070,Staff,4,0,30,26
1683734127691,PHYS 1C,A00,187082,Staff,30,0,120,90
1683734128720,PHYS 1CL,001,187088,Staff,0,9,30,30
1683734128720,PHYS 1CL,002,187089,Staff,0,1,30,30
1683734128720,PHYS 1CL,009,262693,Staff,9,0,30,21
1683734129751,PHYS 2B,A01,187097,Staff,55,0,115,60
1683734130777,PHYS 2C,A01,187099,Staff,63,0,115,52
1683734131801,PHYS 2CL,A01,187101,Staff,5,0,28,23
1683734131801,PHYS 2CL,A02,187102,Staff,15,0,28,13
1683734132826,PHYS 2D,A01,187123,Shotwell; Brian,95,0,115,20
1683734133861,PHYS 4B,A01,187133,Grinstein; Benjamin,35,0,50,15
1683734134886,POLI 10,A00,188819,Staff,0,4,50,50
1683734135914,POLI 11,A00,188827,Staff,43,0,50,7
1683734136939,POLI 13R,A00,188828,Staff,0,2,20,20
1683734137968,POLI 27,A01,188830,Elgin; Samuel Zincke,0,2,70,70
1683734138995,POLI 30,A00,188832,Desposato; Scott,30,0,50,20
1683734140020,POLI 102F,A00,188834,Staff,1,0,40,39
1683734141045,POLI 104A,A00,188852,Staff,12,0,30,18
1683734142068,POLI 104I,A00,188853,Staff,0,8,20,20
1683734143093,POLI 110B,A00,188854,Wiens; David,6,0,20,14
1683734144117,POLI 112A,A00,188855,Wiens; David,3,0,30,27
1683734145144,POLI 117R,A00,188856,Forman; Fonna,0,12,20,20
1683734146168,POLI 118,A00,188857,Ingham; Sean,8,0,20,12
1683734147195,POLI 120G,A00,188858,Staff,7,0,30,23
1683734148220,POLI 131CR,A00,188863,Hoston; Germaine,20,0,50,30
1683734149244,POLI 133,A00,188864,Nellis; Gareth Hb,44,0,50,6
1683734150268,POLI 134D,A00,188865,Desposato; Scott,27,0,30,3
1683734151299,POLI 142A,A00,188871,Gartzke; Erik,21,0,50,29
1683734152326,POLI 142K,A00,188874,Staff,38,0,50,12
1683734153355,POLI 143,A00,188940,Gartzke; Erik,15,0,30,15
1683734154380,POLI 153,A00,188943,Staff,1,0,20,19
1683734155407,POLI 160AA,A00,188944,Staff,10,0,40,30
1683734156432,POLI 170A,A00,188945,Staff,10,0,30,20
1683734158480,PSYC 1,A00,188952,Staff,36,0,90,54
1683734159505,PSYC 2,B00,188953,Staff,19,0,35,16
1683734160529,PSYC 6,A00,188970,Staff,47,0,60,13
1683734161554,PSYC 7,A00,188973,Staff,35,0,45,10
1683734162584,PSYC 60,A01,188980,Rickard; Timothy C.,42,0,60,18
1683734163610,PSYC 70,A01,189001,Steiner; Eric Tomas,21,0,45,24
1683734164639,PSYC 100,A00,189005,Lacefield; Katharine I,1,98,120,119
1683734165664,PSYC 102,A00,189008,Staff,6,0,30,24
1683734166692,PSYC 106,B00,189026,Gorman; Michael R.,26,0,60,34
1683734167717,PSYC 114,B01,189033,Winkielman; Piotr,0,31,30,30
1683734168743,PSYC 131,A00,189036,Anagnostaras; Stephan,0,44,60,60
1683734169774,PSYC 136,A00,189041,Lowe; Angela Beth,0,7,25,25
1683734170800,PSYC 137,A00,189057,Winkielman; Piotr,0,36,25,25
1683734171824,PSYC 144,A00,189107,Wixted; John T,0,11,50,50
1683734173903,PSYC 162,A00,189142,Staff,0,9,85,85
1683734174927,PSYC 172,A00,189144,Gorman; Michael R.,0,6,30,30
1683734176979,PSYC 179,A00,189146,Lacefield; Katharine I,0,88,120,120
1683734178006,PSYC 181,A00,189147,Anagnostaras; Stephan,110,45,200,90
1683734179030,PSYC 190R,A00,189148,Barner; David A.,0,23,80,80
1683734180053,PSYC 191,A00,189275,Rickard; Timothy C.,0,11,25,25
1683734181080,PSYC 193,A00,189276,Chapman; Eddie Nathaniel,0,1,0,4
1683734182105,PSYC 193L,A01,189281,Lowe; Angela Beth,8,0,20,12
1683734182105,PSYC 193L,B01,189285,Staff,28,0,35,7
1683734183129,RELI 149,A00,187137,Rahimi; Babak,6,0,40,34
1683734184151,SE 9,A01,187315,Staff,0,2,18,18
1683734185176,SE 101B,A00,187409,Staff,24,0,30,6
1683734186260,SE 110B,A00,187444,Staff,10,0,40,30
1683734187284,SE 130B,A00,187449,Staff,31,0,40,9
1683734188306,SE 150A,A00,187516,Staff,8,0,20,12
1683734189332,SE 154,A00,187528,Staff,29,0,50,21
1683734190355,SIO 3,A01,258171,Staff,35,0,40,5
1683734191378,SIO 10,A00,187144,Cook; Geoffrey W,0,6,75,75
1683734192401,SIO 45,A00,187152,Cook; Geoffrey W,1,7,100,99
1683734193428,SIO 109R,A00,194486,Staff,0,4,20,20
1683734195479,SIO 187,A01,187233,Kacev; David,12,0,40,28
1683734196505,SOCI 1,A01,258656,Thorpe; Charles Robert,28,0,30,2
1683734196505,SOCI 1,A02,258658,Thorpe; Charles Robert,30,0,30,0
1683734196505,SOCI 1,A03,258661,Thorpe; Charles Robert,25,0,25,0
1683734196505,SOCI 1,A04,258666,Thorpe; Charles Robert,22,0,25,3
1683734196505,SOCI 1,A05,258897,Thorpe; Charles Robert,22,0,25,3
1683734196505,SOCI 1,A06,258898,Thorpe; Charles Robert,25,0,25,0
1683734197531,SOCI 30,A01,258903,Pardo Guerra; Juan Pablo,14,0,30,16
1683734198556,SOCI 102,A00,258904,Staff,9,0,25,16
1683734199580,SOCI 106,A00,258905,Staff,19,0,25,6
1683734200606,SOCI 111,A00,258907,Ribas Norris; Janet Vanesa,26,0,30,4
1683734201633,SOCI 121R,A00,258908,Pardo Guerra; Juan Pablo,7,0,30,23
1683734202661,SOCI 126,A01,203330,Staff,14,0,20,6
1683734203690,SOCI 131,A00,258909,Thorpe; Charles Robert,30,0,60,30
1683734204717,SOCI 135,A00,258910,Payne; Christine Anna,0,13,30,30
1683734205742,SOCI 157,A00,258911,Staff,10,0,30,20
1683734206769,SOCI 184,A00,258912,Staff,25,0,30,5
1683734207793,SOCI 188D,A00,258913,Staff,22,0,30,8
1683734208818,SYN 2,001,187529,Staff,9,0,16,7
1683734208818,SYN 2,002,201452,Staff,0,20,16,16
1683734208818,SYN 2,003,201469,Staff,1,0,16,15
1683734209843,SYN 100,A01,187531,Staff,0,9,20,20
1683734209843,SYN 100,B01,201491,Staff,0,10,20,20
1683734210872,TDAC 1,A00,189286,Walsh; Kim C.,3,0,20,17
1683734210872,TDAC 1,B00,189287,Harting; Carla Kelso,10,0,20,10
1683734211895,TDAC 101,A00,189300,Walsh; Kim C.,16,0,20,4
1683734211895,TDAC 101,B00,189301,Harting; Carla Kelso,18,0,20,2
1683734212921,TDAC 102,A00,189304,Basso; Beatrice,14,0,20,6
1683734213947,TDAC 108,A00,189305,Staff,18,0,20,2
1683734214974,TDDE 131,A00,189310,Staff,19,0,20,1
1683734214974,TDDE 131,B00,189314,Staff,19,0,20,1
1683734214974,TDDE 131,C00,189315,Staff,48,0,50,2
1683734214974,TDDE 131,D00,189316,Staff,14,0,15,1
1683734214974,TDDE 131,E00,204841,Staff,20,0,20,0
1683734215999,TDGE 10,A00,189289,Staff,26,0,50,24
1683734215999,TDGE 10,B00,189290,Havis; Allan,0,1,50,50
1683734217025,TDGE 11,A00,189291,Fulton; Julia,0,4,50,50
1683734217025,TDGE 11,B00,189292,Staff,20,0,25,5
1683734217025,TDGE 11,C00,260270,Staff,0,0,0,0
1683734218048,TDGE 25,A00,189294,Staff,1,0,20,19
1683734219071,TDGE 124,A00,189318,Fulton; Julia,0,7,50,50
1683734220100,TDGE 125,A00,189319,Staff,13,0,25,12
1683734220100,TDGE 125,B00,189320,Staff,23,0,25,2
1683734221129,TDGE 127,A00,189322,Havis; Allan,1,0,50,49
1683734222157,TDHT 101,A00,189323,Staff,18,0,25,7
1683734222157,TDHT 101,B00,189324,Staff,25,0,25,0
1683734223181,TDHT 102,A00,189325,Staff,49,0,50,1
1683734224206,TDMV 1,A00,189295,Arcidiacono; Kristin,20,0,30,10
1683734224206,TDMV 1,B00,189296,Caligagan; Maria T.,23,0,30,7
1683734225231,TDMV 2,A00,189297,Sammartano; Tonnie,27,0,30,3
1683734225231,TDMV 2,B00,189299,Arcidiacono; Kristin,23,0,30,7
1683734226257,TDMV 3,A00,204998,Rincon; Alicia,22,0,30,8
1683734227281,TDMV 120,A00,189458,Sammartano; Tonnie,28,0,30,2
1683734228305,TDMV 138,A00,189541,Jun; Grace Shin Hae,20,0,40,20
1683734229329,TDMV 142,A00,189717,Caligagan; Tony,25,0,30,5
1683734229329,TDMV 142,B00,189718,Caligagan; Maria T.,25,0,30,5
1683734230357,TMC 2,A01,187533,Staff,25,0,25,0
1683734230357,TMC 2,A02,187534,Staff,25,0,25,0
1683734231381,USP 1,A01,187536,Kwak; Nancy,0,16,25,25
1683734232409,USP 5,A01,187538,Staff,8,0,25,17
1683734233430,USP 101,A00,199253,Staff,0,4,0,0
1683734234455,USP 124,A00,187562,Boomhower; Matthew Charles,0,0,30,30
1683734235479,USP 138,A00,187582,Staff,19,0,25,6
1683734236507,USP 152,A01,187597,Staff,3,0,25,22
1683734237534,USP 153,A00,187598,Staff,18,0,25,7
1683734238560,USP 168,A00,187607,Kwak; Nancy,2,0,5,3
1683734239586,USP 173,A00,187619,Staff,4,0,25,21
1683734240613,USP 181,A00,187638,Staff,0,4,25,25
1683734241640,VIS 103,A00,187650,Cruz; Edwin Teddy,17,0,75,58
1683734242663,VIS 110D,A00,187669,Staff,13,0,22,9
1683734243687,VIS 127C,A00,187720,Shen; Kuiyi,67,0,146,79
1683734244715,VIS 149,A00,187731,Yoldas; Pinar,0,12,22,22
1683734245740,VIS 151,A01,188091,Staff,22,0,34,12
1683734245740,VIS 151,A02,188092,Staff,11,0,34,23
1683734246766,VIS 160B,A00,188093,Stalbaum; Brett,0,1,10,10
1683734248816,WCWP 10B,A00,201720,Staff,0,0,5,5
1683734248816,WCWP 10B,B00,201722,Staff,0,0,6,6
1683734249843,WCWP 100,A00,201725,Gagnon; Jeffrey C,0,0,2,2
1683734249843,WCWP 100,B00,201727,Staff,0,4,15,15
1683734252933,ANBI 133,A00,258401,Wilder; Linnea Lorene,34,0,40,6
1683734253961,ANBI 140,A00,258395,Hrvoj Mihic; Branka,18,0,25,7
1683734254985,ANSC 120,A00,258402,Bialecki; Jon Anthony,26,0,40,14
1683734256010,ANSC 144,A00,258400,Staff,12,0,40,28
1683734258058,ANSC 166,A00,258396,Parish; Steven Martin,156,0,175,19
1683734259083,ANSC 180,A00,193533,Staff,8,0,20,12
1683734260110,ANSC 188,A00,258397,Jassal; Aftab,34,0,40,6
1683734261137,ANTH 3,A01,258316,Staff,23,0,30,7
1683734262165,ANTH 5,A00,258394,Semendeferi; Ekaterini,16,0,20,4
1683734263192,ANTH 21,A01,258331,Staff,4,0,40,36
1683734264220,ANTH 103,A00,258398,Varma; Saiba,15,0,25,10
1683734265247,AWP 10,001,202034,Staff,0,0,0,0
1683734265247,AWP 10,002,202035,Staff,0,0,0,0
1683734265247,AWP 10,003,202036,Staff,0,0,0,0
1683734265247,AWP 10,004,202037,Staff,0,0,0,0
1683734265247,AWP 10,005,202038,Staff,0,0,0,0
1683734265247,AWP 10,006,202039,Staff,0,0,0,0
1683734265247,AWP 10,007,202040,Staff,0,0,0,0
1683734265247,AWP 10,008,202041,Staff,0,0,0,0
1683734265247,AWP 10,009,202042,Staff,0,0,0,0
1683734265247,AWP 10,010,202043,Staff,0,0,0,0
1683734265247,AWP 10,011,202044,Staff,0,0,0,0
1683734265247,AWP 10,012,202045,Staff,0,0,0,0
1683734265247,AWP 10,013,202046,Staff,0,0,0,0
1683734265247,AWP 10,014,202047,Staff,0,0,0,0
1683734265247,AWP 10,015,202048,Staff,0,0,0,0
1683734265247,AWP 10,016,202049,Staff,0,0,0,0
1683734265247,AWP 10,017,202050,Staff,0,0,0,0
1683734265247,AWP 10,018,202051,Staff,0,0,0,0
1683734265247,AWP 10,019,202052,Staff,0,0,0,0
1683734265247,AWP 10,020,202053,Staff,0,0,0,0
1683734265247,AWP 10,021,202054,Staff,0,0,0,0
1683734265247,AWP 10,022,202055,Staff,0,0,0,0
1683734265247,AWP 10,023,202056,Staff,0,0,0,0
1683734265247,AWP 10,024,202057,Staff,0,0,0,0
1683734265247,AWP 10,025,202058,Staff,0,0,0,0
1683734265247,AWP 10,026,202059,Staff,0,0,0,0
1683734266274,AWP 102,001,202032,Staff,0,0,0,0
1683734266274,AWP 102,002,202033,Staff,0,0,0,0
1683734267299,BENG 100,A01,254234,Taylor Amos; Alyssa C,31,0,40,9
1683734268325,BENG 196,001,270013,Engler; Adam J.,9999,0,9999,0
1683734269350,BICD 100R,A01,202018,Smith; Laurie,0,7,32,32
1683734269350,BICD 100R,A02,202019,Smith; Laurie,0,3,32,32
1683734269350,BICD 100R,A03,202020,Smith; Laurie,0,1,32,32
1683734269350,BICD 100R,A04,202021,Smith; Laurie,6,0,32,26
1683734269350,BICD 100R,A05,202022,Smith; Laurie,10,0,32,22
1683734270378,BICD 136,A01,193242,Gustafson-Brown; Cindy,0,2,32,32
1683734270378,BICD 136,A02,193244,Gustafson-Brown; Cindy,13,0,32,19
1683734271403,BIEB 102,A01,193249,Butler; Shannon Rhey,0,0,32,32
1683734271403,BIEB 102,A02,193251,Butler; Shannon Rhey,0,0,32,32
1683734271403,BIEB 102,A03,193253,Butler; Shannon Rhey,0,0,32,32
1683734271403,BIEB 102,A04,193255,Butler; Shannon Rhey,13,0,32,19
1683734271403,BIEB 102,A05,193265,Butler; Shannon Rhey,25,0,32,7
1683734271403,BIEB 102,A06,193269,Butler; Shannon Rhey,12,0,32,20
1683734273466,BIEB 150,A01,193274,Staff,0,0,32,32
1683734273466,BIEB 150,A02,193285,Staff,24,0,32,8
1683734274494,BIEB 194,A00,193286,Kurle; Carolyn M.,19,0,32,13
1683734275519,BILD 1,A01,192291,Staff,15,0,32,17
1683734275519,BILD 1,A02,192292,Staff,30,0,32,2
1683734275519,BILD 1,B01,192520,Reuther; Keefe,0,1,0,0
1683734275519,BILD 1,B02,192532,Reuther; Keefe,0,1,0,0
1683734276550,BILD 3,A01,192556,Butler; Shannon Rhey,0,0,32,32
1683734276550,BILD 3,A02,192581,Butler; Shannon Rhey,0,1,32,32
1683734276550,BILD 3,A03,192611,Butler; Shannon Rhey,19,0,32,13
1683734276550,BILD 3,A04,192612,Butler; Shannon Rhey,23,0,32,9
1683734276550,BILD 3,A05,192613,Butler; Shannon Rhey,26,0,32,6
1683734276550,BILD 3,A06,192679,Butler; Shannon Rhey,27,0,32,5
1683734276550,BILD 3,A07,192682,Butler; Shannon Rhey,20,0,32,12
1683734277582,BILD 4,A01,192836,Reuther; Keefe,1,0,24,23
1683734277582,BILD 4,A02,193044,Reuther; Keefe,4,0,24,20
1683734278606,BILD 10,A01,193142,Gustafson-Brown; Cindy,29,0,32,3
1683734278606,BILD 10,A02,193149,Gustafson-Brown; Cindy,31,0,32,1
1683734279632,BIMM 100,A01,193301,Staff,0,6,32,32
1683734279632,BIMM 100,A02,193312,Staff,0,7,32,32
1683734279632,BIMM 100,A03,193323,Staff,0,10,32,32
1683734280658,BIMM 101,A01,193329,McDonnell; Lisa Marie,0,3,24,24
1683734280658,BIMM 101,A02,193339,McDonnell; Lisa Marie,0,3,24,24
1683734280658,BIMM 101,B01,193354,McDonnell; Lisa Marie,0,4,24,24
1683734280658,BIMM 101,B02,193357,McDonnell; Lisa Marie,0,3,24,24
1683734281686,BIMM 110,A01,193377,Tat; John,0,11,32,32
1683734281686,BIMM 110,A02,193378,Tat; John,0,11,32,32
1683734282711,BIMM 120,A01,206116,Staff,1,0,32,31
1683734282711,BIMM 120,A02,206117,Staff,7,0,32,25
1683734282711,BIMM 120,A03,206121,Staff,21,0,32,11
1683734283740,BIPN 100,A01,193393,Park; Ji Young,0,15,32,32
1683734283740,BIPN 100,A02,193402,Park; Ji Young,0,14,32,32
1683734283740,BIPN 100,A03,193413,Park; Ji Young,0,14,32,32
1683734283740,BIPN 100,A04,193414,Park; Ji Young,0,13,32,32
1683734284767,BIPN 102,A01,193429,Staff,0,0,32,32
1683734284767,BIPN 102,A02,193438,Staff,18,0,32,14
1683734285791,BIPN 106,A01,193450,Reyes Gonzalez; Catalina,0,2,40,40
1683734286817,BIPN 134,A01,193465,Cooke; James Edward,0,0,32,32
1683734286817,BIPN 134,A02,193474,Cooke; James Edward,24,0,32,8
1683734286817,BIPN 134,A03,193485,Cooke; James Edward,29,0,32,3
1683734286817,BIPN 134,A04,193486,Cooke; James Edward,20,0,32,12
1683734286817,BIPN 134,A05,193491,Cooke; James Edward,31,0,32,1
1683734286817,BIPN 134,A06,193501,Cooke; James Edward,30,0,32,2
1683734286817,BIPN 134,A07,193510,Cooke; James Edward,29,0,32,3
1683734288876,BISP 194,A00,222522,Staff,14,0,32,18
1683734289984,CAT 124,A01,202407,Staff,19,0,25,6
1683734291007,CAT 125,A00,202408,Marchisotto; Jennifer Anne,2,0,20,18
1683734292033,CAT 125R,A00,202409,Smith; Lauryn Alissa,0,11,20,20
1683734292033,CAT 125R,B00,202410,Morales; Celeste Georgianna,0,11,20,20
1683734292033,CAT 125R,C00,202411,Irwin; Matthew Joseph,0,12,20,20
1683734293062,CENG 15,A01,204712,Yang; Kesong,0,1,0,0
1683734294089,CENG 114,A00,202070,Jahed Motlagh; Zeinab,5,0,20,15
1683734295116,CGS 105,A00,185477,Wesling; Megan E.,24,0,40,16
1683734296143,CGS 106,A00,185494,Staff,11,0,22,11
1683734297170,CGS 108,A00,185495,Staff,14,0,20,6
1683734298196,CGS 114,A00,185496,Staff,13,0,18,5
1683734299223,CGS 119,A00,185501,Staff,15,0,20,5
1683734300247,CGS 120,A00,185511,Staff,11,0,20,9
1683734301276,CHEM 4,A01,184675,Bussey; Thomas J,97,0,100,3
1683734302303,CHEM 6A,A01,184677,Staff,32,0,60,28
1683734303329,CHEM 6B,A01,184679,Staff,63,0,100,37
1683734304355,CHEM 6C,A01,184681,Bussey; Thomas J,0,0,50,50
1683734304355,CHEM 6C,A02,184682,Bussey; Thomas J,32,0,50,18
1683734305379,CHEM 40A,A01,184684,Albizati; Kim F.,33,0,100,67
1683734306408,CHEM 40B,A01,184686,Albizati; Kim F.,0,22,100,100
1683734307433,CHEM 41B,A01,184690,Staff,51,0,100,49
1683734308457,COGS 3,A01,184715,Boyle; Mary E. T.,0,27,40,40
1683734309485,COGS 14B,A01,185172,Staff,0,14,38,38
1683734310508,COGS 18,A01,184736,Staff,14,0,80,66
1683734311532,COGS 100,A01,184932,Staff,0,8,73,73
1683734312557,COGS 101A,A01,184935,Staff,0,40,30,30
1683734313587,COGS 101B,A01,184944,Staff,0,2,30,30
1683734314615,COGS 101C,A01,184946,Staff,0,10,30,30
1683734315643,COGS 102A,A01,184951,Johnson; Christine M.,1,0,40,39
1683734316667,COGS 107B,A01,184953,Mooshagian; Eric Frederick,0,52,40,40
1683734317698,COGS 118B,A01,184959,Gupta; Anjum,0,50,40,40
1683734318726,COGS 153,A00,184961,Staff,1,16,30,29
1683734319752,COGS 177,A00,184962,Staff,0,20,30,30
1683734320775,COGS 187A,A01,184969,Boyle; Mary E. T.,0,19,40,40
1683734321800,COMM 10,A01,185174,Staff,0,5,25,25
1683734321800,COMM 10,A02,185189,Staff,0,2,25,25
1683734321800,COMM 10,A03,269821,Staff,0,1,0,0
1683734322826,COMM 100B,A02,185476,Staff,10,0,25,15
1683734322826,COMM 100B,A03,277340,Staff,25,0,25,0
1683734323851,COMM 100C,A01,185314,Staff,2,0,25,23
1683734323851,COMM 100C,A02,185327,Staff,17,0,25,8
1683734324875,COMM 110M,A00,185349,Staff,0,0,40,40
1683734325899,COMM 113T,A00,185352,Staff,25,0,40,15
1683734326925,COMM 114I,A00,185353,Staff,31,0,40,9
1683734327949,COMM 131,A00,185354,Staff,17,0,30,13
1683734328973,CSE 8A,A50,185358,Cao; Yingjun,0,46,10,10
1683734330004,CSE 8B,A01,185362,Staff,0,48,50,50
1683734331031,CSE 11,A01,185416,Cao; Yingjun,0,91,10,10
1683734332056,CSE 20,A01,185445,Briones; Jor-el Thomas Caparas,3,0,25,22
1683734333080,CSE 21,A01,185447,Staff,9,0,50,41
1683734334110,CSE 101,A01,185451,Staff,0,13,50,50
1683734334110,CSE 101,B01,185453,Jones; Miles E,0,15,50,50
1683734336165,CSE 141,A01,185458,Eldon; John,16,0,100,84
1683734337193,CSE 141L,A01,185461,Eldon; John,8,0,100,92
1683734338219,CSE 142,A01,185463,Staff,34,0,60,26
1683734338219,CSE 142,B01,201355,Staff,0,7,60,60
1683734339244,CSE 142L,A01,185470,Staff,34,0,60,26
1683734339244,CSE 142L,B01,201417,Staff,0,6,60,60
1683734340268,CSE 190,A00,201433,Staff,32,0,49,17
1683734341293,DOC 1,A01,259136,Strom; Megan C.,7,0,15,8
1683734341293,DOC 1,A02,259137,Strom; Megan C.,15,0,15,0
1683734341293,DOC 1,A03,259138,Strom; Megan C.,14,0,15,1
1683734341293,DOC 1,A04,259139,Strom; Megan C.,13,0,15,2
1683734342317,DOC 100D,A00,259140,Pass; Natalye Joann,14,0,25,11
1683734343348,DSGN 1,A01,184749,Rill; Bryan,0,26,30,30
1683734344372,DSGN 100,A01,185168,Staff,0,2,25,25
1683734345400,ECE 5,A01,185626,Morris; Karcher William,0,12,0,0
1683734346423,ECE 101,A01,185628,Staff,14,0,70,56
1683734347447,ECE 107,A01,185635,Baghdadchi; Saharnaz,0,0,20,20
1683734347447,ECE 107,A02,185638,Baghdadchi; Saharnaz,1,0,20,19
1683734348474,ECE 148,A01,185647,Silberman; Jack,0,0,16,16
1683734349498,ECON 1,A01,185537,Crane; Meredith Helen,54,0,70,16
1683734350522,ECON 3,A01,185549,Crane; Meredith Helen,30,0,70,40
1683734351549,ECON 4,A01,203354,Anderson; John Charles,0,5,10,10
1683734352574,ECON 100A,A01,185574,Staff,0,5,40,40
1683734353599,ECON 100B,A01,185576,Staff,0,12,50,50
1683734354624,ECON 100C,A01,185589,Newhouse; Herbert S,30,0,70,40
1683734355651,ECON 105,A00,185608,Vespa; Emanuel Ignacio,19,0,35,16
1683734356681,ECON 109,A01,185610,Shishkin; Denis,9,0,35,26
1683734357706,ECON 110A,A01,185612,Staff,8,0,40,32
1683734358731,ECON 120A,A01,185615,Staff,19,0,40,21
1683734359759,ECON 120C,A01,185617,Sun; Yixiao,0,21,70,70
1683734360783,ECON 144,A00,203346,Squires; Dale E,2,0,35,33
1683734361806,ECON 171,A01,203349,Newhouse; Herbert S,0,1,35,35
1683734362834,ECON 173A,A01,185621,Toda; Alexis Akira,21,0,35,14
1683734363870,EDS 25,A01,202413,Staff,0,1,0,0
1683734363870,EDS 25,A02,202414,Staff,0,1,0,0
1683734363870,EDS 25,A03,202415,Staff,0,0,0,0
1683734363870,EDS 25,A04,202416,Staff,0,1,0,0
1683734363870,EDS 25,A05,202439,Staff,0,0,0,0
1683734363870,EDS 25,A06,202440,Staff,0,0,0,0
1683734363870,EDS 25,B01,202631,Staff,0,0,0,0
1683734363870,EDS 25,B02,202632,Staff,0,0,0,0
1683734363870,EDS 25,B03,202639,Staff,0,0,0,0
1683734363870,EDS 25,B04,202640,Staff,0,0,0,0
1683734363870,EDS 25,B05,202643,Staff,0,0,0,0
1683734363870,EDS 25,B06,202644,Staff,0,0,0,0
1683734364894,EDS 38,A01,202659,Black; Alison Michelle,25,0,25,0
1683734365922,EDS 115,A00,202652,Staff,18,0,30,12
1683734366950,EDS 125,A00,202649,Staff,13,0,30,17
1683734367977,EDS 126,A01,203332,Staff,30,0,30,0
1683734369000,EDS 139,A00,202838,Staff,16,0,25,9
1683734370033,EDS 146,A01,202655,Staff,14,0,25,11
1683734371061,ENG 15,A00,185667,Staff,0,1,0,2
1683734371061,ENG 15,B00,185672,Staff,0,0,0,1
1683734371061,ENG 15,C00,185675,Staff,0,0,0,0
1683734371061,ENG 15,D00,185682,Staff,0,0,0,0
1683734371061,ENG 15,E00,185684,Staff,0,0,0,0
1683734372085,ETHN 103,A00,185710,Staff,0,8,35,35
1683734373113,ETHN 103A,A00,199228,Man; Simeon S,0,0,9,9
1683734374137,ETHN 109,A00,185711,Staff,15,0,35,20
1683734375165,ETHN 142,A00,185726,Staff,0,4,30,30
1683734376192,ETHN 163J,A00,199229,Man; Simeon S,5,0,8,3
1683734377214,ETHN 168,A00,185727,Staff,7,0,10,3
1683734378237,ETHN 182,A00,185728,Staff,0,0,35,35
1683734379265,ETHN 183,A00,185737,Staff,10,0,18,8
1683734380290,GLBH 111,A01,209361,Burgos; Jose L.,0,0,0,0
1683734382341,HIEU 104,A00,185792,Staff,14,0,20,6
1683734383366,HIEU 115,A00,185800,Staff,0,0,20,20
1683734384389,HIEU 128,A00,185801,Staff,0,9,20,20
1683734385416,HIEU 147,A00,185802,Staff,15,0,20,5
1683734386441,HIEU 154,A00,185823,Staff,11,0,20,9
1683734387466,HILA 102,A00,185826,Staff,14,0,20,6
1683734388493,HILD 2C,A01,185778,Staff,0,13,20,20
1683734389518,HILD 7B,A01,185780,Kwak; Nancy,0,17,32,32
1683734389518,HILD 7B,A02,185781,Kwak; Nancy,0,18,32,32
1683734390543,HILD 30,A01,185791,Staff,12,0,20,8
1683734391567,HISC 119,A00,185830,Golan; Tal,0,10,20,20
1683734392592,HITO 156GS,A00,185831,Patterson; Patrick H.,0,0,0,23
1683734393679,HIUS 103,A00,185832,Man; Simeon S,0,4,20,20
1683734394712,HIUS 117,A00,185836,Kwak; Nancy,2,0,20,18
1683734395735,HIUS 125,A00,185840,Man; Simeon S,0,2,23,23
1683734396759,HIUS 149,A00,185845,Staff,1,0,20,19
1683734397786,HUM 3,A01,185882,Zavodny; Tatiana Sophia,0,8,50,50
1683734397786,HUM 3,B01,185899,Caldwell; Michael Alan,0,18,50,50
1683734398836,HUM 3GS,A00,185900,Patterson; Patrick H.,0,0,0,23
1683734399862,HUM 4,A01,185938,Zroka; Amy Liane,28,0,50,22
1683734399862,HUM 4,B01,185956,Watkins; Eric,0,6,50,50
1683734399862,HUM 4,B02,202209,Watkins; Eric,0,6,50,50
1683734399862,HUM 4,B03,202210,Watkins; Eric,0,5,50,50
1683734400890,HUM 5,A01,185958,West; Geoffrey Scott,0,0,50,50
1683734400890,HUM 5,A02,202215,West; Geoffrey Scott,0,1,50,50
1683734401914,INTL 190,A00,185959,Gagnon; Jeffrey C,0,0,0,9
1683734401914,INTL 190,B00,185960,Lettieri; Michael Joseph,0,0,0,2
1683734402939,JAPN 180,A00,254509,Staff,4,0,30,26
1683734403965,LATI 10,A01,202853,Kennemore; Amy Michelle,4,0,35,31
1683734403965,LATI 10,A02,202854,Kennemore; Amy Michelle,3,0,35,32
1683734403965,LATI 10,A03,270054,Kennemore; Amy Michelle,30,0,30,0
1683734404991,LATI 180,A00,202855,Kennemore; Amy Michelle,11,0,20,9
1683734406015,LAWS 101,A00,201767,Golan; Tal,0,7,40,40
1683734407042,LIFR 1C,A00,185961,Staff,6,0,20,14
1683734408079,LIFR 1CX,A00,185962,Staff,7,0,20,13
1683734409103,LIFR 1D,A00,185963,Staff,7,0,20,13
1683734410128,LIFR 1DX,A00,185964,Staff,7,0,20,13
1683734411154,LIGN 101,A01,186039,Staff,43,0,50,7
1683734412181,LIGN 165,A00,186040,Staff,14,0,50,36
1683734413205,LTCS 108,A00,186041,Staff,5,0,10,5
1683734414228,LTCS 119,A00,186042,Staff,15,0,20,5
1683734415252,LTCS 130,A00,186043,Wesling; Megan E.,15,0,25,10
1683734417301,LTEA 138,A00,186119,Staff,13,0,40,27
1683734418325,LTEN 124,A00,186148,Staff,5,0,25,20
1683734419353,LTEN 178,A00,186149,Staff,6,0,15,9
1683734420381,LTEN 181,A00,186150,Blanco; John D,34,0,40,6
1683734421404,LTWL 120,A00,186160,Staff,19,0,25,6
1683734422430,LTWL 165,A00,186161,Staff,22,0,25,3
1683734423453,LTWR 100,A00,186162,Staff,0,5,15,15
1683734424479,LTWR 102,A00,186163,Doller; Ben,5,0,15,10
1683734425503,MAE 8,A01,186412,Staff,0,1,0,1
1683734426528,MAE 30B,A00,186445,Bahadori; Mohammad Yousef,81,0,100,19
1683734427552,MAE 40,A00,186592,Bewley; Thomas R,10,0,50,40
1683734428577,MAE 101B,A00,186593,Bahadori; Mohammad Yousef,80,0,100,20
1683734429601,MAE 105,A00,186594,Bandaru; Prabhakar,10,0,50,40
1683734430624,MAE 107,A00,186599,Pham; Hieu Tan,0,8,120,120
1683734431648,MAE 148,A01,186660,Silberman; Jack,3,0,16,13
1683734432671,MATH 10A,A01,188095,Staff,0,6,35,35
1683734433696,MATH 10B,A01,188097,Bowers; Adam R.,0,12,30,30
1683734433696,MATH 10B,A02,188099,Bowers; Adam R.,0,11,30,30
1683734433696,MATH 10B,B01,188104,Bowers; Adam R.,0,10,30,30
1683734433696,MATH 10B,B02,188106,Bowers; Adam R.,0,9,30,30
1683734434726,MATH 10C,A01,188111,Staff,0,20,30,30
1683734434726,MATH 10C,A02,188127,Staff,0,19,30,30
1683734434726,MATH 10C,A03,188131,Staff,0,19,30,30
1683734434726,MATH 10C,B01,188218,Staff,17,0,30,13
1683734434726,MATH 10C,B02,188244,Staff,13,0,30,17
1683734434726,MATH 10C,B03,188277,Staff,14,0,30,16
1683734435751,MATH 18,A01,188344,Bach; Quang Tran,18,0,30,12
1683734435751,MATH 18,A02,188345,Bach; Quang Tran,11,0,30,19
1683734435751,MATH 18,B01,188353,Bach; Quang Tran,11,0,30,19
1683734435751,MATH 18,B02,188354,Bach; Quang Tran,19,0,30,11
1683734436779,MATH 20A,A01,188374,Staff,10,0,35,25
1683734437806,MATH 20B,A01,188382,Ohm; Ko Woon,7,0,30,23
1683734437806,MATH 20B,A02,188383,Ohm; Ko Woon,22,0,30,8
1683734437806,MATH 20B,B01,188385,Ohm; Ko Woon,7,0,30,23
1683734437806,MATH 20B,B02,188392,Ohm; Ko Woon,22,0,30,8
1683734438832,MATH 20C,A01,188394,Harel; Guershon,10,0,30,20
1683734438832,MATH 20C,A02,188395,Harel; Guershon,13,0,30,17
1683734438832,MATH 20C,B01,188404,Harel; Guershon,5,0,30,25
1683734438832,MATH 20C,B02,188405,Harel; Guershon,18,0,30,12
1683734439856,MATH 20D,A01,188414,Hammock; Frances H,0,1,30,30
1683734439856,MATH 20D,A02,188415,Hammock; Frances H,0,1,30,30
1683734439856,MATH 20D,B01,188447,Hammock; Frances H,0,1,30,30
1683734439856,MATH 20D,B02,188486,Hammock; Frances H,2,0,30,28
1683734440885,MATH 20E,A01,188649,Staff,21,0,30,9
1683734440885,MATH 20E,A02,188650,Staff,20,0,30,10
1683734440885,MATH 20E,A03,188673,Staff,0,0,30,30
1683734441909,MATH 102,A01,188675,Staff,0,40,35,35
1683734442934,MATH 103B,A01,188681,Staff,3,0,35,32
1683734442934,MATH 103B,B01,188692,Staff,5,0,35,30
1683734443958,MATH 109,A01,188695,Salehi Golsefidy; Alireza,24,0,35,11
1683734443958,MATH 109,A02,188696,Salehi Golsefidy; Alireza,24,0,35,11
1683734444986,MATH 120A,A01,188698,Eggers; John Dietrich,7,0,35,28
1683734446014,MATH 142B,A01,188736,Ioana; Adrian,0,0,30,30
1683734446014,MATH 142B,A02,188741,Ioana; Adrian,0,1,30,30
1683734446014,MATH 142B,A03,188743,Ioana; Adrian,0,3,30,30
1683734447039,MATH 168A,A01,188790,Staff,0,11,35,35
1683734448063,MATH 170A,A01,188803,Nie; Jiawang,0,2,35,35
1683734448063,MATH 170A,A02,188811,Nie; Jiawang,0,1,35,35
1683734448063,MATH 170A,A03,188814,Nie; Jiawang,1,0,35,34
1683734448063,MATH 170A,A04,188815,Nie; Jiawang,5,0,35,30
1683734449090,MATH 193B,A01,188817,Staff,0,0,35,35
1683734449090,MATH 193B,A02,188818,Staff,6,0,35,29
1683734450120,MGT 4,A01,202857,Anderson; John Charles,59,0,80,21
1683734451144,MGT 12,A00,202858,Lindenberger; Wade Douglas,40,0,90,50
1683734452168,MGT 18,A00,202859,Staff,73,0,90,17
1683734453194,MGT 18GS,A00,202860,McKay; Michael J,13,0,28,15
1683734454219,MGT 45,A00,202861,Pecore; Joseph P.,8,0,90,82
1683734455243,MGT 100,A00,202863,Yavorsky; Daniel Ryan,27,0,90,63
1683734456266,MGT 103,A00,202864,Ehrich; Kristine R,0,19,90,90
1683734457290,MGT 112,A00,202865,Ehrich; Kristine R,15,0,90,75
1683734458313,MGT 121A,A00,202868,Staff,70,0,90,20
1683734459341,MGT 131B,A00,202869,Anderson; John Charles,58,0,90,32
1683734460366,MGT 136,A00,202871,Lindenberger; Wade Douglas,83,0,90,7
1683734461388,MGT 164,A00,202873,Staff,0,67,90,91
1683734462417,MGT 164GS,A00,202874,McKay; Mary A,13,0,28,15
1683734463441,MGT 180,A00,202875,Staff,0,51,90,91
1683734464471,MMW 11R,A01,205019,Herbst; Matthew,0,0,30,30
1683734464471,MMW 11R,A02,205026,Herbst; Matthew,29,0,30,1
1683734465503,MMW 15,A01,193512,Chang; Edmond Yi-Teh,0,8,28,28
1683734465503,MMW 15,A02,193513,Chang; Edmond Yi-Teh,0,5,28,28
1683734465503,MMW 15,A03,193514,Chang; Edmond Yi-Teh,0,5,28,28
1683734465503,MMW 15,A04,193515,Chang; Edmond Yi-Teh,0,5,28,28
1683734465503,MMW 15,A05,193516,Chang; Edmond Yi-Teh,0,5,28,28
1683734465503,MMW 15,A06,193517,Chang; Edmond Yi-Teh,0,6,28,28
1683734465503,MMW 15,B01,193519,Chang; Edmond Yi-Teh,0,5,28,28
1683734465503,MMW 15,B02,193520,Chang; Edmond Yi-Teh,0,5,28,28
1683734465503,MMW 15,B03,193521,Chang; Edmond Yi-Teh,0,5,28,28
1683734465503,MMW 15,B04,193522,Chang; Edmond Yi-Teh,0,6,28,28
1683734465503,MMW 15,B05,193523,Chang; Edmond Yi-Teh,0,5,28,28
1683734465503,MMW 15,B06,193524,Chang; Edmond Yi-Teh,0,5,28,28
1683734466537,MMW 122,A01,193526,Rahimi; Babak,0,16,28,28
1683734466537,MMW 122,A02,193527,Rahimi; Babak,0,15,28,28
1683734466537,MMW 122,A03,193528,Rahimi; Babak,0,0,0,0
1683734466537,MMW 122,A04,193529,Rahimi; Babak,0,0,0,0
1683734467568,MUS 1A,A01,186663,Staff,0,18,35,35
1683734468592,MUS 4,A01,186715,Staff,0,12,35,35
1683734469617,MUS 5R,A01,186796,Dubnov; Shlomo,0,17,35,35
1683734470645,MUS 6,A01,186798,Staff,0,4,25,25
1683734471669,MUS 7,A01,186830,Staff,11,0,35,24
1683734472692,MUS 8,A01,186930,Staff,0,27,35,35
1683734473721,MUS 15,A01,186932,Staff,0,15,35,35
1683734473721,MUS 15,B01,186934,Staff,0,16,35,35
1683734474748,MUS 80,A00,186935,Staff,0,0,20,20
1683734474748,MUS 80,B00,186936,Staff,24,0,25,1
1683734475773,NANO 11,A00,204702,Lipomi; Darren John,0,0,0,0
1683734476800,NANO 15,A01,204709,Yang; Kesong,0,1,0,0
1683734477829,NANO 114,A00,202069,Jahed Motlagh; Zeinab,2,0,10,8
1683734478857,PHIL 1,A00,186955,Grush; Rick Scott,31,0,40,9
1683734479890,PHIL 10,A01,186973,Grush; Rick Scott,27,0,35,8
1683734479890,PHIL 10,A02,186974,Grush; Rick Scott,33,0,35,2
1683734480914,PHIL 13,A01,186976,Staff,1,0,35,34
1683734480914,PHIL 13,A02,186977,Staff,16,0,35,19
1683734481938,PHIL 14,A01,186979,Staff,30,0,35,5
1683734481938,PHIL 14,A02,186986,Staff,32,0,35,3
1683734482965,PHIL 28,A01,186988,Staff,16,0,30,14
1683734482965,PHIL 28,A02,186989,Staff,0,0,30,30
1683734482965,PHIL 28,A03,186990,Staff,10,0,30,20
1683734482965,PHIL 28,A04,186991,Staff,26,0,30,4
1683734483990,PHIL 120,A00,186997,Staff,23,0,40,17
1683734485016,PHIL 137,A00,187003,Staff,8,0,40,32
1683734486044,PHIL 150,A00,187015,Staff,47,0,70,23
1683734487073,PHIL 167,A00,187021,Lamey; Andy M.,34,0,40,6
1683734488100,PHIL 174,A01,202226,Staff,17,0,20,3
1683734488100,PHIL 174,A02,202235,Staff,20,0,20,0
1683734489126,PHIL 191A,A00,258918,Staff,0,0,1,1
1683734490150,PHYS 1A,A00,187028,Staff,26,0,60,34
1683734491177,PHYS 1AL,001,187036,Staff,3,0,30,27
1683734491177,PHYS 1AL,002,187049,Staff,18,0,30,12
1683734492206,PHYS 1B,A00,187058,Staff,21,0,60,39
1683734493232,PHYS 1BL,001,187064,Staff,0,1,30,30
1683734493232,PHYS 1BL,002,187070,Staff,4,0,30,26
1683734494256,PHYS 1C,A00,187082,Staff,30,0,120,90
1683734495285,PHYS 1CL,001,187088,Staff,0,9,30,30
1683734495285,PHYS 1CL,002,187089,Staff,0,1,30,30
1683734495285,PHYS 1CL,009,262693,Staff,9,0,30,21
1683734496310,PHYS 2B,A01,187097,Staff,55,0,115,60
1683734497390,PHYS 2C,A01,187099,Staff,63,0,115,52
1683734498419,PHYS 2CL,A01,187101,Staff,5,0,28,23
1683734498419,PHYS 2CL,A02,187102,Staff,15,0,28,13
1683734499443,PHYS 2D,A01,187123,Shotwell; Brian,95,0,115,20
1683734500472,PHYS 4B,A01,187133,Grinstein; Benjamin,35,0,50,15
1683734501495,POLI 10,A00,188819,Staff,0,4,50,50
1683734502525,POLI 11,A00,188827,Staff,43,0,50,7
1683734503551,POLI 13R,A00,188828,Staff,0,2,20,20
1683734504577,POLI 27,A01,188830,Elgin; Samuel Zincke,0,2,70,70
1683734505601,POLI 30,A00,188832,Desposato; Scott,30,0,50,20
1683734506625,POLI 102F,A00,188834,Staff,1,0,40,39
1683734507650,POLI 104A,A00,188852,Staff,12,0,30,18
1683734508677,POLI 104I,A00,188853,Staff,0,8,20,20
1683734509702,POLI 110B,A00,188854,Wiens; David,6,0,20,14
1683734510731,POLI 112A,A00,188855,Wiens; David,3,0,30,27
1683734511757,POLI 117R,A00,188856,Forman; Fonna,0,12,20,20
1683734512781,POLI 118,A00,188857,Ingham; Sean,8,0,20,12
1683734513805,POLI 120G,A00,188858,Staff,7,0,30,23
1683734514830,POLI 131CR,A00,188863,Hoston; Germaine,20,0,50,30
1683734515854,POLI 133,A00,188864,Nellis; Gareth Hb,44,0,50,6
1683734516878,POLI 134D,A00,188865,Desposato; Scott,27,0,30,3
1683734517901,POLI 142A,A00,188871,Gartzke; Erik,21,0,50,29
1683734518927,POLI 142K,A00,188874,Staff,38,0,50,12
1683734519951,POLI 143,A00,188940,Gartzke; Erik,15,0,30,15
1683734520976,POLI 153,A00,188943,Staff,1,0,20,19
1683734522006,POLI 160AA,A00,188944,Staff,10,0,40,30
1683734523032,POLI 170A,A00,188945,Staff,10,0,30,20
1683734525087,PSYC 1,A00,188952,Staff,36,0,90,54
1683734526111,PSYC 2,B00,188953,Staff,19,0,35,16
1683734527134,PSYC 6,A00,188970,Staff,47,0,60,13
1683734528158,PSYC 7,A00,188973,Staff,35,0,45,10
1683734529187,PSYC 60,A01,188980,Rickard; Timothy C.,42,0,60,18
1683734530215,PSYC 70,A01,189001,Steiner; Eric Tomas,21,0,45,24
1683734531239,PSYC 100,A00,189005,Lacefield; Katharine I,1,98,120,119
1683734532265,PSYC 102,A00,189008,Staff,6,0,30,24
1683734533291,PSYC 106,B00,189026,Gorman; Michael R.,26,0,60,34
1683734534315,PSYC 114,B01,189033,Winkielman; Piotr,0,31,30,30
1683734535343,PSYC 131,A00,189036,Anagnostaras; Stephan,0,44,60,60
1683734536367,PSYC 136,A00,189041,Lowe; Angela Beth,0,7,25,25
1683734537394,PSYC 137,A00,189057,Winkielman; Piotr,0,36,25,25
1683734538417,PSYC 144,A00,189107,Wixted; John T,0,11,50,50
1683734540465,PSYC 162,A00,189142,Staff,0,9,85,85
1683734541494,PSYC 172,A00,189144,Gorman; Michael R.,0,6,30,30
1683734543550,PSYC 179,A00,189146,Lacefield; Katharine I,0,88,120,120
1683734544575,PSYC 181,A00,189147,Anagnostaras; Stephan,110,45,200,90
1683734545603,PSYC 190R,A00,189148,Barner; David A.,0,23,80,80
1683734546636,PSYC 191,A00,189275,Rickard; Timothy C.,0,11,25,25
1683734547663,PSYC 193,A00,189276,Chapman; Eddie Nathaniel,0,1,0,4
1683734548691,PSYC 193L,A01,189281,Lowe; Angela Beth,8,0,20,12
1683734548691,PSYC 193L,B01,189285,Staff,28,0,35,7
1683734549718,RELI 149,A00,187137,Rahimi; Babak,6,0,40,34
1683734550746,SE 9,A01,187315,Staff,0,2,18,18
1683734551774,SE 101B,A00,187409,Staff,24,0,30,6
1683734552797,SE 110B,A00,187444,Staff,10,0,40,30
1683734553825,SE 130B,A00,187449,Staff,31,0,40,9
1683734554850,SE 150A,A00,187516,Staff,8,0,20,12
1683734555873,SE 154,A00,187528,Staff,29,0,50,21
1683734556898,SIO 3,A01,258171,Staff,35,0,40,5
1683734557926,SIO 10,A00,187144,Cook; Geoffrey W,0,6,75,75
1683734558949,SIO 45,A00,187152,Cook; Geoffrey W,1,7,100,99
1683734559977,SIO 109R,A00,194486,Staff,0,4,20,20
1683734562030,SIO 187,A01,187233,Kacev; David,12,0,40,28
1683734563055,SOCI 1,A01,258656,Thorpe; Charles Robert,28,0,30,2
1683734563055,SOCI 1,A02,258658,Thorpe; Charles Robert,30,0,30,0
1683734563055,SOCI 1,A03,258661,Thorpe; Charles Robert,25,0,25,0
1683734563055,SOCI 1,A04,258666,Thorpe; Charles Robert,22,0,25,3
1683734563055,SOCI 1,A05,258897,Thorpe; Charles Robert,22,0,25,3
1683734563055,SOCI 1,A06,258898,Thorpe; Charles Robert,25,0,25,0
1683734564079,SOCI 30,A01,258903,Pardo Guerra; Juan Pablo,14,0,30,16
1683734565103,SOCI 102,A00,258904,Staff,9,0,25,16
1683734566126,SOCI 106,A00,258905,Staff,19,0,25,6
1683734567150,SOCI 111,A00,258907,Ribas Norris; Janet Vanesa,26,0,30,4
1683734568177,SOCI 121R,A00,258908,Pardo Guerra; Juan Pablo,7,0,30,23
1683734569205,SOCI 126,A01,203330,Staff,14,0,20,6
1683734570232,SOCI 131,A00,258909,Thorpe; Charles Robert,30,0,60,30
1683734571256,SOCI 135,A00,258910,Payne; Christine Anna,0,13,30,30
1683734572279,SOCI 157,A00,258911,Staff,10,0,30,20
1683734573304,SOCI 184,A00,258912,Staff,25,0,30,5
1683734574329,SOCI 188D,A00,258913,Staff,22,0,30,8
1683734575353,SYN 2,001,187529,Staff,9,0,16,7
1683734575353,SYN 2,002,201452,Staff,0,20,16,16
1683734575353,SYN 2,003,201469,Staff,1,0,16,15
1683734576380,SYN 100,A01,187531,Staff,0,9,20,20
1683734576380,SYN 100,B01,201491,Staff,0,10,20,20
1683734577446,TDAC 1,A00,189286,Walsh; Kim C.,3,0,20,17
1683734577446,TDAC 1,B00,189287,Harting; Carla Kelso,10,0,20,10
1683734578470,TDAC 101,A00,189300,Walsh; Kim C.,16,0,20,4
1683734578470,TDAC 101,B00,189301,Harting; Carla Kelso,18,0,20,2
1683734579494,TDAC 102,A00,189304,Basso; Beatrice,14,0,20,6
1683734580518,TDAC 108,A00,189305,Staff,18,0,20,2
1683734581547,TDDE 131,A00,189310,Staff,19,0,20,1
1683734581547,TDDE 131,B00,189314,Staff,19,0,20,1
1683734581547,TDDE 131,C00,189315,Staff,48,0,50,2
1683734581547,TDDE 131,D00,189316,Staff,14,0,15,1
1683734581547,TDDE 131,E00,204841,Staff,20,0,20,0
1683734582573,TDGE 10,A00,189289,Staff,26,0,50,24
1683734582573,TDGE 10,B00,189290,Havis; Allan,0,1,50,50
1683734583598,TDGE 11,A00,189291,Fulton; Julia,0,4,50,50
1683734583598,TDGE 11,B00,189292,Staff,20,0,25,5
1683734583598,TDGE 11,C00,260270,Staff,0,0,0,0
1683734584623,TDGE 25,A00,189294,Staff,1,0,20,19
1683734585649,TDGE 124,A00,189318,Fulton; Julia,0,7,50,50
1683734586677,TDGE 125,A00,189319,Staff,13,0,25,12
1683734586677,TDGE 125,B00,189320,Staff,23,0,25,2
1683734587703,TDGE 127,A00,189322,Havis; Allan,1,0,50,49
1683734588727,TDHT 101,A00,189323,Staff,18,0,25,7
1683734588727,TDHT 101,B00,189324,Staff,25,0,25,0
1683734589754,TDHT 102,A00,189325,Staff,49,0,50,1
1683734590782,TDMV 1,A00,189295,Arcidiacono; Kristin,20,0,30,10
1683734590782,TDMV 1,B00,189296,Caligagan; Maria T.,23,0,30,7
1683734591807,TDMV 2,A00,189297,Sammartano; Tonnie,27,0,30,3
1683734591807,TDMV 2,B00,189299,Arcidiacono; Kristin,23,0,30,7
1683734592835,TDMV 3,A00,204998,Rincon; Alicia,22,0,30,8
1683734593866,TDMV 120,A00,189458,Sammartano; Tonnie,28,0,30,2
1683734594889,TDMV 138,A00,189541,Jun; Grace Shin Hae,20,0,40,20
1683734595918,TDMV 142,A00,189717,Caligagan; Tony,25,0,30,5
1683734595918,TDMV 142,B00,189718,Caligagan; Maria T.,25,0,30,5
1683734596941,TMC 2,A01,187533,Staff,25,0,25,0
1683734596941,TMC 2,A02,187534,Staff,25,0,25,0
1683734597967,USP 1,A01,187536,Kwak; Nancy,0,16,25,25
1683734598991,USP 5,A01,187538,Staff,8,0,25,17
1683734600016,USP 101,A00,199253,Staff,0,4,0,0
1683734601101,USP 124,A00,187562,Boomhower; Matthew Charles,0,0,30,30
1683734602124,USP 138,A00,187582,Staff,19,0,25,6
1683734603149,USP 152,A01,187597,Staff,3,0,25,22
1683734604182,USP 153,A00,187598,Staff,18,0,25,7
1683734605209,USP 168,A00,187607,Kwak; Nancy,2,0,5,3
1683734606237,USP 173,A00,187619,Staff,4,0,25,21
1683734607264,USP 181,A00,187638,Staff,0,4,25,25
1683734608290,VIS 103,A00,187650,Cruz; Edwin Teddy,17,0,75,58
1683734609314,VIS 110D,A00,187669,Staff,13,0,22,9
1683734610338,VIS 127C,A00,187720,Shen; Kuiyi,67,0,146,79
1683734611361,VIS 149,A00,187731,Yoldas; Pinar,0,12,22,22
1683734612390,VIS 151,A01,188091,Staff,22,0,34,12
1683734612390,VIS 151,A02,188092,Staff,11,0,34,23
1683734613418,VIS 160B,A00,188093,Stalbaum; Brett,0,1,10,10
1683734615465,WCWP 10B,A00,201720,Staff,0,0,5,5
1683734615465,WCWP 10B,B00,201722,Staff,0,0,6,6
1683734616490,WCWP 100,A00,201725,Gagnon; Jeffrey C,0,0,2,2
1683734616490,WCWP 100,B00,201727,Staff,0,4,15,15
1683734619586,ANBI 133,A00,258401,Wilder; Linnea Lorene,34,0,40,6
1683734620612,ANBI 140,A00,258395,Hrvoj Mihic; Branka,18,0,25,7
1683734621640,ANSC 120,A00,258402,Bialecki; Jon Anthony,26,0,40,14
1683734622665,ANSC 144,A00,258400,Staff,12,0,40,28
1683734624720,ANSC 166,A00,258396,Parish; Steven Martin,156,0,175,19
1683734625746,ANSC 180,A00,193533,Staff,8,0,20,12
1683734626774,ANSC 188,A00,258397,Jassal; Aftab,34,0,40,6
1683734627798,ANTH 3,A01,258316,Staff,23,0,30,7
1683734628821,ANTH 5,A00,258394,Semendeferi; Ekaterini,16,0,20,4
1683734629846,ANTH 21,A01,258331,Staff,4,0,40,36
1683734630869,ANTH 103,A00,258398,Varma; Saiba,15,0,25,10
1683734631902,AWP 10,001,202034,Staff,0,0,0,0
1683734631902,AWP 10,002,202035,Staff,0,0,0,0
1683734631902,AWP 10,003,202036,Staff,0,0,0,0
1683734631902,AWP 10,004,202037,Staff,0,0,0,0
1683734631902,AWP 10,005,202038,Staff,0,0,0,0
1683734631902,AWP 10,006,202039,Staff,0,0,0,0
1683734631902,AWP 10,007,202040,Staff,0,0,0,0
1683734631902,AWP 10,008,202041,Staff,0,0,0,0
1683734631902,AWP 10,009,202042,Staff,0,0,0,0
1683734631902,AWP 10,010,202043,Staff,0,0,0,0
1683734631902,AWP 10,011,202044,Staff,0,0,0,0
1683734631902,AWP 10,012,202045,Staff,0,0,0,0
1683734631902,AWP 10,013,202046,Staff,0,0,0,0
1683734631902,AWP 10,014,202047,Staff,0,0,0,0
1683734631902,AWP 10,015,202048,Staff,0,0,0,0
1683734631902,AWP 10,016,202049,Staff,0,0,0,0
1683734631902,AWP 10,017,202050,Staff,0,0,0,0
1683734631902,AWP 10,018,202051,Staff,0,0,0,0
1683734631902,AWP 10,019,202052,Staff,0,0,0,0
1683734631902,AWP 10,020,202053,Staff,0,0,0,0
1683734631902,AWP 10,021,202054,Staff,0,0,0,0
1683734631902,AWP 10,022,202055,Staff,0,0,0,0
1683734631902,AWP 10,023,202056,Staff,0,0,0,0
1683734631902,AWP 10,024,202057,Staff,0,0,0,0
1683734631902,AWP 10,025,202058,Staff,0,0,0,0
1683734631902,AWP 10,026,202059,Staff,0,0,0,0
1683734632929,AWP 102,001,202032,Staff,0,0,0,0
1683734632929,AWP 102,002,202033,Staff,0,0,0,0
1683734633953,BENG 100,A01,254234,Taylor Amos; Alyssa C,31,0,40,9
1683734634977,BENG 196,001,270013,Engler; Adam J.,9999,0,9999,0
1683734636007,BICD 100R,A01,202018,Smith; Laurie,0,7,32,32
1683734636007,BICD 100R,A02,202019,Smith; Laurie,0,3,32,32
1683734636007,BICD 100R,A03,202020,Smith; Laurie,0,1,32,32
1683734636007,BICD 100R,A04,202021,Smith; Laurie,6,0,32,26
1683734636007,BICD 100R,A05,202022,Smith; Laurie,10,0,32,22
1683734637035,BICD 136,A01,193242,Gustafson-Brown; Cindy,0,2,32,32
1683734637035,BICD 136,A02,193244,Gustafson-Brown; Cindy,13,0,32,19
1683734638058,BIEB 102,A01,193249,Butler; Shannon Rhey,0,0,32,32
1683734638058,BIEB 102,A02,193251,Butler; Shannon Rhey,0,0,32,32
1683734638058,BIEB 102,A03,193253,Butler; Shannon Rhey,0,0,32,32
1683734638058,BIEB 102,A04,193255,Butler; Shannon Rhey,13,0,32,19
1683734638058,BIEB 102,A05,193265,Butler; Shannon Rhey,25,0,32,7
1683734638058,BIEB 102,A06,193269,Butler; Shannon Rhey,12,0,32,20
1683734640106,BIEB 150,A01,193274,Staff,0,0,32,32
1683734640106,BIEB 150,A02,193285,Staff,24,0,32,8
1683734641131,BIEB 194,A00,193286,Kurle; Carolyn M.,19,0,32,13
1683734642161,BILD 1,A01,192291,Staff,15,0,32,17
1683734642161,BILD 1,A02,192292,Staff,30,0,32,2
1683734642161,BILD 1,B01,192520,Reuther; Keefe,0,1,0,0
1683734642161,BILD 1,B02,192532,Reuther; Keefe,0,1,0,0
1683734643186,BILD 3,A01,192556,Butler; Shannon Rhey,0,0,32,32
1683734643186,BILD 3,A02,192581,Butler; Shannon Rhey,0,1,32,32
1683734643186,BILD 3,A03,192611,Butler; Shannon Rhey,19,0,32,13
1683734643186,BILD 3,A04,192612,Butler; Shannon Rhey,23,0,32,9
1683734643186,BILD 3,A05,192613,Butler; Shannon Rhey,26,0,32,6
1683734643186,BILD 3,A06,192679,Butler; Shannon Rhey,27,0,32,5
1683734643186,BILD 3,A07,192682,Butler; Shannon Rhey,20,0,32,12
1683734644224,BILD 4,A01,192836,Reuther; Keefe,1,0,24,23
1683734644224,BILD 4,A02,193044,Reuther; Keefe,4,0,24,20
1683734645249,BILD 10,A01,193142,Gustafson-Brown; Cindy,29,0,32,3
1683734645249,BILD 10,A02,193149,Gustafson-Brown; Cindy,31,0,32,1
1683734646278,BIMM 100,A01,193301,Staff,0,6,32,32
1683734646278,BIMM 100,A02,193312,Staff,0,7,32,32
1683734646278,BIMM 100,A03,193323,Staff,0,10,32,32
1683734647307,BIMM 101,A01,193329,McDonnell; Lisa Marie,0,3,24,24
1683734647307,BIMM 101,A02,193339,McDonnell; Lisa Marie,0,3,24,24
1683734647307,BIMM 101,B01,193354,McDonnell; Lisa Marie,0,4,24,24
1683734647307,BIMM 101,B02,193357,McDonnell; Lisa Marie,0,3,24,24
1683734648333,BIMM 110,A01,193377,Tat; John,0,11,32,32
1683734648333,BIMM 110,A02,193378,Tat; John,0,11,32,32
1683734649362,BIMM 120,A01,206116,Staff,1,0,32,31
1683734649362,BIMM 120,A02,206117,Staff,7,0,32,25
1683734649362,BIMM 120,A03,206121,Staff,21,0,32,11
1683734650386,BIPN 100,A01,193393,Park; Ji Young,0,15,32,32
1683734650386,BIPN 100,A02,193402,Park; Ji Young,0,14,32,32
1683734650386,BIPN 100,A03,193413,Park; Ji Young,0,14,32,32
1683734650386,BIPN 100,A04,193414,Park; Ji Young,0,13,32,32
1683734651417,BIPN 102,A01,193429,Staff,0,0,32,32
1683734651417,BIPN 102,A02,193438,Staff,18,0,32,14
1683734652441,BIPN 106,A01,193450,Reyes Gonzalez; Catalina,0,2,40,40
1683734653472,BIPN 134,A01,193465,Cooke; James Edward,0,0,32,32
1683734653472,BIPN 134,A02,193474,Cooke; James Edward,24,0,32,8
1683734653472,BIPN 134,A03,193485,Cooke; James Edward,29,0,32,3
1683734653472,BIPN 134,A04,193486,Cooke; James Edward,20,0,32,12
1683734653472,BIPN 134,A05,193491,Cooke; James Edward,31,0,32,1
1683734653472,BIPN 134,A06,193501,Cooke; James Edward,30,0,32,2
1683734653472,BIPN 134,A07,193510,Cooke; James Edward,29,0,32,3
1683734655520,BISP 194,A00,222522,Staff,14,0,32,18
1683734656547,CAT 124,A01,202407,Staff,19,0,25,6
1683734657572,CAT 125,A00,202408,Marchisotto; Jennifer Anne,2,0,20,18
1683734658601,CAT 125R,A00,202409,Smith; Lauryn Alissa,0,11,20,20
1683734658601,CAT 125R,B00,202410,Morales; Celeste Georgianna,0,11,20,20
1683734658601,CAT 125R,C00,202411,Irwin; Matthew Joseph,0,12,20,20
1683734659628,CENG 15,A01,204712,Yang; Kesong,0,1,0,0
1683734660660,CENG 114,A00,202070,Jahed Motlagh; Zeinab,5,0,20,15
1683734661701,CGS 105,A00,185477,Wesling; Megan E.,24,0,40,16
1683734662726,CGS 106,A00,185494,Staff,11,0,22,11
1683734663753,CGS 108,A00,185495,Staff,14,0,20,6
1683734664777,CGS 114,A00,185496,Staff,13,0,18,5
1683734665805,CGS 119,A00,185501,Staff,15,0,20,5
1683734666829,CGS 120,A00,185511,Staff,11,0,20,9
1683734667859,CHEM 4,A01,184675,Bussey; Thomas J,97,0,100,3
1683734668892,CHEM 6A,A01,184677,Staff,32,0,60,28
1683734669917,CHEM 6B,A01,184679,Staff,63,0,100,37
1683734670943,CHEM 6C,A01,184681,Bussey; Thomas J,0,0,50,50
1683734670943,CHEM 6C,A02,184682,Bussey; Thomas J,32,0,50,18
1683734671972,CHEM 40A,A01,184684,Albizati; Kim F.,33,0,100,67
1683734673007,CHEM 40B,A01,184686,Albizati; Kim F.,0,22,100,100
1683734674034,CHEM 41B,A01,184690,Staff,51,0,100,49
1683734675059,COGS 3,A01,184715,Boyle; Mary E. T.,0,27,40,40
1683734676083,COGS 14B,A01,185172,Staff,0,14,38,38
1683734677106,COGS 18,A01,184736,Staff,14,0,80,66
1683734678131,COGS 100,A01,184932,Staff,0,8,73,73
1683734679158,COGS 101A,A01,184935,Staff,0,40,30,30
1683734680188,COGS 101B,A01,184944,Staff,0,2,30,30
1683734681214,COGS 101C,A01,184946,Staff,0,10,30,30
1683734682239,COGS 102A,A01,184951,Johnson; Christine M.,1,0,40,39
1683734683264,COGS 107B,A01,184953,Mooshagian; Eric Frederick,0,52,40,40
1683734684288,COGS 118B,A01,184959,Gupta; Anjum,0,50,40,40
1683734685314,COGS 153,A00,184961,Staff,1,16,30,29
1683734686338,COGS 177,A00,184962,Staff,0,20,30,30
1683734687362,COGS 187A,A01,184969,Boyle; Mary E. T.,0,19,40,40
1683734688391,COMM 10,A01,185174,Staff,0,5,25,25
1683734688391,COMM 10,A02,185189,Staff,0,2,25,25
1683734688391,COMM 10,A03,269821,Staff,0,1,0,0
1683734689419,COMM 100B,A02,185476,Staff,10,0,25,15
1683734689419,COMM 100B,A03,277340,Staff,25,0,25,0
1683734690444,COMM 100C,A01,185314,Staff,2,0,25,23
1683734690444,COMM 100C,A02,185327,Staff,17,0,25,8
1683734691468,COMM 110M,A00,185349,Staff,0,0,40,40
1683734692493,COMM 113T,A00,185352,Staff,25,0,40,15
1683734693521,COMM 114I,A00,185353,Staff,31,0,40,9
1683734694549,COMM 131,A00,185354,Staff,17,0,30,13
1683734695573,CSE 8A,A50,185358,Cao; Yingjun,0,46,10,10
1683734696598,CSE 8B,A01,185362,Staff,0,48,50,50
1683734697626,CSE 11,A01,185416,Cao; Yingjun,0,91,10,10
1683734698652,CSE 20,A01,185445,Briones; Jor-el Thomas Caparas,3,0,25,22
1683734699675,CSE 21,A01,185447,Staff,9,0,50,41
1683734700703,CSE 101,A01,185451,Staff,0,13,50,50
1683734700703,CSE 101,B01,185453,Jones; Miles E,0,15,50,50
1683734702761,CSE 141,A01,185458,Eldon; John,16,0,100,84
1683734703787,CSE 141L,A01,185461,Eldon; John,8,0,100,92
1683734704893,CSE 142,A01,185463,Staff,34,0,60,26
1683734704893,CSE 142,B01,201355,Staff,0,7,60,60
1683734705921,CSE 142L,A01,185470,Staff,34,0,60,26
1683734705921,CSE 142L,B01,201417,Staff,0,6,60,60
1683734706948,CSE 190,A00,201433,Staff,32,0,49,17
1683734707976,DOC 1,A01,259136,Strom; Megan C.,7,0,15,8
1683734707976,DOC 1,A02,259137,Strom; Megan C.,15,0,15,0
1683734707976,DOC 1,A03,259138,Strom; Megan C.,14,0,15,1
1683734707976,DOC 1,A04,259139,Strom; Megan C.,13,0,15,2
1683734709001,DOC 100D,A00,259140,Pass; Natalye Joann,14,0,25,11
1683734710024,DSGN 1,A01,184749,Rill; Bryan,0,26,30,30
1683734711051,DSGN 100,A01,185168,Staff,0,2,25,25
1683734712075,ECE 5,A01,185626,Morris; Karcher William,0,12,0,0
1683734713105,ECE 101,A01,185628,Staff,14,0,70,56
1683734714130,ECE 107,A01,185635,Baghdadchi; Saharnaz,0,0,20,20
1683734714130,ECE 107,A02,185638,Baghdadchi; Saharnaz,1,0,20,19
1683734715157,ECE 148,A01,185647,Silberman; Jack,0,0,16,16
1683734716183,ECON 1,A01,185537,Crane; Meredith Helen,54,0,70,16
1683734717213,ECON 3,A01,185549,Crane; Meredith Helen,30,0,70,40
1683734718238,ECON 4,A01,203354,Anderson; John Charles,0,5,10,10
1683734719264,ECON 100A,A01,185574,Staff,0,5,40,40
1683734720288,ECON 100B,A01,185576,Staff,0,12,50,50
1683734721316,ECON 100C,A01,185589,Newhouse; Herbert S,30,0,70,40
1683734722339,ECON 105,A00,185608,Vespa; Emanuel Ignacio,19,0,35,16
1683734723366,ECON 109,A01,185610,Shishkin; Denis,9,0,35,26
1683734724393,ECON 110A,A01,185612,Staff,8,0,40,32
1683734725416,ECON 120A,A01,185615,Staff,19,0,40,21
1683734726441,ECON 120C,A01,185617,Sun; Yixiao,0,21,70,70
1683734727465,ECON 144,A00,203346,Squires; Dale E,2,0,35,33
1683734728490,ECON 171,A01,203349,Newhouse; Herbert S,0,1,35,35
1683734729517,ECON 173A,A01,185621,Toda; Alexis Akira,21,0,35,14
1683734730543,EDS 25,A01,202413,Staff,0,1,0,0
1683734730543,EDS 25,A02,202414,Staff,0,1,0,0
1683734730543,EDS 25,A03,202415,Staff,0,0,0,0
1683734730543,EDS 25,A04,202416,Staff,0,1,0,0
1683734730543,EDS 25,A05,202439,Staff,0,0,0,0
1683734730543,EDS 25,A06,202440,Staff,0,0,0,0
1683734730543,EDS 25,B01,202631,Staff,0,0,0,0
1683734730543,EDS 25,B02,202632,Staff,0,0,0,0
1683734730543,EDS 25,B03,202639,Staff,0,0,0,0
1683734730543,EDS 25,B04,202640,Staff,0,0,0,0
1683734730543,EDS 25,B05,202643,Staff,0,0,0,0
1683734730543,EDS 25,B06,202644,Staff,0,0,0,0
1683734731571,EDS 38,A01,202659,Black; Alison Michelle,25,0,25,0
1683734732598,EDS 115,A00,202652,Staff,18,0,30,12
1683734733622,EDS 125,A00,202649,Staff,13,0,30,17
1683734734647,EDS 126,A01,203332,Staff,30,0,30,0
1683734735678,EDS 139,A00,202838,Staff,16,0,25,9
1683734736707,EDS 146,A01,202655,Staff,14,0,25,11
1683734737732,ENG 15,A00,185667,Staff,0,1,0,2
1683734737732,ENG 15,B00,185672,Staff,0,0,0,1
1683734737732,ENG 15,C00,185675,Staff,0,0,0,0
1683734737732,ENG 15,D00,185682,Staff,0,0,0,0
1683734737732,ENG 15,E00,185684,Staff,0,0,0,0
1683734738758,ETHN 103,A00,185710,Staff,0,8,35,35
1683734739782,ETHN 103A,A00,199228,Man; Simeon S,0,0,9,9
1683734740811,ETHN 109,A00,185711,Staff,15,0,35,20
1683734741833,ETHN 142,A00,185726,Staff,0,4,30,30
1683734742864,ETHN 163J,A00,199229,Man; Simeon S,5,0,8,3
1683734743891,ETHN 168,A00,185727,Staff,7,0,10,3
1683734744915,ETHN 182,A00,185728,Staff,0,0,35,35
1683734745940,ETHN 183,A00,185737,Staff,10,0,18,8
1683734746961,GLBH 111,A01,209361,Burgos; Jose L.,0,0,0,0
1683734749013,HIEU 104,A00,185792,Staff,14,0,20,6
1683734750037,HIEU 115,A00,185800,Staff,0,0,20,20
1683734751061,HIEU 128,A00,185801,Staff,0,9,20,20
1683734752084,HIEU 147,A00,185802,Staff,15,0,20,5
1683734753107,HIEU 154,A00,185823,Staff,11,0,20,9
1683734754134,HILA 102,A00,185826,Staff,14,0,20,6
1683734755159,HILD 2C,A01,185778,Staff,0,13,20,20
1683734756183,HILD 7B,A01,185780,Kwak; Nancy,0,17,32,32
1683734756183,HILD 7B,A02,185781,Kwak; Nancy,0,18,32,32
1683734757217,HILD 30,A01,185791,Staff,12,0,20,8
1683734758240,HISC 119,A00,185830,Golan; Tal,0,10,20,20
1683734759267,HITO 156GS,A00,185831,Patterson; Patrick H.,0,0,0,23
1683734760291,HIUS 103,A00,185832,Man; Simeon S,0,4,20,20
1683734761320,HIUS 117,A00,185836,Kwak; Nancy,2,0,20,18
1683734762344,HIUS 125,A00,185840,Man; Simeon S,0,2,23,23
1683734763367,HIUS 149,A00,185845,Staff,1,0,20,19
1683734764392,HUM 3,A01,185882,Zavodny; Tatiana Sophia,0,8,50,50
1683734764392,HUM 3,B01,185899,Caldwell; Michael Alan,0,18,50,50
1683734765420,HUM 3GS,A00,185900,Patterson; Patrick H.,0,0,0,23
1683734766449,HUM 4,A01,185938,Zroka; Amy Liane,28,0,50,22
1683734766449,HUM 4,B01,185956,Watkins; Eric,0,6,50,50
1683734766449,HUM 4,B02,202209,Watkins; Eric,0,6,50,50
1683734766449,HUM 4,B03,202210,Watkins; Eric,0,5,50,50
1683734767477,HUM 5,A01,185958,West; Geoffrey Scott,0,0,50,50
1683734767477,HUM 5,A02,202215,West; Geoffrey Scott,0,1,50,50
1683734768500,INTL 190,A00,185959,Gagnon; Jeffrey C,0,0,0,9
1683734768500,INTL 190,B00,185960,Lettieri; Michael Joseph,0,0,0,2
1683734769525,JAPN 180,A00,254509,Staff,4,0,30,26
1683734770549,LATI 10,A01,202853,Kennemore; Amy Michelle,4,0,35,31
1683734770549,LATI 10,A02,202854,Kennemore; Amy Michelle,3,0,35,32
1683734770549,LATI 10,A03,270054,Kennemore; Amy Michelle,30,0,30,0
1683734771578,LATI 180,A00,202855,Kennemore; Amy Michelle,11,0,20,9
1683734772602,LAWS 101,A00,201767,Golan; Tal,0,7,40,40
1683734773626,LIFR 1C,A00,185961,Staff,6,0,20,14
1683734774649,LIFR 1CX,A00,185962,Staff,7,0,20,13
1683734775674,LIFR 1D,A00,185963,Staff,7,0,20,13
1683734776698,LIFR 1DX,A00,185964,Staff,7,0,20,13
1683734777724,LIGN 101,A01,186039,Staff,43,0,50,7
1683734778754,LIGN 165,A00,186040,Staff,14,0,50,36
1683734779780,LTCS 108,A00,186041,Staff,5,0,10,5
1683734780808,LTCS 119,A00,186042,Staff,15,0,20,5
1683734781836,LTCS 130,A00,186043,Wesling; Megan E.,15,0,25,10
1683734783888,LTEA 138,A00,186119,Staff,13,0,40,27
1683734784912,LTEN 124,A00,186148,Staff,5,0,25,20
1683734785939,LTEN 178,A00,186149,Staff,6,0,15,9
1683734786967,LTEN 181,A00,186150,Blanco; John D,34,0,40,6
1683734787995,LTWL 120,A00,186160,Staff,19,0,25,6
1683734789022,LTWL 165,A00,186161,Staff,22,0,25,3
1683734790050,LTWR 100,A00,186162,Staff,0,5,15,15
1683734791076,LTWR 102,A00,186163,Doller; Ben,5,0,15,10
1683734792100,MAE 8,A01,186412,Staff,0,1,0,1
1683734793129,MAE 30B,A00,186445,Bahadori; Mohammad Yousef,81,0,100,19
1683734794153,MAE 40,A00,186592,Bewley; Thomas R,10,0,50,40
1683734795177,MAE 101B,A00,186593,Bahadori; Mohammad Yousef,80,0,100,20
1683734796205,MAE 105,A00,186594,Bandaru; Prabhakar,10,0,50,40
1683734797230,MAE 107,A00,186599,Pham; Hieu Tan,0,8,120,120
1683734798259,MAE 148,A01,186660,Silberman; Jack,3,0,16,13
1683734799284,MATH 10A,A01,188095,Staff,0,6,35,35
1683734800308,MATH 10B,A01,188097,Bowers; Adam R.,0,12,30,30
1683734800308,MATH 10B,A02,188099,Bowers; Adam R.,0,11,30,30
1683734800308,MATH 10B,B01,188104,Bowers; Adam R.,0,10,30,30
1683734800308,MATH 10B,B02,188106,Bowers; Adam R.,0,9,30,30
1683734801333,MATH 10C,A01,188111,Staff,0,20,30,30
1683734801333,MATH 10C,A02,188127,Staff,0,19,30,30
1683734801333,MATH 10C,A03,188131,Staff,0,19,30,30
1683734801333,MATH 10C,B01,188218,Staff,17,0,30,13
1683734801333,MATH 10C,B02,188244,Staff,13,0,30,17
1683734801333,MATH 10C,B03,188277,Staff,14,0,30,16
1683734802359,MATH 18,A01,188344,Bach; Quang Tran,18,0,30,12
1683734802359,MATH 18,A02,188345,Bach; Quang Tran,11,0,30,19
1683734802359,MATH 18,B01,188353,Bach; Quang Tran,11,0,30,19
1683734802359,MATH 18,B02,188354,Bach; Quang Tran,19,0,30,11
1683734803386,MATH 20A,A01,188374,Staff,10,0,35,25
1683734804411,MATH 20B,A01,188382,Ohm; Ko Woon,7,0,30,23
1683734804411,MATH 20B,A02,188383,Ohm; Ko Woon,22,0,30,8
1683734804411,MATH 20B,B01,188385,Ohm; Ko Woon,7,0,30,23
1683734804411,MATH 20B,B02,188392,Ohm; Ko Woon,22,0,30,8
1683734805441,MATH 20C,A01,188394,Harel; Guershon,10,0,30,20
1683734805441,MATH 20C,A02,188395,Harel; Guershon,13,0,30,17
1683734805441,MATH 20C,B01,188404,Harel; Guershon,5,0,30,25
1683734805441,MATH 20C,B02,188405,Harel; Guershon,18,0,30,12
1683734806470,MATH 20D,A01,188414,Hammock; Frances H,0,1,30,30
1683734806470,MATH 20D,A02,188415,Hammock; Frances H,0,1,30,30
1683734806470,MATH 20D,B01,188447,Hammock; Frances H,0,1,30,30
1683734806470,MATH 20D,B02,188486,Hammock; Frances H,2,0,30,28
1683734807498,MATH 20E,A01,188649,Staff,21,0,30,9
1683734807498,MATH 20E,A02,188650,Staff,20,0,30,10
1683734807498,MATH 20E,A03,188673,Staff,0,0,30,30
1683734808581,MATH 102,A01,188675,Staff,0,40,35,35
1683734809612,MATH 103B,A01,188681,Staff,3,0,35,32
1683734809612,MATH 103B,B01,188692,Staff,5,0,35,30
1683734810637,MATH 109,A01,188695,Salehi Golsefidy; Alireza,24,0,35,11
1683734810637,MATH 109,A02,188696,Salehi Golsefidy; Alireza,24,0,35,11
1683734811661,MATH 120A,A01,188698,Eggers; John Dietrich,7,0,35,28
1683734812686,MATH 142B,A01,188736,Ioana; Adrian,0,0,30,30
1683734812686,MATH 142B,A02,188741,Ioana; Adrian,0,1,30,30
1683734812686,MATH 142B,A03,188743,Ioana; Adrian,0,3,30,30
1683734813711,MATH 168A,A01,188790,Staff,0,11,35,35
1683734814740,MATH 170A,A01,188803,Nie; Jiawang,0,2,35,35
1683734814740,MATH 170A,A02,188811,Nie; Jiawang,0,1,35,35
1683734814740,MATH 170A,A03,188814,Nie; Jiawang,1,0,35,34
1683734814740,MATH 170A,A04,188815,Nie; Jiawang,5,0,35,30
1683734815766,MATH 193B,A01,188817,Staff,0,0,35,35
1683734815766,MATH 193B,A02,188818,Staff,6,0,35,29
1683734816790,MGT 4,A01,202857,Anderson; John Charles,59,0,80,21
1683734817816,MGT 12,A00,202858,Lindenberger; Wade Douglas,40,0,90,50
1683734818840,MGT 18,A00,202859,Staff,73,0,90,17
1683734819863,MGT 18GS,A00,202860,McKay; Michael J,13,0,28,15
1683734820891,MGT 45,A00,202861,Pecore; Joseph P.,8,0,90,82
1683734821916,MGT 100,A00,202863,Yavorsky; Daniel Ryan,27,0,90,63
1683734822940,MGT 103,A00,202864,Ehrich; Kristine R,0,19,90,90
1683734823964,MGT 112,A00,202865,Ehrich; Kristine R,15,0,90,75
1683734824992,MGT 121A,A00,202868,Staff,70,0,90,20
1683734826016,MGT 131B,A00,202869,Anderson; John Charles,58,0,90,32
1683734827040,MGT 136,A00,202871,Lindenberger; Wade Douglas,83,0,90,7
1683734828066,MGT 164,A00,202873,Staff,0,67,90,91
1683734829093,MGT 164GS,A00,202874,McKay; Mary A,13,0,28,15
1683734830120,MGT 180,A00,202875,Staff,0,51,90,91
1683734831143,MMW 11R,A01,205019,Herbst; Matthew,0,0,30,30
1683734831143,MMW 11R,A02,205026,Herbst; Matthew,29,0,30,1
1683734832167,MMW 15,A01,193512,Chang; Edmond Yi-Teh,0,8,28,28
1683734832167,MMW 15,A02,193513,Chang; Edmond Yi-Teh,0,5,28,28
1683734832167,MMW 15,A03,193514,Chang; Edmond Yi-Teh,0,5,28,28
1683734832167,MMW 15,A04,193515,Chang; Edmond Yi-Teh,0,5,28,28
1683734832167,MMW 15,A05,193516,Chang; Edmond Yi-Teh,0,5,28,28
1683734832167,MMW 15,A06,193517,Chang; Edmond Yi-Teh,0,6,28,28
1683734832167,MMW 15,B01,193519,Chang; Edmond Yi-Teh,0,5,28,28
1683734832167,MMW 15,B02,193520,Chang; Edmond Yi-Teh,0,5,28,28
1683734832167,MMW 15,B03,193521,Chang; Edmond Yi-Teh,0,5,28,28
1683734832167,MMW 15,B04,193522,Chang; Edmond Yi-Teh,0,6,28,28
1683734832167,MMW 15,B05,193523,Chang; Edmond Yi-Teh,0,5,28,28
1683734832167,MMW 15,B06,193524,Chang; Edmond Yi-Teh,0,5,28,28
1683734833195,MMW 122,A01,193526,Rahimi; Babak,0,16,28,28
1683734833195,MMW 122,A02,193527,Rahimi; Babak,0,15,28,28
1683734833195,MMW 122,A03,193528,Rahimi; Babak,0,0,0,0
1683734833195,MMW 122,A04,193529,Rahimi; Babak,0,0,0,0
1683734834223,MUS 1A,A01,186663,Staff,0,18,35,35
1683734835246,MUS 4,A01,186715,Staff,0,12,35,35
1683734836269,MUS 5R,A01,186796,Dubnov; Shlomo,0,17,35,35
1683734837293,MUS 6,A01,186798,Staff,0,4,25,25
1683734838315,MUS 7,A01,186830,Staff,11,0,35,24
1683734839339,MUS 8,A01,186930,Staff,0,27,35,35
1683734840364,MUS 15,A01,186932,Staff,0,15,35,35
1683734840364,MUS 15,B01,186934,Staff,0,16,35,35
1683734841390,MUS 80,A00,186935,Staff,0,0,20,20
1683734841390,MUS 80,B00,186936,Staff,24,0,25,1
1683734842415,NANO 11,A00,204702,Lipomi; Darren John,0,0,0,0
1683734843444,NANO 15,A01,204709,Yang; Kesong,0,1,0,0
1683734844468,NANO 114,A00,202069,Jahed Motlagh; Zeinab,2,0,10,8
1683734845495,PHIL 1,A00,186955,Grush; Rick Scott,31,0,40,9
1683734846519,PHIL 10,A01,186973,Grush; Rick Scott,27,0,35,8
1683734846519,PHIL 10,A02,186974,Grush; Rick Scott,33,0,35,2
1683734847547,PHIL 13,A01,186976,Staff,1,0,35,34
1683734847547,PHIL 13,A02,186977,Staff,16,0,35,19
1683734848573,PHIL 14,A01,186979,Staff,30,0,35,5
1683734848573,PHIL 14,A02,186986,Staff,32,0,35,3
1683734849601,PHIL 28,A01,186988,Staff,16,0,30,14
1683734849601,PHIL 28,A02,186989,Staff,0,0,30,30
1683734849601,PHIL 28,A03,186990,Staff,10,0,30,20
1683734849601,PHIL 28,A04,186991,Staff,26,0,30,4
1683734850629,PHIL 120,A00,186997,Staff,23,0,40,17
1683734851657,PHIL 137,A00,187003,Staff,8,0,40,32
1683734852683,PHIL 150,A00,187015,Staff,47,0,70,23
1683734853708,PHIL 167,A00,187021,Lamey; Andy M.,34,0,40,6
1683734854737,PHIL 174,A01,202226,Staff,17,0,20,3
1683734854737,PHIL 174,A02,202235,Staff,20,0,20,0
1683734855764,PHIL 191A,A00,258918,Staff,0,0,1,1
1683734856799,PHYS 1A,A00,187028,Staff,26,0,60,34
1683734857823,PHYS 1AL,001,187036,Staff,3,0,30,27
1683734857823,PHYS 1AL,002,187049,Staff,18,0,30,12
1683734858851,PHYS 1B,A00,187058,Staff,21,0,60,39
1683734859879,PHYS 1BL,001,187064,Staff,0,1,30,30
1683734859879,PHYS 1BL,002,187070,Staff,4,0,30,26
1683734860902,PHYS 1C,A00,187082,Staff,30,0,120,90
1683734861930,PHYS 1CL,001,187088,Staff,0,9,30,30
1683734861930,PHYS 1CL,002,187089,Staff,0,1,30,30
1683734861930,PHYS 1CL,009,262693,Staff,9,0,30,21
1683734862955,PHYS 2B,A01,187097,Staff,55,0,115,60
1683734863981,PHYS 2C,A01,187099,Staff,63,0,115,52
1683734865004,PHYS 2CL,A01,187101,Staff,5,0,28,23
1683734865004,PHYS 2CL,A02,187102,Staff,15,0,28,13
1683734866032,PHYS 2D,A01,187123,Shotwell; Brian,95,0,115,20
1683734867057,PHYS 4B,A01,187133,Grinstein; Benjamin,35,0,50,15
1683734868081,POLI 10,A00,188819,Staff,0,4,50,50
1683734869107,POLI 11,A00,188827,Staff,43,0,50,7
1683734870131,POLI 13R,A00,188828,Staff,0,2,20,20
1683734871156,POLI 27,A01,188830,Elgin; Samuel Zincke,0,2,70,70
1683734872183,POLI 30,A00,188832,Desposato; Scott,30,0,50,20
1683734873208,POLI 102F,A00,188834,Staff,1,0,40,39
1683734874235,POLI 104A,A00,188852,Staff,12,0,30,18
1683734875259,POLI 104I,A00,188853,Staff,0,8,20,20
1683734876283,POLI 110B,A00,188854,Wiens; David,6,0,20,14
1683734877310,POLI 112A,A00,188855,Wiens; David,3,0,30,27
1683734878333,POLI 117R,A00,188856,Forman; Fonna,0,12,20,20
1683734879358,POLI 118,A00,188857,Ingham; Sean,8,0,20,12
1683734880382,POLI 120G,A00,188858,Staff,7,0,30,23
1683734881406,POLI 131CR,A00,188863,Hoston; Germaine,20,0,50,30
1683734882433,POLI 133,A00,188864,Nellis; Gareth Hb,44,0,50,6
1683734883456,POLI 134D,A00,188865,Desposato; Scott,27,0,30,3
1683734884484,POLI 142A,A00,188871,Gartzke; Erik,21,0,50,29
1683734885511,POLI 142K,A00,188874,Staff,38,0,50,12
1683734886538,POLI 143,A00,188940,Gartzke; Erik,15,0,30,15
1683734887560,POLI 153,A00,188943,Staff,1,0,20,19
1683734888585,POLI 160AA,A00,188944,Staff,10,0,40,30
1683734889612,POLI 170A,A00,188945,Staff,10,0,30,20
1683734891661,PSYC 1,A00,188952,Staff,36,0,90,54
1683734892689,PSYC 2,B00,188953,Staff,19,0,35,16
1683734893712,PSYC 6,A00,188970,Staff,47,0,60,13
1683734894740,PSYC 7,A00,188973,Staff,35,0,45,10
1683734895769,PSYC 60,A01,188980,Rickard; Timothy C.,42,0,60,18
1683734896795,PSYC 70,A01,189001,Steiner; Eric Tomas,21,0,45,24
1683734897826,PSYC 100,A00,189005,Lacefield; Katharine I,1,98,120,119
1683734898850,PSYC 102,A00,189008,Staff,6,0,30,24
1683734899874,PSYC 106,B00,189026,Gorman; Michael R.,26,0,60,34
1683734900902,PSYC 114,B01,189033,Winkielman; Piotr,0,31,30,30
1683734901929,PSYC 131,A00,189036,Anagnostaras; Stephan,0,44,60,60
1683734902954,PSYC 136,A00,189041,Lowe; Angela Beth,0,7,25,25
1683734903981,PSYC 137,A00,189057,Winkielman; Piotr,0,36,25,25
1683734905004,PSYC 144,A00,189107,Wixted; John T,0,11,50,50
1683734907057,PSYC 162,A00,189142,Staff,0,9,85,85
1683734908081,PSYC 172,A00,189144,Gorman; Michael R.,0,6,30,30
1683734910134,PSYC 179,A00,189146,Lacefield; Katharine I,0,88,120,120
1683734911158,PSYC 181,A00,189147,Anagnostaras; Stephan,110,45,200,90
1683734912238,PSYC 190R,A00,189148,Barner; David A.,0,23,80,80
1683734913265,PSYC 191,A00,189275,Rickard; Timothy C.,0,11,25,25
1683734914294,PSYC 193,A00,189276,Chapman; Eddie Nathaniel,0,1,0,4
1683734915320,PSYC 193L,A01,189281,Lowe; Angela Beth,8,0,20,12
1683734915320,PSYC 193L,B01,189285,Staff,28,0,35,7
1683734916354,RELI 149,A00,187137,Rahimi; Babak,6,0,40,34
1683734917381,SE 9,A01,187315,Staff,0,2,18,18
1683734918407,SE 101B,A00,187409,Staff,24,0,30,6
1683734919431,SE 110B,A00,187444,Staff,10,0,40,30
1683734920467,SE 130B,A00,187449,Staff,31,0,40,9
1683734921491,SE 150A,A00,187516,Staff,8,0,20,12
1683734922518,SE 154,A00,187528,Staff,29,0,50,21
1683734923542,SIO 3,A01,258171,Staff,35,0,40,5
1683734924566,SIO 10,A00,187144,Cook; Geoffrey W,0,6,75,75
1683734925591,SIO 45,A00,187152,Cook; Geoffrey W,1,7,100,99
1683734926614,SIO 109R,A00,194486,Staff,0,4,20,20
1683734928673,SIO 187,A01,187233,Kacev; David,12,0,40,28
1683734929704,SOCI 1,A01,258656,Thorpe; Charles Robert,28,0,30,2
1683734929704,SOCI 1,A02,258658,Thorpe; Charles Robert,30,0,30,0
1683734929704,SOCI 1,A03,258661,Thorpe; Charles Robert,25,0,25,0
1683734929704,SOCI 1,A04,258666,Thorpe; Charles Robert,22,0,25,3
1683734929704,SOCI 1,A05,258897,Thorpe; Charles Robert,22,0,25,3
1683734929704,SOCI 1,A06,258898,Thorpe; Charles Robert,25,0,25,0
1683734930732,SOCI 30,A01,258903,Pardo Guerra; Juan Pablo,14,0,30,16
1683734931775,SOCI 102,A00,258904,Staff,9,0,25,16
1683734932800,SOCI 106,A00,258905,Staff,19,0,25,6
1683734933830,SOCI 111,A00,258907,Ribas Norris; Janet Vanesa,26,0,30,4
1683734934856,SOCI 121R,A00,258908,Pardo Guerra; Juan Pablo,7,0,30,23
1683734935881,SOCI 126,A01,203330,Staff,14,0,20,6
1683734936905,SOCI 131,A00,258909,Thorpe; Charles Robert,30,0,60,30
1683734937930,SOCI 135,A00,258910,Payne; Christine Anna,0,13,30,30
1683734938954,SOCI 157,A00,258911,Staff,10,0,30,20
1683734939980,SOCI 184,A00,258912,Staff,25,0,30,5
1683734941004,SOCI 188D,A00,258913,Staff,22,0,30,8
1683734942027,SYN 2,001,187529,Staff,9,0,16,7
1683734942027,SYN 2,002,201452,Staff,0,20,16,16
1683734942027,SYN 2,003,201469,Staff,1,0,16,15
1683734943051,SYN 100,A01,187531,Staff,0,9,20,20
1683734943051,SYN 100,B01,201491,Staff,0,10,20,20
1683734944076,TDAC 1,A00,189286,Walsh; Kim C.,3,0,20,17
1683734944076,TDAC 1,B00,189287,Harting; Carla Kelso,10,0,20,10
1683734945102,TDAC 101,A00,189300,Walsh; Kim C.,16,0,20,4
1683734945102,TDAC 101,B00,189301,Harting; Carla Kelso,18,0,20,2
1683734946130,TDAC 102,A00,189304,Basso; Beatrice,14,0,20,6
1683734947155,TDAC 108,A00,189305,Staff,18,0,20,2
1683734948180,TDDE 131,A00,189310,Staff,19,0,20,1
1683734948180,TDDE 131,B00,189314,Staff,19,0,20,1
1683734948180,TDDE 131,C00,189315,Staff,48,0,50,2
1683734948180,TDDE 131,D00,189316,Staff,14,0,15,1
1683734948180,TDDE 131,E00,204841,Staff,20,0,20,0
1683734949207,TDGE 10,A00,189289,Staff,26,0,50,24
1683734949207,TDGE 10,B00,189290,Havis; Allan,0,1,50,50
1683734950231,TDGE 11,A00,189291,Fulton; Julia,0,4,50,50
1683734950231,TDGE 11,B00,189292,Staff,20,0,25,5
1683734950231,TDGE 11,C00,260270,Staff,0,0,0,0
1683734951255,TDGE 25,A00,189294,Staff,1,0,20,19
1683734952282,TDGE 124,A00,189318,Fulton; Julia,0,7,50,50
1683734953304,TDGE 125,A00,189319,Staff,13,0,25,12
1683734953304,TDGE 125,B00,189320,Staff,23,0,25,2
1683734954331,TDGE 127,A00,189322,Havis; Allan,1,0,50,49
1683734955356,TDHT 101,A00,189323,Staff,18,0,25,7
1683734955356,TDHT 101,B00,189324,Staff,25,0,25,0
1683734956398,TDHT 102,A00,189325,Staff,49,0,50,1
1683734957427,TDMV 1,A00,189295,Arcidiacono; Kristin,20,0,30,10
1683734957427,TDMV 1,B00,189296,Caligagan; Maria T.,23,0,30,7
1683734958459,TDMV 2,A00,189297,Sammartano; Tonnie,27,0,30,3
1683734958459,TDMV 2,B00,189299,Arcidiacono; Kristin,23,0,30,7
1683734959484,TDMV 3,A00,204998,Rincon; Alicia,22,0,30,8
1683734960506,TDMV 120,A00,189458,Sammartano; Tonnie,28,0,30,2
1683734961531,TDMV 138,A00,189541,Jun; Grace Shin Hae,20,0,40,20
1683734962556,TDMV 142,A00,189717,Caligagan; Tony,25,0,30,5
1683734962556,TDMV 142,B00,189718,Caligagan; Maria T.,25,0,30,5
1683734963580,TMC 2,A01,187533,Staff,25,0,25,0
1683734963580,TMC 2,A02,187534,Staff,25,0,25,0
1683734964606,USP 1,A01,187536,Kwak; Nancy,0,16,25,25
1683734965633,USP 5,A01,187538,Staff,8,0,25,17
1683734966658,USP 101,A00,199253,Staff,0,4,0,0
1683734967682,USP 124,A00,187562,Boomhower; Matthew Charles,0,0,30,30
1683734968706,USP 138,A00,187582,Staff,19,0,25,6
1683734969736,USP 152,A01,187597,Staff,3,0,25,22
1683734970766,USP 153,A00,187598,Staff,18,0,25,7
1683734971793,USP 168,A00,187607,Kwak; Nancy,2,0,5,3
1683734972824,USP 173,A00,187619,Staff,4,0,25,21
1683734973851,USP 181,A00,187638,Staff,0,4,25,25
1683734974883,VIS 103,A00,187650,Cruz; Edwin Teddy,17,0,75,58
1683734975911,VIS 110D,A00,187669,Staff,13,0,22,9
1683734976936,VIS 127C,A00,187720,Shen; Kuiyi,67,0,146,79
1683734977960,VIS 149,A00,187731,Yoldas; Pinar,0,12,22,22
1683734978985,VIS 151,A01,188091,Staff,22,0,34,12
1683734978985,VIS 151,A02,188092,Staff,11,0,34,23
1683734980012,VIS 160B,A00,188093,Stalbaum; Brett,0,1,10,10
1683734982062,WCWP 10B,A00,201720,Staff,0,0,5,5
1683734982062,WCWP 10B,B00,201722,Staff,0,0,6,6
1683734983091,WCWP 100,A00,201725,Gagnon; Jeffrey C,0,0,2,2
1683734983091,WCWP 100,B00,201727,Staff,0,4,15,15
1683734986200,ANBI 133,A00,258401,Wilder; Linnea Lorene,34,0,40,6
1683734987226,ANBI 140,A00,258395,Hrvoj Mihic; Branka,18,0,25,7
1683734988249,ANSC 120,A00,258402,Bialecki; Jon Anthony,26,0,40,14
1683734989274,ANSC 144,A00,258400,Staff,12,0,40,28
1683734991327,ANSC 166,A00,258396,Parish; Steven Martin,156,0,175,19
1683734992349,ANSC 180,A00,193533,Staff,8,0,20,12
1683734993373,ANSC 188,A00,258397,Jassal; Aftab,34,0,40,6
1683734994402,ANTH 3,A01,258316,Staff,23,0,30,7
1683734995425,ANTH 5,A00,258394,Semendeferi; Ekaterini,16,0,20,4
1683734996450,ANTH 21,A01,258331,Staff,4,0,40,36
1683734997474,ANTH 103,A00,258398,Varma; Saiba,15,0,25,10
1683734998506,AWP 10,001,202034,Staff,0,0,0,0
1683734998506,AWP 10,002,202035,Staff,0,0,0,0
1683734998506,AWP 10,003,202036,Staff,0,0,0,0
1683734998506,AWP 10,004,202037,Staff,0,0,0,0
1683734998506,AWP 10,005,202038,Staff,0,0,0,0
1683734998506,AWP 10,006,202039,Staff,0,0,0,0
1683734998506,AWP 10,007,202040,Staff,0,0,0,0
1683734998506,AWP 10,008,202041,Staff,0,0,0,0
1683734998506,AWP 10,009,202042,Staff,0,0,0,0
1683734998506,AWP 10,010,202043,Staff,0,0,0,0
1683734998506,AWP 10,011,202044,Staff,0,0,0,0
1683734998506,AWP 10,012,202045,Staff,0,0,0,0
1683734998506,AWP 10,013,202046,Staff,0,0,0,0
1683734998506,AWP 10,014,202047,Staff,0,0,0,0
1683734998506,AWP 10,015,202048,Staff,0,0,0,0
1683734998506,AWP 10,016,202049,Staff,0,0,0,0
1683734998506,AWP 10,017,202050,Staff,0,0,0,0
1683734998506,AWP 10,018,202051,Staff,0,0,0,0
1683734998506,AWP 10,019,202052,Staff,0,0,0,0
1683734998506,AWP 10,020,202053,Staff,0,0,0,0
1683734998506,AWP 10,021,202054,Staff,0,0,0,0
1683734998506,AWP 10,022,202055,Staff,0,0,0,0
1683734998506,AWP 10,023,202056,Staff,0,0,0,0
1683734998506,AWP 10,024,202057,Staff,0,0,0,0
1683734998506,AWP 10,025,202058,Staff,0,0,0,0
1683734998506,AWP 10,026,202059,Staff,0,0,0,0
1683734999534,AWP 102,001,202032,Staff,0,0,0,0
1683734999534,AWP 102,002,202033,Staff,0,0,0,0
1683735000556,BENG 100,A01,254234,Taylor Amos; Alyssa C,31,0,40,9
1683735001582,BENG 196,001,270013,Engler; Adam J.,9999,0,9999,0
1683735002612,BICD 100R,A01,202018,Smith; Laurie,0,7,32,32
1683735002612,BICD 100R,A02,202019,Smith; Laurie,0,3,32,32
1683735002612,BICD 100R,A03,202020,Smith; Laurie,0,1,32,32
1683735002612,BICD 100R,A04,202021,Smith; Laurie,6,0,32,26
1683735002612,BICD 100R,A05,202022,Smith; Laurie,10,0,32,22
1683735003636,BICD 136,A01,193242,Gustafson-Brown; Cindy,0,2,32,32
1683735003636,BICD 136,A02,193244,Gustafson-Brown; Cindy,13,0,32,19
1683735004662,BIEB 102,A01,193249,Butler; Shannon Rhey,0,0,32,32
1683735004662,BIEB 102,A02,193251,Butler; Shannon Rhey,0,0,32,32
1683735004662,BIEB 102,A03,193253,Butler; Shannon Rhey,0,0,32,32
1683735004662,BIEB 102,A04,193255,Butler; Shannon Rhey,13,0,32,19
1683735004662,BIEB 102,A05,193265,Butler; Shannon Rhey,25,0,32,7
1683735004662,BIEB 102,A06,193269,Butler; Shannon Rhey,12,0,32,20
1683735006711,BIEB 150,A01,193274,Staff,0,0,32,32
1683735006711,BIEB 150,A02,193285,Staff,24,0,32,8
1683735007735,BIEB 194,A00,193286,Kurle; Carolyn M.,19,0,32,13
1683735008764,BILD 1,A01,192291,Staff,15,0,32,17
1683735008764,BILD 1,A02,192292,Staff,30,0,32,2
1683735008764,BILD 1,B01,192520,Reuther; Keefe,0,1,0,0
1683735008764,BILD 1,B02,192532,Reuther; Keefe,0,1,0,0
1683735009798,BILD 3,A01,192556,Butler; Shannon Rhey,0,0,32,32
1683735009798,BILD 3,A02,192581,Butler; Shannon Rhey,0,1,32,32
1683735009798,BILD 3,A03,192611,Butler; Shannon Rhey,19,0,32,13
1683735009798,BILD 3,A04,192612,Butler; Shannon Rhey,23,0,32,9
1683735009798,BILD 3,A05,192613,Butler; Shannon Rhey,26,0,32,6
1683735009798,BILD 3,A06,192679,Butler; Shannon Rhey,27,0,32,5
1683735009798,BILD 3,A07,192682,Butler; Shannon Rhey,20,0,32,12
1683735010825,BILD 4,A01,192836,Reuther; Keefe,1,0,24,23
1683735010825,BILD 4,A02,193044,Reuther; Keefe,4,0,24,20
1683735011853,BILD 10,A01,193142,Gustafson-Brown; Cindy,29,0,32,3
1683735011853,BILD 10,A02,193149,Gustafson-Brown; Cindy,31,0,32,1
1683735012877,BIMM 100,A01,193301,Staff,0,6,32,32
1683735012877,BIMM 100,A02,193312,Staff,0,7,32,32
1683735012877,BIMM 100,A03,193323,Staff,0,10,32,32
1683735013910,BIMM 101,A01,193329,McDonnell; Lisa Marie,0,3,24,24
1683735013910,BIMM 101,A02,193339,McDonnell; Lisa Marie,0,3,24,24
1683735013910,BIMM 101,B01,193354,McDonnell; Lisa Marie,0,4,24,24
1683735013910,BIMM 101,B02,193357,McDonnell; Lisa Marie,0,3,24,24
1683735014934,BIMM 110,A01,193377,Tat; John,0,11,32,32
1683735014934,BIMM 110,A02,193378,Tat; John,0,11,32,32
1683735016041,BIMM 120,A01,206116,Staff,1,0,32,31
1683735016041,BIMM 120,A02,206117,Staff,7,0,32,25
1683735016041,BIMM 120,A03,206121,Staff,21,0,32,11
1683735017070,BIPN 100,A01,193393,Park; Ji Young,0,15,32,32
1683735017070,BIPN 100,A02,193402,Park; Ji Young,0,14,32,32
1683735017070,BIPN 100,A03,193413,Park; Ji Young,0,14,32,32
1683735017070,BIPN 100,A04,193414,Park; Ji Young,0,13,32,32
1683735018094,BIPN 102,A01,193429,Staff,0,0,32,32
1683735018094,BIPN 102,A02,193438,Staff,18,0,32,14
1683735019119,BIPN 106,A01,193450,Reyes Gonzalez; Catalina,0,2,40,40
1683735020147,BIPN 134,A01,193465,Cooke; James Edward,0,0,32,32
1683735020147,BIPN 134,A02,193474,Cooke; James Edward,24,0,32,8
1683735020147,BIPN 134,A03,193485,Cooke; James Edward,29,0,32,3
1683735020147,BIPN 134,A04,193486,Cooke; James Edward,20,0,32,12
1683735020147,BIPN 134,A05,193491,Cooke; James Edward,31,0,32,1
1683735020147,BIPN 134,A06,193501,Cooke; James Edward,30,0,32,2
1683735020147,BIPN 134,A07,193510,Cooke; James Edward,29,0,32,3
1683735022205,BISP 194,A00,222522,Staff,14,0,32,18
1683735023232,CAT 124,A01,202407,Staff,19,0,25,6
1683735024259,CAT 125,A00,202408,Marchisotto; Jennifer Anne,2,0,20,18
1683735025288,CAT 125R,A00,202409,Smith; Lauryn Alissa,0,11,20,20
1683735025288,CAT 125R,B00,202410,Morales; Celeste Georgianna,0,11,20,20
1683735025288,CAT 125R,C00,202411,Irwin; Matthew Joseph,0,12,20,20
1683735026324,CENG 15,A01,204712,Yang; Kesong,0,1,0,0
1683735027351,CENG 114,A00,202070,Jahed Motlagh; Zeinab,5,0,20,15
1683735028374,CGS 105,A00,185477,Wesling; Megan E.,24,0,40,16
1683735029398,CGS 106,A00,185494,Staff,11,0,22,11
1683735030421,CGS 108,A00,185495,Staff,14,0,20,6
1683735031447,CGS 114,A00,185496,Staff,13,0,18,5
1683735032479,CGS 119,A00,185501,Staff,15,0,20,5
1683735033504,CGS 120,A00,185511,Staff,11,0,20,9
1683735034532,CHEM 4,A01,184675,Bussey; Thomas J,97,0,100,3
1683735035559,CHEM 6A,A01,184677,Staff,32,0,60,28
1683735036586,CHEM 6B,A01,184679,Staff,63,0,100,37
1683735037614,CHEM 6C,A01,184681,Bussey; Thomas J,0,0,50,50
1683735037614,CHEM 6C,A02,184682,Bussey; Thomas J,32,0,50,18
1683735038639,CHEM 40A,A01,184684,Albizati; Kim F.,33,0,100,67
1683735039668,CHEM 40B,A01,184686,Albizati; Kim F.,0,22,100,100
1683735040693,CHEM 41B,A01,184690,Staff,51,0,100,49
1683735041718,COGS 3,A01,184715,Boyle; Mary E. T.,0,27,40,40
1683735042744,COGS 14B,A01,185172,Staff,0,14,38,38
1683735043771,COGS 18,A01,184736,Staff,14,0,80,66
1683735044798,COGS 100,A01,184932,Staff,0,8,73,73
1683735045822,COGS 101A,A01,184935,Staff,0,40,30,30
1683735046854,COGS 101B,A01,184944,Staff,0,2,30,30
1683735047879,COGS 101C,A01,184946,Staff,0,10,30,30
1683735048906,COGS 102A,A01,184951,Johnson; Christine M.,1,0,40,39
1683735049936,COGS 107B,A01,184953,Mooshagian; Eric Frederick,0,52,40,40
1683735050965,COGS 118B,A01,184959,Gupta; Anjum,0,50,40,40
1683735051993,COGS 153,A00,184961,Staff,1,16,30,29
1683735053022,COGS 177,A00,184962,Staff,0,20,30,30
1683735054047,COGS 187A,A01,184969,Boyle; Mary E. T.,0,19,40,40
1683735055075,COMM 10,A01,185174,Staff,0,5,25,25
1683735055075,COMM 10,A02,185189,Staff,0,2,25,25
1683735055075,COMM 10,A03,269821,Staff,0,1,0,0
1683735056099,COMM 100B,A02,185476,Staff,10,0,25,15
1683735056099,COMM 100B,A03,277340,Staff,25,0,25,0
1683735057123,COMM 100C,A01,185314,Staff,2,0,25,23
1683735057123,COMM 100C,A02,185327,Staff,17,0,25,8
1683735058148,COMM 110M,A00,185349,Staff,0,0,40,40
1683735059172,COMM 113T,A00,185352,Staff,25,0,40,15
1683735060198,COMM 114I,A00,185353,Staff,31,0,40,9
1683735061267,COMM 131,A00,185354,Staff,17,0,30,13
1683735062291,CSE 8A,A50,185358,Cao; Yingjun,0,46,10,10
1683735063318,CSE 8B,A01,185362,Staff,0,48,50,50
1683735064342,CSE 11,A01,185416,Cao; Yingjun,0,91,10,10
1683735065366,CSE 20,A01,185445,Briones; Jor-el Thomas Caparas,3,0,25,22
1683735066390,CSE 21,A01,185447,Staff,9,0,50,41
1683735067414,CSE 101,A01,185451,Staff,0,13,50,50
1683735067414,CSE 101,B01,185453,Jones; Miles E,0,15,50,50
1683735069466,CSE 141,A01,185458,Eldon; John,16,0,100,84
1683735070492,CSE 141L,A01,185461,Eldon; John,8,0,100,92
1683735071520,CSE 142,A01,185463,Staff,34,0,60,26
1683735071520,CSE 142,B01,201355,Staff,0,7,60,60
1683735072548,CSE 142L,A01,185470,Staff,34,0,60,26
1683735072548,CSE 142L,B01,201417,Staff,0,6,60,60
1683735073573,CSE 190,A00,201433,Staff,32,0,49,17
1683735074603,DOC 1,A01,259136,Strom; Megan C.,7,0,15,8
1683735074603,DOC 1,A02,259137,Strom; Megan C.,15,0,15,0
1683735074603,DOC 1,A03,259138,Strom; Megan C.,14,0,15,1
1683735074603,DOC 1,A04,259139,Strom; Megan C.,13,0,15,2
1683735075627,DOC 100D,A00,259140,Pass; Natalye Joann,14,0,25,11
1683735076655,DSGN 1,A01,184749,Rill; Bryan,0,26,30,30
1683735077683,DSGN 100,A01,185168,Staff,0,2,25,25
1683735078709,ECE 5,A01,185626,Morris; Karcher William,0,12,0,0
1683735079732,ECE 101,A01,185628,Staff,14,0,70,56
1683735080757,ECE 107,A01,185635,Baghdadchi; Saharnaz,0,0,20,20
1683735080757,ECE 107,A02,185638,Baghdadchi; Saharnaz,1,0,20,19
1683735081784,ECE 148,A01,185647,Silberman; Jack,0,0,16,16
1683735082811,ECON 1,A01,185537,Crane; Meredith Helen,54,0,70,16
1683735083838,ECON 3,A01,185549,Crane; Meredith Helen,30,0,70,40
1683735084866,ECON 4,A01,203354,Anderson; John Charles,0,5,10,10
1683735085894,ECON 100A,A01,185574,Staff,0,5,40,40
1683735086918,ECON 100B,A01,185576,Staff,0,12,50,50
1683735087946,ECON 100C,A01,185589,Newhouse; Herbert S,30,0,70,40
1683735088971,ECON 105,A00,185608,Vespa; Emanuel Ignacio,19,0,35,16
1683735089997,ECON 109,A01,185610,Shishkin; Denis,9,0,35,26
1683735091024,ECON 110A,A01,185612,Staff,8,0,40,32
1683735092047,ECON 120A,A01,185615,Staff,19,0,40,21
1683735093070,ECON 120C,A01,185617,Sun; Yixiao,0,21,70,70
1683735094092,ECON 144,A00,203346,Squires; Dale E,2,0,35,33
1683735095158,ECON 171,A01,203349,Newhouse; Herbert S,0,1,35,35
1683735096186,ECON 173A,A01,185621,Toda; Alexis Akira,21,0,35,14
1683735097216,EDS 25,A01,202413,Staff,0,1,0,0
1683735097216,EDS 25,A02,202414,Staff,0,1,0,0
1683735097216,EDS 25,A03,202415,Staff,0,0,0,0
1683735097216,EDS 25,A04,202416,Staff,0,1,0,0
1683735097216,EDS 25,A05,202439,Staff,0,0,0,0
1683735097216,EDS 25,A06,202440,Staff,0,0,0,0
1683735097216,EDS 25,B01,202631,Staff,0,0,0,0
1683735097216,EDS 25,B02,202632,Staff,0,0,0,0
1683735097216,EDS 25,B03,202639,Staff,0,0,0,0
1683735097216,EDS 25,B04,202640,Staff,0,0,0,0
1683735097216,EDS 25,B05,202643,Staff,0,0,0,0
1683735097216,EDS 25,B06,202644,Staff,0,0,0,0
1683735098243,EDS 38,A01,202659,Black; Alison Michelle,25,0,25,0
1683735099268,EDS 115,A00,202652,Staff,18,0,30,12
1683735100298,EDS 125,A00,202649,Staff,13,0,30,17
1683735101322,EDS 126,A01,203332,Staff,30,0,30,0
1683735102354,EDS 139,A00,202838,Staff,16,0,25,9
1683735103380,EDS 146,A01,202655,Staff,14,0,25,11
1683735104406,ENG 15,A00,185667,Staff,0,1,0,2
1683735104406,ENG 15,B00,185672,Staff,0,0,0,1
1683735104406,ENG 15,C00,185675,Staff,0,0,0,0
1683735104406,ENG 15,D00,185682,Staff,0,0,0,0
1683735104406,ENG 15,E00,185684,Staff,0,0,0,0
1683735105433,ETHN 103,A00,185710,Staff,0,8,35,35
1683735106458,ETHN 103A,A00,199228,Man; Simeon S,0,0,9,9
1683735107485,ETHN 109,A00,185711,Staff,15,0,35,20
1683735108512,ETHN 142,A00,185726,Staff,0,4,30,30
1683735109536,ETHN 163J,A00,199229,Man; Simeon S,5,0,8,3
1683735110561,ETHN 168,A00,185727,Staff,7,0,10,3
1683735111585,ETHN 182,A00,185728,Staff,0,0,35,35
1683735112609,ETHN 183,A00,185737,Staff,10,0,18,8
1683735113635,GLBH 111,A01,209361,Burgos; Jose L.,0,0,0,0
1683735115684,HIEU 104,A00,185792,Staff,14,0,20,6
1683735116712,HIEU 115,A00,185800,Staff,0,0,20,20
1683735117738,HIEU 128,A00,185801,Staff,0,9,20,20
1683735118764,HIEU 147,A00,185802,Staff,15,0,20,5
1683735119845,HIEU 154,A00,185823,Staff,11,0,20,9
1683735120872,HILA 102,A00,185826,Staff,14,0,20,6
1683735121900,HILD 2C,A01,185778,Staff,0,13,20,20
1683735122924,HILD 7B,A01,185780,Kwak; Nancy,0,17,32,32
1683735122924,HILD 7B,A02,185781,Kwak; Nancy,0,18,32,32
1683735123950,HILD 30,A01,185791,Staff,12,0,20,8
1683735124979,HISC 119,A00,185830,Golan; Tal,0,10,20,20
1683735126008,HITO 156GS,A00,185831,Patterson; Patrick H.,0,0,0,23
1683735127032,HIUS 103,A00,185832,Man; Simeon S,0,4,20,20
1683735128059,HIUS 117,A00,185836,Kwak; Nancy,2,0,20,18
1683735129084,HIUS 125,A00,185840,Man; Simeon S,0,2,23,23
1683735130110,HIUS 149,A00,185845,Staff,1,0,20,19
1683735131134,HUM 3,A01,185882,Zavodny; Tatiana Sophia,0,8,50,50
1683735131134,HUM 3,B01,185899,Caldwell; Michael Alan,0,18,50,50
1683735132158,HUM 3GS,A00,185900,Patterson; Patrick H.,0,0,0,23
1683735133181,HUM 4,A01,185938,Zroka; Amy Liane,28,0,50,22
1683735133181,HUM 4,B01,185956,Watkins; Eric,0,6,50,50
1683735133181,HUM 4,B02,202209,Watkins; Eric,0,6,50,50
1683735133181,HUM 4,B03,202210,Watkins; Eric,0,5,50,50
1683735134207,HUM 5,A01,185958,West; Geoffrey Scott,0,0,50,50
1683735134207,HUM 5,A02,202215,West; Geoffrey Scott,0,1,50,50
1683735135234,INTL 190,A00,185959,Gagnon; Jeffrey C,0,0,0,9
1683735135234,INTL 190,B00,185960,Lettieri; Michael Joseph,0,0,0,2
1683735136259,JAPN 180,A00,254509,Staff,4,0,30,26
1683735137291,LATI 10,A01,202853,Kennemore; Amy Michelle,0,0,31,31
1683735137291,LATI 10,A02,202854,Kennemore; Amy Michelle,0,0,32,32
1683735137291,LATI 10,A03,270054,Kennemore; Amy Michelle,30,0,30,0
1683735138316,LATI 180,A00,202855,Kennemore; Amy Michelle,11,0,20,9
1683735139339,LAWS 101,A00,201767,Golan; Tal,0,7,40,40
1683735140366,LIFR 1C,A00,185961,Staff,6,0,20,14
1683735141390,LIFR 1CX,A00,185962,Staff,7,0,20,13
1683735142413,LIFR 1D,A00,185963,Staff,7,0,20,13
1683735143437,LIFR 1DX,A00,185964,Staff,7,0,20,13
1683735144461,LIGN 101,A01,186039,Staff,43,0,50,7
1683735145486,LIGN 165,A00,186040,Staff,14,0,50,36
1683735146519,LTCS 108,A00,186041,Staff,5,0,10,5
1683735147543,LTCS 119,A00,186042,Staff,15,0,20,5
1683735148573,LTCS 130,A00,186043,Wesling; Megan E.,15,0,25,10
1683735150622,LTEA 138,A00,186119,Staff,13,0,40,27
1683735151649,LTEN 124,A00,186148,Staff,5,0,25,20
1683735152675,LTEN 178,A00,186149,Staff,6,0,15,9
1683735153698,LTEN 181,A00,186150,Blanco; John D,34,0,40,6
1683735154725,LTWL 120,A00,186160,Staff,19,0,25,6
1683735155751,LTWL 165,A00,186161,Staff,22,0,25,3
1683735156774,LTWR 100,A00,186162,Staff,0,5,15,15
1683735157798,LTWR 102,A00,186163,Doller; Ben,5,0,15,10
1683735158827,MAE 8,A01,186412,Staff,0,1,0,1
1683735159851,MAE 30B,A00,186445,Bahadori; Mohammad Yousef,81,0,100,19
1683735160875,MAE 40,A00,186592,Bewley; Thomas R,10,0,50,40
1683735161902,MAE 101B,A00,186593,Bahadori; Mohammad Yousef,80,0,100,20
1683735162926,MAE 105,A00,186594,Bandaru; Prabhakar,10,0,50,40
1683735163954,MAE 107,A00,186599,Pham; Hieu Tan,0,8,120,120
1683735164979,MAE 148,A01,186660,Silberman; Jack,3,0,16,13
1683735166006,MATH 10A,A01,188095,Staff,0,6,35,35
1683735167035,MATH 10B,A01,188097,Bowers; Adam R.,0,12,30,30
1683735167035,MATH 10B,A02,188099,Bowers; Adam R.,0,11,30,30
1683735167035,MATH 10B,B01,188104,Bowers; Adam R.,0,10,30,30
1683735167035,MATH 10B,B02,188106,Bowers; Adam R.,0,9,30,30
1683735168063,MATH 10C,A01,188111,Staff,0,20,30,30
1683735168063,MATH 10C,A02,188127,Staff,0,19,30,30
1683735168063,MATH 10C,A03,188131,Staff,0,19,30,30
1683735168063,MATH 10C,B01,188218,Staff,17,0,30,13
1683735168063,MATH 10C,B02,188244,Staff,13,0,30,17
1683735168063,MATH 10C,B03,188277,Staff,14,0,30,16
1683735169089,MATH 18,A01,188344,Bach; Quang Tran,18,0,30,12
1683735169089,MATH 18,A02,188345,Bach; Quang Tran,11,0,30,19
1683735169089,MATH 18,B01,188353,Bach; Quang Tran,11,0,30,19
1683735169089,MATH 18,B02,188354,Bach; Quang Tran,19,0,30,11
1683735170114,MATH 20A,A01,188374,Staff,10,0,35,25
1683735171139,MATH 20B,A01,188382,Ohm; Ko Woon,7,0,30,23
1683735171139,MATH 20B,A02,188383,Ohm; Ko Woon,22,0,30,8
1683735171139,MATH 20B,B01,188385,Ohm; Ko Woon,7,0,30,23
1683735171139,MATH 20B,B02,188392,Ohm; Ko Woon,22,0,30,8
1683735172168,MATH 20C,A01,188394,Harel; Guershon,10,0,30,20
1683735172168,MATH 20C,A02,188395,Harel; Guershon,13,0,30,17
1683735172168,MATH 20C,B01,188404,Harel; Guershon,5,0,30,25
1683735172168,MATH 20C,B02,188405,Harel; Guershon,18,0,30,12
1683735173194,MATH 20D,A01,188414,Hammock; Frances H,0,1,30,30
1683735173194,MATH 20D,A02,188415,Hammock; Frances H,0,1,30,30
1683735173194,MATH 20D,B01,188447,Hammock; Frances H,0,1,30,30
1683735173194,MATH 20D,B02,188486,Hammock; Frances H,2,0,30,28
1683735174219,MATH 20E,A01,188649,Staff,21,0,30,9
1683735174219,MATH 20E,A02,188650,Staff,20,0,30,10
1683735174219,MATH 20E,A03,188673,Staff,0,0,30,30
1683735175243,MATH 102,A01,188675,Staff,0,40,35,35
1683735176272,MATH 103B,A01,188681,Staff,3,0,35,32
1683735176272,MATH 103B,B01,188692,Staff,5,0,35,30
1683735177296,MATH 109,A01,188695,Salehi Golsefidy; Alireza,24,0,35,11
1683735177296,MATH 109,A02,188696,Salehi Golsefidy; Alireza,24,0,35,11
1683735178319,MATH 120A,A01,188698,Eggers; John Dietrich,7,0,35,28
1683735179347,MATH 142B,A01,188736,Ioana; Adrian,0,0,30,30
1683735179347,MATH 142B,A02,188741,Ioana; Adrian,0,1,30,30
1683735179347,MATH 142B,A03,188743,Ioana; Adrian,0,3,30,30
1683735180371,MATH 168A,A01,188790,Staff,0,11,35,35
1683735181396,MATH 170A,A01,188803,Nie; Jiawang,0,2,35,35
1683735181396,MATH 170A,A02,188811,Nie; Jiawang,0,1,35,35
1683735181396,MATH 170A,A03,188814,Nie; Jiawang,1,0,35,34
1683735181396,MATH 170A,A04,188815,Nie; Jiawang,5,0,35,30
1683735182421,MATH 193B,A01,188817,Staff,0,0,35,35
1683735182421,MATH 193B,A02,188818,Staff,6,0,35,29
1683735183446,MGT 4,A01,202857,Anderson; John Charles,59,0,80,21
1683735184471,MGT 12,A00,202858,Lindenberger; Wade Douglas,40,0,90,50
1683735185495,MGT 18,A00,202859,Staff,73,0,90,17
1683735186520,MGT 18GS,A00,202860,McKay; Michael J,13,0,28,15
1683735187545,MGT 45,A00,202861,Pecore; Joseph P.,8,0,90,82
1683735188571,MGT 100,A00,202863,Yavorsky; Daniel Ryan,27,0,90,63
1683735189596,MGT 103,A00,202864,Ehrich; Kristine R,0,19,90,90
1683735190623,MGT 112,A00,202865,Ehrich; Kristine R,15,0,90,75
1683735191648,MGT 121A,A00,202868,Staff,70,0,90,20
1683735192674,MGT 131B,A00,202869,Anderson; John Charles,58,0,90,32
1683735193698,MGT 136,A00,202871,Lindenberger; Wade Douglas,83,0,90,7
1683735194726,MGT 164,A00,202873,Staff,0,67,90,91
1683735195751,MGT 164GS,A00,202874,McKay; Mary A,13,0,28,15
1683735196782,MGT 180,A00,202875,Staff,0,51,90,91
1683735197810,MMW 11R,A01,205019,Herbst; Matthew,0,0,30,30
1683735197810,MMW 11R,A02,205026,Herbst; Matthew,29,0,30,1
1683735198836,MMW 15,A01,193512,Chang; Edmond Yi-Teh,0,8,28,28
1683735198836,MMW 15,A02,193513,Chang; Edmond Yi-Teh,0,5,28,28
1683735198836,MMW 15,A03,193514,Chang; Edmond Yi-Teh,0,5,28,28
1683735198836,MMW 15,A04,193515,Chang; Edmond Yi-Teh,0,5,28,28
1683735198836,MMW 15,A05,193516,Chang; Edmond Yi-Teh,0,5,28,28
1683735198836,MMW 15,A06,193517,Chang; Edmond Yi-Teh,0,6,28,28
1683735198836,MMW 15,B01,193519,Chang; Edmond Yi-Teh,0,5,28,28
1683735198836,MMW 15,B02,193520,Chang; Edmond Yi-Teh,0,5,28,28
1683735198836,MMW 15,B03,193521,Chang; Edmond Yi-Teh,0,5,28,28
1683735198836,MMW 15,B04,193522,Chang; Edmond Yi-Teh,0,6,28,28
1683735198836,MMW 15,B05,193523,Chang; Edmond Yi-Teh,0,5,28,28
1683735198836,MMW 15,B06,193524,Chang; Edmond Yi-Teh,0,5,28,28
1683735199865,MMW 122,A01,193526,Rahimi; Babak,0,16,28,28
1683735199865,MMW 122,A02,193527,Rahimi; Babak,0,15,28,28
1683735199865,MMW 122,A03,193528,Rahimi; Babak,0,0,0,0
1683735199865,MMW 122,A04,193529,Rahimi; Babak,0,0,0,0
1683735200893,MUS 1A,A01,186663,Staff,0,18,35,35
1683735201920,MUS 4,A01,186715,Staff,0,12,35,35
1683735202946,MUS 5R,A01,186796,Dubnov; Shlomo,0,17,35,35
1683735203971,MUS 6,A01,186798,Staff,0,4,25,25
1683735204995,MUS 7,A01,186830,Staff,11,0,35,24
1683735206018,MUS 8,A01,186930,Staff,0,27,35,35
1683735207042,MUS 15,A01,186932,Staff,0,15,35,35
1683735207042,MUS 15,B01,186934,Staff,0,16,35,35
1683735208066,MUS 80,A00,186935,Staff,0,0,20,20
1683735208066,MUS 80,B00,186936,Staff,24,0,25,1
1683735209090,NANO 11,A00,204702,Lipomi; Darren John,0,0,0,0
1683735210118,NANO 15,A01,204709,Yang; Kesong,0,1,0,0
1683735211142,NANO 114,A00,202069,Jahed Motlagh; Zeinab,2,0,10,8
1683735212169,PHIL 1,A00,186955,Grush; Rick Scott,31,0,40,9
1683735213198,PHIL 10,A01,186973,Grush; Rick Scott,27,0,35,8
1683735213198,PHIL 10,A02,186974,Grush; Rick Scott,33,0,35,2
1683735214224,PHIL 13,A01,186976,Staff,1,0,35,34
1683735214224,PHIL 13,A02,186977,Staff,16,0,35,19
1683735215248,PHIL 14,A01,186979,Staff,30,0,35,5
1683735215248,PHIL 14,A02,186986,Staff,32,0,35,3
1683735216273,PHIL 28,A01,186988,Staff,16,0,30,14
1683735216273,PHIL 28,A02,186989,Staff,0,0,30,30
1683735216273,PHIL 28,A03,186990,Staff,10,0,30,20
1683735216273,PHIL 28,A04,186991,Staff,26,0,30,4
1683735217298,PHIL 120,A00,186997,Staff,23,0,40,17
1683735218325,PHIL 137,A00,187003,Staff,8,0,40,32
1683735219352,PHIL 150,A00,187015,Staff,47,0,70,23
1683735220379,PHIL 167,A00,187021,Lamey; Andy M.,34,0,40,6
1683735221402,PHIL 174,A01,202226,Staff,17,0,20,3
1683735221402,PHIL 174,A02,202235,Staff,20,0,20,0
1683735222424,PHIL 191A,A00,258918,Staff,0,0,1,1
1683735223507,PHYS 1A,A00,187028,Staff,26,0,60,34
1683735224531,PHYS 1AL,001,187036,Staff,3,0,30,27
1683735224531,PHYS 1AL,002,187049,Staff,18,0,30,12
1683735225559,PHYS 1B,A00,187058,Staff,21,0,60,39
1683735226584,PHYS 1BL,001,187064,Staff,0,1,30,30
1683735226584,PHYS 1BL,002,187070,Staff,4,0,30,26
1683735227607,PHYS 1C,A00,187082,Staff,30,0,120,90
1683735228635,PHYS 1CL,001,187088,Staff,0,9,30,30
1683735228635,PHYS 1CL,002,187089,Staff,0,1,30,30
1683735228635,PHYS 1CL,009,262693,Staff,9,0,30,21
1683735229660,PHYS 2B,A01,187097,Staff,55,0,115,60
1683735230684,PHYS 2C,A01,187099,Staff,63,0,115,52
1683735231715,PHYS 2CL,A01,187101,Staff,5,0,28,23
1683735231715,PHYS 2CL,A02,187102,Staff,15,0,28,13
1683735232738,PHYS 2D,A01,187123,Shotwell; Brian,95,0,115,20
1683735233762,PHYS 4B,A01,187133,Grinstein; Benjamin,35,0,50,15
1683735234786,POLI 10,A00,188819,Staff,0,4,50,50
1683735235810,POLI 11,A00,188827,Staff,43,0,50,7
1683735236837,POLI 13R,A00,188828,Staff,0,2,20,20
1683735237865,POLI 27,A01,188830,Elgin; Samuel Zincke,0,2,70,70
1683735238892,POLI 30,A00,188832,Desposato; Scott,30,0,50,20
1683735239918,POLI 102F,A00,188834,Staff,1,0,40,39
1683735240948,POLI 104A,A00,188852,Staff,12,0,30,18
1683735241975,POLI 104I,A00,188853,Staff,0,8,20,20
1683735243002,POLI 110B,A00,188854,Wiens; David,6,0,20,14
1683735244027,POLI 112A,A00,188855,Wiens; David,3,0,30,27
1683735245051,POLI 117R,A00,188856,Forman; Fonna,0,12,20,20
1683735246078,POLI 118,A00,188857,Ingham; Sean,8,0,20,12
1683735247106,POLI 120G,A00,188858,Staff,7,0,30,23
1683735248133,POLI 131CR,A00,188863,Hoston; Germaine,20,0,50,30
1683735249158,POLI 133,A00,188864,Nellis; Gareth Hb,44,0,50,6
1683735250182,POLI 134D,A00,188865,Desposato; Scott,27,0,30,3
1683735251210,POLI 142A,A00,188871,Gartzke; Erik,21,0,50,29
1683735252238,POLI 142K,A00,188874,Staff,38,0,50,12
1683735253261,POLI 143,A00,188940,Gartzke; Erik,15,0,30,15
1683735254288,POLI 153,A00,188943,Staff,1,0,20,19
1683735255314,POLI 160AA,A00,188944,Staff,10,0,40,30
1683735256339,POLI 170A,A00,188945,Staff,10,0,30,20
1683735258419,PSYC 1,A00,188952,Staff,36,0,90,54
1683735259443,PSYC 2,B00,188953,Staff,19,0,35,16
1683735260467,PSYC 6,A00,188970,Staff,47,0,60,13
1683735261492,PSYC 7,A00,188973,Staff,35,0,45,10
1683735262515,PSYC 60,A01,188980,Rickard; Timothy C.,42,0,60,18
1683735263543,PSYC 70,A01,189001,Steiner; Eric Tomas,21,0,45,24
1683735264577,PSYC 100,A00,189005,Lacefield; Katharine I,1,98,120,119
1683735265605,PSYC 102,A00,189008,Staff,6,0,30,24
1683735266632,PSYC 106,B00,189026,Gorman; Michael R.,26,0,60,34
1683735267656,PSYC 114,B01,189033,Winkielman; Piotr,0,31,30,30
1683735268682,PSYC 131,A00,189036,Anagnostaras; Stephan,0,44,60,60
1683735269707,PSYC 136,A00,189041,Lowe; Angela Beth,0,7,25,25
1683735270730,PSYC 137,A00,189057,Winkielman; Piotr,0,36,25,25
1683735271758,PSYC 144,A00,189107,Wixted; John T,0,11,50,50
1683735273808,PSYC 162,A00,189142,Staff,0,9,85,85
1683735274835,PSYC 172,A00,189144,Gorman; Michael R.,0,6,30,30
1683735276887,PSYC 179,A00,189146,Lacefield; Katharine I,0,88,120,120
1683735277912,PSYC 181,A00,189147,Anagnostaras; Stephan,110,45,200,90
1683735278936,PSYC 190R,A00,189148,Barner; David A.,0,23,80,80
1683735279961,PSYC 191,A00,189275,Rickard; Timothy C.,0,11,25,25
1683735280988,PSYC 193,A00,189276,Chapman; Eddie Nathaniel,0,1,0,4
1683735282017,PSYC 193L,A01,189281,Lowe; Angela Beth,8,0,20,12
1683735282017,PSYC 193L,B01,189285,Staff,28,0,35,7
1683735283043,RELI 149,A00,187137,Rahimi; Babak,6,0,40,34
1683735284069,SE 9,A01,187315,Staff,0,2,18,18
1683735285094,SE 101B,A00,187409,Staff,24,0,30,6
1683735286120,SE 110B,A00,187444,Staff,10,0,40,30
1683735287146,SE 130B,A00,187449,Staff,31,0,40,9
1683735288170,SE 150A,A00,187516,Staff,8,0,20,12
1683735289195,SE 154,A00,187528,Staff,29,0,50,21
1683735290219,SIO 3,A01,258171,Staff,35,0,40,5
1683735291247,SIO 10,A00,187144,Cook; Geoffrey W,0,6,75,75
1683735292271,SIO 45,A00,187152,Cook; Geoffrey W,1,7,100,99
1683735293295,SIO 109R,A00,194486,Staff,0,4,20,20
1683735295344,SIO 187,A01,187233,Kacev; David,12,0,40,28
1683735296370,SOCI 1,A01,258656,Thorpe; Charles Robert,28,0,30,2
1683735296370,SOCI 1,A02,258658,Thorpe; Charles Robert,30,0,30,0
1683735296370,SOCI 1,A03,258661,Thorpe; Charles Robert,25,0,25,0
1683735296370,SOCI 1,A04,258666,Thorpe; Charles Robert,22,0,25,3
1683735296370,SOCI 1,A05,258897,Thorpe; Charles Robert,22,0,25,3
1683735296370,SOCI 1,A06,258898,Thorpe; Charles Robert,25,0,25,0
1683735297395,SOCI 30,A01,258903,Pardo Guerra; Juan Pablo,14,0,30,16
1683735298421,SOCI 102,A00,258904,Staff,9,0,25,16
1683735299445,SOCI 106,A00,258905,Staff,19,0,25,6
1683735300467,SOCI 111,A00,258907,Ribas Norris; Janet Vanesa,26,0,30,4
1683735301497,SOCI 121R,A00,258908,Pardo Guerra; Juan Pablo,7,0,30,23
1683735302524,SOCI 126,A01,203330,Staff,14,0,20,6
1683735303550,SOCI 131,A00,258909,Thorpe; Charles Robert,30,0,60,30
1683735304585,SOCI 135,A00,258910,Payne; Christine Anna,0,13,30,30
1683735305611,SOCI 157,A00,258911,Staff,10,0,30,20
1683735306634,SOCI 184,A00,258912,Staff,25,0,30,5
1683735307658,SOCI 188D,A00,258913,Staff,22,0,30,8
1683735308683,SYN 2,001,187529,Staff,9,0,16,7
1683735308683,SYN 2,002,201452,Staff,0,20,16,16
1683735308683,SYN 2,003,201469,Staff,1,0,16,15
1683735309706,SYN 100,A01,187531,Staff,0,9,20,20
1683735309706,SYN 100,B01,201491,Staff,0,10,20,20
1683735310731,TDAC 1,A00,189286,Walsh; Kim C.,3,0,20,17
1683735310731,TDAC 1,B00,189287,Harting; Carla Kelso,10,0,20,10
1683735311757,TDAC 101,A00,189300,Walsh; Kim C.,16,0,20,4
1683735311757,TDAC 101,B00,189301,Harting; Carla Kelso,18,0,20,2
1683735312784,TDAC 102,A00,189304,Basso; Beatrice,14,0,20,6
1683735313808,TDAC 108,A00,189305,Staff,18,0,20,2
1683735314832,TDDE 131,A00,189310,Staff,19,0,20,1
1683735314832,TDDE 131,B00,189314,Staff,19,0,20,1
1683735314832,TDDE 131,C00,189315,Staff,48,0,50,2
1683735314832,TDDE 131,D00,189316,Staff,14,0,15,1
1683735314832,TDDE 131,E00,204841,Staff,20,0,20,0
1683735315856,TDGE 10,A00,189289,Staff,26,0,50,24
1683735315856,TDGE 10,B00,189290,Havis; Allan,0,1,50,50
1683735316885,TDGE 11,A00,189291,Fulton; Julia,0,4,50,50
1683735316885,TDGE 11,B00,189292,Staff,20,0,25,5
1683735316885,TDGE 11,C00,260270,Staff,0,0,0,0
1683735317910,TDGE 25,A00,189294,Staff,1,0,20,19
1683735318934,TDGE 124,A00,189318,Fulton; Julia,0,7,50,50
1683735319958,TDGE 125,A00,189319,Staff,13,0,25,12
1683735319958,TDGE 125,B00,189320,Staff,23,0,25,2
1683735320983,TDGE 127,A00,189322,Havis; Allan,1,0,50,49
1683735322011,TDHT 101,A00,189323,Staff,18,0,25,7
1683735322011,TDHT 101,B00,189324,Staff,25,0,25,0
1683735323034,TDHT 102,A00,189325,Staff,49,0,50,1
1683735324060,TDMV 1,A00,189295,Arcidiacono; Kristin,20,0,30,10
1683735324060,TDMV 1,B00,189296,Caligagan; Maria T.,23,0,30,7
1683735325084,TDMV 2,A00,189297,Sammartano; Tonnie,27,0,30,3
1683735325084,TDMV 2,B00,189299,Arcidiacono; Kristin,23,0,30,7
1683735326111,TDMV 3,A00,204998,Rincon; Alicia,22,0,30,8
1683735327209,TDMV 120,A00,189458,Sammartano; Tonnie,28,0,30,2
1683735328232,TDMV 138,A00,189541,Jun; Grace Shin Hae,20,0,40,20
1683735329259,TDMV 142,A00,189717,Caligagan; Tony,25,0,30,5
1683735329259,TDMV 142,B00,189718,Caligagan; Maria T.,25,0,30,5
1683735330286,TMC 2,A01,187533,Staff,25,0,25,0
1683735330286,TMC 2,A02,187534,Staff,25,0,25,0
1683735331313,USP 1,A01,187536,Kwak; Nancy,0,16,25,25
1683735332341,USP 5,A01,187538,Staff,8,0,25,17
1683735333365,USP 101,A00,199253,Staff,0,4,0,0
1683735334391,USP 124,A00,187562,Boomhower; Matthew Charles,0,0,30,30
1683735335415,USP 138,A00,187582,Staff,19,0,25,6
1683735336442,USP 152,A01,187597,Staff,3,0,25,22
1683735337466,USP 153,A00,187598,Staff,18,0,25,7
1683735338490,USP 168,A00,187607,Kwak; Nancy,2,0,5,3
1683735339519,USP 173,A00,187619,Staff,4,0,25,21
1683735340543,USP 181,A00,187638,Staff,0,4,25,25
1683735341567,VIS 103,A00,187650,Cruz; Edwin Teddy,17,0,75,58
1683735342594,VIS 110D,A00,187669,Staff,13,0,22,9
1683735343619,VIS 127C,A00,187720,Shen; Kuiyi,67,0,146,79
1683735344645,VIS 149,A00,187731,Yoldas; Pinar,0,12,22,22
1683735345668,VIS 151,A01,188091,Staff,22,0,34,12
1683735345668,VIS 151,A02,188092,Staff,11,0,34,23
1683735346696,VIS 160B,A00,188093,Stalbaum; Brett,0,1,10,10
1683735348748,WCWP 10B,A00,201720,Staff,0,0,5,5
1683735348748,WCWP 10B,B00,201722,Staff,0,0,6,6
1683735349773,WCWP 100,A00,201725,Gagnon; Jeffrey C,0,0,2,2
1683735349773,WCWP 100,B00,201727,Staff,0,4,15,15
1683735352896,ANBI 133,A00,258401,Wilder; Linnea Lorene,34,0,40,6
1683735353924,ANBI 140,A00,258395,Hrvoj Mihic; Branka,18,0,25,7
1683735354949,ANSC 120,A00,258402,Bialecki; Jon Anthony,26,0,40,14
1683735355976,ANSC 144,A00,258400,Staff,12,0,40,28
1683735358029,ANSC 166,A00,258396,Parish; Steven Martin,156,0,175,19
1683735359057,ANSC 180,A00,193533,Staff,8,0,20,12
1683735360081,ANSC 188,A00,258397,Jassal; Aftab,34,0,40,6
1683735361119,ANTH 3,A01,258316,Staff,23,0,30,7
1683735362164,ANTH 5,A00,258394,Semendeferi; Ekaterini,16,0,20,4
1683735363188,ANTH 21,A01,258331,Staff,4,0,40,36
1683735364212,ANTH 103,A00,258398,Varma; Saiba,15,0,25,10
1683735365239,AWP 10,001,202034,Staff,0,0,0,0
1683735365239,AWP 10,002,202035,Staff,0,0,0,0
1683735365239,AWP 10,003,202036,Staff,0,0,0,0
1683735365239,AWP 10,004,202037,Staff,0,0,0,0
1683735365239,AWP 10,005,202038,Staff,0,0,0,0
1683735365239,AWP 10,006,202039,Staff,0,0,0,0
1683735365239,AWP 10,007,202040,Staff,0,0,0,0
1683735365239,AWP 10,008,202041,Staff,0,0,0,0
1683735365239,AWP 10,009,202042,Staff,0,0,0,0
1683735365239,AWP 10,010,202043,Staff,0,0,0,0
1683735365239,AWP 10,011,202044,Staff,0,0,0,0
1683735365239,AWP 10,012,202045,Staff,0,0,0,0
1683735365239,AWP 10,013,202046,Staff,0,0,0,0
1683735365239,AWP 10,014,202047,Staff,0,0,0,0
1683735365239,AWP 10,015,202048,Staff,0,0,0,0
1683735365239,AWP 10,016,202049,Staff,0,0,0,0
1683735365239,AWP 10,017,202050,Staff,0,0,0,0
1683735365239,AWP 10,018,202051,Staff,0,0,0,0
1683735365239,AWP 10,019,202052,Staff,0,0,0,0
1683735365239,AWP 10,020,202053,Staff,0,0,0,0
1683735365239,AWP 10,021,202054,Staff,0,0,0,0
1683735365239,AWP 10,022,202055,Staff,0,0,0,0
1683735365239,AWP 10,023,202056,Staff,0,0,0,0
1683735365239,AWP 10,024,202057,Staff,0,0,0,0
1683735365239,AWP 10,025,202058,Staff,0,0,0,0
1683735365239,AWP 10,026,202059,Staff,0,0,0,0
1683735366267,AWP 102,001,202032,Staff,0,0,0,0
1683735366267,AWP 102,002,202033,Staff,0,0,0,0
1683735367293,BENG 100,A01,254234,Taylor Amos; Alyssa C,31,0,40,9
1683735368316,BENG 196,001,270013,Engler; Adam J.,9999,0,9999,0
1683735369341,BICD 100R,A01,202018,Smith; Laurie,0,7,32,32
1683735369341,BICD 100R,A02,202019,Smith; Laurie,0,3,32,32
1683735369341,BICD 100R,A03,202020,Smith; Laurie,0,1,32,32
1683735369341,BICD 100R,A04,202021,Smith; Laurie,6,0,32,26
1683735369341,BICD 100R,A05,202022,Smith; Laurie,10,0,32,22
1683735370366,BICD 136,A01,193242,Gustafson-Brown; Cindy,0,2,32,32
1683735370366,BICD 136,A02,193244,Gustafson-Brown; Cindy,13,0,32,19
1683735371394,BIEB 102,A01,193249,Butler; Shannon Rhey,0,0,32,32
1683735371394,BIEB 102,A02,193251,Butler; Shannon Rhey,0,0,32,32
1683735371394,BIEB 102,A03,193253,Butler; Shannon Rhey,0,0,32,32
1683735371394,BIEB 102,A04,193255,Butler; Shannon Rhey,13,0,32,19
1683735371394,BIEB 102,A05,193265,Butler; Shannon Rhey,25,0,32,7
1683735371394,BIEB 102,A06,193269,Butler; Shannon Rhey,12,0,32,20
1683735373442,BIEB 150,A01,193274,Staff,0,0,32,32
1683735373442,BIEB 150,A02,193285,Staff,24,0,32,8
1683735374466,BIEB 194,A00,193286,Kurle; Carolyn M.,19,0,32,13
1683735375495,BILD 1,A01,192291,Staff,15,0,32,17
1683735375495,BILD 1,A02,192292,Staff,30,0,32,2
1683735375495,BILD 1,B01,192520,Reuther; Keefe,0,1,0,0
1683735375495,BILD 1,B02,192532,Reuther; Keefe,0,1,0,0
1683735376531,BILD 3,A01,192556,Butler; Shannon Rhey,0,0,32,32
1683735376531,BILD 3,A02,192581,Butler; Shannon Rhey,0,1,32,32
1683735376531,BILD 3,A03,192611,Butler; Shannon Rhey,19,0,32,13
1683735376531,BILD 3,A04,192612,Butler; Shannon Rhey,23,0,32,9
1683735376531,BILD 3,A05,192613,Butler; Shannon Rhey,26,0,32,6
1683735376531,BILD 3,A06,192679,Butler; Shannon Rhey,27,0,32,5
1683735376531,BILD 3,A07,192682,Butler; Shannon Rhey,20,0,32,12
1683735377559,BILD 4,A01,192836,Reuther; Keefe,1,0,24,23
1683735377559,BILD 4,A02,193044,Reuther; Keefe,4,0,24,20
1683735378587,BILD 10,A01,193142,Gustafson-Brown; Cindy,29,0,32,3
1683735378587,BILD 10,A02,193149,Gustafson-Brown; Cindy,31,0,32,1
1683735379614,BIMM 100,A01,193301,Staff,0,6,32,32
1683735379614,BIMM 100,A02,193312,Staff,0,7,32,32
1683735379614,BIMM 100,A03,193323,Staff,0,10,32,32
1683735380644,BIMM 101,A01,193329,McDonnell; Lisa Marie,0,3,24,24
1683735380644,BIMM 101,A02,193339,McDonnell; Lisa Marie,0,3,24,24
1683735380644,BIMM 101,B01,193354,McDonnell; Lisa Marie,0,4,24,24
1683735380644,BIMM 101,B02,193357,McDonnell; Lisa Marie,0,3,24,24
1683735381671,BIMM 110,A01,193377,Tat; John,0,11,32,32
1683735381671,BIMM 110,A02,193378,Tat; John,0,11,32,32
1683735382696,BIMM 120,A01,206116,Staff,1,0,32,31
1683735382696,BIMM 120,A02,206117,Staff,7,0,32,25
1683735382696,BIMM 120,A03,206121,Staff,21,0,32,11
1683735383720,BIPN 100,A01,193393,Park; Ji Young,0,15,32,32
1683735383720,BIPN 100,A02,193402,Park; Ji Young,0,14,32,32
1683735383720,BIPN 100,A03,193413,Park; Ji Young,0,14,32,32
1683735383720,BIPN 100,A04,193414,Park; Ji Young,0,13,32,32
1683735384748,BIPN 102,A01,193429,Staff,0,0,32,32
1683735384748,BIPN 102,A02,193438,Staff,18,0,32,14
1683735385771,BIPN 106,A01,193450,Reyes Gonzalez; Catalina,0,2,40,40
1683735386796,BIPN 134,A01,193465,Cooke; James Edward,0,0,32,32
1683735386796,BIPN 134,A02,193474,Cooke; James Edward,24,0,32,8
1683735386796,BIPN 134,A03,193485,Cooke; James Edward,29,0,32,3
1683735386796,BIPN 134,A04,193486,Cooke; James Edward,20,0,32,12
1683735386796,BIPN 134,A05,193491,Cooke; James Edward,31,0,32,1
1683735386796,BIPN 134,A06,193501,Cooke; James Edward,30,0,32,2
1683735386796,BIPN 134,A07,193510,Cooke; James Edward,29,0,32,3
1683735388845,BISP 194,A00,222522,Staff,14,0,32,18
1683735389871,CAT 124,A01,202407,Staff,19,0,25,6
1683735390905,CAT 125,A00,202408,Marchisotto; Jennifer Anne,2,0,20,18
1683735391929,CAT 125R,A00,202409,Smith; Lauryn Alissa,0,11,20,20
1683735391929,CAT 125R,B00,202410,Morales; Celeste Georgianna,0,11,20,20
1683735391929,CAT 125R,C00,202411,Irwin; Matthew Joseph,0,12,20,20
1683735392954,CENG 15,A01,204712,Yang; Kesong,0,1,0,0
1683735393977,CENG 114,A00,202070,Jahed Motlagh; Zeinab,5,0,20,15
1683735395001,CGS 105,A00,185477,Wesling; Megan E.,24,0,40,16
1683735396025,CGS 106,A00,185494,Staff,11,0,22,11
1683735397052,CGS 108,A00,185495,Staff,14,0,20,6
1683735398076,CGS 114,A00,185496,Staff,13,0,18,5
1683735399101,CGS 119,A00,185501,Staff,15,0,20,5
1683735400125,CGS 120,A00,185511,Staff,11,0,20,9
1683735401150,CHEM 4,A01,184675,Bussey; Thomas J,97,0,100,3
1683735402175,CHEM 6A,A01,184677,Staff,32,0,60,28
1683735403203,CHEM 6B,A01,184679,Staff,63,0,100,37
1683735404227,CHEM 6C,A01,184681,Bussey; Thomas J,0,0,50,50
1683735404227,CHEM 6C,A02,184682,Bussey; Thomas J,32,0,50,18
1683735405250,CHEM 40A,A01,184684,Albizati; Kim F.,33,0,100,67
1683735406274,CHEM 40B,A01,184686,Albizati; Kim F.,0,22,100,100
1683735407301,CHEM 41B,A01,184690,Staff,51,0,100,49
1683735408332,COGS 3,A01,184715,Boyle; Mary E. T.,0,27,40,40
1683735409367,COGS 14B,A01,185172,Staff,0,14,38,38
1683735410394,COGS 18,A01,184736,Staff,14,0,80,66
1683735411418,COGS 100,A01,184932,Staff,0,8,73,73
1683735412444,COGS 101A,A01,184935,Staff,0,40,30,30
1683735413467,COGS 101B,A01,184944,Staff,0,2,30,30
1683735414494,COGS 101C,A01,184946,Staff,0,10,30,30
1683735415522,COGS 102A,A01,184951,Johnson; Christine M.,1,0,40,39
1683735416549,COGS 107B,A01,184953,Mooshagian; Eric Frederick,0,52,40,40
1683735417576,COGS 118B,A01,184959,Gupta; Anjum,0,50,40,40
1683735418600,COGS 153,A00,184961,Staff,1,16,30,29
1683735419625,COGS 177,A00,184962,Staff,0,20,30,30
1683735420650,COGS 187A,A01,184969,Boyle; Mary E. T.,0,19,40,40
1683735421682,COMM 10,A01,185174,Staff,0,5,25,25
1683735421682,COMM 10,A02,185189,Staff,0,2,25,25
1683735421682,COMM 10,A03,269821,Staff,0,1,0,0
1683735422712,COMM 100B,A02,185476,Staff,10,0,25,15
1683735422712,COMM 100B,A03,277340,Staff,25,0,25,0
1683735423743,COMM 100C,A01,185314,Staff,2,0,25,23
1683735423743,COMM 100C,A02,185327,Staff,17,0,25,8
1683735424766,COMM 110M,A00,185349,Staff,0,0,40,40
1683735425791,COMM 113T,A00,185352,Staff,25,0,40,15
1683735426819,COMM 114I,A00,185353,Staff,31,0,40,9
1683735427846,COMM 131,A00,185354,Staff,17,0,30,13
1683735428871,CSE 8A,A50,185358,Cao; Yingjun,0,46,10,10
1683735429899,CSE 8B,A01,185362,Staff,0,48,50,50
1683735430981,CSE 11,A01,185416,Cao; Yingjun,0,91,10,10
1683735432006,CSE 20,A01,185445,Briones; Jor-el Thomas Caparas,3,0,25,22
1683735433033,CSE 21,A01,185447,Staff,9,0,50,41
1683735434062,CSE 101,A01,185451,Staff,0,13,50,50
1683735434062,CSE 101,B01,185453,Jones; Miles E,0,15,50,50
1683735436110,CSE 141,A01,185458,Eldon; John,16,0,100,84
1683735437134,CSE 141L,A01,185461,Eldon; John,8,0,100,92
1683735438159,CSE 142,A01,185463,Staff,34,0,60,26
1683735438159,CSE 142,B01,201355,Staff,0,7,60,60
1683735439187,CSE 142L,A01,185470,Staff,34,0,60,26
1683735439187,CSE 142L,B01,201417,Staff,0,6,60,60
1683735440214,CSE 190,A00,201433,Staff,32,0,49,17
1683735441238,DOC 1,A01,259136,Strom; Megan C.,7,0,15,8
1683735441238,DOC 1,A02,259137,Strom; Megan C.,15,0,15,0
1683735441238,DOC 1,A03,259138,Strom; Megan C.,14,0,15,1
1683735441238,DOC 1,A04,259139,Strom; Megan C.,13,0,15,2
1683735442265,DOC 100D,A00,259140,Pass; Natalye Joann,14,0,25,11
1683735443290,DSGN 1,A01,184749,Rill; Bryan,0,26,30,30
1683735444314,DSGN 100,A01,185168,Staff,0,2,25,25
1683735445337,ECE 5,A01,185626,Morris; Karcher William,0,12,0,0
1683735446361,ECE 101,A01,185628,Staff,14,0,70,56
1683735447389,ECE 107,A01,185635,Baghdadchi; Saharnaz,0,0,20,20
1683735447389,ECE 107,A02,185638,Baghdadchi; Saharnaz,1,0,20,19
1683735448414,ECE 148,A01,185647,Silberman; Jack,0,0,16,16
1683735449445,ECON 1,A01,185537,Crane; Meredith Helen,54,0,70,16
1683735450472,ECON 3,A01,185549,Crane; Meredith Helen,30,0,70,40
1683735451499,ECON 4,A01,203354,Anderson; John Charles,0,5,10,10
1683735452524,ECON 100A,A01,185574,Staff,0,5,40,40
1683735453547,ECON 100B,A01,185576,Staff,0,12,50,50
1683735454571,ECON 100C,A01,185589,Newhouse; Herbert S,30,0,70,40
1683735455595,ECON 105,A00,185608,Vespa; Emanuel Ignacio,19,0,35,16
1683735456623,ECON 109,A01,185610,Shishkin; Denis,9,0,35,26
1683735457646,ECON 110A,A01,185612,Staff,8,0,40,32
1683735458682,ECON 120A,A01,185615,Staff,19,0,40,21
1683735459708,ECON 120C,A01,185617,Sun; Yixiao,0,21,70,70
1683735460738,ECON 144,A00,203346,Squires; Dale E,2,0,35,33
1683735461767,ECON 171,A01,203349,Newhouse; Herbert S,0,1,35,35
1683735462794,ECON 173A,A01,185621,Toda; Alexis Akira,21,0,35,14
1683735463823,EDS 25,A01,202413,Staff,0,1,0,0
1683735463823,EDS 25,A02,202414,Staff,0,1,0,0
1683735463823,EDS 25,A03,202415,Staff,0,0,0,0
1683735463823,EDS 25,A04,202416,Staff,0,1,0,0
1683735463823,EDS 25,A05,202439,Staff,0,0,0,0
1683735463823,EDS 25,A06,202440,Staff,0,0,0,0
1683735463823,EDS 25,B01,202631,Staff,0,0,0,0
1683735463823,EDS 25,B02,202632,Staff,0,0,0,0
1683735463823,EDS 25,B03,202639,Staff,0,0,0,0
1683735463823,EDS 25,B04,202640,Staff,0,0,0,0
1683735463823,EDS 25,B05,202643,Staff,0,0,0,0
1683735463823,EDS 25,B06,202644,Staff,0,0,0,0
1683735464851,EDS 38,A01,202659,Black; Alison Michelle,25,0,25,0
1683735465877,EDS 115,A00,202652,Staff,18,0,30,12
1683735466904,EDS 125,A00,202649,Staff,13,0,30,17
1683735467931,EDS 126,A01,203332,Staff,30,0,30,0
1683735468956,EDS 139,A00,202838,Staff,16,0,25,9
1683735469981,EDS 146,A01,202655,Staff,14,0,25,11
1683735471004,ENG 15,A00,185667,Staff,0,1,0,2
1683735471004,ENG 15,B00,185672,Staff,0,0,0,1
1683735471004,ENG 15,C00,185675,Staff,0,0,0,0
1683735471004,ENG 15,D00,185682,Staff,0,0,0,0
1683735471004,ENG 15,E00,185684,Staff,0,0,0,0
1683735472030,ETHN 103,A00,185710,Staff,0,8,35,35
1683735473056,ETHN 103A,A00,199228,Man; Simeon S,0,0,9,9
1683735474080,ETHN 109,A00,185711,Staff,15,0,35,20
1683735475107,ETHN 142,A00,185726,Staff,0,4,30,30
1683735476134,ETHN 163J,A00,199229,Man; Simeon S,5,0,8,3
1683735477162,ETHN 168,A00,185727,Staff,7,0,10,3
1683735478186,ETHN 182,A00,185728,Staff,0,0,35,35
1683735479211,ETHN 183,A00,185737,Staff,10,0,18,8
1683735480235,GLBH 111,A01,209361,Burgos; Jose L.,0,0,0,0
1683735482281,HIEU 104,A00,185792,Staff,14,0,20,6
1683735483305,HIEU 115,A00,185800,Staff,0,0,20,20
1683735484333,HIEU 128,A00,185801,Staff,0,9,20,20
1683735485357,HIEU 147,A00,185802,Staff,15,0,20,5
1683735486383,HIEU 154,A00,185823,Staff,11,0,20,9
1683735487410,HILA 102,A00,185826,Staff,14,0,20,6
1683735488434,HILD 2C,A01,185778,Staff,0,13,20,20
1683735489458,HILD 7B,A01,185780,Kwak; Nancy,0,17,32,32
1683735489458,HILD 7B,A02,185781,Kwak; Nancy,0,18,32,32
1683735490482,HILD 30,A01,185791,Staff,12,0,20,8
1683735491507,HISC 119,A00,185830,Golan; Tal,0,10,20,20
1683735492536,HITO 156GS,A00,185831,Patterson; Patrick H.,0,0,0,23
1683735493563,HIUS 103,A00,185832,Man; Simeon S,0,4,20,20
1683735494591,HIUS 117,A00,185836,Kwak; Nancy,2,0,20,18
1683735495614,HIUS 125,A00,185840,Man; Simeon S,0,2,23,23
1683735496643,HIUS 149,A00,185845,Staff,1,0,20,19
1683735497671,HUM 3,A01,185882,Zavodny; Tatiana Sophia,0,8,50,50
1683735497671,HUM 3,B01,185899,Caldwell; Michael Alan,0,18,50,50
1683735498698,HUM 3GS,A00,185900,Patterson; Patrick H.,0,0,0,23
1683735499724,HUM 4,A01,185938,Zroka; Amy Liane,28,0,50,22
1683735499724,HUM 4,B01,185956,Watkins; Eric,0,6,50,50
1683735499724,HUM 4,B02,202209,Watkins; Eric,0,6,50,50
1683735499724,HUM 4,B03,202210,Watkins; Eric,0,5,50,50
1683735500749,HUM 5,A01,185958,West; Geoffrey Scott,0,1,50,50
1683735500749,HUM 5,A02,202215,West; Geoffrey Scott,0,1,50,50
1683735501774,INTL 190,A00,185959,Gagnon; Jeffrey C,0,0,0,9
1683735501774,INTL 190,B00,185960,Lettieri; Michael Joseph,0,0,0,2
1683735502798,JAPN 180,A00,254509,Staff,4,0,30,26
1683735503822,LATI 10,A01,202853,Kennemore; Amy Michelle,0,0,31,31
1683735503822,LATI 10,A02,202854,Kennemore; Amy Michelle,0,0,32,32
1683735503822,LATI 10,A03,270054,Kennemore; Amy Michelle,30,0,30,0
1683735504848,LATI 180,A00,202855,Kennemore; Amy Michelle,11,0,20,9
1683735505875,LAWS 101,A00,201767,Golan; Tal,0,7,40,40
1683735506897,LIFR 1C,A00,185961,Staff,6,0,20,14
1683735507920,LIFR 1CX,A00,185962,Staff,7,0,20,13
1683735508954,LIFR 1D,A00,185963,Staff,7,0,20,13
1683735509981,LIFR 1DX,A00,185964,Staff,7,0,20,13
1683735511006,LIGN 101,A01,186039,Staff,43,0,50,7
1683735512030,LIGN 165,A00,186040,Staff,14,0,50,36
1683735513055,LTCS 108,A00,186041,Staff,5,0,10,5
1683735514081,LTCS 119,A00,186042,Staff,15,0,20,5
1683735515108,LTCS 130,A00,186043,Wesling; Megan E.,15,0,25,10
1683735517161,LTEA 138,A00,186119,Staff,13,0,40,27
1683735518188,LTEN 124,A00,186148,Staff,5,0,25,20
1683735519214,LTEN 178,A00,186149,Staff,6,0,15,9
1683735520236,LTEN 181,A00,186150,Blanco; John D,34,0,40,6
1683735521266,LTWL 120,A00,186160,Staff,19,0,25,6
1683735522294,LTWL 165,A00,186161,Staff,22,0,25,3
1683735523320,LTWR 100,A00,186162,Staff,0,5,15,15
1683735524349,LTWR 102,A00,186163,Doller; Ben,5,0,15,10
1683735525373,MAE 8,A01,186412,Staff,0,1,0,1
1683735526400,MAE 30B,A00,186445,Bahadori; Mohammad Yousef,81,0,100,19
1683735527425,MAE 40,A00,186592,Bewley; Thomas R,10,0,50,40
1683735528450,MAE 101B,A00,186593,Bahadori; Mohammad Yousef,80,0,100,20
1683735529474,MAE 105,A00,186594,Bandaru; Prabhakar,10,0,50,40
1683735530503,MAE 107,A00,186599,Pham; Hieu Tan,0,8,120,120
1683735531532,MAE 148,A01,186660,Silberman; Jack,3,0,16,13
1683735532561,MATH 10A,A01,188095,Staff,0,6,35,35
1683735533589,MATH 10B,A01,188097,Bowers; Adam R.,0,12,30,30
1683735533589,MATH 10B,A02,188099,Bowers; Adam R.,0,11,30,30
1683735533589,MATH 10B,B01,188104,Bowers; Adam R.,0,10,30,30
1683735533589,MATH 10B,B02,188106,Bowers; Adam R.,0,9,30,30
1683735534677,MATH 10C,A01,188111,Staff,0,20,30,30
1683735534677,MATH 10C,A02,188127,Staff,0,19,30,30
1683735534677,MATH 10C,A03,188131,Staff,0,19,30,30
1683735534677,MATH 10C,B01,188218,Staff,17,0,30,13
1683735534677,MATH 10C,B02,188244,Staff,13,0,30,17
1683735534677,MATH 10C,B03,188277,Staff,14,0,30,16
1683735535707,MATH 18,A01,188344,Bach; Quang Tran,18,0,30,12
1683735535707,MATH 18,A02,188345,Bach; Quang Tran,11,0,30,19
1683735535707,MATH 18,B01,188353,Bach; Quang Tran,11,0,30,19
1683735535707,MATH 18,B02,188354,Bach; Quang Tran,19,0,30,11
1683735536730,MATH 20A,A01,188374,Staff,10,0,35,25
1683735537755,MATH 20B,A01,188382,Ohm; Ko Woon,7,0,30,23
1683735537755,MATH 20B,A02,188383,Ohm; Ko Woon,22,0,30,8
1683735537755,MATH 20B,B01,188385,Ohm; Ko Woon,7,0,30,23
1683735537755,MATH 20B,B02,188392,Ohm; Ko Woon,22,0,30,8
1683735538785,MATH 20C,A01,188394,Harel; Guershon,10,0,30,20
1683735538785,MATH 20C,A02,188395,Harel; Guershon,13,0,30,17
1683735538785,MATH 20C,B01,188404,Harel; Guershon,5,0,30,25
1683735538785,MATH 20C,B02,188405,Harel; Guershon,18,0,30,12
1683735539815,MATH 20D,A01,188414,Hammock; Frances H,0,1,30,30
1683735539815,MATH 20D,A02,188415,Hammock; Frances H,0,1,30,30
1683735539815,MATH 20D,B01,188447,Hammock; Frances H,0,1,30,30
1683735539815,MATH 20D,B02,188486,Hammock; Frances H,2,0,30,28
1683735540840,MATH 20E,A01,188649,Staff,21,0,30,9
1683735540840,MATH 20E,A02,188650,Staff,20,0,30,10
1683735540840,MATH 20E,A03,188673,Staff,0,0,30,30
1683735541869,MATH 102,A01,188675,Staff,0,40,35,35
1683735542894,MATH 103B,A01,188681,Staff,3,0,35,32
1683735542894,MATH 103B,B01,188692,Staff,5,0,35,30
1683735543918,MATH 109,A01,188695,Salehi Golsefidy; Alireza,24,0,35,11
1683735543918,MATH 109,A02,188696,Salehi Golsefidy; Alireza,24,0,35,11
1683735544945,MATH 120A,A01,188698,Eggers; John Dietrich,7,0,35,28
1683735545971,MATH 142B,A01,188736,Ioana; Adrian,0,0,30,30
1683735545971,MATH 142B,A02,188741,Ioana; Adrian,0,1,30,30
1683735545971,MATH 142B,A03,188743,Ioana; Adrian,0,3,30,30
1683735546999,MATH 168A,A01,188790,Staff,0,11,35,35
1683735548025,MATH 170A,A01,188803,Nie; Jiawang,0,2,35,35
1683735548025,MATH 170A,A02,188811,Nie; Jiawang,0,1,35,35
1683735548025,MATH 170A,A03,188814,Nie; Jiawang,1,0,35,34
1683735548025,MATH 170A,A04,188815,Nie; Jiawang,4,0,35,31
1683735549052,MATH 193B,A01,188817,Staff,0,0,35,35
1683735549052,MATH 193B,A02,188818,Staff,6,0,35,29
1683735550078,MGT 4,A01,202857,Anderson; John Charles,59,0,80,21
1683735551104,MGT 12,A00,202858,Lindenberger; Wade Douglas,40,0,90,50
1683735552128,MGT 18,A00,202859,Staff,73,0,90,17
1683735553154,MGT 18GS,A00,202860,McKay; Michael J,13,0,28,15
1683735554181,MGT 45,A00,202861,Pecore; Joseph P.,8,0,90,82
1683735555205,MGT 100,A00,202863,Yavorsky; Daniel Ryan,27,0,90,63
1683735556234,MGT 103,A00,202864,Ehrich; Kristine R,0,19,90,90
1683735557260,MGT 112,A00,202865,Ehrich; Kristine R,15,0,90,75
1683735558286,MGT 121A,A00,202868,Staff,70,0,90,20
1683735559312,MGT 131B,A00,202869,Anderson; John Charles,58,0,90,32
1683735560336,MGT 136,A00,202871,Lindenberger; Wade Douglas,83,0,90,7
1683735561359,MGT 164,A00,202873,Staff,0,67,90,91
1683735562382,MGT 164GS,A00,202874,McKay; Mary A,13,0,28,15
1683735563408,MGT 180,A00,202875,Staff,0,51,90,91
1683735564437,MMW 11R,A01,205019,Herbst; Matthew,0,0,30,30
1683735564437,MMW 11R,A02,205026,Herbst; Matthew,29,0,30,1
1683735565468,MMW 15,A01,193512,Chang; Edmond Yi-Teh,0,8,28,28
1683735565468,MMW 15,A02,193513,Chang; Edmond Yi-Teh,0,5,28,28
1683735565468,MMW 15,A03,193514,Chang; Edmond Yi-Teh,0,5,28,28
1683735565468,MMW 15,A04,193515,Chang; Edmond Yi-Teh,0,5,28,28
1683735565468,MMW 15,A05,193516,Chang; Edmond Yi-Teh,0,5,28,28
1683735565468,MMW 15,A06,193517,Chang; Edmond Yi-Teh,0,6,28,28
1683735565468,MMW 15,B01,193519,Chang; Edmond Yi-Teh,0,5,28,28
1683735565468,MMW 15,B02,193520,Chang; Edmond Yi-Teh,0,5,28,28
1683735565468,MMW 15,B03,193521,Chang; Edmond Yi-Teh,0,5,28,28
1683735565468,MMW 15,B04,193522,Chang; Edmond Yi-Teh,0,6,28,28
1683735565468,MMW 15,B05,193523,Chang; Edmond Yi-Teh,0,5,28,28
1683735565468,MMW 15,B06,193524,Chang; Edmond Yi-Teh,0,5,28,28
1683735566492,MMW 122,A01,193526,Rahimi; Babak,0,16,28,28
1683735566492,MMW 122,A02,193527,Rahimi; Babak,0,15,28,28
1683735566492,MMW 122,A03,193528,Rahimi; Babak,0,0,0,0
1683735566492,MMW 122,A04,193529,Rahimi; Babak,0,0,0,0
1683735567517,MUS 1A,A01,186663,Staff,0,18,35,35
1683735568541,MUS 4,A01,186715,Staff,0,12,35,35
1683735569564,MUS 5R,A01,186796,Dubnov; Shlomo,0,17,35,35
1683735570588,MUS 6,A01,186798,Staff,0,4,25,25
1683735571613,MUS 7,A01,186830,Staff,11,0,35,24
1683735572636,MUS 8,A01,186930,Staff,0,27,35,35
1683735573661,MUS 15,A01,186932,Staff,0,15,35,35
1683735573661,MUS 15,B01,186934,Staff,0,16,35,35
1683735574694,MUS 80,A00,186935,Staff,0,0,20,20
1683735574694,MUS 80,B00,186936,Staff,24,0,25,1
1683735575719,NANO 11,A00,204702,Lipomi; Darren John,0,0,0,0
1683735576752,NANO 15,A01,204709,Yang; Kesong,0,1,0,0
1683735577774,NANO 114,A00,202069,Jahed Motlagh; Zeinab,2,0,10,8
1683735578805,PHIL 1,A00,186955,Grush; Rick Scott,31,0,40,9
1683735579830,PHIL 10,A01,186973,Grush; Rick Scott,27,0,35,8
1683735579830,PHIL 10,A02,186974,Grush; Rick Scott,33,0,35,2
1683735580857,PHIL 13,A01,186976,Staff,1,0,35,34
1683735580857,PHIL 13,A02,186977,Staff,16,0,35,19
1683735581884,PHIL 14,A01,186979,Staff,30,0,35,5
1683735581884,PHIL 14,A02,186986,Staff,32,0,35,3
1683735582909,PHIL 28,A01,186988,Staff,16,0,30,14
1683735582909,PHIL 28,A02,186989,Staff,0,0,30,30
1683735582909,PHIL 28,A03,186990,Staff,10,0,30,20
1683735582909,PHIL 28,A04,186991,Staff,26,0,30,4
1683735583933,PHIL 120,A00,186997,Staff,23,0,40,17
1683735584957,PHIL 137,A00,187003,Staff,8,0,40,32
1683735585981,PHIL 150,A00,187015,Staff,47,0,70,23
1683735587005,PHIL 167,A00,187021,Lamey; Andy M.,34,0,40,6
1683735588029,PHIL 174,A01,202226,Staff,17,0,20,3
1683735588029,PHIL 174,A02,202235,Staff,20,0,20,0
1683735589052,PHIL 191A,A00,258918,Staff,0,0,1,1
1683735590077,PHYS 1A,A00,187028,Staff,26,0,60,34
1683735591104,PHYS 1AL,001,187036,Staff,3,0,30,27
1683735591104,PHYS 1AL,002,187049,Staff,18,0,30,12
1683735592127,PHYS 1B,A00,187058,Staff,21,0,60,39
1683735593155,PHYS 1BL,001,187064,Staff,0,1,30,30
1683735593155,PHYS 1BL,002,187070,Staff,4,0,30,26
1683735594182,PHYS 1C,A00,187082,Staff,30,0,120,90
1683735595207,PHYS 1CL,001,187088,Staff,0,9,30,30
1683735595207,PHYS 1CL,002,187089,Staff,0,1,30,30
1683735595207,PHYS 1CL,009,262693,Staff,9,0,30,21
1683735596235,PHYS 2B,A01,187097,Staff,55,0,115,60
1683735597258,PHYS 2C,A01,187099,Staff,63,0,115,52
1683735598284,PHYS 2CL,A01,187101,Staff,5,0,28,23
1683735598284,PHYS 2CL,A02,187102,Staff,15,0,28,13
1683735599311,PHYS 2D,A01,187123,Shotwell; Brian,95,0,115,20
1683735600335,PHYS 4B,A01,187133,Grinstein; Benjamin,34,0,50,16
1683735601362,POLI 10,A00,188819,Staff,0,4,50,50
1683735602386,POLI 11,A00,188827,Staff,43,0,50,7
1683735603410,POLI 13R,A00,188828,Staff,0,2,20,20
1683735604435,POLI 27,A01,188830,Elgin; Samuel Zincke,0,2,70,70
1683735605463,POLI 30,A00,188832,Desposato; Scott,30,0,50,20
1683735606490,POLI 102F,A00,188834,Staff,1,0,40,39
1683735607518,POLI 104A,A00,188852,Staff,12,0,30,18
1683735608546,POLI 104I,A00,188853,Staff,0,8,20,20
1683735609571,POLI 110B,A00,188854,Wiens; David,6,0,20,14
1683735610594,POLI 112A,A00,188855,Wiens; David,4,0,30,26
1683735611621,POLI 117R,A00,188856,Forman; Fonna,0,12,20,20
1683735612646,POLI 118,A00,188857,Ingham; Sean,8,0,20,12
1683735613671,POLI 120G,A00,188858,Staff,7,0,30,23
1683735614700,POLI 131CR,A00,188863,Hoston; Germaine,20,0,50,30
1683735615724,POLI 133,A00,188864,Nellis; Gareth Hb,44,0,50,6
1683735616751,POLI 134D,A00,188865,Desposato; Scott,27,0,30,3
1683735617778,POLI 142A,A00,188871,Gartzke; Erik,21,0,50,29
1683735618809,POLI 142K,A00,188874,Staff,38,0,50,12
1683735619836,POLI 143,A00,188940,Gartzke; Erik,15,0,30,15
1683735620859,POLI 153,A00,188943,Staff,1,0,20,19
1683735621886,POLI 160AA,A00,188944,Staff,10,0,40,30
1683735622912,POLI 170A,A00,188945,Staff,10,0,30,20
1683735624970,PSYC 1,A00,188952,Staff,36,0,90,54
1683735625993,PSYC 2,B00,188953,Staff,19,0,35,16
1683735627020,PSYC 6,A00,188970,Staff,47,0,60,13
1683735628045,PSYC 7,A00,188973,Staff,35,0,45,10
1683735629072,PSYC 60,A01,188980,Rickard; Timothy C.,42,0,60,18
1683735630096,PSYC 70,A01,189001,Steiner; Eric Tomas,21,0,45,24
1683735631120,PSYC 100,A00,189005,Lacefield; Katharine I,1,98,120,119
1683735632144,PSYC 102,A00,189008,Staff,6,0,30,24
1683735633171,PSYC 106,B00,189026,Gorman; Michael R.,26,0,60,34
1683735634198,PSYC 114,B01,189033,Winkielman; Piotr,0,31,30,30
1683735635226,PSYC 131,A00,189036,Anagnostaras; Stephan,0,44,60,60
1683735636253,PSYC 136,A00,189041,Lowe; Angela Beth,0,7,25,25
1683735637278,PSYC 137,A00,189057,Winkielman; Piotr,0,36,25,25
1683735638360,PSYC 144,A00,189107,Wixted; John T,0,11,50,50
1683735640412,PSYC 162,A00,189142,Staff,0,9,85,85
1683735641436,PSYC 172,A00,189144,Gorman; Michael R.,0,6,30,30
1683735643486,PSYC 179,A00,189146,Lacefield; Katharine I,0,88,120,120
1683735644513,PSYC 181,A00,189147,Anagnostaras; Stephan,110,45,200,90
1683735645539,PSYC 190R,A00,189148,Barner; David A.,0,23,80,80
1683735646563,PSYC 191,A00,189275,Rickard; Timothy C.,0,11,25,25
1683735647587,PSYC 193,A00,189276,Chapman; Eddie Nathaniel,0,1,0,4
1683735648613,PSYC 193L,A01,189281,Lowe; Angela Beth,8,0,20,12
1683735648613,PSYC 193L,B01,189285,Staff,28,0,35,7
1683735649636,RELI 149,A00,187137,Rahimi; Babak,6,0,40,34
1683735650661,SE 9,A01,187315,Staff,0,2,18,18
1683735651684,SE 101B,A00,187409,Staff,24,0,30,6
1683735652713,SE 110B,A00,187444,Staff,10,0,40,30
1683735653742,SE 130B,A00,187449,Staff,31,0,40,9
1683735654767,SE 150A,A00,187516,Staff,8,0,20,12
1683735655791,SE 154,A00,187528,Staff,29,0,50,21
1683735656815,SIO 3,A01,258171,Staff,35,0,40,5
1683735657843,SIO 10,A00,187144,Cook; Geoffrey W,0,6,75,75
1683735658869,SIO 45,A00,187152,Cook; Geoffrey W,1,7,100,99
1683735659895,SIO 109R,A00,194486,Staff,0,4,20,20
1683735661951,SIO 187,A01,187233,Kacev; David,12,0,40,28
1683735662975,SOCI 1,A01,258656,Thorpe; Charles Robert,28,0,30,2
1683735662975,SOCI 1,A02,258658,Thorpe; Charles Robert,30,0,30,0
1683735662975,SOCI 1,A03,258661,Thorpe; Charles Robert,25,0,25,0
1683735662975,SOCI 1,A04,258666,Thorpe; Charles Robert,22,0,25,3
1683735662975,SOCI 1,A05,258897,Thorpe; Charles Robert,22,0,25,3
1683735662975,SOCI 1,A06,258898,Thorpe; Charles Robert,25,0,25,0
1683735664003,SOCI 30,A01,258903,Pardo Guerra; Juan Pablo,14,0,30,16
1683735665026,SOCI 102,A00,258904,Staff,9,0,25,16
1683735666050,SOCI 106,A00,258905,Staff,19,0,25,6
1683735667077,SOCI 111,A00,258907,Ribas Norris; Janet Vanesa,26,0,30,4
1683735668105,SOCI 121R,A00,258908,Pardo Guerra; Juan Pablo,7,0,30,23
1683735669133,SOCI 126,A01,203330,Staff,14,0,20,6
1683735670162,SOCI 131,A00,258909,Thorpe; Charles Robert,30,0,60,30
1683735671189,SOCI 135,A00,258910,Payne; Christine Anna,0,13,30,30
1683735672214,SOCI 157,A00,258911,Staff,10,0,30,20
1683735673237,SOCI 184,A00,258912,Staff,25,0,30,5
1683735674264,SOCI 188D,A00,258913,Staff,22,0,30,8
1683735675288,SYN 2,001,187529,Staff,9,0,16,7
1683735675288,SYN 2,002,201452,Staff,0,20,16,16
1683735675288,SYN 2,003,201469,Staff,1,0,16,15
1683735676315,SYN 100,A01,187531,Staff,0,9,20,20
1683735676315,SYN 100,B01,201491,Staff,0,10,20,20
1683735677342,TDAC 1,A00,189286,Walsh; Kim C.,3,0,20,17
1683735677342,TDAC 1,B00,189287,Harting; Carla Kelso,10,0,20,10
1683735678366,TDAC 101,A00,189300,Walsh; Kim C.,16,0,20,4
1683735678366,TDAC 101,B00,189301,Harting; Carla Kelso,18,0,20,2
1683735679393,TDAC 102,A00,189304,Basso; Beatrice,14,0,20,6
1683735680419,TDAC 108,A00,189305,Staff,18,0,20,2
1683735681447,TDDE 131,A00,189310,Staff,19,0,20,1
1683735681447,TDDE 131,B00,189314,Staff,19,0,20,1
1683735681447,TDDE 131,C00,189315,Staff,48,0,50,2
1683735681447,TDDE 131,D00,189316,Staff,14,0,15,1
1683735681447,TDDE 131,E00,204841,Staff,20,0,20,0
1683735682476,TDGE 10,A00,189289,Staff,26,0,50,24
1683735682476,TDGE 10,B00,189290,Havis; Allan,0,1,50,50
1683735683505,TDGE 11,A00,189291,Fulton; Julia,0,4,50,50
1683735683505,TDGE 11,B00,189292,Staff,20,0,25,5
1683735683505,TDGE 11,C00,260270,Staff,0,0,0,0
1683735684529,TDGE 25,A00,189294,Staff,1,0,20,19
1683735685552,TDGE 124,A00,189318,Fulton; Julia,0,7,50,50
1683735686579,TDGE 125,A00,189319,Staff,13,0,25,12
1683735686579,TDGE 125,B00,189320,Staff,23,0,25,2
1683735687603,TDGE 127,A00,189322,Havis; Allan,1,0,50,49
1683735688630,TDHT 101,A00,189323,Staff,18,0,25,7
1683735688630,TDHT 101,B00,189324,Staff,25,0,25,0
1683735689656,TDHT 102,A00,189325,Staff,49,0,50,1
1683735690679,TDMV 1,A00,189295,Arcidiacono; Kristin,20,0,30,10
1683735690679,TDMV 1,B00,189296,Caligagan; Maria T.,23,0,30,7
1683735691705,TDMV 2,A00,189297,Sammartano; Tonnie,27,0,30,3
1683735691705,TDMV 2,B00,189299,Arcidiacono; Kristin,23,0,30,7
1683735692728,TDMV 3,A00,204998,Rincon; Alicia,22,0,30,8
1683735693757,TDMV 120,A00,189458,Sammartano; Tonnie,28,0,30,2
1683735694785,TDMV 138,A00,189541,Jun; Grace Shin Hae,20,0,40,20
1683735695808,TDMV 142,A00,189717,Caligagan; Tony,25,0,30,5
1683735695808,TDMV 142,B00,189718,Caligagan; Maria T.,25,0,30,5
1683735696833,TMC 2,A01,187533,Staff,25,0,25,0
1683735696833,TMC 2,A02,187534,Staff,25,0,25,0
1683735697860,USP 1,A01,187536,Kwak; Nancy,0,16,25,25
1683735698891,USP 5,A01,187538,Staff,8,0,25,17
1683735699918,USP 101,A00,199253,Staff,0,4,0,0
1683735700942,USP 124,A00,187562,Boomhower; Matthew Charles,0,0,30,30
1683735701965,USP 138,A00,187582,Staff,19,0,25,6
1683735702990,USP 152,A01,187597,Staff,3,0,25,22
1683735704017,USP 153,A00,187598,Staff,18,0,25,7
1683735705045,USP 168,A00,187607,Kwak; Nancy,2,0,5,3
1683735706071,USP 173,A00,187619,Staff,4,0,25,21
1683735707098,USP 181,A00,187638,Staff,0,4,25,25
1683735708125,VIS 103,A00,187650,Cruz; Edwin Teddy,17,0,75,58
1683735709152,VIS 110D,A00,187669,Staff,13,0,22,9
1683735710177,VIS 127C,A00,187720,Shen; Kuiyi,67,0,146,79
1683735711202,VIS 149,A00,187731,Yoldas; Pinar,0,12,22,22
1683735712228,VIS 151,A01,188091,Staff,22,0,34,12
1683735712228,VIS 151,A02,188092,Staff,11,0,34,23
1683735713253,VIS 160B,A00,188093,Stalbaum; Brett,0,1,10,10
1683735715306,WCWP 10B,A00,201720,Staff,0,0,5,5
1683735715306,WCWP 10B,B00,201722,Staff,0,0,6,6
1683735716331,WCWP 100,A00,201725,Gagnon; Jeffrey C,0,0,2,2
1683735716331,WCWP 100,B00,201727,Staff,0,4,15,15
1683735719466,ANBI 133,A00,258401,Wilder; Linnea Lorene,34,0,40,6
1683735720489,ANBI 140,A00,258395,Hrvoj Mihic; Branka,18,0,25,7
1683735721512,ANSC 120,A00,258402,Bialecki; Jon Anthony,26,0,40,14
1683735722540,ANSC 144,A00,258400,Staff,12,0,40,28
1683735724596,ANSC 166,A00,258396,Parish; Steven Martin,156,0,175,19
1683735725622,ANSC 180,A00,193533,Staff,8,0,20,12
1683735726649,ANSC 188,A00,258397,Jassal; Aftab,34,0,40,6
1683735727671,ANTH 3,A01,258316,Staff,23,0,30,7
1683735728702,ANTH 5,A00,258394,Semendeferi; Ekaterini,16,0,20,4
1683735729728,ANTH 21,A01,258331,Staff,4,0,40,36
1683735730752,ANTH 103,A00,258398,Varma; Saiba,15,0,25,10
1683735731784,AWP 10,001,202034,Staff,0,0,0,0
1683735731784,AWP 10,002,202035,Staff,0,0,0,0
1683735731784,AWP 10,003,202036,Staff,0,0,0,0
1683735731784,AWP 10,004,202037,Staff,0,0,0,0
1683735731784,AWP 10,005,202038,Staff,0,0,0,0
1683735731784,AWP 10,006,202039,Staff,0,0,0,0
1683735731784,AWP 10,007,202040,Staff,0,0,0,0
1683735731784,AWP 10,008,202041,Staff,0,0,0,0
1683735731784,AWP 10,009,202042,Staff,0,0,0,0
1683735731784,AWP 10,010,202043,Staff,0,0,0,0
1683735731784,AWP 10,011,202044,Staff,0,0,0,0
1683735731784,AWP 10,012,202045,Staff,0,0,0,0
1683735731784,AWP 10,013,202046,Staff,0,0,0,0
1683735731784,AWP 10,014,202047,Staff,0,0,0,0
1683735731784,AWP 10,015,202048,Staff,0,0,0,0
1683735731784,AWP 10,016,202049,Staff,0,0,0,0
1683735731784,AWP 10,017,202050,Staff,0,0,0,0
1683735731784,AWP 10,018,202051,Staff,0,0,0,0
1683735731784,AWP 10,019,202052,Staff,0,0,0,0
1683735731784,AWP 10,020,202053,Staff,0,0,0,0
1683735731784,AWP 10,021,202054,Staff,0,0,0,0
1683735731784,AWP 10,022,202055,Staff,0,0,0,0
1683735731784,AWP 10,023,202056,Staff,0,0,0,0
1683735731784,AWP 10,024,202057,Staff,0,0,0,0
1683735731784,AWP 10,025,202058,Staff,0,0,0,0
1683735731784,AWP 10,026,202059,Staff,0,0,0,0
1683735732812,AWP 102,001,202032,Staff,0,0,0,0
1683735732812,AWP 102,002,202033,Staff,0,0,0,0
1683735733838,BENG 100,A01,254234,Taylor Amos; Alyssa C,31,0,40,9
1683735734862,BENG 196,001,270013,Engler; Adam J.,9999,0,9999,0
1683735735891,BICD 100R,A01,202018,Smith; Laurie,0,7,32,32
1683735735891,BICD 100R,A02,202019,Smith; Laurie,0,3,32,32
1683735735891,BICD 100R,A03,202020,Smith; Laurie,0,1,32,32
1683735735891,BICD 100R,A04,202021,Smith; Laurie,6,0,32,26
1683735735891,BICD 100R,A05,202022,Smith; Laurie,10,0,32,22
1683735736915,BICD 136,A01,193242,Gustafson-Brown; Cindy,0,2,32,32
1683735736915,BICD 136,A02,193244,Gustafson-Brown; Cindy,13,0,32,19
1683735737944,BIEB 102,A01,193249,Butler; Shannon Rhey,0,0,32,32
1683735737944,BIEB 102,A02,193251,Butler; Shannon Rhey,0,0,32,32
1683735737944,BIEB 102,A03,193253,Butler; Shannon Rhey,0,0,32,32
1683735737944,BIEB 102,A04,193255,Butler; Shannon Rhey,13,0,32,19
1683735737944,BIEB 102,A05,193265,Butler; Shannon Rhey,25,0,32,7
1683735737944,BIEB 102,A06,193269,Butler; Shannon Rhey,12,0,32,20
1683735739994,BIEB 150,A01,193274,Staff,0,0,32,32
1683735739994,BIEB 150,A02,193285,Staff,24,0,32,8
1683735741019,BIEB 194,A00,193286,Kurle; Carolyn M.,19,0,32,13
1683735742108,BILD 1,A01,192291,Staff,15,0,32,17
1683735742108,BILD 1,A02,192292,Staff,30,0,32,2
1683735742108,BILD 1,B01,192520,Reuther; Keefe,0,1,0,0
1683735742108,BILD 1,B02,192532,Reuther; Keefe,0,1,0,0
1683735743137,BILD 3,A01,192556,Butler; Shannon Rhey,0,0,32,32
1683735743137,BILD 3,A02,192581,Butler; Shannon Rhey,0,1,32,32
1683735743137,BILD 3,A03,192611,Butler; Shannon Rhey,19,0,32,13
1683735743137,BILD 3,A04,192612,Butler; Shannon Rhey,23,0,32,9
1683735743137,BILD 3,A05,192613,Butler; Shannon Rhey,26,0,32,6
1683735743137,BILD 3,A06,192679,Butler; Shannon Rhey,27,0,32,5
1683735743137,BILD 3,A07,192682,Butler; Shannon Rhey,20,0,32,12
1683735744162,BILD 4,A01,192836,Reuther; Keefe,1,0,24,23
1683735744162,BILD 4,A02,193044,Reuther; Keefe,4,0,24,20
1683735745186,BILD 10,A01,193142,Gustafson-Brown; Cindy,29,0,32,3
1683735745186,BILD 10,A02,193149,Gustafson-Brown; Cindy,31,0,32,1
1683735746209,BIMM 100,A01,193301,Staff,0,6,32,32
1683735746209,BIMM 100,A02,193312,Staff,0,7,32,32
1683735746209,BIMM 100,A03,193323,Staff,0,10,32,32
1683735747238,BIMM 101,A01,193329,McDonnell; Lisa Marie,0,3,24,24
1683735747238,BIMM 101,A02,193339,McDonnell; Lisa Marie,0,3,24,24
1683735747238,BIMM 101,B01,193354,McDonnell; Lisa Marie,0,4,24,24
1683735747238,BIMM 101,B02,193357,McDonnell; Lisa Marie,0,3,24,24
1683735748260,BIMM 110,A01,193377,Tat; John,0,11,32,32
1683735748260,BIMM 110,A02,193378,Tat; John,0,11,32,32
1683735749288,BIMM 120,A01,206116,Staff,1,0,32,31
1683735749288,BIMM 120,A02,206117,Staff,7,0,32,25
1683735749288,BIMM 120,A03,206121,Staff,21,0,32,11
1683735750313,BIPN 100,A01,193393,Park; Ji Young,0,15,32,32
1683735750313,BIPN 100,A02,193402,Park; Ji Young,0,14,32,32
1683735750313,BIPN 100,A03,193413,Park; Ji Young,0,14,32,32
1683735750313,BIPN 100,A04,193414,Park; Ji Young,0,13,32,32
1683735751340,BIPN 102,A01,193429,Staff,0,0,32,32
1683735751340,BIPN 102,A02,193438,Staff,18,0,32,14
1683735752368,BIPN 106,A01,193450,Reyes Gonzalez; Catalina,0,2,40,40
1683735753398,BIPN 134,A01,193465,Cooke; James Edward,0,0,32,32
1683735753398,BIPN 134,A02,193474,Cooke; James Edward,24,0,32,8
1683735753398,BIPN 134,A03,193485,Cooke; James Edward,29,0,32,3
1683735753398,BIPN 134,A04,193486,Cooke; James Edward,20,0,32,12
1683735753398,BIPN 134,A05,193491,Cooke; James Edward,31,0,32,1
1683735753398,BIPN 134,A06,193501,Cooke; James Edward,30,0,32,2
1683735753398,BIPN 134,A07,193510,Cooke; James Edward,29,0,32,3
1683735755450,BISP 194,A00,222522,Staff,14,0,32,18
1683735756477,CAT 124,A01,202407,Staff,19,0,25,6
1683735757510,CAT 125,A00,202408,Marchisotto; Jennifer Anne,2,0,20,18
1683735758533,CAT 125R,A00,202409,Smith; Lauryn Alissa,0,11,20,20
1683735758533,CAT 125R,B00,202410,Morales; Celeste Georgianna,0,11,20,20
1683735758533,CAT 125R,C00,202411,Irwin; Matthew Joseph,0,12,20,20
1683735759561,CENG 15,A01,204712,Yang; Kesong,0,1,0,0
1683735760589,CENG 114,A00,202070,Jahed Motlagh; Zeinab,5,0,20,15
1683735761620,CGS 105,A00,185477,Wesling; Megan E.,24,0,40,16
1683735762646,CGS 106,A00,185494,Staff,11,0,22,11
1683735763671,CGS 108,A00,185495,Staff,14,0,20,6
1683735764698,CGS 114,A00,185496,Staff,13,0,18,5
1683735765721,CGS 119,A00,185501,Staff,15,0,20,5
1683735766745,CGS 120,A00,185511,Staff,11,0,20,9
1683735767770,CHEM 4,A01,184675,Bussey; Thomas J,97,0,100,3
1683735768795,CHEM 6A,A01,184677,Staff,32,0,60,28
1683735769822,CHEM 6B,A01,184679,Staff,63,0,100,37
1683735770850,CHEM 6C,A01,184681,Bussey; Thomas J,0,0,50,50
1683735770850,CHEM 6C,A02,184682,Bussey; Thomas J,32,0,50,18
1683735771874,CHEM 40A,A01,184684,Albizati; Kim F.,33,0,100,67
1683735772899,CHEM 40B,A01,184686,Albizati; Kim F.,0,22,100,100
1683735773927,CHEM 41B,A01,184690,Staff,51,0,100,49
1683735774951,COGS 3,A01,184715,Boyle; Mary E. T.,0,27,40,40
1683735775975,COGS 14B,A01,185172,Staff,0,14,38,38
1683735777002,COGS 18,A01,184736,Staff,14,0,80,66
1683735778029,COGS 100,A01,184932,Staff,0,8,73,73
1683735779054,COGS 101A,A01,184935,Staff,0,40,30,30
1683735780077,COGS 101B,A01,184944,Staff,0,2,30,30
1683735781106,COGS 101C,A01,184946,Staff,0,10,30,30
1683735782129,COGS 102A,A01,184951,Johnson; Christine M.,1,0,40,39
1683735783156,COGS 107B,A01,184953,Mooshagian; Eric Frederick,0,52,40,40
1683735784181,COGS 118B,A01,184959,Gupta; Anjum,0,50,40,40
1683735785208,COGS 153,A00,184961,Staff,1,16,30,29
1683735786234,COGS 177,A00,184962,Staff,0,20,30,30
1683735787264,COGS 187A,A01,184969,Boyle; Mary E. T.,0,19,40,40
1683735788289,COMM 10,A01,185174,Staff,0,5,25,25
1683735788289,COMM 10,A02,185189,Staff,0,2,25,25
1683735788289,COMM 10,A03,269821,Staff,0,1,0,0
1683735789312,COMM 100B,A02,185476,Staff,10,0,25,15
1683735789312,COMM 100B,A03,277340,Staff,25,0,25,0
1683735790335,COMM 100C,A01,185314,Staff,2,0,25,23
1683735790335,COMM 100C,A02,185327,Staff,17,0,25,8
1683735791361,COMM 110M,A00,185349,Staff,0,0,40,40
1683735792385,COMM 113T,A00,185352,Staff,25,0,40,15
1683735793408,COMM 114I,A00,185353,Staff,31,0,40,9
1683735794433,COMM 131,A00,185354,Staff,17,0,30,13
1683735795457,CSE 8A,A50,185358,Cao; Yingjun,0,46,10,10
1683735796481,CSE 8B,A01,185362,Staff,0,48,50,50
1683735797507,CSE 11,A01,185416,Cao; Yingjun,0,91,10,10
1683735798535,CSE 20,A01,185445,Briones; Jor-el Thomas Caparas,3,0,25,22
1683735799564,CSE 21,A01,185447,Staff,9,0,50,41
1683735800589,CSE 101,A01,185451,Staff,0,13,50,50
1683735800589,CSE 101,B01,185453,Jones; Miles E,0,15,50,50
1683735802643,CSE 141,A01,185458,Eldon; John,16,0,100,84
1683735803670,CSE 141L,A01,185461,Eldon; John,8,0,100,92
1683735804697,CSE 142,A01,185463,Staff,34,0,60,26
1683735804697,CSE 142,B01,201355,Staff,0,7,60,60
1683735805720,CSE 142L,A01,185470,Staff,34,0,60,26
1683735805720,CSE 142L,B01,201417,Staff,0,6,60,60
1683735806748,CSE 190,A00,201433,Staff,32,0,49,17
1683735807772,DOC 1,A01,259136,Strom; Megan C.,7,0,15,8
1683735807772,DOC 1,A02,259137,Strom; Megan C.,15,0,15,0
1683735807772,DOC 1,A03,259138,Strom; Megan C.,14,0,15,1
1683735807772,DOC 1,A04,259139,Strom; Megan C.,13,0,15,2
1683735808800,DOC 100D,A00,259140,Pass; Natalye Joann,14,0,25,11
1683735809824,DSGN 1,A01,184749,Rill; Bryan,0,26,30,30
1683735810851,DSGN 100,A01,185168,Staff,0,2,25,25
1683735811879,ECE 5,A01,185626,Morris; Karcher William,0,12,0,0
1683735812909,ECE 101,A01,185628,Staff,14,0,70,56
1683735813936,ECE 107,A01,185635,Baghdadchi; Saharnaz,0,0,20,20
1683735813936,ECE 107,A02,185638,Baghdadchi; Saharnaz,1,0,20,19
1683735814961,ECE 148,A01,185647,Silberman; Jack,0,0,16,16
1683735815986,ECON 1,A01,185537,Crane; Meredith Helen,54,0,70,16
1683735817013,ECON 3,A01,185549,Crane; Meredith Helen,30,0,70,40
1683735818039,ECON 4,A01,203354,Anderson; John Charles,0,5,10,10
1683735819073,ECON 100A,A01,185574,Staff,0,5,40,40
1683735820098,ECON 100B,A01,185576,Staff,0,12,50,50
1683735821123,ECON 100C,A01,185589,Newhouse; Herbert S,30,0,70,40
1683735822150,ECON 105,A00,185608,Vespa; Emanuel Ignacio,19,0,35,16
1683735823174,ECON 109,A01,185610,Shishkin; Denis,9,0,35,26
1683735824201,ECON 110A,A01,185612,Staff,8,0,40,32
1683735825225,ECON 120A,A01,185615,Staff,19,0,40,21
1683735826248,ECON 120C,A01,185617,Sun; Yixiao,0,21,70,70
1683735827275,ECON 144,A00,203346,Squires; Dale E,2,0,35,33
1683735828300,ECON 171,A01,203349,Newhouse; Herbert S,0,1,35,35
1683735829324,ECON 173A,A01,185621,Toda; Alexis Akira,21,0,35,14
1683735830356,EDS 25,A01,202413,Staff,0,1,0,0
1683735830356,EDS 25,A02,202414,Staff,0,1,0,0
1683735830356,EDS 25,A03,202415,Staff,0,0,0,0
1683735830356,EDS 25,A04,202416,Staff,0,1,0,0
1683735830356,EDS 25,A05,202439,Staff,0,0,0,0
1683735830356,EDS 25,A06,202440,Staff,0,0,0,0
1683735830356,EDS 25,B01,202631,Staff,0,0,0,0
1683735830356,EDS 25,B02,202632,Staff,0,0,0,0
1683735830356,EDS 25,B03,202639,Staff,0,0,0,0
1683735830356,EDS 25,B04,202640,Staff,0,0,0,0
1683735830356,EDS 25,B05,202643,Staff,0,0,0,0
1683735830356,EDS 25,B06,202644,Staff,0,0,0,0
1683735831383,EDS 38,A01,202659,Black; Alison Michelle,25,0,25,0
1683735832410,EDS 115,A00,202652,Staff,18,0,30,12
1683735833436,EDS 125,A00,202649,Staff,13,0,30,17
1683735834460,EDS 126,A01,203332,Staff,30,0,30,0
1683735835485,EDS 139,A00,202838,Staff,16,0,25,9
1683735836516,EDS 146,A01,202655,Staff,14,0,25,11
1683735837541,ENG 15,A00,185667,Staff,0,1,0,2
1683735837541,ENG 15,B00,185672,Staff,0,0,0,1
1683735837541,ENG 15,C00,185675,Staff,0,0,0,0
1683735837541,ENG 15,D00,185682,Staff,0,0,0,0
1683735837541,ENG 15,E00,185684,Staff,0,0,0,0
1683735838565,ETHN 103,A00,185710,Staff,0,8,35,35
1683735839589,ETHN 103A,A00,199228,Man; Simeon S,0,0,9,9
1683735840613,ETHN 109,A00,185711,Staff,15,0,35,20
1683735841637,ETHN 142,A00,185726,Staff,0,4,30,30
1683735842661,ETHN 163J,A00,199229,Man; Simeon S,5,0,8,3
1683735843685,ETHN 168,A00,185727,Staff,7,0,10,3
1683735844717,ETHN 182,A00,185728,Staff,0,0,35,35
1683735845800,ETHN 183,A00,185737,Staff,10,0,18,8
1683735846827,GLBH 111,A01,209361,Burgos; Jose L.,0,0,0,0
1683735848877,HIEU 104,A00,185792,Staff,14,0,20,6
1683735849901,HIEU 115,A00,185800,Staff,0,0,20,20
1683735850929,HIEU 128,A00,185801,Staff,0,9,20,20
1683735851958,HIEU 147,A00,185802,Staff,15,0,20,5
1683735852982,HIEU 154,A00,185823,Staff,11,0,20,9
1683735854007,HILA 102,A00,185826,Staff,14,0,20,6
1683735855031,HILD 2C,A01,185778,Staff,0,13,20,20
1683735856058,HILD 7B,A01,185780,Kwak; Nancy,0,17,32,32
1683735856058,HILD 7B,A02,185781,Kwak; Nancy,0,18,32,32
1683735857100,HILD 30,A01,185791,Staff,12,0,20,8
1683735858127,HISC 119,A00,185830,Golan; Tal,0,10,20,20
1683735859153,HITO 156GS,A00,185831,Patterson; Patrick H.,0,0,0,23
1683735860180,HIUS 103,A00,185832,Man; Simeon S,0,4,20,20
1683735861208,HIUS 117,A00,185836,Kwak; Nancy,2,0,20,18
1683735862232,HIUS 125,A00,185840,Man; Simeon S,0,2,23,23
1683735863259,HIUS 149,A00,185845,Staff,1,0,20,19
1683735864284,HUM 3,A01,185882,Zavodny; Tatiana Sophia,0,8,50,50
1683735864284,HUM 3,B01,185899,Caldwell; Michael Alan,0,18,50,50
1683735865308,HUM 3GS,A00,185900,Patterson; Patrick H.,0,0,0,23
1683735866333,HUM 4,A01,185938,Zroka; Amy Liane,28,0,50,22
1683735866333,HUM 4,B01,185956,Watkins; Eric,0,6,50,50
1683735866333,HUM 4,B02,202209,Watkins; Eric,0,6,50,50
1683735866333,HUM 4,B03,202210,Watkins; Eric,0,5,50,50
1683735867358,HUM 5,A01,185958,West; Geoffrey Scott,0,1,50,50
1683735867358,HUM 5,A02,202215,West; Geoffrey Scott,0,1,50,50
1683735868385,INTL 190,A00,185959,Gagnon; Jeffrey C,0,0,0,9
1683735868385,INTL 190,B00,185960,Lettieri; Michael Joseph,0,0,0,2
1683735869411,JAPN 180,A00,254509,Staff,4,0,30,26
1683735870433,LATI 10,A01,202853,Kennemore; Amy Michelle,0,0,31,31
1683735870433,LATI 10,A02,202854,Kennemore; Amy Michelle,0,0,32,32
1683735870433,LATI 10,A03,270054,Kennemore; Amy Michelle,30,0,30,0
1683735871456,LATI 180,A00,202855,Kennemore; Amy Michelle,11,0,20,9
1683735872481,LAWS 101,A00,201767,Golan; Tal,0,7,40,40
1683735873507,LIFR 1C,A00,185961,Staff,6,0,20,14
1683735874530,LIFR 1CX,A00,185962,Staff,7,0,20,13
1683735875556,LIFR 1D,A00,185963,Staff,7,0,20,13
1683735876581,LIFR 1DX,A00,185964,Staff,7,0,20,13
1683735877608,LIGN 101,A01,186039,Staff,43,0,50,7
1683735878632,LIGN 165,A00,186040,Staff,14,0,50,36
1683735879659,LTCS 108,A00,186041,Staff,5,0,10,5
1683735880684,LTCS 119,A00,186042,Staff,15,0,20,5
1683735881708,LTCS 130,A00,186043,Wesling; Megan E.,15,0,25,10
1683735883763,LTEA 138,A00,186119,Staff,13,0,40,27
1683735884793,LTEN 124,A00,186148,Staff,5,0,25,20
1683735885819,LTEN 178,A00,186149,Staff,6,0,15,9
1683735886843,LTEN 181,A00,186150,Blanco; John D,34,0,40,6
1683735887870,LTWL 120,A00,186160,Staff,19,0,25,6
1683735888897,LTWL 165,A00,186161,Staff,22,0,25,3
1683735889924,LTWR 100,A00,186162,Staff,0,5,15,15
1683735890947,LTWR 102,A00,186163,Doller; Ben,5,0,15,10
1683735891974,MAE 8,A01,186412,Staff,0,1,0,1
1683735893002,MAE 30B,A00,186445,Bahadori; Mohammad Yousef,81,0,100,19
1683735894027,MAE 40,A00,186592,Bewley; Thomas R,10,0,50,40
1683735895052,MAE 101B,A00,186593,Bahadori; Mohammad Yousef,79,0,100,21
1683735896076,MAE 105,A00,186594,Bandaru; Prabhakar,10,0,50,40
1683735897104,MAE 107,A00,186599,Pham; Hieu Tan,0,8,120,120
1683735898130,MAE 148,A01,186660,Silberman; Jack,3,0,16,13
1683735899157,MATH 10A,A01,188095,Staff,0,6,35,35
1683735900183,MATH 10B,A01,188097,Bowers; Adam R.,0,12,30,30
1683735900183,MATH 10B,A02,188099,Bowers; Adam R.,0,11,30,30
1683735900183,MATH 10B,B01,188104,Bowers; Adam R.,0,10,30,30
1683735900183,MATH 10B,B02,188106,Bowers; Adam R.,0,9,30,30
1683735901247,MATH 10C,A01,188111,Staff,0,20,30,30
1683735901247,MATH 10C,A02,188127,Staff,0,19,30,30
1683735901247,MATH 10C,A03,188131,Staff,0,19,30,30
1683735901247,MATH 10C,B01,188218,Staff,17,0,30,13
1683735901247,MATH 10C,B02,188244,Staff,13,0,30,17
1683735901247,MATH 10C,B03,188277,Staff,14,0,30,16
1683735902275,MATH 18,A01,188344,Bach; Quang Tran,18,0,30,12
1683735902275,MATH 18,A02,188345,Bach; Quang Tran,11,0,30,19
1683735902275,MATH 18,B01,188353,Bach; Quang Tran,11,0,30,19
1683735902275,MATH 18,B02,188354,Bach; Quang Tran,19,0,30,11
1683735903299,MATH 20A,A01,188374,Staff,10,0,35,25
1683735904328,MATH 20B,A01,188382,Ohm; Ko Woon,7,0,30,23
1683735904328,MATH 20B,A02,188383,Ohm; Ko Woon,22,0,30,8
1683735904328,MATH 20B,B01,188385,Ohm; Ko Woon,7,0,30,23
1683735904328,MATH 20B,B02,188392,Ohm; Ko Woon,22,0,30,8
1683735905353,MATH 20C,A01,188394,Harel; Guershon,10,0,30,20
1683735905353,MATH 20C,A02,188395,Harel; Guershon,13,0,30,17
1683735905353,MATH 20C,B01,188404,Harel; Guershon,5,0,30,25
1683735905353,MATH 20C,B02,188405,Harel; Guershon,18,0,30,12
1683735906382,MATH 20D,A01,188414,Hammock; Frances H,0,1,30,30
1683735906382,MATH 20D,A02,188415,Hammock; Frances H,0,1,30,30
1683735906382,MATH 20D,B01,188447,Hammock; Frances H,0,1,30,30
1683735906382,MATH 20D,B02,188486,Hammock; Frances H,2,0,30,28
1683735907405,MATH 20E,A01,188649,Staff,21,0,30,9
1683735907405,MATH 20E,A02,188650,Staff,20,0,30,10
1683735907405,MATH 20E,A03,188673,Staff,0,0,30,30
1683735908431,MATH 102,A01,188675,Staff,0,40,35,35
1683735909456,MATH 103B,A01,188681,Staff,3,0,35,32
1683735909456,MATH 103B,B01,188692,Staff,5,0,35,30
1683735910481,MATH 109,A01,188695,Salehi Golsefidy; Alireza,24,0,35,11
1683735910481,MATH 109,A02,188696,Salehi Golsefidy; Alireza,24,0,35,11
1683735911509,MATH 120A,A01,188698,Eggers; John Dietrich,7,0,35,28
1683735912537,MATH 142B,A01,188736,Ioana; Adrian,0,0,30,30
1683735912537,MATH 142B,A02,188741,Ioana; Adrian,0,1,30,30
1683735912537,MATH 142B,A03,188743,Ioana; Adrian,0,3,30,30
1683735913564,MATH 168A,A01,188790,Staff,0,11,35,35
1683735914598,MATH 170A,A01,188803,Nie; Jiawang,0,2,35,35
1683735914598,MATH 170A,A02,188811,Nie; Jiawang,0,1,35,35
1683735914598,MATH 170A,A03,188814,Nie; Jiawang,1,0,35,34
1683735914598,MATH 170A,A04,188815,Nie; Jiawang,4,0,35,31
1683735915623,MATH 193B,A01,188817,Staff,0,0,35,35
1683735915623,MATH 193B,A02,188818,Staff,6,0,35,29
1683735916647,MGT 4,A01,202857,Anderson; John Charles,59,0,80,21
1683735917670,MGT 12,A00,202858,Lindenberger; Wade Douglas,40,0,90,50
1683735918694,MGT 18,A00,202859,Staff,73,0,90,17
1683735919722,MGT 18GS,A00,202860,McKay; Michael J,13,0,28,15
1683735920745,MGT 45,A00,202861,Pecore; Joseph P.,8,0,90,82
1683735921773,MGT 100,A00,202863,Yavorsky; Daniel Ryan,27,0,90,63
1683735922798,MGT 103,A00,202864,Ehrich; Kristine R,0,19,90,90
1683735923823,MGT 112,A00,202865,Ehrich; Kristine R,15,0,90,75
1683735924850,MGT 121A,A00,202868,Staff,70,0,90,20
1683735925879,MGT 131B,A00,202869,Anderson; John Charles,58,0,90,32
1683735926904,MGT 136,A00,202871,Lindenberger; Wade Douglas,83,0,90,7
1683735927932,MGT 164,A00,202873,Staff,0,67,90,91
1683735928956,MGT 164GS,A00,202874,McKay; Mary A,13,0,28,15
1683735929983,MGT 180,A00,202875,Staff,0,51,90,91
1683735931007,MMW 11R,A01,205019,Herbst; Matthew,0,0,30,30
1683735931007,MMW 11R,A02,205026,Herbst; Matthew,29,0,30,1
1683735932037,MMW 15,A01,193512,Chang; Edmond Yi-Teh,0,8,28,28
1683735932037,MMW 15,A02,193513,Chang; Edmond Yi-Teh,0,5,28,28
1683735932037,MMW 15,A03,193514,Chang; Edmond Yi-Teh,0,5,28,28
1683735932037,MMW 15,A04,193515,Chang; Edmond Yi-Teh,0,5,28,28
1683735932037,MMW 15,A05,193516,Chang; Edmond Yi-Teh,0,5,28,28
1683735932037,MMW 15,A06,193517,Chang; Edmond Yi-Teh,0,6,28,28
1683735932037,MMW 15,B01,193519,Chang; Edmond Yi-Teh,0,5,28,28
1683735932037,MMW 15,B02,193520,Chang; Edmond Yi-Teh,0,5,28,28
1683735932037,MMW 15,B03,193521,Chang; Edmond Yi-Teh,0,5,28,28
1683735932037,MMW 15,B04,193522,Chang; Edmond Yi-Teh,0,6,28,28
1683735932037,MMW 15,B05,193523,Chang; Edmond Yi-Teh,0,5,28,28
1683735932037,MMW 15,B06,193524,Chang; Edmond Yi-Teh,0,5,28,28
1683735933063,MMW 122,A01,193526,Rahimi; Babak,0,16,28,28
1683735933063,MMW 122,A02,193527,Rahimi; Babak,0,15,28,28
1683735933063,MMW 122,A03,193528,Rahimi; Babak,0,0,0,0
1683735933063,MMW 122,A04,193529,Rahimi; Babak,0,0,0,0
1683735934086,MUS 1A,A01,186663,Staff,0,18,35,35
1683735935109,MUS 4,A01,186715,Staff,0,12,35,35
1683735936135,MUS 5R,A01,186796,Dubnov; Shlomo,0,17,35,35
1683735937161,MUS 6,A01,186798,Staff,0,4,25,25
1683735938184,MUS 7,A01,186830,Staff,11,0,35,24
1683735939208,MUS 8,A01,186930,Staff,0,27,35,35
1683735940233,MUS 15,A01,186932,Staff,0,15,35,35
1683735940233,MUS 15,B01,186934,Staff,0,16,35,35
1683735941262,MUS 80,A00,186935,Staff,0,0,20,20
1683735941262,MUS 80,B00,186936,Staff,24,0,25,1
1683735942286,NANO 11,A00,204702,Lipomi; Darren John,0,0,0,0
1683735943314,NANO 15,A01,204709,Yang; Kesong,0,1,0,0
1683735944338,NANO 114,A00,202069,Jahed Motlagh; Zeinab,2,0,10,8
1683735945362,PHIL 1,A00,186955,Grush; Rick Scott,31,0,40,9
1683735946388,PHIL 10,A01,186973,Grush; Rick Scott,27,0,35,8
1683735946388,PHIL 10,A02,186974,Grush; Rick Scott,33,0,35,2
1683735947412,PHIL 13,A01,186976,Staff,1,0,35,34
1683735947412,PHIL 13,A02,186977,Staff,16,0,35,19
1683735948440,PHIL 14,A01,186979,Staff,30,0,35,5
1683735948440,PHIL 14,A02,186986,Staff,32,0,35,3
1683735949520,PHIL 28,A01,186988,Staff,16,0,30,14
1683735949520,PHIL 28,A02,186989,Staff,0,0,30,30
1683735949520,PHIL 28,A03,186990,Staff,10,0,30,20
1683735949520,PHIL 28,A04,186991,Staff,26,0,30,4
1683735950551,PHIL 120,A00,186997,Staff,23,0,40,17
1683735951579,PHIL 137,A00,187003,Staff,8,0,40,32
1683735952607,PHIL 150,A00,187015,Staff,47,0,70,23
1683735953630,PHIL 167,A00,187021,Lamey; Andy M.,34,0,40,6
1683735954655,PHIL 174,A01,202226,Staff,17,0,20,3
1683735954655,PHIL 174,A02,202235,Staff,20,0,20,0
1683735955679,PHIL 191A,A00,258918,Staff,0,0,1,1
1683735956703,PHYS 1A,A00,187028,Staff,26,0,60,34
1683735957728,PHYS 1AL,001,187036,Staff,3,0,30,27
1683735957728,PHYS 1AL,002,187049,Staff,18,0,30,12
1683735958751,PHYS 1B,A00,187058,Staff,21,0,60,39
1683735959776,PHYS 1BL,001,187064,Staff,0,1,30,30
1683735959776,PHYS 1BL,002,187070,Staff,4,0,30,26
1683735960799,PHYS 1C,A00,187082,Staff,30,0,120,90
1683735961823,PHYS 1CL,001,187088,Staff,0,9,30,30
1683735961823,PHYS 1CL,002,187089,Staff,0,1,30,30
1683735961823,PHYS 1CL,009,262693,Staff,9,0,30,21
1683735962848,PHYS 2B,A01,187097,Staff,55,0,115,60
1683735963872,PHYS 2C,A01,187099,Staff,63,0,115,52
1683735964897,PHYS 2CL,A01,187101,Staff,5,0,28,23
1683735964897,PHYS 2CL,A02,187102,Staff,15,0,28,13
1683735965920,PHYS 2D,A01,187123,Shotwell; Brian,95,0,115,20
1683735966947,PHYS 4B,A01,187133,Grinstein; Benjamin,34,0,50,16
1683735967971,POLI 10,A00,188819,Staff,0,4,50,50
1683735968997,POLI 11,A00,188827,Staff,43,0,50,7
1683735970021,POLI 13R,A00,188828,Staff,0,2,20,20
1683735971046,POLI 27,A01,188830,Elgin; Samuel Zincke,0,2,70,70
1683735972070,POLI 30,A00,188832,Desposato; Scott,30,0,50,20
1683735973096,POLI 102F,A00,188834,Staff,1,0,40,39
1683735974126,POLI 104A,A00,188852,Staff,12,0,30,18
1683735975152,POLI 104I,A00,188853,Staff,0,8,20,20
1683735976175,POLI 110B,A00,188854,Wiens; David,6,0,20,14
1683735977202,POLI 112A,A00,188855,Wiens; David,4,0,30,26
1683735978226,POLI 117R,A00,188856,Forman; Fonna,0,12,20,20
1683735979259,POLI 118,A00,188857,Ingham; Sean,8,0,20,12
1683735980285,POLI 120G,A00,188858,Staff,7,0,30,23
1683735981313,POLI 131CR,A00,188863,Hoston; Germaine,20,0,50,30
1683735982337,POLI 133,A00,188864,Nellis; Gareth Hb,44,0,50,6
1683735983361,POLI 134D,A00,188865,Desposato; Scott,27,0,30,3
1683735984384,POLI 142A,A00,188871,Gartzke; Erik,21,0,50,29
1683735985406,POLI 142K,A00,188874,Staff,38,0,50,12
1683735986434,POLI 143,A00,188940,Gartzke; Erik,15,0,30,15
1683735987462,POLI 153,A00,188943,Staff,1,0,20,19
1683735988486,POLI 160AA,A00,188944,Staff,10,0,40,30
1683735989510,POLI 170A,A00,188945,Staff,10,0,30,20
1683735991558,PSYC 1,A00,188952,Staff,36,0,90,54
1683735992586,PSYC 2,B00,188953,Staff,19,0,35,16
1683735993610,PSYC 6,A00,188970,Staff,47,0,60,13
1683735994635,PSYC 7,A00,188973,Staff,35,0,45,10
1683735995659,PSYC 60,A01,188980,Rickard; Timothy C.,42,0,60,18
1683735996688,PSYC 70,A01,189001,Steiner; Eric Tomas,21,0,45,24
1683735997722,PSYC 100,A00,189005,Lacefield; Katharine I,1,98,120,119
1683735998749,PSYC 102,A00,189008,Staff,6,0,30,24
1683735999779,PSYC 106,B00,189026,Gorman; Michael R.,26,0,60,34
1683736000804,PSYC 114,B01,189033,Winkielman; Piotr,0,31,30,30
1683736001835,PSYC 131,A00,189036,Anagnostaras; Stephan,0,44,60,60
1683736002861,PSYC 136,A00,189041,Lowe; Angela Beth,0,7,25,25
1683736003885,PSYC 137,A00,189057,Winkielman; Piotr,0,36,25,25
1683736004910,PSYC 144,A00,189107,Wixted; John T,0,11,50,50
1683736006956,PSYC 162,A00,189142,Staff,0,9,85,85
1683736007980,PSYC 172,A00,189144,Gorman; Michael R.,0,6,30,30
1683736010032,PSYC 179,A00,189146,Lacefield; Katharine I,0,88,120,120
1683736011057,PSYC 181,A00,189147,Anagnostaras; Stephan,110,45,200,90
1683736012084,PSYC 190R,A00,189148,Barner; David A.,0,23,80,80
1683736013112,PSYC 191,A00,189275,Rickard; Timothy C.,0,11,25,25
1683736014136,PSYC 193,A00,189276,Chapman; Eddie Nathaniel,0,1,0,4
1683736015161,PSYC 193L,A01,189281,Lowe; Angela Beth,8,0,20,12
1683736015161,PSYC 193L,B01,189285,Staff,28,0,35,7
1683736016187,RELI 149,A00,187137,Rahimi; Babak,6,0,40,34
1683736017210,SE 9,A01,187315,Staff,0,2,18,18
1683736018238,SE 101B,A00,187409,Staff,24,0,30,6
1683736019265,SE 110B,A00,187444,Staff,10,0,40,30
1683736020290,SE 130B,A00,187449,Staff,31,0,40,9
1683736021315,SE 150A,A00,187516,Staff,8,0,20,12
1683736022339,SE 154,A00,187528,Staff,29,0,50,21
1683736023366,SIO 3,A01,258171,Staff,35,0,40,5
1683736024391,SIO 10,A00,187144,Cook; Geoffrey W,0,6,75,75
1683736025417,SIO 45,A00,187152,Cook; Geoffrey W,1,7,100,99
1683736026440,SIO 109R,A00,194486,Staff,0,4,20,20
1683736028497,SIO 187,A01,187233,Kacev; David,12,0,40,28
1683736029520,SOCI 1,A01,258656,Thorpe; Charles Robert,28,0,30,2
1683736029520,SOCI 1,A02,258658,Thorpe; Charles Robert,30,0,30,0
1683736029520,SOCI 1,A03,258661,Thorpe; Charles Robert,25,0,25,0
1683736029520,SOCI 1,A04,258666,Thorpe; Charles Robert,22,0,25,3
1683736029520,SOCI 1,A05,258897,Thorpe; Charles Robert,22,0,25,3
1683736029520,SOCI 1,A06,258898,Thorpe; Charles Robert,25,0,25,0
1683736030550,SOCI 30,A01,258903,Pardo Guerra; Juan Pablo,14,0,30,16
1683736031574,SOCI 102,A00,258904,Staff,9,0,25,16
1683736032596,SOCI 106,A00,258905,Staff,19,0,25,6
1683736033621,SOCI 111,A00,258907,Ribas Norris; Janet Vanesa,26,0,30,4
1683736034649,SOCI 121R,A00,258908,Pardo Guerra; Juan Pablo,7,0,30,23
1683736035675,SOCI 126,A01,203330,Staff,14,0,20,6
1683736036702,SOCI 131,A00,258909,Thorpe; Charles Robert,30,0,60,30
1683736037727,SOCI 135,A00,258910,Payne; Christine Anna,0,13,30,30
1683736038754,SOCI 157,A00,258911,Staff,10,0,30,20
1683736039779,SOCI 184,A00,258912,Staff,25,0,30,5
1683736040803,SOCI 188D,A00,258913,Staff,22,0,30,8
1683736041832,SYN 2,001,187529,Staff,9,0,16,7
1683736041832,SYN 2,002,201452,Staff,0,20,16,16
1683736041832,SYN 2,003,201469,Staff,1,0,16,15
1683736042867,SYN 100,A01,187531,Staff,0,9,20,20
1683736042867,SYN 100,B01,201491,Staff,0,10,20,20
1683736043894,TDAC 1,A00,189286,Walsh; Kim C.,3,0,20,17
1683736043894,TDAC 1,B00,189287,Harting; Carla Kelso,10,0,20,10
1683736044922,TDAC 101,A00,189300,Walsh; Kim C.,16,0,20,4
1683736044922,TDAC 101,B00,189301,Harting; Carla Kelso,18,0,20,2
1683736045947,TDAC 102,A00,189304,Basso; Beatrice,14,0,20,6
1683736046972,TDAC 108,A00,189305,Staff,18,0,20,2
1683736048002,TDDE 131,A00,189310,Staff,19,0,20,1
1683736048002,TDDE 131,B00,189314,Staff,19,0,20,1
1683736048002,TDDE 131,C00,189315,Staff,48,0,50,2
1683736048002,TDDE 131,D00,189316,Staff,14,0,15,1
1683736048002,TDDE 131,E00,204841,Staff,20,0,20,0
1683736049028,TDGE 10,A00,189289,Staff,26,0,50,24
1683736049028,TDGE 10,B00,189290,Havis; Allan,0,1,50,50
1683736050054,TDGE 11,A00,189291,Fulton; Julia,0,4,50,50
1683736050054,TDGE 11,B00,189292,Staff,20,0,25,5
1683736050054,TDGE 11,C00,260270,Staff,0,0,0,0
1683736051082,TDGE 25,A00,189294,Staff,1,0,20,19
1683736052109,TDGE 124,A00,189318,Fulton; Julia,0,7,50,50
1683736053195,TDGE 125,A00,189319,Staff,13,0,25,12
1683736053195,TDGE 125,B00,189320,Staff,23,0,25,2
1683736054221,TDGE 127,A00,189322,Havis; Allan,1,0,50,49
1683736055246,TDHT 101,A00,189323,Staff,18,0,25,7
1683736055246,TDHT 101,B00,189324,Staff,25,0,25,0
1683736056274,TDHT 102,A00,189325,Staff,49,0,50,1
1683736057303,TDMV 1,A00,189295,Arcidiacono; Kristin,20,0,30,10
1683736057303,TDMV 1,B00,189296,Caligagan; Maria T.,23,0,30,7
1683736058328,TDMV 2,A00,189297,Sammartano; Tonnie,27,0,30,3
1683736058328,TDMV 2,B00,189299,Arcidiacono; Kristin,23,0,30,7
1683736059355,TDMV 3,A00,204998,Rincon; Alicia,22,0,30,8
1683736060379,TDMV 120,A00,189458,Sammartano; Tonnie,28,0,30,2
1683736061408,TDMV 138,A00,189541,Jun; Grace Shin Hae,20,0,40,20
1683736062433,TDMV 142,A00,189717,Caligagan; Tony,25,0,30,5
1683736062433,TDMV 142,B00,189718,Caligagan; Maria T.,25,0,30,5
1683736063459,TMC 2,A01,187533,Staff,25,0,25,0
1683736063459,TMC 2,A02,187534,Staff,25,0,25,0
1683736064484,USP 1,A01,187536,Kwak; Nancy,0,16,25,25
1683736065508,USP 5,A01,187538,Staff,8,0,25,17
1683736066533,USP 101,A00,199253,Staff,0,4,0,0
1683736067557,USP 124,A00,187562,Boomhower; Matthew Charles,0,0,30,30
1683736068581,USP 138,A00,187582,Staff,19,0,25,6
1683736069603,USP 152,A01,187597,Staff,3,0,25,22
1683736070627,USP 153,A00,187598,Staff,18,0,25,7
1683736071652,USP 168,A00,187607,Kwak; Nancy,2,0,5,3
1683736072679,USP 173,A00,187619,Staff,4,0,25,21
1683736073705,USP 181,A00,187638,Staff,0,4,25,25
1683736074730,VIS 103,A00,187650,Cruz; Edwin Teddy,17,0,75,58
1683736075754,VIS 110D,A00,187669,Staff,13,0,22,9
1683736076777,VIS 127C,A00,187720,Shen; Kuiyi,67,0,146,79
1683736077802,VIS 149,A00,187731,Yoldas; Pinar,0,12,22,22
1683736078830,VIS 151,A01,188091,Staff,22,0,34,12
1683736078830,VIS 151,A02,188092,Staff,11,0,34,23
1683736079863,VIS 160B,A00,188093,Stalbaum; Brett,0,1,10,10
1683736081916,WCWP 10B,A00,201720,Staff,0,0,5,5
1683736081916,WCWP 10B,B00,201722,Staff,0,0,6,6
1683736082946,WCWP 100,A00,201725,Gagnon; Jeffrey C,0,0,2,2
1683736082946,WCWP 100,B00,201727,Staff,0,4,15,15
1683736086073,ANBI 133,A00,258401,Wilder; Linnea Lorene,34,0,40,6
1683736087096,ANBI 140,A00,258395,Hrvoj Mihic; Branka,18,0,25,7
1683736088125,ANSC 120,A00,258402,Bialecki; Jon Anthony,26,0,40,14
1683736089151,ANSC 144,A00,258400,Staff,12,0,40,28
1683736091208,ANSC 166,A00,258396,Parish; Steven Martin,156,0,175,19
1683736092232,ANSC 180,A00,193533,Staff,8,0,20,12
1683736093258,ANSC 188,A00,258397,Jassal; Aftab,34,0,40,6
1683736094286,ANTH 3,A01,258316,Staff,23,0,30,7
1683736095314,ANTH 5,A00,258394,Semendeferi; Ekaterini,16,0,20,4
1683736096342,ANTH 21,A01,258331,Staff,4,0,40,36
1683736097365,ANTH 103,A00,258398,Varma; Saiba,15,0,25,10
1683736098392,AWP 10,001,202034,Staff,0,0,0,0
1683736098392,AWP 10,002,202035,Staff,0,0,0,0
1683736098392,AWP 10,003,202036,Staff,0,0,0,0
1683736098392,AWP 10,004,202037,Staff,0,0,0,0
1683736098392,AWP 10,005,202038,Staff,0,0,0,0
1683736098392,AWP 10,006,202039,Staff,0,0,0,0
1683736098392,AWP 10,007,202040,Staff,0,0,0,0
1683736098392,AWP 10,008,202041,Staff,0,0,0,0
1683736098392,AWP 10,009,202042,Staff,0,0,0,0
1683736098392,AWP 10,010,202043,Staff,0,0,0,0
1683736098392,AWP 10,011,202044,Staff,0,0,0,0
1683736098392,AWP 10,012,202045,Staff,0,0,0,0
1683736098392,AWP 10,013,202046,Staff,0,0,0,0
1683736098392,AWP 10,014,202047,Staff,0,0,0,0
1683736098392,AWP 10,015,202048,Staff,0,0,0,0
1683736098392,AWP 10,016,202049,Staff,0,0,0,0
1683736098392,AWP 10,017,202050,Staff,0,0,0,0
1683736098392,AWP 10,018,202051,Staff,0,0,0,0
1683736098392,AWP 10,019,202052,Staff,0,0,0,0
1683736098392,AWP 10,020,202053,Staff,0,0,0,0
1683736098392,AWP 10,021,202054,Staff,0,0,0,0
1683736098392,AWP 10,022,202055,Staff,0,0,0,0
1683736098392,AWP 10,023,202056,Staff,0,0,0,0
1683736098392,AWP 10,024,202057,Staff,0,0,0,0
1683736098392,AWP 10,025,202058,Staff,0,0,0,0
1683736098392,AWP 10,026,202059,Staff,0,0,0,0
1683736099417,AWP 102,001,202032,Staff,0,0,0,0
1683736099417,AWP 102,002,202033,Staff,0,0,0,0
1683736100441,BENG 100,A01,254234,Taylor Amos; Alyssa C,31,0,40,9
1683736101464,BENG 196,001,270013,Engler; Adam J.,9999,0,9999,0
1683736102493,BICD 100R,A01,202018,Smith; Laurie,0,7,32,32
1683736102493,BICD 100R,A02,202019,Smith; Laurie,0,3,32,32
1683736102493,BICD 100R,A03,202020,Smith; Laurie,0,1,32,32
1683736102493,BICD 100R,A04,202021,Smith; Laurie,6,0,32,26
1683736102493,BICD 100R,A05,202022,Smith; Laurie,10,0,32,22
1683736103518,BICD 136,A01,193242,Gustafson-Brown; Cindy,0,2,32,32
1683736103518,BICD 136,A02,193244,Gustafson-Brown; Cindy,13,0,32,19
1683736104548,BIEB 102,A01,193249,Butler; Shannon Rhey,0,0,32,32
1683736104548,BIEB 102,A02,193251,Butler; Shannon Rhey,0,0,32,32
1683736104548,BIEB 102,A03,193253,Butler; Shannon Rhey,0,0,32,32
1683736104548,BIEB 102,A04,193255,Butler; Shannon Rhey,13,0,32,19
1683736104548,BIEB 102,A05,193265,Butler; Shannon Rhey,25,0,32,7
1683736104548,BIEB 102,A06,193269,Butler; Shannon Rhey,12,0,32,20
1683736106598,BIEB 150,A01,193274,Staff,0,0,32,32
1683736106598,BIEB 150,A02,193285,Staff,24,0,32,8
1683736107626,BIEB 194,A00,193286,Kurle; Carolyn M.,19,0,32,13
1683736108653,BILD 1,A01,192291,Staff,15,0,32,17
1683736108653,BILD 1,A02,192292,Staff,30,0,32,2
1683736108653,BILD 1,B01,192520,Reuther; Keefe,0,1,0,0
1683736108653,BILD 1,B02,192532,Reuther; Keefe,0,1,0,0
1683736109684,BILD 3,A01,192556,Butler; Shannon Rhey,0,0,32,32
1683736109684,BILD 3,A02,192581,Butler; Shannon Rhey,0,1,32,32
1683736109684,BILD 3,A03,192611,Butler; Shannon Rhey,19,0,32,13
1683736109684,BILD 3,A04,192612,Butler; Shannon Rhey,23,0,32,9
1683736109684,BILD 3,A05,192613,Butler; Shannon Rhey,26,0,32,6
1683736109684,BILD 3,A06,192679,Butler; Shannon Rhey,27,0,32,5
1683736109684,BILD 3,A07,192682,Butler; Shannon Rhey,20,0,32,12
1683736110710,BILD 4,A01,192836,Reuther; Keefe,1,0,24,23
1683736110710,BILD 4,A02,193044,Reuther; Keefe,4,0,24,20
1683736111734,BILD 10,A01,193142,Gustafson-Brown; Cindy,29,0,32,3
1683736111734,BILD 10,A02,193149,Gustafson-Brown; Cindy,31,0,32,1
1683736112762,BIMM 100,A01,193301,Staff,0,6,32,32
1683736112762,BIMM 100,A02,193312,Staff,0,7,32,32
1683736112762,BIMM 100,A03,193323,Staff,0,10,32,32
1683736113794,BIMM 101,A01,193329,McDonnell; Lisa Marie,0,3,24,24
1683736113794,BIMM 101,A02,193339,McDonnell; Lisa Marie,0,3,24,24
1683736113794,BIMM 101,B01,193354,McDonnell; Lisa Marie,0,4,24,24
1683736113794,BIMM 101,B02,193357,McDonnell; Lisa Marie,0,3,24,24
1683736114822,BIMM 110,A01,193377,Tat; John,0,11,32,32
1683736114822,BIMM 110,A02,193378,Tat; John,0,11,32,32
1683736115848,BIMM 120,A01,206116,Staff,1,0,32,31
1683736115848,BIMM 120,A02,206117,Staff,7,0,32,25
1683736115848,BIMM 120,A03,206121,Staff,21,0,32,11
1683736116878,BIPN 100,A01,193393,Park; Ji Young,0,15,32,32
1683736116878,BIPN 100,A02,193402,Park; Ji Young,0,14,32,32
1683736116878,BIPN 100,A03,193413,Park; Ji Young,0,14,32,32
1683736116878,BIPN 100,A04,193414,Park; Ji Young,0,13,32,32
1683736117902,BIPN 102,A01,193429,Staff,0,0,32,32
1683736117902,BIPN 102,A02,193438,Staff,18,0,32,14
1683736118929,BIPN 106,A01,193450,Reyes Gonzalez; Catalina,0,2,40,40
1683736119956,BIPN 134,A01,193465,Cooke; James Edward,0,0,32,32
1683736119956,BIPN 134,A02,193474,Cooke; James Edward,24,0,32,8
1683736119956,BIPN 134,A03,193485,Cooke; James Edward,29,0,32,3
1683736119956,BIPN 134,A04,193486,Cooke; James Edward,20,0,32,12
1683736119956,BIPN 134,A05,193491,Cooke; James Edward,31,0,32,1
1683736119956,BIPN 134,A06,193501,Cooke; James Edward,30,0,32,2
1683736119956,BIPN 134,A07,193510,Cooke; James Edward,29,0,32,3
1683736122009,BISP 194,A00,222522,Staff,14,0,32,18
1683736123034,CAT 124,A01,202407,Staff,19,0,25,6
1683736124059,CAT 125,A00,202408,Marchisotto; Jennifer Anne,2,0,20,18
1683736125084,CAT 125R,A00,202409,Smith; Lauryn Alissa,0,11,20,20
1683736125084,CAT 125R,B00,202410,Morales; Celeste Georgianna,0,11,20,20
1683736125084,CAT 125R,C00,202411,Irwin; Matthew Joseph,0,12,20,20
1683736126107,CENG 15,A01,204712,Yang; Kesong,0,1,0,0
1683736127135,CENG 114,A00,202070,Jahed Motlagh; Zeinab,5,0,20,15
1683736128162,CGS 105,A00,185477,Wesling; Megan E.,24,0,40,16
1683736129188,CGS 106,A00,185494,Staff,11,0,22,11
1683736130212,CGS 108,A00,185495,Staff,14,0,20,6
1683736131240,CGS 114,A00,185496,Staff,13,0,18,5
1683736132266,CGS 119,A00,185501,Staff,15,0,20,5
1683736133289,CGS 120,A00,185511,Staff,11,0,20,9
1683736134314,CHEM 4,A01,184675,Bussey; Thomas J,97,0,100,3
1683736135338,CHEM 6A,A01,184677,Staff,32,0,60,28
1683736136364,CHEM 6B,A01,184679,Staff,63,0,100,37
1683736137389,CHEM 6C,A01,184681,Bussey; Thomas J,0,0,50,50
1683736137389,CHEM 6C,A02,184682,Bussey; Thomas J,32,0,50,18
1683736138412,CHEM 40A,A01,184684,Albizati; Kim F.,33,0,100,67
1683736139436,CHEM 40B,A01,184686,Albizati; Kim F.,0,22,100,100
1683736140469,CHEM 41B,A01,184690,Staff,51,0,100,49
1683736141494,COGS 3,A01,184715,Boyle; Mary E. T.,0,27,40,40
1683736142523,COGS 14B,A01,185172,Staff,0,14,38,38
1683736143549,COGS 18,A01,184736,Staff,14,0,80,66
1683736144576,COGS 100,A01,184932,Staff,0,8,73,73
1683736145604,COGS 101A,A01,184935,Staff,0,40,30,30
1683736146628,COGS 101B,A01,184944,Staff,0,2,30,30
1683736147654,COGS 101C,A01,184946,Staff,0,10,30,30
1683736148678,COGS 102A,A01,184951,Johnson; Christine M.,1,0,40,39
1683736149706,COGS 107B,A01,184953,Mooshagian; Eric Frederick,0,52,40,40
1683736150731,COGS 118B,A01,184959,Gupta; Anjum,0,50,40,40
1683736151756,COGS 153,A00,184961,Staff,1,16,30,29
1683736152788,COGS 177,A00,184962,Staff,0,20,30,30
1683736153813,COGS 187A,A01,184969,Boyle; Mary E. T.,0,19,40,40
1683736154840,COMM 10,A01,185174,Staff,0,5,25,25
1683736154840,COMM 10,A02,185189,Staff,0,2,25,25
1683736154840,COMM 10,A03,269821,Staff,0,1,0,0
1683736155865,COMM 100B,A02,185476,Staff,10,0,25,15
1683736155865,COMM 100B,A03,277340,Staff,25,0,25,0
1683736156947,COMM 100C,A01,185314,Staff,2,0,25,23
1683736156947,COMM 100C,A02,185327,Staff,17,0,25,8
1683736157971,COMM 110M,A00,185349,Staff,0,0,40,40
1683736158995,COMM 113T,A00,185352,Staff,25,0,40,15
1683736160020,COMM 114I,A00,185353,Staff,31,0,40,9
1683736161045,COMM 131,A00,185354,Staff,17,0,30,13
1683736162068,CSE 8A,A50,185358,Cao; Yingjun,0,46,10,10
1683736163090,CSE 8B,A01,185362,Staff,0,48,50,50
1683736164115,CSE 11,A01,185416,Cao; Yingjun,0,91,10,10
1683736165139,CSE 20,A01,185445,Briones; Jor-el Thomas Caparas,3,0,25,22
1683736166165,CSE 21,A01,185447,Staff,9,0,50,41
1683736167190,CSE 101,A01,185451,Staff,0,13,50,50
1683736167190,CSE 101,B01,185453,Jones; Miles E,0,15,50,50
1683736169239,CSE 141,A01,185458,Eldon; John,16,0,100,84
1683736170265,CSE 141L,A01,185461,Eldon; John,8,0,100,92
1683736171291,CSE 142,A01,185463,Staff,34,0,60,26
1683736171291,CSE 142,B01,201355,Staff,0,7,60,60
1683736172315,CSE 142L,A01,185470,Staff,34,0,60,26
1683736172315,CSE 142L,B01,201417,Staff,0,6,60,60
1683736173343,CSE 190,A00,201433,Staff,32,0,49,17
1683736174366,DOC 1,A01,259136,Strom; Megan C.,7,0,15,8
1683736174366,DOC 1,A02,259137,Strom; Megan C.,15,0,15,0
1683736174366,DOC 1,A03,259138,Strom; Megan C.,14,0,15,1
1683736174366,DOC 1,A04,259139,Strom; Megan C.,13,0,15,2
1683736175393,DOC 100D,A00,259140,Pass; Natalye Joann,14,0,25,11
1683736176417,DSGN 1,A01,184749,Rill; Bryan,0,26,30,30
1683736177444,DSGN 100,A01,185168,Staff,0,2,25,25
1683736178474,ECE 5,A01,185626,Morris; Karcher William,0,12,0,0
1683736179500,ECE 101,A01,185628,Staff,14,0,70,56
1683736180524,ECE 107,A01,185635,Baghdadchi; Saharnaz,0,0,20,20
1683736180524,ECE 107,A02,185638,Baghdadchi; Saharnaz,1,0,20,19
1683736181550,ECE 148,A01,185647,Silberman; Jack,0,0,16,16
1683736182575,ECON 1,A01,185537,Crane; Meredith Helen,54,0,70,16
1683736183601,ECON 3,A01,185549,Crane; Meredith Helen,30,0,70,40
1683736184626,ECON 4,A01,203354,Anderson; John Charles,0,5,10,10
1683736185650,ECON 100A,A01,185574,Staff,0,5,40,40
1683736186677,ECON 100B,A01,185576,Staff,0,12,50,50
1683736187700,ECON 100C,A01,185589,Newhouse; Herbert S,30,0,70,40
1683736188726,ECON 105,A00,185608,Vespa; Emanuel Ignacio,19,0,35,16
1683736189753,ECON 109,A01,185610,Shishkin; Denis,9,0,35,26
1683736190776,ECON 110A,A01,185612,Staff,8,0,40,32
1683736191802,ECON 120A,A01,185615,Staff,19,0,40,21
1683736192830,ECON 120C,A01,185617,Sun; Yixiao,0,21,70,70
1683736193887,ECON 144,A00,203346,Squires; Dale E,2,0,35,33
1683736194915,ECON 171,A01,203349,Newhouse; Herbert S,0,1,35,35
1683736195938,ECON 173A,A01,185621,Toda; Alexis Akira,21,0,35,14
1683736196969,EDS 25,A01,202413,Staff,0,1,0,0
1683736196969,EDS 25,A02,202414,Staff,0,1,0,0
1683736196969,EDS 25,A03,202415,Staff,0,0,0,0
1683736196969,EDS 25,A04,202416,Staff,0,1,0,0
1683736196969,EDS 25,A05,202439,Staff,0,0,0,0
1683736196969,EDS 25,A06,202440,Staff,0,0,0,0
1683736196969,EDS 25,B01,202631,Staff,0,0,0,0
1683736196969,EDS 25,B02,202632,Staff,0,0,0,0
1683736196969,EDS 25,B03,202639,Staff,0,0,0,0
1683736196969,EDS 25,B04,202640,Staff,0,0,0,0
1683736196969,EDS 25,B05,202643,Staff,0,0,0,0
1683736196969,EDS 25,B06,202644,Staff,0,0,0,0
1683736197995,EDS 38,A01,202659,Black; Alison Michelle,25,0,25,0
1683736199022,EDS 115,A00,202652,Staff,18,0,30,12
1683736200048,EDS 125,A00,202649,Staff,13,0,30,17
1683736201077,EDS 126,A01,203332,Staff,30,0,30,0
1683736202100,EDS 139,A00,202838,Staff,16,0,25,9
1683736203123,EDS 146,A01,202655,Staff,14,0,25,11
1683736204154,ENG 15,A00,185667,Staff,0,1,0,2
1683736204154,ENG 15,B00,185672,Staff,0,0,0,1
1683736204154,ENG 15,C00,185675,Staff,0,0,0,0
1683736204154,ENG 15,D00,185682,Staff,0,0,0,0
1683736204154,ENG 15,E00,185684,Staff,0,0,0,0
1683736205185,ETHN 103,A00,185710,Staff,0,8,35,35
1683736206212,ETHN 103A,A00,199228,Man; Simeon S,0,0,9,9
1683736207236,ETHN 109,A00,185711,Staff,15,0,35,20
1683736208262,ETHN 142,A00,185726,Staff,0,4,30,30
1683736209290,ETHN 163J,A00,199229,Man; Simeon S,5,0,8,3
1683736210316,ETHN 168,A00,185727,Staff,7,0,10,3
1683736211342,ETHN 182,A00,185728,Staff,0,0,35,35
1683736212365,ETHN 183,A00,185737,Staff,10,0,18,8
1683736213397,GLBH 111,A01,209361,Burgos; Jose L.,0,0,0,0
1683736215443,HIEU 104,A00,185792,Staff,14,0,20,6
1683736216470,HIEU 115,A00,185800,Staff,0,0,20,20
1683736217494,HIEU 128,A00,185801,Staff,0,9,20,20
1683736218521,HIEU 147,A00,185802,Staff,15,0,20,5
1683736219547,HIEU 154,A00,185823,Staff,11,0,20,9
1683736220579,HILA 102,A00,185826,Staff,14,0,20,6
1683736221614,HILD 2C,A01,185778,Staff,0,13,20,20
1683736222642,HILD 7B,A01,185780,Kwak; Nancy,0,17,32,32
1683736222642,HILD 7B,A02,185781,Kwak; Nancy,0,18,32,32
1683736223666,HILD 30,A01,185791,Staff,12,0,20,8
1683736224690,HISC 119,A00,185830,Golan; Tal,0,10,20,20
1683736225716,HITO 156GS,A00,185831,Patterson; Patrick H.,0,0,0,23
1683736226741,HIUS 103,A00,185832,Man; Simeon S,0,4,20,20
1683736227767,HIUS 117,A00,185836,Kwak; Nancy,2,0,20,18
1683736228795,HIUS 125,A00,185840,Man; Simeon S,0,2,23,23
1683736229822,HIUS 149,A00,185845,Staff,1,0,20,19
1683736230856,HUM 3,A01,185882,Zavodny; Tatiana Sophia,0,8,50,50
1683736230856,HUM 3,B01,185899,Caldwell; Michael Alan,0,18,50,50
1683736231883,HUM 3GS,A00,185900,Patterson; Patrick H.,0,0,0,23
1683736232913,HUM 4,A01,185938,Zroka; Amy Liane,28,0,50,22
1683736232913,HUM 4,B01,185956,Watkins; Eric,0,6,50,50
1683736232913,HUM 4,B02,202209,Watkins; Eric,0,6,50,50
1683736232913,HUM 4,B03,202210,Watkins; Eric,0,5,50,50
1683736233937,HUM 5,A01,185958,West; Geoffrey Scott,0,1,50,50
1683736233937,HUM 5,A02,202215,West; Geoffrey Scott,0,1,50,50
1683736234964,INTL 190,A00,185959,Gagnon; Jeffrey C,0,0,0,9
1683736234964,INTL 190,B00,185960,Lettieri; Michael Joseph,0,0,0,2
1683736235987,JAPN 180,A00,254509,Staff,4,0,30,26
1683736237012,LATI 10,A01,202853,Kennemore; Amy Michelle,0,0,31,31
1683736237012,LATI 10,A02,202854,Kennemore; Amy Michelle,0,0,32,32
1683736237012,LATI 10,A03,270054,Kennemore; Amy Michelle,30,0,30,0
1683736238036,LATI 180,A00,202855,Kennemore; Amy Michelle,11,0,20,9
1683736239060,LAWS 101,A00,201767,Golan; Tal,0,7,40,40
1683736240084,LIFR 1C,A00,185961,Staff,6,0,20,14
1683736241108,LIFR 1CX,A00,185962,Staff,7,0,20,13
1683736242134,LIFR 1D,A00,185963,Staff,7,0,20,13
1683736243158,LIFR 1DX,A00,185964,Staff,7,0,20,13
1683736244182,LIGN 101,A01,186039,Staff,43,0,50,7
1683736245205,LIGN 165,A00,186040,Staff,14,0,50,36
1683736246228,LTCS 108,A00,186041,Staff,5,0,10,5
1683736247252,LTCS 119,A00,186042,Staff,15,0,20,5
1683736248279,LTCS 130,A00,186043,Wesling; Megan E.,15,0,25,10
1683736250329,LTEA 138,A00,186119,Staff,13,0,40,27
1683736251356,LTEN 124,A00,186148,Staff,5,0,25,20
1683736252381,LTEN 178,A00,186149,Staff,6,0,15,9
1683736253404,LTEN 181,A00,186150,Blanco; John D,34,0,40,6
1683736254429,LTWL 120,A00,186160,Staff,19,0,25,6
1683736255456,LTWL 165,A00,186161,Staff,22,0,25,3
1683736256485,LTWR 100,A00,186162,Staff,0,5,15,15
1683736257511,LTWR 102,A00,186163,Doller; Ben,5,0,15,10
1683736258536,MAE 8,A01,186412,Staff,0,1,0,1
1683736259563,MAE 30B,A00,186445,Bahadori; Mohammad Yousef,81,0,100,19
1683736260642,MAE 40,A00,186592,Bewley; Thomas R,10,0,50,40
1683736261666,MAE 101B,A00,186593,Bahadori; Mohammad Yousef,79,0,100,21
1683736262691,MAE 105,A00,186594,Bandaru; Prabhakar,10,0,50,40
1683736263714,MAE 107,A00,186599,Pham; Hieu Tan,0,8,120,120
1683736264738,MAE 148,A01,186660,Silberman; Jack,3,0,16,13
1683736265766,MATH 10A,A01,188095,Staff,0,6,35,35
1683736266794,MATH 10B,A01,188097,Bowers; Adam R.,0,12,30,30
1683736266794,MATH 10B,A02,188099,Bowers; Adam R.,0,11,30,30
1683736266794,MATH 10B,B01,188104,Bowers; Adam R.,0,10,30,30
1683736266794,MATH 10B,B02,188106,Bowers; Adam R.,0,9,30,30
1683736267823,MATH 10C,A01,188111,Staff,0,20,30,30
1683736267823,MATH 10C,A02,188127,Staff,0,19,30,30
1683736267823,MATH 10C,A03,188131,Staff,0,19,30,30
1683736267823,MATH 10C,B01,188218,Staff,17,0,30,13
1683736267823,MATH 10C,B02,188244,Staff,13,0,30,17
1683736267823,MATH 10C,B03,188277,Staff,14,0,30,16
1683736268848,MATH 18,A01,188344,Bach; Quang Tran,18,0,30,12
1683736268848,MATH 18,A02,188345,Bach; Quang Tran,11,0,30,19
1683736268848,MATH 18,B01,188353,Bach; Quang Tran,11,0,30,19
1683736268848,MATH 18,B02,188354,Bach; Quang Tran,19,0,30,11
1683736269872,MATH 20A,A01,188374,Staff,10,0,35,25
1683736270902,MATH 20B,A01,188382,Ohm; Ko Woon,7,0,30,23
1683736270902,MATH 20B,A02,188383,Ohm; Ko Woon,22,0,30,8
1683736270902,MATH 20B,B01,188385,Ohm; Ko Woon,7,0,30,23
1683736270902,MATH 20B,B02,188392,Ohm; Ko Woon,22,0,30,8
1683736271926,MATH 20C,A01,188394,Harel; Guershon,10,0,30,20
1683736271926,MATH 20C,A02,188395,Harel; Guershon,13,0,30,17
1683736271926,MATH 20C,B01,188404,Harel; Guershon,5,0,30,25
1683736271926,MATH 20C,B02,188405,Harel; Guershon,18,0,30,12
1683736272954,MATH 20D,A01,188414,Hammock; Frances H,0,1,30,30
1683736272954,MATH 20D,A02,188415,Hammock; Frances H,0,1,30,30
1683736272954,MATH 20D,B01,188447,Hammock; Frances H,0,1,30,30
1683736272954,MATH 20D,B02,188486,Hammock; Frances H,2,0,30,28
1683736273981,MATH 20E,A01,188649,Staff,21,0,30,9
1683736273981,MATH 20E,A02,188650,Staff,20,0,30,10
1683736273981,MATH 20E,A03,188673,Staff,0,0,30,30
1683736275007,MATH 102,A01,188675,Staff,0,40,35,35
1683736276037,MATH 103B,A01,188681,Staff,3,0,35,32
1683736276037,MATH 103B,B01,188692,Staff,5,0,35,30
1683736277062,MATH 109,A01,188695,Salehi Golsefidy; Alireza,24,0,35,11
1683736277062,MATH 109,A02,188696,Salehi Golsefidy; Alireza,24,0,35,11
1683736278085,MATH 120A,A01,188698,Eggers; John Dietrich,7,0,35,28
1683736279110,MATH 142B,A01,188736,Ioana; Adrian,0,0,30,30
1683736279110,MATH 142B,A02,188741,Ioana; Adrian,0,1,30,30
1683736279110,MATH 142B,A03,188743,Ioana; Adrian,0,3,30,30
1683736280137,MATH 168A,A01,188790,Staff,0,11,35,35
1683736281161,MATH 170A,A01,188803,Nie; Jiawang,0,2,35,35
1683736281161,MATH 170A,A02,188811,Nie; Jiawang,0,1,35,35
1683736281161,MATH 170A,A03,188814,Nie; Jiawang,1,0,35,34
1683736281161,MATH 170A,A04,188815,Nie; Jiawang,4,0,35,31
1683736282184,MATH 193B,A01,188817,Staff,0,0,35,35
1683736282184,MATH 193B,A02,188818,Staff,6,0,35,29
1683736283208,MGT 4,A01,202857,Anderson; John Charles,59,0,80,21
1683736284232,MGT 12,A00,202858,Lindenberger; Wade Douglas,40,0,90,50
1683736285255,MGT 18,A00,202859,Staff,73,0,90,17
1683736286281,MGT 18GS,A00,202860,McKay; Michael J,13,0,28,15
1683736287305,MGT 45,A00,202861,Pecore; Joseph P.,8,0,90,82
1683736288327,MGT 100,A00,202863,Yavorsky; Daniel Ryan,27,0,90,63
1683736289351,MGT 103,A00,202864,Ehrich; Kristine R,0,19,90,90
1683736290374,MGT 112,A00,202865,Ehrich; Kristine R,15,0,90,75
1683736291400,MGT 121A,A00,202868,Staff,70,0,90,20
1683736292424,MGT 131B,A00,202869,Anderson; John Charles,58,0,90,32
1683736293448,MGT 136,A00,202871,Lindenberger; Wade Douglas,83,0,90,7
1683736294481,MGT 164,A00,202873,Staff,0,67,90,91
1683736295507,MGT 164GS,A00,202874,McKay; Mary A,13,0,28,15
1683736296534,MGT 180,A00,202875,Staff,0,51,90,91
1683736297557,MMW 11R,A01,205019,Herbst; Matthew,0,0,30,30
1683736297557,MMW 11R,A02,205026,Herbst; Matthew,29,0,30,1
1683736298581,MMW 15,A01,193512,Chang; Edmond Yi-Teh,0,8,28,28
1683736298581,MMW 15,A02,193513,Chang; Edmond Yi-Teh,0,5,28,28
1683736298581,MMW 15,A03,193514,Chang; Edmond Yi-Teh,0,5,28,28
1683736298581,MMW 15,A04,193515,Chang; Edmond Yi-Teh,0,5,28,28
1683736298581,MMW 15,A05,193516,Chang; Edmond Yi-Teh,0,5,28,28
1683736298581,MMW 15,A06,193517,Chang; Edmond Yi-Teh,0,6,28,28
1683736298581,MMW 15,B01,193519,Chang; Edmond Yi-Teh,0,5,28,28
1683736298581,MMW 15,B02,193520,Chang; Edmond Yi-Teh,0,5,28,28
1683736298581,MMW 15,B03,193521,Chang; Edmond Yi-Teh,0,5,28,28
1683736298581,MMW 15,B04,193522,Chang; Edmond Yi-Teh,0,6,28,28
1683736298581,MMW 15,B05,193523,Chang; Edmond Yi-Teh,0,5,28,28
1683736298581,MMW 15,B06,193524,Chang; Edmond Yi-Teh,0,5,28,28
1683736299609,MMW 122,A01,193526,Rahimi; Babak,0,16,28,28
1683736299609,MMW 122,A02,193527,Rahimi; Babak,0,15,28,28
1683736299609,MMW 122,A03,193528,Rahimi; Babak,0,0,0,0
1683736299609,MMW 122,A04,193529,Rahimi; Babak,0,0,0,0
1683736300637,MUS 1A,A01,186663,Staff,0,18,35,35
1683736301660,MUS 4,A01,186715,Staff,0,12,35,35
1683736302687,MUS 5R,A01,186796,Dubnov; Shlomo,0,17,35,35
1683736303712,MUS 6,A01,186798,Staff,0,4,25,25
1683736304735,MUS 7,A01,186830,Staff,11,0,35,24
1683736305758,MUS 8,A01,186930,Staff,0,27,35,35
1683736306785,MUS 15,A01,186932,Staff,0,15,35,35
1683736306785,MUS 15,B01,186934,Staff,0,16,35,35
1683736307812,MUS 80,A00,186935,Staff,0,0,20,20
1683736307812,MUS 80,B00,186936,Staff,24,0,25,1
1683736308837,NANO 11,A00,204702,Lipomi; Darren John,0,0,0,0
1683736309860,NANO 15,A01,204709,Yang; Kesong,0,1,0,0
1683736310889,NANO 114,A00,202069,Jahed Motlagh; Zeinab,2,0,10,8
1683736311913,PHIL 1,A00,186955,Grush; Rick Scott,31,0,40,9
1683736312938,PHIL 10,A01,186973,Grush; Rick Scott,27,0,35,8
1683736312938,PHIL 10,A02,186974,Grush; Rick Scott,33,0,35,2
1683736313965,PHIL 13,A01,186976,Staff,1,0,35,34
1683736313965,PHIL 13,A02,186977,Staff,16,0,35,19
1683736314988,PHIL 14,A01,186979,Staff,30,0,35,5
1683736314988,PHIL 14,A02,186986,Staff,32,0,35,3
1683736316016,PHIL 28,A01,186988,Staff,16,0,30,14
1683736316016,PHIL 28,A02,186989,Staff,0,0,30,30
1683736316016,PHIL 28,A03,186990,Staff,10,0,30,20
1683736316016,PHIL 28,A04,186991,Staff,26,0,30,4
1683736317040,PHIL 120,A00,186997,Staff,23,0,40,17
1683736318064,PHIL 137,A00,187003,Staff,8,0,40,32
1683736319088,PHIL 150,A00,187015,Staff,47,0,70,23
1683736320114,PHIL 167,A00,187021,Lamey; Andy M.,34,0,40,6
1683736321139,PHIL 174,A01,202226,Staff,17,0,20,3
1683736321139,PHIL 174,A02,202235,Staff,20,0,20,0
1683736322172,PHIL 191A,A00,258918,Staff,0,0,1,1
1683736323199,PHYS 1A,A00,187028,Staff,26,0,60,34
1683736324228,PHYS 1AL,001,187036,Staff,3,0,30,27
1683736324228,PHYS 1AL,002,187049,Staff,18,0,30,12
1683736325251,PHYS 1B,A00,187058,Staff,21,0,60,39
1683736326278,PHYS 1BL,001,187064,Staff,0,1,30,30
1683736326278,PHYS 1BL,002,187070,Staff,4,0,30,26
1683736327301,PHYS 1C,A00,187082,Staff,30,0,120,90
1683736328332,PHYS 1CL,001,187088,Staff,0,9,30,30
1683736328332,PHYS 1CL,002,187089,Staff,0,1,30,30
1683736328332,PHYS 1CL,009,262693,Staff,9,0,30,21
1683736329355,PHYS 2B,A01,187097,Staff,55,0,115,60
1683736330379,PHYS 2C,A01,187099,Staff,63,0,115,52
1683736331407,PHYS 2CL,A01,187101,Staff,5,0,28,23
1683736331407,PHYS 2CL,A02,187102,Staff,15,0,28,13
1683736332431,PHYS 2D,A01,187123,Shotwell; Brian,95,0,115,20
1683736333456,PHYS 4B,A01,187133,Grinstein; Benjamin,34,0,50,16
1683736334479,POLI 10,A00,188819,Staff,0,4,50,50
1683736335503,POLI 11,A00,188827,Staff,43,0,50,7
1683736336529,POLI 13R,A00,188828,Staff,0,2,20,20
1683736337556,POLI 27,A01,188830,Elgin; Samuel Zincke,0,2,70,70
1683736338580,POLI 30,A00,188832,Desposato; Scott,30,0,50,20
1683736339607,POLI 102F,A00,188834,Staff,1,0,40,39
1683736340631,POLI 104A,A00,188852,Staff,12,0,30,18
1683736341655,POLI 104I,A00,188853,Staff,0,8,20,20
1683736342680,POLI 110B,A00,188854,Wiens; David,6,0,20,14
1683736343706,POLI 112A,A00,188855,Wiens; David,4,0,30,26
1683736344730,POLI 117R,A00,188856,Forman; Fonna,0,12,20,20
1683736345757,POLI 118,A00,188857,Ingham; Sean,8,0,20,12
1683736346781,POLI 120G,A00,188858,Staff,7,0,30,23
1683736347810,POLI 131CR,A00,188863,Hoston; Germaine,20,0,50,30
1683736348836,POLI 133,A00,188864,Nellis; Gareth Hb,44,0,50,6
1683736349862,POLI 134D,A00,188865,Desposato; Scott,27,0,30,3
1683736350887,POLI 142A,A00,188871,Gartzke; Erik,21,0,50,29
1683736351911,POLI 142K,A00,188874,Staff,38,0,50,12
1683736352937,POLI 143,A00,188940,Gartzke; Erik,15,0,30,15
1683736353962,POLI 153,A00,188943,Staff,1,0,20,19
1683736354991,POLI 160AA,A00,188944,Staff,10,0,40,30
1683736356019,POLI 170A,A00,188945,Staff,10,0,30,20
1683736358069,PSYC 1,A00,188952,Staff,36,0,90,54
1683736359092,PSYC 2,B00,188953,Staff,19,0,35,16
1683736360118,PSYC 6,A00,188970,Staff,47,0,60,13
1683736361143,PSYC 7,A00,188973,Staff,35,0,45,10
1683736362170,PSYC 60,A01,188980,Rickard; Timothy C.,42,0,60,18
1683736363197,PSYC 70,A01,189001,Steiner; Eric Tomas,21,0,45,24
1683736364294,PSYC 100,A00,189005,Lacefield; Katharine I,1,98,120,119
1683736365316,PSYC 102,A00,189008,Staff,6,0,30,24
1683736366340,PSYC 106,B00,189026,Gorman; Michael R.,26,0,60,34
1683736367363,PSYC 114,B01,189033,Winkielman; Piotr,0,31,30,30
1683736368387,PSYC 131,A00,189036,Anagnostaras; Stephan,0,44,60,60
1683736369413,PSYC 136,A00,189041,Lowe; Angela Beth,0,7,25,25
1683736370434,PSYC 137,A00,189057,Winkielman; Piotr,0,36,25,25
1683736371461,PSYC 144,A00,189107,Wixted; John T,0,11,50,50
1683736373508,PSYC 162,A00,189142,Staff,0,9,85,85
1683736374535,PSYC 172,A00,189144,Gorman; Michael R.,0,6,30,30
1683736376586,PSYC 179,A00,189146,Lacefield; Katharine I,0,88,120,120
1683736377611,PSYC 181,A00,189147,Anagnostaras; Stephan,110,45,200,90
1683736378647,PSYC 190R,A00,189148,Barner; David A.,0,23,80,80
1683736379672,PSYC 191,A00,189275,Rickard; Timothy C.,0,11,25,25
1683736380697,PSYC 193,A00,189276,Chapman; Eddie Nathaniel,0,1,0,4
1683736381726,PSYC 193L,A01,189281,Lowe; Angela Beth,8,0,20,12
1683736381726,PSYC 193L,B01,189285,Staff,28,0,35,7
1683736382759,RELI 149,A00,187137,Rahimi; Babak,6,0,40,34
1683736383782,SE 9,A01,187315,Staff,0,2,18,18
1683736384806,SE 101B,A00,187409,Staff,24,0,30,6
1683736385830,SE 110B,A00,187444,Staff,10,0,40,30
1683736386858,SE 130B,A00,187449,Staff,31,0,40,9
1683736387882,SE 150A,A00,187516,Staff,8,0,20,12
1683736388906,SE 154,A00,187528,Staff,29,0,50,21
1683736389929,SIO 3,A01,258171,Staff,35,0,40,5
1683736390953,SIO 10,A00,187144,Cook; Geoffrey W,0,6,75,75
1683736391983,SIO 45,A00,187152,Cook; Geoffrey W,1,7,100,99
1683736393007,SIO 109R,A00,194486,Staff,0,4,20,20
1683736395065,SIO 187,A01,187233,Kacev; David,12,0,40,28
1683736396089,SOCI 1,A01,258656,Thorpe; Charles Robert,28,0,30,2
1683736396089,SOCI 1,A02,258658,Thorpe; Charles Robert,30,0,30,0
1683736396089,SOCI 1,A03,258661,Thorpe; Charles Robert,25,0,25,0
1683736396089,SOCI 1,A04,258666,Thorpe; Charles Robert,22,0,25,3
1683736396089,SOCI 1,A05,258897,Thorpe; Charles Robert,22,0,25,3
1683736396089,SOCI 1,A06,258898,Thorpe; Charles Robert,25,0,25,0
1683736397116,SOCI 30,A01,258903,Pardo Guerra; Juan Pablo,14,0,30,16
1683736398140,SOCI 102,A00,258904,Staff,9,0,25,16
1683736399166,SOCI 106,A00,258905,Staff,19,0,25,6
1683736400191,SOCI 111,A00,258907,Ribas Norris; Janet Vanesa,26,0,30,4
1683736401219,SOCI 121R,A00,258908,Pardo Guerra; Juan Pablo,7,0,30,23
1683736402254,SOCI 126,A01,203330,Staff,14,0,20,6
1683736403284,SOCI 131,A00,258909,Thorpe; Charles Robert,30,0,60,30
1683736404312,SOCI 135,A00,258910,Payne; Christine Anna,0,13,30,30
1683736405339,SOCI 157,A00,258911,Staff,10,0,30,20
1683736406366,SOCI 184,A00,258912,Staff,25,0,30,5
1683736407393,SOCI 188D,A00,258913,Staff,22,0,30,8
1683736408417,SYN 2,001,187529,Staff,9,0,16,7
1683736408417,SYN 2,002,201452,Staff,0,20,16,16
1683736408417,SYN 2,003,201469,Staff,1,0,16,15
1683736409443,SYN 100,A01,187531,Staff,0,9,20,20
1683736409443,SYN 100,B01,201491,Staff,0,10,20,20
1683736410467,TDAC 1,A00,189286,Walsh; Kim C.,3,0,20,17
1683736410467,TDAC 1,B00,189287,Harting; Carla Kelso,10,0,20,10
1683736411493,TDAC 101,A00,189300,Walsh; Kim C.,16,0,20,4
1683736411493,TDAC 101,B00,189301,Harting; Carla Kelso,18,0,20,2
1683736412517,TDAC 102,A00,189304,Basso; Beatrice,14,0,20,6
1683736413544,TDAC 108,A00,189305,Staff,18,0,20,2
1683736414574,TDDE 131,A00,189310,Staff,19,0,20,1
1683736414574,TDDE 131,B00,189314,Staff,19,0,20,1
1683736414574,TDDE 131,C00,189315,Staff,48,0,50,2
1683736414574,TDDE 131,D00,189316,Staff,14,0,15,1
1683736414574,TDDE 131,E00,204841,Staff,20,0,20,0
1683736415598,TDGE 10,A00,189289,Staff,26,0,50,24
1683736415598,TDGE 10,B00,189290,Havis; Allan,0,1,50,50
1683736416623,TDGE 11,A00,189291,Fulton; Julia,0,4,50,50
1683736416623,TDGE 11,B00,189292,Staff,20,0,25,5
1683736416623,TDGE 11,C00,260270,Staff,0,0,0,0
1683736417649,TDGE 25,A00,189294,Staff,1,0,20,19
1683736418674,TDGE 124,A00,189318,Fulton; Julia,0,7,50,50
1683736419698,TDGE 125,A00,189319,Staff,13,0,25,12
1683736419698,TDGE 125,B00,189320,Staff,23,0,25,2
1683736420725,TDGE 127,A00,189322,Havis; Allan,1,0,50,49
1683736421749,TDHT 101,A00,189323,Staff,18,0,25,7
1683736421749,TDHT 101,B00,189324,Staff,25,0,25,0
1683736422777,TDHT 102,A00,189325,Staff,49,0,50,1
1683736423803,TDMV 1,A00,189295,Arcidiacono; Kristin,20,0,30,10
1683736423803,TDMV 1,B00,189296,Caligagan; Maria T.,23,0,30,7
1683736424829,TDMV 2,A00,189297,Sammartano; Tonnie,27,0,30,3
1683736424829,TDMV 2,B00,189299,Arcidiacono; Kristin,23,0,30,7
1683736425853,TDMV 3,A00,204998,Rincon; Alicia,22,0,30,8
1683736426878,TDMV 120,A00,189458,Sammartano; Tonnie,28,0,30,2
1683736427902,TDMV 138,A00,189541,Jun; Grace Shin Hae,20,0,40,20
1683736428930,TDMV 142,A00,189717,Caligagan; Tony,25,0,30,5
1683736428930,TDMV 142,B00,189718,Caligagan; Maria T.,25,0,30,5
1683736429954,TMC 2,A01,187533,Staff,25,0,25,0
1683736429954,TMC 2,A02,187534,Staff,25,0,25,0
1683736430978,USP 1,A01,187536,Kwak; Nancy,0,16,25,25
1683736432002,USP 5,A01,187538,Staff,8,0,25,17
1683736433029,USP 101,A00,199253,Staff,0,4,0,0
1683736434059,USP 124,A00,187562,Boomhower; Matthew Charles,0,0,30,30
1683736435082,USP 138,A00,187582,Staff,19,0,25,6
1683736436107,USP 152,A01,187597,Staff,3,0,25,22
1683736437133,USP 153,A00,187598,Staff,18,0,25,7
1683736438156,USP 168,A00,187607,Kwak; Nancy,2,0,5,3
1683736439182,USP 173,A00,187619,Staff,4,0,25,21
1683736440206,USP 181,A00,187638,Staff,0,4,25,25
1683736441240,VIS 103,A00,187650,Cruz; Edwin Teddy,17,0,75,58
1683736442264,VIS 110D,A00,187669,Staff,13,0,22,9
1683736443292,VIS 127C,A00,187720,Shen; Kuiyi,67,0,146,79
1683736444318,VIS 149,A00,187731,Yoldas; Pinar,0,12,22,22
1683736445345,VIS 151,A01,188091,Staff,22,0,34,12
1683736445345,VIS 151,A02,188092,Staff,11,0,34,23
1683736446369,VIS 160B,A00,188093,Stalbaum; Brett,0,1,10,10
1683736448422,WCWP 10B,A00,201720,Staff,0,0,5,5
1683736448422,WCWP 10B,B00,201722,Staff,0,0,6,6
1683736449446,WCWP 100,A00,201725,Gagnon; Jeffrey C,0,0,2,2
1683736449446,WCWP 100,B00,201727,Staff,0,4,15,15
1683736452549,ANBI 133,A00,258401,Wilder; Linnea Lorene,34,0,40,6
1683736453585,ANBI 140,A00,258395,Hrvoj Mihic; Branka,18,0,25,7
1683736454608,ANSC 120,A00,258402,Bialecki; Jon Anthony,26,0,40,14
1683736455637,ANSC 144,A00,258400,Staff,12,0,40,28
1683736457684,ANSC 166,A00,258396,Parish; Steven Martin,156,0,175,19
1683736458708,ANSC 180,A00,193533,Staff,8,0,20,12
1683736459737,ANSC 188,A00,258397,Jassal; Aftab,34,0,40,6
1683736460760,ANTH 3,A01,258316,Staff,23,0,30,7
1683736461788,ANTH 5,A00,258394,Semendeferi; Ekaterini,16,0,20,4
1683736462819,ANTH 21,A01,258331,Staff,4,0,40,36
1683736463844,ANTH 103,A00,258398,Varma; Saiba,15,0,25,10
1683736464870,AWP 10,001,202034,Staff,0,0,0,0
1683736464870,AWP 10,002,202035,Staff,0,0,0,0
1683736464870,AWP 10,003,202036,Staff,0,0,0,0
1683736464870,AWP 10,004,202037,Staff,0,0,0,0
1683736464870,AWP 10,005,202038,Staff,0,0,0,0
1683736464870,AWP 10,006,202039,Staff,0,0,0,0
1683736464870,AWP 10,007,202040,Staff,0,0,0,0
1683736464870,AWP 10,008,202041,Staff,0,0,0,0
1683736464870,AWP 10,009,202042,Staff,0,0,0,0
1683736464870,AWP 10,010,202043,Staff,0,0,0,0
1683736464870,AWP 10,011,202044,Staff,0,0,0,0
1683736464870,AWP 10,012,202045,Staff,0,0,0,0
1683736464870,AWP 10,013,202046,Staff,0,0,0,0
1683736464870,AWP 10,014,202047,Staff,0,0,0,0
1683736464870,AWP 10,015,202048,Staff,0,0,0,0
1683736464870,AWP 10,016,202049,Staff,0,0,0,0
1683736464870,AWP 10,017,202050,Staff,0,0,0,0
1683736464870,AWP 10,018,202051,Staff,0,0,0,0
1683736464870,AWP 10,019,202052,Staff,0,0,0,0
1683736464870,AWP 10,020,202053,Staff,0,0,0,0
1683736464870,AWP 10,021,202054,Staff,0,0,0,0
1683736464870,AWP 10,022,202055,Staff,0,0,0,0
1683736464870,AWP 10,023,202056,Staff,0,0,0,0
1683736464870,AWP 10,024,202057,Staff,0,0,0,0
1683736464870,AWP 10,025,202058,Staff,0,0,0,0
1683736464870,AWP 10,026,202059,Staff,0,0,0,0
1683736465898,AWP 102,001,202032,Staff,0,0,0,0
1683736465898,AWP 102,002,202033,Staff,0,0,0,0
1683736466925,BENG 100,A01,254234,Taylor Amos; Alyssa C,31,0,40,9
1683736468007,BENG 196,001,270013,Engler; Adam J.,9999,0,9999,0
1683736469036,BICD 100R,A01,202018,Smith; Laurie,0,7,32,32
1683736469036,BICD 100R,A02,202019,Smith; Laurie,0,3,32,32
1683736469036,BICD 100R,A03,202020,Smith; Laurie,0,1,32,32
1683736469036,BICD 100R,A04,202021,Smith; Laurie,6,0,32,26
1683736469036,BICD 100R,A05,202022,Smith; Laurie,10,0,32,22
1683736470064,BICD 136,A01,193242,Gustafson-Brown; Cindy,0,2,32,32
1683736470064,BICD 136,A02,193244,Gustafson-Brown; Cindy,13,0,32,19
1683736471088,BIEB 102,A01,193249,Butler; Shannon Rhey,0,0,32,32
1683736471088,BIEB 102,A02,193251,Butler; Shannon Rhey,0,0,32,32
1683736471088,BIEB 102,A03,193253,Butler; Shannon Rhey,0,0,32,32
1683736471088,BIEB 102,A04,193255,Butler; Shannon Rhey,13,0,32,19
1683736471088,BIEB 102,A05,193265,Butler; Shannon Rhey,25,0,32,7
1683736471088,BIEB 102,A06,193269,Butler; Shannon Rhey,12,0,32,20
1683736473139,BIEB 150,A01,193274,Staff,0,0,32,32
1683736473139,BIEB 150,A02,193285,Staff,24,0,32,8
1683736474167,BIEB 194,A00,193286,Kurle; Carolyn M.,19,0,32,13
1683736475197,BILD 1,A01,192291,Staff,15,0,32,17
1683736475197,BILD 1,A02,192292,Staff,30,0,32,2
1683736475197,BILD 1,B01,192520,Reuther; Keefe,0,1,0,0
1683736475197,BILD 1,B02,192532,Reuther; Keefe,0,1,0,0
1683736476220,BILD 3,A01,192556,Butler; Shannon Rhey,0,0,32,32
1683736476220,BILD 3,A02,192581,Butler; Shannon Rhey,0,1,32,32
1683736476220,BILD 3,A03,192611,Butler; Shannon Rhey,19,0,32,13
1683736476220,BILD 3,A04,192612,Butler; Shannon Rhey,23,0,32,9
1683736476220,BILD 3,A05,192613,Butler; Shannon Rhey,26,0,32,6
1683736476220,BILD 3,A06,192679,Butler; Shannon Rhey,27,0,32,5
1683736476220,BILD 3,A07,192682,Butler; Shannon Rhey,20,0,32,12
1683736477248,BILD 4,A01,192836,Reuther; Keefe,1,0,24,23
1683736477248,BILD 4,A02,193044,Reuther; Keefe,4,0,24,20
1683736478275,BILD 10,A01,193142,Gustafson-Brown; Cindy,29,0,32,3
1683736478275,BILD 10,A02,193149,Gustafson-Brown; Cindy,31,0,32,1
1683736479299,BIMM 100,A01,193301,Staff,0,6,32,32
1683736479299,BIMM 100,A02,193312,Staff,0,7,32,32
1683736479299,BIMM 100,A03,193323,Staff,0,10,32,32
1683736480322,BIMM 101,A01,193329,McDonnell; Lisa Marie,0,3,24,24
1683736480322,BIMM 101,A02,193339,McDonnell; Lisa Marie,0,3,24,24
1683736480322,BIMM 101,B01,193354,McDonnell; Lisa Marie,0,4,24,24
1683736480322,BIMM 101,B02,193357,McDonnell; Lisa Marie,0,3,24,24
1683736481351,BIMM 110,A01,193377,Tat; John,0,11,32,32
1683736481351,BIMM 110,A02,193378,Tat; John,0,11,32,32
1683736482378,BIMM 120,A01,206116,Staff,1,0,32,31
1683736482378,BIMM 120,A02,206117,Staff,7,0,32,25
1683736482378,BIMM 120,A03,206121,Staff,21,0,32,11
1683736483403,BIPN 100,A01,193393,Park; Ji Young,0,15,32,32
1683736483403,BIPN 100,A02,193402,Park; Ji Young,0,14,32,32
1683736483403,BIPN 100,A03,193413,Park; Ji Young,0,14,32,32
1683736483403,BIPN 100,A04,193414,Park; Ji Young,0,13,32,32
1683736484426,BIPN 102,A01,193429,Staff,0,0,32,32
1683736484426,BIPN 102,A02,193438,Staff,18,0,32,14
1683736485454,BIPN 106,A01,193450,Reyes Gonzalez; Catalina,0,2,40,40
1683736486480,BIPN 134,A01,193465,Cooke; James Edward,0,0,32,32
1683736486480,BIPN 134,A02,193474,Cooke; James Edward,24,0,32,8
1683736486480,BIPN 134,A03,193485,Cooke; James Edward,29,0,32,3
1683736486480,BIPN 134,A04,193486,Cooke; James Edward,20,0,32,12
1683736486480,BIPN 134,A05,193491,Cooke; James Edward,31,0,32,1
1683736486480,BIPN 134,A06,193501,Cooke; James Edward,30,0,32,2
1683736486480,BIPN 134,A07,193510,Cooke; James Edward,29,0,32,3
1683736488529,BISP 194,A00,222522,Staff,14,0,32,18
1683736489553,CAT 124,A01,202407,Staff,19,0,25,6
1683736490577,CAT 125,A00,202408,Marchisotto; Jennifer Anne,2,0,20,18
1683736491603,CAT 125R,A00,202409,Smith; Lauryn Alissa,0,11,20,20
1683736491603,CAT 125R,B00,202410,Morales; Celeste Georgianna,0,11,20,20
1683736491603,CAT 125R,C00,202411,Irwin; Matthew Joseph,0,12,20,20
1683736492630,CENG 15,A01,204712,Yang; Kesong,0,1,0,0
1683736493654,CENG 114,A00,202070,Jahed Motlagh; Zeinab,5,0,20,15
1683736494678,CGS 105,A00,185477,Wesling; Megan E.,24,0,40,16
1683736495703,CGS 106,A00,185494,Staff,11,0,22,11
1683736496728,CGS 108,A00,185495,Staff,14,0,20,6
1683736497754,CGS 114,A00,185496,Staff,13,0,18,5
1683736498778,CGS 119,A00,185501,Staff,15,0,20,5
1683736499805,CGS 120,A00,185511,Staff,11,0,20,9
1683736500827,CHEM 4,A01,184675,Bussey; Thomas J,97,0,100,3
1683736501851,CHEM 6A,A01,184677,Staff,32,0,60,28
1683736502878,CHEM 6B,A01,184679,Staff,63,0,100,37
1683736503910,CHEM 6C,A01,184681,Bussey; Thomas J,0,0,50,50
1683736503910,CHEM 6C,A02,184682,Bussey; Thomas J,32,0,50,18
1683736504938,CHEM 40A,A01,184684,Albizati; Kim F.,33,0,100,67
1683736505962,CHEM 40B,A01,184686,Albizati; Kim F.,0,22,100,100
1683736506986,CHEM 41B,A01,184690,Staff,51,0,100,49
1683736508008,COGS 3,A01,184715,Boyle; Mary E. T.,0,27,40,40
1683736509032,COGS 14B,A01,185172,Staff,0,14,38,38
1683736510057,COGS 18,A01,184736,Staff,14,0,80,66
1683736511081,COGS 100,A01,184932,Staff,0,8,73,73
1683736512116,COGS 101A,A01,184935,Staff,0,40,30,30
1683736513143,COGS 101B,A01,184944,Staff,0,2,30,30
1683736514177,COGS 101C,A01,184946,Staff,0,10,30,30
1683736515216,COGS 102A,A01,184951,Johnson; Christine M.,1,0,40,39
1683736516239,COGS 107B,A01,184953,Mooshagian; Eric Frederick,0,52,40,40
1683736517268,COGS 118B,A01,184959,Gupta; Anjum,0,50,40,40
1683736518292,COGS 153,A00,184961,Staff,1,16,30,29
1683736519316,COGS 177,A00,184962,Staff,0,20,30,30
1683736520343,COGS 187A,A01,184969,Boyle; Mary E. T.,0,19,40,40
1683736521367,COMM 10,A01,185174,Staff,0,5,25,25
1683736521367,COMM 10,A02,185189,Staff,0,2,25,25
1683736521367,COMM 10,A03,269821,Staff,0,1,0,0
1683736522390,COMM 100B,A02,185476,Staff,10,0,25,15
1683736522390,COMM 100B,A03,277340,Staff,25,0,25,0
1683736523418,COMM 100C,A01,185314,Staff,2,0,25,23
1683736523418,COMM 100C,A02,185327,Staff,17,0,25,8
1683736524442,COMM 110M,A00,185349,Staff,0,0,40,40
1683736525466,COMM 113T,A00,185352,Staff,25,0,40,15
1683736526493,COMM 114I,A00,185353,Staff,31,0,40,9
1683736527517,COMM 131,A00,185354,Staff,17,0,30,13
1683736528541,CSE 8A,A50,185358,Cao; Yingjun,0,46,10,10
1683736529565,CSE 8B,A01,185362,Staff,0,48,50,50
1683736530592,CSE 11,A01,185416,Cao; Yingjun,0,91,10,10
1683736531616,CSE 20,A01,185445,Briones; Jor-el Thomas Caparas,3,0,25,22
1683736532639,CSE 21,A01,185447,Staff,9,0,50,41
1683736533663,CSE 101,A01,185451,Staff,0,13,50,50
1683736533663,CSE 101,B01,185453,Jones; Miles E,0,15,50,50
1683736535718,CSE 141,A01,185458,Eldon; John,16,0,100,84
1683736536746,CSE 141L,A01,185461,Eldon; John,8,0,100,92
1683736537773,CSE 142,A01,185463,Staff,34,0,60,26
1683736537773,CSE 142,B01,201355,Staff,0,7,60,60
1683736538796,CSE 142L,A01,185470,Staff,34,0,60,26
1683736538796,CSE 142L,B01,201417,Staff,0,6,60,60
1683736539823,CSE 190,A00,201433,Staff,32,0,49,17
1683736540861,DOC 1,A01,259136,Strom; Megan C.,7,0,15,8
1683736540861,DOC 1,A02,259137,Strom; Megan C.,15,0,15,0
1683736540861,DOC 1,A03,259138,Strom; Megan C.,14,0,15,1
1683736540861,DOC 1,A04,259139,Strom; Megan C.,13,0,15,2
1683736541889,DOC 100D,A00,259140,Pass; Natalye Joann,14,0,25,11
1683736542915,DSGN 1,A01,184749,Rill; Bryan,0,26,30,30
1683736543943,DSGN 100,A01,185168,Staff,0,2,25,25
1683736544967,ECE 5,A01,185626,Morris; Karcher William,0,12,0,0
1683736545994,ECE 101,A01,185628,Staff,14,0,70,56
1683736547023,ECE 107,A01,185635,Baghdadchi; Saharnaz,0,0,20,20
1683736547023,ECE 107,A02,185638,Baghdadchi; Saharnaz,1,0,20,19
1683736548049,ECE 148,A01,185647,Silberman; Jack,0,0,16,16
1683736549077,ECON 1,A01,185537,Crane; Meredith Helen,54,0,70,16
1683736550108,ECON 3,A01,185549,Crane; Meredith Helen,30,0,70,40
1683736551136,ECON 4,A01,203354,Anderson; John Charles,0,5,10,10
1683736552159,ECON 100A,A01,185574,Staff,0,5,40,40
1683736553183,ECON 100B,A01,185576,Staff,0,12,50,50
1683736554210,ECON 100C,A01,185589,Newhouse; Herbert S,30,0,70,40
1683736555239,ECON 105,A00,185608,Vespa; Emanuel Ignacio,19,0,35,16
1683736556263,ECON 109,A01,185610,Shishkin; Denis,9,0,35,26
1683736557291,ECON 110A,A01,185612,Staff,8,0,40,32
1683736558315,ECON 120A,A01,185615,Staff,19,0,40,21
1683736559342,ECON 120C,A01,185617,Sun; Yixiao,0,21,70,70
1683736560368,ECON 144,A00,203346,Squires; Dale E,2,0,35,33
1683736561393,ECON 171,A01,203349,Newhouse; Herbert S,0,1,35,35
1683736562419,ECON 173A,A01,185621,Toda; Alexis Akira,21,0,35,14
1683736563444,EDS 25,A01,202413,Staff,0,1,0,0
1683736563444,EDS 25,A02,202414,Staff,0,1,0,0
1683736563444,EDS 25,A03,202415,Staff,0,0,0,0
1683736563444,EDS 25,A04,202416,Staff,0,1,0,0
1683736563444,EDS 25,A05,202439,Staff,0,0,0,0
1683736563444,EDS 25,A06,202440,Staff,0,0,0,0
1683736563444,EDS 25,B01,202631,Staff,0,0,0,0
1683736563444,EDS 25,B02,202632,Staff,0,0,0,0
1683736563444,EDS 25,B03,202639,Staff,0,0,0,0
1683736563444,EDS 25,B04,202640,Staff,0,0,0,0
1683736563444,EDS 25,B05,202643,Staff,0,0,0,0
1683736563444,EDS 25,B06,202644,Staff,0,0,0,0
1683736564472,EDS 38,A01,202659,Black; Alison Michelle,25,0,25,0
1683736565495,EDS 115,A00,202652,Staff,18,0,30,12
1683736566520,EDS 125,A00,202649,Staff,13,0,30,17
1683736567548,EDS 126,A01,203332,Staff,30,0,30,0
1683736568574,EDS 139,A00,202838,Staff,16,0,25,9
1683736569598,EDS 146,A01,202655,Staff,14,0,25,11
1683736570627,ENG 15,A00,185667,Staff,0,1,0,2
1683736570627,ENG 15,B00,185672,Staff,0,0,0,1
1683736570627,ENG 15,C00,185675,Staff,0,0,0,0
1683736570627,ENG 15,D00,185682,Staff,0,0,0,0
1683736570627,ENG 15,E00,185684,Staff,0,0,0,0
1683736571713,ETHN 103,A00,185710,Staff,0,8,35,35
1683736572743,ETHN 103A,A00,199228,Man; Simeon S,0,0,9,9
1683736573771,ETHN 109,A00,185711,Staff,15,0,35,20
1683736574798,ETHN 142,A00,185726,Staff,0,4,30,30
1683736575825,ETHN 163J,A00,199229,Man; Simeon S,5,0,8,3
1683736576849,ETHN 168,A00,185727,Staff,7,0,10,3
1683736577876,ETHN 182,A00,185728,Staff,0,0,35,35
1683736578900,ETHN 183,A00,185737,Staff,10,0,18,8
1683736579929,GLBH 111,A01,209361,Burgos; Jose L.,0,0,0,0
1683736581985,HIEU 104,A00,185792,Staff,14,0,20,6
1683736583008,HIEU 115,A00,185800,Staff,0,0,20,20
1683736584033,HIEU 128,A00,185801,Staff,0,9,20,20
1683736585058,HIEU 147,A00,185802,Staff,15,0,20,5
1683736586085,HIEU 154,A00,185823,Staff,11,0,20,9
1683736587112,HILA 102,A00,185826,Staff,14,0,20,6
1683736588136,HILD 2C,A01,185778,Staff,0,13,20,20
1683736589165,HILD 7B,A01,185780,Kwak; Nancy,0,17,32,32
1683736589165,HILD 7B,A02,185781,Kwak; Nancy,0,18,32,32
1683736590189,HILD 30,A01,185791,Staff,12,0,20,8
1683736591213,HISC 119,A00,185830,Golan; Tal,0,10,20,20
1683736592240,HITO 156GS,A00,185831,Patterson; Patrick H.,0,0,0,23
1683736593267,HIUS 103,A00,185832,Man; Simeon S,0,4,20,20
1683736594291,HIUS 117,A00,185836,Kwak; Nancy,2,0,20,18
1683736595320,HIUS 125,A00,185840,Man; Simeon S,0,2,23,23
1683736596347,HIUS 149,A00,185845,Staff,1,0,20,19
1683736597374,HUM 3,A01,185882,Zavodny; Tatiana Sophia,0,8,50,50
1683736597374,HUM 3,B01,185899,Caldwell; Michael Alan,0,18,50,50
1683736598398,HUM 3GS,A00,185900,Patterson; Patrick H.,0,0,0,23
1683736599423,HUM 4,A01,185938,Zroka; Amy Liane,28,0,50,22
1683736599423,HUM 4,B01,185956,Watkins; Eric,0,6,50,50
1683736599423,HUM 4,B02,202209,Watkins; Eric,0,6,50,50
1683736599423,HUM 4,B03,202210,Watkins; Eric,0,5,50,50
1683736600450,HUM 5,A01,185958,West; Geoffrey Scott,0,1,50,50
1683736600450,HUM 5,A02,202215,West; Geoffrey Scott,0,1,50,50
1683736601474,INTL 190,A00,185959,Gagnon; Jeffrey C,0,0,0,9
1683736601474,INTL 190,B00,185960,Lettieri; Michael Joseph,0,0,0,2
1683736602497,JAPN 180,A00,254509,Staff,4,0,30,26
1683736603526,LATI 10,A01,202853,Kennemore; Amy Michelle,0,0,31,31
1683736603526,LATI 10,A02,202854,Kennemore; Amy Michelle,0,0,32,32
1683736603526,LATI 10,A03,270054,Kennemore; Amy Michelle,30,0,30,0
1683736604549,LATI 180,A00,202855,Kennemore; Amy Michelle,11,0,20,9
1683736605577,LAWS 101,A00,201767,Golan; Tal,0,7,40,40
1683736606603,LIFR 1C,A00,185961,Staff,6,0,20,14
1683736607628,LIFR 1CX,A00,185962,Staff,7,0,20,13
1683736608654,LIFR 1D,A00,185963,Staff,7,0,20,13
1683736609677,LIFR 1DX,A00,185964,Staff,7,0,20,13
1683736610701,LIGN 101,A01,186039,Staff,43,0,50,7
1683736611727,LIGN 165,A00,186040,Staff,14,0,50,36
1683736612752,LTCS 108,A00,186041,Staff,5,0,10,5
1683736613782,LTCS 119,A00,186042,Staff,15,0,20,5
1683736614806,LTCS 130,A00,186043,Wesling; Megan E.,15,0,25,10
1683736616861,LTEA 138,A00,186119,Staff,13,0,40,27
1683736617884,LTEN 124,A00,186148,Staff,5,0,25,20
1683736618907,LTEN 178,A00,186149,Staff,6,0,15,9
1683736619931,LTEN 181,A00,186150,Blanco; John D,34,0,40,6
1683736620960,LTWL 120,A00,186160,Staff,19,0,25,6
1683736621987,LTWL 165,A00,186161,Staff,22,0,25,3
1683736623013,LTWR 100,A00,186162,Staff,0,5,15,15
1683736624037,LTWR 102,A00,186163,Doller; Ben,5,0,15,10
1683736625060,MAE 8,A01,186412,Staff,0,1,0,1
1683736626084,MAE 30B,A00,186445,Bahadori; Mohammad Yousef,81,0,100,19
1683736627110,MAE 40,A00,186592,Bewley; Thomas R,10,0,50,40
1683736628137,MAE 101B,A00,186593,Bahadori; Mohammad Yousef,79,0,100,21
1683736629163,MAE 105,A00,186594,Bandaru; Prabhakar,10,0,50,40
1683736630190,MAE 107,A00,186599,Pham; Hieu Tan,0,8,120,120
1683736631214,MAE 148,A01,186660,Silberman; Jack,3,0,16,13
1683736632238,MATH 10A,A01,188095,Staff,0,6,35,35
1683736633267,MATH 10B,A01,188097,Bowers; Adam R.,0,12,30,30
1683736633267,MATH 10B,A02,188099,Bowers; Adam R.,0,11,30,30
1683736633267,MATH 10B,B01,188104,Bowers; Adam R.,0,10,30,30
1683736633267,MATH 10B,B02,188106,Bowers; Adam R.,0,9,30,30
1683736634292,MATH 10C,A01,188111,Staff,0,20,30,30
1683736634292,MATH 10C,A02,188127,Staff,0,19,30,30
1683736634292,MATH 10C,A03,188131,Staff,0,19,30,30
1683736634292,MATH 10C,B01,188218,Staff,17,0,30,13
1683736634292,MATH 10C,B02,188244,Staff,13,0,30,17
1683736634292,MATH 10C,B03,188277,Staff,14,0,30,16
1683736635320,MATH 18,A01,188344,Bach; Quang Tran,18,0,30,12
1683736635320,MATH 18,A02,188345,Bach; Quang Tran,11,0,30,19
1683736635320,MATH 18,B01,188353,Bach; Quang Tran,11,0,30,19
1683736635320,MATH 18,B02,188354,Bach; Quang Tran,19,0,30,11
1683736636347,MATH 20A,A01,188374,Staff,10,0,35,25
1683736637372,MATH 20B,A01,188382,Ohm; Ko Woon,7,0,30,23
1683736637372,MATH 20B,A02,188383,Ohm; Ko Woon,22,0,30,8
1683736637372,MATH 20B,B01,188385,Ohm; Ko Woon,7,0,30,23
1683736637372,MATH 20B,B02,188392,Ohm; Ko Woon,22,0,30,8
1683736638395,MATH 20C,A01,188394,Harel; Guershon,10,0,30,20
1683736638395,MATH 20C,A02,188395,Harel; Guershon,13,0,30,17
1683736638395,MATH 20C,B01,188404,Harel; Guershon,5,0,30,25
1683736638395,MATH 20C,B02,188405,Harel; Guershon,18,0,30,12
1683736639418,MATH 20D,A01,188414,Hammock; Frances H,0,1,30,30
1683736639418,MATH 20D,A02,188415,Hammock; Frances H,0,1,30,30
1683736639418,MATH 20D,B01,188447,Hammock; Frances H,0,1,30,30
1683736639418,MATH 20D,B02,188486,Hammock; Frances H,2,0,30,28
1683736640443,MATH 20E,A01,188649,Staff,21,0,30,9
1683736640443,MATH 20E,A02,188650,Staff,20,0,30,10
1683736640443,MATH 20E,A03,188673,Staff,0,0,30,30
1683736641470,MATH 102,A01,188675,Staff,0,40,35,35
1683736642495,MATH 103B,A01,188681,Staff,3,0,35,32
1683736642495,MATH 103B,B01,188692,Staff,5,0,35,30
1683736643522,MATH 109,A01,188695,Salehi Golsefidy; Alireza,24,0,35,11
1683736643522,MATH 109,A02,188696,Salehi Golsefidy; Alireza,24,0,35,11
1683736644547,MATH 120A,A01,188698,Eggers; John Dietrich,7,0,35,28
1683736645574,MATH 142B,A01,188736,Ioana; Adrian,0,0,30,30
1683736645574,MATH 142B,A02,188741,Ioana; Adrian,0,1,30,30
1683736645574,MATH 142B,A03,188743,Ioana; Adrian,0,3,30,30
1683736646602,MATH 168A,A01,188790,Staff,0,11,35,35
1683736647629,MATH 170A,A01,188803,Nie; Jiawang,0,2,35,35
1683736647629,MATH 170A,A02,188811,Nie; Jiawang,0,1,35,35
1683736647629,MATH 170A,A03,188814,Nie; Jiawang,1,0,35,34
1683736647629,MATH 170A,A04,188815,Nie; Jiawang,4,0,35,31
1683736648659,MATH 193B,A01,188817,Staff,0,0,35,35
1683736648659,MATH 193B,A02,188818,Staff,6,0,35,29
1683736649685,MGT 4,A01,202857,Anderson; John Charles,59,0,80,21
1683736650710,MGT 12,A00,202858,Lindenberger; Wade Douglas,40,0,90,50
1683736651736,MGT 18,A00,202859,Staff,73,0,90,17
1683736652762,MGT 18GS,A00,202860,McKay; Michael J,13,0,28,15
1683736653787,MGT 45,A00,202861,Pecore; Joseph P.,8,0,90,82
1683736654810,MGT 100,A00,202863,Yavorsky; Daniel Ryan,27,0,90,63
1683736655836,MGT 103,A00,202864,Ehrich; Kristine R,0,19,90,90
1683736656865,MGT 112,A00,202865,Ehrich; Kristine R,15,0,90,75
1683736657890,MGT 121A,A00,202868,Staff,70,0,90,20
1683736658914,MGT 131B,A00,202869,Anderson; John Charles,58,0,90,32
1683736659940,MGT 136,A00,202871,Lindenberger; Wade Douglas,83,0,90,7
1683736660967,MGT 164,A00,202873,Staff,0,67,90,91
1683736661993,MGT 164GS,A00,202874,McKay; Mary A,13,0,28,15
1683736663017,MGT 180,A00,202875,Staff,0,51,90,91
1683736664044,MMW 11R,A01,205019,Herbst; Matthew,0,0,30,30
1683736664044,MMW 11R,A02,205026,Herbst; Matthew,29,0,30,1
1683736665073,MMW 15,A01,193512,Chang; Edmond Yi-Teh,0,8,28,28
1683736665073,MMW 15,A02,193513,Chang; Edmond Yi-Teh,0,5,28,28
1683736665073,MMW 15,A03,193514,Chang; Edmond Yi-Teh,0,5,28,28
1683736665073,MMW 15,A04,193515,Chang; Edmond Yi-Teh,0,5,28,28
1683736665073,MMW 15,A05,193516,Chang; Edmond Yi-Teh,0,5,28,28
1683736665073,MMW 15,A06,193517,Chang; Edmond Yi-Teh,0,6,28,28
1683736665073,MMW 15,B01,193519,Chang; Edmond Yi-Teh,0,5,28,28
1683736665073,MMW 15,B02,193520,Chang; Edmond Yi-Teh,0,5,28,28
1683736665073,MMW 15,B03,193521,Chang; Edmond Yi-Teh,0,5,28,28
1683736665073,MMW 15,B04,193522,Chang; Edmond Yi-Teh,0,6,28,28
1683736665073,MMW 15,B05,193523,Chang; Edmond Yi-Teh,0,5,28,28
1683736665073,MMW 15,B06,193524,Chang; Edmond Yi-Teh,0,5,28,28
1683736666100,MMW 122,A01,193526,Rahimi; Babak,0,16,28,28
1683736666100,MMW 122,A02,193527,Rahimi; Babak,0,15,28,28
1683736666100,MMW 122,A03,193528,Rahimi; Babak,0,0,0,0
1683736666100,MMW 122,A04,193529,Rahimi; Babak,0,0,0,0
1683736667124,MUS 1A,A01,186663,Staff,0,18,35,35
1683736668149,MUS 4,A01,186715,Staff,0,12,35,35
1683736669173,MUS 5R,A01,186796,Dubnov; Shlomo,0,17,35,35
1683736670200,MUS 6,A01,186798,Staff,0,4,25,25
1683736671223,MUS 7,A01,186830,Staff,11,0,35,24
1683736672246,MUS 8,A01,186930,Staff,0,27,35,35
1683736673269,MUS 15,A01,186932,Staff,0,15,35,35
1683736673269,MUS 15,B01,186934,Staff,0,16,35,35
1683736674296,MUS 80,A00,186935,Staff,0,0,20,20
1683736674296,MUS 80,B00,186936,Staff,24,0,25,1
1683736675377,NANO 11,A00,204702,Lipomi; Darren John,0,0,0,0
1683736676402,NANO 15,A01,204709,Yang; Kesong,0,1,0,0
1683736677425,NANO 114,A00,202069,Jahed Motlagh; Zeinab,2,0,10,8
1683736678449,PHIL 1,A00,186955,Grush; Rick Scott,31,0,40,9
1683736679477,PHIL 10,A01,186973,Grush; Rick Scott,27,0,35,8
1683736679477,PHIL 10,A02,186974,Grush; Rick Scott,33,0,35,2
1683736680502,PHIL 13,A01,186976,Staff,1,0,35,34
1683736680502,PHIL 13,A02,186977,Staff,16,0,35,19
1683736681526,PHIL 14,A01,186979,Staff,30,0,35,5
1683736681526,PHIL 14,A02,186986,Staff,32,0,35,3
1683736682554,PHIL 28,A01,186988,Staff,16,0,30,14
1683736682554,PHIL 28,A02,186989,Staff,0,0,30,30
1683736682554,PHIL 28,A03,186990,Staff,10,0,30,20
1683736682554,PHIL 28,A04,186991,Staff,26,0,30,4
1683736683582,PHIL 120,A00,186997,Staff,23,0,40,17
1683736684609,PHIL 137,A00,187003,Staff,8,0,40,32
1683736685632,PHIL 150,A00,187015,Staff,47,0,70,23
1683736686659,PHIL 167,A00,187021,Lamey; Andy M.,34,0,40,6
1683736687682,PHIL 174,A01,202226,Staff,17,0,20,3
1683736687682,PHIL 174,A02,202235,Staff,20,0,20,0
1683736688707,PHIL 191A,A00,258918,Staff,0,0,1,1
1683736689733,PHYS 1A,A00,187028,Staff,26,0,60,34
1683736690758,PHYS 1AL,001,187036,Staff,3,0,30,27
1683736690758,PHYS 1AL,002,187049,Staff,18,0,30,12
1683736691781,PHYS 1B,A00,187058,Staff,21,0,60,39
1683736692808,PHYS 1BL,001,187064,Staff,0,1,30,30
1683736692808,PHYS 1BL,002,187070,Staff,4,0,30,26
1683736693832,PHYS 1C,A00,187082,Staff,30,0,120,90
1683736694856,PHYS 1CL,001,187088,Staff,0,9,30,30
1683736694856,PHYS 1CL,002,187089,Staff,0,1,30,30
1683736694856,PHYS 1CL,009,262693,Staff,9,0,30,21
1683736695882,PHYS 2B,A01,187097,Staff,55,0,115,60
1683736696909,PHYS 2C,A01,187099,Staff,63,0,115,52
1683736697931,PHYS 2CL,A01,187101,Staff,5,0,28,23
1683736697931,PHYS 2CL,A02,187102,Staff,15,0,28,13
1683736698961,PHYS 2D,A01,187123,Shotwell; Brian,95,0,115,20
1683736699985,PHYS 4B,A01,187133,Grinstein; Benjamin,34,0,50,16
1683736701011,POLI 10,A00,188819,Staff,0,4,50,50
1683736702038,POLI 11,A00,188827,Staff,43,0,50,7
1683736703064,POLI 13R,A00,188828,Staff,0,2,20,20
1683736704088,POLI 27,A01,188830,Elgin; Samuel Zincke,0,2,70,70
1683736705115,POLI 30,A00,188832,Desposato; Scott,30,0,50,20
1683736706142,POLI 102F,A00,188834,Staff,1,0,40,39
1683736707235,POLI 104A,A00,188852,Staff,12,0,30,18
1683736708259,POLI 104I,A00,188853,Staff,0,8,20,20
1683736709283,POLI 110B,A00,188854,Wiens; David,6,0,20,14
1683736710307,POLI 112A,A00,188855,Wiens; David,4,0,30,26
1683736711335,POLI 117R,A00,188856,Forman; Fonna,0,12,20,20
1683736712358,POLI 118,A00,188857,Ingham; Sean,8,0,20,12
1683736713382,POLI 120G,A00,188858,Staff,7,0,30,23
1683736714406,POLI 131CR,A00,188863,Hoston; Germaine,20,0,50,30
1683736715434,POLI 133,A00,188864,Nellis; Gareth Hb,44,0,50,6
1683736716461,POLI 134D,A00,188865,Desposato; Scott,27,0,30,3
1683736717488,POLI 142A,A00,188871,Gartzke; Erik,21,0,50,29
1683736718514,POLI 142K,A00,188874,Staff,38,0,50,12
1683736719541,POLI 143,A00,188940,Gartzke; Erik,15,0,30,15
1683736720567,POLI 153,A00,188943,Staff,1,0,20,19
1683736721594,POLI 160AA,A00,188944,Staff,10,0,40,30
1683736722621,POLI 170A,A00,188945,Staff,10,0,30,20
1683736724671,PSYC 1,A00,188952,Staff,36,0,90,54
1683736725697,PSYC 2,B00,188953,Staff,19,0,35,16
1683736726723,PSYC 6,A00,188970,Staff,47,0,60,13
1683736727749,PSYC 7,A00,188973,Staff,35,0,45,10
1683736728773,PSYC 60,A01,188980,Rickard; Timothy C.,42,0,60,18
1683736729801,PSYC 70,A01,189001,Steiner; Eric Tomas,21,0,45,24
1683736730825,PSYC 100,A00,189005,Lacefield; Katharine I,1,98,120,119
1683736731848,PSYC 102,A00,189008,Staff,6,0,30,24
1683736732871,PSYC 106,B00,189026,Gorman; Michael R.,26,0,60,34
1683736733899,PSYC 114,B01,189033,Winkielman; Piotr,0,31,30,30
1683736734922,PSYC 131,A00,189036,Anagnostaras; Stephan,0,44,60,60
1683736735947,PSYC 136,A00,189041,Lowe; Angela Beth,0,7,25,25
1683736736972,PSYC 137,A00,189057,Winkielman; Piotr,0,36,25,25
1683736737999,PSYC 144,A00,189107,Wixted; John T,0,11,50,50
1683736740048,PSYC 162,A00,189142,Staff,0,9,85,85
1683736741073,PSYC 172,A00,189144,Gorman; Michael R.,0,6,30,30
1683736743127,PSYC 179,A00,189146,Lacefield; Katharine I,0,88,120,120
1683736744160,PSYC 181,A00,189147,Anagnostaras; Stephan,110,45,200,90
1683736745185,PSYC 190R,A00,189148,Barner; David A.,0,23,80,80
1683736746211,PSYC 191,A00,189275,Rickard; Timothy C.,0,11,25,25
1683736747234,PSYC 193,A00,189276,Chapman; Eddie Nathaniel,0,1,0,4
1683736748263,PSYC 193L,A01,189281,Lowe; Angela Beth,8,0,20,12
1683736748263,PSYC 193L,B01,189285,Staff,28,0,35,7
1683736749287,RELI 149,A00,187137,Rahimi; Babak,6,0,40,34
1683736750312,SE 9,A01,187315,Staff,0,2,18,18
1683736751338,SE 101B,A00,187409,Staff,24,0,30,6
1683736752365,SE 110B,A00,187444,Staff,10,0,40,30
1683736753392,SE 130B,A00,187449,Staff,31,0,40,9
1683736754417,SE 150A,A00,187516,Staff,8,0,20,12
1683736755443,SE 154,A00,187528,Staff,29,0,50,21
1683736756467,SIO 3,A01,258171,Staff,35,0,40,5
1683736757504,SIO 10,A00,187144,Cook; Geoffrey W,0,6,75,75
1683736758529,SIO 45,A00,187152,Cook; Geoffrey W,1,7,100,99
1683736759551,SIO 109R,A00,194486,Staff,0,4,20,20
1683736761601,SIO 187,A01,187233,Kacev; David,12,0,40,28
1683736762629,SOCI 1,A01,258656,Thorpe; Charles Robert,28,0,30,2
1683736762629,SOCI 1,A02,258658,Thorpe; Charles Robert,30,0,30,0
1683736762629,SOCI 1,A03,258661,Thorpe; Charles Robert,25,0,25,0
1683736762629,SOCI 1,A04,258666,Thorpe; Charles Robert,22,0,25,3
1683736762629,SOCI 1,A05,258897,Thorpe; Charles Robert,22,0,25,3
1683736762629,SOCI 1,A06,258898,Thorpe; Charles Robert,25,0,25,0
1683736763655,SOCI 30,A01,258903,Pardo Guerra; Juan Pablo,14,0,30,16
1683736764682,SOCI 102,A00,258904,Staff,9,0,25,16
1683736765704,SOCI 106,A00,258905,Staff,19,0,25,6
1683736766731,SOCI 111,A00,258907,Ribas Norris; Janet Vanesa,26,0,30,4
1683736767755,SOCI 121R,A00,258908,Pardo Guerra; Juan Pablo,7,0,30,23
1683736768782,SOCI 126,A01,203330,Staff,14,0,20,6
1683736769806,SOCI 131,A00,258909,Thorpe; Charles Robert,30,0,60,30
1683736770830,SOCI 135,A00,258910,Payne; Christine Anna,0,13,30,30
1683736771858,SOCI 157,A00,258911,Staff,10,0,30,20
1683736772882,SOCI 184,A00,258912,Staff,25,0,30,5
1683736773908,SOCI 188D,A00,258913,Staff,22,0,30,8
1683736774932,SYN 2,001,187529,Staff,9,0,16,7
1683736774932,SYN 2,002,201452,Staff,0,20,16,16
1683736774932,SYN 2,003,201469,Staff,1,0,16,15
1683736775960,SYN 100,A01,187531,Staff,0,9,20,20
1683736775960,SYN 100,B01,201491,Staff,0,10,20,20
1683736776983,TDAC 1,A00,189286,Walsh; Kim C.,3,0,20,17
1683736776983,TDAC 1,B00,189287,Harting; Carla Kelso,10,0,20,10
1683736778012,TDAC 101,A00,189300,Walsh; Kim C.,16,0,20,4
1683736778012,TDAC 101,B00,189301,Harting; Carla Kelso,18,0,20,2
1683736779094,TDAC 102,A00,189304,Basso; Beatrice,14,0,20,6
1683736780116,TDAC 108,A00,189305,Staff,18,0,20,2
1683736781141,TDDE 131,A00,189310,Staff,19,0,20,1
1683736781141,TDDE 131,B00,189314,Staff,19,0,20,1
1683736781141,TDDE 131,C00,189315,Staff,48,0,50,2
1683736781141,TDDE 131,D00,189316,Staff,14,0,15,1
1683736781141,TDDE 131,E00,204841,Staff,20,0,20,0
1683736782165,TDGE 10,A00,189289,Staff,26,0,50,24
1683736782165,TDGE 10,B00,189290,Havis; Allan,0,1,50,50
1683736783189,TDGE 11,A00,189291,Fulton; Julia,0,4,50,50
1683736783189,TDGE 11,B00,189292,Staff,20,0,25,5
1683736783189,TDGE 11,C00,260270,Staff,0,0,0,0
1683736784213,TDGE 25,A00,189294,Staff,1,0,20,19
1683736785240,TDGE 124,A00,189318,Fulton; Julia,0,7,50,50
1683736786266,TDGE 125,A00,189319,Staff,13,0,25,12
1683736786266,TDGE 125,B00,189320,Staff,23,0,25,2
1683736787293,TDGE 127,A00,189322,Havis; Allan,1,0,50,49
1683736788319,TDHT 101,A00,189323,Staff,18,0,25,7
1683736788319,TDHT 101,B00,189324,Staff,25,0,25,0
1683736789343,TDHT 102,A00,189325,Staff,49,0,50,1
1683736790367,TDMV 1,A00,189295,Arcidiacono; Kristin,20,0,30,10
1683736790367,TDMV 1,B00,189296,Caligagan; Maria T.,23,0,30,7
1683736791392,TDMV 2,A00,189297,Sammartano; Tonnie,27,0,30,3
1683736791392,TDMV 2,B00,189299,Arcidiacono; Kristin,23,0,30,7
1683736792415,TDMV 3,A00,204998,Rincon; Alicia,22,0,30,8
1683736793439,TDMV 120,A00,189458,Sammartano; Tonnie,28,0,30,2
1683736794464,TDMV 138,A00,189541,Jun; Grace Shin Hae,20,0,40,20
1683736795489,TDMV 142,A00,189717,Caligagan; Tony,25,0,30,5
1683736795489,TDMV 142,B00,189718,Caligagan; Maria T.,25,0,30,5
1683736796512,TMC 2,A01,187533,Staff,25,0,25,0
1683736796512,TMC 2,A02,187534,Staff,25,0,25,0
1683736797536,USP 1,A01,187536,Kwak; Nancy,0,16,25,25
1683736798560,USP 5,A01,187538,Staff,8,0,25,17
1683736799588,USP 101,A00,199253,Staff,0,4,0,0
1683736800611,USP 124,A00,187562,Boomhower; Matthew Charles,1,0,30,29
1683736801638,USP 138,A00,187582,Staff,19,0,25,6
1683736802662,USP 152,A01,187597,Staff,3,0,25,22
1683736803686,USP 153,A00,187598,Staff,18,0,25,7
1683736804714,USP 168,A00,187607,Kwak; Nancy,2,0,5,3
1683736805738,USP 173,A00,187619,Staff,4,0,25,21
1683736806763,USP 181,A00,187638,Staff,0,4,25,25
1683736807791,VIS 103,A00,187650,Cruz; Edwin Teddy,17,0,75,58
1683736808815,VIS 110D,A00,187669,Staff,13,0,22,9
1683736809840,VIS 127C,A00,187720,Shen; Kuiyi,67,0,146,79
1683736810866,VIS 149,A00,187731,Yoldas; Pinar,0,12,22,22
1683736811891,VIS 151,A01,188091,Staff,22,0,34,12
1683736811891,VIS 151,A02,188092,Staff,11,0,34,23
1683736812915,VIS 160B,A00,188093,Stalbaum; Brett,0,1,10,10
1683736814962,WCWP 10B,A00,201720,Staff,0,0,5,5
1683736814962,WCWP 10B,B00,201722,Staff,0,0,6,6
1683736815989,WCWP 100,A00,201725,Gagnon; Jeffrey C,0,0,2,2
1683736815989,WCWP 100,B00,201727,Staff,0,4,15,15
1683736819130,ANBI 133,A00,258401,Wilder; Linnea Lorene,34,0,40,6
1683736820154,ANBI 140,A00,258395,Hrvoj Mihic; Branka,18,0,25,7
1683736821178,ANSC 120,A00,258402,Bialecki; Jon Anthony,26,0,40,14
1683736822203,ANSC 144,A00,258400,Staff,12,0,40,28
1683736824254,ANSC 166,A00,258396,Parish; Steven Martin,156,0,175,19
1683736825282,ANSC 180,A00,193533,Staff,8,0,20,12
1683736826310,ANSC 188,A00,258397,Jassal; Aftab,34,0,40,6
1683736827338,ANTH 3,A01,258316,Staff,23,0,30,7
1683736828361,ANTH 5,A00,258394,Semendeferi; Ekaterini,16,0,20,4
1683736829383,ANTH 21,A01,258331,Staff,4,0,40,36
1683736830408,ANTH 103,A00,258398,Varma; Saiba,15,0,25,10
1683736831439,AWP 10,001,202034,Staff,0,0,0,0
1683736831439,AWP 10,002,202035,Staff,0,0,0,0
1683736831439,AWP 10,003,202036,Staff,0,0,0,0
1683736831439,AWP 10,004,202037,Staff,0,0,0,0
1683736831439,AWP 10,005,202038,Staff,0,0,0,0
1683736831439,AWP 10,006,202039,Staff,0,0,0,0
1683736831439,AWP 10,007,202040,Staff,0,0,0,0
1683736831439,AWP 10,008,202041,Staff,0,0,0,0
1683736831439,AWP 10,009,202042,Staff,0,0,0,0
1683736831439,AWP 10,010,202043,Staff,0,0,0,0
1683736831439,AWP 10,011,202044,Staff,0,0,0,0
1683736831439,AWP 10,012,202045,Staff,0,0,0,0
1683736831439,AWP 10,013,202046,Staff,0,0,0,0
1683736831439,AWP 10,014,202047,Staff,0,0,0,0
1683736831439,AWP 10,015,202048,Staff,0,0,0,0
1683736831439,AWP 10,016,202049,Staff,0,0,0,0
1683736831439,AWP 10,017,202050,Staff,0,0,0,0
1683736831439,AWP 10,018,202051,Staff,0,0,0,0
1683736831439,AWP 10,019,202052,Staff,0,0,0,0
1683736831439,AWP 10,020,202053,Staff,0,0,0,0
1683736831439,AWP 10,021,202054,Staff,0,0,0,0
1683736831439,AWP 10,022,202055,Staff,0,0,0,0
1683736831439,AWP 10,023,202056,Staff,0,0,0,0
1683736831439,AWP 10,024,202057,Staff,0,0,0,0
1683736831439,AWP 10,025,202058,Staff,0,0,0,0
1683736831439,AWP 10,026,202059,Staff,0,0,0,0
1683736832464,AWP 102,001,202032,Staff,0,0,0,0
1683736832464,AWP 102,002,202033,Staff,0,0,0,0
1683736833488,BENG 100,A01,254234,Taylor Amos; Alyssa C,31,0,40,9
1683736834512,BENG 196,001,270013,Engler; Adam J.,9999,0,9999,0
1683736835536,BICD 100R,A01,202018,Smith; Laurie,0,7,32,32
1683736835536,BICD 100R,A02,202019,Smith; Laurie,0,3,32,32
1683736835536,BICD 100R,A03,202020,Smith; Laurie,0,1,32,32
1683736835536,BICD 100R,A04,202021,Smith; Laurie,6,0,32,26
1683736835536,BICD 100R,A05,202022,Smith; Laurie,10,0,32,22
1683736836564,BICD 136,A01,193242,Gustafson-Brown; Cindy,0,2,32,32
1683736836564,BICD 136,A02,193244,Gustafson-Brown; Cindy,13,0,32,19
1683736837590,BIEB 102,A01,193249,Butler; Shannon Rhey,0,0,32,32
1683736837590,BIEB 102,A02,193251,Butler; Shannon Rhey,0,0,32,32
1683736837590,BIEB 102,A03,193253,Butler; Shannon Rhey,0,0,32,32
1683736837590,BIEB 102,A04,193255,Butler; Shannon Rhey,13,0,32,19
1683736837590,BIEB 102,A05,193265,Butler; Shannon Rhey,25,0,32,7
1683736837590,BIEB 102,A06,193269,Butler; Shannon Rhey,12,0,32,20
1683736839640,BIEB 150,A01,193274,Staff,0,0,32,32
1683736839640,BIEB 150,A02,193285,Staff,24,0,32,8
1683736840665,BIEB 194,A00,193286,Kurle; Carolyn M.,19,0,32,13
1683736841690,BILD 1,A01,192291,Staff,15,0,32,17
1683736841690,BILD 1,A02,192292,Staff,30,0,32,2
1683736841690,BILD 1,B01,192520,Reuther; Keefe,0,1,0,0
1683736841690,BILD 1,B02,192532,Reuther; Keefe,0,1,0,0
1683736842715,BILD 3,A01,192556,Butler; Shannon Rhey,0,0,32,32
1683736842715,BILD 3,A02,192581,Butler; Shannon Rhey,0,1,32,32
1683736842715,BILD 3,A03,192611,Butler; Shannon Rhey,19,0,32,13
1683736842715,BILD 3,A04,192612,Butler; Shannon Rhey,23,0,32,9
1683736842715,BILD 3,A05,192613,Butler; Shannon Rhey,26,0,32,6
1683736842715,BILD 3,A06,192679,Butler; Shannon Rhey,27,0,32,5
1683736842715,BILD 3,A07,192682,Butler; Shannon Rhey,20,0,32,12
1683736843744,BILD 4,A01,192836,Reuther; Keefe,1,0,24,23
1683736843744,BILD 4,A02,193044,Reuther; Keefe,4,0,24,20
1683736844769,BILD 10,A01,193142,Gustafson-Brown; Cindy,29,0,32,3
1683736844769,BILD 10,A02,193149,Gustafson-Brown; Cindy,31,0,32,1
1683736845796,BIMM 100,A01,193301,Staff,0,6,32,32
1683736845796,BIMM 100,A02,193312,Staff,0,7,32,32
1683736845796,BIMM 100,A03,193323,Staff,0,10,32,32
1683736846824,BIMM 101,A01,193329,McDonnell; Lisa Marie,0,3,24,24
1683736846824,BIMM 101,A02,193339,McDonnell; Lisa Marie,0,3,24,24
1683736846824,BIMM 101,B01,193354,McDonnell; Lisa Marie,0,4,24,24
1683736846824,BIMM 101,B02,193357,McDonnell; Lisa Marie,0,3,24,24
1683736847847,BIMM 110,A01,193377,Tat; John,0,11,32,32
1683736847847,BIMM 110,A02,193378,Tat; John,0,11,32,32
1683736848871,BIMM 120,A01,206116,Staff,1,0,32,31
1683736848871,BIMM 120,A02,206117,Staff,7,0,32,25
1683736848871,BIMM 120,A03,206121,Staff,21,0,32,11
1683736849898,BIPN 100,A01,193393,Park; Ji Young,0,15,32,32
1683736849898,BIPN 100,A02,193402,Park; Ji Young,0,14,32,32
1683736849898,BIPN 100,A03,193413,Park; Ji Young,0,14,32,32
1683736849898,BIPN 100,A04,193414,Park; Ji Young,0,13,32,32
1683736850922,BIPN 102,A01,193429,Staff,0,0,32,32
1683736850922,BIPN 102,A02,193438,Staff,18,0,32,14
1683736851950,BIPN 106,A01,193450,Reyes Gonzalez; Catalina,0,2,40,40
1683736852975,BIPN 134,A01,193465,Cooke; James Edward,0,0,32,32
1683736852975,BIPN 134,A02,193474,Cooke; James Edward,24,0,32,8
1683736852975,BIPN 134,A03,193485,Cooke; James Edward,29,0,32,3
1683736852975,BIPN 134,A04,193486,Cooke; James Edward,20,0,32,12
1683736852975,BIPN 134,A05,193491,Cooke; James Edward,31,0,32,1
1683736852975,BIPN 134,A06,193501,Cooke; James Edward,30,0,32,2
1683736852975,BIPN 134,A07,193510,Cooke; James Edward,29,0,32,3
1683736855031,BISP 194,A00,222522,Staff,14,0,32,18
1683736856056,CAT 124,A01,202407,Staff,19,0,25,6
1683736857081,CAT 125,A00,202408,Marchisotto; Jennifer Anne,2,0,20,18
1683736858104,CAT 125R,A00,202409,Smith; Lauryn Alissa,0,11,20,20
1683736858104,CAT 125R,B00,202410,Morales; Celeste Georgianna,0,11,20,20
1683736858104,CAT 125R,C00,202411,Irwin; Matthew Joseph,0,12,20,20
1683736859136,CENG 15,A01,204712,Yang; Kesong,0,1,0,0
1683736860158,CENG 114,A00,202070,Jahed Motlagh; Zeinab,5,0,20,15
1683736861184,CGS 105,A00,185477,Wesling; Megan E.,24,0,40,16
1683736862208,CGS 106,A00,185494,Staff,11,0,22,11
1683736863232,CGS 108,A00,185495,Staff,14,0,20,6
1683736864260,CGS 114,A00,185496,Staff,13,0,18,5
1683736865284,CGS 119,A00,185501,Staff,15,0,20,5
1683736866308,CGS 120,A00,185511,Staff,11,0,20,9
1683736867334,CHEM 4,A01,184675,Bussey; Thomas J,97,0,100,3
1683736868359,CHEM 6A,A01,184677,Staff,32,0,60,28
1683736869385,CHEM 6B,A01,184679,Staff,63,0,100,37
1683736870409,CHEM 6C,A01,184681,Bussey; Thomas J,0,0,50,50
1683736870409,CHEM 6C,A02,184682,Bussey; Thomas J,32,0,50,18
1683736871434,CHEM 40A,A01,184684,Albizati; Kim F.,33,0,100,67
1683736872460,CHEM 40B,A01,184686,Albizati; Kim F.,0,22,100,100
1683736873484,CHEM 41B,A01,184690,Staff,51,0,100,49
1683736874508,COGS 3,A01,184715,Boyle; Mary E. T.,0,27,40,40
1683736875536,COGS 14B,A01,185172,Staff,0,14,38,38
1683736876561,COGS 18,A01,184736,Staff,14,0,80,66
1683736877593,COGS 100,A01,184932,Staff,0,8,73,73
1683736878622,COGS 101A,A01,184935,Staff,0,40,30,30
1683736879650,COGS 101B,A01,184944,Staff,0,2,30,30
1683736880676,COGS 101C,A01,184946,Staff,0,10,30,30
1683736881700,COGS 102A,A01,184951,Johnson; Christine M.,1,0,40,39
1683736882803,COGS 107B,A01,184953,Mooshagian; Eric Frederick,0,52,40,40
1683736883834,COGS 118B,A01,184959,Gupta; Anjum,0,50,40,40
1683736884859,COGS 153,A00,184961,Staff,1,16,30,29
1683736885889,COGS 177,A00,184962,Staff,0,20,30,30
1683736886916,COGS 187A,A01,184969,Boyle; Mary E. T.,0,19,40,40
1683736887940,COMM 10,A01,185174,Staff,0,5,25,25
1683736887940,COMM 10,A02,185189,Staff,0,2,25,25
1683736887940,COMM 10,A03,269821,Staff,0,1,0,0
1683736888968,COMM 100B,A02,185476,Staff,10,0,25,15
1683736888968,COMM 100B,A03,277340,Staff,25,0,25,0
1683736889998,COMM 100C,A01,185314,Staff,2,0,25,23
1683736889998,COMM 100C,A02,185327,Staff,17,0,25,8
1683736891025,COMM 110M,A00,185349,Staff,0,0,40,40
1683736892050,COMM 113T,A00,185352,Staff,25,0,40,15
1683736893074,COMM 114I,A00,185353,Staff,31,0,40,9
1683736894099,COMM 131,A00,185354,Staff,17,0,30,13
1683736895126,CSE 8A,A50,185358,Cao; Yingjun,0,46,10,10
1683736896150,CSE 8B,A01,185362,Staff,0,48,50,50
1683736897177,CSE 11,A01,185416,Cao; Yingjun,0,91,10,10
1683736898205,CSE 20,A01,185445,Briones; Jor-el Thomas Caparas,3,0,25,22
1683736899234,CSE 21,A01,185447,Staff,9,0,50,41
1683736900260,CSE 101,A01,185451,Staff,0,13,50,50
1683736900260,CSE 101,B01,185453,Jones; Miles E,0,15,50,50
1683736902311,CSE 141,A01,185458,Eldon; John,16,0,100,84
1683736903340,CSE 141L,A01,185461,Eldon; John,8,0,100,92
1683736904368,CSE 142,A01,185463,Staff,34,0,60,26
1683736904368,CSE 142,B01,201355,Staff,0,7,60,60
1683736905392,CSE 142L,A01,185470,Staff,34,0,60,26
1683736905392,CSE 142L,B01,201417,Staff,0,6,60,60
1683736906419,CSE 190,A00,201433,Staff,32,0,49,17
1683736907443,DOC 1,A01,259136,Strom; Megan C.,7,0,15,8
1683736907443,DOC 1,A02,259137,Strom; Megan C.,15,0,15,0
1683736907443,DOC 1,A03,259138,Strom; Megan C.,14,0,15,1
1683736907443,DOC 1,A04,259139,Strom; Megan C.,13,0,15,2
1683736908471,DOC 100D,A00,259140,Pass; Natalye Joann,14,0,25,11
1683736909499,DSGN 1,A01,184749,Rill; Bryan,0,26,30,30
1683736910526,DSGN 100,A01,185168,Staff,0,2,25,25
1683736911550,ECE 5,A01,185626,Morris; Karcher William,0,12,0,0
1683736912579,ECE 101,A01,185628,Staff,14,0,70,56
1683736913607,ECE 107,A01,185635,Baghdadchi; Saharnaz,0,0,20,20
1683736913607,ECE 107,A02,185638,Baghdadchi; Saharnaz,1,0,20,19
1683736914631,ECE 148,A01,185647,Silberman; Jack,0,0,16,16
1683736915658,ECON 1,A01,185537,Crane; Meredith Helen,54,0,70,16
1683736916682,ECON 3,A01,185549,Crane; Meredith Helen,30,0,70,40
1683736917706,ECON 4,A01,203354,Anderson; John Charles,0,5,10,10
1683736918733,ECON 100A,A01,185574,Staff,0,5,40,40
1683736919757,ECON 100B,A01,185576,Staff,0,12,50,50
1683736920783,ECON 100C,A01,185589,Newhouse; Herbert S,30,0,70,40
1683736921808,ECON 105,A00,185608,Vespa; Emanuel Ignacio,19,0,35,16
1683736922833,ECON 109,A01,185610,Shishkin; Denis,9,0,35,26
1683736923860,ECON 110A,A01,185612,Staff,8,0,40,32
1683736924883,ECON 120A,A01,185615,Staff,19,0,40,21
1683736925907,ECON 120C,A01,185617,Sun; Yixiao,0,21,70,70
1683736926933,ECON 144,A00,203346,Squires; Dale E,2,0,35,33
1683736927961,ECON 171,A01,203349,Newhouse; Herbert S,0,1,35,35
1683736928987,ECON 173A,A01,185621,Toda; Alexis Akira,21,0,35,14
1683736930017,EDS 25,A01,202413,Staff,0,1,0,0
1683736930017,EDS 25,A02,202414,Staff,0,1,0,0
1683736930017,EDS 25,A03,202415,Staff,0,0,0,0
1683736930017,EDS 25,A04,202416,Staff,0,1,0,0
1683736930017,EDS 25,A05,202439,Staff,0,0,0,0
1683736930017,EDS 25,A06,202440,Staff,0,0,0,0
1683736930017,EDS 25,B01,202631,Staff,0,0,0,0
1683736930017,EDS 25,B02,202632,Staff,0,0,0,0
1683736930017,EDS 25,B03,202639,Staff,0,0,0,0
1683736930017,EDS 25,B04,202640,Staff,0,0,0,0
1683736930017,EDS 25,B05,202643,Staff,0,0,0,0
1683736930017,EDS 25,B06,202644,Staff,0,0,0,0
1683736931044,EDS 38,A01,202659,Black; Alison Michelle,25,0,25,0
1683736932070,EDS 115,A00,202652,Staff,18,0,30,12
1683736933098,EDS 125,A00,202649,Staff,13,0,30,17
1683736934122,EDS 126,A01,203332,Staff,30,0,30,0
1683736935146,EDS 139,A00,202838,Staff,16,0,25,9
1683736936170,EDS 146,A01,202655,Staff,14,0,25,11
1683736937194,ENG 15,A00,185667,Staff,0,1,0,2
1683736937194,ENG 15,B00,185672,Staff,0,0,0,1
1683736937194,ENG 15,C00,185675,Staff,0,0,0,0
1683736937194,ENG 15,D00,185682,Staff,0,0,0,0
1683736937194,ENG 15,E00,185684,Staff,0,0,0,0
1683736938218,ETHN 103,A00,185710,Staff,0,8,35,35
1683736939242,ETHN 103A,A00,199228,Man; Simeon S,0,0,9,9
1683736940269,ETHN 109,A00,185711,Staff,15,0,35,20
1683736941293,ETHN 142,A00,185726,Staff,0,4,30,30
1683736942317,ETHN 163J,A00,199229,Man; Simeon S,5,0,8,3
1683736943356,ETHN 168,A00,185727,Staff,7,0,10,3
1683736944379,ETHN 182,A00,185728,Staff,0,0,35,35
1683736945401,ETHN 183,A00,185737,Staff,10,0,18,8
1683736946425,GLBH 111,A01,209361,Burgos; Jose L.,0,0,0,0
1683736948475,HIEU 104,A00,185792,Staff,14,0,20,6
1683736949502,HIEU 115,A00,185800,Staff,0,0,20,20
1683736950529,HIEU 128,A00,185801,Staff,0,9,20,20
1683736951555,HIEU 147,A00,185802,Staff,15,0,20,5
1683736952578,HIEU 154,A00,185823,Staff,11,0,20,9
1683736953606,HILA 102,A00,185826,Staff,14,0,20,6
1683736954629,HILD 2C,A01,185778,Staff,0,13,20,20
1683736955654,HILD 7B,A01,185780,Kwak; Nancy,0,17,32,32
1683736955654,HILD 7B,A02,185781,Kwak; Nancy,0,18,32,32
1683736956680,HILD 30,A01,185791,Staff,12,0,20,8
1683736957706,HISC 119,A00,185830,Golan; Tal,0,10,20,20
1683736958730,HITO 156GS,A00,185831,Patterson; Patrick H.,0,0,0,23
1683736959756,HIUS 103,A00,185832,Man; Simeon S,0,4,20,20
1683736960783,HIUS 117,A00,185836,Kwak; Nancy,2,0,20,18
1683736961809,HIUS 125,A00,185840,Man; Simeon S,0,2,23,23
1683736962833,HIUS 149,A00,185845,Staff,1,0,20,19
1683736963859,HUM 3,A01,185882,Zavodny; Tatiana Sophia,0,8,50,50
1683736963859,HUM 3,B01,185899,Caldwell; Michael Alan,0,18,50,50
1683736964884,HUM 3GS,A00,185900,Patterson; Patrick H.,0,0,0,23
1683736965909,HUM 4,A01,185938,Zroka; Amy Liane,28,0,50,22
1683736965909,HUM 4,B01,185956,Watkins; Eric,0,6,50,50
1683736965909,HUM 4,B02,202209,Watkins; Eric,0,6,50,50
1683736965909,HUM 4,B03,202210,Watkins; Eric,0,5,50,50
1683736966934,HUM 5,A01,185958,West; Geoffrey Scott,0,1,50,50
1683736966934,HUM 5,A02,202215,West; Geoffrey Scott,0,1,50,50
1683736967961,INTL 190,A00,185959,Gagnon; Jeffrey C,0,0,0,9
1683736967961,INTL 190,B00,185960,Lettieri; Michael Joseph,0,0,0,2
1683736968988,JAPN 180,A00,254509,Staff,4,0,30,26
1683736970012,LATI 10,A01,202853,Kennemore; Amy Michelle,0,0,31,31
1683736970012,LATI 10,A02,202854,Kennemore; Amy Michelle,0,0,32,32
1683736970012,LATI 10,A03,270054,Kennemore; Amy Michelle,30,0,30,0
1683736971036,LATI 180,A00,202855,Kennemore; Amy Michelle,11,0,20,9
1683736972066,LAWS 101,A00,201767,Golan; Tal,0,7,40,40
1683736973090,LIFR 1C,A00,185961,Staff,6,0,20,14
1683736974115,LIFR 1CX,A00,185962,Staff,7,0,20,13
1683736975140,LIFR 1D,A00,185963,Staff,7,0,20,13
1683736976167,LIFR 1DX,A00,185964,Staff,7,0,20,13
1683736977190,LIGN 101,A01,186039,Staff,43,0,50,7
1683736978212,LIGN 165,A00,186040,Staff,14,0,50,36
1683736979239,LTCS 108,A00,186041,Staff,5,0,10,5
1683736980263,LTCS 119,A00,186042,Staff,15,0,20,5
1683736981287,LTCS 130,A00,186043,Wesling; Megan E.,15,0,25,10
1683736983337,LTEA 138,A00,186119,Staff,13,0,40,27
1683736984364,LTEN 124,A00,186148,Staff,5,0,25,20
1683736985389,LTEN 178,A00,186149,Staff,6,0,15,9
1683736986472,LTEN 181,A00,186150,Blanco; John D,34,0,40,6
1683736987495,LTWL 120,A00,186160,Staff,19,0,25,6
1683736988521,LTWL 165,A00,186161,Staff,22,0,25,3
1683736989545,LTWR 100,A00,186162,Staff,0,5,15,15
1683736990568,LTWR 102,A00,186163,Doller; Ben,5,0,15,10
1683736991592,MAE 8,A01,186412,Staff,0,1,0,1
1683736992619,MAE 30B,A00,186445,Bahadori; Mohammad Yousef,81,0,100,19
1683736993643,MAE 40,A00,186592,Bewley; Thomas R,10,0,50,40
1683736994670,MAE 101B,A00,186593,Bahadori; Mohammad Yousef,79,0,100,21
1683736995697,MAE 105,A00,186594,Bandaru; Prabhakar,10,0,50,40
1683736996721,MAE 107,A00,186599,Pham; Hieu Tan,0,8,120,120
1683736997744,MAE 148,A01,186660,Silberman; Jack,3,0,16,13
1683736998769,MATH 10A,A01,188095,Staff,0,6,35,35
1683736999793,MATH 10B,A01,188097,Bowers; Adam R.,0,12,30,30
1683736999793,MATH 10B,A02,188099,Bowers; Adam R.,0,11,30,30
1683736999793,MATH 10B,B01,188104,Bowers; Adam R.,0,10,30,30
1683736999793,MATH 10B,B02,188106,Bowers; Adam R.,0,9,30,30
1683737000818,MATH 10C,A01,188111,Staff,0,20,30,30
1683737000818,MATH 10C,A02,188127,Staff,0,19,30,30
1683737000818,MATH 10C,A03,188131,Staff,0,19,30,30
1683737000818,MATH 10C,B01,188218,Staff,17,0,30,13
1683737000818,MATH 10C,B02,188244,Staff,13,0,30,17
1683737000818,MATH 10C,B03,188277,Staff,14,0,30,16
1683737001847,MATH 18,A01,188344,Bach; Quang Tran,18,0,30,12
1683737001847,MATH 18,A02,188345,Bach; Quang Tran,11,0,30,19
1683737001847,MATH 18,B01,188353,Bach; Quang Tran,11,0,30,19
1683737001847,MATH 18,B02,188354,Bach; Quang Tran,19,0,30,11
1683737002894,MATH 20A,A01,188374,Staff,10,0,35,25
1683737003923,MATH 20B,A01,188382,Ohm; Ko Woon,7,0,30,23
1683737003923,MATH 20B,A02,188383,Ohm; Ko Woon,22,0,30,8
1683737003923,MATH 20B,B01,188385,Ohm; Ko Woon,7,0,30,23
1683737003923,MATH 20B,B02,188392,Ohm; Ko Woon,22,0,30,8
1683737004951,MATH 20C,A01,188394,Harel; Guershon,10,0,30,20
1683737004951,MATH 20C,A02,188395,Harel; Guershon,13,0,30,17
1683737004951,MATH 20C,B01,188404,Harel; Guershon,5,0,30,25
1683737004951,MATH 20C,B02,188405,Harel; Guershon,18,0,30,12
1683737005980,MATH 20D,A01,188414,Hammock; Frances H,0,1,30,30
1683737005980,MATH 20D,A02,188415,Hammock; Frances H,0,1,30,30
1683737005980,MATH 20D,B01,188447,Hammock; Frances H,0,1,30,30
1683737005980,MATH 20D,B02,188486,Hammock; Frances H,2,0,30,28
1683737007004,MATH 20E,A01,188649,Staff,21,0,30,9
1683737007004,MATH 20E,A02,188650,Staff,20,0,30,10
1683737007004,MATH 20E,A03,188673,Staff,0,0,30,30
1683737008028,MATH 102,A01,188675,Staff,0,40,35,35
1683737009054,MATH 103B,A01,188681,Staff,3,0,35,32
1683737009054,MATH 103B,B01,188692,Staff,5,0,35,30
1683737010081,MATH 109,A01,188695,Salehi Golsefidy; Alireza,24,0,35,11
1683737010081,MATH 109,A02,188696,Salehi Golsefidy; Alireza,24,0,35,11
1683737011104,MATH 120A,A01,188698,Eggers; John Dietrich,7,0,35,28
1683737012135,MATH 142B,A01,188736,Ioana; Adrian,0,0,30,30
1683737012135,MATH 142B,A02,188741,Ioana; Adrian,0,1,30,30
1683737012135,MATH 142B,A03,188743,Ioana; Adrian,0,3,30,30
1683737013159,MATH 168A,A01,188790,Staff,0,11,35,35
1683737014188,MATH 170A,A01,188803,Nie; Jiawang,0,2,35,35
1683737014188,MATH 170A,A02,188811,Nie; Jiawang,0,1,35,35
1683737014188,MATH 170A,A03,188814,Nie; Jiawang,1,0,35,34
1683737014188,MATH 170A,A04,188815,Nie; Jiawang,4,0,35,31
1683737015218,MATH 193B,A01,188817,Staff,0,0,35,35
1683737015218,MATH 193B,A02,188818,Staff,6,0,35,29
1683737016246,MGT 4,A01,202857,Anderson; John Charles,59,0,80,21
1683737017270,MGT 12,A00,202858,Lindenberger; Wade Douglas,39,0,90,51
1683737018294,MGT 18,A00,202859,Staff,73,0,90,17
1683737019318,MGT 18GS,A00,202860,McKay; Michael J,13,0,28,15
1683737020343,MGT 45,A00,202861,Pecore; Joseph P.,8,0,90,82
1683737021365,MGT 100,A00,202863,Yavorsky; Daniel Ryan,27,0,90,63
1683737022388,MGT 103,A00,202864,Ehrich; Kristine R,0,19,90,90
1683737023420,MGT 112,A00,202865,Ehrich; Kristine R,15,0,90,75
1683737024448,MGT 121A,A00,202868,Staff,70,0,90,20
1683737025474,MGT 131B,A00,202869,Anderson; John Charles,58,0,90,32
1683737026502,MGT 136,A00,202871,Lindenberger; Wade Douglas,83,0,90,7
1683737027526,MGT 164,A00,202873,Staff,0,67,90,91
1683737028552,MGT 164GS,A00,202874,McKay; Mary A,13,0,28,15
1683737029584,MGT 180,A00,202875,Staff,0,51,90,91
1683737030611,MMW 11R,A01,205019,Herbst; Matthew,0,0,30,30
1683737030611,MMW 11R,A02,205026,Herbst; Matthew,29,0,30,1
1683737031638,MMW 15,A01,193512,Chang; Edmond Yi-Teh,0,8,28,28
1683737031638,MMW 15,A02,193513,Chang; Edmond Yi-Teh,0,5,28,28
1683737031638,MMW 15,A03,193514,Chang; Edmond Yi-Teh,0,5,28,28
1683737031638,MMW 15,A04,193515,Chang; Edmond Yi-Teh,0,5,28,28
1683737031638,MMW 15,A05,193516,Chang; Edmond Yi-Teh,0,5,28,28
1683737031638,MMW 15,A06,193517,Chang; Edmond Yi-Teh,0,6,28,28
1683737031638,MMW 15,B01,193519,Chang; Edmond Yi-Teh,0,5,28,28
1683737031638,MMW 15,B02,193520,Chang; Edmond Yi-Teh,0,5,28,28
1683737031638,MMW 15,B03,193521,Chang; Edmond Yi-Teh,0,5,28,28
1683737031638,MMW 15,B04,193522,Chang; Edmond Yi-Teh,0,6,28,28
1683737031638,MMW 15,B05,193523,Chang; Edmond Yi-Teh,0,5,28,28
1683737031638,MMW 15,B06,193524,Chang; Edmond Yi-Teh,0,5,28,28
1683737032666,MMW 122,A01,193526,Rahimi; Babak,0,16,28,28
1683737032666,MMW 122,A02,193527,Rahimi; Babak,0,15,28,28
1683737032666,MMW 122,A03,193528,Rahimi; Babak,0,0,0,0
1683737032666,MMW 122,A04,193529,Rahimi; Babak,0,0,0,0
1683737033694,MUS 1A,A01,186663,Staff,0,18,35,35
1683737034718,MUS 4,A01,186715,Staff,0,12,35,35
1683737035743,MUS 5R,A01,186796,Dubnov; Shlomo,0,17,35,35
1683737036770,MUS 6,A01,186798,Staff,0,4,25,25
1683737037794,MUS 7,A01,186830,Staff,11,0,35,24
1683737038818,MUS 8,A01,186930,Staff,0,27,35,35
1683737039842,MUS 15,A01,186932,Staff,0,15,35,35
1683737039842,MUS 15,B01,186934,Staff,0,16,35,35
1683737040874,MUS 80,A00,186935,Staff,0,0,20,20
1683737040874,MUS 80,B00,186936,Staff,24,0,25,1
1683737041896,NANO 11,A00,204702,Lipomi; Darren John,0,0,0,0
1683737042924,NANO 15,A01,204709,Yang; Kesong,0,1,0,0
1683737043953,NANO 114,A00,202069,Jahed Motlagh; Zeinab,2,0,10,8
1683737044979,PHIL 1,A00,186955,Grush; Rick Scott,31,0,40,9
1683737046003,PHIL 10,A01,186973,Grush; Rick Scott,27,0,35,8
1683737046003,PHIL 10,A02,186974,Grush; Rick Scott,33,0,35,2
1683737047027,PHIL 13,A01,186976,Staff,1,0,35,34
1683737047027,PHIL 13,A02,186977,Staff,16,0,35,19
1683737048051,PHIL 14,A01,186979,Staff,30,0,35,5
1683737048051,PHIL 14,A02,186986,Staff,32,0,35,3
1683737049079,PHIL 28,A01,186988,Staff,16,0,30,14
1683737049079,PHIL 28,A02,186989,Staff,0,0,30,30
1683737049079,PHIL 28,A03,186990,Staff,10,0,30,20
1683737049079,PHIL 28,A04,186991,Staff,26,0,30,4
1683737050106,PHIL 120,A00,186997,Staff,23,0,40,17
1683737051129,PHIL 137,A00,187003,Staff,8,0,40,32
1683737052155,PHIL 150,A00,187015,Staff,47,0,70,23
1683737053182,PHIL 167,A00,187021,Lamey; Andy M.,34,0,40,6
1683737054209,PHIL 174,A01,202226,Staff,17,0,20,3
1683737054209,PHIL 174,A02,202235,Staff,20,0,20,0
1683737055232,PHIL 191A,A00,258918,Staff,0,0,1,1
1683737056257,PHYS 1A,A00,187028,Staff,26,0,60,34
1683737057281,PHYS 1AL,001,187036,Staff,3,0,30,27
1683737057281,PHYS 1AL,002,187049,Staff,18,0,30,12
1683737058306,PHYS 1B,A00,187058,Staff,21,0,60,39
1683737059330,PHYS 1BL,001,187064,Staff,0,1,30,30
1683737059330,PHYS 1BL,002,187070,Staff,4,0,30,26
1683737060357,PHYS 1C,A00,187082,Staff,30,0,120,90
1683737061382,PHYS 1CL,001,187088,Staff,0,9,30,30
1683737061382,PHYS 1CL,002,187089,Staff,0,1,30,30
1683737061382,PHYS 1CL,009,262693,Staff,9,0,30,21
1683737062408,PHYS 2B,A01,187097,Staff,55,0,115,60
1683737063431,PHYS 2C,A01,187099,Staff,63,0,115,52
1683737064459,PHYS 2CL,A01,187101,Staff,5,0,28,23
1683737064459,PHYS 2CL,A02,187102,Staff,15,0,28,13
1683737065483,PHYS 2D,A01,187123,Shotwell; Brian,95,0,115,20
1683737066510,PHYS 4B,A01,187133,Grinstein; Benjamin,34,0,50,16
1683737067534,POLI 10,A00,188819,Staff,0,4,50,50
1683737068557,POLI 11,A00,188827,Staff,43,0,50,7
1683737069589,POLI 13R,A00,188828,Staff,0,2,20,20
1683737070611,POLI 27,A01,188830,Elgin; Samuel Zincke,0,2,70,70
1683737071636,POLI 30,A00,188832,Desposato; Scott,30,0,50,20
1683737072663,POLI 102F,A00,188834,Staff,1,0,40,39
1683737073687,POLI 104A,A00,188852,Staff,12,0,30,18
1683737074711,POLI 104I,A00,188853,Staff,0,8,20,20
1683737075740,POLI 110B,A00,188854,Wiens; David,6,0,20,14
1683737076765,POLI 112A,A00,188855,Wiens; David,4,0,30,26
1683737077789,POLI 117R,A00,188856,Forman; Fonna,0,12,20,20
1683737078813,POLI 118,A00,188857,Ingham; Sean,8,0,20,12
1683737079840,POLI 120G,A00,188858,Staff,7,0,30,23
1683737080864,POLI 131CR,A00,188863,Hoston; Germaine,20,0,50,30
1683737081888,POLI 133,A00,188864,Nellis; Gareth Hb,44,0,50,6
1683737082916,POLI 134D,A00,188865,Desposato; Scott,27,0,30,3
1683737083940,POLI 142A,A00,188871,Gartzke; Erik,21,0,50,29
1683737084965,POLI 142K,A00,188874,Staff,38,0,50,12
1683737085989,POLI 143,A00,188940,Gartzke; Erik,15,0,30,15
1683737087013,POLI 153,A00,188943,Staff,1,0,20,19
1683737088037,POLI 160AA,A00,188944,Staff,10,0,40,30
1683737089062,POLI 170A,A00,188945,Staff,10,0,30,20
1683737091173,PSYC 1,A00,188952,Staff,36,0,90,54
1683737092196,PSYC 2,B00,188953,Staff,19,0,35,16
1683737093220,PSYC 6,A00,188970,Staff,47,0,60,13
1683737094250,PSYC 7,A00,188973,Staff,35,0,45,10
1683737095275,PSYC 60,A01,188980,Rickard; Timothy C.,42,0,60,18
1683737096299,PSYC 70,A01,189001,Steiner; Eric Tomas,21,0,45,24
1683737097323,PSYC 100,A00,189005,Lacefield; Katharine I,1,98,120,119
1683737098348,PSYC 102,A00,189008,Staff,6,0,30,24
1683737099378,PSYC 106,B00,189026,Gorman; Michael R.,26,0,60,34
1683737100404,PSYC 114,B01,189033,Winkielman; Piotr,0,31,30,30
1683737101434,PSYC 131,A00,189036,Anagnostaras; Stephan,0,44,60,60
1683737102461,PSYC 136,A00,189041,Lowe; Angela Beth,0,7,25,25
1683737103485,PSYC 137,A00,189057,Winkielman; Piotr,0,36,25,25
1683737104511,PSYC 144,A00,189107,Wixted; John T,0,11,50,50
1683737106560,PSYC 162,A00,189142,Staff,0,9,85,85
1683737107583,PSYC 172,A00,189144,Gorman; Michael R.,0,6,30,30
1683737109634,PSYC 179,A00,189146,Lacefield; Katharine I,0,88,120,120
1683737110663,PSYC 181,A00,189147,Anagnostaras; Stephan,110,45,200,90
1683737111686,PSYC 190R,A00,189148,Barner; David A.,0,23,80,80
1683737112718,PSYC 191,A00,189275,Rickard; Timothy C.,0,11,25,25
1683737113744,PSYC 193,A00,189276,Chapman; Eddie Nathaniel,0,1,0,4
1683737114769,PSYC 193L,A01,189281,Lowe; Angela Beth,8,0,20,12
1683737114769,PSYC 193L,B01,189285,Staff,28,0,35,7
1683737115797,RELI 149,A00,187137,Rahimi; Babak,6,0,40,34
1683737116822,SE 9,A01,187315,Staff,0,2,18,18
1683737117846,SE 101B,A00,187409,Staff,24,0,30,6
1683737118873,SE 110B,A00,187444,Staff,10,0,40,30
1683737119897,SE 130B,A00,187449,Staff,31,0,40,9
1683737120921,SE 150A,A00,187516,Staff,8,0,20,12
1683737121946,SE 154,A00,187528,Staff,29,0,50,21
1683737122969,SIO 3,A01,258171,Staff,35,0,40,5
1683737123993,SIO 10,A00,187144,Cook; Geoffrey W,0,6,75,75
1683737125016,SIO 45,A00,187152,Cook; Geoffrey W,1,7,100,99
1683737126040,SIO 109R,A00,194486,Staff,0,4,20,20
1683737128089,SIO 187,A01,187233,Kacev; David,12,0,40,28
1683737129116,SOCI 1,A01,258656,Thorpe; Charles Robert,28,0,30,2
1683737129116,SOCI 1,A02,258658,Thorpe; Charles Robert,30,0,30,0
1683737129116,SOCI 1,A03,258661,Thorpe; Charles Robert,25,0,25,0
1683737129116,SOCI 1,A04,258666,Thorpe; Charles Robert,22,0,25,3
1683737129116,SOCI 1,A05,258897,Thorpe; Charles Robert,22,0,25,3
1683737129116,SOCI 1,A06,258898,Thorpe; Charles Robert,25,0,25,0
1683737130143,SOCI 30,A01,258903,Pardo Guerra; Juan Pablo,14,0,30,16
1683737131165,SOCI 102,A00,258904,Staff,9,0,25,16
1683737132189,SOCI 106,A00,258905,Staff,19,0,25,6
1683737133215,SOCI 111,A00,258907,Ribas Norris; Janet Vanesa,26,0,30,4
1683737134245,SOCI 121R,A00,258908,Pardo Guerra; Juan Pablo,7,0,30,23
1683737135268,SOCI 126,A01,203330,Staff,14,0,20,6
1683737136294,SOCI 131,A00,258909,Thorpe; Charles Robert,30,0,60,30
1683737137318,SOCI 135,A00,258910,Payne; Christine Anna,0,13,30,30
1683737138342,SOCI 157,A00,258911,Staff,10,0,30,20
1683737139366,SOCI 184,A00,258912,Staff,25,0,30,5
1683737140396,SOCI 188D,A00,258913,Staff,22,0,30,8
1683737141423,SYN 2,001,187529,Staff,9,0,16,7
1683737141423,SYN 2,002,201452,Staff,0,20,16,16
1683737141423,SYN 2,003,201469,Staff,1,0,16,15
1683737142450,SYN 100,A01,187531,Staff,0,9,20,20
1683737142450,SYN 100,B01,201491,Staff,0,10,20,20
1683737143475,TDAC 1,A00,189286,Walsh; Kim C.,3,0,20,17
1683737143475,TDAC 1,B00,189287,Harting; Carla Kelso,10,0,20,10
1683737144499,TDAC 101,A00,189300,Walsh; Kim C.,16,0,20,4
1683737144499,TDAC 101,B00,189301,Harting; Carla Kelso,18,0,20,2
1683737145528,TDAC 102,A00,189304,Basso; Beatrice,14,0,20,6
1683737146551,TDAC 108,A00,189305,Staff,18,0,20,2
1683737147580,TDDE 131,A00,189310,Staff,19,0,20,1
1683737147580,TDDE 131,B00,189314,Staff,19,0,20,1
1683737147580,TDDE 131,C00,189315,Staff,48,0,50,2
1683737147580,TDDE 131,D00,189316,Staff,14,0,15,1
1683737147580,TDDE 131,E00,204841,Staff,20,0,20,0
1683737148607,TDGE 10,A00,189289,Staff,26,0,50,24
1683737148607,TDGE 10,B00,189290,Havis; Allan,0,1,50,50
1683737149632,TDGE 11,A00,189291,Fulton; Julia,0,4,50,50
1683737149632,TDGE 11,B00,189292,Staff,20,0,25,5
1683737149632,TDGE 11,C00,260270,Staff,0,0,0,0
1683737150658,TDGE 25,A00,189294,Staff,1,0,20,19
1683737151683,TDGE 124,A00,189318,Fulton; Julia,0,7,50,50
1683737152712,TDGE 125,A00,189319,Staff,13,0,25,12
1683737152712,TDGE 125,B00,189320,Staff,23,0,25,2
1683737153743,TDGE 127,A00,189322,Havis; Allan,1,0,50,49
1683737154770,TDHT 101,A00,189323,Staff,18,0,25,7
1683737154770,TDHT 101,B00,189324,Staff,25,0,25,0
1683737155798,TDHT 102,A00,189325,Staff,49,0,50,1
1683737156826,TDMV 1,A00,189295,Arcidiacono; Kristin,20,0,30,10
1683737156826,TDMV 1,B00,189296,Caligagan; Maria T.,23,0,30,7
1683737157855,TDMV 2,A00,189297,Sammartano; Tonnie,27,0,30,3
1683737157855,TDMV 2,B00,189299,Arcidiacono; Kristin,23,0,30,7
1683737158879,TDMV 3,A00,204998,Rincon; Alicia,22,0,30,8
1683737159906,TDMV 120,A00,189458,Sammartano; Tonnie,28,0,30,2
1683737160933,TDMV 138,A00,189541,Jun; Grace Shin Hae,20,0,40,20
1683737161958,TDMV 142,A00,189717,Caligagan; Tony,25,0,30,5
1683737161958,TDMV 142,B00,189718,Caligagan; Maria T.,25,0,30,5
1683737162986,TMC 2,A01,187533,Staff,25,0,25,0
1683737162986,TMC 2,A02,187534,Staff,25,0,25,0
1683737164010,USP 1,A01,187536,Kwak; Nancy,0,16,25,25
1683737165035,USP 5,A01,187538,Staff,8,0,25,17
1683737166063,USP 101,A00,199253,Staff,0,4,0,0
1683737167087,USP 124,A00,187562,Boomhower; Matthew Charles,1,0,30,29
1683737168111,USP 138,A00,187582,Staff,19,0,25,6
1683737169135,USP 152,A01,187597,Staff,3,0,25,22
1683737170161,USP 153,A00,187598,Staff,18,0,25,7
1683737171184,USP 168,A00,187607,Kwak; Nancy,2,0,5,3
1683737172208,USP 173,A00,187619,Staff,4,0,25,21
1683737173234,USP 181,A00,187638,Staff,0,4,25,25
1683737174261,VIS 103,A00,187650,Cruz; Edwin Teddy,17,0,75,58
1683737175289,VIS 110D,A00,187669,Staff,13,0,22,9
1683737176317,VIS 127C,A00,187720,Shen; Kuiyi,67,0,146,79
1683737177344,VIS 149,A00,187731,Yoldas; Pinar,0,12,22,22
1683737178368,VIS 151,A01,188091,Staff,22,0,34,12
1683737178368,VIS 151,A02,188092,Staff,11,0,34,23
1683737179395,VIS 160B,A00,188093,Stalbaum; Brett,0,1,10,10
1683737181448,WCWP 10B,A00,201720,Staff,0,0,5,5
1683737181448,WCWP 10B,B00,201722,Staff,0,0,6,6
1683737182472,WCWP 100,A00,201725,Gagnon; Jeffrey C,0,0,2,2
1683737182472,WCWP 100,B00,201727,Staff,0,4,15,15
1683737185571,ANBI 133,A00,258401,Wilder; Linnea Lorene,34,0,40,6
1683737186595,ANBI 140,A00,258395,Hrvoj Mihic; Branka,18,0,25,7
1683737187619,ANSC 120,A00,258402,Bialecki; Jon Anthony,26,0,40,14
1683737188650,ANSC 144,A00,258400,Staff,12,0,40,28
1683737190704,ANSC 166,A00,258396,Parish; Steven Martin,156,0,175,19
1683737191731,ANSC 180,A00,193533,Staff,8,0,20,12
1683737192755,ANSC 188,A00,258397,Jassal; Aftab,34,0,40,6
1683737193834,ANTH 3,A01,258316,Staff,23,0,30,7
1683737194861,ANTH 5,A00,258394,Semendeferi; Ekaterini,16,0,20,4
1683737195887,ANTH 21,A01,258331,Staff,4,0,40,36
1683737196915,ANTH 103,A00,258398,Varma; Saiba,15,0,25,10
1683737197941,AWP 10,001,202034,Staff,0,0,0,0
1683737197941,AWP 10,002,202035,Staff,0,0,0,0
1683737197941,AWP 10,003,202036,Staff,0,0,0,0
1683737197941,AWP 10,004,202037,Staff,0,0,0,0
1683737197941,AWP 10,005,202038,Staff,0,0,0,0
1683737197941,AWP 10,006,202039,Staff,0,0,0,0
1683737197941,AWP 10,007,202040,Staff,0,0,0,0
1683737197941,AWP 10,008,202041,Staff,0,0,0,0
1683737197941,AWP 10,009,202042,Staff,0,0,0,0
1683737197941,AWP 10,010,202043,Staff,0,0,0,0
1683737197941,AWP 10,011,202044,Staff,0,0,0,0
1683737197941,AWP 10,012,202045,Staff,0,0,0,0
1683737197941,AWP 10,013,202046,Staff,0,0,0,0
1683737197941,AWP 10,014,202047,Staff,0,0,0,0
1683737197941,AWP 10,015,202048,Staff,0,0,0,0
1683737197941,AWP 10,016,202049,Staff,0,0,0,0
1683737197941,AWP 10,017,202050,Staff,0,0,0,0
1683737197941,AWP 10,018,202051,Staff,0,0,0,0
1683737197941,AWP 10,019,202052,Staff,0,0,0,0
1683737197941,AWP 10,020,202053,Staff,0,0,0,0
1683737197941,AWP 10,021,202054,Staff,0,0,0,0
1683737197941,AWP 10,022,202055,Staff,0,0,0,0
1683737197941,AWP 10,023,202056,Staff,0,0,0,0
1683737197941,AWP 10,024,202057,Staff,0,0,0,0
1683737197941,AWP 10,025,202058,Staff,0,0,0,0
1683737197941,AWP 10,026,202059,Staff,0,0,0,0
1683737198964,AWP 102,001,202032,Staff,0,0,0,0
1683737198964,AWP 102,002,202033,Staff,0,0,0,0
1683737199989,BENG 100,A01,254234,Taylor Amos; Alyssa C,31,0,40,9
1683737201013,BENG 196,001,270013,Engler; Adam J.,9999,0,9999,0
1683737202039,BICD 100R,A01,202018,Smith; Laurie,0,7,32,32
1683737202039,BICD 100R,A02,202019,Smith; Laurie,0,3,32,32
1683737202039,BICD 100R,A03,202020,Smith; Laurie,0,1,32,32
1683737202039,BICD 100R,A04,202021,Smith; Laurie,6,0,32,26
1683737202039,BICD 100R,A05,202022,Smith; Laurie,10,0,32,22
1683737203064,BICD 136,A01,193242,Gustafson-Brown; Cindy,0,2,32,32
1683737203064,BICD 136,A02,193244,Gustafson-Brown; Cindy,13,0,32,19
1683737204094,BIEB 102,A01,193249,Butler; Shannon Rhey,0,0,32,32
1683737204094,BIEB 102,A02,193251,Butler; Shannon Rhey,0,0,32,32
1683737204094,BIEB 102,A03,193253,Butler; Shannon Rhey,0,0,32,32
1683737204094,BIEB 102,A04,193255,Butler; Shannon Rhey,13,0,32,19
1683737204094,BIEB 102,A05,193265,Butler; Shannon Rhey,25,0,32,7
1683737204094,BIEB 102,A06,193269,Butler; Shannon Rhey,12,0,32,20
1683737206143,BIEB 150,A01,193274,Staff,0,0,32,32
1683737206143,BIEB 150,A02,193285,Staff,24,0,32,8
1683737207172,BIEB 194,A00,193286,Kurle; Carolyn M.,19,0,32,13
1683737208201,BILD 1,A01,192291,Staff,15,0,32,17
1683737208201,BILD 1,A02,192292,Staff,30,0,32,2
1683737208201,BILD 1,B01,192520,Reuther; Keefe,0,1,0,0
1683737208201,BILD 1,B02,192532,Reuther; Keefe,0,1,0,0
1683737209226,BILD 3,A01,192556,Butler; Shannon Rhey,0,0,32,32
1683737209226,BILD 3,A02,192581,Butler; Shannon Rhey,0,1,32,32
1683737209226,BILD 3,A03,192611,Butler; Shannon Rhey,19,0,32,13
1683737209226,BILD 3,A04,192612,Butler; Shannon Rhey,23,0,32,9
1683737209226,BILD 3,A05,192613,Butler; Shannon Rhey,26,0,32,6
1683737209226,BILD 3,A06,192679,Butler; Shannon Rhey,27,0,32,5
1683737209226,BILD 3,A07,192682,Butler; Shannon Rhey,20,0,32,12
1683737210250,BILD 4,A01,192836,Reuther; Keefe,1,0,24,23
1683737210250,BILD 4,A02,193044,Reuther; Keefe,4,0,24,20
1683737211278,BILD 10,A01,193142,Gustafson-Brown; Cindy,29,0,32,3
1683737211278,BILD 10,A02,193149,Gustafson-Brown; Cindy,31,0,32,1
1683737212305,BIMM 100,A01,193301,Staff,0,6,32,32
1683737212305,BIMM 100,A02,193312,Staff,0,7,32,32
1683737212305,BIMM 100,A03,193323,Staff,0,10,32,32
1683737213332,BIMM 101,A01,193329,McDonnell; Lisa Marie,0,3,24,24
1683737213332,BIMM 101,A02,193339,McDonnell; Lisa Marie,0,3,24,24
1683737213332,BIMM 101,B01,193354,McDonnell; Lisa Marie,0,4,24,24
1683737213332,BIMM 101,B02,193357,McDonnell; Lisa Marie,0,3,24,24
1683737214362,BIMM 110,A01,193377,Tat; John,0,11,32,32
1683737214362,BIMM 110,A02,193378,Tat; John,0,11,32,32
1683737215386,BIMM 120,A01,206116,Staff,1,0,32,31
1683737215386,BIMM 120,A02,206117,Staff,7,0,32,25
1683737215386,BIMM 120,A03,206121,Staff,21,0,32,11
1683737216415,BIPN 100,A01,193393,Park; Ji Young,0,15,32,32
1683737216415,BIPN 100,A02,193402,Park; Ji Young,0,14,32,32
1683737216415,BIPN 100,A03,193413,Park; Ji Young,0,14,32,32
1683737216415,BIPN 100,A04,193414,Park; Ji Young,0,13,32,32
1683737217439,BIPN 102,A01,193429,Staff,0,0,32,32
1683737217439,BIPN 102,A02,193438,Staff,18,0,32,14
1683737218467,BIPN 106,A01,193450,Reyes Gonzalez; Catalina,0,2,40,40
1683737219493,BIPN 134,A01,193465,Cooke; James Edward,0,0,32,32
1683737219493,BIPN 134,A02,193474,Cooke; James Edward,24,0,32,8
1683737219493,BIPN 134,A03,193485,Cooke; James Edward,29,0,32,3
1683737219493,BIPN 134,A04,193486,Cooke; James Edward,20,0,32,12
1683737219493,BIPN 134,A05,193491,Cooke; James Edward,31,0,32,1
1683737219493,BIPN 134,A06,193501,Cooke; James Edward,30,0,32,2
1683737219493,BIPN 134,A07,193510,Cooke; James Edward,29,0,32,3
1683737221542,BISP 194,A00,222522,Staff,14,0,32,18
1683737222572,CAT 124,A01,202407,Staff,19,0,25,6
1683737223596,CAT 125,A00,202408,Marchisotto; Jennifer Anne,2,0,20,18
1683737224622,CAT 125R,A00,202409,Smith; Lauryn Alissa,0,11,20,20
1683737224622,CAT 125R,B00,202410,Morales; Celeste Georgianna,0,11,20,20
1683737224622,CAT 125R,C00,202411,Irwin; Matthew Joseph,0,12,20,20
1683737225652,CENG 15,A01,204712,Yang; Kesong,0,1,0,0
1683737226680,CENG 114,A00,202070,Jahed Motlagh; Zeinab,5,0,20,15
1683737227704,CGS 105,A00,185477,Wesling; Megan E.,24,0,40,16
1683737228735,CGS 106,A00,185494,Staff,11,0,22,11
1683737229759,CGS 108,A00,185495,Staff,14,0,20,6
1683737230794,CGS 114,A00,185496,Staff,13,0,18,5
1683737231818,CGS 119,A00,185501,Staff,15,0,20,5
1683737232846,CGS 120,A00,185511,Staff,11,0,20,9
1683737233875,CHEM 4,A01,184675,Bussey; Thomas J,97,0,100,3
1683737234900,CHEM 6A,A01,184677,Staff,32,0,60,28
1683737235926,CHEM 6B,A01,184679,Staff,63,0,100,37
1683737236955,CHEM 6C,A01,184681,Bussey; Thomas J,0,0,50,50
1683737236955,CHEM 6C,A02,184682,Bussey; Thomas J,32,0,50,18
1683737237979,CHEM 40A,A01,184684,Albizati; Kim F.,33,0,100,67
1683737239006,CHEM 40B,A01,184686,Albizati; Kim F.,0,22,100,100
1683737240034,CHEM 41B,A01,184690,Staff,51,0,100,49
1683737241061,COGS 3,A01,184715,Boyle; Mary E. T.,0,27,40,40
1683737242085,COGS 14B,A01,185172,Staff,0,14,38,38
1683737243111,COGS 18,A01,184736,Staff,14,0,80,66
1683737244135,COGS 100,A01,184932,Staff,0,8,73,73
1683737245163,COGS 101A,A01,184935,Staff,0,40,30,30
1683737246189,COGS 101B,A01,184944,Staff,0,2,30,30
1683737247213,COGS 101C,A01,184946,Staff,0,10,30,30
1683737248236,COGS 102A,A01,184951,Johnson; Christine M.,1,0,40,39
1683737249261,COGS 107B,A01,184953,Mooshagian; Eric Frederick,0,52,40,40
1683737250287,COGS 118B,A01,184959,Gupta; Anjum,0,50,40,40
1683737251311,COGS 153,A00,184961,Staff,1,16,30,29
1683737252336,COGS 177,A00,184962,Staff,0,20,30,30
1683737253362,COGS 187A,A01,184969,Boyle; Mary E. T.,0,19,40,40
1683737254386,COMM 10,A01,185174,Staff,0,5,25,25
1683737254386,COMM 10,A02,185189,Staff,0,2,25,25
1683737254386,COMM 10,A03,269821,Staff,0,1,0,0
1683737255411,COMM 100B,A02,185476,Staff,10,0,25,15
1683737255411,COMM 100B,A03,277340,Staff,25,0,25,0
1683737256439,COMM 100C,A01,185314,Staff,2,0,25,23
1683737256439,COMM 100C,A02,185327,Staff,17,0,25,8
1683737257466,COMM 110M,A00,185349,Staff,0,0,40,40
1683737258490,COMM 113T,A00,185352,Staff,25,0,40,15
1683737259512,COMM 114I,A00,185353,Staff,31,0,40,9
1683737260536,COMM 131,A00,185354,Staff,17,0,30,13
1683737261560,CSE 8A,A50,185358,Cao; Yingjun,0,46,10,10
1683737262587,CSE 8B,A01,185362,Staff,0,48,50,50
1683737263610,CSE 11,A01,185416,Cao; Yingjun,0,91,10,10
1683737264635,CSE 20,A01,185445,Briones; Jor-el Thomas Caparas,3,0,25,22
1683737265662,CSE 21,A01,185447,Staff,9,0,50,41
1683737266692,CSE 101,A01,185451,Staff,0,13,50,50
1683737266692,CSE 101,B01,185453,Jones; Miles E,0,15,50,50
1683737268746,CSE 141,A01,185458,Eldon; John,16,0,100,84
1683737269769,CSE 141L,A01,185461,Eldon; John,8,0,100,92
1683737270794,CSE 142,A01,185463,Staff,34,0,60,26
1683737270794,CSE 142,B01,201355,Staff,0,7,60,60
1683737271822,CSE 142L,A01,185470,Staff,34,0,60,26
1683737271822,CSE 142L,B01,201417,Staff,0,6,60,60
1683737272850,CSE 190,A00,201433,Staff,32,0,49,17
1683737273875,DOC 1,A01,259136,Strom; Megan C.,7,0,15,8
1683737273875,DOC 1,A02,259137,Strom; Megan C.,15,0,15,0
1683737273875,DOC 1,A03,259138,Strom; Megan C.,14,0,15,1
1683737273875,DOC 1,A04,259139,Strom; Megan C.,13,0,15,2
1683737274904,DOC 100D,A00,259140,Pass; Natalye Joann,14,0,25,11
1683737275929,DSGN 1,A01,184749,Rill; Bryan,0,26,30,30
1683737276952,DSGN 100,A01,185168,Staff,0,2,25,25
1683737277982,ECE 5,A01,185626,Morris; Karcher William,0,12,0,0
1683737279009,ECE 101,A01,185628,Staff,14,0,70,56
1683737280034,ECE 107,A01,185635,Baghdadchi; Saharnaz,0,0,20,20
1683737280034,ECE 107,A02,185638,Baghdadchi; Saharnaz,1,0,20,19
1683737281067,ECE 148,A01,185647,Silberman; Jack,0,0,16,16
1683737282095,ECON 1,A01,185537,Crane; Meredith Helen,54,0,70,16
1683737283118,ECON 3,A01,185549,Crane; Meredith Helen,30,0,70,40
1683737284142,ECON 4,A01,203354,Anderson; John Charles,0,5,10,10
1683737285165,ECON 100A,A01,185574,Staff,0,5,40,40
1683737286192,ECON 100B,A01,185576,Staff,0,12,50,50
1683737287218,ECON 100C,A01,185589,Newhouse; Herbert S,30,0,70,40
1683737288243,ECON 105,A00,185608,Vespa; Emanuel Ignacio,19,0,35,16
1683737289274,ECON 109,A01,185610,Shishkin; Denis,9,0,35,26
1683737290306,ECON 110A,A01,185612,Staff,8,0,40,32
1683737291334,ECON 120A,A01,185615,Staff,19,0,40,21
1683737292365,ECON 120C,A01,185617,Sun; Yixiao,0,21,70,70
1683737293387,ECON 144,A00,203346,Squires; Dale E,2,0,35,33
1683737294411,ECON 171,A01,203349,Newhouse; Herbert S,0,1,35,35
1683737295435,ECON 173A,A01,185621,Toda; Alexis Akira,21,0,35,14
1683737296463,EDS 25,A01,202413,Staff,0,1,0,0
1683737296463,EDS 25,A02,202414,Staff,0,1,0,0
1683737296463,EDS 25,A03,202415,Staff,0,0,0,0
1683737296463,EDS 25,A04,202416,Staff,0,1,0,0
1683737296463,EDS 25,A05,202439,Staff,0,0,0,0
1683737296463,EDS 25,A06,202440,Staff,0,0,0,0
1683737296463,EDS 25,B01,202631,Staff,0,0,0,0
1683737296463,EDS 25,B02,202632,Staff,0,0,0,0
1683737296463,EDS 25,B03,202639,Staff,0,0,0,0
1683737296463,EDS 25,B04,202640,Staff,0,0,0,0
1683737296463,EDS 25,B05,202643,Staff,0,0,0,0
1683737296463,EDS 25,B06,202644,Staff,0,0,0,0
1683737297547,EDS 38,A01,202659,Black; Alison Michelle,25,0,25,0
1683737298573,EDS 115,A00,202652,Staff,18,0,30,12
1683737299596,EDS 125,A00,202649,Staff,13,0,30,17
1683737300621,EDS 126,A01,203332,Staff,30,0,30,0
1683737301648,EDS 139,A00,202838,Staff,16,0,25,9
1683737302671,EDS 146,A01,202655,Staff,14,0,25,11
1683737303710,ENG 15,A00,185667,Staff,0,1,0,2
1683737303710,ENG 15,B00,185672,Staff,0,0,0,1
1683737303710,ENG 15,C00,185675,Staff,0,0,0,0
1683737303710,ENG 15,D00,185682,Staff,0,0,0,0
1683737303710,ENG 15,E00,185684,Staff,0,0,0,0
1683737304735,ETHN 103,A00,185710,Staff,0,8,35,35
1683737305762,ETHN 103A,A00,199228,Man; Simeon S,0,0,9,9
1683737306790,ETHN 109,A00,185711,Staff,15,0,35,20
1683737307814,ETHN 142,A00,185726,Staff,0,4,30,30
1683737308839,ETHN 163J,A00,199229,Man; Simeon S,5,0,8,3
1683737309863,ETHN 168,A00,185727,Staff,7,0,10,3
1683737310887,ETHN 182,A00,185728,Staff,0,0,35,35
1683737311911,ETHN 183,A00,185737,Staff,10,0,18,8
1683737312936,GLBH 111,A01,209361,Burgos; Jose L.,0,0,0,0
1683737314987,HIEU 104,A00,185792,Staff,14,0,20,6
1683737316011,HIEU 115,A00,185800,Staff,0,0,20,20
1683737317037,HIEU 128,A00,185801,Staff,0,9,20,20
1683737318061,HIEU 147,A00,185802,Staff,15,0,20,5
1683737319087,HIEU 154,A00,185823,Staff,11,0,20,9
1683737320112,HILA 102,A00,185826,Staff,14,0,20,6
1683737321138,HILD 2C,A01,185778,Staff,0,13,20,20
1683737322162,HILD 7B,A01,185780,Kwak; Nancy,0,17,32,32
1683737322162,HILD 7B,A02,185781,Kwak; Nancy,0,18,32,32
1683737323186,HILD 30,A01,185791,Staff,12,0,20,8
1683737324210,HISC 119,A00,185830,Golan; Tal,0,10,20,20
1683737325236,HITO 156GS,A00,185831,Patterson; Patrick H.,0,0,0,23
1683737326260,HIUS 103,A00,185832,Man; Simeon S,0,4,20,20
1683737327285,HIUS 117,A00,185836,Kwak; Nancy,2,0,20,18
1683737328313,HIUS 125,A00,185840,Man; Simeon S,0,2,23,23
1683737329338,HIUS 149,A00,185845,Staff,1,0,20,19
1683737330366,HUM 3,A01,185882,Zavodny; Tatiana Sophia,0,8,50,50
1683737330366,HUM 3,B01,185899,Caldwell; Michael Alan,0,18,50,50
1683737331394,HUM 3GS,A00,185900,Patterson; Patrick H.,0,0,0,23
1683737332421,HUM 4,A01,185938,Zroka; Amy Liane,28,0,50,22
1683737332421,HUM 4,B01,185956,Watkins; Eric,0,6,50,50
1683737332421,HUM 4,B02,202209,Watkins; Eric,0,6,50,50
1683737332421,HUM 4,B03,202210,Watkins; Eric,0,5,50,50
1683737333449,HUM 5,A01,185958,West; Geoffrey Scott,0,1,50,50
1683737333449,HUM 5,A02,202215,West; Geoffrey Scott,0,1,50,50
1683737334474,INTL 190,A00,185959,Gagnon; Jeffrey C,0,0,0,9
1683737334474,INTL 190,B00,185960,Lettieri; Michael Joseph,0,0,0,2
1683737335500,JAPN 180,A00,254509,Staff,4,0,30,26
1683737336524,LATI 10,A01,202853,Kennemore; Amy Michelle,0,0,31,31
1683737336524,LATI 10,A02,202854,Kennemore; Amy Michelle,0,0,32,32
1683737336524,LATI 10,A03,270054,Kennemore; Amy Michelle,30,0,30,0
1683737337548,LATI 180,A00,202855,Kennemore; Amy Michelle,11,0,20,9
1683737338575,LAWS 101,A00,201767,Golan; Tal,0,7,40,40
1683737339599,LIFR 1C,A00,185961,Staff,6,0,20,14
1683737340621,LIFR 1CX,A00,185962,Staff,7,0,20,13
1683737341647,LIFR 1D,A00,185963,Staff,7,0,20,13
1683737342675,LIFR 1DX,A00,185964,Staff,7,0,20,13
1683737343702,LIGN 101,A01,186039,Staff,43,0,50,7
1683737344726,LIGN 165,A00,186040,Staff,14,0,50,36
1683737345753,LTCS 108,A00,186041,Staff,5,0,10,5
1683737346777,LTCS 119,A00,186042,Staff,15,0,20,5
1683737347805,LTCS 130,A00,186043,Wesling; Megan E.,15,0,25,10
1683737349856,LTEA 138,A00,186119,Staff,13,0,40,27
1683737350881,LTEN 124,A00,186148,Staff,5,0,25,20
1683737351905,LTEN 178,A00,186149,Staff,6,0,15,9
1683737352929,LTEN 181,A00,186150,Blanco; John D,34,0,40,6
1683737353955,LTWL 120,A00,186160,Staff,19,0,25,6
1683737354982,LTWL 165,A00,186161,Staff,22,0,25,3
1683737356008,LTWR 100,A00,186162,Staff,0,5,15,15
1683737357033,LTWR 102,A00,186163,Doller; Ben,5,0,15,10
1683737358058,MAE 8,A01,186412,Staff,0,1,0,1
1683737359082,MAE 30B,A00,186445,Bahadori; Mohammad Yousef,81,0,100,19
1683737360107,MAE 40,A00,186592,Bewley; Thomas R,10,0,50,40
1683737361131,MAE 101B,A00,186593,Bahadori; Mohammad Yousef,79,0,100,21
1683737362155,MAE 105,A00,186594,Bandaru; Prabhakar,10,0,50,40
1683737363183,MAE 107,A00,186599,Pham; Hieu Tan,0,8,120,120
1683737364209,MAE 148,A01,186660,Silberman; Jack,3,0,16,13
1683737365231,MATH 10A,A01,188095,Staff,0,6,35,35
1683737366256,MATH 10B,A01,188097,Bowers; Adam R.,0,12,30,30
1683737366256,MATH 10B,A02,188099,Bowers; Adam R.,0,11,30,30
1683737366256,MATH 10B,B01,188104,Bowers; Adam R.,0,10,30,30
1683737366256,MATH 10B,B02,188106,Bowers; Adam R.,0,9,30,30
1683737367281,MATH 10C,A01,188111,Staff,0,20,30,30
1683737367281,MATH 10C,A02,188127,Staff,0,19,30,30
1683737367281,MATH 10C,A03,188131,Staff,0,19,30,30
1683737367281,MATH 10C,B01,188218,Staff,17,0,30,13
1683737367281,MATH 10C,B02,188244,Staff,13,0,30,17
1683737367281,MATH 10C,B03,188277,Staff,14,0,30,16
1683737368309,MATH 18,A01,188344,Bach; Quang Tran,18,0,30,12
1683737368309,MATH 18,A02,188345,Bach; Quang Tran,11,0,30,19
1683737368309,MATH 18,B01,188353,Bach; Quang Tran,11,0,30,19
1683737368309,MATH 18,B02,188354,Bach; Quang Tran,19,0,30,11
1683737369337,MATH 20A,A01,188374,Staff,10,0,35,25
1683737370366,MATH 20B,A01,188382,Ohm; Ko Woon,7,0,30,23
1683737370366,MATH 20B,A02,188383,Ohm; Ko Woon,22,0,30,8
1683737370366,MATH 20B,B01,188385,Ohm; Ko Woon,7,0,30,23
1683737370366,MATH 20B,B02,188392,Ohm; Ko Woon,22,0,30,8
1683737371390,MATH 20C,A01,188394,Harel; Guershon,10,0,30,20
1683737371390,MATH 20C,A02,188395,Harel; Guershon,13,0,30,17
1683737371390,MATH 20C,B01,188404,Harel; Guershon,5,0,30,25
1683737371390,MATH 20C,B02,188405,Harel; Guershon,18,0,30,12
1683737372417,MATH 20D,A01,188414,Hammock; Frances H,0,1,30,30
1683737372417,MATH 20D,A02,188415,Hammock; Frances H,0,1,30,30
1683737372417,MATH 20D,B01,188447,Hammock; Frances H,0,1,30,30
1683737372417,MATH 20D,B02,188486,Hammock; Frances H,2,0,30,28
1683737373446,MATH 20E,A01,188649,Staff,21,0,30,9
1683737373446,MATH 20E,A02,188650,Staff,20,0,30,10
1683737373446,MATH 20E,A03,188673,Staff,0,0,30,30
1683737374472,MATH 102,A01,188675,Staff,0,40,35,35
1683737375502,MATH 103B,A01,188681,Staff,3,0,35,32
1683737375502,MATH 103B,B01,188692,Staff,5,0,35,30
1683737376526,MATH 109,A01,188695,Salehi Golsefidy; Alireza,24,0,35,11
1683737376526,MATH 109,A02,188696,Salehi Golsefidy; Alireza,24,0,35,11
1683737377552,MATH 120A,A01,188698,Eggers; John Dietrich,7,0,35,28
1683737378580,MATH 142B,A01,188736,Ioana; Adrian,0,0,30,30
1683737378580,MATH 142B,A02,188741,Ioana; Adrian,0,1,30,30
1683737378580,MATH 142B,A03,188743,Ioana; Adrian,0,3,30,30
1683737379604,MATH 168A,A01,188790,Staff,0,11,35,35
1683737380628,MATH 170A,A01,188803,Nie; Jiawang,0,2,35,35
1683737380628,MATH 170A,A02,188811,Nie; Jiawang,0,1,35,35
1683737380628,MATH 170A,A03,188814,Nie; Jiawang,1,0,35,34
1683737380628,MATH 170A,A04,188815,Nie; Jiawang,4,0,35,31
1683737381657,MATH 193B,A01,188817,Staff,0,0,35,35
1683737381657,MATH 193B,A02,188818,Staff,6,0,35,29
1683737382681,MGT 4,A01,202857,Anderson; John Charles,59,0,80,21
1683737383708,MGT 12,A00,202858,Lindenberger; Wade Douglas,39,0,90,51
1683737384732,MGT 18,A00,202859,Staff,73,0,90,17
1683737385761,MGT 18GS,A00,202860,McKay; Michael J,13,0,28,15
1683737386788,MGT 45,A00,202861,Pecore; Joseph P.,8,0,90,82
1683737387811,MGT 100,A00,202863,Yavorsky; Daniel Ryan,27,0,90,63
1683737388839,MGT 103,A00,202864,Ehrich; Kristine R,0,19,90,90
1683737389865,MGT 112,A00,202865,Ehrich; Kristine R,15,0,90,75
1683737390893,MGT 121A,A00,202868,Staff,70,0,90,20
1683737391922,MGT 131B,A00,202869,Anderson; John Charles,58,0,90,32
1683737392946,MGT 136,A00,202871,Lindenberger; Wade Douglas,83,0,90,7
1683737393970,MGT 164,A00,202873,Staff,0,67,90,91
1683737394999,MGT 164GS,A00,202874,McKay; Mary A,13,0,28,15
1683737396029,MGT 180,A00,202875,Staff,0,51,90,91
1683737397052,MMW 11R,A01,205019,Herbst; Matthew,0,0,30,30
1683737397052,MMW 11R,A02,205026,Herbst; Matthew,29,0,30,1
1683737398082,MMW 15,A01,193512,Chang; Edmond Yi-Teh,0,8,28,28
1683737398082,MMW 15,A02,193513,Chang; Edmond Yi-Teh,0,5,28,28
1683737398082,MMW 15,A03,193514,Chang; Edmond Yi-Teh,0,5,28,28
1683737398082,MMW 15,A04,193515,Chang; Edmond Yi-Teh,0,5,28,28
1683737398082,MMW 15,A05,193516,Chang; Edmond Yi-Teh,0,5,28,28
1683737398082,MMW 15,A06,193517,Chang; Edmond Yi-Teh,0,6,28,28
1683737398082,MMW 15,B01,193519,Chang; Edmond Yi-Teh,0,5,28,28
1683737398082,MMW 15,B02,193520,Chang; Edmond Yi-Teh,0,5,28,28
1683737398082,MMW 15,B03,193521,Chang; Edmond Yi-Teh,0,5,28,28
1683737398082,MMW 15,B04,193522,Chang; Edmond Yi-Teh,0,6,28,28
1683737398082,MMW 15,B05,193523,Chang; Edmond Yi-Teh,0,5,28,28
1683737398082,MMW 15,B06,193524,Chang; Edmond Yi-Teh,0,5,28,28
1683737399115,MMW 122,A01,193526,Rahimi; Babak,0,16,28,28
1683737399115,MMW 122,A02,193527,Rahimi; Babak,0,15,28,28
1683737399115,MMW 122,A03,193528,Rahimi; Babak,0,0,0,0
1683737399115,MMW 122,A04,193529,Rahimi; Babak,0,0,0,0
1683737400143,MUS 1A,A01,186663,Staff,0,18,35,35
1683737401246,MUS 4,A01,186715,Staff,0,12,35,35
1683737402270,MUS 5R,A01,186796,Dubnov; Shlomo,0,17,35,35
1683737403294,MUS 6,A01,186798,Staff,0,4,25,25
1683737404317,MUS 7,A01,186830,Staff,11,0,35,24
1683737405340,MUS 8,A01,186930,Staff,0,27,35,35
1683737406370,MUS 15,A01,186932,Staff,0,15,35,35
1683737406370,MUS 15,B01,186934,Staff,0,16,35,35
1683737407398,MUS 80,A00,186935,Staff,0,0,20,20
1683737407398,MUS 80,B00,186936,Staff,24,0,25,1
1683737408422,NANO 11,A00,204702,Lipomi; Darren John,0,0,0,0
1683737409445,NANO 15,A01,204709,Yang; Kesong,0,1,0,0
1683737410468,NANO 114,A00,202069,Jahed Motlagh; Zeinab,2,0,10,8
1683737411496,PHIL 1,A00,186955,Grush; Rick Scott,31,0,40,9
1683737412525,PHIL 10,A01,186973,Grush; Rick Scott,27,0,35,8
1683737412525,PHIL 10,A02,186974,Grush; Rick Scott,33,0,35,2
1683737413551,PHIL 13,A01,186976,Staff,1,0,35,34
1683737413551,PHIL 13,A02,186977,Staff,16,0,35,19
1683737414585,PHIL 14,A01,186979,Staff,30,0,35,5
1683737414585,PHIL 14,A02,186986,Staff,32,0,35,3
1683737415613,PHIL 28,A01,186988,Staff,16,0,30,14
1683737415613,PHIL 28,A02,186989,Staff,0,0,30,30
1683737415613,PHIL 28,A03,186990,Staff,10,0,30,20
1683737415613,PHIL 28,A04,186991,Staff,26,0,30,4
1683737416643,PHIL 120,A00,186997,Staff,23,0,40,17
1683737417666,PHIL 137,A00,187003,Staff,8,0,40,32
1683737418690,PHIL 150,A00,187015,Staff,47,0,70,23
1683737419717,PHIL 167,A00,187021,Lamey; Andy M.,34,0,40,6
1683737420740,PHIL 174,A01,202226,Staff,17,0,20,3
1683737420740,PHIL 174,A02,202235,Staff,20,0,20,0
1683737421772,PHIL 191A,A00,258918,Staff,0,0,1,1
1683737422796,PHYS 1A,A00,187028,Staff,26,0,60,34
1683737423824,PHYS 1AL,001,187036,Staff,3,0,30,27
1683737423824,PHYS 1AL,002,187049,Staff,18,0,30,12
1683737424848,PHYS 1B,A00,187058,Staff,21,0,60,39
1683737425872,PHYS 1BL,001,187064,Staff,0,1,30,30
1683737425872,PHYS 1BL,002,187070,Staff,4,0,30,26
1683737426898,PHYS 1C,A00,187082,Staff,30,0,120,90
1683737427924,PHYS 1CL,001,187088,Staff,0,9,30,30
1683737427924,PHYS 1CL,002,187089,Staff,0,1,30,30
1683737427924,PHYS 1CL,009,262693,Staff,9,0,30,21
1683737428948,PHYS 2B,A01,187097,Staff,55,0,115,60
1683737429973,PHYS 2C,A01,187099,Staff,63,0,115,52
1683737430998,PHYS 2CL,A01,187101,Staff,5,0,28,23
1683737430998,PHYS 2CL,A02,187102,Staff,15,0,28,13
1683737432022,PHYS 2D,A01,187123,Shotwell; Brian,95,0,115,20
1683737433047,PHYS 4B,A01,187133,Grinstein; Benjamin,34,0,50,16
1683737434074,POLI 10,A00,188819,Staff,0,4,50,50
1683737435098,POLI 11,A00,188827,Staff,43,0,50,7
1683737436122,POLI 13R,A00,188828,Staff,0,2,20,20
1683737437146,POLI 27,A01,188830,Elgin; Samuel Zincke,0,2,70,70
1683737438170,POLI 30,A00,188832,Desposato; Scott,30,0,50,20
1683737439196,POLI 102F,A00,188834,Staff,1,0,40,39
1683737440222,POLI 104A,A00,188852,Staff,12,0,30,18
1683737441248,POLI 104I,A00,188853,Staff,0,8,20,20
1683737442272,POLI 110B,A00,188854,Wiens; David,6,0,20,14
1683737443299,POLI 112A,A00,188855,Wiens; David,4,0,30,26
1683737444324,POLI 117R,A00,188856,Forman; Fonna,0,12,20,20
1683737445349,POLI 118,A00,188857,Ingham; Sean,8,0,20,12
1683737446373,POLI 120G,A00,188858,Staff,7,0,30,23
1683737447397,POLI 131CR,A00,188863,Hoston; Germaine,20,0,50,30
1683737448423,POLI 133,A00,188864,Nellis; Gareth Hb,44,0,50,6
1683737449448,POLI 134D,A00,188865,Desposato; Scott,27,0,30,3
1683737450472,POLI 142A,A00,188871,Gartzke; Erik,21,0,50,29
1683737451498,POLI 142K,A00,188874,Staff,38,0,50,12
1683737452523,POLI 143,A00,188940,Gartzke; Erik,15,0,30,15
1683737453550,POLI 153,A00,188943,Staff,1,0,20,19
1683737454574,POLI 160AA,A00,188944,Staff,10,0,40,30
1683737455602,POLI 170A,A00,188945,Staff,10,0,30,20
1683737457654,PSYC 1,A00,188952,Staff,36,0,90,54
1683737458676,PSYC 2,B00,188953,Staff,19,0,35,16
1683737459700,PSYC 6,A00,188970,Staff,47,0,60,13
1683737460724,PSYC 7,A00,188973,Staff,35,0,45,10
1683737461749,PSYC 60,A01,188980,Rickard; Timothy C.,42,0,60,18
1683737462776,PSYC 70,A01,189001,Steiner; Eric Tomas,21,0,45,24
1683737463805,PSYC 100,A00,189005,Lacefield; Katharine I,1,98,120,119
1683737464830,PSYC 102,A00,189008,Staff,6,0,30,24
1683737465854,PSYC 106,B00,189026,Gorman; Michael R.,26,0,60,34
1683737466879,PSYC 114,B01,189033,Winkielman; Piotr,0,31,30,30
1683737467908,PSYC 131,A00,189036,Anagnostaras; Stephan,0,44,60,60
1683737468937,PSYC 136,A00,189041,Lowe; Angela Beth,0,7,25,25
1683737469963,PSYC 137,A00,189057,Winkielman; Piotr,0,36,25,25
1683737470987,PSYC 144,A00,189107,Wixted; John T,0,11,50,50
1683737473037,PSYC 162,A00,189142,Staff,0,9,85,85
1683737474064,PSYC 172,A00,189144,Gorman; Michael R.,0,6,30,30
1683737476114,PSYC 179,A00,189146,Lacefield; Katharine I,0,88,120,120
1683737477143,PSYC 181,A00,189147,Anagnostaras; Stephan,110,45,200,90
1683737478165,PSYC 190R,A00,189148,Barner; David A.,0,23,80,80
1683737479191,PSYC 191,A00,189275,Rickard; Timothy C.,0,11,25,25
1683737480215,PSYC 193,A00,189276,Chapman; Eddie Nathaniel,0,1,0,4
1683737481255,PSYC 193L,A01,189281,Lowe; Angela Beth,8,0,20,12
1683737481255,PSYC 193L,B01,189285,Staff,28,0,35,7
1683737482281,RELI 149,A00,187137,Rahimi; Babak,6,0,40,34
1683737483306,SE 9,A01,187315,Staff,0,2,18,18
1683737484330,SE 101B,A00,187409,Staff,24,0,30,6
1683737485356,SE 110B,A00,187444,Staff,10,0,40,30
1683737486383,SE 130B,A00,187449,Staff,31,0,40,9
1683737487407,SE 150A,A00,187516,Staff,8,0,20,12
1683737488432,SE 154,A00,187528,Staff,29,0,50,21
1683737489460,SIO 3,A01,258171,Staff,35,0,40,5
1683737490484,SIO 10,A00,187144,Cook; Geoffrey W,0,6,75,75
1683737491509,SIO 45,A00,187152,Cook; Geoffrey W,1,7,100,99
1683737492533,SIO 109R,A00,194486,Staff,0,4,20,20
1683737494582,SIO 187,A01,187233,Kacev; David,12,0,40,28
1683737495612,SOCI 1,A01,258656,Thorpe; Charles Robert,28,0,30,2
1683737495612,SOCI 1,A02,258658,Thorpe; Charles Robert,30,0,30,0
1683737495612,SOCI 1,A03,258661,Thorpe; Charles Robert,25,0,25,0
1683737495612,SOCI 1,A04,258666,Thorpe; Charles Robert,22,0,25,3
1683737495612,SOCI 1,A05,258897,Thorpe; Charles Robert,22,0,25,3
1683737495612,SOCI 1,A06,258898,Thorpe; Charles Robert,25,0,25,0
1683737496636,SOCI 30,A01,258903,Pardo Guerra; Juan Pablo,14,0,30,16
1683737497661,SOCI 102,A00,258904,Staff,9,0,25,16
1683737498688,SOCI 106,A00,258905,Staff,19,0,25,6
1683737499714,SOCI 111,A00,258907,Ribas Norris; Janet Vanesa,26,0,30,4
1683737500740,SOCI 121R,A00,258908,Pardo Guerra; Juan Pablo,7,0,30,23
1683737501768,SOCI 126,A01,203330,Staff,14,0,20,6
1683737502794,SOCI 131,A00,258909,Thorpe; Charles Robert,30,0,60,30
1683737503818,SOCI 135,A00,258910,Payne; Christine Anna,0,13,30,30
1683737504902,SOCI 157,A00,258911,Staff,10,0,30,20
1683737505929,SOCI 184,A00,258912,Staff,25,0,30,5
1683737506954,SOCI 188D,A00,258913,Staff,22,0,30,8
1683737507982,SYN 2,001,187529,Staff,9,0,16,7
1683737507982,SYN 2,002,201452,Staff,0,20,16,16
1683737507982,SYN 2,003,201469,Staff,1,0,16,15
1683737509009,SYN 100,A01,187531,Staff,0,9,20,20
1683737509009,SYN 100,B01,201491,Staff,0,10,20,20
1683737510034,TDAC 1,A00,189286,Walsh; Kim C.,3,0,20,17
1683737510034,TDAC 1,B00,189287,Harting; Carla Kelso,10,0,20,10
1683737511062,TDAC 101,A00,189300,Walsh; Kim C.,16,0,20,4
1683737511062,TDAC 101,B00,189301,Harting; Carla Kelso,18,0,20,2
1683737512089,TDAC 102,A00,189304,Basso; Beatrice,14,0,20,6
1683737513113,TDAC 108,A00,189305,Staff,18,0,20,2
1683737514142,TDDE 131,A00,189310,Staff,19,0,20,1
1683737514142,TDDE 131,B00,189314,Staff,19,0,20,1
1683737514142,TDDE 131,C00,189315,Staff,48,0,50,2
1683737514142,TDDE 131,D00,189316,Staff,14,0,15,1
1683737514142,TDDE 131,E00,204841,Staff,20,0,20,0
1683737515166,TDGE 10,A00,189289,Staff,26,0,50,24
1683737515166,TDGE 10,B00,189290,Havis; Allan,0,1,50,50
1683737516189,TDGE 11,A00,189291,Fulton; Julia,0,4,50,50
1683737516189,TDGE 11,B00,189292,Staff,20,0,25,5
1683737516189,TDGE 11,C00,260270,Staff,0,0,0,0
1683737517211,TDGE 25,A00,189294,Staff,1,0,20,19
1683737518233,TDGE 124,A00,189318,Fulton; Julia,0,7,50,50
1683737519260,TDGE 125,A00,189319,Staff,13,0,25,12
1683737519260,TDGE 125,B00,189320,Staff,23,0,25,2
1683737520287,TDGE 127,A00,189322,Havis; Allan,1,0,50,49
1683737521317,TDHT 101,A00,189323,Staff,18,0,25,7
1683737521317,TDHT 101,B00,189324,Staff,25,0,25,0
1683737522344,TDHT 102,A00,189325,Staff,49,0,50,1
1683737523374,TDMV 1,A00,189295,Arcidiacono; Kristin,20,0,30,10
1683737523374,TDMV 1,B00,189296,Caligagan; Maria T.,23,0,30,7
1683737524400,TDMV 2,A00,189297,Sammartano; Tonnie,27,0,30,3
1683737524400,TDMV 2,B00,189299,Arcidiacono; Kristin,23,0,30,7
1683737525425,TDMV 3,A00,204998,Rincon; Alicia,22,0,30,8
1683737526452,TDMV 120,A00,189458,Sammartano; Tonnie,28,0,30,2
1683737527478,TDMV 138,A00,189541,Jun; Grace Shin Hae,20,0,40,20
1683737528501,TDMV 142,A00,189717,Caligagan; Tony,25,0,30,5
1683737528501,TDMV 142,B00,189718,Caligagan; Maria T.,25,0,30,5
1683737529526,TMC 2,A01,187533,Staff,25,0,25,0
1683737529526,TMC 2,A02,187534,Staff,25,0,25,0
1683737530551,USP 1,A01,187536,Kwak; Nancy,0,16,25,25
1683737531579,USP 5,A01,187538,Staff,8,0,25,17
1683737532606,USP 101,A00,199253,Staff,0,4,0,0
1683737533631,USP 124,A00,187562,Boomhower; Matthew Charles,1,0,30,29
1683737534658,USP 138,A00,187582,Staff,19,0,25,6
1683737535685,USP 152,A01,187597,Staff,3,0,25,22
1683737536709,USP 153,A00,187598,Staff,18,0,25,7
1683737537732,USP 168,A00,187607,Kwak; Nancy,2,0,5,3
1683737538756,USP 173,A00,187619,Staff,4,0,25,21
1683737539783,USP 181,A00,187638,Staff,0,4,25,25
1683737540807,VIS 103,A00,187650,Cruz; Edwin Teddy,17,0,75,58
1683737541831,VIS 110D,A00,187669,Staff,13,0,22,9
1683737542855,VIS 127C,A00,187720,Shen; Kuiyi,67,0,146,79
1683737543883,VIS 149,A00,187731,Yoldas; Pinar,0,12,22,22
1683737544910,VIS 151,A01,188091,Staff,22,0,34,12
1683737544910,VIS 151,A02,188092,Staff,11,0,34,23
1683737545936,VIS 160B,A00,188093,Stalbaum; Brett,0,1,10,10
1683737547988,WCWP 10B,A00,201720,Staff,0,0,5,5
1683737547988,WCWP 10B,B00,201722,Staff,0,0,6,6
1683737549016,WCWP 100,A00,201725,Gagnon; Jeffrey C,0,0,2,2
1683737549016,WCWP 100,B00,201727,Staff,0,4,15,15
1683737552116,ANBI 133,A00,258401,Wilder; Linnea Lorene,34,0,40,6
1683737553140,ANBI 140,A00,258395,Hrvoj Mihic; Branka,18,0,25,7
1683737554164,ANSC 120,A00,258402,Bialecki; Jon Anthony,26,0,40,14
1683737555187,ANSC 144,A00,258400,Staff,12,0,40,28
1683737557238,ANSC 166,A00,258396,Parish; Steven Martin,156,0,175,19
1683737558271,ANSC 180,A00,193533,Staff,8,0,20,12
1683737559295,ANSC 188,A00,258397,Jassal; Aftab,34,0,40,6
1683737560319,ANTH 3,A01,258316,Staff,23,0,30,7
1683737561343,ANTH 5,A00,258394,Semendeferi; Ekaterini,16,0,20,4
1683737562367,ANTH 21,A01,258331,Staff,4,0,40,36
1683737563393,ANTH 103,A00,258398,Varma; Saiba,15,0,25,10
1683737564426,AWP 10,001,202034,Staff,0,0,0,0
1683737564426,AWP 10,002,202035,Staff,0,0,0,0
1683737564426,AWP 10,003,202036,Staff,0,0,0,0
1683737564426,AWP 10,004,202037,Staff,0,0,0,0
1683737564426,AWP 10,005,202038,Staff,0,0,0,0
1683737564426,AWP 10,006,202039,Staff,0,0,0,0
1683737564426,AWP 10,007,202040,Staff,0,0,0,0
1683737564426,AWP 10,008,202041,Staff,0,0,0,0
1683737564426,AWP 10,009,202042,Staff,0,0,0,0
1683737564426,AWP 10,010,202043,Staff,0,0,0,0
1683737564426,AWP 10,011,202044,Staff,0,0,0,0
1683737564426,AWP 10,012,202045,Staff,0,0,0,0
1683737564426,AWP 10,013,202046,Staff,0,0,0,0
1683737564426,AWP 10,014,202047,Staff,0,0,0,0
1683737564426,AWP 10,015,202048,Staff,0,0,0,0
1683737564426,AWP 10,016,202049,Staff,0,0,0,0
1683737564426,AWP 10,017,202050,Staff,0,0,0,0
1683737564426,AWP 10,018,202051,Staff,0,0,0,0
1683737564426,AWP 10,019,202052,Staff,0,0,0,0
1683737564426,AWP 10,020,202053,Staff,0,0,0,0
1683737564426,AWP 10,021,202054,Staff,0,0,0,0
1683737564426,AWP 10,022,202055,Staff,0,0,0,0
1683737564426,AWP 10,023,202056,Staff,0,0,0,0
1683737564426,AWP 10,024,202057,Staff,0,0,0,0
1683737564426,AWP 10,025,202058,Staff,0,0,0,0
1683737564426,AWP 10,026,202059,Staff,0,0,0,0
1683737565452,AWP 102,001,202032,Staff,0,0,0,0
1683737565452,AWP 102,002,202033,Staff,0,0,0,0
1683737566484,BENG 100,A01,254234,Taylor Amos; Alyssa C,31,0,40,9
1683737567511,BENG 196,001,270013,Engler; Adam J.,9999,0,9999,0
1683737568536,BICD 100R,A01,202018,Smith; Laurie,0,7,32,32
1683737568536,BICD 100R,A02,202019,Smith; Laurie,0,3,32,32
1683737568536,BICD 100R,A03,202020,Smith; Laurie,0,1,32,32
1683737568536,BICD 100R,A04,202021,Smith; Laurie,6,0,32,26
1683737568536,BICD 100R,A05,202022,Smith; Laurie,10,0,32,22
1683737569561,BICD 136,A01,193242,Gustafson-Brown; Cindy,0,2,32,32
1683737569561,BICD 136,A02,193244,Gustafson-Brown; Cindy,13,0,32,19
1683737570589,BIEB 102,A01,193249,Butler; Shannon Rhey,0,0,32,32
1683737570589,BIEB 102,A02,193251,Butler; Shannon Rhey,0,0,32,32
1683737570589,BIEB 102,A03,193253,Butler; Shannon Rhey,0,0,32,32
1683737570589,BIEB 102,A04,193255,Butler; Shannon Rhey,13,0,32,19
1683737570589,BIEB 102,A05,193265,Butler; Shannon Rhey,25,0,32,7
1683737570589,BIEB 102,A06,193269,Butler; Shannon Rhey,12,0,32,20
1683737572642,BIEB 150,A01,193274,Staff,0,0,32,32
1683737572642,BIEB 150,A02,193285,Staff,24,0,32,8
1683737573670,BIEB 194,A00,193286,Kurle; Carolyn M.,19,0,32,13
1683737574699,BILD 1,A01,192291,Staff,15,0,32,17
1683737574699,BILD 1,A02,192292,Staff,30,0,32,2
1683737574699,BILD 1,B01,192520,Reuther; Keefe,0,1,0,0
1683737574699,BILD 1,B02,192532,Reuther; Keefe,0,1,0,0
1683737575724,BILD 3,A01,192556,Butler; Shannon Rhey,0,0,32,32
1683737575724,BILD 3,A02,192581,Butler; Shannon Rhey,0,1,32,32
1683737575724,BILD 3,A03,192611,Butler; Shannon Rhey,19,0,32,13
1683737575724,BILD 3,A04,192612,Butler; Shannon Rhey,23,0,32,9
1683737575724,BILD 3,A05,192613,Butler; Shannon Rhey,26,0,32,6
1683737575724,BILD 3,A06,192679,Butler; Shannon Rhey,27,0,32,5
1683737575724,BILD 3,A07,192682,Butler; Shannon Rhey,20,0,32,12
1683737576748,BILD 4,A01,192836,Reuther; Keefe,1,0,24,23
1683737576748,BILD 4,A02,193044,Reuther; Keefe,4,0,24,20
1683737577782,BILD 10,A01,193142,Gustafson-Brown; Cindy,29,0,32,3
1683737577782,BILD 10,A02,193149,Gustafson-Brown; Cindy,31,0,32,1
1683737578807,BIMM 100,A01,193301,Staff,0,6,32,32
1683737578807,BIMM 100,A02,193312,Staff,0,7,32,32
1683737578807,BIMM 100,A03,193323,Staff,0,10,32,32
1683737579833,BIMM 101,A01,193329,McDonnell; Lisa Marie,0,3,24,24
1683737579833,BIMM 101,A02,193339,McDonnell; Lisa Marie,0,3,24,24
1683737579833,BIMM 101,B01,193354,McDonnell; Lisa Marie,0,4,24,24
1683737579833,BIMM 101,B02,193357,McDonnell; Lisa Marie,0,3,24,24
1683737580858,BIMM 110,A01,193377,Tat; John,0,11,32,32
1683737580858,BIMM 110,A02,193378,Tat; John,0,11,32,32
1683737581886,BIMM 120,A01,206116,Staff,1,0,32,31
1683737581886,BIMM 120,A02,206117,Staff,7,0,32,25
1683737581886,BIMM 120,A03,206121,Staff,21,0,32,11
1683737582915,BIPN 100,A01,193393,Park; Ji Young,0,15,32,32
1683737582915,BIPN 100,A02,193402,Park; Ji Young,0,14,32,32
1683737582915,BIPN 100,A03,193413,Park; Ji Young,0,14,32,32
1683737582915,BIPN 100,A04,193414,Park; Ji Young,0,13,32,32
1683737583942,BIPN 102,A01,193429,Staff,0,0,32,32
1683737583942,BIPN 102,A02,193438,Staff,18,0,32,14
1683737584966,BIPN 106,A01,193450,Reyes Gonzalez; Catalina,0,2,40,40
1683737585993,BIPN 134,A01,193465,Cooke; James Edward,0,0,32,32
1683737585993,BIPN 134,A02,193474,Cooke; James Edward,24,0,32,8
1683737585993,BIPN 134,A03,193485,Cooke; James Edward,29,0,32,3
1683737585993,BIPN 134,A04,193486,Cooke; James Edward,20,0,32,12
1683737585993,BIPN 134,A05,193491,Cooke; James Edward,31,0,32,1
1683737585993,BIPN 134,A06,193501,Cooke; James Edward,30,0,32,2
1683737585993,BIPN 134,A07,193510,Cooke; James Edward,29,0,32,3
1683737588048,BISP 194,A00,222522,Staff,14,0,32,18
1683737589074,CAT 124,A01,202407,Staff,19,0,25,6
1683737590099,CAT 125,A00,202408,Marchisotto; Jennifer Anne,2,0,20,18
1683737591123,CAT 125R,A00,202409,Smith; Lauryn Alissa,0,11,20,20
1683737591123,CAT 125R,B00,202410,Morales; Celeste Georgianna,0,11,20,20
1683737591123,CAT 125R,C00,202411,Irwin; Matthew Joseph,0,12,20,20
1683737592146,CENG 15,A01,204712,Yang; Kesong,0,1,0,0
1683737593172,CENG 114,A00,202070,Jahed Motlagh; Zeinab,5,0,20,15
1683737594199,CGS 105,A00,185477,Wesling; Megan E.,24,0,40,16
1683737595223,CGS 106,A00,185494,Staff,11,0,22,11
1683737596249,CGS 108,A00,185495,Staff,14,0,20,6
1683737597274,CGS 114,A00,185496,Staff,13,0,18,5
1683737598300,CGS 119,A00,185501,Staff,15,0,20,5
1683737599327,CGS 120,A00,185511,Staff,11,0,20,9
1683737600361,CHEM 4,A01,184675,Bussey; Thomas J,97,0,100,3
1683737601389,CHEM 6A,A01,184677,Staff,32,0,60,28
1683737602416,CHEM 6B,A01,184679,Staff,63,0,100,37
1683737603440,CHEM 6C,A01,184681,Bussey; Thomas J,0,0,50,50
1683737603440,CHEM 6C,A02,184682,Bussey; Thomas J,32,0,50,18
1683737604467,CHEM 40A,A01,184684,Albizati; Kim F.,33,0,100,67
1683737605492,CHEM 40B,A01,184686,Albizati; Kim F.,0,22,100,100
1683737606520,CHEM 41B,A01,184690,Staff,51,0,100,49
1683737607545,COGS 3,A01,184715,Boyle; Mary E. T.,0,27,40,40
1683737608629,COGS 14B,A01,185172,Staff,0,14,38,38
1683737609657,COGS 18,A01,184736,Staff,14,0,80,66
1683737610680,COGS 100,A01,184932,Staff,0,8,73,73
1683737611708,COGS 101A,A01,184935,Staff,0,40,30,30
1683737612736,COGS 101B,A01,184944,Staff,0,2,30,30
1683737613763,COGS 101C,A01,184946,Staff,0,10,30,30
1683737614785,COGS 102A,A01,184951,Johnson; Christine M.,1,0,40,39
1683737615810,COGS 107B,A01,184953,Mooshagian; Eric Frederick,0,52,40,40
1683737616839,COGS 118B,A01,184959,Gupta; Anjum,0,50,40,40
1683737617863,COGS 153,A00,184961,Staff,1,16,30,29
1683737618890,COGS 177,A00,184962,Staff,0,20,30,30
1683737619914,COGS 187A,A01,184969,Boyle; Mary E. T.,0,19,40,40
1683737620942,COMM 10,A01,185174,Staff,0,5,25,25
1683737620942,COMM 10,A02,185189,Staff,0,2,25,25
1683737620942,COMM 10,A03,269821,Staff,0,1,0,0
1683737621970,COMM 100B,A02,185476,Staff,10,0,25,15
1683737621970,COMM 100B,A03,277340,Staff,25,0,25,0
1683737622997,COMM 100C,A01,185314,Staff,2,0,25,23
1683737622997,COMM 100C,A02,185327,Staff,17,0,25,8
1683737624022,COMM 110M,A00,185349,Staff,0,0,40,40
1683737625048,COMM 113T,A00,185352,Staff,25,0,40,15
1683737626073,COMM 114I,A00,185353,Staff,31,0,40,9
1683737627100,COMM 131,A00,185354,Staff,17,0,30,13
1683737628127,CSE 8A,A50,185358,Cao; Yingjun,0,46,10,10
1683737629151,CSE 8B,A01,185362,Staff,0,48,50,50
1683737630179,CSE 11,A01,185416,Cao; Yingjun,0,91,10,10
1683737631204,CSE 20,A01,185445,Briones; Jor-el Thomas Caparas,3,0,25,22
1683737632227,CSE 21,A01,185447,Staff,9,0,50,41
1683737633256,CSE 101,A01,185451,Staff,0,13,50,50
1683737633256,CSE 101,B01,185453,Jones; Miles E,0,15,50,50
1683737635309,CSE 141,A01,185458,Eldon; John,16,0,100,84
1683737636334,CSE 141L,A01,185461,Eldon; John,8,0,100,92
1683737637359,CSE 142,A01,185463,Staff,34,0,60,26
1683737637359,CSE 142,B01,201355,Staff,0,7,60,60
1683737638387,CSE 142L,A01,185470,Staff,34,0,60,26
1683737638387,CSE 142L,B01,201417,Staff,0,6,60,60
1683737639412,CSE 190,A00,201433,Staff,32,0,49,17
1683737640441,DOC 1,A01,259136,Strom; Megan C.,7,0,15,8
1683737640441,DOC 1,A02,259137,Strom; Megan C.,15,0,15,0
1683737640441,DOC 1,A03,259138,Strom; Megan C.,14,0,15,1
1683737640441,DOC 1,A04,259139,Strom; Megan C.,13,0,15,2
1683737641468,DOC 100D,A00,259140,Pass; Natalye Joann,14,0,25,11
1683737642493,DSGN 1,A01,184749,Rill; Bryan,0,26,30,30
1683737643518,DSGN 100,A01,185168,Staff,0,2,25,25
1683737644542,ECE 5,A01,185626,Morris; Karcher William,0,12,0,0
1683737645569,ECE 101,A01,185628,Staff,14,0,70,56
1683737646597,ECE 107,A01,185635,Baghdadchi; Saharnaz,0,0,20,20
1683737646597,ECE 107,A02,185638,Baghdadchi; Saharnaz,1,0,20,19
1683737647626,ECE 148,A01,185647,Silberman; Jack,0,0,16,16
1683737648654,ECON 1,A01,185537,Crane; Meredith Helen,54,0,70,16
1683737649679,ECON 3,A01,185549,Crane; Meredith Helen,30,0,70,40
1683737650705,ECON 4,A01,203354,Anderson; John Charles,0,5,10,10
1683737651733,ECON 100A,A01,185574,Staff,0,5,40,40
1683737652760,ECON 100B,A01,185576,Staff,0,12,50,50
1683737653789,ECON 100C,A01,185589,Newhouse; Herbert S,30,0,70,40
1683737654813,ECON 105,A00,185608,Vespa; Emanuel Ignacio,19,0,35,16
1683737655841,ECON 109,A01,185610,Shishkin; Denis,9,0,35,26
1683737656868,ECON 110A,A01,185612,Staff,8,0,40,32
1683737657898,ECON 120A,A01,185615,Staff,19,0,40,21
1683737658922,ECON 120C,A01,185617,Sun; Yixiao,0,21,70,70
1683737659945,ECON 144,A00,203346,Squires; Dale E,2,0,35,33
1683737660972,ECON 171,A01,203349,Newhouse; Herbert S,0,1,35,35
1683737662012,ECON 173A,A01,185621,Toda; Alexis Akira,21,0,35,14
1683737663044,EDS 25,A01,202413,Staff,0,1,0,0
1683737663044,EDS 25,A02,202414,Staff,0,1,0,0
1683737663044,EDS 25,A03,202415,Staff,0,0,0,0
1683737663044,EDS 25,A04,202416,Staff,0,1,0,0
1683737663044,EDS 25,A05,202439,Staff,0,0,0,0
1683737663044,EDS 25,A06,202440,Staff,0,0,0,0
1683737663044,EDS 25,B01,202631,Staff,0,0,0,0
1683737663044,EDS 25,B02,202632,Staff,0,0,0,0
1683737663044,EDS 25,B03,202639,Staff,0,0,0,0
1683737663044,EDS 25,B04,202640,Staff,0,0,0,0
1683737663044,EDS 25,B05,202643,Staff,0,0,0,0
1683737663044,EDS 25,B06,202644,Staff,0,0,0,0
1683737664069,EDS 38,A01,202659,Black; Alison Michelle,25,0,25,0
1683737665093,EDS 115,A00,202652,Staff,18,0,30,12
1683737666117,EDS 125,A00,202649,Staff,13,0,30,17
1683737667141,EDS 126,A01,203332,Staff,30,0,30,0
1683737668167,EDS 139,A00,202838,Staff,16,0,25,9
1683737669194,EDS 146,A01,202655,Staff,14,0,25,11
1683737670222,ENG 15,A00,185667,Staff,0,1,0,2
1683737670222,ENG 15,B00,185672,Staff,0,0,0,1
1683737670222,ENG 15,C00,185675,Staff,0,0,0,0
1683737670222,ENG 15,D00,185682,Staff,0,0,0,0
1683737670222,ENG 15,E00,185684,Staff,0,0,0,0
1683737671246,ETHN 103,A00,185710,Staff,0,8,35,35
1683737672270,ETHN 103A,A00,199228,Man; Simeon S,0,0,9,9
1683737673294,ETHN 109,A00,185711,Staff,15,0,35,20
1683737674318,ETHN 142,A00,185726,Staff,0,4,30,30
1683737675341,ETHN 163J,A00,199229,Man; Simeon S,5,0,8,3
1683737676365,ETHN 168,A00,185727,Staff,7,0,10,3
1683737677392,ETHN 182,A00,185728,Staff,0,0,35,35
1683737678416,ETHN 183,A00,185737,Staff,10,0,18,8
1683737679441,GLBH 111,A01,209361,Burgos; Jose L.,0,0,0,0
1683737681493,HIEU 104,A00,185792,Staff,14,0,20,6
1683737682518,HIEU 115,A00,185800,Staff,0,0,20,20
1683737683542,HIEU 128,A00,185801,Staff,0,9,20,20
1683737684566,HIEU 147,A00,185802,Staff,15,0,20,5
1683737685588,HIEU 154,A00,185823,Staff,11,0,20,9
1683737686612,HILA 102,A00,185826,Staff,14,0,20,6
1683737687641,HILD 2C,A01,185778,Staff,0,13,20,20
1683737688666,HILD 7B,A01,185780,Kwak; Nancy,0,17,32,32
1683737688666,HILD 7B,A02,185781,Kwak; Nancy,0,18,32,32
1683737689691,HILD 30,A01,185791,Staff,12,0,20,8
1683737690719,HISC 119,A00,185830,Golan; Tal,0,10,20,20
1683737691742,HITO 156GS,A00,185831,Patterson; Patrick H.,0,0,0,23
1683737692770,HIUS 103,A00,185832,Man; Simeon S,0,4,20,20
1683737693794,HIUS 117,A00,185836,Kwak; Nancy,2,0,20,18
1683737694816,HIUS 125,A00,185840,Man; Simeon S,0,2,23,23
1683737695844,HIUS 149,A00,185845,Staff,1,0,20,19
1683737696872,HUM 3,A01,185882,Zavodny; Tatiana Sophia,0,8,50,50
1683737696872,HUM 3,B01,185899,Caldwell; Michael Alan,0,18,50,50
1683737697898,HUM 3GS,A00,185900,Patterson; Patrick H.,0,0,0,23
1683737698933,HUM 4,A01,185938,Zroka; Amy Liane,28,0,50,22
1683737698933,HUM 4,B01,185956,Watkins; Eric,0,6,50,50
1683737698933,HUM 4,B02,202209,Watkins; Eric,0,6,50,50
1683737698933,HUM 4,B03,202210,Watkins; Eric,0,5,50,50
1683737699962,HUM 5,A01,185958,West; Geoffrey Scott,0,1,50,50
1683737699962,HUM 5,A02,202215,West; Geoffrey Scott,0,1,50,50
1683737700987,INTL 190,A00,185959,Gagnon; Jeffrey C,0,0,0,9
1683737700987,INTL 190,B00,185960,Lettieri; Michael Joseph,0,0,0,2
1683737702021,JAPN 180,A00,254509,Staff,4,0,30,26
1683737703052,LATI 10,A01,202853,Kennemore; Amy Michelle,0,0,31,31
1683737703052,LATI 10,A02,202854,Kennemore; Amy Michelle,0,0,32,32
1683737703052,LATI 10,A03,270054,Kennemore; Amy Michelle,30,0,30,0
1683737704076,LATI 180,A00,202855,Kennemore; Amy Michelle,11,0,20,9
1683737705105,LAWS 101,A00,201767,Golan; Tal,0,7,40,40
1683737706135,LIFR 1C,A00,185961,Staff,6,0,20,14
1683737707159,LIFR 1CX,A00,185962,Staff,7,0,20,13
1683737708185,LIFR 1D,A00,185963,Staff,7,0,20,13
1683737709209,LIFR 1DX,A00,185964,Staff,7,0,20,13
1683737710235,LIGN 101,A01,186039,Staff,43,0,50,7
1683737711260,LIGN 165,A00,186040,Staff,14,0,50,36
1683737712346,LTCS 108,A00,186041,Staff,5,0,10,5
1683737713369,LTCS 119,A00,186042,Staff,15,0,20,5
1683737714396,LTCS 130,A00,186043,Wesling; Megan E.,15,0,25,10
1683737716443,LTEA 138,A00,186119,Staff,13,0,40,27
1683737717466,LTEN 124,A00,186148,Staff,5,0,25,20
1683737718493,LTEN 178,A00,186149,Staff,6,0,15,9
1683737719517,LTEN 181,A00,186150,Blanco; John D,34,0,40,6
1683737720541,LTWL 120,A00,186160,Staff,19,0,25,6
1683737721567,LTWL 165,A00,186161,Staff,22,0,25,3
1683737722591,LTWR 100,A00,186162,Staff,0,5,15,15
1683737723619,LTWR 102,A00,186163,Doller; Ben,5,0,15,10
1683737724646,MAE 8,A01,186412,Staff,0,1,0,1
1683737725674,MAE 30B,A00,186445,Bahadori; Mohammad Yousef,81,0,100,19
1683737726698,MAE 40,A00,186592,Bewley; Thomas R,10,0,50,40
1683737727724,MAE 101B,A00,186593,Bahadori; Mohammad Yousef,79,0,100,21
1683737728754,MAE 105,A00,186594,Bandaru; Prabhakar,10,0,50,40
1683737729784,MAE 107,A00,186599,Pham; Hieu Tan,0,8,120,120
1683737730808,MAE 148,A01,186660,Silberman; Jack,3,0,16,13
1683737731834,MATH 10A,A01,188095,Staff,0,6,35,35
1683737732864,MATH 10B,A01,188097,Bowers; Adam R.,0,12,30,30
1683737732864,MATH 10B,A02,188099,Bowers; Adam R.,0,11,30,30
1683737732864,MATH 10B,B01,188104,Bowers; Adam R.,0,10,30,30
1683737732864,MATH 10B,B02,188106,Bowers; Adam R.,0,9,30,30
1683737733890,MATH 10C,A01,188111,Staff,0,20,30,30
1683737733890,MATH 10C,A02,188127,Staff,0,19,30,30
1683737733890,MATH 10C,A03,188131,Staff,0,19,30,30
1683737733890,MATH 10C,B01,188218,Staff,17,0,30,13
1683737733890,MATH 10C,B02,188244,Staff,13,0,30,17
1683737733890,MATH 10C,B03,188277,Staff,14,0,30,16
1683737734923,MATH 18,A01,188344,Bach; Quang Tran,18,0,30,12
1683737734923,MATH 18,A02,188345,Bach; Quang Tran,11,0,30,19
1683737734923,MATH 18,B01,188353,Bach; Quang Tran,11,0,30,19
1683737734923,MATH 18,B02,188354,Bach; Quang Tran,19,0,30,11
1683737735948,MATH 20A,A01,188374,Staff,10,0,35,25
1683737736976,MATH 20B,A01,188382,Ohm; Ko Woon,7,0,30,23
1683737736976,MATH 20B,A02,188383,Ohm; Ko Woon,22,0,30,8
1683737736976,MATH 20B,B01,188385,Ohm; Ko Woon,7,0,30,23
1683737736976,MATH 20B,B02,188392,Ohm; Ko Woon,22,0,30,8
1683737738001,MATH 20C,A01,188394,Harel; Guershon,10,0,30,20
1683737738001,MATH 20C,A02,188395,Harel; Guershon,13,0,30,17
1683737738001,MATH 20C,B01,188404,Harel; Guershon,5,0,30,25
1683737738001,MATH 20C,B02,188405,Harel; Guershon,18,0,30,12
1683737739026,MATH 20D,A01,188414,Hammock; Frances H,0,1,30,30
1683737739026,MATH 20D,A02,188415,Hammock; Frances H,0,1,30,30
1683737739026,MATH 20D,B01,188447,Hammock; Frances H,0,1,30,30
1683737739026,MATH 20D,B02,188486,Hammock; Frances H,2,0,30,28
1683737740050,MATH 20E,A01,188649,Staff,21,0,30,9
1683737740050,MATH 20E,A02,188650,Staff,20,0,30,10
1683737740050,MATH 20E,A03,188673,Staff,0,0,30,30
1683737741077,MATH 102,A01,188675,Staff,0,40,35,35
1683737742103,MATH 103B,A01,188681,Staff,3,0,35,32
1683737742103,MATH 103B,B01,188692,Staff,5,0,35,30
1683737743129,MATH 109,A01,188695,Salehi Golsefidy; Alireza,24,0,35,11
1683737743129,MATH 109,A02,188696,Salehi Golsefidy; Alireza,24,0,35,11
1683737744152,MATH 120A,A01,188698,Eggers; John Dietrich,7,0,35,28
1683737745176,MATH 142B,A01,188736,Ioana; Adrian,0,0,30,30
1683737745176,MATH 142B,A02,188741,Ioana; Adrian,0,1,30,30
1683737745176,MATH 142B,A03,188743,Ioana; Adrian,0,3,30,30
1683737746203,MATH 168A,A01,188790,Staff,0,11,35,35
1683737747232,MATH 170A,A01,188803,Nie; Jiawang,0,2,35,35
1683737747232,MATH 170A,A02,188811,Nie; Jiawang,0,1,35,35
1683737747232,MATH 170A,A03,188814,Nie; Jiawang,1,0,35,34
1683737747232,MATH 170A,A04,188815,Nie; Jiawang,4,0,35,31
1683737748366,MATH 193B,A01,188817,Staff,0,0,35,35
1683737748366,MATH 193B,A02,188818,Staff,6,0,35,29
1683737749392,MGT 4,A01,202857,Anderson; John Charles,59,0,80,21
1683737750419,MGT 12,A00,202858,Lindenberger; Wade Douglas,39,0,90,51
1683737751447,MGT 18,A00,202859,Staff,73,0,90,17
1683737752474,MGT 18GS,A00,202860,McKay; Michael J,13,0,28,15
1683737753500,MGT 45,A00,202861,Pecore; Joseph P.,8,0,90,82
1683737754525,MGT 100,A00,202863,Yavorsky; Daniel Ryan,27,0,90,63
1683737755550,MGT 103,A00,202864,Ehrich; Kristine R,0,19,90,90
1683737756574,MGT 112,A00,202865,Ehrich; Kristine R,15,0,90,75
1683737757600,MGT 121A,A00,202868,Staff,70,0,90,20
1683737758624,MGT 131B,A00,202869,Anderson; John Charles,58,0,90,32
1683737759652,MGT 136,A00,202871,Lindenberger; Wade Douglas,83,0,90,7
1683737760676,MGT 164,A00,202873,Staff,0,67,90,91
1683737761707,MGT 164GS,A00,202874,McKay; Mary A,13,0,28,15
1683737762730,MGT 180,A00,202875,Staff,0,51,90,91
1683737763754,MMW 11R,A01,205019,Herbst; Matthew,0,0,30,30
1683737763754,MMW 11R,A02,205026,Herbst; Matthew,29,0,30,1
1683737764786,MMW 15,A01,193512,Chang; Edmond Yi-Teh,0,8,28,28
1683737764786,MMW 15,A02,193513,Chang; Edmond Yi-Teh,0,5,28,28
1683737764786,MMW 15,A03,193514,Chang; Edmond Yi-Teh,0,5,28,28
1683737764786,MMW 15,A04,193515,Chang; Edmond Yi-Teh,0,5,28,28
1683737764786,MMW 15,A05,193516,Chang; Edmond Yi-Teh,0,5,28,28
1683737764786,MMW 15,A06,193517,Chang; Edmond Yi-Teh,0,6,28,28
1683737764786,MMW 15,B01,193519,Chang; Edmond Yi-Teh,0,5,28,28
1683737764786,MMW 15,B02,193520,Chang; Edmond Yi-Teh,0,5,28,28
1683737764786,MMW 15,B03,193521,Chang; Edmond Yi-Teh,0,5,28,28
1683737764786,MMW 15,B04,193522,Chang; Edmond Yi-Teh,0,6,28,28
1683737764786,MMW 15,B05,193523,Chang; Edmond Yi-Teh,0,5,28,28
1683737764786,MMW 15,B06,193524,Chang; Edmond Yi-Teh,0,5,28,28
1683737765811,MMW 122,A01,193526,Rahimi; Babak,0,16,28,28
1683737765811,MMW 122,A02,193527,Rahimi; Babak,0,15,28,28
1683737765811,MMW 122,A03,193528,Rahimi; Babak,0,0,0,0
1683737765811,MMW 122,A04,193529,Rahimi; Babak,0,0,0,0
1683737766837,MUS 1A,A01,186663,Staff,0,18,35,35
1683737767862,MUS 4,A01,186715,Staff,0,12,35,35
1683737768886,MUS 5R,A01,186796,Dubnov; Shlomo,0,17,35,35
1683737769914,MUS 6,A01,186798,Staff,0,4,25,25
1683737770939,MUS 7,A01,186830,Staff,11,0,35,24
1683737771964,MUS 8,A01,186930,Staff,0,27,35,35
1683737772987,MUS 15,A01,186932,Staff,0,15,35,35
1683737772987,MUS 15,B01,186934,Staff,0,16,35,35
1683737774012,MUS 80,A00,186935,Staff,0,0,20,20
1683737774012,MUS 80,B00,186936,Staff,24,0,25,1
1683737775036,NANO 11,A00,204702,Lipomi; Darren John,0,0,0,0
1683737776060,NANO 15,A01,204709,Yang; Kesong,0,1,0,0
1683737777088,NANO 114,A00,202069,Jahed Motlagh; Zeinab,2,0,10,8
1683737778112,PHIL 1,A00,186955,Grush; Rick Scott,31,0,40,9
1683737779137,PHIL 10,A01,186973,Grush; Rick Scott,27,0,35,8
1683737779137,PHIL 10,A02,186974,Grush; Rick Scott,33,0,35,2
1683737780165,PHIL 13,A01,186976,Staff,1,0,35,34
1683737780165,PHIL 13,A02,186977,Staff,16,0,35,19
1683737781190,PHIL 14,A01,186979,Staff,30,0,35,5
1683737781190,PHIL 14,A02,186986,Staff,32,0,35,3
1683737782218,PHIL 28,A01,186988,Staff,16,0,30,14
1683737782218,PHIL 28,A02,186989,Staff,0,0,30,30
1683737782218,PHIL 28,A03,186990,Staff,10,0,30,20
1683737782218,PHIL 28,A04,186991,Staff,26,0,30,4
1683737783242,PHIL 120,A00,186997,Staff,23,0,40,17
1683737784269,PHIL 137,A00,187003,Staff,8,0,40,32
1683737785296,PHIL 150,A00,187015,Staff,47,0,70,23
1683737786328,PHIL 167,A00,187021,Lamey; Andy M.,34,0,40,6
1683737787351,PHIL 174,A01,202226,Staff,17,0,20,3
1683737787351,PHIL 174,A02,202235,Staff,20,0,20,0
1683737788374,PHIL 191A,A00,258918,Staff,0,0,1,1
1683737789401,PHYS 1A,A00,187028,Staff,26,0,60,34
1683737790426,PHYS 1AL,001,187036,Staff,3,0,30,27
1683737790426,PHYS 1AL,002,187049,Staff,18,0,30,12
1683737791461,PHYS 1B,A00,187058,Staff,21,0,60,39
1683737792485,PHYS 1BL,001,187064,Staff,0,1,30,30
1683737792485,PHYS 1BL,002,187070,Staff,4,0,30,26
1683737793512,PHYS 1C,A00,187082,Staff,30,0,120,90
1683737794540,PHYS 1CL,001,187088,Staff,0,9,30,30
1683737794540,PHYS 1CL,002,187089,Staff,0,1,30,30
1683737794540,PHYS 1CL,009,262693,Staff,9,0,30,21
1683737795566,PHYS 2B,A01,187097,Staff,55,0,115,60
1683737796592,PHYS 2C,A01,187099,Staff,63,0,115,52
1683737797620,PHYS 2CL,A01,187101,Staff,5,0,28,23
1683737797620,PHYS 2CL,A02,187102,Staff,15,0,28,13
1683737798645,PHYS 2D,A01,187123,Shotwell; Brian,95,0,115,20
1683737799673,PHYS 4B,A01,187133,Grinstein; Benjamin,34,0,50,16
1683737800698,POLI 10,A00,188819,Staff,0,4,50,50
1683737801723,POLI 11,A00,188827,Staff,43,0,50,7
1683737802747,POLI 13R,A00,188828,Staff,0,2,20,20
1683737803771,POLI 27,A01,188830,Elgin; Samuel Zincke,0,2,70,70
1683737804795,POLI 30,A00,188832,Desposato; Scott,30,0,50,20
1683737805822,POLI 102F,A00,188834,Staff,1,0,40,39
1683737806849,POLI 104A,A00,188852,Staff,12,0,30,18
1683737807877,POLI 104I,A00,188853,Staff,0,8,20,20
1683737808904,POLI 110B,A00,188854,Wiens; David,6,0,20,14
1683737809928,POLI 112A,A00,188855,Wiens; David,4,0,30,26
1683737810952,POLI 117R,A00,188856,Forman; Fonna,0,12,20,20
1683737811978,POLI 118,A00,188857,Ingham; Sean,8,0,20,12
1683737813002,POLI 120G,A00,188858,Staff,7,0,30,23
1683737814027,POLI 131CR,A00,188863,Hoston; Germaine,20,0,50,30
1683737815052,POLI 133,A00,188864,Nellis; Gareth Hb,44,0,50,6
1683737816134,POLI 134D,A00,188865,Desposato; Scott,27,0,30,3
1683737817164,POLI 142A,A00,188871,Gartzke; Erik,21,0,50,29
1683737818189,POLI 142K,A00,188874,Staff,38,0,50,12
1683737819216,POLI 143,A00,188940,Gartzke; Erik,15,0,30,15
1683737820241,POLI 153,A00,188943,Staff,1,0,20,19
1683737821289,POLI 160AA,A00,188944,Staff,10,0,40,30
1683737822314,POLI 170A,A00,188945,Staff,10,0,30,20
1683737824367,PSYC 1,A00,188952,Staff,36,0,90,54
1683737825392,PSYC 2,B00,188953,Staff,19,0,35,16
1683737826419,PSYC 6,A00,188970,Staff,47,0,60,13
1683737827444,PSYC 7,A00,188973,Staff,35,0,45,10
1683737828471,PSYC 60,A01,188980,Rickard; Timothy C.,42,0,60,18
1683737829496,PSYC 70,A01,189001,Steiner; Eric Tomas,21,0,45,24
1683737830520,PSYC 100,A00,189005,Lacefield; Katharine I,1,98,120,119
1683737831547,PSYC 102,A00,189008,Staff,6,0,30,24
1683737832572,PSYC 106,B00,189026,Gorman; Michael R.,26,0,60,34
1683737833600,PSYC 114,B01,189033,Winkielman; Piotr,0,31,30,30
1683737834624,PSYC 131,A00,189036,Anagnostaras; Stephan,0,44,60,60
1683737835651,PSYC 136,A00,189041,Lowe; Angela Beth,0,7,25,25
1683737836675,PSYC 137,A00,189057,Winkielman; Piotr,0,36,25,25
1683737837700,PSYC 144,A00,189107,Wixted; John T,0,11,50,50
1683737839749,PSYC 162,A00,189142,Staff,0,9,85,85
1683737840780,PSYC 172,A00,189144,Gorman; Michael R.,0,6,30,30
1683737842828,PSYC 179,A00,189146,Lacefield; Katharine I,0,88,120,120
1683737843856,PSYC 181,A00,189147,Anagnostaras; Stephan,110,45,200,90
1683737844883,PSYC 190R,A00,189148,Barner; David A.,0,23,80,80
1683737845906,PSYC 191,A00,189275,Rickard; Timothy C.,0,11,25,25
1683737846931,PSYC 193,A00,189276,Chapman; Eddie Nathaniel,0,1,0,4
1683737847959,PSYC 193L,A01,189281,Lowe; Angela Beth,8,0,20,12
1683737847959,PSYC 193L,B01,189285,Staff,28,0,35,7
1683737848985,RELI 149,A00,187137,Rahimi; Babak,6,0,40,34
1683737850010,SE 9,A01,187315,Staff,0,2,18,18
1683737851034,SE 101B,A00,187409,Staff,24,0,30,6
1683737852058,SE 110B,A00,187444,Staff,10,0,40,30
1683737853082,SE 130B,A00,187449,Staff,31,0,40,9
1683737854106,SE 150A,A00,187516,Staff,8,0,20,12
1683737855130,SE 154,A00,187528,Staff,29,0,50,21
1683737856154,SIO 3,A01,258171,Staff,35,0,40,5
1683737857178,SIO 10,A00,187144,Cook; Geoffrey W,0,6,75,75
1683737858203,SIO 45,A00,187152,Cook; Geoffrey W,1,7,100,99
1683737859230,SIO 109R,A00,194486,Staff,0,4,20,20
1683737861280,SIO 187,A01,187233,Kacev; David,12,0,40,28
1683737862311,SOCI 1,A01,258656,Thorpe; Charles Robert,28,0,30,2
1683737862311,SOCI 1,A02,258658,Thorpe; Charles Robert,30,0,30,0
1683737862311,SOCI 1,A03,258661,Thorpe; Charles Robert,25,0,25,0
1683737862311,SOCI 1,A04,258666,Thorpe; Charles Robert,22,0,25,3
1683737862311,SOCI 1,A05,258897,Thorpe; Charles Robert,22,0,25,3
1683737862311,SOCI 1,A06,258898,Thorpe; Charles Robert,25,0,25,0
1683737863336,SOCI 30,A01,258903,Pardo Guerra; Juan Pablo,14,0,30,16
1683737864361,SOCI 102,A00,258904,Staff,9,0,25,16
1683737865384,SOCI 106,A00,258905,Staff,19,0,25,6
1683737866410,SOCI 111,A00,258907,Ribas Norris; Janet Vanesa,26,0,30,4
1683737867436,SOCI 121R,A00,258908,Pardo Guerra; Juan Pablo,7,0,30,23
1683737868461,SOCI 126,A01,203330,Staff,14,0,20,6
1683737869486,SOCI 131,A00,258909,Thorpe; Charles Robert,30,0,60,30
1683737870514,SOCI 135,A00,258910,Payne; Christine Anna,0,13,30,30
1683737871542,SOCI 157,A00,258911,Staff,10,0,30,20
1683737872565,SOCI 184,A00,258912,Staff,25,0,30,5
1683737873588,SOCI 188D,A00,258913,Staff,22,0,30,8
1683737874614,SYN 2,001,187529,Staff,9,0,16,7
1683737874614,SYN 2,002,201452,Staff,0,20,16,16
1683737874614,SYN 2,003,201469,Staff,1,0,16,15
1683737875639,SYN 100,A01,187531,Staff,0,9,20,20
1683737875639,SYN 100,B01,201491,Staff,0,10,20,20
1683737876662,TDAC 1,A00,189286,Walsh; Kim C.,3,0,20,17
1683737876662,TDAC 1,B00,189287,Harting; Carla Kelso,10,0,20,10
1683737877686,TDAC 101,A00,189300,Walsh; Kim C.,16,0,20,4
1683737877686,TDAC 101,B00,189301,Harting; Carla Kelso,18,0,20,2
1683737878713,TDAC 102,A00,189304,Basso; Beatrice,14,0,20,6
1683737879738,TDAC 108,A00,189305,Staff,18,0,20,2
1683737880764,TDDE 131,A00,189310,Staff,19,0,20,1
1683737880764,TDDE 131,B00,189314,Staff,19,0,20,1
1683737880764,TDDE 131,C00,189315,Staff,48,0,50,2
1683737880764,TDDE 131,D00,189316,Staff,14,0,15,1
1683737880764,TDDE 131,E00,204841,Staff,20,0,20,0
1683737881793,TDGE 10,A00,189289,Staff,26,0,50,24
1683737881793,TDGE 10,B00,189290,Havis; Allan,0,1,50,50
1683737882819,TDGE 11,A00,189291,Fulton; Julia,0,4,50,50
1683737882819,TDGE 11,B00,189292,Staff,20,0,25,5
1683737882819,TDGE 11,C00,260270,Staff,0,0,0,0
1683737883843,TDGE 25,A00,189294,Staff,1,0,20,19
1683737884867,TDGE 124,A00,189318,Fulton; Julia,0,7,50,50
1683737885891,TDGE 125,A00,189319,Staff,13,0,25,12
1683737885891,TDGE 125,B00,189320,Staff,23,0,25,2
1683737886916,TDGE 127,A00,189322,Havis; Allan,1,0,50,49
1683737887946,TDHT 101,A00,189323,Staff,18,0,25,7
1683737887946,TDHT 101,B00,189324,Staff,25,0,25,0
1683737888973,TDHT 102,A00,189325,Staff,49,0,50,1
1683737889996,TDMV 1,A00,189295,Arcidiacono; Kristin,20,0,30,10
1683737889996,TDMV 1,B00,189296,Caligagan; Maria T.,23,0,30,7
1683737891021,TDMV 2,A00,189297,Sammartano; Tonnie,27,0,30,3
1683737891021,TDMV 2,B00,189299,Arcidiacono; Kristin,23,0,30,7
1683737892046,TDMV 3,A00,204998,Rincon; Alicia,22,0,30,8
1683737893069,TDMV 120,A00,189458,Sammartano; Tonnie,28,0,30,2
1683737894096,TDMV 138,A00,189541,Jun; Grace Shin Hae,20,0,40,20
1683737895123,TDMV 142,A00,189717,Caligagan; Tony,25,0,30,5
1683737895123,TDMV 142,B00,189718,Caligagan; Maria T.,25,0,30,5
1683737896149,TMC 2,A01,187533,Staff,25,0,25,0
1683737896149,TMC 2,A02,187534,Staff,25,0,25,0
1683737897177,USP 1,A01,187536,Kwak; Nancy,0,16,25,25
1683737898200,USP 5,A01,187538,Staff,8,0,25,17
1683737899223,USP 101,A00,199253,Staff,0,4,0,0
1683737900247,USP 124,A00,187562,Boomhower; Matthew Charles,1,0,30,29
1683737901275,USP 138,A00,187582,Staff,19,0,25,6
1683737902301,USP 152,A01,187597,Staff,3,0,25,22
1683737903325,USP 153,A00,187598,Staff,18,0,25,7
1683737904349,USP 168,A00,187607,Kwak; Nancy,2,0,5,3
1683737905376,USP 173,A00,187619,Staff,4,0,25,21
1683737906403,USP 181,A00,187638,Staff,0,4,25,25
1683737907432,VIS 103,A00,187650,Cruz; Edwin Teddy,17,0,75,58
1683737908457,VIS 110D,A00,187669,Staff,13,0,22,9
1683737909482,VIS 127C,A00,187720,Shen; Kuiyi,67,0,146,79
1683737910505,VIS 149,A00,187731,Yoldas; Pinar,0,12,22,22
1683737911530,VIS 151,A01,188091,Staff,22,0,34,12
1683737911530,VIS 151,A02,188092,Staff,11,0,34,23
1683737912558,VIS 160B,A00,188093,Stalbaum; Brett,0,1,10,10
1683737914608,WCWP 10B,A00,201720,Staff,0,0,5,5
1683737914608,WCWP 10B,B00,201722,Staff,0,0,6,6
1683737915637,WCWP 100,A00,201725,Gagnon; Jeffrey C,0,0,2,2
1683737915637,WCWP 100,B00,201727,Staff,0,4,15,15
1683737918746,ANBI 133,A00,258401,Wilder; Linnea Lorene,34,0,40,6
1683737919846,ANBI 140,A00,258395,Hrvoj Mihic; Branka,18,0,25,7
1683737920870,ANSC 120,A00,258402,Bialecki; Jon Anthony,26,0,40,14
1683737921894,ANSC 144,A00,258400,Staff,12,0,40,28
1683737923943,ANSC 166,A00,258396,Parish; Steven Martin,156,0,175,19
1683737924966,ANSC 180,A00,193533,Staff,8,0,20,12
1683737925990,ANSC 188,A00,258397,Jassal; Aftab,34,0,40,6
1683737927013,ANTH 3,A01,258316,Staff,23,0,30,7
1683737928043,ANTH 5,A00,258394,Semendeferi; Ekaterini,16,0,20,4
1683737929070,ANTH 21,A01,258331,Staff,4,0,40,36
1683737930098,ANTH 103,A00,258398,Varma; Saiba,15,0,25,10
1683737931130,AWP 10,001,202034,Staff,0,0,0,0
1683737931130,AWP 10,002,202035,Staff,0,0,0,0
1683737931130,AWP 10,003,202036,Staff,0,0,0,0
1683737931130,AWP 10,004,202037,Staff,0,0,0,0
1683737931130,AWP 10,005,202038,Staff,0,0,0,0
1683737931130,AWP 10,006,202039,Staff,0,0,0,0
1683737931130,AWP 10,007,202040,Staff,0,0,0,0
1683737931130,AWP 10,008,202041,Staff,0,0,0,0
1683737931130,AWP 10,009,202042,Staff,0,0,0,0
1683737931130,AWP 10,010,202043,Staff,0,0,0,0
1683737931130,AWP 10,011,202044,Staff,0,0,0,0
1683737931130,AWP 10,012,202045,Staff,0,0,0,0
1683737931130,AWP 10,013,202046,Staff,0,0,0,0
1683737931130,AWP 10,014,202047,Staff,0,0,0,0
1683737931130,AWP 10,015,202048,Staff,0,0,0,0
1683737931130,AWP 10,016,202049,Staff,0,0,0,0
1683737931130,AWP 10,017,202050,Staff,0,0,0,0
1683737931130,AWP 10,018,202051,Staff,0,0,0,0
1683737931130,AWP 10,019,202052,Staff,0,0,0,0
1683737931130,AWP 10,020,202053,Staff,0,0,0,0
1683737931130,AWP 10,021,202054,Staff,0,0,0,0
1683737931130,AWP 10,022,202055,Staff,0,0,0,0
1683737931130,AWP 10,023,202056,Staff,0,0,0,0
1683737931130,AWP 10,024,202057,Staff,0,0,0,0
1683737931130,AWP 10,025,202058,Staff,0,0,0,0
1683737931130,AWP 10,026,202059,Staff,0,0,0,0
1683737932154,AWP 102,001,202032,Staff,0,0,0,0
1683737932154,AWP 102,002,202033,Staff,0,0,0,0
1683737933178,BENG 100,A01,254234,Taylor Amos; Alyssa C,31,0,40,9
1683737934211,BENG 196,001,270013,Engler; Adam J.,9999,0,9999,0
1683737935236,BICD 100R,A01,202018,Smith; Laurie,0,7,32,32
1683737935236,BICD 100R,A02,202019,Smith; Laurie,0,3,32,32
1683737935236,BICD 100R,A03,202020,Smith; Laurie,0,1,32,32
1683737935236,BICD 100R,A04,202021,Smith; Laurie,6,0,32,26
1683737935236,BICD 100R,A05,202022,Smith; Laurie,10,0,32,22
1683737936261,BICD 136,A01,193242,Gustafson-Brown; Cindy,0,2,32,32
1683737936261,BICD 136,A02,193244,Gustafson-Brown; Cindy,13,0,32,19
1683737937290,BIEB 102,A01,193249,Butler; Shannon Rhey,0,0,32,32
1683737937290,BIEB 102,A02,193251,Butler; Shannon Rhey,0,0,32,32
1683737937290,BIEB 102,A03,193253,Butler; Shannon Rhey,0,0,32,32
1683737937290,BIEB 102,A04,193255,Butler; Shannon Rhey,13,0,32,19
1683737937290,BIEB 102,A05,193265,Butler; Shannon Rhey,25,0,32,7
1683737937290,BIEB 102,A06,193269,Butler; Shannon Rhey,12,0,32,20
1683737939338,BIEB 150,A01,193274,Staff,0,0,32,32
1683737939338,BIEB 150,A02,193285,Staff,24,0,32,8
1683737940363,BIEB 194,A00,193286,Kurle; Carolyn M.,19,0,32,13
1683737941393,BILD 1,A01,192291,Staff,15,0,32,17
1683737941393,BILD 1,A02,192292,Staff,30,0,32,2
1683737941393,BILD 1,B01,192520,Reuther; Keefe,0,1,0,0
1683737941393,BILD 1,B02,192532,Reuther; Keefe,0,1,0,0
1683737942423,BILD 3,A01,192556,Butler; Shannon Rhey,0,0,32,32
1683737942423,BILD 3,A02,192581,Butler; Shannon Rhey,0,1,32,32
1683737942423,BILD 3,A03,192611,Butler; Shannon Rhey,19,0,32,13
1683737942423,BILD 3,A04,192612,Butler; Shannon Rhey,23,0,32,9
1683737942423,BILD 3,A05,192613,Butler; Shannon Rhey,26,0,32,6
1683737942423,BILD 3,A06,192679,Butler; Shannon Rhey,27,0,32,5
1683737942423,BILD 3,A07,192682,Butler; Shannon Rhey,20,0,32,12
1683737943448,BILD 4,A01,192836,Reuther; Keefe,1,0,24,23
1683737943448,BILD 4,A02,193044,Reuther; Keefe,4,0,24,20
1683737944473,BILD 10,A01,193142,Gustafson-Brown; Cindy,29,0,32,3
1683737944473,BILD 10,A02,193149,Gustafson-Brown; Cindy,31,0,32,1
1683737945499,BIMM 100,A01,193301,Staff,0,6,32,32
1683737945499,BIMM 100,A02,193312,Staff,0,7,32,32
1683737945499,BIMM 100,A03,193323,Staff,0,10,32,32
1683737946525,BIMM 101,A01,193329,McDonnell; Lisa Marie,0,3,24,24
1683737946525,BIMM 101,A02,193339,McDonnell; Lisa Marie,0,3,24,24
1683737946525,BIMM 101,B01,193354,McDonnell; Lisa Marie,0,4,24,24
1683737946525,BIMM 101,B02,193357,McDonnell; Lisa Marie,0,3,24,24
1683737947553,BIMM 110,A01,193377,Tat; John,0,11,32,32
1683737947553,BIMM 110,A02,193378,Tat; John,0,11,32,32
1683737948577,BIMM 120,A01,206116,Staff,1,0,32,31
1683737948577,BIMM 120,A02,206117,Staff,7,0,32,25
1683737948577,BIMM 120,A03,206121,Staff,21,0,32,11
1683737949605,BIPN 100,A01,193393,Park; Ji Young,0,15,32,32
1683737949605,BIPN 100,A02,193402,Park; Ji Young,0,14,32,32
1683737949605,BIPN 100,A03,193413,Park; Ji Young,0,14,32,32
1683737949605,BIPN 100,A04,193414,Park; Ji Young,0,13,32,32
1683737950634,BIPN 102,A01,193429,Staff,0,0,32,32
1683737950634,BIPN 102,A02,193438,Staff,18,0,32,14
1683737951658,BIPN 106,A01,193450,Reyes Gonzalez; Catalina,0,2,40,40
1683737952684,BIPN 134,A01,193465,Cooke; James Edward,0,0,32,32
1683737952684,BIPN 134,A02,193474,Cooke; James Edward,24,0,32,8
1683737952684,BIPN 134,A03,193485,Cooke; James Edward,29,0,32,3
1683737952684,BIPN 134,A04,193486,Cooke; James Edward,20,0,32,12
1683737952684,BIPN 134,A05,193491,Cooke; James Edward,31,0,32,1
1683737952684,BIPN 134,A06,193501,Cooke; James Edward,30,0,32,2
1683737952684,BIPN 134,A07,193510,Cooke; James Edward,29,0,32,3
1683737954737,BISP 194,A00,222522,Staff,14,0,32,18
1683737955762,CAT 124,A01,202407,Staff,19,0,25,6
1683737956790,CAT 125,A00,202408,Marchisotto; Jennifer Anne,2,0,20,18
1683737957814,CAT 125R,A00,202409,Smith; Lauryn Alissa,0,11,20,20
1683737957814,CAT 125R,B00,202410,Morales; Celeste Georgianna,0,11,20,20
1683737957814,CAT 125R,C00,202411,Irwin; Matthew Joseph,0,12,20,20
1683737958839,CENG 15,A01,204712,Yang; Kesong,0,1,0,0
1683737959868,CENG 114,A00,202070,Jahed Motlagh; Zeinab,5,0,20,15
1683737960895,CGS 105,A00,185477,Wesling; Megan E.,24,0,40,16
1683737961923,CGS 106,A00,185494,Staff,11,0,22,11
1683737962948,CGS 108,A00,185495,Staff,14,0,20,6
1683737963971,CGS 114,A00,185496,Staff,13,0,18,5
1683737964997,CGS 119,A00,185501,Staff,15,0,20,5
1683737966021,CGS 120,A00,185511,Staff,11,0,20,9
1683737967051,CHEM 4,A01,184675,Bussey; Thomas J,97,0,100,3
1683737968075,CHEM 6A,A01,184677,Staff,32,0,60,28
1683737969099,CHEM 6B,A01,184679,Staff,63,0,100,37
1683737970123,CHEM 6C,A01,184681,Bussey; Thomas J,0,0,50,50
1683737970123,CHEM 6C,A02,184682,Bussey; Thomas J,32,0,50,18
1683737971146,CHEM 40A,A01,184684,Albizati; Kim F.,33,0,100,67
1683737972174,CHEM 40B,A01,184686,Albizati; Kim F.,0,22,100,100
1683737973198,CHEM 41B,A01,184690,Staff,51,0,100,49
1683737974224,COGS 3,A01,184715,Boyle; Mary E. T.,0,27,40,40
1683737975248,COGS 14B,A01,185172,Staff,0,14,38,38
1683737976272,COGS 18,A01,184736,Staff,14,0,80,66
1683737977296,COGS 100,A01,184932,Staff,0,8,73,73
1683737978320,COGS 101A,A01,184935,Staff,0,40,30,30
1683737979345,COGS 101B,A01,184944,Staff,0,2,30,30
1683737980372,COGS 101C,A01,184946,Staff,0,10,30,30
1683737981396,COGS 102A,A01,184951,Johnson; Christine M.,1,0,40,39
1683737982421,COGS 107B,A01,184953,Mooshagian; Eric Frederick,0,52,40,40
1683737983445,COGS 118B,A01,184959,Gupta; Anjum,0,50,40,40
1683737984473,COGS 153,A00,184961,Staff,1,16,30,29
1683737985497,COGS 177,A00,184962,Staff,0,20,30,30
1683737986522,COGS 187A,A01,184969,Boyle; Mary E. T.,0,19,40,40
1683737987551,COMM 10,A01,185174,Staff,0,5,25,25
1683737987551,COMM 10,A02,185189,Staff,0,2,25,25
1683737987551,COMM 10,A03,269821,Staff,0,1,0,0
1683737988581,COMM 100B,A02,185476,Staff,10,0,25,15
1683737988581,COMM 100B,A03,277340,Staff,25,0,25,0
1683737989607,COMM 100C,A01,185314,Staff,2,0,25,23
1683737989607,COMM 100C,A02,185327,Staff,17,0,25,8
1683737990629,COMM 110M,A00,185349,Staff,0,0,40,40
1683737991654,COMM 113T,A00,185352,Staff,25,0,40,15
1683737992678,COMM 114I,A00,185353,Staff,31,0,40,9
1683737993705,COMM 131,A00,185354,Staff,17,0,30,13
1683737994728,CSE 8A,A50,185358,Cao; Yingjun,0,46,10,10
1683737995755,CSE 8B,A01,185362,Staff,0,48,50,50
1683737996779,CSE 11,A01,185416,Cao; Yingjun,0,91,10,10
1683737997806,CSE 20,A01,185445,Briones; Jor-el Thomas Caparas,3,0,25,22
1683737998832,CSE 21,A01,185447,Staff,9,0,50,41
1683737999862,CSE 101,A01,185451,Staff,0,13,50,50
1683737999862,CSE 101,B01,185453,Jones; Miles E,0,15,50,50
1683738001916,CSE 141,A01,185458,Eldon; John,16,0,100,84
1683738002940,CSE 141L,A01,185461,Eldon; John,8,0,100,92
1683738003966,CSE 142,A01,185463,Staff,34,0,60,26
1683738003966,CSE 142,B01,201355,Staff,0,7,60,60
1683738004995,CSE 142L,A01,185470,Staff,34,0,60,26
1683738004995,CSE 142L,B01,201417,Staff,0,6,60,60
1683738006017,CSE 190,A00,201433,Staff,32,0,49,17
1683738007041,DOC 1,A01,259136,Strom; Megan C.,7,0,15,8
1683738007041,DOC 1,A02,259137,Strom; Megan C.,15,0,15,0
1683738007041,DOC 1,A03,259138,Strom; Megan C.,14,0,15,1
1683738007041,DOC 1,A04,259139,Strom; Megan C.,13,0,15,2
1683738008067,DOC 100D,A00,259140,Pass; Natalye Joann,14,0,25,11
1683738009090,DSGN 1,A01,184749,Rill; Bryan,0,26,30,30
1683738010118,DSGN 100,A01,185168,Staff,0,2,25,25
1683738011145,ECE 5,A01,185626,Morris; Karcher William,0,12,0,0
1683738012169,ECE 101,A01,185628,Staff,14,0,70,56
1683738013193,ECE 107,A01,185635,Baghdadchi; Saharnaz,0,0,20,20
1683738013193,ECE 107,A02,185638,Baghdadchi; Saharnaz,1,0,20,19
1683738014216,ECE 148,A01,185647,Silberman; Jack,0,0,16,16
1683738015239,ECON 1,A01,185537,Crane; Meredith Helen,54,0,70,16
1683738016262,ECON 3,A01,185549,Crane; Meredith Helen,30,0,70,40
1683738017289,ECON 4,A01,203354,Anderson; John Charles,0,5,10,10
1683738018317,ECON 100A,A01,185574,Staff,0,5,40,40
1683738019344,ECON 100B,A01,185576,Staff,0,12,50,50
1683738020374,ECON 100C,A01,185589,Newhouse; Herbert S,30,0,70,40
1683738021405,ECON 105,A00,185608,Vespa; Emanuel Ignacio,19,0,35,16
1683738022433,ECON 109,A01,185610,Shishkin; Denis,9,0,35,26
1683738023511,ECON 110A,A01,185612,Staff,8,0,40,32
1683738024534,ECON 120A,A01,185615,Staff,19,0,40,21
1683738025562,ECON 120C,A01,185617,Sun; Yixiao,0,21,70,70
1683738026586,ECON 144,A00,203346,Squires; Dale E,2,0,35,33
1683738027616,ECON 171,A01,203349,Newhouse; Herbert S,0,1,35,35
1683738028641,ECON 173A,A01,185621,Toda; Alexis Akira,21,0,35,14
1683738029675,EDS 25,A01,202413,Staff,0,1,0,0
1683738029675,EDS 25,A02,202414,Staff,0,1,0,0
1683738029675,EDS 25,A03,202415,Staff,0,0,0,0
1683738029675,EDS 25,A04,202416,Staff,0,1,0,0
1683738029675,EDS 25,A05,202439,Staff,0,0,0,0
1683738029675,EDS 25,A06,202440,Staff,0,0,0,0
1683738029675,EDS 25,B01,202631,Staff,0,0,0,0
1683738029675,EDS 25,B02,202632,Staff,0,0,0,0
1683738029675,EDS 25,B03,202639,Staff,0,0,0,0
1683738029675,EDS 25,B04,202640,Staff,0,0,0,0
1683738029675,EDS 25,B05,202643,Staff,0,0,0,0
1683738029675,EDS 25,B06,202644,Staff,0,0,0,0
1683738030699,EDS 38,A01,202659,Black; Alison Michelle,25,0,25,0
1683738031726,EDS 115,A00,202652,Staff,18,0,30,12
1683738032753,EDS 125,A00,202649,Staff,13,0,30,17
1683738033780,EDS 126,A01,203332,Staff,30,0,30,0
1683738034811,EDS 139,A00,202838,Staff,16,0,25,9
1683738035834,EDS 146,A01,202655,Staff,14,0,25,11
1683738036857,ENG 15,A00,185667,Staff,0,1,0,2
1683738036857,ENG 15,B00,185672,Staff,0,0,0,1
1683738036857,ENG 15,C00,185675,Staff,0,0,0,0
1683738036857,ENG 15,D00,185682,Staff,0,0,0,0
1683738036857,ENG 15,E00,185684,Staff,0,0,0,0
1683738037881,ETHN 103,A00,185710,Staff,0,8,35,35
1683738038906,ETHN 103A,A00,199228,Man; Simeon S,0,0,9,9
1683738039933,ETHN 109,A00,185711,Staff,15,0,35,20
1683738040960,ETHN 142,A00,185726,Staff,0,4,30,30
1683738041984,ETHN 163J,A00,199229,Man; Simeon S,5,0,8,3
1683738043009,ETHN 168,A00,185727,Staff,7,0,10,3
1683738044036,ETHN 182,A00,185728,Staff,0,0,35,35
1683738045061,ETHN 183,A00,185737,Staff,10,0,18,8
1683738046086,GLBH 111,A01,209361,Burgos; Jose L.,0,0,0,0
1683738048137,HIEU 104,A00,185792,Staff,14,0,20,6
1683738049162,HIEU 115,A00,185800,Staff,0,0,20,20
1683738050185,HIEU 128,A00,185801,Staff,0,9,20,20
1683738051210,HIEU 147,A00,185802,Staff,15,0,20,5
1683738052234,HIEU 154,A00,185823,Staff,11,0,20,9
1683738053259,HILA 102,A00,185826,Staff,14,0,20,6
1683738054284,HILD 2C,A01,185778,Staff,0,13,20,20
1683738055310,HILD 7B,A01,185780,Kwak; Nancy,0,17,32,32
1683738055310,HILD 7B,A02,185781,Kwak; Nancy,0,18,32,32
1683738056338,HILD 30,A01,185791,Staff,12,0,20,8
1683738057363,HISC 119,A00,185830,Golan; Tal,0,10,20,20
1683738058390,HITO 156GS,A00,185831,Patterson; Patrick H.,0,0,0,23
1683738059415,HIUS 103,A00,185832,Man; Simeon S,0,4,20,20
1683738060440,HIUS 117,A00,185836,Kwak; Nancy,2,0,20,18
1683738061467,HIUS 125,A00,185840,Man; Simeon S,0,2,23,23
1683738062490,HIUS 149,A00,185845,Staff,1,0,20,19
1683738063520,HUM 3,A01,185882,Zavodny; Tatiana Sophia,0,8,50,50
1683738063520,HUM 3,B01,185899,Caldwell; Michael Alan,0,18,50,50
1683738064547,HUM 3GS,A00,185900,Patterson; Patrick H.,0,0,0,23
1683738065577,HUM 4,A01,185938,Zroka; Amy Liane,28,0,50,22
1683738065577,HUM 4,B01,185956,Watkins; Eric,0,6,50,50
1683738065577,HUM 4,B02,202209,Watkins; Eric,0,6,50,50
1683738065577,HUM 4,B03,202210,Watkins; Eric,0,5,50,50
1683738066602,HUM 5,A01,185958,West; Geoffrey Scott,0,1,50,50
1683738066602,HUM 5,A02,202215,West; Geoffrey Scott,0,1,50,50
1683738067627,INTL 190,A00,185959,Gagnon; Jeffrey C,0,0,0,9
1683738067627,INTL 190,B00,185960,Lettieri; Michael Joseph,0,0,0,2
1683738068653,JAPN 180,A00,254509,Staff,4,0,30,26
1683738069681,LATI 10,A01,202853,Kennemore; Amy Michelle,0,0,31,31
1683738069681,LATI 10,A02,202854,Kennemore; Amy Michelle,0,0,32,32
1683738069681,LATI 10,A03,270054,Kennemore; Amy Michelle,30,0,30,0
1683738070712,LATI 180,A00,202855,Kennemore; Amy Michelle,11,0,20,9
1683738071745,LAWS 101,A00,201767,Golan; Tal,0,7,40,40
1683738072772,LIFR 1C,A00,185961,Staff,6,0,20,14
1683738073802,LIFR 1CX,A00,185962,Staff,7,0,20,13
1683738074826,LIFR 1D,A00,185963,Staff,7,0,20,13
1683738075853,LIFR 1DX,A00,185964,Staff,7,0,20,13
1683738076877,LIGN 101,A01,186039,Staff,43,0,50,7
1683738077903,LIGN 165,A00,186040,Staff,14,0,50,36
1683738078929,LTCS 108,A00,186041,Staff,5,0,10,5
1683738079953,LTCS 119,A00,186042,Staff,15,0,20,5
1683738080980,LTCS 130,A00,186043,Wesling; Megan E.,15,0,25,10
1683738083036,LTEA 138,A00,186119,Staff,13,0,40,27
1683738084060,LTEN 124,A00,186148,Staff,5,0,25,20
1683738085083,LTEN 178,A00,186149,Staff,6,0,15,9
1683738086110,LTEN 181,A00,186150,Blanco; John D,34,0,40,6
1683738087134,LTWL 120,A00,186160,Staff,19,0,25,6
1683738088162,LTWL 165,A00,186161,Staff,22,0,25,3
1683738089188,LTWR 100,A00,186162,Staff,0,5,15,15
1683738090215,LTWR 102,A00,186163,Doller; Ben,5,0,15,10
1683738091239,MAE 8,A01,186412,Staff,0,1,0,1
1683738092263,MAE 30B,A00,186445,Bahadori; Mohammad Yousef,81,0,100,19
1683738093287,MAE 40,A00,186592,Bewley; Thomas R,10,0,50,40
1683738094311,MAE 101B,A00,186593,Bahadori; Mohammad Yousef,79,0,100,21
1683738095335,MAE 105,A00,186594,Bandaru; Prabhakar,10,0,50,40
1683738096358,MAE 107,A00,186599,Pham; Hieu Tan,0,8,120,120
1683738097382,MAE 148,A01,186660,Silberman; Jack,3,0,16,13
1683738098407,MATH 10A,A01,188095,Staff,0,6,35,35
1683738099432,MATH 10B,A01,188097,Bowers; Adam R.,0,12,30,30
1683738099432,MATH 10B,A02,188099,Bowers; Adam R.,0,11,30,30
1683738099432,MATH 10B,B01,188104,Bowers; Adam R.,0,10,30,30
1683738099432,MATH 10B,B02,188106,Bowers; Adam R.,0,9,30,30
1683738100457,MATH 10C,A01,188111,Staff,0,20,30,30
1683738100457,MATH 10C,A02,188127,Staff,0,19,30,30
1683738100457,MATH 10C,A03,188131,Staff,0,19,30,30
1683738100457,MATH 10C,B01,188218,Staff,17,0,30,13
1683738100457,MATH 10C,B02,188244,Staff,13,0,30,17
1683738100457,MATH 10C,B03,188277,Staff,14,0,30,16
1683738101486,MATH 18,A01,188344,Bach; Quang Tran,18,0,30,12
1683738101486,MATH 18,A02,188345,Bach; Quang Tran,11,0,30,19
1683738101486,MATH 18,B01,188353,Bach; Quang Tran,11,0,30,19
1683738101486,MATH 18,B02,188354,Bach; Quang Tran,19,0,30,11
1683738102514,MATH 20A,A01,188374,Staff,10,0,35,25
1683738103540,MATH 20B,A01,188382,Ohm; Ko Woon,7,0,30,23
1683738103540,MATH 20B,A02,188383,Ohm; Ko Woon,22,0,30,8
1683738103540,MATH 20B,B01,188385,Ohm; Ko Woon,7,0,30,23
1683738103540,MATH 20B,B02,188392,Ohm; Ko Woon,22,0,30,8
1683738104565,MATH 20C,A01,188394,Harel; Guershon,10,0,30,20
1683738104565,MATH 20C,A02,188395,Harel; Guershon,13,0,30,17
1683738104565,MATH 20C,B01,188404,Harel; Guershon,5,0,30,25
1683738104565,MATH 20C,B02,188405,Harel; Guershon,18,0,30,12
1683738105591,MATH 20D,A01,188414,Hammock; Frances H,0,1,30,30
1683738105591,MATH 20D,A02,188415,Hammock; Frances H,0,1,30,30
1683738105591,MATH 20D,B01,188447,Hammock; Frances H,0,1,30,30
1683738105591,MATH 20D,B02,188486,Hammock; Frances H,2,0,30,28
1683738106615,MATH 20E,A01,188649,Staff,21,0,30,9
1683738106615,MATH 20E,A02,188650,Staff,20,0,30,10
1683738106615,MATH 20E,A03,188673,Staff,0,0,30,30
1683738107643,MATH 102,A01,188675,Staff,0,40,35,35
1683738108672,MATH 103B,A01,188681,Staff,3,0,35,32
1683738108672,MATH 103B,B01,188692,Staff,5,0,35,30
1683738109699,MATH 109,A01,188695,Salehi Golsefidy; Alireza,24,0,35,11
1683738109699,MATH 109,A02,188696,Salehi Golsefidy; Alireza,24,0,35,11
1683738110727,MATH 120A,A01,188698,Eggers; John Dietrich,7,0,35,28
1683738111756,MATH 142B,A01,188736,Ioana; Adrian,0,0,30,30
1683738111756,MATH 142B,A02,188741,Ioana; Adrian,0,1,30,30
1683738111756,MATH 142B,A03,188743,Ioana; Adrian,0,3,30,30
1683738112784,MATH 168A,A01,188790,Staff,0,11,35,35
1683738113812,MATH 170A,A01,188803,Nie; Jiawang,0,2,35,35
1683738113812,MATH 170A,A02,188811,Nie; Jiawang,0,1,35,35
1683738113812,MATH 170A,A03,188814,Nie; Jiawang,1,0,35,34
1683738113812,MATH 170A,A04,188815,Nie; Jiawang,4,0,35,31
1683738114840,MATH 193B,A01,188817,Staff,0,0,35,35
1683738114840,MATH 193B,A02,188818,Staff,6,0,35,29
1683738115867,MGT 4,A01,202857,Anderson; John Charles,59,0,80,21
1683738116891,MGT 12,A00,202858,Lindenberger; Wade Douglas,39,0,90,51
1683738117918,MGT 18,A00,202859,Staff,73,0,90,17
1683738118948,MGT 18GS,A00,202860,McKay; Michael J,13,0,28,15
1683738119978,MGT 45,A00,202861,Pecore; Joseph P.,8,0,90,82
1683738121003,MGT 100,A00,202863,Yavorsky; Daniel Ryan,27,0,90,63
1683738122028,MGT 103,A00,202864,Ehrich; Kristine R,0,19,90,90
1683738123058,MGT 112,A00,202865,Ehrich; Kristine R,15,0,90,75
1683738124085,MGT 121A,A00,202868,Staff,70,0,90,20
1683738125110,MGT 131B,A00,202869,Anderson; John Charles,58,0,90,32
1683738126135,MGT 136,A00,202871,Lindenberger; Wade Douglas,83,0,90,7
1683738127215,MGT 164,A00,202873,Staff,0,67,90,91
1683738128242,MGT 164GS,A00,202874,McKay; Mary A,13,0,28,15
1683738129272,MGT 180,A00,202875,Staff,0,51,90,91
1683738130297,MMW 11R,A01,205019,Herbst; Matthew,0,0,30,30
1683738130297,MMW 11R,A02,205026,Herbst; Matthew,29,0,30,1
1683738131322,MMW 15,A01,193512,Chang; Edmond Yi-Teh,0,8,28,28
1683738131322,MMW 15,A02,193513,Chang; Edmond Yi-Teh,0,5,28,28
1683738131322,MMW 15,A03,193514,Chang; Edmond Yi-Teh,0,5,28,28
1683738131322,MMW 15,A04,193515,Chang; Edmond Yi-Teh,0,5,28,28
1683738131322,MMW 15,A05,193516,Chang; Edmond Yi-Teh,0,5,28,28
1683738131322,MMW 15,A06,193517,Chang; Edmond Yi-Teh,0,6,28,28
1683738131322,MMW 15,B01,193519,Chang; Edmond Yi-Teh,0,5,28,28
1683738131322,MMW 15,B02,193520,Chang; Edmond Yi-Teh,0,5,28,28
1683738131322,MMW 15,B03,193521,Chang; Edmond Yi-Teh,0,5,28,28
1683738131322,MMW 15,B04,193522,Chang; Edmond Yi-Teh,0,6,28,28
1683738131322,MMW 15,B05,193523,Chang; Edmond Yi-Teh,0,5,28,28
1683738131322,MMW 15,B06,193524,Chang; Edmond Yi-Teh,0,5,28,28
1683738132345,MMW 122,A01,193526,Rahimi; Babak,0,16,28,28
1683738132345,MMW 122,A02,193527,Rahimi; Babak,0,15,28,28
1683738132345,MMW 122,A03,193528,Rahimi; Babak,0,0,0,0
1683738132345,MMW 122,A04,193529,Rahimi; Babak,0,0,0,0
1683738133372,MUS 1A,A01,186663,Staff,0,18,35,35
1683738134403,MUS 4,A01,186715,Staff,0,12,35,35
1683738135428,MUS 5R,A01,186796,Dubnov; Shlomo,0,17,35,35
1683738136454,MUS 6,A01,186798,Staff,0,4,25,25
1683738137481,MUS 7,A01,186830,Staff,11,0,35,24
1683738138508,MUS 8,A01,186930,Staff,0,27,35,35
1683738139534,MUS 15,A01,186932,Staff,0,15,35,35
1683738139534,MUS 15,B01,186934,Staff,0,16,35,35
1683738140560,MUS 80,A00,186935,Staff,0,0,20,20
1683738140560,MUS 80,B00,186936,Staff,24,0,25,1
1683738141585,NANO 11,A00,204702,Lipomi; Darren John,0,0,0,0
1683738142611,NANO 15,A01,204709,Yang; Kesong,0,1,0,0
1683738143634,NANO 114,A00,202069,Jahed Motlagh; Zeinab,2,0,10,8
1683738144662,PHIL 1,A00,186955,Grush; Rick Scott,31,0,40,9
1683738145685,PHIL 10,A01,186973,Grush; Rick Scott,27,0,35,8
1683738145685,PHIL 10,A02,186974,Grush; Rick Scott,33,0,35,2
1683738146710,PHIL 13,A01,186976,Staff,1,0,35,34
1683738146710,PHIL 13,A02,186977,Staff,16,0,35,19
1683738147738,PHIL 14,A01,186979,Staff,30,0,35,5
1683738147738,PHIL 14,A02,186986,Staff,32,0,35,3
1683738148766,PHIL 28,A01,186988,Staff,16,0,30,14
1683738148766,PHIL 28,A02,186989,Staff,0,0,30,30
1683738148766,PHIL 28,A03,186990,Staff,10,0,30,20
1683738148766,PHIL 28,A04,186991,Staff,26,0,30,4
1683738149790,PHIL 120,A00,186997,Staff,23,0,40,17
1683738150817,PHIL 137,A00,187003,Staff,8,0,40,32
1683738151842,PHIL 150,A00,187015,Staff,47,0,70,23
1683738152869,PHIL 167,A00,187021,Lamey; Andy M.,34,0,40,6
1683738153892,PHIL 174,A01,202226,Staff,17,0,20,3
1683738153892,PHIL 174,A02,202235,Staff,20,0,20,0
1683738154919,PHIL 191A,A00,258918,Staff,0,0,1,1
1683738155946,PHYS 1A,A00,187028,Staff,26,0,60,34
1683738156971,PHYS 1AL,001,187036,Staff,3,0,30,27
1683738156971,PHYS 1AL,002,187049,Staff,18,0,30,12
1683738157996,PHYS 1B,A00,187058,Staff,21,0,60,39
1683738159023,PHYS 1BL,001,187064,Staff,0,1,30,30
1683738159023,PHYS 1BL,002,187070,Staff,4,0,30,26
1683738160050,PHYS 1C,A00,187082,Staff,30,0,120,90
1683738161075,PHYS 1CL,001,187088,Staff,0,9,30,30
1683738161075,PHYS 1CL,002,187089,Staff,0,1,30,30
1683738161075,PHYS 1CL,009,262693,Staff,9,0,30,21
1683738162099,PHYS 2B,A01,187097,Staff,55,0,115,60
1683738163124,PHYS 2C,A01,187099,Staff,63,0,115,52
1683738164148,PHYS 2CL,A01,187101,Staff,5,0,28,23
1683738164148,PHYS 2CL,A02,187102,Staff,15,0,28,13
1683738165172,PHYS 2D,A01,187123,Shotwell; Brian,95,0,115,20
1683738166200,PHYS 4B,A01,187133,Grinstein; Benjamin,34,0,50,16
1683738167225,POLI 10,A00,188819,Staff,0,4,50,50
1683738168249,POLI 11,A00,188827,Staff,43,0,50,7
1683738169271,POLI 13R,A00,188828,Staff,0,2,20,20
1683738170294,POLI 27,A01,188830,Elgin; Samuel Zincke,0,2,70,70
1683738171322,POLI 30,A00,188832,Desposato; Scott,30,0,50,20
1683738172345,POLI 102F,A00,188834,Staff,1,0,40,39
1683738173373,POLI 104A,A00,188852,Staff,12,0,30,18
1683738174397,POLI 104I,A00,188853,Staff,0,8,20,20
1683738175423,POLI 110B,A00,188854,Wiens; David,6,0,20,14
1683738176447,POLI 112A,A00,188855,Wiens; David,4,0,30,26
1683738177473,POLI 117R,A00,188856,Forman; Fonna,0,12,20,20
1683738178497,POLI 118,A00,188857,Ingham; Sean,8,0,20,12
1683738179522,POLI 120G,A00,188858,Staff,7,0,30,23
1683738180546,POLI 131CR,A00,188863,Hoston; Germaine,19,0,50,31
1683738181571,POLI 133,A00,188864,Nellis; Gareth Hb,44,0,50,6
1683738182595,POLI 134D,A00,188865,Desposato; Scott,27,0,30,3
1683738183622,POLI 142A,A00,188871,Gartzke; Erik,21,0,50,29
1683738184646,POLI 142K,A00,188874,Staff,38,0,50,12
1683738185673,POLI 143,A00,188940,Gartzke; Erik,15,0,30,15
1683738186697,POLI 153,A00,188943,Staff,1,0,20,19
1683738187721,POLI 160AA,A00,188944,Staff,10,0,40,30
1683738188745,POLI 170A,A00,188945,Staff,10,0,30,20
1683738190792,PSYC 1,A00,188952,Staff,36,0,90,54
1683738191816,PSYC 2,B00,188953,Staff,19,0,35,16
1683738192840,PSYC 6,A00,188970,Staff,47,0,60,13
1683738193868,PSYC 7,A00,188973,Staff,35,0,45,10
1683738194892,PSYC 60,A01,188980,Rickard; Timothy C.,42,0,60,18
1683738195916,PSYC 70,A01,189001,Steiner; Eric Tomas,21,0,45,24
1683738196939,PSYC 100,A00,189005,Lacefield; Katharine I,1,98,120,119
1683738197962,PSYC 102,A00,189008,Staff,6,0,30,24
1683738198986,PSYC 106,B00,189026,Gorman; Michael R.,26,0,60,34
1683738200015,PSYC 114,B01,189033,Winkielman; Piotr,0,31,30,30
1683738201039,PSYC 131,A00,189036,Anagnostaras; Stephan,0,44,60,60
1683738202064,PSYC 136,A00,189041,Lowe; Angela Beth,0,7,25,25
1683738203093,PSYC 137,A00,189057,Winkielman; Piotr,0,36,25,25
1683738204121,PSYC 144,A00,189107,Wixted; John T,0,11,50,50
1683738206170,PSYC 162,A00,189142,Staff,0,9,85,85
1683738207193,PSYC 172,A00,189144,Gorman; Michael R.,0,6,30,30
1683738209243,PSYC 179,A00,189146,Lacefield; Katharine I,0,88,120,120
1683738210270,PSYC 181,A00,189147,Anagnostaras; Stephan,110,45,200,90
1683738211296,PSYC 190R,A00,189148,Barner; David A.,0,23,80,80
1683738212319,PSYC 191,A00,189275,Rickard; Timothy C.,0,11,25,25
1683738213343,PSYC 193,A00,189276,Chapman; Eddie Nathaniel,0,1,0,4
1683738214367,PSYC 193L,A01,189281,Lowe; Angela Beth,8,0,20,12
1683738214367,PSYC 193L,B01,189285,Staff,28,0,35,7
1683738215391,RELI 149,A00,187137,Rahimi; Babak,6,0,40,34
1683738216415,SE 9,A01,187315,Staff,0,2,18,18
1683738217443,SE 101B,A00,187409,Staff,24,0,30,6
1683738218466,SE 110B,A00,187444,Staff,10,0,40,30
1683738219494,SE 130B,A00,187449,Staff,31,0,40,9
1683738220522,SE 150A,A00,187516,Staff,8,0,20,12
1683738221547,SE 154,A00,187528,Staff,29,0,50,21
1683738222571,SIO 3,A01,258171,Staff,35,0,40,5
1683738223596,SIO 10,A00,187144,Cook; Geoffrey W,0,6,75,75
1683738224624,SIO 45,A00,187152,Cook; Geoffrey W,1,7,100,99
1683738225651,SIO 109R,A00,194486,Staff,0,4,20,20
1683738227703,SIO 187,A01,187233,Kacev; David,12,0,40,28
1683738228734,SOCI 1,A01,258656,Thorpe; Charles Robert,28,0,30,2
1683738228734,SOCI 1,A02,258658,Thorpe; Charles Robert,30,0,30,0
1683738228734,SOCI 1,A03,258661,Thorpe; Charles Robert,25,0,25,0
1683738228734,SOCI 1,A04,258666,Thorpe; Charles Robert,22,0,25,3
1683738228734,SOCI 1,A05,258897,Thorpe; Charles Robert,22,0,25,3
1683738228734,SOCI 1,A06,258898,Thorpe; Charles Robert,25,0,25,0
1683738229763,SOCI 30,A01,258903,Pardo Guerra; Juan Pablo,14,0,30,16
1683738230846,SOCI 102,A00,258904,Staff,9,0,25,16
1683738231874,SOCI 106,A00,258905,Staff,19,0,25,6
1683738232901,SOCI 111,A00,258907,Ribas Norris; Janet Vanesa,26,0,30,4
1683738233928,SOCI 121R,A00,258908,Pardo Guerra; Juan Pablo,7,0,30,23
1683738234954,SOCI 126,A01,203330,Staff,14,0,20,6
1683738235979,SOCI 131,A00,258909,Thorpe; Charles Robert,30,0,60,30
1683738237010,SOCI 135,A00,258910,Payne; Christine Anna,0,13,30,30
1683738238035,SOCI 157,A00,258911,Staff,10,0,30,20
1683738239060,SOCI 184,A00,258912,Staff,25,0,30,5
1683738240081,SOCI 188D,A00,258913,Staff,22,0,30,8
1683738241105,SYN 2,001,187529,Staff,9,0,16,7
1683738241105,SYN 2,002,201452,Staff,0,20,16,16
1683738241105,SYN 2,003,201469,Staff,1,0,16,15
1683738242130,SYN 100,A01,187531,Staff,0,9,20,20
1683738242130,SYN 100,B01,201491,Staff,0,10,20,20
1683738243156,TDAC 1,A00,189286,Walsh; Kim C.,3,0,20,17
1683738243156,TDAC 1,B00,189287,Harting; Carla Kelso,10,0,20,10
1683738244183,TDAC 101,A00,189300,Walsh; Kim C.,16,0,20,4
1683738244183,TDAC 101,B00,189301,Harting; Carla Kelso,18,0,20,2
1683738245207,TDAC 102,A00,189304,Basso; Beatrice,14,0,20,6
1683738246231,TDAC 108,A00,189305,Staff,18,0,20,2
1683738247260,TDDE 131,A00,189310,Staff,19,0,20,1
1683738247260,TDDE 131,B00,189314,Staff,19,0,20,1
1683738247260,TDDE 131,C00,189315,Staff,48,0,50,2
1683738247260,TDDE 131,D00,189316,Staff,14,0,15,1
1683738247260,TDDE 131,E00,204841,Staff,20,0,20,0
1683738248287,TDGE 10,A00,189289,Staff,26,0,50,24
1683738248287,TDGE 10,B00,189290,Havis; Allan,0,1,50,50
1683738249318,TDGE 11,A00,189291,Fulton; Julia,0,4,50,50
1683738249318,TDGE 11,B00,189292,Staff,20,0,25,5
1683738249318,TDGE 11,C00,260270,Staff,0,0,0,0
1683738250345,TDGE 25,A00,189294,Staff,1,0,20,19
1683738251371,TDGE 124,A00,189318,Fulton; Julia,0,7,50,50
1683738252395,TDGE 125,A00,189319,Staff,13,0,25,12
1683738252395,TDGE 125,B00,189320,Staff,23,0,25,2
1683738253423,TDGE 127,A00,189322,Havis; Allan,1,0,50,49
1683738254450,TDHT 101,A00,189323,Staff,18,0,25,7
1683738254450,TDHT 101,B00,189324,Staff,25,0,25,0
1683738255487,TDHT 102,A00,189325,Staff,49,0,50,1
1683738256514,TDMV 1,A00,189295,Arcidiacono; Kristin,20,0,30,10
1683738256514,TDMV 1,B00,189296,Caligagan; Maria T.,23,0,30,7
1683738257537,TDMV 2,A00,189297,Sammartano; Tonnie,27,0,30,3
1683738257537,TDMV 2,B00,189299,Arcidiacono; Kristin,23,0,30,7
1683738258564,TDMV 3,A00,204998,Rincon; Alicia,22,0,30,8
1683738259592,TDMV 120,A00,189458,Sammartano; Tonnie,28,0,30,2
1683738260619,TDMV 138,A00,189541,Jun; Grace Shin Hae,20,0,40,20
1683738261647,TDMV 142,A00,189717,Caligagan; Tony,25,0,30,5
1683738261647,TDMV 142,B00,189718,Caligagan; Maria T.,25,0,30,5
1683738262674,TMC 2,A01,187533,Staff,25,0,25,0
1683738262674,TMC 2,A02,187534,Staff,25,0,25,0
1683738263702,USP 1,A01,187536,Kwak; Nancy,0,16,25,25
1683738264726,USP 5,A01,187538,Staff,8,0,25,17
1683738265750,USP 101,A00,199253,Staff,0,4,0,0
1683738266774,USP 124,A00,187562,Boomhower; Matthew Charles,1,0,30,29
1683738267799,USP 138,A00,187582,Staff,19,0,25,6
1683738268823,USP 152,A01,187597,Staff,3,0,25,22
1683738269847,USP 153,A00,187598,Staff,18,0,25,7
1683738270874,USP 168,A00,187607,Kwak; Nancy,2,0,5,3
1683738271898,USP 173,A00,187619,Staff,4,0,25,21
1683738272922,USP 181,A00,187638,Staff,0,4,25,25
1683738273949,VIS 103,A00,187650,Cruz; Edwin Teddy,17,0,75,58
1683738274974,VIS 110D,A00,187669,Staff,13,0,22,9
1683738276004,VIS 127C,A00,187720,Shen; Kuiyi,67,0,146,79
1683738277028,VIS 149,A00,187731,Yoldas; Pinar,0,12,22,22
1683738278054,VIS 151,A01,188091,Staff,22,0,34,12
1683738278054,VIS 151,A02,188092,Staff,11,0,34,23
1683738279077,VIS 160B,A00,188093,Stalbaum; Brett,0,1,10,10
1683738281131,WCWP 10B,A00,201720,Staff,0,0,5,5
1683738281131,WCWP 10B,B00,201722,Staff,0,0,6,6
1683738282155,WCWP 100,A00,201725,Gagnon; Jeffrey C,0,0,2,2
1683738282155,WCWP 100,B00,201727,Staff,0,4,15,15
1683738285258,ANBI 133,A00,258401,Wilder; Linnea Lorene,34,0,40,6
1683738286286,ANBI 140,A00,258395,Hrvoj Mihic; Branka,18,0,25,7
1683738287310,ANSC 120,A00,258402,Bialecki; Jon Anthony,26,0,40,14
1683738288334,ANSC 144,A00,258400,Staff,12,0,40,28
1683738290382,ANSC 166,A00,258396,Parish; Steven Martin,156,0,175,19
1683738291410,ANSC 180,A00,193533,Staff,8,0,20,12
1683738292447,ANSC 188,A00,258397,Jassal; Aftab,34,0,40,6
1683738293471,ANTH 3,A01,258316,Staff,23,0,30,7
1683738294496,ANTH 5,A00,258394,Semendeferi; Ekaterini,16,0,20,4
1683738295522,ANTH 21,A01,258331,Staff,4,0,40,36
1683738296546,ANTH 103,A00,258398,Varma; Saiba,15,0,25,10
1683738297573,AWP 10,001,202034,Staff,0,0,0,0
1683738297573,AWP 10,002,202035,Staff,0,0,0,0
1683738297573,AWP 10,003,202036,Staff,0,0,0,0
1683738297573,AWP 10,004,202037,Staff,0,0,0,0
1683738297573,AWP 10,005,202038,Staff,0,0,0,0
1683738297573,AWP 10,006,202039,Staff,0,0,0,0
1683738297573,AWP 10,007,202040,Staff,0,0,0,0
1683738297573,AWP 10,008,202041,Staff,0,0,0,0
1683738297573,AWP 10,009,202042,Staff,0,0,0,0
1683738297573,AWP 10,010,202043,Staff,0,0,0,0
1683738297573,AWP 10,011,202044,Staff,0,0,0,0
1683738297573,AWP 10,012,202045,Staff,0,0,0,0
1683738297573,AWP 10,013,202046,Staff,0,0,0,0
1683738297573,AWP 10,014,202047,Staff,0,0,0,0
1683738297573,AWP 10,015,202048,Staff,0,0,0,0
1683738297573,AWP 10,016,202049,Staff,0,0,0,0
1683738297573,AWP 10,017,202050,Staff,0,0,0,0
1683738297573,AWP 10,018,202051,Staff,0,0,0,0
1683738297573,AWP 10,019,202052,Staff,0,0,0,0
1683738297573,AWP 10,020,202053,Staff,0,0,0,0
1683738297573,AWP 10,021,202054,Staff,0,0,0,0
1683738297573,AWP 10,022,202055,Staff,0,0,0,0
1683738297573,AWP 10,023,202056,Staff,0,0,0,0
1683738297573,AWP 10,024,202057,Staff,0,0,0,0
1683738297573,AWP 10,025,202058,Staff,0,0,0,0
1683738297573,AWP 10,026,202059,Staff,0,0,0,0
1683738298597,AWP 102,001,202032,Staff,0,0,0,0
1683738298597,AWP 102,002,202033,Staff,0,0,0,0
1683738299620,BENG 100,A01,254234,Taylor Amos; Alyssa C,31,0,40,9
1683738300642,BENG 196,001,270013,Engler; Adam J.,9999,0,9999,0
1683738301671,BICD 100R,A01,202018,Smith; Laurie,0,7,32,32
1683738301671,BICD 100R,A02,202019,Smith; Laurie,0,3,32,32
1683738301671,BICD 100R,A03,202020,Smith; Laurie,0,1,32,32
1683738301671,BICD 100R,A04,202021,Smith; Laurie,6,0,32,26
1683738301671,BICD 100R,A05,202022,Smith; Laurie,10,0,32,22
1683738302699,BICD 136,A01,193242,Gustafson-Brown; Cindy,0,2,32,32
1683738302699,BICD 136,A02,193244,Gustafson-Brown; Cindy,13,0,32,19
1683738303723,BIEB 102,A01,193249,Butler; Shannon Rhey,0,0,32,32
1683738303723,BIEB 102,A02,193251,Butler; Shannon Rhey,0,0,32,32
1683738303723,BIEB 102,A03,193253,Butler; Shannon Rhey,0,0,32,32
1683738303723,BIEB 102,A04,193255,Butler; Shannon Rhey,13,0,32,19
1683738303723,BIEB 102,A05,193265,Butler; Shannon Rhey,25,0,32,7
1683738303723,BIEB 102,A06,193269,Butler; Shannon Rhey,12,0,32,20
1683738305776,BIEB 150,A01,193274,Staff,0,0,32,32
1683738305776,BIEB 150,A02,193285,Staff,24,0,32,8
1683738306801,BIEB 194,A00,193286,Kurle; Carolyn M.,19,0,32,13
1683738307826,BILD 1,A01,192291,Staff,15,0,32,17
1683738307826,BILD 1,A02,192292,Staff,30,0,32,2
1683738307826,BILD 1,B01,192520,Reuther; Keefe,0,1,0,0
1683738307826,BILD 1,B02,192532,Reuther; Keefe,0,1,0,0
1683738308850,BILD 3,A01,192556,Butler; Shannon Rhey,0,0,32,32
1683738308850,BILD 3,A02,192581,Butler; Shannon Rhey,0,1,32,32
1683738308850,BILD 3,A03,192611,Butler; Shannon Rhey,19,0,32,13
1683738308850,BILD 3,A04,192612,Butler; Shannon Rhey,23,0,32,9
1683738308850,BILD 3,A05,192613,Butler; Shannon Rhey,26,0,32,6
1683738308850,BILD 3,A06,192679,Butler; Shannon Rhey,27,0,32,5
1683738308850,BILD 3,A07,192682,Butler; Shannon Rhey,20,0,32,12
1683738309875,BILD 4,A01,192836,Reuther; Keefe,1,0,24,23
1683738309875,BILD 4,A02,193044,Reuther; Keefe,4,0,24,20
1683738310901,BILD 10,A01,193142,Gustafson-Brown; Cindy,29,0,32,3
1683738310901,BILD 10,A02,193149,Gustafson-Brown; Cindy,31,0,32,1
1683738311930,BIMM 100,A01,193301,Staff,0,6,32,32
1683738311930,BIMM 100,A02,193312,Staff,0,7,32,32
1683738311930,BIMM 100,A03,193323,Staff,0,10,32,32
1683738312953,BIMM 101,A01,193329,McDonnell; Lisa Marie,0,3,24,24
1683738312953,BIMM 101,A02,193339,McDonnell; Lisa Marie,0,3,24,24
1683738312953,BIMM 101,B01,193354,McDonnell; Lisa Marie,0,4,24,24
1683738312953,BIMM 101,B02,193357,McDonnell; Lisa Marie,0,3,24,24
1683738313978,BIMM 110,A01,193377,Tat; John,0,11,32,32
1683738313978,BIMM 110,A02,193378,Tat; John,0,11,32,32
1683738315003,BIMM 120,A01,206116,Staff,1,0,32,31
1683738315003,BIMM 120,A02,206117,Staff,7,0,32,25
1683738315003,BIMM 120,A03,206121,Staff,21,0,32,11
1683738316029,BIPN 100,A01,193393,Park; Ji Young,0,15,32,32
1683738316029,BIPN 100,A02,193402,Park; Ji Young,0,14,32,32
1683738316029,BIPN 100,A03,193413,Park; Ji Young,0,14,32,32
1683738316029,BIPN 100,A04,193414,Park; Ji Young,0,13,32,32
1683738317054,BIPN 102,A01,193429,Staff,0,0,32,32
1683738317054,BIPN 102,A02,193438,Staff,18,0,32,14
1683738318077,BIPN 106,A01,193450,Reyes Gonzalez; Catalina,0,2,40,40
1683738319103,BIPN 134,A01,193465,Cooke; James Edward,0,0,32,32
1683738319103,BIPN 134,A02,193474,Cooke; James Edward,24,0,32,8
1683738319103,BIPN 134,A03,193485,Cooke; James Edward,29,0,32,3
1683738319103,BIPN 134,A04,193486,Cooke; James Edward,20,0,32,12
1683738319103,BIPN 134,A05,193491,Cooke; James Edward,31,0,32,1
1683738319103,BIPN 134,A06,193501,Cooke; James Edward,30,0,32,2
1683738319103,BIPN 134,A07,193510,Cooke; James Edward,29,0,32,3
1683738321151,BISP 194,A00,222522,Staff,14,0,32,18
1683738322178,CAT 124,A01,202407,Staff,19,0,25,6
1683738323208,CAT 125,A00,202408,Marchisotto; Jennifer Anne,2,0,20,18
1683738324238,CAT 125R,A00,202409,Smith; Lauryn Alissa,0,11,20,20
1683738324238,CAT 125R,B00,202410,Morales; Celeste Georgianna,0,11,20,20
1683738324238,CAT 125R,C00,202411,Irwin; Matthew Joseph,0,12,20,20
1683738325262,CENG 15,A01,204712,Yang; Kesong,0,1,0,0
1683738326289,CENG 114,A00,202070,Jahed Motlagh; Zeinab,5,0,20,15
1683738327315,CGS 105,A00,185477,Wesling; Megan E.,24,0,40,16
1683738328339,CGS 106,A00,185494,Staff,11,0,22,11
1683738329364,CGS 108,A00,185495,Staff,14,0,20,6
1683738330388,CGS 114,A00,185496,Staff,13,0,18,5
1683738331410,CGS 119,A00,185501,Staff,15,0,20,5
1683738332433,CGS 120,A00,185511,Staff,11,0,20,9
1683738333457,CHEM 4,A01,184675,Bussey; Thomas J,97,0,100,3
1683738334542,CHEM 6A,A01,184677,Staff,32,0,60,28
1683738335567,CHEM 6B,A01,184679,Staff,63,0,100,37
1683738336596,CHEM 6C,A01,184681,Bussey; Thomas J,0,0,50,50
1683738336596,CHEM 6C,A02,184682,Bussey; Thomas J,32,0,50,18
1683738337620,CHEM 40A,A01,184684,Albizati; Kim F.,33,0,100,67
1683738338649,CHEM 40B,A01,184686,Albizati; Kim F.,0,23,100,100
1683738339673,CHEM 41B,A01,184690,Staff,51,0,100,49
1683738340701,COGS 3,A01,184715,Boyle; Mary E. T.,0,27,40,40
1683738341726,COGS 14B,A01,185172,Staff,0,14,38,38
1683738342750,COGS 18,A01,184736,Staff,14,0,80,66
1683738343776,COGS 100,A01,184932,Staff,0,8,73,73
1683738344800,COGS 101A,A01,184935,Staff,0,40,30,30
1683738345823,COGS 101B,A01,184944,Staff,0,2,30,30
1683738346848,COGS 101C,A01,184946,Staff,0,10,30,30
1683738347872,COGS 102A,A01,184951,Johnson; Christine M.,1,0,40,39
1683738348897,COGS 107B,A01,184953,Mooshagian; Eric Frederick,0,52,40,40
1683738349921,COGS 118B,A01,184959,Gupta; Anjum,0,50,40,40
1683738350948,COGS 153,A00,184961,Staff,1,16,30,29
1683738351974,COGS 177,A00,184962,Staff,0,20,30,30
1683738353001,COGS 187A,A01,184969,Boyle; Mary E. T.,0,19,40,40
1683738354028,COMM 10,A01,185174,Staff,0,5,25,25
1683738354028,COMM 10,A02,185189,Staff,0,2,25,25
1683738354028,COMM 10,A03,269821,Staff,0,1,0,0
1683738355053,COMM 100B,A02,185476,Staff,10,0,25,15
1683738355053,COMM 100B,A03,277340,Staff,25,0,25,0
1683738356081,COMM 100C,A01,185314,Staff,2,0,25,23
1683738356081,COMM 100C,A02,185327,Staff,17,0,25,8
1683738357105,COMM 110M,A00,185349,Staff,0,0,40,40
1683738358128,COMM 113T,A00,185352,Staff,25,0,40,15
1683738359152,COMM 114I,A00,185353,Staff,31,0,40,9
1683738360178,COMM 131,A00,185354,Staff,17,0,30,13
1683738361202,CSE 8A,A50,185358,Cao; Yingjun,0,46,10,10
1683738362226,CSE 8B,A01,185362,Staff,0,48,50,50
1683738363254,CSE 11,A01,185416,Cao; Yingjun,0,91,10,10
1683738364277,CSE 20,A01,185445,Briones; Jor-el Thomas Caparas,3,0,25,22
1683738365301,CSE 21,A01,185447,Staff,9,0,50,41
1683738366327,CSE 101,A01,185451,Staff,0,13,50,50
1683738366327,CSE 101,B01,185453,Jones; Miles E,0,15,50,50
1683738368378,CSE 141,A01,185458,Eldon; John,16,0,100,84
1683738369402,CSE 141L,A01,185461,Eldon; John,8,0,100,92
1683738370426,CSE 142,A01,185463,Staff,34,0,60,26
1683738370426,CSE 142,B01,201355,Staff,0,7,60,60
1683738371452,CSE 142L,A01,185470,Staff,34,0,60,26
1683738371452,CSE 142L,B01,201417,Staff,0,6,60,60
1683738372476,CSE 190,A00,201433,Staff,32,0,49,17
1683738373500,DOC 1,A01,259136,Strom; Megan C.,7,0,15,8
1683738373500,DOC 1,A02,259137,Strom; Megan C.,15,0,15,0
1683738373500,DOC 1,A03,259138,Strom; Megan C.,14,0,15,1
1683738373500,DOC 1,A04,259139,Strom; Megan C.,13,0,15,2
1683738374526,DOC 100D,A00,259140,Pass; Natalye Joann,14,0,25,11
1683738375554,DSGN 1,A01,184749,Rill; Bryan,0,26,30,30
1683738376580,DSGN 100,A01,185168,Staff,0,2,25,25
1683738377614,ECE 5,A01,185626,Morris; Karcher William,0,12,0,0
1683738378638,ECE 101,A01,185628,Staff,14,0,70,56
1683738379662,ECE 107,A01,185635,Baghdadchi; Saharnaz,0,0,20,20
1683738379662,ECE 107,A02,185638,Baghdadchi; Saharnaz,1,0,20,19
1683738380686,ECE 148,A01,185647,Silberman; Jack,0,0,16,16
1683738381710,ECON 1,A01,185537,Crane; Meredith Helen,54,0,70,16
1683738382736,ECON 3,A01,185549,Crane; Meredith Helen,30,0,70,40
1683738383767,ECON 4,A01,203354,Anderson; John Charles,0,5,10,10
1683738384790,ECON 100A,A01,185574,Staff,0,5,40,40
1683738385814,ECON 100B,A01,185576,Staff,0,12,50,50
1683738386845,ECON 100C,A01,185589,Newhouse; Herbert S,30,0,70,40
1683738387869,ECON 105,A00,185608,Vespa; Emanuel Ignacio,19,0,35,16
1683738388896,ECON 109,A01,185610,Shishkin; Denis,9,0,35,26
1683738389924,ECON 110A,A01,185612,Staff,8,0,40,32
1683738390951,ECON 120A,A01,185615,Staff,19,0,40,21
1683738391975,ECON 120C,A01,185617,Sun; Yixiao,0,21,70,70
1683738392999,ECON 144,A00,203346,Squires; Dale E,2,0,35,33
1683738394027,ECON 171,A01,203349,Newhouse; Herbert S,0,1,35,35
1683738395053,ECON 173A,A01,185621,Toda; Alexis Akira,21,0,35,14
1683738396087,EDS 25,A01,202413,Staff,0,1,0,0
1683738396087,EDS 25,A02,202414,Staff,0,1,0,0
1683738396087,EDS 25,A03,202415,Staff,0,0,0,0
1683738396087,EDS 25,A04,202416,Staff,0,1,0,0
1683738396087,EDS 25,A05,202439,Staff,0,0,0,0
1683738396087,EDS 25,A06,202440,Staff,0,0,0,0
1683738396087,EDS 25,B01,202631,Staff,0,0,0,0
1683738396087,EDS 25,B02,202632,Staff,0,0,0,0
1683738396087,EDS 25,B03,202639,Staff,0,0,0,0
1683738396087,EDS 25,B04,202640,Staff,0,0,0,0
1683738396087,EDS 25,B05,202643,Staff,0,0,0,0
1683738396087,EDS 25,B06,202644,Staff,0,0,0,0
1683738397114,EDS 38,A01,202659,Black; Alison Michelle,25,0,25,0
1683738398139,EDS 115,A00,202652,Staff,18,0,30,12
1683738399164,EDS 125,A00,202649,Staff,13,0,30,17
1683738400187,EDS 126,A01,203332,Staff,30,0,30,0
1683738401211,EDS 139,A00,202838,Staff,16,0,25,9
1683738402236,EDS 146,A01,202655,Staff,14,0,25,11
1683738403262,ENG 15,A00,185667,Staff,0,1,0,2
1683738403262,ENG 15,B00,185672,Staff,0,0,0,1
1683738403262,ENG 15,C00,185675,Staff,0,0,0,0
1683738403262,ENG 15,D00,185682,Staff,0,0,0,0
1683738403262,ENG 15,E00,185684,Staff,0,0,0,0
1683738404286,ETHN 103,A00,185710,Staff,0,8,35,35
1683738405310,ETHN 103A,A00,199228,Man; Simeon S,0,0,9,9
1683738406333,ETHN 109,A00,185711,Staff,15,0,35,20
1683738407359,ETHN 142,A00,185726,Staff,0,4,30,30
1683738408386,ETHN 163J,A00,199229,Man; Simeon S,5,0,8,3
1683738409411,ETHN 168,A00,185727,Staff,7,0,10,3
1683738410439,ETHN 182,A00,185728,Staff,0,0,35,35
1683738411462,ETHN 183,A00,185737,Staff,10,0,18,8
1683738412490,GLBH 111,A01,209361,Burgos; Jose L.,0,0,0,0
1683738414540,HIEU 104,A00,185792,Staff,14,0,20,6
1683738415567,HIEU 115,A00,185800,Staff,0,0,20,20
1683738416591,HIEU 128,A00,185801,Staff,0,9,20,20
1683738417617,HIEU 147,A00,185802,Staff,15,0,20,5
1683738418644,HIEU 154,A00,185823,Staff,11,0,20,9
1683738419667,HILA 102,A00,185826,Staff,14,0,20,6
1683738420693,HILD 2C,A01,185778,Staff,0,13,20,20
1683738421720,HILD 7B,A01,185780,Kwak; Nancy,0,17,32,32
1683738421720,HILD 7B,A02,185781,Kwak; Nancy,0,18,32,32
1683738422744,HILD 30,A01,185791,Staff,12,0,20,8
1683738423767,HISC 119,A00,185830,Golan; Tal,0,10,20,20
1683738424790,HITO 156GS,A00,185831,Patterson; Patrick H.,0,0,0,23
1683738425818,HIUS 103,A00,185832,Man; Simeon S,0,4,20,20
1683738426841,HIUS 117,A00,185836,Kwak; Nancy,2,0,20,18
1683738427865,HIUS 125,A00,185840,Man; Simeon S,0,2,23,23
1683738428889,HIUS 149,A00,185845,Staff,1,0,20,19
1683738429915,HUM 3,A01,185882,Zavodny; Tatiana Sophia,0,8,50,50
1683738429915,HUM 3,B01,185899,Caldwell; Michael Alan,0,18,50,50
1683738430941,HUM 3GS,A00,185900,Patterson; Patrick H.,0,0,0,23
1683738431966,HUM 4,A01,185938,Zroka; Amy Liane,28,0,50,22
1683738431966,HUM 4,B01,185956,Watkins; Eric,0,6,50,50
1683738431966,HUM 4,B02,202209,Watkins; Eric,0,6,50,50
1683738431966,HUM 4,B03,202210,Watkins; Eric,0,5,50,50
1683738432994,HUM 5,A01,185958,West; Geoffrey Scott,0,1,50,50
1683738432994,HUM 5,A02,202215,West; Geoffrey Scott,0,1,50,50
1683738434019,INTL 190,A00,185959,Gagnon; Jeffrey C,0,0,0,9
1683738434019,INTL 190,B00,185960,Lettieri; Michael Joseph,0,0,0,2
1683738435042,JAPN 180,A00,254509,Staff,4,0,30,26
1683738436070,LATI 10,A01,202853,Kennemore; Amy Michelle,0,0,31,31
1683738436070,LATI 10,A02,202854,Kennemore; Amy Michelle,0,0,32,32
1683738436070,LATI 10,A03,270054,Kennemore; Amy Michelle,30,0,30,0
1683738437099,LATI 180,A00,202855,Kennemore; Amy Michelle,11,0,20,9
1683738438199,LAWS 101,A00,201767,Golan; Tal,0,7,40,40
1683738439226,LIFR 1C,A00,185961,Staff,6,0,20,14
1683738440252,LIFR 1CX,A00,185962,Staff,7,0,20,13
1683738441278,LIFR 1D,A00,185963,Staff,7,0,20,13
1683738442304,LIFR 1DX,A00,185964,Staff,7,0,20,13
1683738443330,LIGN 101,A01,186039,Staff,43,0,50,7
1683738444354,LIGN 165,A00,186040,Staff,14,0,50,36
1683738445378,LTCS 108,A00,186041,Staff,5,0,10,5
1683738446406,LTCS 119,A00,186042,Staff,15,0,20,5
1683738447431,LTCS 130,A00,186043,Wesling; Megan E.,15,0,25,10
1683738449483,LTEA 138,A00,186119,Staff,13,0,40,27
1683738450509,LTEN 124,A00,186148,Staff,5,0,25,20
1683738451534,LTEN 178,A00,186149,Staff,6,0,15,9
1683738452563,LTEN 181,A00,186150,Blanco; John D,34,0,40,6
1683738453588,LTWL 120,A00,186160,Staff,19,0,25,6
1683738454614,LTWL 165,A00,186161,Staff,22,0,25,3
1683738455638,LTWR 100,A00,186162,Staff,0,5,15,15
1683738456664,LTWR 102,A00,186163,Doller; Ben,5,0,15,10
1683738457694,MAE 8,A01,186412,Staff,0,1,0,1
1683738458718,MAE 30B,A00,186445,Bahadori; Mohammad Yousef,81,0,100,19
1683738459745,MAE 40,A00,186592,Bewley; Thomas R,10,0,50,40
1683738460770,MAE 101B,A00,186593,Bahadori; Mohammad Yousef,79,0,100,21
1683738461793,MAE 105,A00,186594,Bandaru; Prabhakar,10,0,50,40
1683738462817,MAE 107,A00,186599,Pham; Hieu Tan,0,8,120,120
1683738463840,MAE 148,A01,186660,Silberman; Jack,3,0,16,13
1683738464864,MATH 10A,A01,188095,Staff,0,6,35,35
1683738465888,MATH 10B,A01,188097,Bowers; Adam R.,0,12,30,30
1683738465888,MATH 10B,A02,188099,Bowers; Adam R.,0,11,30,30
1683738465888,MATH 10B,B01,188104,Bowers; Adam R.,0,10,30,30
1683738465888,MATH 10B,B02,188106,Bowers; Adam R.,0,9,30,30
1683738466923,MATH 10C,A01,188111,Staff,0,20,30,30
1683738466923,MATH 10C,A02,188127,Staff,0,19,30,30
1683738466923,MATH 10C,A03,188131,Staff,0,19,30,30
1683738466923,MATH 10C,B01,188218,Staff,17,0,30,13
1683738466923,MATH 10C,B02,188244,Staff,13,0,30,17
1683738466923,MATH 10C,B03,188277,Staff,14,0,30,16
1683738467952,MATH 18,A01,188344,Bach; Quang Tran,18,0,30,12
1683738467952,MATH 18,A02,188345,Bach; Quang Tran,11,0,30,19
1683738467952,MATH 18,B01,188353,Bach; Quang Tran,11,0,30,19
1683738467952,MATH 18,B02,188354,Bach; Quang Tran,19,0,30,11
1683738468976,MATH 20A,A01,188374,Staff,10,0,35,25
1683738470014,MATH 20B,A01,188382,Ohm; Ko Woon,7,0,30,23
1683738470014,MATH 20B,A02,188383,Ohm; Ko Woon,22,0,30,8
1683738470014,MATH 20B,B01,188385,Ohm; Ko Woon,7,0,30,23
1683738470014,MATH 20B,B02,188392,Ohm; Ko Woon,22,0,30,8
1683738471038,MATH 20C,A01,188394,Harel; Guershon,10,0,30,20
1683738471038,MATH 20C,A02,188395,Harel; Guershon,13,0,30,17
1683738471038,MATH 20C,B01,188404,Harel; Guershon,5,0,30,25
1683738471038,MATH 20C,B02,188405,Harel; Guershon,18,0,30,12
1683738472068,MATH 20D,A01,188414,Hammock; Frances H,0,1,30,30
1683738472068,MATH 20D,A02,188415,Hammock; Frances H,0,1,30,30
1683738472068,MATH 20D,B01,188447,Hammock; Frances H,0,1,30,30
1683738472068,MATH 20D,B02,188486,Hammock; Frances H,2,0,30,28
1683738473091,MATH 20E,A01,188649,Staff,21,0,30,9
1683738473091,MATH 20E,A02,188650,Staff,20,0,30,10
1683738473091,MATH 20E,A03,188673,Staff,0,0,30,30
1683738474118,MATH 102,A01,188675,Staff,0,40,35,35
1683738475145,MATH 103B,A01,188681,Staff,2,0,35,33
1683738475145,MATH 103B,B01,188692,Staff,5,0,35,30
1683738476169,MATH 109,A01,188695,Salehi Golsefidy; Alireza,24,0,35,11
1683738476169,MATH 109,A02,188696,Salehi Golsefidy; Alireza,24,0,35,11
1683738477198,MATH 120A,A01,188698,Eggers; John Dietrich,7,0,35,28
1683738478220,MATH 142B,A01,188736,Ioana; Adrian,0,0,30,30
1683738478220,MATH 142B,A02,188741,Ioana; Adrian,0,1,30,30
1683738478220,MATH 142B,A03,188743,Ioana; Adrian,0,3,30,30
1683738479248,MATH 168A,A01,188790,Staff,0,11,35,35
1683738480274,MATH 170A,A01,188803,Nie; Jiawang,0,2,35,35
1683738480274,MATH 170A,A02,188811,Nie; Jiawang,0,1,35,35
1683738480274,MATH 170A,A03,188814,Nie; Jiawang,1,0,35,34
1683738480274,MATH 170A,A04,188815,Nie; Jiawang,4,0,35,31
1683738481299,MATH 193B,A01,188817,Staff,0,0,35,35
1683738481299,MATH 193B,A02,188818,Staff,6,0,35,29
1683738482323,MGT 4,A01,202857,Anderson; John Charles,59,0,80,21
1683738483348,MGT 12,A00,202858,Lindenberger; Wade Douglas,39,0,90,51
1683738484371,MGT 18,A00,202859,Staff,73,0,90,17
1683738485395,MGT 18GS,A00,202860,McKay; Michael J,13,0,28,15
1683738486423,MGT 45,A00,202861,Pecore; Joseph P.,8,0,90,82
1683738487466,MGT 100,A00,202863,Yavorsky; Daniel Ryan,27,0,90,63
1683738488493,MGT 103,A00,202864,Ehrich; Kristine R,0,19,90,90
1683738489519,MGT 112,A00,202865,Ehrich; Kristine R,15,0,90,75
1683738490544,MGT 121A,A00,202868,Staff,70,0,90,20
1683738491571,MGT 131B,A00,202869,Anderson; John Charles,58,0,90,32
1683738492595,MGT 136,A00,202871,Lindenberger; Wade Douglas,83,0,90,7
1683738493623,MGT 164,A00,202873,Staff,0,67,90,91
1683738494650,MGT 164GS,A00,202874,McKay; Mary A,13,0,28,15
1683738495674,MGT 180,A00,202875,Staff,0,51,90,91
1683738496699,MMW 11R,A01,205019,Herbst; Matthew,0,0,30,30
1683738496699,MMW 11R,A02,205026,Herbst; Matthew,29,0,30,1
1683738497726,MMW 15,A01,193512,Chang; Edmond Yi-Teh,0,8,28,28
1683738497726,MMW 15,A02,193513,Chang; Edmond Yi-Teh,0,5,28,28
1683738497726,MMW 15,A03,193514,Chang; Edmond Yi-Teh,0,5,28,28
1683738497726,MMW 15,A04,193515,Chang; Edmond Yi-Teh,0,5,28,28
1683738497726,MMW 15,A05,193516,Chang; Edmond Yi-Teh,0,5,28,28
1683738497726,MMW 15,A06,193517,Chang; Edmond Yi-Teh,0,6,28,28
1683738497726,MMW 15,B01,193519,Chang; Edmond Yi-Teh,0,5,28,28
1683738497726,MMW 15,B02,193520,Chang; Edmond Yi-Teh,0,5,28,28
1683738497726,MMW 15,B03,193521,Chang; Edmond Yi-Teh,0,5,28,28
1683738497726,MMW 15,B04,193522,Chang; Edmond Yi-Teh,0,6,28,28
1683738497726,MMW 15,B05,193523,Chang; Edmond Yi-Teh,0,5,28,28
1683738497726,MMW 15,B06,193524,Chang; Edmond Yi-Teh,0,5,28,28
1683738498750,MMW 122,A01,193526,Rahimi; Babak,0,16,28,28
1683738498750,MMW 122,A02,193527,Rahimi; Babak,0,15,28,28
1683738498750,MMW 122,A03,193528,Rahimi; Babak,0,0,0,0
1683738498750,MMW 122,A04,193529,Rahimi; Babak,0,0,0,0
1683738499781,MUS 1A,A01,186663,Staff,0,18,35,35
1683738500809,MUS 4,A01,186715,Staff,0,12,35,35
1683738501837,MUS 5R,A01,186796,Dubnov; Shlomo,0,17,35,35
1683738502863,MUS 6,A01,186798,Staff,0,4,25,25
1683738503887,MUS 7,A01,186830,Staff,11,0,35,24
1683738504912,MUS 8,A01,186930,Staff,0,27,35,35
1683738505938,MUS 15,A01,186932,Staff,0,15,35,35
1683738505938,MUS 15,B01,186934,Staff,0,16,35,35
1683738506966,MUS 80,A00,186935,Staff,0,0,20,20
1683738506966,MUS 80,B00,186936,Staff,24,0,25,1
1683738507994,NANO 11,A00,204702,Lipomi; Darren John,0,0,0,0
1683738509022,NANO 15,A01,204709,Yang; Kesong,0,1,0,0
1683738510049,NANO 114,A00,202069,Jahed Motlagh; Zeinab,2,0,10,8
1683738511076,PHIL 1,A00,186955,Grush; Rick Scott,31,0,40,9
1683738512100,PHIL 10,A01,186973,Grush; Rick Scott,27,0,35,8
1683738512100,PHIL 10,A02,186974,Grush; Rick Scott,33,0,35,2
1683738513127,PHIL 13,A01,186976,Staff,1,0,35,34
1683738513127,PHIL 13,A02,186977,Staff,16,0,35,19
1683738514155,PHIL 14,A01,186979,Staff,30,0,35,5
1683738514155,PHIL 14,A02,186986,Staff,32,0,35,3
1683738515181,PHIL 28,A01,186988,Staff,16,0,30,14
1683738515181,PHIL 28,A02,186989,Staff,0,0,30,30
1683738515181,PHIL 28,A03,186990,Staff,10,0,30,20
1683738515181,PHIL 28,A04,186991,Staff,26,0,30,4
1683738516210,PHIL 120,A00,186997,Staff,23,0,40,17
1683738517236,PHIL 137,A00,187003,Staff,8,0,40,32
1683738518260,PHIL 150,A00,187015,Staff,47,0,70,23
1683738519284,PHIL 167,A00,187021,Lamey; Andy M.,34,0,40,6
1683738520311,PHIL 174,A01,202226,Staff,17,0,20,3
1683738520311,PHIL 174,A02,202235,Staff,20,0,20,0
1683738521335,PHIL 191A,A00,258918,Staff,0,0,1,1
1683738522358,PHYS 1A,A00,187028,Staff,26,0,60,34
1683738523382,PHYS 1AL,001,187036,Staff,3,0,30,27
1683738523382,PHYS 1AL,002,187049,Staff,18,0,30,12
1683738524408,PHYS 1B,A00,187058,Staff,21,0,60,39
1683738525432,PHYS 1BL,001,187064,Staff,0,1,30,30
1683738525432,PHYS 1BL,002,187070,Staff,4,0,30,26
1683738526455,PHYS 1C,A00,187082,Staff,30,0,120,90
1683738527480,PHYS 1CL,001,187088,Staff,0,9,30,30
1683738527480,PHYS 1CL,002,187089,Staff,0,1,30,30
1683738527480,PHYS 1CL,009,262693,Staff,9,0,30,21
1683738528510,PHYS 2B,A01,187097,Staff,55,0,115,60
1683738529537,PHYS 2C,A01,187099,Staff,63,0,115,52
1683738530565,PHYS 2CL,A01,187101,Staff,5,0,28,23
1683738530565,PHYS 2CL,A02,187102,Staff,15,0,28,13
1683738531590,PHYS 2D,A01,187123,Shotwell; Brian,95,0,115,20
1683738532613,PHYS 4B,A01,187133,Grinstein; Benjamin,34,0,50,16
1683738533636,POLI 10,A00,188819,Staff,0,4,50,50
1683738534660,POLI 11,A00,188827,Staff,43,0,50,7
1683738535686,POLI 13R,A00,188828,Staff,0,2,20,20
1683738536715,POLI 27,A01,188830,Elgin; Samuel Zincke,0,2,70,70
1683738537739,POLI 30,A00,188832,Desposato; Scott,30,0,50,20
1683738538765,POLI 102F,A00,188834,Staff,1,0,40,39
1683738539789,POLI 104A,A00,188852,Staff,12,0,30,18
1683738540812,POLI 104I,A00,188853,Staff,0,8,20,20
1683738541901,POLI 110B,A00,188854,Wiens; David,6,0,20,14
1683738542926,POLI 112A,A00,188855,Wiens; David,4,0,30,26
1683738543950,POLI 117R,A00,188856,Forman; Fonna,0,12,20,20
1683738544974,POLI 118,A00,188857,Ingham; Sean,8,0,20,12
1683738545998,POLI 120G,A00,188858,Staff,7,0,30,23
1683738547022,POLI 131CR,A00,188863,Hoston; Germaine,19,0,50,31
1683738548047,POLI 133,A00,188864,Nellis; Gareth Hb,44,0,50,6
1683738549074,POLI 134D,A00,188865,Desposato; Scott,27,0,30,3
1683738550101,POLI 142A,A00,188871,Gartzke; Erik,21,0,50,29
1683738551126,POLI 142K,A00,188874,Staff,38,0,50,12
1683738552153,POLI 143,A00,188940,Gartzke; Erik,15,0,30,15
1683738553175,POLI 153,A00,188943,Staff,1,0,20,19
1683738554199,POLI 160AA,A00,188944,Staff,10,0,40,30
1683738555227,POLI 170A,A00,188945,Staff,10,0,30,20
1683738557279,PSYC 1,A00,188952,Staff,36,0,90,54
1683738558307,PSYC 2,B00,188953,Staff,19,0,35,16
1683738559332,PSYC 6,A00,188970,Staff,47,0,60,13
1683738560357,PSYC 7,A00,188973,Staff,35,0,45,10
1683738561381,PSYC 60,A01,188980,Rickard; Timothy C.,42,0,60,18
1683738562405,PSYC 70,A01,189001,Steiner; Eric Tomas,21,0,45,24
1683738563437,PSYC 100,A00,189005,Lacefield; Katharine I,1,97,120,119
1683738564463,PSYC 102,A00,189008,Staff,6,0,30,24
1683738565487,PSYC 106,B00,189026,Gorman; Michael R.,26,0,60,34
1683738566511,PSYC 114,B01,189033,Winkielman; Piotr,0,31,30,30
1683738567539,PSYC 131,A00,189036,Anagnostaras; Stephan,0,44,60,60
1683738568566,PSYC 136,A00,189041,Lowe; Angela Beth,0,7,25,25
1683738569590,PSYC 137,A00,189057,Winkielman; Piotr,0,36,25,25
1683738570618,PSYC 144,A00,189107,Wixted; John T,0,11,50,50
1683738572668,PSYC 162,A00,189142,Staff,0,9,85,85
1683738573692,PSYC 172,A00,189144,Gorman; Michael R.,0,6,30,30
1683738575741,PSYC 179,A00,189146,Lacefield; Katharine I,0,88,120,120
1683738576766,PSYC 181,A00,189147,Anagnostaras; Stephan,110,45,200,90
1683738577793,PSYC 190R,A00,189148,Barner; David A.,0,23,80,80
1683738578817,PSYC 191,A00,189275,Rickard; Timothy C.,0,11,25,25
1683738579843,PSYC 193,A00,189276,Chapman; Eddie Nathaniel,0,1,0,4
1683738580871,PSYC 193L,A01,189281,Lowe; Angela Beth,8,0,20,12
1683738580871,PSYC 193L,B01,189285,Staff,28,0,35,7
1683738581894,RELI 149,A00,187137,Rahimi; Babak,6,0,40,34
1683738582922,SE 9,A01,187315,Staff,0,2,18,18
1683738583949,SE 101B,A00,187409,Staff,24,0,30,6
1683738584974,SE 110B,A00,187444,Staff,10,0,40,30
1683738586006,SE 130B,A00,187449,Staff,31,0,40,9
1683738587031,SE 150A,A00,187516,Staff,8,0,20,12
1683738588058,SE 154,A00,187528,Staff,29,0,50,21
1683738589082,SIO 3,A01,258171,Staff,35,0,40,5
1683738590106,SIO 10,A00,187144,Cook; Geoffrey W,0,6,75,75
1683738591131,SIO 45,A00,187152,Cook; Geoffrey W,1,7,100,99
1683738592154,SIO 109R,A00,194486,Staff,0,4,20,20
1683738594204,SIO 187,A01,187233,Kacev; David,12,0,40,28
1683738595228,SOCI 1,A01,258656,Thorpe; Charles Robert,28,0,30,2
1683738595228,SOCI 1,A02,258658,Thorpe; Charles Robert,30,0,30,0
1683738595228,SOCI 1,A03,258661,Thorpe; Charles Robert,25,0,25,0
1683738595228,SOCI 1,A04,258666,Thorpe; Charles Robert,22,0,25,3
1683738595228,SOCI 1,A05,258897,Thorpe; Charles Robert,22,0,25,3
1683738595228,SOCI 1,A06,258898,Thorpe; Charles Robert,25,0,25,0
1683738596254,SOCI 30,A01,258903,Pardo Guerra; Juan Pablo,14,0,30,16
1683738597277,SOCI 102,A00,258904,Staff,9,0,25,16
1683738598301,SOCI 106,A00,258905,Staff,19,0,25,6
1683738599332,SOCI 111,A00,258907,Ribas Norris; Janet Vanesa,26,0,30,4
1683738600355,SOCI 121R,A00,258908,Pardo Guerra; Juan Pablo,7,0,30,23
1683738601379,SOCI 126,A01,203330,Staff,14,0,20,6
1683738602406,SOCI 131,A00,258909,Thorpe; Charles Robert,30,0,60,30
1683738603432,SOCI 135,A00,258910,Payne; Christine Anna,0,13,30,30
1683738604459,SOCI 157,A00,258911,Staff,10,0,30,20
1683738605486,SOCI 184,A00,258912,Staff,25,0,30,5
1683738606513,SOCI 188D,A00,258913,Staff,22,0,30,8
1683738607539,SYN 2,001,187529,Staff,9,0,16,7
1683738607539,SYN 2,002,201452,Staff,0,20,16,16
1683738607539,SYN 2,003,201469,Staff,1,0,16,15
1683738608563,SYN 100,A01,187531,Staff,0,9,20,20
1683738608563,SYN 100,B01,201491,Staff,0,10,20,20
1683738609591,TDAC 1,A00,189286,Walsh; Kim C.,3,0,20,17
1683738609591,TDAC 1,B00,189287,Harting; Carla Kelso,10,0,20,10
1683738610617,TDAC 101,A00,189300,Walsh; Kim C.,16,0,20,4
1683738610617,TDAC 101,B00,189301,Harting; Carla Kelso,18,0,20,2
1683738611640,TDAC 102,A00,189304,Basso; Beatrice,14,0,20,6
1683738612667,TDAC 108,A00,189305,Staff,18,0,20,2
1683738613691,TDDE 131,A00,189310,Staff,19,0,20,1
1683738613691,TDDE 131,B00,189314,Staff,19,0,20,1
1683738613691,TDDE 131,C00,189315,Staff,48,0,50,2
1683738613691,TDDE 131,D00,189316,Staff,14,0,15,1
1683738613691,TDDE 131,E00,204841,Staff,20,0,20,0
1683738614724,TDGE 10,A00,189289,Staff,26,0,50,24
1683738614724,TDGE 10,B00,189290,Havis; Allan,0,1,50,50
1683738615747,TDGE 11,A00,189291,Fulton; Julia,0,4,50,50
1683738615747,TDGE 11,B00,189292,Staff,20,0,25,5
1683738615747,TDGE 11,C00,260270,Staff,0,0,0,0
1683738616776,TDGE 25,A00,189294,Staff,1,0,20,19
1683738617800,TDGE 124,A00,189318,Fulton; Julia,0,7,50,50
1683738618830,TDGE 125,A00,189319,Staff,13,0,25,12
1683738618830,TDGE 125,B00,189320,Staff,23,0,25,2
1683738619857,TDGE 127,A00,189322,Havis; Allan,1,0,50,49
1683738620884,TDHT 101,A00,189323,Staff,18,0,25,7
1683738620884,TDHT 101,B00,189324,Staff,25,0,25,0
1683738621911,TDHT 102,A00,189325,Staff,49,0,50,1
1683738622938,TDMV 1,A00,189295,Arcidiacono; Kristin,20,0,30,10
1683738622938,TDMV 1,B00,189296,Caligagan; Maria T.,23,0,30,7
1683738623963,TDMV 2,A00,189297,Sammartano; Tonnie,27,0,30,3
1683738623963,TDMV 2,B00,189299,Arcidiacono; Kristin,23,0,30,7
1683738624988,TDMV 3,A00,204998,Rincon; Alicia,22,0,30,8
1683738626016,TDMV 120,A00,189458,Sammartano; Tonnie,28,0,30,2
1683738627040,TDMV 138,A00,189541,Jun; Grace Shin Hae,20,0,40,20
1683738628068,TDMV 142,A00,189717,Caligagan; Tony,25,0,30,5
1683738628068,TDMV 142,B00,189718,Caligagan; Maria T.,25,0,30,5
1683738629093,TMC 2,A01,187533,Staff,25,0,25,0
1683738629093,TMC 2,A02,187534,Staff,25,0,25,0
1683738630117,USP 1,A01,187536,Kwak; Nancy,0,16,25,25
1683738631141,USP 5,A01,187538,Staff,8,0,25,17
1683738632168,USP 101,A00,199253,Staff,0,4,0,0
1683738633193,USP 124,A00,187562,Boomhower; Matthew Charles,0,0,30,30
1683738634214,USP 138,A00,187582,Staff,19,0,25,6
1683738635238,USP 152,A01,187597,Staff,3,0,25,22
1683738636266,USP 153,A00,187598,Staff,18,0,25,7
1683738637291,USP 168,A00,187607,Kwak; Nancy,2,0,5,3
1683738638315,USP 173,A00,187619,Staff,4,0,25,21
1683738639340,USP 181,A00,187638,Staff,0,4,25,25
1683738640370,VIS 103,A00,187650,Cruz; Edwin Teddy,17,0,75,58
1683738641394,VIS 110D,A00,187669,Staff,13,0,22,9
1683738642418,VIS 127C,A00,187720,Shen; Kuiyi,67,0,146,79
1683738643447,VIS 149,A00,187731,Yoldas; Pinar,0,12,22,22
1683738644472,VIS 151,A01,188091,Staff,22,0,34,12
1683738644472,VIS 151,A02,188092,Staff,11,0,34,23
1683738645554,VIS 160B,A00,188093,Stalbaum; Brett,0,1,10,10
1683738647607,WCWP 10B,A00,201720,Staff,0,0,5,5
1683738647607,WCWP 10B,B00,201722,Staff,0,0,6,6
1683738648631,WCWP 100,A00,201725,Gagnon; Jeffrey C,0,0,2,2
1683738648631,WCWP 100,B00,201727,Staff,0,4,15,15
1683738651722,ANBI 133,A00,258401,Wilder; Linnea Lorene,34,0,40,6
1683738652747,ANBI 140,A00,258395,Hrvoj Mihic; Branka,18,0,25,7
1683738653772,ANSC 120,A00,258402,Bialecki; Jon Anthony,26,0,40,14
1683738654795,ANSC 144,A00,258400,Staff,12,0,40,28
1683738656848,ANSC 166,A00,258396,Parish; Steven Martin,156,0,175,19
1683738657874,ANSC 180,A00,193533,Staff,8,0,20,12
1683738658902,ANSC 188,A00,258397,Jassal; Aftab,34,0,40,6
1683738659929,ANTH 3,A01,258316,Staff,23,0,30,7
1683738660954,ANTH 5,A00,258394,Semendeferi; Ekaterini,16,0,20,4
1683738661983,ANTH 21,A01,258331,Staff,4,0,40,36
1683738663009,ANTH 103,A00,258398,Varma; Saiba,15,0,25,10
1683738664035,AWP 10,001,202034,Staff,0,0,0,0
1683738664035,AWP 10,002,202035,Staff,0,0,0,0
1683738664035,AWP 10,003,202036,Staff,0,0,0,0
1683738664035,AWP 10,004,202037,Staff,0,0,0,0
1683738664035,AWP 10,005,202038,Staff,0,0,0,0
1683738664035,AWP 10,006,202039,Staff,0,0,0,0
1683738664035,AWP 10,007,202040,Staff,0,0,0,0
1683738664035,AWP 10,008,202041,Staff,0,0,0,0
1683738664035,AWP 10,009,202042,Staff,0,0,0,0
1683738664035,AWP 10,010,202043,Staff,0,0,0,0
1683738664035,AWP 10,011,202044,Staff,0,0,0,0
1683738664035,AWP 10,012,202045,Staff,0,0,0,0
1683738664035,AWP 10,013,202046,Staff,0,0,0,0
1683738664035,AWP 10,014,202047,Staff,0,0,0,0
1683738664035,AWP 10,015,202048,Staff,0,0,0,0
1683738664035,AWP 10,016,202049,Staff,0,0,0,0
1683738664035,AWP 10,017,202050,Staff,0,0,0,0
1683738664035,AWP 10,018,202051,Staff,0,0,0,0
1683738664035,AWP 10,019,202052,Staff,0,0,0,0
1683738664035,AWP 10,020,202053,Staff,0,0,0,0
1683738664035,AWP 10,021,202054,Staff,0,0,0,0
1683738664035,AWP 10,022,202055,Staff,0,0,0,0
1683738664035,AWP 10,023,202056,Staff,0,0,0,0
1683738664035,AWP 10,024,202057,Staff,0,0,0,0
1683738664035,AWP 10,025,202058,Staff,0,0,0,0
1683738664035,AWP 10,026,202059,Staff,0,0,0,0
1683738665062,AWP 102,001,202032,Staff,0,0,0,0
1683738665062,AWP 102,002,202033,Staff,0,0,0,0
1683738666086,BENG 100,A01,254234,Taylor Amos; Alyssa C,31,0,40,9
1683738667110,BENG 196,001,270013,Engler; Adam J.,9999,0,9999,0
1683738668139,BICD 100R,A01,202018,Smith; Laurie,0,7,32,32
1683738668139,BICD 100R,A02,202019,Smith; Laurie,0,3,32,32
1683738668139,BICD 100R,A03,202020,Smith; Laurie,0,1,32,32
1683738668139,BICD 100R,A04,202021,Smith; Laurie,6,0,32,26
1683738668139,BICD 100R,A05,202022,Smith; Laurie,10,0,32,22
1683738669165,BICD 136,A01,193242,Gustafson-Brown; Cindy,0,2,32,32
1683738669165,BICD 136,A02,193244,Gustafson-Brown; Cindy,13,0,32,19
1683738670189,BIEB 102,A01,193249,Butler; Shannon Rhey,0,0,32,32
1683738670189,BIEB 102,A02,193251,Butler; Shannon Rhey,0,0,32,32
1683738670189,BIEB 102,A03,193253,Butler; Shannon Rhey,0,0,32,32
1683738670189,BIEB 102,A04,193255,Butler; Shannon Rhey,13,0,32,19
1683738670189,BIEB 102,A05,193265,Butler; Shannon Rhey,25,0,32,7
1683738670189,BIEB 102,A06,193269,Butler; Shannon Rhey,12,0,32,20
1683738672236,BIEB 150,A01,193274,Staff,0,0,32,32
1683738672236,BIEB 150,A02,193285,Staff,24,0,32,8
1683738673260,BIEB 194,A00,193286,Kurle; Carolyn M.,19,0,32,13
1683738674290,BILD 1,A01,192291,Staff,15,0,32,17
1683738674290,BILD 1,A02,192292,Staff,30,0,32,2
1683738674290,BILD 1,B01,192520,Reuther; Keefe,0,1,0,0
1683738674290,BILD 1,B02,192532,Reuther; Keefe,0,1,0,0
1683738675318,BILD 3,A01,192556,Butler; Shannon Rhey,0,0,32,32
1683738675318,BILD 3,A02,192581,Butler; Shannon Rhey,0,1,32,32
1683738675318,BILD 3,A03,192611,Butler; Shannon Rhey,19,0,32,13
1683738675318,BILD 3,A04,192612,Butler; Shannon Rhey,23,0,32,9
1683738675318,BILD 3,A05,192613,Butler; Shannon Rhey,26,0,32,6
1683738675318,BILD 3,A06,192679,Butler; Shannon Rhey,27,0,32,5
1683738675318,BILD 3,A07,192682,Butler; Shannon Rhey,20,0,32,12
1683738676343,BILD 4,A01,192836,Reuther; Keefe,1,0,24,23
1683738676343,BILD 4,A02,193044,Reuther; Keefe,4,0,24,20
1683738677371,BILD 10,A01,193142,Gustafson-Brown; Cindy,29,0,32,3
1683738677371,BILD 10,A02,193149,Gustafson-Brown; Cindy,31,0,32,1
1683738678394,BIMM 100,A01,193301,Staff,0,6,32,32
1683738678394,BIMM 100,A02,193312,Staff,0,7,32,32
1683738678394,BIMM 100,A03,193323,Staff,0,10,32,32
1683738679423,BIMM 101,A01,193329,McDonnell; Lisa Marie,0,3,24,24
1683738679423,BIMM 101,A02,193339,McDonnell; Lisa Marie,0,3,24,24
1683738679423,BIMM 101,B01,193354,McDonnell; Lisa Marie,0,4,24,24
1683738679423,BIMM 101,B02,193357,McDonnell; Lisa Marie,0,3,24,24
1683738680447,BIMM 110,A01,193377,Tat; John,0,11,32,32
1683738680447,BIMM 110,A02,193378,Tat; John,0,11,32,32
1683738681474,BIMM 120,A01,206116,Staff,1,0,32,31
1683738681474,BIMM 120,A02,206117,Staff,7,0,32,25
1683738681474,BIMM 120,A03,206121,Staff,21,0,32,11
1683738682503,BIPN 100,A01,193393,Park; Ji Young,0,15,32,32
1683738682503,BIPN 100,A02,193402,Park; Ji Young,0,14,32,32
1683738682503,BIPN 100,A03,193413,Park; Ji Young,0,14,32,32
1683738682503,BIPN 100,A04,193414,Park; Ji Young,0,13,32,32
1683738683530,BIPN 102,A01,193429,Staff,0,0,32,32
1683738683530,BIPN 102,A02,193438,Staff,18,0,32,14
1683738684554,BIPN 106,A01,193450,Reyes Gonzalez; Catalina,0,2,40,40
1683738685583,BIPN 134,A01,193465,Cooke; James Edward,0,0,32,32
1683738685583,BIPN 134,A02,193474,Cooke; James Edward,24,0,32,8
1683738685583,BIPN 134,A03,193485,Cooke; James Edward,29,0,32,3
1683738685583,BIPN 134,A04,193486,Cooke; James Edward,20,0,32,12
1683738685583,BIPN 134,A05,193491,Cooke; James Edward,31,0,32,1
1683738685583,BIPN 134,A06,193501,Cooke; James Edward,30,0,32,2
1683738685583,BIPN 134,A07,193510,Cooke; James Edward,29,0,32,3
1683738687635,BISP 194,A00,222522,Staff,14,0,32,18
1683738688661,CAT 124,A01,202407,Staff,19,0,25,6
1683738689686,CAT 125,A00,202408,Marchisotto; Jennifer Anne,2,0,20,18
1683738690710,CAT 125R,A00,202409,Smith; Lauryn Alissa,0,11,20,20
1683738690710,CAT 125R,B00,202410,Morales; Celeste Georgianna,0,11,20,20
1683738690710,CAT 125R,C00,202411,Irwin; Matthew Joseph,0,12,20,20
1683738691735,CENG 15,A01,204712,Yang; Kesong,0,1,0,0
1683738692759,CENG 114,A00,202070,Jahed Motlagh; Zeinab,5,0,20,15
1683738693901,CGS 105,A00,185477,Wesling; Megan E.,24,0,40,16
1683738694925,CGS 106,A00,185494,Staff,11,0,22,11
1683738695948,CGS 108,A00,185495,Staff,14,0,20,6
1683738696976,CGS 114,A00,185496,Staff,13,0,18,5
1683738698002,CGS 119,A00,185501,Staff,15,0,20,5
1683738699027,CGS 120,A00,185511,Staff,11,0,20,9
1683738700054,CHEM 4,A01,184675,Bussey; Thomas J,97,0,100,3
1683738701078,CHEM 6A,A01,184677,Staff,32,0,60,28
1683738702105,CHEM 6B,A01,184679,Staff,63,0,100,37
1683738703133,CHEM 6C,A01,184681,Bussey; Thomas J,0,0,50,50
1683738703133,CHEM 6C,A02,184682,Bussey; Thomas J,32,0,50,18
1683738704159,CHEM 40A,A01,184684,Albizati; Kim F.,33,0,100,67
1683738705184,CHEM 40B,A01,184686,Albizati; Kim F.,0,23,100,100
1683738706210,CHEM 41B,A01,184690,Staff,51,0,100,49
1683738707235,COGS 3,A01,184715,Boyle; Mary E. T.,0,27,40,40
1683738708260,COGS 14B,A01,185172,Staff,0,14,38,38
1683738709284,COGS 18,A01,184736,Staff,14,0,80,66
1683738710311,COGS 100,A01,184932,Staff,0,8,73,73
1683738711335,COGS 101A,A01,184935,Staff,0,40,30,30
1683738712362,COGS 101B,A01,184944,Staff,0,2,30,30
1683738713389,COGS 101C,A01,184946,Staff,0,10,30,30
1683738714417,COGS 102A,A01,184951,Johnson; Christine M.,1,0,40,39
1683738715442,COGS 107B,A01,184953,Mooshagian; Eric Frederick,0,52,40,40
1683738716466,COGS 118B,A01,184959,Gupta; Anjum,0,50,40,40
1683738717492,COGS 153,A00,184961,Staff,1,16,30,29
1683738718520,COGS 177,A00,184962,Staff,0,20,30,30
1683738719547,COGS 187A,A01,184969,Boyle; Mary E. T.,0,19,40,40
1683738720569,COMM 10,A01,185174,Staff,0,5,25,25
1683738720569,COMM 10,A02,185189,Staff,0,2,25,25
1683738720569,COMM 10,A03,269821,Staff,0,1,0,0
1683738721594,COMM 100B,A02,185476,Staff,10,0,25,15
1683738721594,COMM 100B,A03,277340,Staff,25,0,25,0
1683738722618,COMM 100C,A01,185314,Staff,2,0,25,23
1683738722618,COMM 100C,A02,185327,Staff,17,0,25,8
1683738723641,COMM 110M,A00,185349,Staff,0,0,40,40
1683738724665,COMM 113T,A00,185352,Staff,25,0,40,15
1683738725690,COMM 114I,A00,185353,Staff,31,0,40,9
1683738726714,COMM 131,A00,185354,Staff,17,0,30,13
1683738727739,CSE 8A,A50,185358,Cao; Yingjun,0,46,10,10
1683738728765,CSE 8B,A01,185362,Staff,0,48,50,50
1683738729792,CSE 11,A01,185416,Cao; Yingjun,0,91,10,10
1683738730821,CSE 20,A01,185445,Briones; Jor-el Thomas Caparas,3,0,25,22
1683738731848,CSE 21,A01,185447,Staff,9,0,50,41
1683738732873,CSE 101,A01,185451,Staff,0,13,50,50
1683738732873,CSE 101,B01,185453,Jones; Miles E,0,15,50,50
1683738734929,CSE 141,A01,185458,Eldon; John,16,0,100,84
1683738735954,CSE 141L,A01,185461,Eldon; John,8,0,100,92
1683738736983,CSE 142,A01,185463,Staff,34,0,60,26
1683738736983,CSE 142,B01,201355,Staff,0,7,60,60
1683738738013,CSE 142L,A01,185470,Staff,34,0,60,26
1683738738013,CSE 142L,B01,201417,Staff,0,6,60,60
1683738739040,CSE 190,A00,201433,Staff,32,0,49,17
1683738740067,DOC 1,A01,259136,Strom; Megan C.,7,0,15,8
1683738740067,DOC 1,A02,259137,Strom; Megan C.,15,0,15,0
1683738740067,DOC 1,A03,259138,Strom; Megan C.,14,0,15,1
1683738740067,DOC 1,A04,259139,Strom; Megan C.,13,0,15,2
1683738741094,DOC 100D,A00,259140,Pass; Natalye Joann,14,0,25,11
1683738742119,DSGN 1,A01,184749,Rill; Bryan,0,26,30,30
1683738743143,DSGN 100,A01,185168,Staff,0,2,25,25
1683738744168,ECE 5,A01,185626,Morris; Karcher William,0,12,0,0
1683738745196,ECE 101,A01,185628,Staff,14,0,70,56
1683738746221,ECE 107,A01,185635,Baghdadchi; Saharnaz,0,0,20,20
1683738746221,ECE 107,A02,185638,Baghdadchi; Saharnaz,1,0,20,19
1683738747248,ECE 148,A01,185647,Silberman; Jack,0,0,16,16
1683738748271,ECON 1,A01,185537,Crane; Meredith Helen,54,0,70,16
1683738749353,ECON 3,A01,185549,Crane; Meredith Helen,30,0,70,40
1683738750377,ECON 4,A01,203354,Anderson; John Charles,0,5,10,10
1683738751407,ECON 100A,A01,185574,Staff,0,5,40,40
1683738752434,ECON 100B,A01,185576,Staff,0,12,50,50
1683738753458,ECON 100C,A01,185589,Newhouse; Herbert S,30,0,70,40
1683738754482,ECON 105,A00,185608,Vespa; Emanuel Ignacio,19,0,35,16
1683738755507,ECON 109,A01,185610,Shishkin; Denis,9,0,35,26
1683738756532,ECON 110A,A01,185612,Staff,8,0,40,32
1683738757559,ECON 120A,A01,185615,Staff,19,0,40,21
1683738758584,ECON 120C,A01,185617,Sun; Yixiao,0,21,70,70
1683738759612,ECON 144,A00,203346,Squires; Dale E,2,0,35,33
1683738760640,ECON 171,A01,203349,Newhouse; Herbert S,0,1,35,35
1683738761668,ECON 173A,A01,185621,Toda; Alexis Akira,21,0,35,14
1683738762698,EDS 25,A01,202413,Staff,0,1,0,0
1683738762698,EDS 25,A02,202414,Staff,0,1,0,0
1683738762698,EDS 25,A03,202415,Staff,0,0,0,0
1683738762698,EDS 25,A04,202416,Staff,0,1,0,0
1683738762698,EDS 25,A05,202439,Staff,0,0,0,0
1683738762698,EDS 25,A06,202440,Staff,0,0,0,0
1683738762698,EDS 25,B01,202631,Staff,0,0,0,0
1683738762698,EDS 25,B02,202632,Staff,0,0,0,0
1683738762698,EDS 25,B03,202639,Staff,0,0,0,0
1683738762698,EDS 25,B04,202640,Staff,0,0,0,0
1683738762698,EDS 25,B05,202643,Staff,0,0,0,0
1683738762698,EDS 25,B06,202644,Staff,0,0,0,0
1683738763726,EDS 38,A01,202659,Black; Alison Michelle,25,0,25,0
1683738764751,EDS 115,A00,202652,Staff,18,0,30,12
1683738765780,EDS 125,A00,202649,Staff,13,0,30,17
1683738766804,EDS 126,A01,203332,Staff,30,0,30,0
1683738767829,EDS 139,A00,202838,Staff,16,0,25,9
1683738768852,EDS 146,A01,202655,Staff,14,0,25,11
1683738769877,ENG 15,A00,185667,Staff,0,1,0,2
1683738769877,ENG 15,B00,185672,Staff,0,0,0,1
1683738769877,ENG 15,C00,185675,Staff,0,0,0,0
1683738769877,ENG 15,D00,185682,Staff,0,0,0,0
1683738769877,ENG 15,E00,185684,Staff,0,0,0,0
1683738770905,ETHN 103,A00,185710,Staff,0,8,35,35
1683738771929,ETHN 103A,A00,199228,Man; Simeon S,0,0,9,9
1683738772954,ETHN 109,A00,185711,Staff,15,0,35,20
1683738773978,ETHN 142,A00,185726,Staff,0,4,30,30
1683738775002,ETHN 163J,A00,199229,Man; Simeon S,5,0,8,3
1683738776030,ETHN 168,A00,185727,Staff,7,0,10,3
1683738777057,ETHN 182,A00,185728,Staff,0,0,35,35
1683738778079,ETHN 183,A00,185737,Staff,10,0,18,8
1683738779104,GLBH 111,A01,209361,Burgos; Jose L.,0,0,0,0
1683738781175,HIEU 104,A00,185792,Staff,14,0,20,6
1683738782202,HIEU 115,A00,185800,Staff,0,0,20,20
1683738783225,HIEU 128,A00,185801,Staff,0,9,20,20
1683738784248,HIEU 147,A00,185802,Staff,15,0,20,5
1683738785272,HIEU 154,A00,185823,Staff,11,0,20,9
1683738786298,HILA 102,A00,185826,Staff,14,0,20,6
1683738787326,HILD 2C,A01,185778,Staff,0,13,20,20
1683738788354,HILD 7B,A01,185780,Kwak; Nancy,0,17,32,32
1683738788354,HILD 7B,A02,185781,Kwak; Nancy,0,18,32,32
1683738789379,HILD 30,A01,185791,Staff,12,0,20,8
1683738790408,HISC 119,A00,185830,Golan; Tal,0,10,20,20
1683738791435,HITO 156GS,A00,185831,Patterson; Patrick H.,0,0,0,23
1683738792459,HIUS 103,A00,185832,Man; Simeon S,0,4,20,20
1683738793483,HIUS 117,A00,185836,Kwak; Nancy,2,0,20,18
1683738794506,HIUS 125,A00,185840,Man; Simeon S,0,2,23,23
1683738795533,HIUS 149,A00,185845,Staff,1,0,20,19
1683738796558,HUM 3,A01,185882,Zavodny; Tatiana Sophia,0,8,50,50
1683738796558,HUM 3,B01,185899,Caldwell; Michael Alan,0,18,50,50
1683738797582,HUM 3GS,A00,185900,Patterson; Patrick H.,0,0,0,23
1683738798612,HUM 4,A01,185938,Zroka; Amy Liane,28,0,50,22
1683738798612,HUM 4,B01,185956,Watkins; Eric,0,6,50,50
1683738798612,HUM 4,B02,202209,Watkins; Eric,0,6,50,50
1683738798612,HUM 4,B03,202210,Watkins; Eric,0,5,50,50
1683738799640,HUM 5,A01,185958,West; Geoffrey Scott,0,1,50,50
1683738799640,HUM 5,A02,202215,West; Geoffrey Scott,0,1,50,50
1683738800665,INTL 190,A00,185959,Gagnon; Jeffrey C,0,0,0,9
1683738800665,INTL 190,B00,185960,Lettieri; Michael Joseph,0,0,0,2
1683738801692,JAPN 180,A00,254509,Staff,4,0,30,26
1683738802715,LATI 10,A01,202853,Kennemore; Amy Michelle,0,0,31,31
1683738802715,LATI 10,A02,202854,Kennemore; Amy Michelle,0,0,32,32
1683738802715,LATI 10,A03,270054,Kennemore; Amy Michelle,30,0,30,0
1683738803739,LATI 180,A00,202855,Kennemore; Amy Michelle,11,0,20,9
1683738804763,LAWS 101,A00,201767,Golan; Tal,0,7,40,40
1683738805790,LIFR 1C,A00,185961,Staff,6,0,20,14
1683738806814,LIFR 1CX,A00,185962,Staff,7,0,20,13
1683738807838,LIFR 1D,A00,185963,Staff,7,0,20,13
1683738808862,LIFR 1DX,A00,185964,Staff,7,0,20,13
1683738809886,LIGN 101,A01,186039,Staff,43,0,50,7
1683738810912,LIGN 165,A00,186040,Staff,14,0,50,36
1683738811935,LTCS 108,A00,186041,Staff,5,0,10,5
1683738812962,LTCS 119,A00,186042,Staff,15,0,20,5
1683738813994,LTCS 130,A00,186043,Wesling; Megan E.,15,0,25,10
1683738816050,LTEA 138,A00,186119,Staff,13,0,40,27
1683738817074,LTEN 124,A00,186148,Staff,5,0,25,20
1683738818101,LTEN 178,A00,186149,Staff,6,0,15,9
1683738819129,LTEN 181,A00,186150,Blanco; John D,34,0,40,6
1683738820154,LTWL 120,A00,186160,Staff,19,0,25,6
1683738821179,LTWL 165,A00,186161,Staff,22,0,25,3
1683738822203,LTWR 100,A00,186162,Staff,0,5,15,15
1683738823230,LTWR 102,A00,186163,Doller; Ben,5,0,15,10
1683738824255,MAE 8,A01,186412,Staff,0,1,0,1
1683738825283,MAE 30B,A00,186445,Bahadori; Mohammad Yousef,81,0,100,19
1683738826307,MAE 40,A00,186592,Bewley; Thomas R,10,0,50,40
1683738827332,MAE 101B,A00,186593,Bahadori; Mohammad Yousef,79,0,100,21
1683738828357,MAE 105,A00,186594,Bandaru; Prabhakar,10,0,50,40
1683738829380,MAE 107,A00,186599,Pham; Hieu Tan,0,8,120,120
1683738830407,MAE 148,A01,186660,Silberman; Jack,3,0,16,13
1683738831434,MATH 10A,A01,188095,Staff,0,6,35,35
1683738832458,MATH 10B,A01,188097,Bowers; Adam R.,0,12,30,30
1683738832458,MATH 10B,A02,188099,Bowers; Adam R.,0,11,30,30
1683738832458,MATH 10B,B01,188104,Bowers; Adam R.,0,10,30,30
1683738832458,MATH 10B,B02,188106,Bowers; Adam R.,0,9,30,30
1683738833488,MATH 10C,A01,188111,Staff,0,20,30,30
1683738833488,MATH 10C,A02,188127,Staff,0,19,30,30
1683738833488,MATH 10C,A03,188131,Staff,0,19,30,30
1683738833488,MATH 10C,B01,188218,Staff,17,0,30,13
1683738833488,MATH 10C,B02,188244,Staff,13,0,30,17
1683738833488,MATH 10C,B03,188277,Staff,14,0,30,16
1683738834513,MATH 18,A01,188344,Bach; Quang Tran,18,0,30,12
1683738834513,MATH 18,A02,188345,Bach; Quang Tran,11,0,30,19
1683738834513,MATH 18,B01,188353,Bach; Quang Tran,11,0,30,19
1683738834513,MATH 18,B02,188354,Bach; Quang Tran,19,0,30,11
1683738835539,MATH 20A,A01,188374,Staff,10,0,35,25
1683738836564,MATH 20B,A01,188382,Ohm; Ko Woon,7,0,30,23
1683738836564,MATH 20B,A02,188383,Ohm; Ko Woon,22,0,30,8
1683738836564,MATH 20B,B01,188385,Ohm; Ko Woon,7,0,30,23
1683738836564,MATH 20B,B02,188392,Ohm; Ko Woon,22,0,30,8
1683738837590,MATH 20C,A01,188394,Harel; Guershon,10,0,30,20
1683738837590,MATH 20C,A02,188395,Harel; Guershon,13,0,30,17
1683738837590,MATH 20C,B01,188404,Harel; Guershon,5,0,30,25
1683738837590,MATH 20C,B02,188405,Harel; Guershon,18,0,30,12
1683738838620,MATH 20D,A01,188414,Hammock; Frances H,0,1,30,30
1683738838620,MATH 20D,A02,188415,Hammock; Frances H,0,1,30,30
1683738838620,MATH 20D,B01,188447,Hammock; Frances H,0,1,30,30
1683738838620,MATH 20D,B02,188486,Hammock; Frances H,2,0,30,28
1683738839646,MATH 20E,A01,188649,Staff,21,0,30,9
1683738839646,MATH 20E,A02,188650,Staff,20,0,30,10
1683738839646,MATH 20E,A03,188673,Staff,0,0,30,30
1683738840669,MATH 102,A01,188675,Staff,0,40,35,35
1683738841694,MATH 103B,A01,188681,Staff,2,0,35,33
1683738841694,MATH 103B,B01,188692,Staff,5,0,35,30
1683738842726,MATH 109,A01,188695,Salehi Golsefidy; Alireza,24,0,35,11
1683738842726,MATH 109,A02,188696,Salehi Golsefidy; Alireza,24,0,35,11
1683738843750,MATH 120A,A01,188698,Eggers; John Dietrich,7,0,35,28
1683738844776,MATH 142B,A01,188736,Ioana; Adrian,0,0,30,30
1683738844776,MATH 142B,A02,188741,Ioana; Adrian,0,1,30,30
1683738844776,MATH 142B,A03,188743,Ioana; Adrian,0,3,30,30
1683738845806,MATH 168A,A01,188790,Staff,0,11,35,35
1683738846836,MATH 170A,A01,188803,Nie; Jiawang,0,2,35,35
1683738846836,MATH 170A,A02,188811,Nie; Jiawang,0,1,35,35
1683738846836,MATH 170A,A03,188814,Nie; Jiawang,1,0,35,34
1683738846836,MATH 170A,A04,188815,Nie; Jiawang,4,0,35,31
1683738847864,MATH 193B,A01,188817,Staff,0,0,35,35
1683738847864,MATH 193B,A02,188818,Staff,6,0,35,29
1683738848892,MGT 4,A01,202857,Anderson; John Charles,59,0,80,21
1683738849919,MGT 12,A00,202858,Lindenberger; Wade Douglas,39,0,90,51
1683738850944,MGT 18,A00,202859,Staff,73,0,90,17
1683738851973,MGT 18GS,A00,202860,McKay; Michael J,13,0,28,15
1683738853056,MGT 45,A00,202861,Pecore; Joseph P.,8,0,90,82
1683738854083,MGT 100,A00,202863,Yavorsky; Daniel Ryan,27,0,90,63
1683738855106,MGT 103,A00,202864,Ehrich; Kristine R,0,19,90,90
1683738856129,MGT 112,A00,202865,Ehrich; Kristine R,15,0,90,75
1683738857158,MGT 121A,A00,202868,Staff,70,0,90,20
1683738858183,MGT 131B,A00,202869,Anderson; John Charles,58,0,90,32
1683738859206,MGT 136,A00,202871,Lindenberger; Wade Douglas,83,0,90,7
1683738860231,MGT 164,A00,202873,Staff,0,67,90,91
1683738861260,MGT 164GS,A00,202874,McKay; Mary A,13,0,28,15
1683738862284,MGT 180,A00,202875,Staff,0,51,90,91
1683738863310,MMW 11R,A01,205019,Herbst; Matthew,0,0,30,30
1683738863310,MMW 11R,A02,205026,Herbst; Matthew,29,0,30,1
1683738864335,MMW 15,A01,193512,Chang; Edmond Yi-Teh,0,8,28,28
1683738864335,MMW 15,A02,193513,Chang; Edmond Yi-Teh,0,5,28,28
1683738864335,MMW 15,A03,193514,Chang; Edmond Yi-Teh,0,5,28,28
1683738864335,MMW 15,A04,193515,Chang; Edmond Yi-Teh,0,5,28,28
1683738864335,MMW 15,A05,193516,Chang; Edmond Yi-Teh,0,5,28,28
1683738864335,MMW 15,A06,193517,Chang; Edmond Yi-Teh,0,6,28,28
1683738864335,MMW 15,B01,193519,Chang; Edmond Yi-Teh,0,5,28,28
1683738864335,MMW 15,B02,193520,Chang; Edmond Yi-Teh,0,5,28,28
1683738864335,MMW 15,B03,193521,Chang; Edmond Yi-Teh,0,5,28,28
1683738864335,MMW 15,B04,193522,Chang; Edmond Yi-Teh,0,6,28,28
1683738864335,MMW 15,B05,193523,Chang; Edmond Yi-Teh,0,5,28,28
1683738864335,MMW 15,B06,193524,Chang; Edmond Yi-Teh,0,5,28,28
1683738865362,MMW 122,A01,193526,Rahimi; Babak,0,16,28,28
1683738865362,MMW 122,A02,193527,Rahimi; Babak,0,15,28,28
1683738865362,MMW 122,A03,193528,Rahimi; Babak,0,0,0,0
1683738865362,MMW 122,A04,193529,Rahimi; Babak,0,0,0,0
1683738866390,MUS 1A,A01,186663,Staff,0,18,35,35
1683738867417,MUS 4,A01,186715,Staff,0,12,35,35
1683738868439,MUS 5R,A01,186796,Dubnov; Shlomo,0,17,35,35
1683738869476,MUS 6,A01,186798,Staff,0,4,25,25
1683738870502,MUS 7,A01,186830,Staff,11,0,35,24
1683738871531,MUS 8,A01,186930,Staff,0,27,35,35
1683738872562,MUS 15,A01,186932,Staff,0,15,35,35
1683738872562,MUS 15,B01,186934,Staff,0,16,35,35
1683738873587,MUS 80,A00,186935,Staff,0,0,20,20
1683738873587,MUS 80,B00,186936,Staff,24,0,25,1
1683738874617,NANO 11,A00,204702,Lipomi; Darren John,0,0,0,0
1683738875646,NANO 15,A01,204709,Yang; Kesong,0,1,0,0
1683738876674,NANO 114,A00,202069,Jahed Motlagh; Zeinab,2,0,10,8
1683738877704,PHIL 1,A00,186955,Grush; Rick Scott,31,0,40,9
1683738878734,PHIL 10,A01,186973,Grush; Rick Scott,27,0,35,8
1683738878734,PHIL 10,A02,186974,Grush; Rick Scott,33,0,35,2
1683738879761,PHIL 13,A01,186976,Staff,1,0,35,34
1683738879761,PHIL 13,A02,186977,Staff,16,0,35,19
1683738880786,PHIL 14,A01,186979,Staff,30,0,35,5
1683738880786,PHIL 14,A02,186986,Staff,32,0,35,3
1683738881815,PHIL 28,A01,186988,Staff,16,0,30,14
1683738881815,PHIL 28,A02,186989,Staff,0,0,30,30
1683738881815,PHIL 28,A03,186990,Staff,10,0,30,20
1683738881815,PHIL 28,A04,186991,Staff,26,0,30,4
1683738882840,PHIL 120,A00,186997,Staff,23,0,40,17
1683738883864,PHIL 137,A00,187003,Staff,8,0,40,32
1683738884889,PHIL 150,A00,187015,Staff,47,0,70,23
1683738885918,PHIL 167,A00,187021,Lamey; Andy M.,34,0,40,6
1683738886943,PHIL 174,A01,202226,Staff,17,0,20,3
1683738886943,PHIL 174,A02,202235,Staff,20,0,20,0
1683738887968,PHIL 191A,A00,258918,Staff,0,0,1,1
1683738888992,PHYS 1A,A00,187028,Staff,26,0,60,34
1683738890022,PHYS 1AL,001,187036,Staff,3,0,30,27
1683738890022,PHYS 1AL,002,187049,Staff,18,0,30,12
1683738891048,PHYS 1B,A00,187058,Staff,21,0,60,39
1683738892075,PHYS 1BL,001,187064,Staff,0,1,30,30
1683738892075,PHYS 1BL,002,187070,Staff,4,0,30,26
1683738893102,PHYS 1C,A00,187082,Staff,30,0,120,90
1683738894131,PHYS 1CL,001,187088,Staff,0,9,30,30
1683738894131,PHYS 1CL,002,187089,Staff,0,1,30,30
1683738894131,PHYS 1CL,009,262693,Staff,9,0,30,21
1683738895162,PHYS 2B,A01,187097,Staff,55,0,115,60
1683738896187,PHYS 2C,A01,187099,Staff,63,0,115,52
1683738897215,PHYS 2CL,A01,187101,Staff,5,0,28,23
1683738897215,PHYS 2CL,A02,187102,Staff,15,0,28,13
1683738898241,PHYS 2D,A01,187123,Shotwell; Brian,95,0,115,20
1683738899266,PHYS 4B,A01,187133,Grinstein; Benjamin,34,0,50,16
1683738900293,POLI 10,A00,188819,Staff,0,4,50,50
1683738901318,POLI 11,A00,188827,Staff,43,0,50,7
1683738902341,POLI 13R,A00,188828,Staff,0,2,20,20
1683738903364,POLI 27,A01,188830,Elgin; Samuel Zincke,0,2,70,70
1683738904390,POLI 30,A00,188832,Desposato; Scott,30,0,50,20
1683738905417,POLI 102F,A00,188834,Staff,1,0,40,39
1683738906441,POLI 104A,A00,188852,Staff,12,0,30,18
1683738907465,POLI 104I,A00,188853,Staff,0,8,20,20
1683738908491,POLI 110B,A00,188854,Wiens; David,6,0,20,14
1683738909517,POLI 112A,A00,188855,Wiens; David,4,0,30,26
1683738910545,POLI 117R,A00,188856,Forman; Fonna,0,12,20,20
1683738911575,POLI 118,A00,188857,Ingham; Sean,8,0,20,12
1683738912603,POLI 120G,A00,188858,Staff,7,0,30,23
1683738913630,POLI 131CR,A00,188863,Hoston; Germaine,19,0,50,31
1683738914656,POLI 133,A00,188864,Nellis; Gareth Hb,44,0,50,6
1683738915682,POLI 134D,A00,188865,Desposato; Scott,27,0,30,3
1683738916708,POLI 142A,A00,188871,Gartzke; Erik,21,0,50,29
1683738917735,POLI 142K,A00,188874,Staff,38,0,50,12
1683738918759,POLI 143,A00,188940,Gartzke; Erik,15,0,30,15
1683738919786,POLI 153,A00,188943,Staff,1,0,20,19
1683738920815,POLI 160AA,A00,188944,Staff,10,0,40,30
1683738921839,POLI 170A,A00,188945,Staff,10,0,30,20
1683738923889,PSYC 1,A00,188952,Staff,36,0,90,54
1683738924915,PSYC 2,B00,188953,Staff,19,0,35,16
1683738925939,PSYC 6,A00,188970,Staff,47,0,60,13
1683738926967,PSYC 7,A00,188973,Staff,35,0,45,10
1683738927992,PSYC 60,A01,188980,Rickard; Timothy C.,42,0,60,18
1683738929017,PSYC 70,A01,189001,Steiner; Eric Tomas,21,0,45,24
1683738930044,PSYC 100,A00,189005,Lacefield; Katharine I,1,97,120,119
1683738931068,PSYC 102,A00,189008,Staff,6,0,30,24
1683738932091,PSYC 106,B00,189026,Gorman; Michael R.,26,0,60,34
1683738933134,PSYC 114,B01,189033,Winkielman; Piotr,0,31,30,30
1683738934157,PSYC 131,A00,189036,Anagnostaras; Stephan,0,44,60,60
1683738935185,PSYC 136,A00,189041,Lowe; Angela Beth,0,7,25,25
1683738936211,PSYC 137,A00,189057,Winkielman; Piotr,0,36,25,25
1683738937236,PSYC 144,A00,189107,Wixted; John T,0,11,50,50
1683738939287,PSYC 162,A00,189142,Staff,0,9,85,85
1683738940311,PSYC 172,A00,189144,Gorman; Michael R.,0,6,30,30
1683738942364,PSYC 179,A00,189146,Lacefield; Katharine I,0,88,120,120
1683738943392,PSYC 181,A00,189147,Anagnostaras; Stephan,110,45,200,90
1683738944416,PSYC 190R,A00,189148,Barner; David A.,0,23,80,80
1683738945442,PSYC 191,A00,189275,Rickard; Timothy C.,0,11,25,25
1683738946468,PSYC 193,A00,189276,Chapman; Eddie Nathaniel,0,1,0,4
1683738947493,PSYC 193L,A01,189281,Lowe; Angela Beth,8,0,20,12
1683738947493,PSYC 193L,B01,189285,Staff,28,0,35,7
1683738948517,RELI 149,A00,187137,Rahimi; Babak,6,0,40,34
1683738949543,SE 9,A01,187315,Staff,0,2,18,18
1683738950567,SE 101B,A00,187409,Staff,24,0,30,6
1683738951592,SE 110B,A00,187444,Staff,10,0,40,30
1683738952618,SE 130B,A00,187449,Staff,31,0,40,9
1683738953645,SE 150A,A00,187516,Staff,8,0,20,12
1683738954669,SE 154,A00,187528,Staff,29,0,50,21
1683738955694,SIO 3,A01,258171,Staff,35,0,40,5
1683738956775,SIO 10,A00,187144,Cook; Geoffrey W,0,6,75,75
1683738957799,SIO 45,A00,187152,Cook; Geoffrey W,1,7,100,99
1683738958823,SIO 109R,A00,194486,Staff,0,4,20,20
1683738960880,SIO 187,A01,187233,Kacev; David,12,0,40,28
1683738961919,SOCI 1,A01,258656,Thorpe; Charles Robert,28,0,30,2
1683738961919,SOCI 1,A02,258658,Thorpe; Charles Robert,30,0,30,0
1683738961919,SOCI 1,A03,258661,Thorpe; Charles Robert,25,0,25,0
1683738961919,SOCI 1,A04,258666,Thorpe; Charles Robert,22,0,25,3
1683738961919,SOCI 1,A05,258897,Thorpe; Charles Robert,22,0,25,3
1683738961919,SOCI 1,A06,258898,Thorpe; Charles Robert,25,0,25,0
1683738962944,SOCI 30,A01,258903,Pardo Guerra; Juan Pablo,14,0,30,16
1683738963977,SOCI 102,A00,258904,Staff,9,0,25,16
1683738965009,SOCI 106,A00,258905,Staff,19,0,25,6
1683738966033,SOCI 111,A00,258907,Ribas Norris; Janet Vanesa,26,0,30,4
1683738967061,SOCI 121R,A00,258908,Pardo Guerra; Juan Pablo,7,0,30,23
1683738968090,SOCI 126,A01,203330,Staff,14,0,20,6
1683738969115,SOCI 131,A00,258909,Thorpe; Charles Robert,30,0,60,30
1683738970159,SOCI 135,A00,258910,Payne; Christine Anna,0,13,30,30
1683738971183,SOCI 157,A00,258911,Staff,10,0,30,20
1683738972209,SOCI 184,A00,258912,Staff,25,0,30,5
1683738973232,SOCI 188D,A00,258913,Staff,22,0,30,8
1683738974263,SYN 2,001,187529,Staff,9,0,16,7
1683738974263,SYN 2,002,201452,Staff,0,20,16,16
1683738974263,SYN 2,003,201469,Staff,1,0,16,15
1683738975287,SYN 100,A01,187531,Staff,0,9,20,20
1683738975287,SYN 100,B01,201491,Staff,0,10,20,20
1683738976314,TDAC 1,A00,189286,Walsh; Kim C.,3,0,20,17
1683738976314,TDAC 1,B00,189287,Harting; Carla Kelso,10,0,20,10
1683738977338,TDAC 101,A00,189300,Walsh; Kim C.,16,0,20,4
1683738977338,TDAC 101,B00,189301,Harting; Carla Kelso,18,0,20,2
1683738978363,TDAC 102,A00,189304,Basso; Beatrice,14,0,20,6
1683738979385,TDAC 108,A00,189305,Staff,18,0,20,2
1683738980415,TDDE 131,A00,189310,Staff,19,0,20,1
1683738980415,TDDE 131,B00,189314,Staff,19,0,20,1
1683738980415,TDDE 131,C00,189315,Staff,48,0,50,2
1683738980415,TDDE 131,D00,189316,Staff,14,0,15,1
1683738980415,TDDE 131,E00,204841,Staff,20,0,20,0
1683738981440,TDGE 10,A00,189289,Staff,26,0,50,24
1683738981440,TDGE 10,B00,189290,Havis; Allan,0,1,50,50
1683738982464,TDGE 11,A00,189291,Fulton; Julia,0,4,50,50
1683738982464,TDGE 11,B00,189292,Staff,20,0,25,5
1683738982464,TDGE 11,C00,260270,Staff,0,0,0,0
1683738983489,TDGE 25,A00,189294,Staff,1,0,20,19
1683738984514,TDGE 124,A00,189318,Fulton; Julia,0,7,50,50
1683738985543,TDGE 125,A00,189319,Staff,13,0,25,12
1683738985543,TDGE 125,B00,189320,Staff,23,0,25,2
1683738986568,TDGE 127,A00,189322,Havis; Allan,1,0,50,49
1683738987607,TDHT 101,A00,189323,Staff,18,0,25,7
1683738987607,TDHT 101,B00,189324,Staff,25,0,25,0
1683738988632,TDHT 102,A00,189325,Staff,49,0,50,1
1683738989674,TDMV 1,A00,189295,Arcidiacono; Kristin,20,0,30,10
1683738989674,TDMV 1,B00,189296,Caligagan; Maria T.,23,0,30,7
1683738990708,TDMV 2,A00,189297,Sammartano; Tonnie,27,0,30,3
1683738990708,TDMV 2,B00,189299,Arcidiacono; Kristin,23,0,30,7
1683738991733,TDMV 3,A00,204998,Rincon; Alicia,22,0,30,8
1683738992764,TDMV 120,A00,189458,Sammartano; Tonnie,28,0,30,2
1683738993792,TDMV 138,A00,189541,Jun; Grace Shin Hae,20,0,40,20
1683738994820,TDMV 142,A00,189717,Caligagan; Tony,25,0,30,5
1683738994820,TDMV 142,B00,189718,Caligagan; Maria T.,25,0,30,5
1683738995848,TMC 2,A01,187533,Staff,25,0,25,0
1683738995848,TMC 2,A02,187534,Staff,25,0,25,0
1683738996871,USP 1,A01,187536,Kwak; Nancy,0,16,25,25
1683738997899,USP 5,A01,187538,Staff,8,0,25,17
1683738998923,USP 101,A00,199253,Staff,0,4,0,0
1683738999947,USP 124,A00,187562,Boomhower; Matthew Charles,0,0,30,30
1683739000970,USP 138,A00,187582,Staff,19,0,25,6
1683739001998,USP 152,A01,187597,Staff,3,0,25,22
1683739003026,USP 153,A00,187598,Staff,18,0,25,7
1683739004050,USP 168,A00,187607,Kwak; Nancy,2,0,5,3
1683739005077,USP 173,A00,187619,Staff,4,0,25,21
1683739006103,USP 181,A00,187638,Staff,0,4,25,25
1683739007127,VIS 103,A00,187650,Cruz; Edwin Teddy,17,0,75,58
1683739008150,VIS 110D,A00,187669,Staff,13,0,22,9
1683739009178,VIS 127C,A00,187720,Shen; Kuiyi,67,0,146,79
1683739010203,VIS 149,A00,187731,Yoldas; Pinar,0,12,22,22
1683739011235,VIS 151,A01,188091,Staff,22,0,34,12
1683739011235,VIS 151,A02,188092,Staff,11,0,34,23
1683739012262,VIS 160B,A00,188093,Stalbaum; Brett,0,1,10,10
1683739014316,WCWP 10B,A00,201720,Staff,0,0,5,5
1683739014316,WCWP 10B,B00,201722,Staff,0,0,6,6
1683739015344,WCWP 100,A00,201725,Gagnon; Jeffrey C,0,0,2,2
1683739015344,WCWP 100,B00,201727,Staff,0,4,15,15
1683739018445,ANBI 133,A00,258401,Wilder; Linnea Lorene,34,0,40,6
1683739019472,ANBI 140,A00,258395,Hrvoj Mihic; Branka,18,0,25,7
1683739020496,ANSC 120,A00,258402,Bialecki; Jon Anthony,26,0,40,14
1683739021525,ANSC 144,A00,258400,Staff,12,0,40,28
1683739023574,ANSC 166,A00,258396,Parish; Steven Martin,156,0,175,19
1683739024596,ANSC 180,A00,193533,Staff,8,0,20,12
1683739025626,ANSC 188,A00,258397,Jassal; Aftab,34,0,40,6
1683739026650,ANTH 3,A01,258316,Staff,23,0,30,7
1683739027674,ANTH 5,A00,258394,Semendeferi; Ekaterini,16,0,20,4
1683739028698,ANTH 21,A01,258331,Staff,4,0,40,36
1683739029722,ANTH 103,A00,258398,Varma; Saiba,15,0,25,10
1683739030748,AWP 10,001,202034,Staff,0,0,0,0
1683739030748,AWP 10,002,202035,Staff,0,0,0,0
1683739030748,AWP 10,003,202036,Staff,0,0,0,0
1683739030748,AWP 10,004,202037,Staff,0,0,0,0
1683739030748,AWP 10,005,202038,Staff,0,0,0,0
1683739030748,AWP 10,006,202039,Staff,0,0,0,0
1683739030748,AWP 10,007,202040,Staff,0,0,0,0
1683739030748,AWP 10,008,202041,Staff,0,0,0,0
1683739030748,AWP 10,009,202042,Staff,0,0,0,0
1683739030748,AWP 10,010,202043,Staff,0,0,0,0
1683739030748,AWP 10,011,202044,Staff,0,0,0,0
1683739030748,AWP 10,012,202045,Staff,0,0,0,0
1683739030748,AWP 10,013,202046,Staff,0,0,0,0
1683739030748,AWP 10,014,202047,Staff,0,0,0,0
1683739030748,AWP 10,015,202048,Staff,0,0,0,0
1683739030748,AWP 10,016,202049,Staff,0,0,0,0
1683739030748,AWP 10,017,202050,Staff,0,0,0,0
1683739030748,AWP 10,018,202051,Staff,0,0,0,0
1683739030748,AWP 10,019,202052,Staff,0,0,0,0
1683739030748,AWP 10,020,202053,Staff,0,0,0,0
1683739030748,AWP 10,021,202054,Staff,0,0,0,0
1683739030748,AWP 10,022,202055,Staff,0,0,0,0
1683739030748,AWP 10,023,202056,Staff,0,0,0,0
1683739030748,AWP 10,024,202057,Staff,0,0,0,0
1683739030748,AWP 10,025,202058,Staff,0,0,0,0
1683739030748,AWP 10,026,202059,Staff,0,0,0,0
1683739031771,AWP 102,001,202032,Staff,0,0,0,0
1683739031771,AWP 102,002,202033,Staff,0,0,0,0
1683739032806,BENG 100,A01,254234,Taylor Amos; Alyssa C,31,0,40,9
1683739033832,BENG 196,001,270013,Engler; Adam J.,9999,0,9999,0
1683739034866,BICD 100R,A01,202018,Smith; Laurie,0,7,32,32
1683739034866,BICD 100R,A02,202019,Smith; Laurie,0,3,32,32
1683739034866,BICD 100R,A03,202020,Smith; Laurie,0,1,32,32
1683739034866,BICD 100R,A04,202021,Smith; Laurie,6,0,32,26
1683739034866,BICD 100R,A05,202022,Smith; Laurie,10,0,32,22
1683739035891,BICD 136,A01,193242,Gustafson-Brown; Cindy,0,2,32,32
1683739035891,BICD 136,A02,193244,Gustafson-Brown; Cindy,13,0,32,19
1683739036923,BIEB 102,A01,193249,Butler; Shannon Rhey,0,0,32,32
1683739036923,BIEB 102,A02,193251,Butler; Shannon Rhey,0,0,32,32
1683739036923,BIEB 102,A03,193253,Butler; Shannon Rhey,0,0,32,32
1683739036923,BIEB 102,A04,193255,Butler; Shannon Rhey,13,0,32,19
1683739036923,BIEB 102,A05,193265,Butler; Shannon Rhey,25,0,32,7
1683739036923,BIEB 102,A06,193269,Butler; Shannon Rhey,12,0,32,20
1683739038982,BIEB 150,A01,193274,Staff,0,0,32,32
1683739038982,BIEB 150,A02,193285,Staff,24,0,32,8
1683739040011,BIEB 194,A00,193286,Kurle; Carolyn M.,19,0,32,13
1683739041042,BILD 1,A01,192291,Staff,15,0,32,17
1683739041042,BILD 1,A02,192292,Staff,30,0,32,2
1683739041042,BILD 1,B01,192520,Reuther; Keefe,0,1,0,0
1683739041042,BILD 1,B02,192532,Reuther; Keefe,0,1,0,0
1683739042068,BILD 3,A01,192556,Butler; Shannon Rhey,0,0,32,32
1683739042068,BILD 3,A02,192581,Butler; Shannon Rhey,0,1,32,32
1683739042068,BILD 3,A03,192611,Butler; Shannon Rhey,19,0,32,13
1683739042068,BILD 3,A04,192612,Butler; Shannon Rhey,23,0,32,9
1683739042068,BILD 3,A05,192613,Butler; Shannon Rhey,26,0,32,6
1683739042068,BILD 3,A06,192679,Butler; Shannon Rhey,27,0,32,5
1683739042068,BILD 3,A07,192682,Butler; Shannon Rhey,20,0,32,12
1683739043096,BILD 4,A01,192836,Reuther; Keefe,1,0,24,23
1683739043096,BILD 4,A02,193044,Reuther; Keefe,4,0,24,20
1683739044121,BILD 10,A01,193142,Gustafson-Brown; Cindy,29,0,32,3
1683739044121,BILD 10,A02,193149,Gustafson-Brown; Cindy,31,0,32,1
1683739045148,BIMM 100,A01,193301,Staff,0,6,32,32
1683739045148,BIMM 100,A02,193312,Staff,0,7,32,32
1683739045148,BIMM 100,A03,193323,Staff,0,10,32,32
1683739046178,BIMM 101,A01,193329,McDonnell; Lisa Marie,0,3,24,24
1683739046178,BIMM 101,A02,193339,McDonnell; Lisa Marie,0,3,24,24
1683739046178,BIMM 101,B01,193354,McDonnell; Lisa Marie,0,4,24,24
1683739046178,BIMM 101,B02,193357,McDonnell; Lisa Marie,0,3,24,24
1683739047206,BIMM 110,A01,193377,Tat; John,0,11,32,32
1683739047206,BIMM 110,A02,193378,Tat; John,0,11,32,32
1683739048230,BIMM 120,A01,206116,Staff,1,0,32,31
1683739048230,BIMM 120,A02,206117,Staff,7,0,32,25
1683739048230,BIMM 120,A03,206121,Staff,21,0,32,11
1683739049256,BIPN 100,A01,193393,Park; Ji Young,0,15,32,32
1683739049256,BIPN 100,A02,193402,Park; Ji Young,0,14,32,32
1683739049256,BIPN 100,A03,193413,Park; Ji Young,0,14,32,32
1683739049256,BIPN 100,A04,193414,Park; Ji Young,0,13,32,32
1683739050285,BIPN 102,A01,193429,Staff,0,0,32,32
1683739050285,BIPN 102,A02,193438,Staff,18,0,32,14
1683739051309,BIPN 106,A01,193450,Reyes Gonzalez; Catalina,0,2,40,40
1683739052334,BIPN 134,A01,193465,Cooke; James Edward,0,0,32,32
1683739052334,BIPN 134,A02,193474,Cooke; James Edward,24,0,32,8
1683739052334,BIPN 134,A03,193485,Cooke; James Edward,29,0,32,3
1683739052334,BIPN 134,A04,193486,Cooke; James Edward,20,0,32,12
1683739052334,BIPN 134,A05,193491,Cooke; James Edward,31,0,32,1
1683739052334,BIPN 134,A06,193501,Cooke; James Edward,30,0,32,2
1683739052334,BIPN 134,A07,193510,Cooke; James Edward,29,0,32,3
1683739054385,BISP 194,A00,222522,Staff,14,0,32,18
1683739055410,CAT 124,A01,202407,Staff,19,0,25,6
1683739056434,CAT 125,A00,202408,Marchisotto; Jennifer Anne,2,0,20,18
1683739057459,CAT 125R,A00,202409,Smith; Lauryn Alissa,0,11,20,20
1683739057459,CAT 125R,B00,202410,Morales; Celeste Georgianna,0,11,20,20
1683739057459,CAT 125R,C00,202411,Irwin; Matthew Joseph,0,12,20,20
1683739058485,CENG 15,A01,204712,Yang; Kesong,0,1,0,0
1683739059510,CENG 114,A00,202070,Jahed Motlagh; Zeinab,5,0,20,15
1683739060594,CGS 105,A00,185477,Wesling; Megan E.,24,0,40,16
1683739061617,CGS 106,A00,185494,Staff,11,0,22,11
1683739062642,CGS 108,A00,185495,Staff,14,0,20,6
1683739063669,CGS 114,A00,185496,Staff,13,0,18,5
1683739064693,CGS 119,A00,185501,Staff,15,0,20,5
1683739065717,CGS 120,A00,185511,Staff,11,0,20,9
1683739066742,CHEM 4,A01,184675,Bussey; Thomas J,97,0,100,3
1683739067770,CHEM 6A,A01,184677,Staff,32,0,60,28
1683739068795,CHEM 6B,A01,184679,Staff,63,0,100,37
1683739069819,CHEM 6C,A01,184681,Bussey; Thomas J,0,0,50,50
1683739069819,CHEM 6C,A02,184682,Bussey; Thomas J,32,0,50,18
1683739070850,CHEM 40A,A01,184684,Albizati; Kim F.,33,0,100,67
1683739071875,CHEM 40B,A01,184686,Albizati; Kim F.,0,23,100,100
1683739072903,CHEM 41B,A01,184690,Staff,51,0,100,49
1683739073929,COGS 3,A01,184715,Boyle; Mary E. T.,0,27,40,40
1683739074958,COGS 14B,A01,185172,Staff,0,14,38,38
1683739075986,COGS 18,A01,184736,Staff,14,0,80,66
1683739077013,COGS 100,A01,184932,Staff,0,8,73,73
1683739078042,COGS 101A,A01,184935,Staff,0,40,30,30
1683739079070,COGS 101B,A01,184944,Staff,0,2,30,30
1683739080096,COGS 101C,A01,184946,Staff,0,10,30,30
1683739081139,COGS 102A,A01,184951,Johnson; Christine M.,1,0,40,39
1683739082164,COGS 107B,A01,184953,Mooshagian; Eric Frederick,0,52,40,40
1683739083187,COGS 118B,A01,184959,Gupta; Anjum,0,50,40,40
1683739084211,COGS 153,A00,184961,Staff,1,16,30,29
1683739085237,COGS 177,A00,184962,Staff,0,20,30,30
1683739086265,COGS 187A,A01,184969,Boyle; Mary E. T.,0,19,40,40
1683739087288,COMM 10,A01,185174,Staff,0,5,25,25
1683739087288,COMM 10,A02,185189,Staff,0,2,25,25
1683739087288,COMM 10,A03,269821,Staff,0,1,0,0
1683739088316,COMM 100B,A02,185476,Staff,10,0,25,15
1683739088316,COMM 100B,A03,277340,Staff,25,0,25,0
1683739089342,COMM 100C,A01,185314,Staff,2,0,25,23
1683739089342,COMM 100C,A02,185327,Staff,17,0,25,8
1683739090370,COMM 110M,A00,185349,Staff,0,0,40,40
1683739091396,COMM 113T,A00,185352,Staff,25,0,40,15
1683739092425,COMM 114I,A00,185353,Staff,31,0,40,9
1683739093449,COMM 131,A00,185354,Staff,17,0,30,13
1683739094474,CSE 8A,A50,185358,Cao; Yingjun,0,46,10,10
1683739095497,CSE 8B,A01,185362,Staff,0,48,50,50
1683739096520,CSE 11,A01,185416,Cao; Yingjun,0,91,10,10
1683739097548,CSE 20,A01,185445,Briones; Jor-el Thomas Caparas,3,0,25,22
1683739098577,CSE 21,A01,185447,Staff,9,0,50,41
1683739099601,CSE 101,A01,185451,Staff,0,13,50,50
1683739099601,CSE 101,B01,185453,Jones; Miles E,0,15,50,50
1683739101653,CSE 141,A01,185458,Eldon; John,16,0,100,84
1683739102680,CSE 141L,A01,185461,Eldon; John,8,0,100,92
1683739103708,CSE 142,A01,185463,Staff,34,0,60,26
1683739103708,CSE 142,B01,201355,Staff,0,7,60,60
1683739104732,CSE 142L,A01,185470,Staff,34,0,60,26
1683739104732,CSE 142L,B01,201417,Staff,0,6,60,60
1683739105755,CSE 190,A00,201433,Staff,32,0,49,17
1683739106780,DOC 1,A01,259136,Strom; Megan C.,7,0,15,8
1683739106780,DOC 1,A02,259137,Strom; Megan C.,15,0,15,0
1683739106780,DOC 1,A03,259138,Strom; Megan C.,14,0,15,1
1683739106780,DOC 1,A04,259139,Strom; Megan C.,13,0,15,2
1683739107808,DOC 100D,A00,259140,Pass; Natalye Joann,14,0,25,11
1683739108832,DSGN 1,A01,184749,Rill; Bryan,0,26,30,30
1683739109858,DSGN 100,A01,185168,Staff,0,2,25,25
1683739110882,ECE 5,A01,185626,Morris; Karcher William,0,12,0,0
1683739111910,ECE 101,A01,185628,Staff,14,0,70,56
1683739112939,ECE 107,A01,185635,Baghdadchi; Saharnaz,0,0,20,20
1683739112939,ECE 107,A02,185638,Baghdadchi; Saharnaz,1,0,20,19
1683739113963,ECE 148,A01,185647,Silberman; Jack,0,0,16,16
1683739114992,ECON 1,A01,185537,Crane; Meredith Helen,54,0,70,16
1683739116020,ECON 3,A01,185549,Crane; Meredith Helen,30,0,70,40
1683739117049,ECON 4,A01,203354,Anderson; John Charles,0,5,10,10
1683739118076,ECON 100A,A01,185574,Staff,0,5,40,40
1683739119100,ECON 100B,A01,185576,Staff,0,12,50,50
1683739120141,ECON 100C,A01,185589,Newhouse; Herbert S,30,0,70,40
1683739121166,ECON 105,A00,185608,Vespa; Emanuel Ignacio,19,0,35,16
1683739122191,ECON 109,A01,185610,Shishkin; Denis,9,0,35,26
1683739123215,ECON 110A,A01,185612,Staff,8,0,40,32
1683739124241,ECON 120A,A01,185615,Staff,19,0,40,21
1683739125274,ECON 120C,A01,185617,Sun; Yixiao,0,21,70,70
1683739126298,ECON 144,A00,203346,Squires; Dale E,2,0,35,33
1683739127327,ECON 171,A01,203349,Newhouse; Herbert S,0,1,35,35
1683739128351,ECON 173A,A01,185621,Toda; Alexis Akira,21,0,35,14
1683739129381,EDS 25,A01,202413,Staff,0,1,0,0
1683739129381,EDS 25,A02,202414,Staff,0,1,0,0
1683739129381,EDS 25,A03,202415,Staff,0,0,0,0
1683739129381,EDS 25,A04,202416,Staff,0,1,0,0
1683739129381,EDS 25,A05,202439,Staff,0,0,0,0
1683739129381,EDS 25,A06,202440,Staff,0,0,0,0
1683739129381,EDS 25,B01,202631,Staff,0,0,0,0
1683739129381,EDS 25,B02,202632,Staff,0,0,0,0
1683739129381,EDS 25,B03,202639,Staff,0,0,0,0
1683739129381,EDS 25,B04,202640,Staff,0,0,0,0
1683739129381,EDS 25,B05,202643,Staff,0,0,0,0
1683739129381,EDS 25,B06,202644,Staff,0,0,0,0
1683739130406,EDS 38,A01,202659,Black; Alison Michelle,25,0,25,0
1683739131430,EDS 115,A00,202652,Staff,18,0,30,12
1683739132456,EDS 125,A00,202649,Staff,13,0,30,17
1683739133481,EDS 126,A01,203332,Staff,30,0,30,0
1683739134506,EDS 139,A00,202838,Staff,16,0,25,9
1683739135534,EDS 146,A01,202655,Staff,14,0,25,11
1683739136559,ENG 15,A00,185667,Staff,0,1,0,2
1683739136559,ENG 15,B00,185672,Staff,0,0,0,1
1683739136559,ENG 15,C00,185675,Staff,0,0,0,0
1683739136559,ENG 15,D00,185682,Staff,0,0,0,0
1683739136559,ENG 15,E00,185684,Staff,0,0,0,0
1683739137583,ETHN 103,A00,185710,Staff,0,8,35,35
1683739138613,ETHN 103A,A00,199228,Man; Simeon S,0,0,9,9
1683739139638,ETHN 109,A00,185711,Staff,15,0,35,20
1683739140661,ETHN 142,A00,185726,Staff,0,4,30,30
1683739141690,ETHN 163J,A00,199229,Man; Simeon S,5,0,8,3
1683739142717,ETHN 168,A00,185727,Staff,7,0,10,3
1683739143742,ETHN 182,A00,185728,Staff,0,0,35,35
1683739144773,ETHN 183,A00,185737,Staff,10,0,18,8
1683739145800,GLBH 111,A01,209361,Burgos; Jose L.,0,0,0,0
1683739147853,HIEU 104,A00,185792,Staff,14,0,20,6
1683739148882,HIEU 115,A00,185800,Staff,0,0,20,20
1683739149906,HIEU 128,A00,185801,Staff,0,9,20,20
1683739150931,HIEU 147,A00,185802,Staff,15,0,20,5
1683739151956,HIEU 154,A00,185823,Staff,11,0,20,9
1683739152981,HILA 102,A00,185826,Staff,14,0,20,6
1683739154006,HILD 2C,A01,185778,Staff,0,13,20,20
1683739155028,HILD 7B,A01,185780,Kwak; Nancy,0,17,32,32
1683739155028,HILD 7B,A02,185781,Kwak; Nancy,0,18,32,32
1683739156089,HILD 30,A01,185791,Staff,12,0,20,8
1683739157127,HISC 119,A00,185830,Golan; Tal,0,10,20,20
1683739158150,HITO 156GS,A00,185831,Patterson; Patrick H.,0,0,0,23
1683739159173,HIUS 103,A00,185832,Man; Simeon S,0,4,20,20
1683739160201,HIUS 117,A00,185836,Kwak; Nancy,2,0,20,18
1683739161227,HIUS 125,A00,185840,Man; Simeon S,0,2,23,23
1683739162250,HIUS 149,A00,185845,Staff,1,0,20,19
1683739163277,HUM 3,A01,185882,Zavodny; Tatiana Sophia,0,8,50,50
1683739163277,HUM 3,B01,185899,Caldwell; Michael Alan,0,18,50,50
1683739164374,HUM 3GS,A00,185900,Patterson; Patrick H.,0,0,0,23
1683739165398,HUM 4,A01,185938,Zroka; Amy Liane,28,0,50,22
1683739165398,HUM 4,B01,185956,Watkins; Eric,0,6,50,50
1683739165398,HUM 4,B02,202209,Watkins; Eric,0,6,50,50
1683739165398,HUM 4,B03,202210,Watkins; Eric,0,5,50,50
1683739166426,HUM 5,A01,185958,West; Geoffrey Scott,0,1,50,50
1683739166426,HUM 5,A02,202215,West; Geoffrey Scott,0,1,50,50
1683739167450,INTL 190,A00,185959,Gagnon; Jeffrey C,0,0,0,9
1683739167450,INTL 190,B00,185960,Lettieri; Michael Joseph,0,0,0,2
1683739168475,JAPN 180,A00,254509,Staff,4,0,30,26
1683739169506,LATI 10,A01,202853,Kennemore; Amy Michelle,0,0,31,31
1683739169506,LATI 10,A02,202854,Kennemore; Amy Michelle,0,0,32,32
1683739169506,LATI 10,A03,270054,Kennemore; Amy Michelle,30,0,30,0
1683739170530,LATI 180,A00,202855,Kennemore; Amy Michelle,11,0,20,9
1683739171553,LAWS 101,A00,201767,Golan; Tal,0,7,40,40
1683739172582,LIFR 1C,A00,185961,Staff,6,0,20,14
1683739173611,LIFR 1CX,A00,185962,Staff,7,0,20,13
1683739174637,LIFR 1D,A00,185963,Staff,7,0,20,13
1683739175664,LIFR 1DX,A00,185964,Staff,7,0,20,13
1683739176688,LIGN 101,A01,186039,Staff,43,0,50,7
1683739177713,LIGN 165,A00,186040,Staff,14,0,50,36
1683739178741,LTCS 108,A00,186041,Staff,5,0,10,5
1683739179768,LTCS 119,A00,186042,Staff,15,0,20,5
1683739180790,LTCS 130,A00,186043,Wesling; Megan E.,15,0,25,10
1683739182846,LTEA 138,A00,186119,Staff,13,0,40,27
1683739183872,LTEN 124,A00,186148,Staff,5,0,25,20
1683739184903,LTEN 178,A00,186149,Staff,6,0,15,9
1683739185933,LTEN 181,A00,186150,Blanco; John D,34,0,40,6
1683739186962,LTWL 120,A00,186160,Staff,19,0,25,6
1683739187991,LTWL 165,A00,186161,Staff,22,0,25,3
1683739189015,LTWR 100,A00,186162,Staff,0,5,15,15
1683739190042,LTWR 102,A00,186163,Doller; Ben,5,0,15,10
1683739191067,MAE 8,A01,186412,Staff,0,1,0,1
1683739192092,MAE 30B,A00,186445,Bahadori; Mohammad Yousef,81,0,100,19
1683739193148,MAE 40,A00,186592,Bewley; Thomas R,10,0,50,40
1683739194174,MAE 101B,A00,186593,Bahadori; Mohammad Yousef,79,0,100,21
1683739195203,MAE 105,A00,186594,Bandaru; Prabhakar,10,0,50,40
1683739196232,MAE 107,A00,186599,Pham; Hieu Tan,0,8,120,120
1683739197256,MAE 148,A01,186660,Silberman; Jack,3,0,16,13
1683739198284,MATH 10A,A01,188095,Staff,0,6,35,35
1683739199315,MATH 10B,A01,188097,Bowers; Adam R.,0,12,30,30
1683739199315,MATH 10B,A02,188099,Bowers; Adam R.,0,11,30,30
1683739199315,MATH 10B,B01,188104,Bowers; Adam R.,0,10,30,30
1683739199315,MATH 10B,B02,188106,Bowers; Adam R.,0,9,30,30
1683739200344,MATH 10C,A01,188111,Staff,0,20,30,30
1683739200344,MATH 10C,A02,188127,Staff,0,19,30,30
1683739200344,MATH 10C,A03,188131,Staff,0,19,30,30
1683739200344,MATH 10C,B01,188218,Staff,17,0,30,13
1683739200344,MATH 10C,B02,188244,Staff,13,0,30,17
1683739200344,MATH 10C,B03,188277,Staff,14,0,30,16
1683739201382,MATH 18,A01,188344,Bach; Quang Tran,18,0,30,12
1683739201382,MATH 18,A02,188345,Bach; Quang Tran,11,0,30,19
1683739201382,MATH 18,B01,188353,Bach; Quang Tran,11,0,30,19
1683739201382,MATH 18,B02,188354,Bach; Quang Tran,19,0,30,11
1683739202407,MATH 20A,A01,188374,Staff,10,0,35,25
1683739203443,MATH 20B,A01,188382,Ohm; Ko Woon,7,0,30,23
1683739203443,MATH 20B,A02,188383,Ohm; Ko Woon,22,0,30,8
1683739203443,MATH 20B,B01,188385,Ohm; Ko Woon,7,0,30,23
1683739203443,MATH 20B,B02,188392,Ohm; Ko Woon,22,0,30,8
1683739204468,MATH 20C,A01,188394,Harel; Guershon,10,0,30,20
1683739204468,MATH 20C,A02,188395,Harel; Guershon,13,0,30,17
1683739204468,MATH 20C,B01,188404,Harel; Guershon,5,0,30,25
1683739204468,MATH 20C,B02,188405,Harel; Guershon,18,0,30,12
1683739205493,MATH 20D,A01,188414,Hammock; Frances H,0,1,30,30
1683739205493,MATH 20D,A02,188415,Hammock; Frances H,0,1,30,30
1683739205493,MATH 20D,B01,188447,Hammock; Frances H,0,1,30,30
1683739205493,MATH 20D,B02,188486,Hammock; Frances H,2,0,30,28
1683739206517,MATH 20E,A01,188649,Staff,21,0,30,9
1683739206517,MATH 20E,A02,188650,Staff,20,0,30,10
1683739206517,MATH 20E,A03,188673,Staff,0,0,30,30
1683739207547,MATH 102,A01,188675,Staff,0,40,35,35
1683739208571,MATH 103B,A01,188681,Staff,2,0,35,33
1683739208571,MATH 103B,B01,188692,Staff,5,0,35,30
1683739209601,MATH 109,A01,188695,Salehi Golsefidy; Alireza,24,0,35,11
1683739209601,MATH 109,A02,188696,Salehi Golsefidy; Alireza,24,0,35,11
1683739210625,MATH 120A,A01,188698,Eggers; John Dietrich,7,0,35,28
1683739211652,MATH 142B,A01,188736,Ioana; Adrian,0,0,30,30
1683739211652,MATH 142B,A02,188741,Ioana; Adrian,0,1,30,30
1683739211652,MATH 142B,A03,188743,Ioana; Adrian,0,3,30,30
1683739212675,MATH 168A,A01,188790,Staff,0,11,35,35
1683739213699,MATH 170A,A01,188803,Nie; Jiawang,0,2,35,35
1683739213699,MATH 170A,A02,188811,Nie; Jiawang,0,1,35,35
1683739213699,MATH 170A,A03,188814,Nie; Jiawang,1,0,35,34
1683739213699,MATH 170A,A04,188815,Nie; Jiawang,4,0,35,31
1683739214723,MATH 193B,A01,188817,Staff,0,0,35,35
1683739214723,MATH 193B,A02,188818,Staff,6,0,35,29
1683739215747,MGT 4,A01,202857,Anderson; John Charles,59,0,80,21
1683739216774,MGT 12,A00,202858,Lindenberger; Wade Douglas,39,0,90,51
1683739217805,MGT 18,A00,202859,Staff,73,0,90,17
1683739218831,MGT 18GS,A00,202860,McKay; Michael J,13,0,28,15
1683739219858,MGT 45,A00,202861,Pecore; Joseph P.,8,0,90,82
1683739220885,MGT 100,A00,202863,Yavorsky; Daniel Ryan,27,0,90,63
1683739221912,MGT 103,A00,202864,Ehrich; Kristine R,0,19,90,90
1683739222938,MGT 112,A00,202865,Ehrich; Kristine R,15,0,90,75
1683739223966,MGT 121A,A00,202868,Staff,70,0,90,20
1683739224990,MGT 131B,A00,202869,Anderson; John Charles,58,0,90,32
1683739226016,MGT 136,A00,202871,Lindenberger; Wade Douglas,83,0,90,7
1683739227048,MGT 164,A00,202873,Staff,0,67,90,91
1683739228073,MGT 164GS,A00,202874,McKay; Mary A,13,0,28,15
1683739229097,MGT 180,A00,202875,Staff,0,51,90,91
1683739230147,MMW 11R,A01,205019,Herbst; Matthew,0,0,30,30
1683739230147,MMW 11R,A02,205026,Herbst; Matthew,29,0,30,1
1683739231173,MMW 15,A01,193512,Chang; Edmond Yi-Teh,0,8,28,28
1683739231173,MMW 15,A02,193513,Chang; Edmond Yi-Teh,0,5,28,28
1683739231173,MMW 15,A03,193514,Chang; Edmond Yi-Teh,0,5,28,28
1683739231173,MMW 15,A04,193515,Chang; Edmond Yi-Teh,0,5,28,28
1683739231173,MMW 15,A05,193516,Chang; Edmond Yi-Teh,0,5,28,28
1683739231173,MMW 15,A06,193517,Chang; Edmond Yi-Teh,0,6,28,28
1683739231173,MMW 15,B01,193519,Chang; Edmond Yi-Teh,0,5,28,28
1683739231173,MMW 15,B02,193520,Chang; Edmond Yi-Teh,0,5,28,28
1683739231173,MMW 15,B03,193521,Chang; Edmond Yi-Teh,0,5,28,28
1683739231173,MMW 15,B04,193522,Chang; Edmond Yi-Teh,0,6,28,28
1683739231173,MMW 15,B05,193523,Chang; Edmond Yi-Teh,0,5,28,28
1683739231173,MMW 15,B06,193524,Chang; Edmond Yi-Teh,0,5,28,28
1683739232198,MMW 122,A01,193526,Rahimi; Babak,0,16,28,28
1683739232198,MMW 122,A02,193527,Rahimi; Babak,0,15,28,28
1683739232198,MMW 122,A03,193528,Rahimi; Babak,0,0,0,0
1683739232198,MMW 122,A04,193529,Rahimi; Babak,0,0,0,0
1683739233227,MUS 1A,A01,186663,Staff,0,18,35,35
1683739234254,MUS 4,A01,186715,Staff,0,12,35,35
1683739235282,MUS 5R,A01,186796,Dubnov; Shlomo,0,17,35,35
1683739236310,MUS 6,A01,186798,Staff,0,4,25,25
1683739237339,MUS 7,A01,186830,Staff,11,0,35,24
1683739238366,MUS 8,A01,186930,Staff,0,27,35,35
1683739239390,MUS 15,A01,186932,Staff,0,15,35,35
1683739239390,MUS 15,B01,186934,Staff,0,16,35,35
1683739240415,MUS 80,A00,186935,Staff,0,0,20,20
1683739240415,MUS 80,B00,186936,Staff,24,0,25,1
1683739241441,NANO 11,A00,204702,Lipomi; Darren John,0,0,0,0
1683739242468,NANO 15,A01,204709,Yang; Kesong,0,1,0,0
1683739243493,NANO 114,A00,202069,Jahed Motlagh; Zeinab,2,0,10,8
1683739244520,PHIL 1,A00,186955,Grush; Rick Scott,31,0,40,9
1683739245544,PHIL 10,A01,186973,Grush; Rick Scott,27,0,35,8
1683739245544,PHIL 10,A02,186974,Grush; Rick Scott,33,0,35,2
1683739246568,PHIL 13,A01,186976,Staff,1,0,35,34
1683739246568,PHIL 13,A02,186977,Staff,16,0,35,19
1683739247595,PHIL 14,A01,186979,Staff,30,0,35,5
1683739247595,PHIL 14,A02,186986,Staff,32,0,35,3
1683739248626,PHIL 28,A01,186988,Staff,16,0,30,14
1683739248626,PHIL 28,A02,186989,Staff,0,0,30,30
1683739248626,PHIL 28,A03,186990,Staff,10,0,30,20
1683739248626,PHIL 28,A04,186991,Staff,26,0,30,4
1683739249651,PHIL 120,A00,186997,Staff,23,0,40,17
1683739250678,PHIL 137,A00,187003,Staff,8,0,40,32
1683739251705,PHIL 150,A00,187015,Staff,47,0,70,23
1683739252730,PHIL 167,A00,187021,Lamey; Andy M.,34,0,40,6
1683739253761,PHIL 174,A01,202226,Staff,17,0,20,3
1683739253761,PHIL 174,A02,202235,Staff,20,0,20,0
1683739254783,PHIL 191A,A00,258918,Staff,0,0,1,1
1683739255806,PHYS 1A,A00,187028,Staff,26,0,60,34
1683739256831,PHYS 1AL,001,187036,Staff,3,0,30,27
1683739256831,PHYS 1AL,002,187049,Staff,18,0,30,12
1683739257858,PHYS 1B,A00,187058,Staff,21,0,60,39
1683739258882,PHYS 1BL,001,187064,Staff,0,1,30,30
1683739258882,PHYS 1BL,002,187070,Staff,4,0,30,26
1683739259907,PHYS 1C,A00,187082,Staff,30,0,120,90
1683739260932,PHYS 1CL,001,187088,Staff,0,9,30,30
1683739260932,PHYS 1CL,002,187089,Staff,0,1,30,30
1683739260932,PHYS 1CL,009,262693,Staff,9,0,30,21
1683739261960,PHYS 2B,A01,187097,Staff,55,0,115,60
1683739262984,PHYS 2C,A01,187099,Staff,63,0,115,52
1683739264012,PHYS 2CL,A01,187101,Staff,5,0,28,23
1683739264012,PHYS 2CL,A02,187102,Staff,15,0,28,13
1683739265037,PHYS 2D,A01,187123,Shotwell; Brian,95,0,115,20
1683739266067,PHYS 4B,A01,187133,Grinstein; Benjamin,35,0,50,15
1683739267094,POLI 10,A00,188819,Staff,0,4,50,50
1683739268174,POLI 11,A00,188827,Staff,43,0,50,7
1683739269200,POLI 13R,A00,188828,Staff,0,2,20,20
1683739270227,POLI 27,A01,188830,Elgin; Samuel Zincke,0,2,70,70
1683739271254,POLI 30,A00,188832,Desposato; Scott,30,0,50,20
1683739272282,POLI 102F,A00,188834,Staff,1,0,40,39
1683739273305,POLI 104A,A00,188852,Staff,12,0,30,18
1683739274329,POLI 104I,A00,188853,Staff,0,8,20,20
1683739275354,POLI 110B,A00,188854,Wiens; David,6,0,20,14
1683739276390,POLI 112A,A00,188855,Wiens; David,4,0,30,26
1683739277415,POLI 117R,A00,188856,Forman; Fonna,0,12,20,20
1683739278441,POLI 118,A00,188857,Ingham; Sean,8,0,20,12
1683739279464,POLI 120G,A00,188858,Staff,7,0,30,23
1683739280489,POLI 131CR,A00,188863,Hoston; Germaine,19,0,50,31
1683739281514,POLI 133,A00,188864,Nellis; Gareth Hb,44,0,50,6
1683739282539,POLI 134D,A00,188865,Desposato; Scott,27,0,30,3
1683739283565,POLI 142A,A00,188871,Gartzke; Erik,21,0,50,29
1683739284592,POLI 142K,A00,188874,Staff,38,0,50,12
1683739285622,POLI 143,A00,188940,Gartzke; Erik,15,0,30,15
1683739286650,POLI 153,A00,188943,Staff,1,0,20,19
1683739287675,POLI 160AA,A00,188944,Staff,10,0,40,30
1683739288701,POLI 170A,A00,188945,Staff,10,0,30,20
1683739290751,PSYC 1,A00,188952,Staff,36,0,90,54
1683739291778,PSYC 2,B00,188953,Staff,19,0,35,16
1683739292805,PSYC 6,A00,188970,Staff,47,0,60,13
1683739293829,PSYC 7,A00,188973,Staff,35,0,45,10
1683739294859,PSYC 60,A01,188980,Rickard; Timothy C.,42,0,60,18
1683739295887,PSYC 70,A01,189001,Steiner; Eric Tomas,21,0,45,24
1683739296915,PSYC 100,A00,189005,Lacefield; Katharine I,1,97,120,119
1683739297939,PSYC 102,A00,189008,Staff,6,0,30,24
1683739298963,PSYC 106,B00,189026,Gorman; Michael R.,26,0,60,34
1683739299988,PSYC 114,B01,189033,Winkielman; Piotr,0,31,30,30
1683739301016,PSYC 131,A00,189036,Anagnostaras; Stephan,0,44,60,60
1683739302042,PSYC 136,A00,189041,Lowe; Angela Beth,0,7,25,25
1683739303066,PSYC 137,A00,189057,Winkielman; Piotr,0,36,25,25
1683739304093,PSYC 144,A00,189107,Wixted; John T,0,11,50,50
1683739306148,PSYC 162,A00,189142,Staff,0,9,85,85
1683739307171,PSYC 172,A00,189144,Gorman; Michael R.,0,6,30,30
1683739309221,PSYC 179,A00,189146,Lacefield; Katharine I,0,88,120,120
1683739310247,PSYC 181,A00,189147,Anagnostaras; Stephan,110,45,200,90
1683739311275,PSYC 190R,A00,189148,Barner; David A.,0,23,80,80
1683739312302,PSYC 191,A00,189275,Rickard; Timothy C.,0,11,25,25
1683739313329,PSYC 193,A00,189276,Chapman; Eddie Nathaniel,0,1,0,4
1683739314355,PSYC 193L,A01,189281,Lowe; Angela Beth,8,0,20,12
1683739314355,PSYC 193L,B01,189285,Staff,28,0,35,7
1683739315381,RELI 149,A00,187137,Rahimi; Babak,6,0,40,34
1683739316449,SE 9,A01,187315,Staff,0,2,18,18
1683739317478,SE 101B,A00,187409,Staff,24,0,30,6
1683739318508,SE 110B,A00,187444,Staff,10,0,40,30
1683739319533,SE 130B,A00,187449,Staff,31,0,40,9
1683739320558,SE 150A,A00,187516,Staff,8,0,20,12
1683739321584,SE 154,A00,187528,Staff,29,0,50,21
1683739322610,SIO 3,A01,258171,Staff,35,0,40,5
1683739323642,SIO 10,A00,187144,Cook; Geoffrey W,0,6,75,75
1683739324666,SIO 45,A00,187152,Cook; Geoffrey W,1,7,100,99
1683739325690,SIO 109R,A00,194486,Staff,0,4,20,20
1683739327780,SIO 187,A01,187233,Kacev; David,12,0,40,28
1683739328805,SOCI 1,A01,258656,Thorpe; Charles Robert,28,0,30,2
1683739328805,SOCI 1,A02,258658,Thorpe; Charles Robert,30,0,30,0
1683739328805,SOCI 1,A03,258661,Thorpe; Charles Robert,25,0,25,0
1683739328805,SOCI 1,A04,258666,Thorpe; Charles Robert,22,0,25,3
1683739328805,SOCI 1,A05,258897,Thorpe; Charles Robert,22,0,25,3
1683739328805,SOCI 1,A06,258898,Thorpe; Charles Robert,25,0,25,0
1683739329834,SOCI 30,A01,258903,Pardo Guerra; Juan Pablo,14,0,30,16
1683739330863,SOCI 102,A00,258904,Staff,9,0,25,16
1683739331888,SOCI 106,A00,258905,Staff,19,0,25,6
1683739332915,SOCI 111,A00,258907,Ribas Norris; Janet Vanesa,26,0,30,4
1683739333940,SOCI 121R,A00,258908,Pardo Guerra; Juan Pablo,7,0,30,23
1683739334963,SOCI 126,A01,203330,Staff,14,0,20,6
1683739335987,SOCI 131,A00,258909,Thorpe; Charles Robert,30,0,60,30
1683739337012,SOCI 135,A00,258910,Payne; Christine Anna,0,13,30,30
1683739338039,SOCI 157,A00,258911,Staff,10,0,30,20
1683739339062,SOCI 184,A00,258912,Staff,25,0,30,5
1683739340086,SOCI 188D,A00,258913,Staff,22,0,30,8
1683739341115,SYN 2,001,187529,Staff,9,0,16,7
1683739341115,SYN 2,002,201452,Staff,0,20,16,16
1683739341115,SYN 2,003,201469,Staff,1,0,16,15
1683739342138,SYN 100,A01,187531,Staff,0,9,20,20
1683739342138,SYN 100,B01,201491,Staff,0,10,20,20
1683739343163,TDAC 1,A00,189286,Walsh; Kim C.,3,0,20,17
1683739343163,TDAC 1,B00,189287,Harting; Carla Kelso,10,0,20,10
1683739344188,TDAC 101,A00,189300,Walsh; Kim C.,16,0,20,4
1683739344188,TDAC 101,B00,189301,Harting; Carla Kelso,18,0,20,2
1683739345215,TDAC 102,A00,189304,Basso; Beatrice,14,0,20,6
1683739346239,TDAC 108,A00,189305,Staff,18,0,20,2
1683739347263,TDDE 131,A00,189310,Staff,19,0,20,1
1683739347263,TDDE 131,B00,189314,Staff,19,0,20,1
1683739347263,TDDE 131,C00,189315,Staff,48,0,50,2
1683739347263,TDDE 131,D00,189316,Staff,14,0,15,1
1683739347263,TDDE 131,E00,204841,Staff,20,0,20,0
1683739348286,TDGE 10,A00,189289,Staff,26,0,50,24
1683739348286,TDGE 10,B00,189290,Havis; Allan,0,1,50,50
1683739349311,TDGE 11,A00,189291,Fulton; Julia,0,4,50,50
1683739349311,TDGE 11,B00,189292,Staff,20,0,25,5
1683739349311,TDGE 11,C00,260270,Staff,0,0,0,0
1683739350335,TDGE 25,A00,189294,Staff,1,0,20,19
1683739351361,TDGE 124,A00,189318,Fulton; Julia,0,7,50,50
1683739352384,TDGE 125,A00,189319,Staff,13,0,25,12
1683739352384,TDGE 125,B00,189320,Staff,23,0,25,2
1683739353408,TDGE 127,A00,189322,Havis; Allan,1,0,50,49
1683739354430,TDHT 101,A00,189323,Staff,18,0,25,7
1683739354430,TDHT 101,B00,189324,Staff,25,0,25,0
1683739355458,TDHT 102,A00,189325,Staff,49,0,50,1
1683739356483,TDMV 1,A00,189295,Arcidiacono; Kristin,20,0,30,10
1683739356483,TDMV 1,B00,189296,Caligagan; Maria T.,23,0,30,7
1683739357508,TDMV 2,A00,189297,Sammartano; Tonnie,27,0,30,3
1683739357508,TDMV 2,B00,189299,Arcidiacono; Kristin,23,0,30,7
1683739358535,TDMV 3,A00,204998,Rincon; Alicia,22,0,30,8
1683739359558,TDMV 120,A00,189458,Sammartano; Tonnie,28,0,30,2
1683739360585,TDMV 138,A00,189541,Jun; Grace Shin Hae,20,0,40,20
1683739361609,TDMV 142,A00,189717,Caligagan; Tony,25,0,30,5
1683739361609,TDMV 142,B00,189718,Caligagan; Maria T.,25,0,30,5
1683739362638,TMC 2,A01,187533,Staff,25,0,25,0
1683739362638,TMC 2,A02,187534,Staff,25,0,25,0
1683739363664,USP 1,A01,187536,Kwak; Nancy,0,16,25,25
1683739364688,USP 5,A01,187538,Staff,8,0,25,17
1683739365715,USP 101,A00,199253,Staff,0,4,0,0
1683739366751,USP 124,A00,187562,Boomhower; Matthew Charles,0,0,30,30
1683739367774,USP 138,A00,187582,Staff,19,0,25,6
1683739368802,USP 152,A01,187597,Staff,3,0,25,22
1683739369829,USP 153,A00,187598,Staff,18,0,25,7
1683739370854,USP 168,A00,187607,Kwak; Nancy,2,0,5,3
1683739371939,USP 173,A00,187619,Staff,4,0,25,21
1683739372965,USP 181,A00,187638,Staff,0,4,25,25
1683739373989,VIS 103,A00,187650,Cruz; Edwin Teddy,17,0,75,58
1683739375016,VIS 110D,A00,187669,Staff,13,0,22,9
1683739376041,VIS 127C,A00,187720,Shen; Kuiyi,67,0,146,79
1683739377066,VIS 149,A00,187731,Yoldas; Pinar,0,12,22,22
1683739378088,VIS 151,A01,188091,Staff,22,0,34,12
1683739378088,VIS 151,A02,188092,Staff,11,0,34,23
1683739379111,VIS 160B,A00,188093,Stalbaum; Brett,0,1,10,10
1683739381166,WCWP 10B,A00,201720,Staff,0,0,5,5
1683739381166,WCWP 10B,B00,201722,Staff,0,0,6,6
1683739382195,WCWP 100,A00,201725,Gagnon; Jeffrey C,0,0,2,2
1683739382195,WCWP 100,B00,201727,Staff,0,4,15,15
1683739385324,ANBI 133,A00,258401,Wilder; Linnea Lorene,34,0,40,6
1683739386353,ANBI 140,A00,258395,Hrvoj Mihic; Branka,18,0,25,7
1683739387377,ANSC 120,A00,258402,Bialecki; Jon Anthony,26,0,40,14
1683739388400,ANSC 144,A00,258400,Staff,12,0,40,28
1683739390452,ANSC 166,A00,258396,Parish; Steven Martin,156,0,175,19
1683739391476,ANSC 180,A00,193533,Staff,8,0,20,12
1683739392503,ANSC 188,A00,258397,Jassal; Aftab,34,0,40,6
1683739393531,ANTH 3,A01,258316,Staff,23,0,30,7
1683739394558,ANTH 5,A00,258394,Semendeferi; Ekaterini,16,0,20,4
1683739395586,ANTH 21,A01,258331,Staff,4,0,40,36
1683739396612,ANTH 103,A00,258398,Varma; Saiba,15,0,25,10
1683739397644,AWP 10,001,202034,Staff,0,0,0,0
1683739397644,AWP 10,002,202035,Staff,0,0,0,0
1683739397644,AWP 10,003,202036,Staff,0,0,0,0
1683739397644,AWP 10,004,202037,Staff,0,0,0,0
1683739397644,AWP 10,005,202038,Staff,0,0,0,0
1683739397644,AWP 10,006,202039,Staff,0,0,0,0
1683739397644,AWP 10,007,202040,Staff,0,0,0,0
1683739397644,AWP 10,008,202041,Staff,0,0,0,0
1683739397644,AWP 10,009,202042,Staff,0,0,0,0
1683739397644,AWP 10,010,202043,Staff,0,0,0,0
1683739397644,AWP 10,011,202044,Staff,0,0,0,0
1683739397644,AWP 10,012,202045,Staff,0,0,0,0
1683739397644,AWP 10,013,202046,Staff,0,0,0,0
1683739397644,AWP 10,014,202047,Staff,0,0,0,0
1683739397644,AWP 10,015,202048,Staff,0,0,0,0
1683739397644,AWP 10,016,202049,Staff,0,0,0,0
1683739397644,AWP 10,017,202050,Staff,0,0,0,0
1683739397644,AWP 10,018,202051,Staff,0,0,0,0
1683739397644,AWP 10,019,202052,Staff,0,0,0,0
1683739397644,AWP 10,020,202053,Staff,0,0,0,0
1683739397644,AWP 10,021,202054,Staff,0,0,0,0
1683739397644,AWP 10,022,202055,Staff,0,0,0,0
1683739397644,AWP 10,023,202056,Staff,0,0,0,0
1683739397644,AWP 10,024,202057,Staff,0,0,0,0
1683739397644,AWP 10,025,202058,Staff,0,0,0,0
1683739397644,AWP 10,026,202059,Staff,0,0,0,0
1683739398669,AWP 102,001,202032,Staff,0,0,0,0
1683739398669,AWP 102,002,202033,Staff,0,0,0,0
1683739399694,BENG 100,A01,254234,Taylor Amos; Alyssa C,31,0,40,9
1683739400720,BENG 196,001,270013,Engler; Adam J.,9999,0,9999,0
1683739401746,BICD 100R,A01,202018,Smith; Laurie,0,7,32,32
1683739401746,BICD 100R,A02,202019,Smith; Laurie,0,3,32,32
1683739401746,BICD 100R,A03,202020,Smith; Laurie,0,1,32,32
1683739401746,BICD 100R,A04,202021,Smith; Laurie,6,0,32,26
1683739401746,BICD 100R,A05,202022,Smith; Laurie,10,0,32,22
1683739402771,BICD 136,A01,193242,Gustafson-Brown; Cindy,0,2,32,32
1683739402771,BICD 136,A02,193244,Gustafson-Brown; Cindy,13,0,32,19
1683739403796,BIEB 102,A01,193249,Butler; Shannon Rhey,0,0,32,32
1683739403796,BIEB 102,A02,193251,Butler; Shannon Rhey,0,0,32,32
1683739403796,BIEB 102,A03,193253,Butler; Shannon Rhey,0,0,32,32
1683739403796,BIEB 102,A04,193255,Butler; Shannon Rhey,13,0,32,19
1683739403796,BIEB 102,A05,193265,Butler; Shannon Rhey,25,0,32,7
1683739403796,BIEB 102,A06,193269,Butler; Shannon Rhey,12,0,32,20
1683739405856,BIEB 150,A01,193274,Staff,0,0,32,32
1683739405856,BIEB 150,A02,193285,Staff,24,0,32,8
1683739406881,BIEB 194,A00,193286,Kurle; Carolyn M.,19,0,32,13
1683739407910,BILD 1,A01,192291,Staff,15,0,32,17
1683739407910,BILD 1,A02,192292,Staff,30,0,32,2
1683739407910,BILD 1,B01,192520,Reuther; Keefe,0,1,0,0
1683739407910,BILD 1,B02,192532,Reuther; Keefe,0,1,0,0
1683739408938,BILD 3,A01,192556,Butler; Shannon Rhey,0,0,32,32
1683739408938,BILD 3,A02,192581,Butler; Shannon Rhey,0,1,32,32
1683739408938,BILD 3,A03,192611,Butler; Shannon Rhey,19,0,32,13
1683739408938,BILD 3,A04,192612,Butler; Shannon Rhey,23,0,32,9
1683739408938,BILD 3,A05,192613,Butler; Shannon Rhey,26,0,32,6
1683739408938,BILD 3,A06,192679,Butler; Shannon Rhey,27,0,32,5
1683739408938,BILD 3,A07,192682,Butler; Shannon Rhey,20,0,32,12
1683739409966,BILD 4,A01,192836,Reuther; Keefe,1,0,24,23
1683739409966,BILD 4,A02,193044,Reuther; Keefe,4,0,24,20
1683739410991,BILD 10,A01,193142,Gustafson-Brown; Cindy,29,0,32,3
1683739410991,BILD 10,A02,193149,Gustafson-Brown; Cindy,31,0,32,1
1683739412016,BIMM 100,A01,193301,Staff,0,6,32,32
1683739412016,BIMM 100,A02,193312,Staff,0,7,32,32
1683739412016,BIMM 100,A03,193323,Staff,0,10,32,32
1683739413041,BIMM 101,A01,193329,McDonnell; Lisa Marie,0,3,24,24
1683739413041,BIMM 101,A02,193339,McDonnell; Lisa Marie,0,3,24,24
1683739413041,BIMM 101,B01,193354,McDonnell; Lisa Marie,0,4,24,24
1683739413041,BIMM 101,B02,193357,McDonnell; Lisa Marie,0,3,24,24
1683739414072,BIMM 110,A01,193377,Tat; John,0,11,32,32
1683739414072,BIMM 110,A02,193378,Tat; John,0,11,32,32
1683739415099,BIMM 120,A01,206116,Staff,1,0,32,31
1683739415099,BIMM 120,A02,206117,Staff,7,0,32,25
1683739415099,BIMM 120,A03,206121,Staff,21,0,32,11
1683739416124,BIPN 100,A01,193393,Park; Ji Young,0,15,32,32
1683739416124,BIPN 100,A02,193402,Park; Ji Young,0,14,32,32
1683739416124,BIPN 100,A03,193413,Park; Ji Young,0,14,32,32
1683739416124,BIPN 100,A04,193414,Park; Ji Young,0,14,32,32
1683739417148,BIPN 102,A01,193429,Staff,0,0,32,32
1683739417148,BIPN 102,A02,193438,Staff,18,0,32,14
1683739418172,BIPN 106,A01,193450,Reyes Gonzalez; Catalina,0,2,40,40
1683739419200,BIPN 134,A01,193465,Cooke; James Edward,0,0,32,32
1683739419200,BIPN 134,A02,193474,Cooke; James Edward,24,0,32,8
1683739419200,BIPN 134,A03,193485,Cooke; James Edward,29,0,32,3
1683739419200,BIPN 134,A04,193486,Cooke; James Edward,20,0,32,12
1683739419200,BIPN 134,A05,193491,Cooke; James Edward,31,0,32,1
1683739419200,BIPN 134,A06,193501,Cooke; James Edward,30,0,32,2
1683739419200,BIPN 134,A07,193510,Cooke; James Edward,29,0,32,3
1683739421257,BISP 194,A00,222522,Staff,14,0,32,18
1683739422283,CAT 124,A01,202407,Staff,19,0,25,6
1683739423308,CAT 125,A00,202408,Marchisotto; Jennifer Anne,2,0,20,18
1683739424337,CAT 125R,A00,202409,Smith; Lauryn Alissa,0,11,20,20
1683739424337,CAT 125R,B00,202410,Morales; Celeste Georgianna,0,11,20,20
1683739424337,CAT 125R,C00,202411,Irwin; Matthew Joseph,0,12,20,20
1683739425362,CENG 15,A01,204712,Yang; Kesong,0,1,0,0
1683739426386,CENG 114,A00,202070,Jahed Motlagh; Zeinab,5,0,20,15
1683739427414,CGS 105,A00,185477,Wesling; Megan E.,24,0,40,16
1683739428444,CGS 106,A00,185494,Staff,11,0,22,11
1683739429468,CGS 108,A00,185495,Staff,14,0,20,6
1683739430492,CGS 114,A00,185496,Staff,13,0,18,5
1683739431516,CGS 119,A00,185501,Staff,15,0,20,5
1683739432540,CGS 120,A00,185511,Staff,11,0,20,9
1683739433565,CHEM 4,A01,184675,Bussey; Thomas J,97,0,100,3
1683739434589,CHEM 6A,A01,184677,Staff,32,0,60,28
1683739435615,CHEM 6B,A01,184679,Staff,63,0,100,37
1683739436643,CHEM 6C,A01,184681,Bussey; Thomas J,0,0,50,50
1683739436643,CHEM 6C,A02,184682,Bussey; Thomas J,32,0,50,18
1683739437668,CHEM 40A,A01,184684,Albizati; Kim F.,33,0,100,67
1683739438692,CHEM 40B,A01,184686,Albizati; Kim F.,0,23,100,100
1683739439722,CHEM 41B,A01,184690,Staff,51,0,100,49
1683739440747,COGS 3,A01,184715,Boyle; Mary E. T.,0,27,40,40
1683739441772,COGS 14B,A01,185172,Staff,0,14,38,38
1683739442797,COGS 18,A01,184736,Staff,14,0,80,66
1683739443822,COGS 100,A01,184932,Staff,0,8,73,73
1683739444848,COGS 101A,A01,184935,Staff,0,40,30,30
1683739445873,COGS 101B,A01,184944,Staff,0,2,30,30
1683739446902,COGS 101C,A01,184946,Staff,0,10,30,30
1683739447930,COGS 102A,A01,184951,Johnson; Christine M.,1,0,40,39
1683739448956,COGS 107B,A01,184953,Mooshagian; Eric Frederick,0,52,40,40
1683739449981,COGS 118B,A01,184959,Gupta; Anjum,0,50,40,40
1683739451016,COGS 153,A00,184961,Staff,1,16,30,29
1683739452043,COGS 177,A00,184962,Staff,0,20,30,30
1683739453070,COGS 187A,A01,184969,Boyle; Mary E. T.,0,19,40,40
1683739454095,COMM 10,A01,185174,Staff,0,5,25,25
1683739454095,COMM 10,A02,185189,Staff,0,2,25,25
1683739454095,COMM 10,A03,269821,Staff,0,1,0,0
1683739455122,COMM 100B,A02,185476,Staff,10,0,25,15
1683739455122,COMM 100B,A03,277340,Staff,25,0,25,0
1683739456147,COMM 100C,A01,185314,Staff,2,0,25,23
1683739456147,COMM 100C,A02,185327,Staff,17,0,25,8
1683739457175,COMM 110M,A00,185349,Staff,0,0,40,40
1683739458199,COMM 113T,A00,185352,Staff,25,0,40,15
1683739459226,COMM 114I,A00,185353,Staff,31,0,40,9
1683739460249,COMM 131,A00,185354,Staff,17,0,30,13
1683739461278,CSE 8A,A50,185358,Cao; Yingjun,0,46,10,10
1683739462303,CSE 8B,A01,185362,Staff,0,48,50,50
1683739463328,CSE 11,A01,185416,Cao; Yingjun,0,91,10,10
1683739464356,CSE 20,A01,185445,Briones; Jor-el Thomas Caparas,3,0,25,22
1683739465380,CSE 21,A01,185447,Staff,9,0,50,41
1683739466408,CSE 101,A01,185451,Staff,0,13,50,50
1683739466408,CSE 101,B01,185453,Jones; Miles E,0,15,50,50
1683739468458,CSE 141,A01,185458,Eldon; John,16,0,100,84
1683739469482,CSE 141L,A01,185461,Eldon; John,8,0,100,92
1683739470511,CSE 142,A01,185463,Staff,34,0,60,26
1683739470511,CSE 142,B01,201355,Staff,0,7,60,60
1683739471537,CSE 142L,A01,185470,Staff,34,0,60,26
1683739471537,CSE 142L,B01,201417,Staff,0,6,60,60
1683739472564,CSE 190,A00,201433,Staff,32,0,49,17
1683739473589,DOC 1,A01,259136,Strom; Megan C.,7,0,15,8
1683739473589,DOC 1,A02,259137,Strom; Megan C.,15,0,15,0
1683739473589,DOC 1,A03,259138,Strom; Megan C.,14,0,15,1
1683739473589,DOC 1,A04,259139,Strom; Megan C.,13,0,15,2
1683739474614,DOC 100D,A00,259140,Pass; Natalye Joann,14,0,25,11
1683739475713,DSGN 1,A01,184749,Rill; Bryan,0,26,30,30
1683739476739,DSGN 100,A01,185168,Staff,0,2,25,25
1683739477764,ECE 5,A01,185626,Morris; Karcher William,0,12,0,0
1683739478789,ECE 101,A01,185628,Staff,14,0,70,56
1683739479814,ECE 107,A01,185635,Baghdadchi; Saharnaz,0,0,20,20
1683739479814,ECE 107,A02,185638,Baghdadchi; Saharnaz,1,0,20,19
1683739480839,ECE 148,A01,185647,Silberman; Jack,0,0,16,16
1683739481866,ECON 1,A01,185537,Crane; Meredith Helen,54,0,70,16
1683739482889,ECON 3,A01,185549,Crane; Meredith Helen,30,0,70,40
1683739483937,ECON 4,A01,203354,Anderson; John Charles,0,5,10,10
1683739484963,ECON 100A,A01,185574,Staff,0,5,40,40
1683739485992,ECON 100B,A01,185576,Staff,0,12,50,50
1683739487020,ECON 100C,A01,185589,Newhouse; Herbert S,30,0,70,40
1683739488046,ECON 105,A00,185608,Vespa; Emanuel Ignacio,19,0,35,16
1683739489069,ECON 109,A01,185610,Shishkin; Denis,9,0,35,26
1683739490095,ECON 110A,A01,185612,Staff,8,0,40,32
1683739491120,ECON 120A,A01,185615,Staff,19,0,40,21
1683739492143,ECON 120C,A01,185617,Sun; Yixiao,0,21,70,70
1683739493172,ECON 144,A00,203346,Squires; Dale E,2,0,35,33
1683739494195,ECON 171,A01,203349,Newhouse; Herbert S,0,1,35,35
1683739495219,ECON 173A,A01,185621,Toda; Alexis Akira,21,0,35,14
1683739496258,EDS 25,A01,202413,Staff,0,1,0,0
1683739496258,EDS 25,A02,202414,Staff,0,1,0,0
1683739496258,EDS 25,A03,202415,Staff,0,0,0,0
1683739496258,EDS 25,A04,202416,Staff,0,1,0,0
1683739496258,EDS 25,A05,202439,Staff,0,0,0,0
1683739496258,EDS 25,A06,202440,Staff,0,0,0,0
1683739496258,EDS 25,B01,202631,Staff,0,0,0,0
1683739496258,EDS 25,B02,202632,Staff,0,0,0,0
1683739496258,EDS 25,B03,202639,Staff,0,0,0,0
1683739496258,EDS 25,B04,202640,Staff,0,0,0,0
1683739496258,EDS 25,B05,202643,Staff,0,0,0,0
1683739496258,EDS 25,B06,202644,Staff,0,0,0,0
1683739497284,EDS 38,A01,202659,Black; Alison Michelle,25,0,25,0
1683739498309,EDS 115,A00,202652,Staff,18,0,30,12
1683739499334,EDS 125,A00,202649,Staff,13,0,30,17
1683739500358,EDS 126,A01,203332,Staff,30,0,30,0
1683739501381,EDS 139,A00,202838,Staff,16,0,25,9
1683739502403,EDS 146,A01,202655,Staff,14,0,25,11
1683739503432,ENG 15,A00,185667,Staff,0,1,0,2
1683739503432,ENG 15,B00,185672,Staff,0,0,0,1
1683739503432,ENG 15,C00,185675,Staff,0,0,0,0
1683739503432,ENG 15,D00,185682,Staff,0,0,0,0
1683739503432,ENG 15,E00,185684,Staff,0,0,0,0
1683739504459,ETHN 103,A00,185710,Staff,0,8,35,35
1683739505484,ETHN 103A,A00,199228,Man; Simeon S,0,0,9,9
1683739506510,ETHN 109,A00,185711,Staff,15,0,35,20
1683739507534,ETHN 142,A00,185726,Staff,0,4,30,30
1683739508563,ETHN 163J,A00,199229,Man; Simeon S,5,0,8,3
1683739509589,ETHN 168,A00,185727,Staff,7,0,10,3
1683739510617,ETHN 182,A00,185728,Staff,0,0,35,35
1683739511642,ETHN 183,A00,185737,Staff,10,0,18,8
1683739512665,GLBH 111,A01,209361,Burgos; Jose L.,0,0,0,0
1683739514717,HIEU 104,A00,185792,Staff,14,0,20,6
1683739515745,HIEU 115,A00,185800,Staff,0,0,20,20
1683739516770,HIEU 128,A00,185801,Staff,0,9,20,20
1683739517795,HIEU 147,A00,185802,Staff,15,0,20,5
1683739518818,HIEU 154,A00,185823,Staff,11,0,20,9
1683739519845,HILA 102,A00,185826,Staff,14,0,20,6
1683739520870,HILD 2C,A01,185778,Staff,0,13,20,20
1683739521895,HILD 7B,A01,185780,Kwak; Nancy,0,17,32,32
1683739521895,HILD 7B,A02,185781,Kwak; Nancy,0,18,32,32
1683739522922,HILD 30,A01,185791,Staff,12,0,20,8
1683739523946,HISC 119,A00,185830,Golan; Tal,0,10,20,20
1683739524972,HITO 156GS,A00,185831,Patterson; Patrick H.,0,0,0,23
1683739525999,HIUS 103,A00,185832,Man; Simeon S,0,4,20,20
1683739527026,HIUS 117,A00,185836,Kwak; Nancy,2,0,20,18
1683739528053,HIUS 125,A00,185840,Man; Simeon S,0,2,23,23
1683739529079,HIUS 149,A00,185845,Staff,1,0,20,19
1683739530102,HUM 3,A01,185882,Zavodny; Tatiana Sophia,0,8,50,50
1683739530102,HUM 3,B01,185899,Caldwell; Michael Alan,0,18,50,50
1683739531125,HUM 3GS,A00,185900,Patterson; Patrick H.,0,0,0,23
1683739532155,HUM 4,A01,185938,Zroka; Amy Liane,28,0,50,22
1683739532155,HUM 4,B01,185956,Watkins; Eric,0,6,50,50
1683739532155,HUM 4,B02,202209,Watkins; Eric,0,6,50,50
1683739532155,HUM 4,B03,202210,Watkins; Eric,0,5,50,50
1683739533180,HUM 5,A01,185958,West; Geoffrey Scott,0,1,50,50
1683739533180,HUM 5,A02,202215,West; Geoffrey Scott,0,1,50,50
1683739534206,INTL 190,A00,185959,Gagnon; Jeffrey C,0,0,0,9
1683739534206,INTL 190,B00,185960,Lettieri; Michael Joseph,0,0,0,2
1683739535231,JAPN 180,A00,254509,Staff,4,0,30,26
1683739536256,LATI 10,A01,202853,Kennemore; Amy Michelle,0,0,31,31
1683739536256,LATI 10,A02,202854,Kennemore; Amy Michelle,0,0,32,32
1683739536256,LATI 10,A03,270054,Kennemore; Amy Michelle,30,0,30,0
1683739537278,LATI 180,A00,202855,Kennemore; Amy Michelle,11,0,20,9
1683739538302,LAWS 101,A00,201767,Golan; Tal,0,8,40,40
1683739539326,LIFR 1C,A00,185961,Staff,6,0,20,14
1683739540348,LIFR 1CX,A00,185962,Staff,7,0,20,13
1683739541377,LIFR 1D,A00,185963,Staff,7,0,20,13
1683739542404,LIFR 1DX,A00,185964,Staff,7,0,20,13
1683739543430,LIGN 101,A01,186039,Staff,43,0,50,7
1683739544456,LIGN 165,A00,186040,Staff,14,0,50,36
1683739545481,LTCS 108,A00,186041,Staff,5,0,10,5
1683739546506,LTCS 119,A00,186042,Staff,15,0,20,5
1683739547534,LTCS 130,A00,186043,Wesling; Megan E.,15,0,25,10
1683739549586,LTEA 138,A00,186119,Staff,13,0,40,27
1683739550612,LTEN 124,A00,186148,Staff,5,0,25,20
1683739551638,LTEN 178,A00,186149,Staff,6,0,15,9
1683739552662,LTEN 181,A00,186150,Blanco; John D,34,0,40,6
1683739553688,LTWL 120,A00,186160,Staff,19,0,25,6
1683739554715,LTWL 165,A00,186161,Staff,22,0,25,3
1683739555742,LTWR 100,A00,186162,Staff,0,5,15,15
1683739556769,LTWR 102,A00,186163,Doller; Ben,5,0,15,10
1683739557794,MAE 8,A01,186412,Staff,0,1,0,1
1683739558821,MAE 30B,A00,186445,Bahadori; Mohammad Yousef,81,0,100,19
1683739559846,MAE 40,A00,186592,Bewley; Thomas R,10,0,50,40
1683739560873,MAE 101B,A00,186593,Bahadori; Mohammad Yousef,79,0,100,21
1683739561899,MAE 105,A00,186594,Bandaru; Prabhakar,10,0,50,40
1683739562923,MAE 107,A00,186599,Pham; Hieu Tan,0,8,120,120
1683739563951,MAE 148,A01,186660,Silberman; Jack,3,0,16,13
1683739564978,MATH 10A,A01,188095,Staff,0,6,35,35
1683739566004,MATH 10B,A01,188097,Bowers; Adam R.,0,12,30,30
1683739566004,MATH 10B,A02,188099,Bowers; Adam R.,0,11,30,30
1683739566004,MATH 10B,B01,188104,Bowers; Adam R.,0,10,30,30
1683739566004,MATH 10B,B02,188106,Bowers; Adam R.,0,9,30,30
1683739567034,MATH 10C,A01,188111,Staff,0,20,30,30
1683739567034,MATH 10C,A02,188127,Staff,0,19,30,30
1683739567034,MATH 10C,A03,188131,Staff,0,19,30,30
1683739567034,MATH 10C,B01,188218,Staff,17,0,30,13
1683739567034,MATH 10C,B02,188244,Staff,13,0,30,17
1683739567034,MATH 10C,B03,188277,Staff,14,0,30,16
1683739568060,MATH 18,A01,188344,Bach; Quang Tran,18,0,30,12
1683739568060,MATH 18,A02,188345,Bach; Quang Tran,11,0,30,19
1683739568060,MATH 18,B01,188353,Bach; Quang Tran,11,0,30,19
1683739568060,MATH 18,B02,188354,Bach; Quang Tran,19,0,30,11
1683739569088,MATH 20A,A01,188374,Staff,10,0,35,25
1683739570114,MATH 20B,A01,188382,Ohm; Ko Woon,7,0,30,23
1683739570114,MATH 20B,A02,188383,Ohm; Ko Woon,22,0,30,8
1683739570114,MATH 20B,B01,188385,Ohm; Ko Woon,7,0,30,23
1683739570114,MATH 20B,B02,188392,Ohm; Ko Woon,22,0,30,8
1683739571139,MATH 20C,A01,188394,Harel; Guershon,10,0,30,20
1683739571139,MATH 20C,A02,188395,Harel; Guershon,13,0,30,17
1683739571139,MATH 20C,B01,188404,Harel; Guershon,5,0,30,25
1683739571139,MATH 20C,B02,188405,Harel; Guershon,18,0,30,12
1683739572170,MATH 20D,A01,188414,Hammock; Frances H,0,1,30,30
1683739572170,MATH 20D,A02,188415,Hammock; Frances H,0,1,30,30
1683739572170,MATH 20D,B01,188447,Hammock; Frances H,0,1,30,30
1683739572170,MATH 20D,B02,188486,Hammock; Frances H,2,0,30,28
1683739573196,MATH 20E,A01,188649,Staff,21,0,30,9
1683739573196,MATH 20E,A02,188650,Staff,20,0,30,10
1683739573196,MATH 20E,A03,188673,Staff,0,0,30,30
1683739574223,MATH 102,A01,188675,Staff,0,40,35,35
1683739575250,MATH 103B,A01,188681,Staff,2,0,35,33
1683739575250,MATH 103B,B01,188692,Staff,5,0,35,30
1683739576274,MATH 109,A01,188695,Salehi Golsefidy; Alireza,24,0,35,11
1683739576274,MATH 109,A02,188696,Salehi Golsefidy; Alireza,24,0,35,11
1683739577304,MATH 120A,A01,188698,Eggers; John Dietrich,7,0,35,28
1683739578333,MATH 142B,A01,188736,Ioana; Adrian,0,0,30,30
1683739578333,MATH 142B,A02,188741,Ioana; Adrian,0,1,30,30
1683739578333,MATH 142B,A03,188743,Ioana; Adrian,0,3,30,30
1683739579416,MATH 168A,A01,188790,Staff,0,11,35,35
1683739580443,MATH 170A,A01,188803,Nie; Jiawang,0,2,35,35
1683739580443,MATH 170A,A02,188811,Nie; Jiawang,0,1,35,35
1683739580443,MATH 170A,A03,188814,Nie; Jiawang,1,0,35,34
1683739580443,MATH 170A,A04,188815,Nie; Jiawang,4,0,35,31
1683739581468,MATH 193B,A01,188817,Staff,0,0,35,35
1683739581468,MATH 193B,A02,188818,Staff,6,0,35,29
1683739582491,MGT 4,A01,202857,Anderson; John Charles,59,0,80,21
1683739583518,MGT 12,A00,202858,Lindenberger; Wade Douglas,39,0,90,51
1683739584542,MGT 18,A00,202859,Staff,73,0,90,17
1683739585568,MGT 18GS,A00,202860,McKay; Michael J,13,0,28,15
1683739586591,MGT 45,A00,202861,Pecore; Joseph P.,8,0,90,82
1683739587616,MGT 100,A00,202863,Yavorsky; Daniel Ryan,27,0,90,63
1683739588643,MGT 103,A00,202864,Ehrich; Kristine R,0,19,90,90
1683739589671,MGT 112,A00,202865,Ehrich; Kristine R,15,0,90,75
1683739590698,MGT 121A,A00,202868,Staff,70,0,90,20
1683739591721,MGT 131B,A00,202869,Anderson; John Charles,58,0,90,32
1683739592747,MGT 136,A00,202871,Lindenberger; Wade Douglas,83,0,90,7
1683739593774,MGT 164,A00,202873,Staff,0,67,90,91
1683739594801,MGT 164GS,A00,202874,McKay; Mary A,13,0,28,15
1683739595827,MGT 180,A00,202875,Staff,0,51,90,91
1683739596855,MMW 11R,A01,205019,Herbst; Matthew,0,0,30,30
1683739596855,MMW 11R,A02,205026,Herbst; Matthew,29,0,30,1
1683739597885,MMW 15,A01,193512,Chang; Edmond Yi-Teh,0,8,28,28
1683739597885,MMW 15,A02,193513,Chang; Edmond Yi-Teh,0,5,28,28
1683739597885,MMW 15,A03,193514,Chang; Edmond Yi-Teh,0,5,28,28
1683739597885,MMW 15,A04,193515,Chang; Edmond Yi-Teh,0,5,28,28
1683739597885,MMW 15,A05,193516,Chang; Edmond Yi-Teh,0,5,28,28
1683739597885,MMW 15,A06,193517,Chang; Edmond Yi-Teh,0,6,28,28
1683739597885,MMW 15,B01,193519,Chang; Edmond Yi-Teh,0,5,28,28
1683739597885,MMW 15,B02,193520,Chang; Edmond Yi-Teh,0,5,28,28
1683739597885,MMW 15,B03,193521,Chang; Edmond Yi-Teh,0,5,28,28
1683739597885,MMW 15,B04,193522,Chang; Edmond Yi-Teh,0,6,28,28
1683739597885,MMW 15,B05,193523,Chang; Edmond Yi-Teh,0,5,28,28
1683739597885,MMW 15,B06,193524,Chang; Edmond Yi-Teh,0,5,28,28
1683739598910,MMW 122,A01,193526,Rahimi; Babak,0,16,28,28
1683739598910,MMW 122,A02,193527,Rahimi; Babak,0,15,28,28
1683739598910,MMW 122,A03,193528,Rahimi; Babak,0,0,0,0
1683739598910,MMW 122,A04,193529,Rahimi; Babak,0,0,0,0
1683739599934,MUS 1A,A01,186663,Staff,0,18,35,35
1683739600958,MUS 4,A01,186715,Staff,0,12,35,35
1683739601982,MUS 5R,A01,186796,Dubnov; Shlomo,0,17,35,35
1683739603009,MUS 6,A01,186798,Staff,0,4,25,25
1683739604033,MUS 7,A01,186830,Staff,11,0,35,24
1683739605058,MUS 8,A01,186930,Staff,0,27,35,35
1683739606087,MUS 15,A01,186932,Staff,0,15,35,35
1683739606087,MUS 15,B01,186934,Staff,0,16,35,35
1683739607116,MUS 80,A00,186935,Staff,0,0,20,20
1683739607116,MUS 80,B00,186936,Staff,24,0,25,1
1683739608144,NANO 11,A00,204702,Lipomi; Darren John,0,0,0,0
1683739609168,NANO 15,A01,204709,Yang; Kesong,0,1,0,0
1683739610192,NANO 114,A00,202069,Jahed Motlagh; Zeinab,2,0,10,8
1683739611220,PHIL 1,A00,186955,Grush; Rick Scott,31,0,40,9
1683739612243,PHIL 10,A01,186973,Grush; Rick Scott,27,0,35,8
1683739612243,PHIL 10,A02,186974,Grush; Rick Scott,33,0,35,2
1683739613274,PHIL 13,A01,186976,Staff,1,0,35,34
1683739613274,PHIL 13,A02,186977,Staff,16,0,35,19
1683739614313,PHIL 14,A01,186979,Staff,30,0,35,5
1683739614313,PHIL 14,A02,186986,Staff,32,0,35,3
1683739615345,PHIL 28,A01,186988,Staff,16,0,30,14
1683739615345,PHIL 28,A02,186989,Staff,0,0,30,30
1683739615345,PHIL 28,A03,186990,Staff,10,0,30,20
1683739615345,PHIL 28,A04,186991,Staff,26,0,30,4
1683739616378,PHIL 120,A00,186997,Staff,23,0,40,17
1683739617406,PHIL 137,A00,187003,Staff,8,0,40,32
1683739618430,PHIL 150,A00,187015,Staff,47,0,70,23
1683739619454,PHIL 167,A00,187021,Lamey; Andy M.,34,0,40,6
1683739620482,PHIL 174,A01,202226,Staff,17,0,20,3
1683739620482,PHIL 174,A02,202235,Staff,20,0,20,0
1683739621509,PHIL 191A,A00,258918,Staff,0,0,1,1
1683739622541,PHYS 1A,A00,187028,Staff,26,0,60,34
1683739623566,PHYS 1AL,001,187036,Staff,3,0,30,27
1683739623566,PHYS 1AL,002,187049,Staff,18,0,30,12
1683739624592,PHYS 1B,A00,187058,Staff,21,0,60,39
1683739625620,PHYS 1BL,001,187064,Staff,0,1,30,30
1683739625620,PHYS 1BL,002,187070,Staff,4,0,30,26
1683739626643,PHYS 1C,A00,187082,Staff,30,0,120,90
1683739627670,PHYS 1CL,001,187088,Staff,0,9,30,30
1683739627670,PHYS 1CL,002,187089,Staff,0,1,30,30
1683739627670,PHYS 1CL,009,262693,Staff,9,0,30,21
1683739628694,PHYS 2B,A01,187097,Staff,55,0,115,60
1683739629723,PHYS 2C,A01,187099,Staff,63,0,115,52
1683739630750,PHYS 2CL,A01,187101,Staff,5,0,28,23
1683739630750,PHYS 2CL,A02,187102,Staff,15,0,28,13
1683739631778,PHYS 2D,A01,187123,Shotwell; Brian,95,0,115,20
1683739632805,PHYS 4B,A01,187133,Grinstein; Benjamin,35,0,50,15
1683739633829,POLI 10,A00,188819,Staff,0,4,50,50
1683739634854,POLI 11,A00,188827,Staff,43,0,50,7
1683739635882,POLI 13R,A00,188828,Staff,0,2,20,20
1683739636911,POLI 27,A01,188830,Elgin; Samuel Zincke,0,2,70,70
1683739637935,POLI 30,A00,188832,Desposato; Scott,30,0,50,20
1683739638957,POLI 102F,A00,188834,Staff,1,0,40,39
1683739639985,POLI 104A,A00,188852,Staff,12,0,30,18
1683739641012,POLI 104I,A00,188853,Staff,0,8,20,20
1683739642035,POLI 110B,A00,188854,Wiens; David,6,0,20,14
1683739643062,POLI 112A,A00,188855,Wiens; David,4,0,30,26
1683739644086,POLI 117R,A00,188856,Forman; Fonna,0,12,20,20
1683739645115,POLI 118,A00,188857,Ingham; Sean,8,0,20,12
1683739646140,POLI 120G,A00,188858,Staff,7,0,30,23
1683739647174,POLI 131CR,A00,188863,Hoston; Germaine,19,0,50,31
1683739648197,POLI 133,A00,188864,Nellis; Gareth Hb,44,0,50,6
1683739649224,POLI 134D,A00,188865,Desposato; Scott,27,0,30,3
1683739650247,POLI 142A,A00,188871,Gartzke; Erik,21,0,50,29
1683739651275,POLI 142K,A00,188874,Staff,38,0,50,12
1683739652302,POLI 143,A00,188940,Gartzke; Erik,15,0,30,15
1683739653328,POLI 153,A00,188943,Staff,1,0,20,19
1683739654351,POLI 160AA,A00,188944,Staff,10,0,40,30
1683739655378,POLI 170A,A00,188945,Staff,10,0,30,20
1683739657427,PSYC 1,A00,188952,Staff,36,0,90,54
1683739658453,PSYC 2,B00,188953,Staff,19,0,35,16
1683739659476,PSYC 6,A00,188970,Staff,47,0,60,13
1683739660504,PSYC 7,A00,188973,Staff,35,0,45,10
1683739661529,PSYC 60,A01,188980,Rickard; Timothy C.,42,0,60,18
1683739662557,PSYC 70,A01,189001,Steiner; Eric Tomas,21,0,45,24
1683739663584,PSYC 100,A00,189005,Lacefield; Katharine I,1,97,120,119
1683739664608,PSYC 102,A00,189008,Staff,6,0,30,24
1683739665636,PSYC 106,B00,189026,Gorman; Michael R.,26,0,60,34
1683739666661,PSYC 114,B01,189033,Winkielman; Piotr,0,31,30,30
1683739667689,PSYC 131,A00,189036,Anagnostaras; Stephan,0,44,60,60
1683739668716,PSYC 136,A00,189041,Lowe; Angela Beth,0,7,25,25
1683739669741,PSYC 137,A00,189057,Winkielman; Piotr,0,36,25,25
1683739670768,PSYC 144,A00,189107,Wixted; John T,0,11,50,50
1683739672821,PSYC 162,A00,189142,Staff,0,9,85,85
1683739673846,PSYC 172,A00,189144,Gorman; Michael R.,0,6,30,30
1683739675896,PSYC 179,A00,189146,Lacefield; Katharine I,0,88,120,120
1683739676931,PSYC 181,A00,189147,Anagnostaras; Stephan,110,45,200,90
1683739677955,PSYC 190R,A00,189148,Barner; David A.,0,23,80,80
1683739678980,PSYC 191,A00,189275,Rickard; Timothy C.,0,11,25,25
1683739680010,PSYC 193,A00,189276,Chapman; Eddie Nathaniel,0,1,0,4
1683739681035,PSYC 193L,A01,189281,Lowe; Angela Beth,8,0,20,12
1683739681035,PSYC 193L,B01,189285,Staff,28,0,35,7
1683739682061,RELI 149,A00,187137,Rahimi; Babak,6,0,40,34
1683739683191,SE 9,A01,187315,Staff,0,2,18,18
1683739684221,SE 101B,A00,187409,Staff,24,0,30,6
1683739685246,SE 110B,A00,187444,Staff,10,0,40,30
1683739686270,SE 130B,A00,187449,Staff,31,0,40,9
1683739687293,SE 150A,A00,187516,Staff,8,0,20,12
1683739688320,SE 154,A00,187528,Staff,29,0,50,21
1683739689348,SIO 3,A01,258171,Staff,35,0,40,5
1683739690380,SIO 10,A00,187144,Cook; Geoffrey W,0,6,75,75
1683739691409,SIO 45,A00,187152,Cook; Geoffrey W,1,7,100,99
1683739692437,SIO 109R,A00,194486,Staff,0,4,20,20
1683739694492,SIO 187,A01,187233,Kacev; David,12,0,40,28
1683739695521,SOCI 1,A01,258656,Thorpe; Charles Robert,28,0,30,2
1683739695521,SOCI 1,A02,258658,Thorpe; Charles Robert,30,0,30,0
1683739695521,SOCI 1,A03,258661,Thorpe; Charles Robert,25,0,25,0
1683739695521,SOCI 1,A04,258666,Thorpe; Charles Robert,22,0,25,3
1683739695521,SOCI 1,A05,258897,Thorpe; Charles Robert,22,0,25,3
1683739695521,SOCI 1,A06,258898,Thorpe; Charles Robert,25,0,25,0
1683739696546,SOCI 30,A01,258903,Pardo Guerra; Juan Pablo,14,0,30,16
1683739697575,SOCI 102,A00,258904,Staff,9,0,25,16
1683739698598,SOCI 106,A00,258905,Staff,19,0,25,6
1683739699630,SOCI 111,A00,258907,Ribas Norris; Janet Vanesa,26,0,30,4
1683739700655,SOCI 121R,A00,258908,Pardo Guerra; Juan Pablo,7,0,30,23
1683739701680,SOCI 126,A01,203330,Staff,14,0,20,6
1683739702722,SOCI 131,A00,258909,Thorpe; Charles Robert,30,0,60,30
1683739703748,SOCI 135,A00,258910,Payne; Christine Anna,0,13,30,30
1683739704774,SOCI 157,A00,258911,Staff,10,0,30,20
1683739705813,SOCI 184,A00,258912,Staff,25,0,30,5
1683739706838,SOCI 188D,A00,258913,Staff,22,0,30,8
1683739707862,SYN 2,001,187529,Staff,9,0,16,7
1683739707862,SYN 2,002,201452,Staff,0,20,16,16
1683739707862,SYN 2,003,201469,Staff,1,0,16,15
1683739708885,SYN 100,A01,187531,Staff,0,9,20,20
1683739708885,SYN 100,B01,201491,Staff,0,10,20,20
1683739709909,TDAC 1,A00,189286,Walsh; Kim C.,3,0,20,17
1683739709909,TDAC 1,B00,189287,Harting; Carla Kelso,10,0,20,10
1683739710937,TDAC 101,A00,189300,Walsh; Kim C.,16,0,20,4
1683739710937,TDAC 101,B00,189301,Harting; Carla Kelso,18,0,20,2
1683739711964,TDAC 102,A00,189304,Basso; Beatrice,14,0,20,6
1683739712988,TDAC 108,A00,189305,Staff,18,0,20,2
1683739714016,TDDE 131,A00,189310,Staff,19,0,20,1
1683739714016,TDDE 131,B00,189314,Staff,19,0,20,1
1683739714016,TDDE 131,C00,189315,Staff,48,0,50,2
1683739714016,TDDE 131,D00,189316,Staff,14,0,15,1
1683739714016,TDDE 131,E00,204841,Staff,20,0,20,0
1683739715040,TDGE 10,A00,189289,Staff,26,0,50,24
1683739715040,TDGE 10,B00,189290,Havis; Allan,0,1,50,50
1683739716064,TDGE 11,A00,189291,Fulton; Julia,0,4,50,50
1683739716064,TDGE 11,B00,189292,Staff,20,0,25,5
1683739716064,TDGE 11,C00,260270,Staff,0,0,0,0
1683739717088,TDGE 25,A00,189294,Staff,1,0,20,19
1683739718118,TDGE 124,A00,189318,Fulton; Julia,0,7,50,50
1683739719141,TDGE 125,A00,189319,Staff,13,0,25,12
1683739719141,TDGE 125,B00,189320,Staff,23,0,25,2
1683739720164,TDGE 127,A00,189322,Havis; Allan,1,0,50,49
1683739721193,TDHT 101,A00,189323,Staff,18,0,25,7
1683739721193,TDHT 101,B00,189324,Staff,25,0,25,0
1683739722219,TDHT 102,A00,189325,Staff,49,0,50,1
1683739723247,TDMV 1,A00,189295,Arcidiacono; Kristin,20,0,30,10
1683739723247,TDMV 1,B00,189296,Caligagan; Maria T.,23,0,30,7
1683739724271,TDMV 2,A00,189297,Sammartano; Tonnie,27,0,30,3
1683739724271,TDMV 2,B00,189299,Arcidiacono; Kristin,23,0,30,7
1683739725299,TDMV 3,A00,204998,Rincon; Alicia,22,0,30,8
1683739726325,TDMV 120,A00,189458,Sammartano; Tonnie,28,0,30,2
1683739727349,TDMV 138,A00,189541,Jun; Grace Shin Hae,20,0,40,20
1683739728373,TDMV 142,A00,189717,Caligagan; Tony,25,0,30,5
1683739728373,TDMV 142,B00,189718,Caligagan; Maria T.,25,0,30,5
1683739729400,TMC 2,A01,187533,Staff,25,0,25,0
1683739729400,TMC 2,A02,187534,Staff,25,0,25,0
1683739730430,USP 1,A01,187536,Kwak; Nancy,0,16,25,25
1683739731454,USP 5,A01,187538,Staff,8,0,25,17
1683739732480,USP 101,A00,199253,Staff,0,4,0,0
1683739733509,USP 124,A00,187562,Boomhower; Matthew Charles,0,0,30,30
1683739734535,USP 138,A00,187582,Staff,19,0,25,6
1683739735558,USP 152,A01,187597,Staff,3,0,25,22
1683739736582,USP 153,A00,187598,Staff,18,0,25,7
1683739737609,USP 168,A00,187607,Kwak; Nancy,2,0,5,3
1683739738631,USP 173,A00,187619,Staff,4,0,25,21
1683739739654,USP 181,A00,187638,Staff,0,4,25,25
1683739740681,VIS 103,A00,187650,Cruz; Edwin Teddy,17,0,75,58
1683739741705,VIS 110D,A00,187669,Staff,13,0,22,9
1683739742729,VIS 127C,A00,187720,Shen; Kuiyi,67,0,146,79
1683739743753,VIS 149,A00,187731,Yoldas; Pinar,0,12,22,22
1683739744777,VIS 151,A01,188091,Staff,22,0,34,12
1683739744777,VIS 151,A02,188092,Staff,11,0,34,23
1683739745802,VIS 160B,A00,188093,Stalbaum; Brett,0,1,10,10
1683739747854,WCWP 10B,A00,201720,Staff,0,0,5,5
1683739747854,WCWP 10B,B00,201722,Staff,0,0,6,6
1683739748881,WCWP 100,A00,201725,Gagnon; Jeffrey C,0,0,2,2
1683739748881,WCWP 100,B00,201727,Staff,0,4,15,15
1683739752013,ANBI 133,A00,258401,Wilder; Linnea Lorene,34,0,40,6
1683739753041,ANBI 140,A00,258395,Hrvoj Mihic; Branka,18,0,25,7
1683739754067,ANSC 120,A00,258402,Bialecki; Jon Anthony,26,0,40,14
1683739755094,ANSC 144,A00,258400,Staff,12,0,40,28
1683739757149,ANSC 166,A00,258396,Parish; Steven Martin,156,0,175,19
1683739758177,ANSC 180,A00,193533,Staff,8,0,20,12
1683739759201,ANSC 188,A00,258397,Jassal; Aftab,34,0,40,6
1683739760231,ANTH 3,A01,258316,Staff,23,0,30,7
1683739761257,ANTH 5,A00,258394,Semendeferi; Ekaterini,16,0,20,4
1683739762281,ANTH 21,A01,258331,Staff,4,0,40,36
1683739763308,ANTH 103,A00,258398,Varma; Saiba,15,0,25,10
1683739764341,AWP 10,001,202034,Staff,0,0,0,0
1683739764341,AWP 10,002,202035,Staff,0,0,0,0
1683739764341,AWP 10,003,202036,Staff,0,0,0,0
1683739764341,AWP 10,004,202037,Staff,0,0,0,0
1683739764341,AWP 10,005,202038,Staff,0,0,0,0
1683739764341,AWP 10,006,202039,Staff,0,0,0,0
1683739764341,AWP 10,007,202040,Staff,0,0,0,0
1683739764341,AWP 10,008,202041,Staff,0,0,0,0
1683739764341,AWP 10,009,202042,Staff,0,0,0,0
1683739764341,AWP 10,010,202043,Staff,0,0,0,0
1683739764341,AWP 10,011,202044,Staff,0,0,0,0
1683739764341,AWP 10,012,202045,Staff,0,0,0,0
1683739764341,AWP 10,013,202046,Staff,0,0,0,0
1683739764341,AWP 10,014,202047,Staff,0,0,0,0
1683739764341,AWP 10,015,202048,Staff,0,0,0,0
1683739764341,AWP 10,016,202049,Staff,0,0,0,0
1683739764341,AWP 10,017,202050,Staff,0,0,0,0
1683739764341,AWP 10,018,202051,Staff,0,0,0,0
1683739764341,AWP 10,019,202052,Staff,0,0,0,0
1683739764341,AWP 10,020,202053,Staff,0,0,0,0
1683739764341,AWP 10,021,202054,Staff,0,0,0,0
1683739764341,AWP 10,022,202055,Staff,0,0,0,0
1683739764341,AWP 10,023,202056,Staff,0,0,0,0
1683739764341,AWP 10,024,202057,Staff,0,0,0,0
1683739764341,AWP 10,025,202058,Staff,0,0,0,0
1683739764341,AWP 10,026,202059,Staff,0,0,0,0
1683739765365,AWP 102,001,202032,Staff,0,0,0,0
1683739765365,AWP 102,002,202033,Staff,0,0,0,0
1683739766387,BENG 100,A01,254234,Taylor Amos; Alyssa C,31,0,40,9
1683739767412,BENG 196,001,270013,Engler; Adam J.,9999,0,9999,0
1683739768440,BICD 100R,A01,202018,Smith; Laurie,0,7,32,32
1683739768440,BICD 100R,A02,202019,Smith; Laurie,0,3,32,32
1683739768440,BICD 100R,A03,202020,Smith; Laurie,0,1,32,32
1683739768440,BICD 100R,A04,202021,Smith; Laurie,6,0,32,26
1683739768440,BICD 100R,A05,202022,Smith; Laurie,10,0,32,22
1683739769468,BICD 136,A01,193242,Gustafson-Brown; Cindy,0,2,32,32
1683739769468,BICD 136,A02,193244,Gustafson-Brown; Cindy,13,0,32,19
1683739770493,BIEB 102,A01,193249,Butler; Shannon Rhey,0,0,32,32
1683739770493,BIEB 102,A02,193251,Butler; Shannon Rhey,0,0,32,32
1683739770493,BIEB 102,A03,193253,Butler; Shannon Rhey,0,0,32,32
1683739770493,BIEB 102,A04,193255,Butler; Shannon Rhey,13,0,32,19
1683739770493,BIEB 102,A05,193265,Butler; Shannon Rhey,25,0,32,7
1683739770493,BIEB 102,A06,193269,Butler; Shannon Rhey,12,0,32,20
1683739772545,BIEB 150,A01,193274,Staff,0,0,32,32
1683739772545,BIEB 150,A02,193285,Staff,24,0,32,8
1683739773570,BIEB 194,A00,193286,Kurle; Carolyn M.,19,0,32,13
1683739774601,BILD 1,A01,192291,Staff,15,0,32,17
1683739774601,BILD 1,A02,192292,Staff,30,0,32,2
1683739774601,BILD 1,B01,192520,Reuther; Keefe,0,1,0,0
1683739774601,BILD 1,B02,192532,Reuther; Keefe,0,1,0,0
1683739775629,BILD 3,A01,192556,Butler; Shannon Rhey,0,0,32,32
1683739775629,BILD 3,A02,192581,Butler; Shannon Rhey,0,1,32,32
1683739775629,BILD 3,A03,192611,Butler; Shannon Rhey,19,0,32,13
1683739775629,BILD 3,A04,192612,Butler; Shannon Rhey,23,0,32,9
1683739775629,BILD 3,A05,192613,Butler; Shannon Rhey,26,0,32,6
1683739775629,BILD 3,A06,192679,Butler; Shannon Rhey,27,0,32,5
1683739775629,BILD 3,A07,192682,Butler; Shannon Rhey,20,0,32,12
1683739776659,BILD 4,A01,192836,Reuther; Keefe,1,0,24,23
1683739776659,BILD 4,A02,193044,Reuther; Keefe,4,0,24,20
1683739777690,BILD 10,A01,193142,Gustafson-Brown; Cindy,29,0,32,3
1683739777690,BILD 10,A02,193149,Gustafson-Brown; Cindy,31,0,32,1
1683739778714,BIMM 100,A01,193301,Staff,0,6,32,32
1683739778714,BIMM 100,A02,193312,Staff,0,7,32,32
1683739778714,BIMM 100,A03,193323,Staff,0,10,32,32
1683739779745,BIMM 101,A01,193329,McDonnell; Lisa Marie,0,3,24,24
1683739779745,BIMM 101,A02,193339,McDonnell; Lisa Marie,0,3,24,24
1683739779745,BIMM 101,B01,193354,McDonnell; Lisa Marie,0,4,24,24
1683739779745,BIMM 101,B02,193357,McDonnell; Lisa Marie,0,3,24,24
1683739780772,BIMM 110,A01,193377,Tat; John,0,11,32,32
1683739780772,BIMM 110,A02,193378,Tat; John,0,11,32,32
1683739781796,BIMM 120,A01,206116,Staff,1,0,32,31
1683739781796,BIMM 120,A02,206117,Staff,7,0,32,25
1683739781796,BIMM 120,A03,206121,Staff,21,0,32,11
1683739782826,BIPN 100,A01,193393,Park; Ji Young,0,15,32,32
1683739782826,BIPN 100,A02,193402,Park; Ji Young,0,14,32,32
1683739782826,BIPN 100,A03,193413,Park; Ji Young,0,14,32,32
1683739782826,BIPN 100,A04,193414,Park; Ji Young,0,14,32,32
1683739783850,BIPN 102,A01,193429,Staff,0,0,32,32
1683739783850,BIPN 102,A02,193438,Staff,18,0,32,14
1683739784879,BIPN 106,A01,193450,Reyes Gonzalez; Catalina,0,2,40,40
1683739785904,BIPN 134,A01,193465,Cooke; James Edward,0,0,32,32
1683739785904,BIPN 134,A02,193474,Cooke; James Edward,24,0,32,8
1683739785904,BIPN 134,A03,193485,Cooke; James Edward,29,0,32,3
1683739785904,BIPN 134,A04,193486,Cooke; James Edward,20,0,32,12
1683739785904,BIPN 134,A05,193491,Cooke; James Edward,31,0,32,1
1683739785904,BIPN 134,A06,193501,Cooke; James Edward,30,0,32,2
1683739785904,BIPN 134,A07,193510,Cooke; James Edward,29,0,32,3
1683739788028,BISP 194,A00,222522,Staff,14,0,32,18
1683739789052,CAT 124,A01,202407,Staff,19,0,25,6
1683739790076,CAT 125,A00,202408,Marchisotto; Jennifer Anne,2,0,20,18
1683739791102,CAT 125R,A00,202409,Smith; Lauryn Alissa,0,11,20,20
1683739791102,CAT 125R,B00,202410,Morales; Celeste Georgianna,0,11,20,20
1683739791102,CAT 125R,C00,202411,Irwin; Matthew Joseph,0,12,20,20
1683739792127,CENG 15,A01,204712,Yang; Kesong,0,1,0,0
1683739793153,CENG 114,A00,202070,Jahed Motlagh; Zeinab,5,0,20,15
1683739794176,CGS 105,A00,185477,Wesling; Megan E.,24,0,40,16
1683739795200,CGS 106,A00,185494,Staff,11,0,22,11
1683739796226,CGS 108,A00,185495,Staff,14,0,20,6
1683739797250,CGS 114,A00,185496,Staff,13,0,18,5
1683739798272,CGS 119,A00,185501,Staff,15,0,20,5
1683739799296,CGS 120,A00,185511,Staff,11,0,20,9
1683739800319,CHEM 4,A01,184675,Bussey; Thomas J,97,0,100,3
1683739801359,CHEM 6A,A01,184677,Staff,32,0,60,28
1683739802383,CHEM 6B,A01,184679,Staff,63,0,100,37
1683739803407,CHEM 6C,A01,184681,Bussey; Thomas J,0,0,50,50
1683739803407,CHEM 6C,A02,184682,Bussey; Thomas J,32,0,50,18
1683739804430,CHEM 40A,A01,184684,Albizati; Kim F.,33,0,100,67
1683739805458,CHEM 40B,A01,184686,Albizati; Kim F.,0,23,100,100
1683739806485,CHEM 41B,A01,184690,Staff,51,0,100,49
1683739807509,COGS 3,A01,184715,Boyle; Mary E. T.,0,27,40,40
1683739808534,COGS 14B,A01,185172,Staff,0,14,38,38
1683739809562,COGS 18,A01,184736,Staff,14,0,80,66
1683739810590,COGS 100,A01,184932,Staff,0,8,73,73
1683739811618,COGS 101A,A01,184935,Staff,0,40,30,30
1683739812646,COGS 101B,A01,184944,Staff,0,2,30,30
1683739813669,COGS 101C,A01,184946,Staff,0,10,30,30
1683739814696,COGS 102A,A01,184951,Johnson; Christine M.,1,0,40,39
1683739815727,COGS 107B,A01,184953,Mooshagian; Eric Frederick,0,52,40,40
1683739816755,COGS 118B,A01,184959,Gupta; Anjum,0,50,40,40
1683739817779,COGS 153,A00,184961,Staff,1,16,30,29
1683739818807,COGS 177,A00,184962,Staff,0,20,30,30
1683739819833,COGS 187A,A01,184969,Boyle; Mary E. T.,0,19,40,40
1683739820858,COMM 10,A01,185174,Staff,0,5,25,25
1683739820858,COMM 10,A02,185189,Staff,0,2,25,25
1683739820858,COMM 10,A03,269821,Staff,0,1,0,0
1683739821890,COMM 100B,A02,185476,Staff,10,0,25,15
1683739821890,COMM 100B,A03,277340,Staff,25,0,25,0
1683739822917,COMM 100C,A01,185314,Staff,2,0,25,23
1683739822917,COMM 100C,A02,185327,Staff,17,0,25,8
1683739823942,COMM 110M,A00,185349,Staff,0,0,40,40
1683739824970,COMM 113T,A00,185352,Staff,25,0,40,15
1683739826000,COMM 114I,A00,185353,Staff,31,0,40,9
1683739827038,COMM 131,A00,185354,Staff,17,0,30,13
1683739828062,CSE 8A,A50,185358,Cao; Yingjun,0,46,10,10
1683739829086,CSE 8B,A01,185362,Staff,0,48,50,50
1683739830114,CSE 11,A01,185416,Cao; Yingjun,0,91,10,10
1683739831140,CSE 20,A01,185445,Briones; Jor-el Thomas Caparas,3,0,25,22
1683739832170,CSE 21,A01,185447,Staff,9,0,50,41
1683739833195,CSE 101,A01,185451,Staff,0,13,50,50
1683739833195,CSE 101,B01,185453,Jones; Miles E,0,15,50,50
1683739835254,CSE 141,A01,185458,Eldon; John,16,0,100,84
1683739836279,CSE 141L,A01,185461,Eldon; John,8,0,100,92
1683739837307,CSE 142,A01,185463,Staff,34,0,60,26
1683739837307,CSE 142,B01,201355,Staff,0,7,60,60
1683739838337,CSE 142L,A01,185470,Staff,34,0,60,26
1683739838337,CSE 142L,B01,201417,Staff,0,6,60,60
1683739839365,CSE 190,A00,201433,Staff,32,0,49,17
1683739840390,DOC 1,A01,259136,Strom; Megan C.,7,0,15,8
1683739840390,DOC 1,A02,259137,Strom; Megan C.,15,0,15,0
1683739840390,DOC 1,A03,259138,Strom; Megan C.,14,0,15,1
1683739840390,DOC 1,A04,259139,Strom; Megan C.,13,0,15,2
1683739841416,DOC 100D,A00,259140,Pass; Natalye Joann,14,0,25,11
1683739842441,DSGN 1,A01,184749,Rill; Bryan,0,26,30,30
1683739843466,DSGN 100,A01,185168,Staff,0,2,25,25
1683739844494,ECE 5,A01,185626,Morris; Karcher William,0,12,0,0
1683739845519,ECE 101,A01,185628,Staff,14,0,70,56
1683739846547,ECE 107,A01,185635,Baghdadchi; Saharnaz,0,0,20,20
1683739846547,ECE 107,A02,185638,Baghdadchi; Saharnaz,1,0,20,19
1683739847571,ECE 148,A01,185647,Silberman; Jack,0,0,16,16
1683739848599,ECON 1,A01,185537,Crane; Meredith Helen,54,0,70,16
