time,subj_course_id,sec_code,sec_id,prof,available,waitlist,total,enrolled_ct
1683655731069,ANBI 133,A00,258401,Wilder; Linnea Lorene,34,0,40,6
1683655732097,ANBI 140,A00,258395,Hrvoj Mihic; Branka,18,0,25,7
1683655733123,ANSC 120,A00,258402,Bialecki; Jon Anthony,26,0,40,14
1683655734153,ANSC 144,A00,258400,Staff,12,0,40,28
1683655736205,ANSC 166,A00,258396,Parish; Steven Martin,156,0,175,19
1683655737235,ANSC 180,A00,193533,Staff,8,0,20,12
1683655738264,ANSC 188,A00,258397,Jassal; Aftab,34,0,40,6
1683655739292,ANTH 3,A01,258316,Staff,23,0,30,7
1683655740321,ANTH 5,A00,258394,Semendeferi; Ekaterini,16,0,20,4
1683655741348,ANTH 21,A01,258331,Staff,4,0,40,36
1683655742375,ANTH 103,A00,258398,Varma; Saiba,15,0,25,10
1683655743410,AWP 10,001,202034,Staff,0,0,0,0
1683655743410,AWP 10,002,202035,Staff,0,0,0,0
1683655743410,AWP 10,003,202036,Staff,0,0,0,0
1683655743410,AWP 10,004,202037,Staff,0,0,0,0
1683655743410,AWP 10,005,202038,Staff,0,0,0,0
1683655743410,AWP 10,006,202039,Staff,0,0,0,0
1683655743410,AWP 10,007,202040,Staff,0,0,0,0
1683655743410,AWP 10,008,202041,Staff,0,0,0,0
1683655743410,AWP 10,009,202042,Staff,0,0,0,0
1683655743410,AWP 10,010,202043,Staff,0,0,0,0
1683655743410,AWP 10,011,202044,Staff,0,0,0,0
1683655743410,AWP 10,012,202045,Staff,0,0,0,0
1683655743410,AWP 10,013,202046,Staff,0,0,0,0
1683655743410,AWP 10,014,202047,Staff,0,0,0,0
1683655743410,AWP 10,015,202048,Staff,0,0,0,0
1683655743410,AWP 10,016,202049,Staff,0,0,0,0
1683655743410,AWP 10,017,202050,Staff,0,0,0,0
1683655743410,AWP 10,018,202051,Staff,0,0,0,0
1683655743410,AWP 10,019,202052,Staff,0,0,0,0
1683655743410,AWP 10,020,202053,Staff,0,0,0,0
1683655743410,AWP 10,021,202054,Staff,0,0,0,0
1683655743410,AWP 10,022,202055,Staff,0,0,0,0
1683655743410,AWP 10,023,202056,Staff,0,0,0,0
1683655743410,AWP 10,024,202057,Staff,0,0,0,0
1683655743410,AWP 10,025,202058,Staff,0,0,0,0
1683655743410,AWP 10,026,202059,Staff,0,0,0,0
1683655744439,AWP 102,001,202032,Staff,0,0,0,0
1683655744439,AWP 102,002,202033,Staff,0,0,0,0
1683655745471,BENG 100,A01,254234,Taylor Amos; Alyssa C,31,0,40,9
1683655746501,BENG 196,001,270013,Engler; Adam J.,9999,0,9999,0
1683655747530,BICD 100R,A01,202018,Smith; Laurie,0,7,32,32
1683655747530,BICD 100R,A02,202019,Smith; Laurie,0,3,32,32
1683655747530,BICD 100R,A03,202020,Smith; Laurie,0,1,32,32
1683655747530,BICD 100R,A04,202021,Smith; Laurie,6,0,32,26
1683655747530,BICD 100R,A05,202022,Smith; Laurie,11,0,32,21
1683655748557,BICD 136,A01,193242,Gustafson-Brown; Cindy,0,2,32,32
1683655748557,BICD 136,A02,193244,Gustafson-Brown; Cindy,13,0,32,19
1683655749585,BIEB 102,A01,193249,Butler; Shannon Rhey,0,2,32,32
1683655749585,BIEB 102,A02,193251,Butler; Shannon Rhey,0,0,32,32
1683655749585,BIEB 102,A03,193253,Butler; Shannon Rhey,0,0,32,32
1683655749585,BIEB 102,A04,193255,Butler; Shannon Rhey,14,0,32,18
1683655749585,BIEB 102,A05,193265,Butler; Shannon Rhey,26,0,32,6
1683655749585,BIEB 102,A06,193269,Butler; Shannon Rhey,14,0,32,18
1683655751642,BIEB 150,A01,193274,Staff,0,0,32,32
1683655751642,BIEB 150,A02,193285,Staff,24,0,32,8
1683655752670,BIEB 194,A00,193286,Kurle; Carolyn M.,20,0,32,12
1683655753698,BILD 1,A01,192291,Staff,15,0,32,17
1683655753698,BILD 1,A02,192292,Staff,30,0,32,2
1683655753698,BILD 1,B01,192520,Reuther; Keefe,0,1,0,0
1683655753698,BILD 1,B02,192532,Reuther; Keefe,0,1,0,0
1683655754732,BILD 3,A01,192556,Butler; Shannon Rhey,0,0,32,32
1683655754732,BILD 3,A02,192581,Butler; Shannon Rhey,1,0,32,31
1683655754732,BILD 3,A03,192611,Butler; Shannon Rhey,21,0,32,11
1683655754732,BILD 3,A04,192612,Butler; Shannon Rhey,24,0,32,8
1683655754732,BILD 3,A05,192613,Butler; Shannon Rhey,26,0,32,6
1683655754732,BILD 3,A06,192679,Butler; Shannon Rhey,27,0,32,5
1683655754732,BILD 3,A07,192682,Butler; Shannon Rhey,20,0,32,12
1683655755760,BILD 4,A01,192836,Reuther; Keefe,1,0,24,23
1683655755760,BILD 4,A02,193044,Reuther; Keefe,4,0,24,20
1683655756788,BILD 10,A01,193142,Gustafson-Brown; Cindy,29,0,32,3
1683655756788,BILD 10,A02,193149,Gustafson-Brown; Cindy,31,0,32,1
1683655757819,BIMM 100,A01,193301,Staff,0,6,32,32
1683655757819,BIMM 100,A02,193312,Staff,0,7,32,32
1683655757819,BIMM 100,A03,193323,Staff,0,9,32,32
1683655758854,BIMM 101,A01,193329,McDonnell; Lisa Marie,0,4,24,24
1683655758854,BIMM 101,A02,193339,McDonnell; Lisa Marie,1,3,24,23
1683655758854,BIMM 101,B01,193354,McDonnell; Lisa Marie,0,4,24,24
1683655758854,BIMM 101,B02,193357,McDonnell; Lisa Marie,0,3,24,24
1683655759882,BIMM 110,A01,193377,Tat; John,0,11,32,32
1683655759882,BIMM 110,A02,193378,Tat; John,0,10,32,32
1683655760911,BIMM 120,A01,206116,Staff,0,0,32,32
1683655760911,BIMM 120,A02,206117,Staff,6,0,32,26
1683655760911,BIMM 120,A03,206121,Staff,21,0,32,11
1683655761939,BIPN 100,A01,193393,Park; Ji Young,0,15,32,32
1683655761939,BIPN 100,A02,193402,Park; Ji Young,0,14,32,32
1683655761939,BIPN 100,A03,193413,Park; Ji Young,0,14,32,32
1683655761939,BIPN 100,A04,193414,Park; Ji Young,0,13,32,32
1683655762969,BIPN 102,A01,193429,Staff,0,0,32,32
1683655762969,BIPN 102,A02,193438,Staff,18,0,32,14
1683655763995,BIPN 106,A01,193450,Reyes Gonzalez; Catalina,0,2,40,40
1683655765023,BIPN 134,A01,193465,Cooke; James Edward,0,0,32,32
1683655765023,BIPN 134,A02,193474,Cooke; James Edward,25,0,32,7
1683655765023,BIPN 134,A03,193485,Cooke; James Edward,29,0,32,3
1683655765023,BIPN 134,A04,193486,Cooke; James Edward,20,0,32,12
1683655765023,BIPN 134,A05,193491,Cooke; James Edward,31,0,32,1
1683655765023,BIPN 134,A06,193501,Cooke; James Edward,30,0,32,2
1683655765023,BIPN 134,A07,193510,Cooke; James Edward,29,0,32,3
1683655767078,BISP 194,A00,222522,Staff,14,0,32,18
1683655768108,CAT 124,A01,202407,Staff,19,0,25,6
1683655769140,CAT 125,A00,202408,Marchisotto; Jennifer Anne,2,0,20,18
1683655770169,CAT 125R,A00,202409,Smith; Lauryn Alissa,0,11,20,20
1683655770169,CAT 125R,B00,202410,Morales; Celeste Georgianna,0,11,20,20
1683655770169,CAT 125R,C00,202411,Irwin; Matthew Joseph,0,12,20,20
1683655771193,CENG 15,A01,204712,Yang; Kesong,0,1,0,0
1683655772222,CENG 114,A00,202070,Jahed Motlagh; Zeinab,5,0,20,15
1683655773251,CGS 105,A00,185477,Wesling; Megan E.,24,0,40,16
1683655774281,CGS 106,A00,185494,Staff,11,0,22,11
1683655775327,CGS 108,A00,185495,Staff,14,0,20,6
1683655776357,CGS 114,A00,185496,Staff,13,0,18,5
1683655777384,CGS 119,A00,185501,Staff,15,0,20,5
1683655778412,CGS 120,A00,185511,Staff,12,0,20,8
1683655779440,CHEM 4,A01,184675,Bussey; Thomas J,97,0,100,3
1683655780472,CHEM 6A,A01,184677,Staff,33,0,60,27
1683655781502,CHEM 6B,A01,184679,Staff,63,0,100,37
1683655782528,CHEM 6C,A01,184681,Bussey; Thomas J,0,0,50,50
1683655782528,CHEM 6C,A02,184682,Bussey; Thomas J,32,0,50,18
1683655783559,CHEM 40A,A01,184684,Albizati; Kim F.,34,0,100,66
1683655784590,CHEM 40B,A01,184686,Albizati; Kim F.,0,22,100,100
1683655785626,CHEM 41B,A01,184690,Staff,51,0,100,49
1683655786653,COGS 3,A01,184715,Boyle; Mary E. T.,0,27,40,40
1683655787680,COGS 14B,A01,185172,Staff,0,14,38,38
1683655788708,COGS 18,A01,184736,Staff,14,0,80,66
1683655789738,COGS 100,A01,184932,Staff,0,7,73,73
1683655790766,COGS 101A,A01,184935,Staff,0,39,30,30
1683655791798,COGS 101B,A01,184944,Staff,0,2,30,30
1683655792828,COGS 101C,A01,184946,Staff,0,10,30,30
1683655793860,COGS 102A,A01,184951,Johnson; Christine M.,2,0,40,38
1683655794890,COGS 107B,A01,184953,Mooshagian; Eric Frederick,0,51,40,40
1683655795919,COGS 118B,A01,184959,Gupta; Anjum,0,49,40,40
1683655796944,COGS 153,A00,184961,Staff,0,16,30,30
1683655797968,COGS 177,A00,184962,Staff,0,21,30,30
1683655798993,COGS 187A,A01,184969,Boyle; Mary E. T.,0,19,40,40
1683655800020,COMM 10,A01,185174,Staff,0,5,25,25
1683655800020,COMM 10,A02,185189,Staff,0,2,25,25
1683655800020,COMM 10,A03,269821,Staff,0,1,0,0
1683655801045,COMM 100B,A01,185475,Staff,0,1,0,2
1683655801045,COMM 100B,A02,185476,Staff,12,0,25,13
1683655802075,COMM 100C,A01,185314,Staff,1,0,25,24
1683655802075,COMM 100C,A02,185327,Staff,18,0,25,7
1683655803105,COMM 110M,A00,185349,Staff,0,0,40,40
1683655804134,COMM 113T,A00,185352,Staff,25,0,40,15
1683655805165,COMM 114I,A00,185353,Staff,31,0,40,9
1683655806191,COMM 131,A00,185354,Staff,17,0,30,13
1683655807216,CSE 8A,A50,185358,Cao; Yingjun,0,46,10,10
1683655808239,CSE 8B,A01,185362,Staff,0,48,50,50
1683655809270,CSE 11,A01,185416,Cao; Yingjun,0,91,10,10
1683655810295,CSE 20,A01,185445,Briones; Jor-el Thomas Caparas,4,0,25,21
1683655811324,CSE 21,A01,185447,Staff,9,0,50,41
1683655812356,CSE 101,A01,185451,Staff,0,13,50,50
1683655812356,CSE 101,B01,185453,Jones; Miles E,0,13,50,50
1683655814415,CSE 141,A01,185458,Eldon; John,16,0,100,84
1683655815442,CSE 141L,A01,185461,Eldon; John,8,0,100,92
1683655816479,CSE 142,A01,185463,Staff,35,0,60,25
1683655816479,CSE 142,B01,201355,Staff,0,7,60,60
1683655817507,CSE 142L,A01,185470,Staff,35,0,60,25
1683655817507,CSE 142L,B01,201417,Staff,0,6,60,60
1683655818534,CSE 190,A00,201433,Staff,32,0,49,17
1683655819567,DOC 1,A01,259136,Strom; Megan C.,7,0,15,8
1683655819567,DOC 1,A02,259137,Strom; Megan C.,14,0,15,1
1683655819567,DOC 1,A03,259138,Strom; Megan C.,14,0,15,1
1683655819567,DOC 1,A04,259139,Strom; Megan C.,14,0,15,1
1683655820595,DOC 100D,A00,259140,Pass; Natalye Joann,14,0,25,11
1683655821623,DSGN 1,A01,184749,Rill; Bryan,0,26,30,30
1683655822650,DSGN 100,A01,185168,Staff,0,2,25,25
1683655823677,ECE 5,A01,185626,Morris; Karcher William,0,11,0,0
1683655824704,ECE 101,A01,185628,Staff,14,0,70,56
1683655825733,ECE 107,A01,185635,Baghdadchi; Saharnaz,0,0,20,20
1683655825733,ECE 107,A02,185638,Baghdadchi; Saharnaz,2,0,20,18
1683655826762,ECE 148,A01,185647,Silberman; Jack,0,0,16,16
1683655827790,ECON 1,A01,185537,Crane; Meredith Helen,54,0,70,16
1683655828819,ECON 3,A01,185549,Crane; Meredith Helen,29,0,70,41
1683655829901,ECON 4,A01,203354,Anderson; John Charles,0,5,10,10
1683655830927,ECON 100A,A01,185574,Staff,0,5,40,40
1683655831959,ECON 100B,A01,185576,Staff,0,12,50,50
1683655832985,ECON 100C,A01,185589,Newhouse; Herbert S,30,0,70,40
1683655834015,ECON 105,A00,185608,Vespa; Emanuel Ignacio,19,0,35,16
1683655835047,ECON 109,A01,185610,Shishkin; Denis,9,0,35,26
1683655836081,ECON 110A,A01,185612,Staff,9,0,40,31
1683655837112,ECON 120A,A01,185615,Staff,20,0,40,20
1683655838139,ECON 120C,A01,185617,Sun; Yixiao,0,20,70,70
1683655839170,ECON 144,A00,203346,Squires; Dale E,2,0,35,33
1683655840200,ECON 171,A01,203349,Newhouse; Herbert S,0,1,35,35
1683655841228,ECON 173A,A01,185621,Toda; Alexis Akira,21,0,35,14
1683655842263,EDS 25,A01,202413,Staff,0,1,0,0
1683655842263,EDS 25,A02,202414,Staff,0,1,0,0
1683655842263,EDS 25,A03,202415,Staff,0,0,0,0
1683655842263,EDS 25,A04,202416,Staff,0,1,0,0
1683655842263,EDS 25,A05,202439,Staff,0,0,0,0
1683655842263,EDS 25,A06,202440,Staff,0,0,0,0
1683655842263,EDS 25,B01,202631,Staff,0,0,0,0
1683655842263,EDS 25,B02,202632,Staff,0,0,0,0
1683655842263,EDS 25,B03,202639,Staff,0,0,0,0
1683655842263,EDS 25,B04,202640,Staff,0,0,0,0
1683655842263,EDS 25,B05,202643,Staff,0,0,0,0
1683655842263,EDS 25,B06,202644,Staff,0,0,0,0
1683655843296,EDS 38,A01,202659,Black; Alison Michelle,24,0,25,1
1683655844329,EDS 115,A00,202652,Staff,18,0,30,12
1683655845358,EDS 125,A00,202649,Staff,13,0,30,17
1683655846386,EDS 126,A01,203332,Staff,30,0,30,0
1683655847420,EDS 139,A00,202838,Staff,16,0,25,9
1683655848447,EDS 146,A01,202655,Staff,14,0,25,11
1683655849480,ENG 15,A00,185667,Staff,0,1,0,0
1683655849480,ENG 15,B00,185672,Staff,0,0,0,0
1683655849480,ENG 15,C00,185675,Staff,0,0,0,0
1683655849480,ENG 15,D00,185682,Staff,0,0,0,0
1683655849480,ENG 15,E00,185684,Staff,0,0,0,0
1683655850509,ETHN 103,A00,185710,Staff,0,8,35,35
1683655851539,ETHN 103A,A00,199228,Man; Simeon S,0,0,9,9
1683655852567,ETHN 109,A00,185711,Staff,16,0,35,19
1683655853594,ETHN 142,A00,185726,Staff,0,4,30,30
1683655854624,ETHN 163J,A00,199229,Man; Simeon S,5,0,8,3
1683655855651,ETHN 168,A00,185727,Staff,7,0,10,3
1683655856679,ETHN 182,A00,185728,Staff,0,0,35,35
1683655857706,ETHN 183,A00,185737,Staff,9,0,18,9
1683655858740,GLBH 111,A01,209361,Burgos; Jose L.,0,0,0,0
1683655860797,HIEU 104,A00,185792,Staff,14,0,20,6
1683655861826,HIEU 115,A00,185800,Staff,0,0,20,20
1683655862856,HIEU 128,A00,185801,Staff,0,9,20,20
1683655863882,HIEU 147,A00,185802,Staff,15,0,20,5
1683655864908,HIEU 154,A00,185823,Staff,11,0,20,9
1683655865934,HILA 102,A00,185826,Staff,14,0,20,6
1683655866961,HILD 2C,A01,185778,Staff,0,13,20,20
1683655867991,HILD 7B,A01,185780,Kwak; Nancy,0,16,32,32
1683655867991,HILD 7B,A02,185781,Kwak; Nancy,0,18,32,32
1683655869022,HILD 30,A01,185791,Staff,12,0,20,8
1683655870051,HISC 119,A00,185830,Golan; Tal,0,9,20,20
1683655871077,HITO 156GS,A00,185831,Patterson; Patrick H.,0,0,0,23
1683655872104,HIUS 103,A00,185832,Man; Simeon S,0,4,20,20
1683655873133,HIUS 117,A00,185836,Kwak; Nancy,2,0,20,18
1683655874160,HIUS 125,A00,185840,Man; Simeon S,0,2,23,23
1683655875189,HIUS 149,A00,185845,Staff,1,0,20,19
1683655876221,HUM 3,A01,185882,Zavodny; Tatiana Sophia,0,8,50,50
1683655876221,HUM 3,B01,185899,Caldwell; Michael Alan,0,18,50,50
1683655877250,HUM 3GS,A00,185900,Patterson; Patrick H.,0,0,0,23
1683655878281,HUM 4,A01,185938,Zroka; Amy Liane,29,0,50,21
1683655878281,HUM 4,B01,185956,Watkins; Eric,0,4,50,50
1683655878281,HUM 4,B02,202209,Watkins; Eric,0,5,50,50
1683655878281,HUM 4,B03,202210,Watkins; Eric,0,5,50,50
1683655879309,HUM 5,A01,185958,West; Geoffrey Scott,1,0,50,49
1683655879309,HUM 5,A02,202215,West; Geoffrey Scott,0,0,50,50
1683655880336,INTL 190,A00,185959,Gagnon; Jeffrey C,0,0,0,9
1683655880336,INTL 190,B00,185960,Lettieri; Michael Joseph,0,0,0,2
1683655881367,JAPN 180,A00,254509,Staff,5,0,30,25
1683655882399,LATI 10,A01,202853,Kennemore; Amy Michelle,4,0,35,31
1683655882399,LATI 10,A02,202854,Kennemore; Amy Michelle,2,0,35,33
1683655882399,LATI 10,A03,270054,Kennemore; Amy Michelle,30,0,30,0
1683655883428,LATI 180,A00,202855,Kennemore; Amy Michelle,11,0,20,9
1683655884455,LAWS 101,A00,201767,Golan; Tal,0,7,40,40
1683655885484,LIFR 1C,A00,185961,Staff,6,0,20,14
1683655886512,LIFR 1CX,A00,185962,Staff,7,0,20,13
1683655887540,LIFR 1D,A00,185963,Staff,7,0,20,13
1683655888563,LIFR 1DX,A00,185964,Staff,7,0,20,13
1683655889591,LIGN 101,A01,186039,Staff,43,0,50,7
1683655890616,LIGN 165,A00,186040,Staff,15,0,50,35
1683655891644,LTCS 108,A00,186041,Staff,5,0,10,5
1683655892670,LTCS 119,A00,186042,Staff,15,0,20,5
1683655893699,LTCS 130,A00,186043,Wesling; Megan E.,15,0,25,10
1683655895757,LTEA 138,A00,186119,Staff,14,0,40,26
1683655896786,LTEN 124,A00,186148,Staff,5,0,25,20
1683655897813,LTEN 178,A00,186149,Staff,7,0,15,8
1683655898840,LTEN 181,A00,186150,Blanco; John D,34,0,40,6
1683655899871,LTWL 120,A00,186160,Staff,20,0,25,5
1683655900898,LTWL 165,A00,186161,Staff,22,0,25,3
1683655901927,LTWR 100,A00,186162,Staff,0,5,15,15
1683655902959,LTWR 102,A00,186163,Doller; Ben,5,0,15,10
1683655903988,MAE 8,A01,186412,Staff,0,0,0,0
1683655905015,MAE 30B,A00,186445,Bahadori; Mohammad Yousef,82,0,100,18
1683655906045,MAE 40,A00,186592,Bewley; Thomas R,10,0,50,40
1683655907077,MAE 101B,A00,186593,Bahadori; Mohammad Yousef,80,0,100,20
1683655908106,MAE 105,A00,186594,Bandaru; Prabhakar,10,0,50,40
1683655909132,MAE 107,A00,186599,Pham; Hieu Tan,0,7,120,120
1683655910161,MAE 148,A01,186660,Silberman; Jack,3,0,16,13
1683655911189,MATH 10A,A01,188095,Staff,0,6,35,35
1683655912215,MATH 10B,A01,188097,Bowers; Adam R.,0,12,30,30
1683655912215,MATH 10B,A02,188099,Bowers; Adam R.,0,11,30,30
1683655912215,MATH 10B,B01,188104,Bowers; Adam R.,0,10,30,30
1683655912215,MATH 10B,B02,188106,Bowers; Adam R.,1,9,30,29
1683655913247,MATH 10C,A01,188111,Staff,0,18,30,30
1683655913247,MATH 10C,A02,188127,Staff,0,19,30,30
1683655913247,MATH 10C,A03,188131,Staff,0,19,30,30
1683655913247,MATH 10C,B01,188218,Staff,17,0,30,13
1683655913247,MATH 10C,B02,188244,Staff,13,0,30,17
1683655913247,MATH 10C,B03,188277,Staff,14,0,30,16
1683655914276,MATH 18,A01,188344,Bach; Quang Tran,18,0,30,12
1683655914276,MATH 18,A02,188345,Bach; Quang Tran,11,0,30,19
1683655914276,MATH 18,B01,188353,Bach; Quang Tran,11,0,30,19
1683655914276,MATH 18,B02,188354,Bach; Quang Tran,19,0,30,11
1683655915302,MATH 20A,A01,188374,Staff,11,0,35,24
1683655916328,MATH 20B,A01,188382,Ohm; Ko Woon,7,0,30,23
1683655916328,MATH 20B,A02,188383,Ohm; Ko Woon,22,0,30,8
1683655916328,MATH 20B,B01,188385,Ohm; Ko Woon,7,0,30,23
1683655916328,MATH 20B,B02,188392,Ohm; Ko Woon,22,0,30,8
1683655917355,MATH 20C,A01,188394,Harel; Guershon,11,0,30,19
1683655917355,MATH 20C,A02,188395,Harel; Guershon,13,0,30,17
1683655917355,MATH 20C,B01,188404,Harel; Guershon,5,0,30,25
1683655917355,MATH 20C,B02,188405,Harel; Guershon,18,0,30,12
1683655918389,MATH 20D,A01,188414,Hammock; Frances H,0,1,30,30
1683655918389,MATH 20D,A02,188415,Hammock; Frances H,0,1,30,30
1683655918389,MATH 20D,B01,188447,Hammock; Frances H,0,1,30,30
1683655918389,MATH 20D,B02,188486,Hammock; Frances H,4,0,30,26
1683655919418,MATH 20E,A01,188649,Staff,21,0,30,9
1683655919418,MATH 20E,A02,188650,Staff,21,0,30,9
1683655919418,MATH 20E,A03,188673,Staff,0,0,30,30
1683655920446,MATH 102,A01,188675,Staff,0,36,35,35
1683655921476,MATH 103B,A01,188681,Staff,3,0,35,32
1683655921476,MATH 103B,B01,188692,Staff,5,0,35,30
1683655922506,MATH 109,A01,188695,Salehi Golsefidy; Alireza,24,0,35,11
1683655922506,MATH 109,A02,188696,Salehi Golsefidy; Alireza,25,0,35,10
1683655923539,MATH 120A,A01,188698,Eggers; John Dietrich,7,0,35,28
1683655924567,MATH 142B,A01,188736,Ioana; Adrian,0,1,30,30
1683655924567,MATH 142B,A02,188741,Ioana; Adrian,0,1,30,30
1683655924567,MATH 142B,A03,188743,Ioana; Adrian,0,1,30,30
1683655925593,MATH 168A,A01,188790,Staff,0,10,35,35
1683655926626,MATH 170A,A01,188803,Nie; Jiawang,0,2,35,35
1683655926626,MATH 170A,A02,188811,Nie; Jiawang,0,0,35,35
1683655926626,MATH 170A,A03,188814,Nie; Jiawang,0,0,35,35
1683655926626,MATH 170A,A04,188815,Nie; Jiawang,10,0,35,25
1683655927653,MATH 193B,A01,188817,Staff,0,0,35,35
1683655927653,MATH 193B,A02,188818,Staff,5,0,35,30
1683655928680,MGT 4,A01,202857,Anderson; John Charles,61,0,80,19
1683655929707,MGT 12,A00,202858,Lindenberger; Wade Douglas,40,0,90,50
1683655930737,MGT 18,A00,202859,Staff,74,0,90,16
1683655931765,MGT 18GS,A00,202860,McKay; Michael J,13,0,28,15
1683655932798,MGT 45,A00,202861,Pecore; Joseph P.,12,0,90,78
1683655933884,MGT 100,A00,202863,Yavorsky; Daniel Ryan,28,0,90,62
1683655934911,MGT 103,A00,202864,Ehrich; Kristine R,0,17,90,90
1683655935939,MGT 112,A00,202865,Ehrich; Kristine R,15,0,90,75
1683655936966,MGT 121A,A00,202868,Staff,90,20,90,0
1683655937994,MGT 131B,A00,202869,Anderson; John Charles,59,0,90,31
1683655939021,MGT 136,A00,202871,Lindenberger; Wade Douglas,83,0,90,7
1683655940052,MGT 164,A00,202873,Staff,0,66,90,91
1683655941079,MGT 164GS,A00,202874,McKay; Mary A,13,0,28,15
1683655942108,MGT 180,A00,202875,Staff,0,50,90,91
1683655943135,MMW 11R,A01,205019,Herbst; Matthew,2,0,30,28
1683655943135,MMW 11R,A02,205026,Herbst; Matthew,29,0,30,1
1683655944161,MMW 15,A01,193512,Chang; Edmond Yi-Teh,0,8,28,28
1683655944161,MMW 15,A02,193513,Chang; Edmond Yi-Teh,0,5,28,28
1683655944161,MMW 15,A03,193514,Chang; Edmond Yi-Teh,0,5,28,28
1683655944161,MMW 15,A04,193515,Chang; Edmond Yi-Teh,0,5,28,28
1683655944161,MMW 15,A05,193516,Chang; Edmond Yi-Teh,0,5,28,28
1683655944161,MMW 15,A06,193517,Chang; Edmond Yi-Teh,0,6,28,28
1683655944161,MMW 15,B01,193519,Chang; Edmond Yi-Teh,0,5,28,28
1683655944161,MMW 15,B02,193520,Chang; Edmond Yi-Teh,0,5,28,28
1683655944161,MMW 15,B03,193521,Chang; Edmond Yi-Teh,0,5,28,28
1683655944161,MMW 15,B04,193522,Chang; Edmond Yi-Teh,0,5,28,28
1683655944161,MMW 15,B05,193523,Chang; Edmond Yi-Teh,0,5,28,28
1683655944161,MMW 15,B06,193524,Chang; Edmond Yi-Teh,0,5,28,28
1683655945190,MMW 122,A01,193526,Rahimi; Babak,0,16,28,28
1683655945190,MMW 122,A02,193527,Rahimi; Babak,0,15,28,28
1683655945190,MMW 122,A03,193528,Rahimi; Babak,0,0,0,0
1683655945190,MMW 122,A04,193529,Rahimi; Babak,0,0,0,0
1683655946216,MUS 1A,A01,186663,Staff,1,20,35,34
1683655947246,MUS 4,A01,186715,Staff,0,12,35,35
1683655948270,MUS 5R,A01,186796,Dubnov; Shlomo,0,17,35,35
1683655949296,MUS 6,A01,186798,Staff,0,5,25,25
1683655950324,MUS 7,A01,186830,Staff,11,0,35,24
1683655951350,MUS 8,A01,186930,Staff,0,26,35,35
1683655952379,MUS 15,A01,186932,Staff,0,16,35,35
1683655952379,MUS 15,B01,186934,Staff,0,17,35,35
1683655953411,MUS 80,A00,186935,Staff,0,0,20,20
1683655953411,MUS 80,B00,186936,Staff,24,0,25,1
1683655954443,NANO 11,A00,204702,Lipomi; Darren John,0,0,0,0
1683655955470,NANO 15,A01,204709,Yang; Kesong,0,1,0,0
1683655956501,NANO 114,A00,202069,Jahed Motlagh; Zeinab,3,0,10,7
1683655957530,PHIL 1,A00,186955,Grush; Rick Scott,31,0,40,9
1683655958559,PHIL 10,A01,186973,Grush; Rick Scott,27,0,35,8
1683655958559,PHIL 10,A02,186974,Grush; Rick Scott,33,0,35,2
1683655959586,PHIL 13,A01,186976,Staff,3,0,35,32
1683655959586,PHIL 13,A02,186977,Staff,16,0,35,19
1683655960613,PHIL 14,A01,186979,Staff,31,0,35,4
1683655960613,PHIL 14,A02,186986,Staff,32,0,35,3
1683655961643,PHIL 28,A01,186988,Staff,16,0,30,14
1683655961643,PHIL 28,A02,186989,Staff,1,0,30,29
1683655961643,PHIL 28,A03,186990,Staff,10,0,30,20
1683655961643,PHIL 28,A04,186991,Staff,26,0,30,4
1683655962672,PHIL 120,A00,186997,Staff,23,0,40,17
1683655963707,PHIL 137,A00,187003,Staff,7,0,40,33
1683655964734,PHIL 150,A00,187015,Staff,47,0,70,23
1683655965759,PHIL 167,A00,187021,Lamey; Andy M.,34,0,40,6
1683655966787,PHIL 174,A01,202226,Staff,17,0,20,3
1683655966787,PHIL 174,A02,202235,Staff,20,0,20,0
1683655967819,PHIL 191A,A00,258918,Staff,0,0,1,1
1683655968850,PHYS 1A,A00,187028,Staff,26,0,60,34
1683655969878,PHYS 1AL,001,187036,Staff,3,0,30,27
1683655969878,PHYS 1AL,002,187049,Staff,18,0,30,12
1683655970908,PHYS 1B,A00,187058,Staff,22,0,60,38
1683655971938,PHYS 1BL,001,187064,Staff,0,1,30,30
1683655971938,PHYS 1BL,002,187070,Staff,4,0,30,26
1683655972965,PHYS 1C,A00,187082,Staff,29,0,120,91
1683655973992,PHYS 1CL,001,187088,Staff,0,9,30,30
1683655973992,PHYS 1CL,002,187089,Staff,0,1,30,30
1683655973992,PHYS 1CL,009,262693,Staff,9,0,30,21
1683655975019,PHYS 2B,A01,187097,Staff,55,0,115,60
1683655976048,PHYS 2C,A01,187099,Staff,63,0,115,52
1683655977075,PHYS 2CL,A01,187101,Staff,5,0,28,23
1683655977075,PHYS 2CL,A02,187102,Staff,15,0,28,13
1683655978100,PHYS 2D,A01,187123,Shotwell; Brian,95,0,115,20
1683655979128,PHYS 4B,A01,187133,Grinstein; Benjamin,35,0,50,15
1683655980154,POLI 10,A00,188819,Staff,0,4,50,50
1683655981181,POLI 11,A00,188827,Staff,43,0,50,7
1683655982209,POLI 13R,A00,188828,Staff,0,1,20,20
1683655983236,POLI 27,A01,188830,Elgin; Samuel Zincke,0,2,70,70
1683655984259,POLI 30,A00,188832,Desposato; Scott,30,0,50,20
1683655985287,POLI 102F,A00,188834,Staff,0,0,40,40
1683655986316,POLI 104A,A00,188852,Staff,13,0,30,17
1683655987343,POLI 104I,A00,188853,Staff,0,7,20,20
1683655988371,POLI 110B,A00,188854,Wiens; David,6,0,20,14
1683655989398,POLI 112A,A00,188855,Wiens; David,3,0,30,27
1683655990428,POLI 117R,A00,188856,Forman; Fonna,0,12,20,20
1683655991458,POLI 118,A00,188857,Ingham; Sean,8,0,20,12
1683655992484,POLI 120G,A00,188858,Staff,8,0,30,22
1683655993510,POLI 131CR,A00,188863,Hoston; Germaine,21,0,50,29
1683655994539,POLI 133,A00,188864,Nellis; Gareth Hb,44,0,50,6
1683655995563,POLI 134D,A00,188865,Desposato; Scott,27,0,30,3
1683655996588,POLI 142A,A00,188871,Gartzke; Erik,21,0,50,29
1683655997619,POLI 142K,A00,188874,Staff,38,0,50,12
1683655998648,POLI 143,A00,188940,Gartzke; Erik,16,0,30,14
1683655999673,POLI 153,A00,188943,Staff,2,0,20,18
1683656000704,POLI 160AA,A00,188944,Staff,11,0,40,29
1683656001733,POLI 170A,A00,188945,Staff,11,0,30,19
1683656003788,PSYC 1,A00,188952,Staff,36,0,90,54
1683656004814,PSYC 2,B00,188953,Staff,19,0,35,16
1683656005837,PSYC 6,A00,188970,Staff,47,0,60,13
1683656006863,PSYC 7,A00,188973,Staff,35,0,45,10
1683656007890,PSYC 60,A01,188980,Rickard; Timothy C.,42,0,60,18
1683656008917,PSYC 70,A01,189001,Steiner; Eric Tomas,22,0,45,23
1683656009945,PSYC 100,A00,189005,Lacefield; Katharine I,0,99,120,120
1683656010972,PSYC 102,A00,189008,Staff,8,0,30,22
1683656011999,PSYC 106,B00,189026,Gorman; Michael R.,27,0,60,33
1683656013057,PSYC 114,B01,189033,Winkielman; Piotr,0,31,30,30
1683656014084,PSYC 131,A00,189036,Anagnostaras; Stephan,0,43,60,60
1683656015110,PSYC 136,A00,189041,Lowe; Angela Beth,0,7,25,25
1683656016139,PSYC 137,A00,189057,Winkielman; Piotr,0,37,25,25
1683656017165,PSYC 144,A00,189107,Wixted; John T,0,11,50,50
1683656019216,PSYC 162,A00,189142,Staff,0,9,85,85
1683656020241,PSYC 172,A00,189144,Gorman; Michael R.,0,6,30,30
1683656022295,PSYC 179,A00,189146,Lacefield; Katharine I,0,87,120,120
1683656023320,PSYC 181,A00,189147,Anagnostaras; Stephan,0,44,90,90
1683656024351,PSYC 190R,A00,189148,Barner; David A.,0,23,80,80
1683656037154,PSYC 191,A00,189275,Rickard; Timothy C.,0,10,25,25
1683656038177,PSYC 193,A00,189276,Chapman; Eddie Nathaniel,0,1,0,4
1683656039203,PSYC 193L,A01,189281,Lowe; Angela Beth,10,0,20,10
1683656039203,PSYC 193L,B01,189285,Staff,28,0,35,7
1683656040231,RELI 149,A00,187137,Rahimi; Babak,7,0,40,33
1683656041256,SE 9,A01,187315,Staff,0,2,18,18
1683656042278,SE 101B,A00,187409,Staff,24,0,30,6
1683656043303,SE 110B,A00,187444,Staff,10,0,40,30
1683656044327,SE 130B,A00,187449,Staff,31,0,40,9
1683656045352,SE 150A,A00,187516,Staff,9,0,20,11
1683656046380,SE 154,A00,187528,Staff,29,0,50,21
1683656059893,SIO 3,A01,258171,Staff,35,0,40,5
1683656060921,SIO 10,A00,187144,Cook; Geoffrey W,0,6,75,75
1683656062024,SIO 45,A00,187152,Cook; Geoffrey W,0,4,100,100
1683656063054,SIO 109R,A00,194486,Staff,0,4,20,20
1683656065108,SIO 187,A01,187233,Kacev; David,12,0,40,28
1683656066134,SOCI 1,A01,258656,Thorpe; Charles Robert,28,0,30,2
1683656066134,SOCI 1,A02,258658,Thorpe; Charles Robert,30,0,30,0
1683656066134,SOCI 1,A03,258661,Thorpe; Charles Robert,25,0,25,0
1683656066134,SOCI 1,A04,258666,Thorpe; Charles Robert,22,0,25,3
1683656066134,SOCI 1,A05,258897,Thorpe; Charles Robert,22,0,25,3
1683656066134,SOCI 1,A06,258898,Thorpe; Charles Robert,25,0,25,0
1683656067162,SOCI 30,A01,258903,Pardo Guerra; Juan Pablo,14,0,30,16
1683656068186,SOCI 102,A00,258904,Staff,9,0,25,16
1683656069212,SOCI 106,A00,258905,Staff,19,0,25,6
1683656073570,SOCI 111,A00,258907,Ribas Norris; Janet Vanesa,26,0,30,4
1683656074599,SOCI 121R,A00,258908,Pardo Guerra; Juan Pablo,8,0,30,22
1683656075630,SOCI 126,A01,203330,Staff,14,0,20,6
1683656076659,SOCI 131,A00,258909,Thorpe; Charles Robert,30,0,60,30
1683656077688,SOCI 135,A00,258910,Payne; Christine Anna,0,11,30,30
1683656078713,SOCI 157,A00,258911,Staff,12,0,30,18
1683656079739,SOCI 184,A00,258912,Staff,25,0,30,5
1683656080767,SOCI 188D,A00,258913,Staff,22,0,30,8
1683656081793,SYN 2,001,187529,Staff,9,0,16,7
1683656081793,SYN 2,002,201452,Staff,0,20,16,16
1683656081793,SYN 2,003,201469,Staff,2,0,16,14
1683656082818,SYN 100,A01,187531,Staff,0,9,20,20
1683656082818,SYN 100,B01,201491,Staff,0,10,20,20
1683656083844,TDAC 1,A00,189286,Walsh; Kim C.,3,0,20,17
1683656083844,TDAC 1,B00,189287,Harting; Carla Kelso,10,0,20,10
1683656084870,TDAC 101,A00,189300,Walsh; Kim C.,16,0,20,4
1683656084870,TDAC 101,B00,189301,Harting; Carla Kelso,18,0,20,2
1683656085899,TDAC 102,A00,189304,Basso; Beatrice,14,0,20,6
1683656086925,TDAC 108,A00,189305,Staff,18,0,20,2
1683656087952,TDDE 131,A00,189310,Staff,19,0,20,1
1683656087952,TDDE 131,B00,189314,Staff,19,0,20,1
1683656087952,TDDE 131,C00,189315,Staff,48,0,50,2
1683656087952,TDDE 131,D00,189316,Staff,14,0,15,1
1683656087952,TDDE 131,E00,204841,Staff,20,0,20,0
1683656088978,TDGE 10,A00,189289,Staff,27,0,50,23
1683656088978,TDGE 10,B00,189290,Havis; Allan,0,0,50,50
1683656090007,TDGE 11,A00,189291,Fulton; Julia,0,4,50,50
1683656090007,TDGE 11,B00,189292,Staff,20,0,25,5
1683656090007,TDGE 11,C00,260270,Staff,0,0,0,0
1683656091034,TDGE 25,A00,189294,Staff,2,0,20,18
1683656092060,TDGE 124,A00,189318,Fulton; Julia,0,8,50,50
1683656093087,TDGE 125,A00,189319,Staff,13,0,25,12
1683656093087,TDGE 125,B00,189320,Staff,23,0,25,2
1683656094114,TDGE 127,A00,189322,Havis; Allan,0,0,50,50
1683656095144,TDHT 101,A00,189323,Staff,18,0,25,7
1683656095144,TDHT 101,B00,189324,Staff,25,0,25,0
1683656096170,TDHT 102,A00,189325,Staff,49,0,50,1
1683656097200,TDMV 1,A00,189295,Arcidiacono; Kristin,20,0,30,10
1683656097200,TDMV 1,B00,189296,Caligagan; Maria T.,24,0,30,6
1683656098227,TDMV 2,A00,189297,Sammartano; Tonnie,27,0,30,3
1683656098227,TDMV 2,B00,189299,Arcidiacono; Kristin,23,0,30,7
1683656099254,TDMV 3,A00,204998,Rincon; Alicia,22,0,30,8
1683656100280,TDMV 120,A00,189458,Sammartano; Tonnie,28,0,30,2
1683656101319,TDMV 138,A00,189541,Jun; Grace Shin Hae,20,0,40,20
1683656102348,TDMV 142,A00,189717,Caligagan; Tony,25,0,30,5
1683656102348,TDMV 142,B00,189718,Caligagan; Maria T.,25,0,30,5
1683656103377,TMC 2,A01,187533,Staff,25,0,25,0
1683656103377,TMC 2,A02,187534,Staff,25,0,25,0
1683656104406,USP 1,A01,187536,Kwak; Nancy,0,16,25,25
1683656105432,USP 5,A01,187538,Staff,9,0,25,16
1683656106461,USP 101,A00,199253,Staff,0,4,0,0
1683656107487,USP 124,A00,187562,Boomhower; Matthew Charles,0,0,30,30
1683656108515,USP 138,A00,187582,Staff,20,0,25,5
1683656109546,USP 152,A01,187597,Staff,3,0,25,22
1683656110572,USP 153,A00,187598,Staff,19,0,25,6
1683656111598,USP 168,A00,187607,Kwak; Nancy,2,0,5,3
1683656112627,USP 173,A00,187619,Staff,4,0,25,21
1683656113655,USP 181,A00,187638,Staff,0,4,25,25
1683656114684,VIS 103,A00,187650,Cruz; Edwin Teddy,18,0,75,57
1683656115709,VIS 110D,A00,187669,Staff,13,0,22,9
1683656116738,VIS 127C,A00,187720,Shen; Kuiyi,67,0,146,79
1683656117764,VIS 149,A00,187731,Yoldas; Pinar,0,14,22,22
1683656118791,VIS 151,A01,188091,Staff,22,0,34,12
1683656118791,VIS 151,A02,188092,Staff,11,0,34,23
1683656119818,VIS 160B,A00,188093,Stalbaum; Brett,0,1,10,10
1683656121869,WCWP 10B,A00,201720,Staff,10,0,15,5
1683656121869,WCWP 10B,B00,201722,Staff,9,0,15,6
1683656122896,WCWP 100,A00,201725,Gagnon; Jeffrey C,0,0,2,2
1683656122896,WCWP 100,B00,201727,Staff,0,4,15,15
1683656126024,ANBI 133,A00,258401,Wilder; Linnea Lorene,34,0,40,6
1683656127050,ANBI 140,A00,258395,Hrvoj Mihic; Branka,18,0,25,7
1683656128075,ANSC 120,A00,258402,Bialecki; Jon Anthony,26,0,40,14
1683656129102,ANSC 144,A00,258400,Staff,12,0,40,28
1683656131151,ANSC 166,A00,258396,Parish; Steven Martin,156,0,175,19
1683656132176,ANSC 180,A00,193533,Staff,8,0,20,12
1683656133205,ANSC 188,A00,258397,Jassal; Aftab,34,0,40,6
1683656134230,ANTH 3,A01,258316,Staff,23,0,30,7
1683656135256,ANTH 5,A00,258394,Semendeferi; Ekaterini,16,0,20,4
1683656136285,ANTH 21,A01,258331,Staff,4,0,40,36
1683656137313,ANTH 103,A00,258398,Varma; Saiba,15,0,25,10
1683656138347,AWP 10,001,202034,Staff,0,0,0,0
1683656138347,AWP 10,002,202035,Staff,0,0,0,0
1683656138347,AWP 10,003,202036,Staff,0,0,0,0
1683656138347,AWP 10,004,202037,Staff,0,0,0,0
1683656138347,AWP 10,005,202038,Staff,0,0,0,0
1683656138347,AWP 10,006,202039,Staff,0,0,0,0
1683656138347,AWP 10,007,202040,Staff,0,0,0,0
1683656138347,AWP 10,008,202041,Staff,0,0,0,0
1683656138347,AWP 10,009,202042,Staff,0,0,0,0
1683656138347,AWP 10,010,202043,Staff,0,0,0,0
1683656138347,AWP 10,011,202044,Staff,0,0,0,0
1683656138347,AWP 10,012,202045,Staff,0,0,0,0
1683656138347,AWP 10,013,202046,Staff,0,0,0,0
1683656138347,AWP 10,014,202047,Staff,0,0,0,0
1683656138347,AWP 10,015,202048,Staff,0,0,0,0
1683656138347,AWP 10,016,202049,Staff,0,0,0,0
1683656138347,AWP 10,017,202050,Staff,0,0,0,0
1683656138347,AWP 10,018,202051,Staff,0,0,0,0
1683656138347,AWP 10,019,202052,Staff,0,0,0,0
1683656138347,AWP 10,020,202053,Staff,0,0,0,0
1683656138347,AWP 10,021,202054,Staff,0,0,0,0
1683656138347,AWP 10,022,202055,Staff,0,0,0,0
1683656138347,AWP 10,023,202056,Staff,0,0,0,0
1683656138347,AWP 10,024,202057,Staff,0,0,0,0
1683656138347,AWP 10,025,202058,Staff,0,0,0,0
1683656138347,AWP 10,026,202059,Staff,0,0,0,0
1683656139376,AWP 102,001,202032,Staff,0,0,0,0
1683656139376,AWP 102,002,202033,Staff,0,0,0,0
1683656140404,BENG 100,A01,254234,Taylor Amos; Alyssa C,31,0,40,9
1683656141430,BENG 196,001,270013,Engler; Adam J.,9999,0,9999,0
1683656142460,BICD 100R,A01,202018,Smith; Laurie,0,7,32,32
1683656142460,BICD 100R,A02,202019,Smith; Laurie,0,3,32,32
1683656142460,BICD 100R,A03,202020,Smith; Laurie,0,1,32,32
1683656142460,BICD 100R,A04,202021,Smith; Laurie,6,0,32,26
1683656142460,BICD 100R,A05,202022,Smith; Laurie,11,0,32,21
1683656143488,BICD 136,A01,193242,Gustafson-Brown; Cindy,0,2,32,32
1683656143488,BICD 136,A02,193244,Gustafson-Brown; Cindy,13,0,32,19
1683656144518,BIEB 102,A01,193249,Butler; Shannon Rhey,0,2,32,32
1683656144518,BIEB 102,A02,193251,Butler; Shannon Rhey,0,0,32,32
1683656144518,BIEB 102,A03,193253,Butler; Shannon Rhey,0,0,32,32
1683656144518,BIEB 102,A04,193255,Butler; Shannon Rhey,14,0,32,18
1683656144518,BIEB 102,A05,193265,Butler; Shannon Rhey,26,0,32,6
1683656144518,BIEB 102,A06,193269,Butler; Shannon Rhey,14,0,32,18
1683656146577,BIEB 150,A01,193274,Staff,0,0,32,32
1683656146577,BIEB 150,A02,193285,Staff,24,0,32,8
1683656147609,BIEB 194,A00,193286,Kurle; Carolyn M.,20,0,32,12
1683656148646,BILD 1,A01,192291,Staff,15,0,32,17
1683656148646,BILD 1,A02,192292,Staff,30,0,32,2
1683656148646,BILD 1,B01,192520,Reuther; Keefe,0,1,0,0
1683656148646,BILD 1,B02,192532,Reuther; Keefe,0,1,0,0
1683656149673,BILD 3,A01,192556,Butler; Shannon Rhey,0,0,32,32
1683656149673,BILD 3,A02,192581,Butler; Shannon Rhey,1,0,32,31
1683656149673,BILD 3,A03,192611,Butler; Shannon Rhey,21,0,32,11
1683656149673,BILD 3,A04,192612,Butler; Shannon Rhey,24,0,32,8
1683656149673,BILD 3,A05,192613,Butler; Shannon Rhey,26,0,32,6
1683656149673,BILD 3,A06,192679,Butler; Shannon Rhey,27,0,32,5
1683656149673,BILD 3,A07,192682,Butler; Shannon Rhey,20,0,32,12
1683656150704,BILD 4,A01,192836,Reuther; Keefe,1,0,24,23
1683656150704,BILD 4,A02,193044,Reuther; Keefe,4,0,24,20
1683656151730,BILD 10,A01,193142,Gustafson-Brown; Cindy,29,0,32,3
1683656151730,BILD 10,A02,193149,Gustafson-Brown; Cindy,31,0,32,1
1683656152760,BIMM 100,A01,193301,Staff,0,6,32,32
1683656152760,BIMM 100,A02,193312,Staff,0,7,32,32
1683656152760,BIMM 100,A03,193323,Staff,0,9,32,32
1683656153788,BIMM 101,A01,193329,McDonnell; Lisa Marie,0,4,24,24
1683656153788,BIMM 101,A02,193339,McDonnell; Lisa Marie,1,3,24,23
1683656153788,BIMM 101,B01,193354,McDonnell; Lisa Marie,0,4,24,24
1683656153788,BIMM 101,B02,193357,McDonnell; Lisa Marie,0,3,24,24
1683656154819,BIMM 110,A01,193377,Tat; John,0,11,32,32
1683656154819,BIMM 110,A02,193378,Tat; John,0,10,32,32
1683656155849,BIMM 120,A01,206116,Staff,0,0,32,32
1683656155849,BIMM 120,A02,206117,Staff,6,0,32,26
1683656155849,BIMM 120,A03,206121,Staff,21,0,32,11
1683656156880,BIPN 100,A01,193393,Park; Ji Young,0,15,32,32
1683656156880,BIPN 100,A02,193402,Park; Ji Young,0,14,32,32
1683656156880,BIPN 100,A03,193413,Park; Ji Young,0,14,32,32
1683656156880,BIPN 100,A04,193414,Park; Ji Young,0,13,32,32
1683656157909,BIPN 102,A01,193429,Staff,0,0,32,32
1683656157909,BIPN 102,A02,193438,Staff,18,0,32,14
1683656158935,BIPN 106,A01,193450,Reyes Gonzalez; Catalina,0,2,40,40
1683656159966,BIPN 134,A01,193465,Cooke; James Edward,0,0,32,32
1683656159966,BIPN 134,A02,193474,Cooke; James Edward,25,0,32,7
1683656159966,BIPN 134,A03,193485,Cooke; James Edward,29,0,32,3
1683656159966,BIPN 134,A04,193486,Cooke; James Edward,20,0,32,12
1683656159966,BIPN 134,A05,193491,Cooke; James Edward,31,0,32,1
1683656159966,BIPN 134,A06,193501,Cooke; James Edward,30,0,32,2
1683656159966,BIPN 134,A07,193510,Cooke; James Edward,29,0,32,3
1683656162025,BISP 194,A00,222522,Staff,14,0,32,18
1683656163050,CAT 124,A01,202407,Staff,19,0,25,6
1683656164081,CAT 125,A00,202408,Marchisotto; Jennifer Anne,2,0,20,18
1683656165112,CAT 125R,A00,202409,Smith; Lauryn Alissa,0,11,20,20
1683656165112,CAT 125R,B00,202410,Morales; Celeste Georgianna,0,11,20,20
1683656165112,CAT 125R,C00,202411,Irwin; Matthew Joseph,0,12,20,20
1683656166145,CENG 15,A01,204712,Yang; Kesong,0,1,0,0
1683656167173,CENG 114,A00,202070,Jahed Motlagh; Zeinab,5,0,20,15
1683656168200,CGS 105,A00,185477,Wesling; Megan E.,24,0,40,16
1683656169285,CGS 106,A00,185494,Staff,11,0,22,11
1683656170318,CGS 108,A00,185495,Staff,14,0,20,6
1683656171344,CGS 114,A00,185496,Staff,13,0,18,5
1683656172370,CGS 119,A00,185501,Staff,15,0,20,5
1683656173400,CGS 120,A00,185511,Staff,12,0,20,8
1683656174428,CHEM 4,A01,184675,Bussey; Thomas J,97,0,100,3
1683656175454,CHEM 6A,A01,184677,Staff,33,0,60,27
1683656176483,CHEM 6B,A01,184679,Staff,63,0,100,37
1683656177514,CHEM 6C,A01,184681,Bussey; Thomas J,0,0,50,50
1683656177514,CHEM 6C,A02,184682,Bussey; Thomas J,32,0,50,18
1683656178544,CHEM 40A,A01,184684,Albizati; Kim F.,34,0,100,66
1683656179570,CHEM 40B,A01,184686,Albizati; Kim F.,0,22,100,100
1683656180600,CHEM 41B,A01,184690,Staff,51,0,100,49
1683656181626,COGS 3,A01,184715,Boyle; Mary E. T.,0,27,40,40
1683656182656,COGS 14B,A01,185172,Staff,0,14,38,38
1683656183689,COGS 18,A01,184736,Staff,14,0,80,66
1683656184719,COGS 100,A01,184932,Staff,0,7,73,73
1683656185748,COGS 101A,A01,184935,Staff,0,39,30,30
1683656186774,COGS 101B,A01,184944,Staff,0,2,30,30
1683656187800,COGS 101C,A01,184946,Staff,0,10,30,30
1683656188827,COGS 102A,A01,184951,Johnson; Christine M.,2,0,40,38
1683656189858,COGS 107B,A01,184953,Mooshagian; Eric Frederick,0,51,40,40
1683656190889,COGS 118B,A01,184959,Gupta; Anjum,0,49,40,40
1683656191917,COGS 153,A00,184961,Staff,0,16,30,30
1683656192945,COGS 177,A00,184962,Staff,0,21,30,30
1683656193972,COGS 187A,A01,184969,Boyle; Mary E. T.,0,19,40,40
1683656194998,COMM 10,A01,185174,Staff,0,5,25,25
1683656194998,COMM 10,A02,185189,Staff,0,2,25,25
1683656194998,COMM 10,A03,269821,Staff,0,1,0,0
1683656196023,COMM 100B,A01,185475,Staff,0,1,0,2
1683656196023,COMM 100B,A02,185476,Staff,12,0,25,13
1683656197049,COMM 100C,A01,185314,Staff,1,0,25,24
1683656197049,COMM 100C,A02,185327,Staff,18,0,25,7
1683656198074,COMM 110M,A00,185349,Staff,0,0,40,40
1683656199102,COMM 113T,A00,185352,Staff,25,0,40,15
1683656200128,COMM 114I,A00,185353,Staff,31,0,40,9
1683656201157,COMM 131,A00,185354,Staff,17,0,30,13
1683656202184,CSE 8A,A50,185358,Cao; Yingjun,0,46,10,10
1683656203211,CSE 8B,A01,185362,Staff,0,48,50,50
1683656204241,CSE 11,A01,185416,Cao; Yingjun,0,91,10,10
1683656205267,CSE 20,A01,185445,Briones; Jor-el Thomas Caparas,4,0,25,21
1683656206294,CSE 21,A01,185447,Staff,9,0,50,41
1683656207320,CSE 101,A01,185451,Staff,0,13,50,50
1683656207320,CSE 101,B01,185453,Jones; Miles E,0,13,50,50
1683656209375,CSE 141,A01,185458,Eldon; John,16,0,100,84
1683656210401,CSE 141L,A01,185461,Eldon; John,8,0,100,92
1683656211431,CSE 142,A01,185463,Staff,35,0,60,25
1683656211431,CSE 142,B01,201355,Staff,0,7,60,60
1683656212456,CSE 142L,A01,185470,Staff,35,0,60,25
1683656212456,CSE 142L,B01,201417,Staff,0,6,60,60
1683656213483,CSE 190,A00,201433,Staff,32,0,49,17
1683656214510,DOC 1,A01,259136,Strom; Megan C.,7,0,15,8
1683656214510,DOC 1,A02,259137,Strom; Megan C.,14,0,15,1
1683656214510,DOC 1,A03,259138,Strom; Megan C.,14,0,15,1
1683656214510,DOC 1,A04,259139,Strom; Megan C.,14,0,15,1
1683656215538,DOC 100D,A00,259140,Pass; Natalye Joann,14,0,25,11
1683656216565,DSGN 1,A01,184749,Rill; Bryan,0,26,30,30
1683656217592,DSGN 100,A01,185168,Staff,0,2,25,25
1683656218621,ECE 5,A01,185626,Morris; Karcher William,0,11,0,0
1683656219648,ECE 101,A01,185628,Staff,14,0,70,56
1683656220671,ECE 107,A01,185635,Baghdadchi; Saharnaz,0,0,20,20
1683656220671,ECE 107,A02,185638,Baghdadchi; Saharnaz,2,0,20,18
1683656221701,ECE 148,A01,185647,Silberman; Jack,0,0,16,16
1683656222725,ECON 1,A01,185537,Crane; Meredith Helen,54,0,70,16
1683656223752,ECON 3,A01,185549,Crane; Meredith Helen,29,0,70,41
1683656224779,ECON 4,A01,203354,Anderson; John Charles,0,5,10,10
1683656225803,ECON 100A,A01,185574,Staff,0,5,40,40
1683656226832,ECON 100B,A01,185576,Staff,0,12,50,50
1683656227857,ECON 100C,A01,185589,Newhouse; Herbert S,30,0,70,40
1683656228884,ECON 105,A00,185608,Vespa; Emanuel Ignacio,19,0,35,16
1683656229910,ECON 109,A01,185610,Shishkin; Denis,9,0,35,26
1683656230935,ECON 110A,A01,185612,Staff,9,0,40,31
1683656231966,ECON 120A,A01,185615,Staff,20,0,40,20
1683656232993,ECON 120C,A01,185617,Sun; Yixiao,0,20,70,70
1683656234022,ECON 144,A00,203346,Squires; Dale E,2,0,35,33
1683656235049,ECON 171,A01,203349,Newhouse; Herbert S,0,1,35,35
1683656236075,ECON 173A,A01,185621,Toda; Alexis Akira,21,0,35,14
1683656237106,EDS 25,A01,202413,Staff,0,1,0,0
1683656237106,EDS 25,A02,202414,Staff,0,1,0,0
1683656237106,EDS 25,A03,202415,Staff,0,0,0,0
1683656237106,EDS 25,A04,202416,Staff,0,1,0,0
1683656237106,EDS 25,A05,202439,Staff,0,0,0,0
1683656237106,EDS 25,A06,202440,Staff,0,0,0,0
1683656237106,EDS 25,B01,202631,Staff,0,0,0,0
1683656237106,EDS 25,B02,202632,Staff,0,0,0,0
1683656237106,EDS 25,B03,202639,Staff,0,0,0,0
1683656237106,EDS 25,B04,202640,Staff,0,0,0,0
1683656237106,EDS 25,B05,202643,Staff,0,0,0,0
1683656237106,EDS 25,B06,202644,Staff,0,0,0,0
1683656238131,EDS 38,A01,202659,Black; Alison Michelle,24,0,25,1
1683656239157,EDS 115,A00,202652,Staff,18,0,30,12
1683656240185,EDS 125,A00,202649,Staff,13,0,30,17
1683656241211,EDS 126,A01,203332,Staff,30,0,30,0
1683656242236,EDS 139,A00,202838,Staff,16,0,25,9
1683656243264,EDS 146,A01,202655,Staff,14,0,25,11
1683656244293,ENG 15,A00,185667,Staff,0,1,0,0
1683656244293,ENG 15,B00,185672,Staff,0,0,0,0
1683656244293,ENG 15,C00,185675,Staff,0,0,0,0
1683656244293,ENG 15,D00,185682,Staff,0,0,0,0
1683656244293,ENG 15,E00,185684,Staff,0,0,0,0
1683656245318,ETHN 103,A00,185710,Staff,0,8,35,35
1683656246344,ETHN 103A,A00,199228,Man; Simeon S,0,0,9,9
1683656247370,ETHN 109,A00,185711,Staff,16,0,35,19
1683656248396,ETHN 142,A00,185726,Staff,0,4,30,30
1683656249424,ETHN 163J,A00,199229,Man; Simeon S,5,0,8,3
1683656250449,ETHN 168,A00,185727,Staff,7,0,10,3
1683656251476,ETHN 182,A00,185728,Staff,0,0,35,35
1683656252509,ETHN 183,A00,185737,Staff,9,0,18,9
1683656253538,GLBH 111,A01,209361,Burgos; Jose L.,0,0,0,0
1683656255596,HIEU 104,A00,185792,Staff,14,0,20,6
1683656256621,HIEU 115,A00,185800,Staff,0,0,20,20
1683656257647,HIEU 128,A00,185801,Staff,0,9,20,20
1683656258673,HIEU 147,A00,185802,Staff,15,0,20,5
1683656259699,HIEU 154,A00,185823,Staff,11,0,20,9
1683656260727,HILA 102,A00,185826,Staff,14,0,20,6
1683656261751,HILD 2C,A01,185778,Staff,0,13,20,20
1683656262780,HILD 7B,A01,185780,Kwak; Nancy,0,16,32,32
1683656262780,HILD 7B,A02,185781,Kwak; Nancy,0,18,32,32
1683656263805,HILD 30,A01,185791,Staff,12,0,20,8
1683656264833,HISC 119,A00,185830,Golan; Tal,0,9,20,20
1683656265859,HITO 156GS,A00,185831,Patterson; Patrick H.,0,0,0,23
1683656266887,HIUS 103,A00,185832,Man; Simeon S,0,4,20,20
1683656267913,HIUS 117,A00,185836,Kwak; Nancy,2,0,20,18
1683656268939,HIUS 125,A00,185840,Man; Simeon S,0,2,23,23
1683656269968,HIUS 149,A00,185845,Staff,1,0,20,19
1683656270993,HUM 3,A01,185882,Zavodny; Tatiana Sophia,0,8,50,50
1683656270993,HUM 3,B01,185899,Caldwell; Michael Alan,0,18,50,50
1683656272020,HUM 3GS,A00,185900,Patterson; Patrick H.,0,0,0,23
1683656273104,HUM 4,A01,185938,Zroka; Amy Liane,29,0,50,21
1683656273104,HUM 4,B01,185956,Watkins; Eric,0,4,50,50
1683656273104,HUM 4,B02,202209,Watkins; Eric,0,5,50,50
1683656273104,HUM 4,B03,202210,Watkins; Eric,0,5,50,50
1683656274136,HUM 5,A01,185958,West; Geoffrey Scott,1,0,50,49
1683656274136,HUM 5,A02,202215,West; Geoffrey Scott,0,0,50,50
1683656275165,INTL 190,A00,185959,Gagnon; Jeffrey C,0,0,0,9
1683656275165,INTL 190,B00,185960,Lettieri; Michael Joseph,0,0,0,2
1683656276195,JAPN 180,A00,254509,Staff,5,0,30,25
1683656277226,LATI 10,A01,202853,Kennemore; Amy Michelle,4,0,35,31
1683656277226,LATI 10,A02,202854,Kennemore; Amy Michelle,2,0,35,33
1683656277226,LATI 10,A03,270054,Kennemore; Amy Michelle,30,0,30,0
1683656278249,LATI 180,A00,202855,Kennemore; Amy Michelle,11,0,20,9
1683656279279,LAWS 101,A00,201767,Golan; Tal,0,7,40,40
1683656280306,LIFR 1C,A00,185961,Staff,6,0,20,14
1683656281331,LIFR 1CX,A00,185962,Staff,7,0,20,13
1683656282358,LIFR 1D,A00,185963,Staff,7,0,20,13
1683656283384,LIFR 1DX,A00,185964,Staff,7,0,20,13
1683656284414,LIGN 101,A01,186039,Staff,43,0,50,7
1683656285442,LIGN 165,A00,186040,Staff,15,0,50,35
1683656286469,LTCS 108,A00,186041,Staff,5,0,10,5
1683656287497,LTCS 119,A00,186042,Staff,15,0,20,5
1683656288527,LTCS 130,A00,186043,Wesling; Megan E.,15,0,25,10
1683656290584,LTEA 138,A00,186119,Staff,14,0,40,26
1683656291613,LTEN 124,A00,186148,Staff,5,0,25,20
1683656292641,LTEN 178,A00,186149,Staff,7,0,15,8
1683656293670,LTEN 181,A00,186150,Blanco; John D,34,0,40,6
1683656294699,LTWL 120,A00,186160,Staff,20,0,25,5
1683656295725,LTWL 165,A00,186161,Staff,22,0,25,3
1683656296758,LTWR 100,A00,186162,Staff,0,5,15,15
1683656297784,LTWR 102,A00,186163,Doller; Ben,5,0,15,10
1683656298813,MAE 8,A01,186412,Staff,0,0,0,0
1683656299840,MAE 30B,A00,186445,Bahadori; Mohammad Yousef,82,0,100,18
1683656300866,MAE 40,A00,186592,Bewley; Thomas R,10,0,50,40
1683656301893,MAE 101B,A00,186593,Bahadori; Mohammad Yousef,80,0,100,20
1683656302921,MAE 105,A00,186594,Bandaru; Prabhakar,10,0,50,40
1683656303952,MAE 107,A00,186599,Pham; Hieu Tan,0,7,120,120
1683656304981,MAE 148,A01,186660,Silberman; Jack,3,0,16,13
1683656306005,MATH 10A,A01,188095,Staff,0,6,35,35
1683656307034,MATH 10B,A01,188097,Bowers; Adam R.,0,12,30,30
1683656307034,MATH 10B,A02,188099,Bowers; Adam R.,0,11,30,30
1683656307034,MATH 10B,B01,188104,Bowers; Adam R.,0,10,30,30
1683656307034,MATH 10B,B02,188106,Bowers; Adam R.,1,9,30,29
1683656308061,MATH 10C,A01,188111,Staff,0,18,30,30
1683656308061,MATH 10C,A02,188127,Staff,0,19,30,30
1683656308061,MATH 10C,A03,188131,Staff,0,19,30,30
1683656308061,MATH 10C,B01,188218,Staff,17,0,30,13
1683656308061,MATH 10C,B02,188244,Staff,13,0,30,17
1683656308061,MATH 10C,B03,188277,Staff,14,0,30,16
1683656309090,MATH 18,A01,188344,Bach; Quang Tran,18,0,30,12
1683656309090,MATH 18,A02,188345,Bach; Quang Tran,11,0,30,19
1683656309090,MATH 18,B01,188353,Bach; Quang Tran,11,0,30,19
1683656309090,MATH 18,B02,188354,Bach; Quang Tran,19,0,30,11
1683656310116,MATH 20A,A01,188374,Staff,11,0,35,24
1683656311143,MATH 20B,A01,188382,Ohm; Ko Woon,7,0,30,23
1683656311143,MATH 20B,A02,188383,Ohm; Ko Woon,22,0,30,8
1683656311143,MATH 20B,B01,188385,Ohm; Ko Woon,7,0,30,23
1683656311143,MATH 20B,B02,188392,Ohm; Ko Woon,22,0,30,8
1683656312167,MATH 20C,A01,188394,Harel; Guershon,11,0,30,19
1683656312167,MATH 20C,A02,188395,Harel; Guershon,13,0,30,17
1683656312167,MATH 20C,B01,188404,Harel; Guershon,5,0,30,25
1683656312167,MATH 20C,B02,188405,Harel; Guershon,18,0,30,12
1683656313195,MATH 20D,A01,188414,Hammock; Frances H,0,1,30,30
1683656313195,MATH 20D,A02,188415,Hammock; Frances H,0,1,30,30
1683656313195,MATH 20D,B01,188447,Hammock; Frances H,0,1,30,30
1683656313195,MATH 20D,B02,188486,Hammock; Frances H,4,0,30,26
1683656314219,MATH 20E,A01,188649,Staff,21,0,30,9
1683656314219,MATH 20E,A02,188650,Staff,21,0,30,9
1683656314219,MATH 20E,A03,188673,Staff,0,0,30,30
1683656315249,MATH 102,A01,188675,Staff,0,36,35,35
1683656316285,MATH 103B,A01,188681,Staff,3,0,35,32
1683656316285,MATH 103B,B01,188692,Staff,5,0,35,30
1683656317311,MATH 109,A01,188695,Salehi Golsefidy; Alireza,24,0,35,11
1683656317311,MATH 109,A02,188696,Salehi Golsefidy; Alireza,25,0,35,10
1683656318337,MATH 120A,A01,188698,Eggers; John Dietrich,7,0,35,28
1683656319363,MATH 142B,A01,188736,Ioana; Adrian,0,1,30,30
1683656319363,MATH 142B,A02,188741,Ioana; Adrian,0,1,30,30
1683656319363,MATH 142B,A03,188743,Ioana; Adrian,0,1,30,30
1683656320391,MATH 168A,A01,188790,Staff,0,10,35,35
1683656321421,MATH 170A,A01,188803,Nie; Jiawang,0,2,35,35
1683656321421,MATH 170A,A02,188811,Nie; Jiawang,0,0,35,35
1683656321421,MATH 170A,A03,188814,Nie; Jiawang,0,0,35,35
1683656321421,MATH 170A,A04,188815,Nie; Jiawang,10,0,35,25
1683656322452,MATH 193B,A01,188817,Staff,0,0,35,35
1683656322452,MATH 193B,A02,188818,Staff,5,0,35,30
1683656323477,MGT 4,A01,202857,Anderson; John Charles,61,0,80,19
1683656324504,MGT 12,A00,202858,Lindenberger; Wade Douglas,40,0,90,50
1683656325533,MGT 18,A00,202859,Staff,74,0,90,16
1683656326559,MGT 18GS,A00,202860,McKay; Michael J,13,0,28,15
1683656327589,MGT 45,A00,202861,Pecore; Joseph P.,12,0,90,78
1683656328616,MGT 100,A00,202863,Yavorsky; Daniel Ryan,28,0,90,62
1683656329646,MGT 103,A00,202864,Ehrich; Kristine R,0,17,90,90
1683656330672,MGT 112,A00,202865,Ehrich; Kristine R,15,0,90,75
1683656331698,MGT 121A,A00,202868,Staff,90,20,90,0
1683656332726,MGT 131B,A00,202869,Anderson; John Charles,59,0,90,31
1683656333752,MGT 136,A00,202871,Lindenberger; Wade Douglas,83,0,90,7
1683656334782,MGT 164,A00,202873,Staff,0,66,90,91
1683656335806,MGT 164GS,A00,202874,McKay; Mary A,13,0,28,15
1683656336835,MGT 180,A00,202875,Staff,0,50,90,91
1683656337861,MMW 11R,A01,205019,Herbst; Matthew,2,0,30,28
1683656337861,MMW 11R,A02,205026,Herbst; Matthew,29,0,30,1
1683656338887,MMW 15,A01,193512,Chang; Edmond Yi-Teh,0,8,28,28
1683656338887,MMW 15,A02,193513,Chang; Edmond Yi-Teh,0,5,28,28
1683656338887,MMW 15,A03,193514,Chang; Edmond Yi-Teh,0,5,28,28
1683656338887,MMW 15,A04,193515,Chang; Edmond Yi-Teh,0,5,28,28
1683656338887,MMW 15,A05,193516,Chang; Edmond Yi-Teh,0,5,28,28
1683656338887,MMW 15,A06,193517,Chang; Edmond Yi-Teh,0,6,28,28
1683656338887,MMW 15,B01,193519,Chang; Edmond Yi-Teh,0,5,28,28
1683656338887,MMW 15,B02,193520,Chang; Edmond Yi-Teh,0,5,28,28
1683656338887,MMW 15,B03,193521,Chang; Edmond Yi-Teh,0,5,28,28
1683656338887,MMW 15,B04,193522,Chang; Edmond Yi-Teh,0,5,28,28
1683656338887,MMW 15,B05,193523,Chang; Edmond Yi-Teh,0,5,28,28
1683656338887,MMW 15,B06,193524,Chang; Edmond Yi-Teh,0,5,28,28
1683656339912,MMW 122,A01,193526,Rahimi; Babak,0,16,28,28
1683656339912,MMW 122,A02,193527,Rahimi; Babak,0,15,28,28
1683656339912,MMW 122,A03,193528,Rahimi; Babak,0,0,0,0
1683656339912,MMW 122,A04,193529,Rahimi; Babak,0,0,0,0
1683656340939,MUS 1A,A01,186663,Staff,1,20,35,34
1683656341971,MUS 4,A01,186715,Staff,0,12,35,35
1683656342997,MUS 5R,A01,186796,Dubnov; Shlomo,0,17,35,35
1683656344024,MUS 6,A01,186798,Staff,0,5,25,25
1683656345047,MUS 7,A01,186830,Staff,11,0,35,24
1683656346075,MUS 8,A01,186930,Staff,0,26,35,35
1683656347100,MUS 15,A01,186932,Staff,0,16,35,35
1683656347100,MUS 15,B01,186934,Staff,0,17,35,35
1683656348127,MUS 80,A00,186935,Staff,0,0,20,20
1683656348127,MUS 80,B00,186936,Staff,24,0,25,1
1683656349152,NANO 11,A00,204702,Lipomi; Darren John,0,0,0,0
1683656350176,NANO 15,A01,204709,Yang; Kesong,0,1,0,0
1683656351201,NANO 114,A00,202069,Jahed Motlagh; Zeinab,3,0,10,7
1683656352230,PHIL 1,A00,186955,Grush; Rick Scott,31,0,40,9
1683656353484,PHIL 10,A01,186973,Grush; Rick Scott,27,0,35,8
1683656353484,PHIL 10,A02,186974,Grush; Rick Scott,33,0,35,2
1683656354512,PHIL 13,A01,186976,Staff,3,0,35,32
1683656354512,PHIL 13,A02,186977,Staff,16,0,35,19
1683656355539,PHIL 14,A01,186979,Staff,31,0,35,4
1683656355539,PHIL 14,A02,186986,Staff,32,0,35,3
1683656356566,PHIL 28,A01,186988,Staff,16,0,30,14
1683656356566,PHIL 28,A02,186989,Staff,1,0,30,29
1683656356566,PHIL 28,A03,186990,Staff,10,0,30,20
1683656356566,PHIL 28,A04,186991,Staff,26,0,30,4
1683656357593,PHIL 120,A00,186997,Staff,23,0,40,17
1683656358619,PHIL 137,A00,187003,Staff,7,0,40,33
1683656359645,PHIL 150,A00,187015,Staff,47,0,70,23
1683656360674,PHIL 167,A00,187021,Lamey; Andy M.,34,0,40,6
1683656361699,PHIL 174,A01,202226,Staff,17,0,20,3
1683656361699,PHIL 174,A02,202235,Staff,20,0,20,0
1683656362729,PHIL 191A,A00,258918,Staff,0,0,1,1
1683656363758,PHYS 1A,A00,187028,Staff,26,0,60,34
1683656364785,PHYS 1AL,001,187036,Staff,3,0,30,27
1683656364785,PHYS 1AL,002,187049,Staff,18,0,30,12
1683656365814,PHYS 1B,A00,187058,Staff,22,0,60,38
1683656366842,PHYS 1BL,001,187064,Staff,0,1,30,30
1683656366842,PHYS 1BL,002,187070,Staff,4,0,30,26
1683656367869,PHYS 1C,A00,187082,Staff,29,0,120,91
1683656368897,PHYS 1CL,001,187088,Staff,0,9,30,30
1683656368897,PHYS 1CL,002,187089,Staff,0,1,30,30
1683656368897,PHYS 1CL,009,262693,Staff,9,0,30,21
1683656369922,PHYS 2B,A01,187097,Staff,55,0,115,60
1683656370952,PHYS 2C,A01,187099,Staff,63,0,115,52
1683656371978,PHYS 2CL,A01,187101,Staff,5,0,28,23
1683656371978,PHYS 2CL,A02,187102,Staff,15,0,28,13
1683656373006,PHYS 2D,A01,187123,Shotwell; Brian,95,0,115,20
1683656374033,PHYS 4B,A01,187133,Grinstein; Benjamin,35,0,50,15
1683656375060,POLI 10,A00,188819,Staff,0,4,50,50
1683656376085,POLI 11,A00,188827,Staff,43,0,50,7
1683656377183,POLI 13R,A00,188828,Staff,0,1,20,20
1683656378214,POLI 27,A01,188830,Elgin; Samuel Zincke,0,2,70,70
1683656379242,POLI 30,A00,188832,Desposato; Scott,30,0,50,20
1683656380268,POLI 102F,A00,188834,Staff,0,0,40,40
1683656381295,POLI 104A,A00,188852,Staff,13,0,30,17
1683656382320,POLI 104I,A00,188853,Staff,0,7,20,20
1683656383348,POLI 110B,A00,188854,Wiens; David,6,0,20,14
1683656384374,POLI 112A,A00,188855,Wiens; David,3,0,30,27
1683656385400,POLI 117R,A00,188856,Forman; Fonna,0,12,20,20
1683656386427,POLI 118,A00,188857,Ingham; Sean,8,0,20,12
1683656387454,POLI 120G,A00,188858,Staff,8,0,30,22
1683656388482,POLI 131CR,A00,188863,Hoston; Germaine,21,0,50,29
1683656389511,POLI 133,A00,188864,Nellis; Gareth Hb,44,0,50,6
1683656393889,POLI 134D,A00,188865,Desposato; Scott,27,0,30,3
1683656394914,POLI 142A,A00,188871,Gartzke; Erik,21,0,50,29
1683656395941,POLI 142K,A00,188874,Staff,38,0,50,12
1683656396967,POLI 143,A00,188940,Gartzke; Erik,16,0,30,14
1683656397992,POLI 153,A00,188943,Staff,2,0,20,18
1683656399018,POLI 160AA,A00,188944,Staff,11,0,40,29
1683656400046,POLI 170A,A00,188945,Staff,11,0,30,19
1683656402101,PSYC 1,A00,188952,Staff,36,0,90,54
1683656403128,PSYC 2,B00,188953,Staff,19,0,35,16
1683656404156,PSYC 6,A00,188970,Staff,47,0,60,13
1683656405182,PSYC 7,A00,188973,Staff,35,0,45,10
1683656406210,PSYC 60,A01,188980,Rickard; Timothy C.,42,0,60,18
1683656407235,PSYC 70,A01,189001,Steiner; Eric Tomas,22,0,45,23
1683656408262,PSYC 100,A00,189005,Lacefield; Katharine I,0,99,120,120
1683656409291,PSYC 102,A00,189008,Staff,8,0,30,22
1683656410319,PSYC 106,B00,189026,Gorman; Michael R.,27,0,60,33
1683656411345,PSYC 114,B01,189033,Winkielman; Piotr,0,31,30,30
1683656412371,PSYC 131,A00,189036,Anagnostaras; Stephan,0,43,60,60
1683656413402,PSYC 136,A00,189041,Lowe; Angela Beth,0,7,25,25
1683656414428,PSYC 137,A00,189057,Winkielman; Piotr,0,37,25,25
1683656415457,PSYC 144,A00,189107,Wixted; John T,0,11,50,50
1683656417517,PSYC 162,A00,189142,Staff,0,9,85,85
1683656418545,PSYC 172,A00,189144,Gorman; Michael R.,0,6,30,30
1683656420601,PSYC 179,A00,189146,Lacefield; Katharine I,0,87,120,120
1683656421629,PSYC 181,A00,189147,Anagnostaras; Stephan,0,44,90,90
1683656422654,PSYC 190R,A00,189148,Barner; David A.,0,23,80,80
1683656423684,PSYC 191,A00,189275,Rickard; Timothy C.,0,10,25,25
1683656424713,PSYC 193,A00,189276,Chapman; Eddie Nathaniel,0,1,0,4
1683656425742,PSYC 193L,A01,189281,Lowe; Angela Beth,10,0,20,10
1683656425742,PSYC 193L,B01,189285,Staff,28,0,35,7
1683656426772,RELI 149,A00,187137,Rahimi; Babak,7,0,40,33
1683656427798,SE 9,A01,187315,Staff,0,2,18,18
1683656428824,SE 101B,A00,187409,Staff,24,0,30,6
1683656429850,SE 110B,A00,187444,Staff,10,0,40,30
1683656430876,SE 130B,A00,187449,Staff,31,0,40,9
1683656431904,SE 150A,A00,187516,Staff,9,0,20,11
1683656432930,SE 154,A00,187528,Staff,29,0,50,21
1683656433958,SIO 3,A01,258171,Staff,35,0,40,5
1683656434987,SIO 10,A00,187144,Cook; Geoffrey W,0,6,75,75
1683656436013,SIO 45,A00,187152,Cook; Geoffrey W,0,4,100,100
1683656437038,SIO 109R,A00,194486,Staff,0,4,20,20
1683656439097,SIO 187,A01,187233,Kacev; David,12,0,40,28
1683656440121,SOCI 1,A01,258656,Thorpe; Charles Robert,28,0,30,2
1683656440121,SOCI 1,A02,258658,Thorpe; Charles Robert,30,0,30,0
1683656440121,SOCI 1,A03,258661,Thorpe; Charles Robert,25,0,25,0
1683656440121,SOCI 1,A04,258666,Thorpe; Charles Robert,22,0,25,3
1683656440121,SOCI 1,A05,258897,Thorpe; Charles Robert,22,0,25,3
1683656440121,SOCI 1,A06,258898,Thorpe; Charles Robert,25,0,25,0
1683656441152,SOCI 30,A01,258903,Pardo Guerra; Juan Pablo,14,0,30,16
1683656442176,SOCI 102,A00,258904,Staff,9,0,25,16
1683656443206,SOCI 106,A00,258905,Staff,19,0,25,6
1683656444232,SOCI 111,A00,258907,Ribas Norris; Janet Vanesa,26,0,30,4
1683656445257,SOCI 121R,A00,258908,Pardo Guerra; Juan Pablo,8,0,30,22
1683656446282,SOCI 126,A01,203330,Staff,14,0,20,6
1683656447312,SOCI 131,A00,258909,Thorpe; Charles Robert,30,0,60,30
1683656448342,SOCI 135,A00,258910,Payne; Christine Anna,0,11,30,30
1683656449374,SOCI 157,A00,258911,Staff,12,0,30,18
1683656450399,SOCI 184,A00,258912,Staff,25,0,30,5
1683656451428,SOCI 188D,A00,258913,Staff,22,0,30,8
1683656452450,SYN 2,001,187529,Staff,9,0,16,7
1683656452450,SYN 2,002,201452,Staff,0,20,16,16
1683656452450,SYN 2,003,201469,Staff,2,0,16,14
1683656453476,SYN 100,A01,187531,Staff,0,9,20,20
1683656453476,SYN 100,B01,201491,Staff,0,10,20,20
1683656454503,TDAC 1,A00,189286,Walsh; Kim C.,3,0,20,17
1683656454503,TDAC 1,B00,189287,Harting; Carla Kelso,10,0,20,10
1683656455527,TDAC 101,A00,189300,Walsh; Kim C.,16,0,20,4
1683656455527,TDAC 101,B00,189301,Harting; Carla Kelso,18,0,20,2
1683656456556,TDAC 102,A00,189304,Basso; Beatrice,14,0,20,6
1683656457585,TDAC 108,A00,189305,Staff,18,0,20,2
1683656458618,TDDE 131,A00,189310,Staff,19,0,20,1
1683656458618,TDDE 131,B00,189314,Staff,19,0,20,1
1683656458618,TDDE 131,C00,189315,Staff,48,0,50,2
1683656458618,TDDE 131,D00,189316,Staff,14,0,15,1
1683656458618,TDDE 131,E00,204841,Staff,20,0,20,0
1683656459647,TDGE 10,A00,189289,Staff,27,0,50,23
1683656459647,TDGE 10,B00,189290,Havis; Allan,0,0,50,50
1683656460674,TDGE 11,A00,189291,Fulton; Julia,0,4,50,50
1683656460674,TDGE 11,B00,189292,Staff,20,0,25,5
1683656460674,TDGE 11,C00,260270,Staff,0,0,0,0
1683656461702,TDGE 25,A00,189294,Staff,2,0,20,18
1683656462731,TDGE 124,A00,189318,Fulton; Julia,0,8,50,50
1683656463759,TDGE 125,A00,189319,Staff,13,0,25,12
1683656463759,TDGE 125,B00,189320,Staff,23,0,25,2
1683656464788,TDGE 127,A00,189322,Havis; Allan,0,0,50,50
1683656465813,TDHT 101,A00,189323,Staff,18,0,25,7
1683656465813,TDHT 101,B00,189324,Staff,25,0,25,0
1683656466840,TDHT 102,A00,189325,Staff,49,0,50,1
1683656467870,TDMV 1,A00,189295,Arcidiacono; Kristin,20,0,30,10
1683656467870,TDMV 1,B00,189296,Caligagan; Maria T.,24,0,30,6
1683656468895,TDMV 2,A00,189297,Sammartano; Tonnie,27,0,30,3
1683656468895,TDMV 2,B00,189299,Arcidiacono; Kristin,23,0,30,7
1683656469920,TDMV 3,A00,204998,Rincon; Alicia,22,0,30,8
1683656470948,TDMV 120,A00,189458,Sammartano; Tonnie,28,0,30,2
1683656471974,TDMV 138,A00,189541,Jun; Grace Shin Hae,20,0,40,20
1683656472997,TDMV 142,A00,189717,Caligagan; Tony,25,0,30,5
1683656472997,TDMV 142,B00,189718,Caligagan; Maria T.,25,0,30,5
1683656474024,TMC 2,A01,187533,Staff,25,0,25,0
1683656474024,TMC 2,A02,187534,Staff,25,0,25,0
1683656475050,USP 1,A01,187536,Kwak; Nancy,0,16,25,25
1683656476074,USP 5,A01,187538,Staff,9,0,25,16
1683656477099,USP 101,A00,199253,Staff,0,4,0,0
1683656478125,USP 124,A00,187562,Boomhower; Matthew Charles,0,0,30,30
1683656479149,USP 138,A00,187582,Staff,20,0,25,5
1683656480174,USP 152,A01,187597,Staff,3,0,25,22
1683656481201,USP 153,A00,187598,Staff,19,0,25,6
1683656482229,USP 168,A00,187607,Kwak; Nancy,2,0,5,3
1683656483256,USP 173,A00,187619,Staff,4,0,25,21
1683656484336,USP 181,A00,187638,Staff,0,4,25,25
1683656485362,VIS 103,A00,187650,Cruz; Edwin Teddy,18,0,75,57
1683656486391,VIS 110D,A00,187669,Staff,13,0,22,9
1683656487419,VIS 127C,A00,187720,Shen; Kuiyi,67,0,146,79
1683656488447,VIS 149,A00,187731,Yoldas; Pinar,0,14,22,22
1683656489474,VIS 151,A01,188091,Staff,22,0,34,12
1683656489474,VIS 151,A02,188092,Staff,11,0,34,23
1683656490497,VIS 160B,A00,188093,Stalbaum; Brett,0,1,10,10
1683656492553,WCWP 10B,A00,201720,Staff,10,0,15,5
1683656492553,WCWP 10B,B00,201722,Staff,9,0,15,6
1683656493578,WCWP 100,A00,201725,Gagnon; Jeffrey C,0,0,2,2
1683656493578,WCWP 100,B00,201727,Staff,0,4,15,15
1683656496678,ANBI 133,A00,258401,Wilder; Linnea Lorene,34,0,40,6
1683656497703,ANBI 140,A00,258395,Hrvoj Mihic; Branka,18,0,25,7
1683656498729,ANSC 120,A00,258402,Bialecki; Jon Anthony,26,0,40,14
1683656499757,ANSC 144,A00,258400,Staff,12,0,40,28
1683656501812,ANSC 166,A00,258396,Parish; Steven Martin,156,0,175,19
1683656502839,ANSC 180,A00,193533,Staff,8,0,20,12
1683656503866,ANSC 188,A00,258397,Jassal; Aftab,34,0,40,6
1683656504893,ANTH 3,A01,258316,Staff,23,0,30,7
1683656505922,ANTH 5,A00,258394,Semendeferi; Ekaterini,16,0,20,4
1683656506950,ANTH 21,A01,258331,Staff,4,0,40,36
1683656507974,ANTH 103,A00,258398,Varma; Saiba,15,0,25,10
1683656509007,AWP 10,001,202034,Staff,0,0,0,0
1683656509007,AWP 10,002,202035,Staff,0,0,0,0
1683656509007,AWP 10,003,202036,Staff,0,0,0,0
1683656509007,AWP 10,004,202037,Staff,0,0,0,0
1683656509007,AWP 10,005,202038,Staff,0,0,0,0
1683656509007,AWP 10,006,202039,Staff,0,0,0,0
1683656509007,AWP 10,007,202040,Staff,0,0,0,0
1683656509007,AWP 10,008,202041,Staff,0,0,0,0
1683656509007,AWP 10,009,202042,Staff,0,0,0,0
1683656509007,AWP 10,010,202043,Staff,0,0,0,0
1683656509007,AWP 10,011,202044,Staff,0,0,0,0
1683656509007,AWP 10,012,202045,Staff,0,0,0,0
1683656509007,AWP 10,013,202046,Staff,0,0,0,0
1683656509007,AWP 10,014,202047,Staff,0,0,0,0
1683656509007,AWP 10,015,202048,Staff,0,0,0,0
1683656509007,AWP 10,016,202049,Staff,0,0,0,0
1683656509007,AWP 10,017,202050,Staff,0,0,0,0
1683656509007,AWP 10,018,202051,Staff,0,0,0,0
1683656509007,AWP 10,019,202052,Staff,0,0,0,0
1683656509007,AWP 10,020,202053,Staff,0,0,0,0
1683656509007,AWP 10,021,202054,Staff,0,0,0,0
1683656509007,AWP 10,022,202055,Staff,0,0,0,0
1683656509007,AWP 10,023,202056,Staff,0,0,0,0
1683656509007,AWP 10,024,202057,Staff,0,0,0,0
1683656509007,AWP 10,025,202058,Staff,0,0,0,0
1683656509007,AWP 10,026,202059,Staff,0,0,0,0
1683656510036,AWP 102,001,202032,Staff,0,0,0,0
1683656510036,AWP 102,002,202033,Staff,0,0,0,0
1683656511063,BENG 100,A01,254234,Taylor Amos; Alyssa C,31,0,40,9
1683656512095,BENG 196,001,270013,Engler; Adam J.,9999,0,9999,0
1683656513124,BICD 100R,A01,202018,Smith; Laurie,0,7,32,32
1683656513124,BICD 100R,A02,202019,Smith; Laurie,0,3,32,32
1683656513124,BICD 100R,A03,202020,Smith; Laurie,0,1,32,32
1683656513124,BICD 100R,A04,202021,Smith; Laurie,6,0,32,26
1683656513124,BICD 100R,A05,202022,Smith; Laurie,11,0,32,21
1683656514149,BICD 136,A01,193242,Gustafson-Brown; Cindy,0,2,32,32
1683656514149,BICD 136,A02,193244,Gustafson-Brown; Cindy,13,0,32,19
1683656515176,BIEB 102,A01,193249,Butler; Shannon Rhey,0,2,32,32
1683656515176,BIEB 102,A02,193251,Butler; Shannon Rhey,0,0,32,32
1683656515176,BIEB 102,A03,193253,Butler; Shannon Rhey,0,0,32,32
1683656515176,BIEB 102,A04,193255,Butler; Shannon Rhey,14,0,32,18
1683656515176,BIEB 102,A05,193265,Butler; Shannon Rhey,26,0,32,6
1683656515176,BIEB 102,A06,193269,Butler; Shannon Rhey,14,0,32,18
1683656517225,BIEB 150,A01,193274,Staff,0,0,32,32
1683656517225,BIEB 150,A02,193285,Staff,24,0,32,8
1683656518253,BIEB 194,A00,193286,Kurle; Carolyn M.,20,0,32,12
1683656519279,BILD 1,A01,192291,Staff,15,0,32,17
1683656519279,BILD 1,A02,192292,Staff,30,0,32,2
1683656519279,BILD 1,B01,192520,Reuther; Keefe,0,1,0,0
1683656519279,BILD 1,B02,192532,Reuther; Keefe,0,1,0,0
1683656520309,BILD 3,A01,192556,Butler; Shannon Rhey,0,0,32,32
1683656520309,BILD 3,A02,192581,Butler; Shannon Rhey,1,0,32,31
1683656520309,BILD 3,A03,192611,Butler; Shannon Rhey,21,0,32,11
1683656520309,BILD 3,A04,192612,Butler; Shannon Rhey,24,0,32,8
1683656520309,BILD 3,A05,192613,Butler; Shannon Rhey,26,0,32,6
1683656520309,BILD 3,A06,192679,Butler; Shannon Rhey,27,0,32,5
1683656520309,BILD 3,A07,192682,Butler; Shannon Rhey,20,0,32,12
1683656521336,BILD 4,A01,192836,Reuther; Keefe,1,0,24,23
1683656521336,BILD 4,A02,193044,Reuther; Keefe,4,0,24,20
1683656522365,BILD 10,A01,193142,Gustafson-Brown; Cindy,29,0,32,3
1683656522365,BILD 10,A02,193149,Gustafson-Brown; Cindy,31,0,32,1
1683656523394,BIMM 100,A01,193301,Staff,0,6,32,32
1683656523394,BIMM 100,A02,193312,Staff,0,7,32,32
1683656523394,BIMM 100,A03,193323,Staff,0,9,32,32
1683656524423,BIMM 101,A01,193329,McDonnell; Lisa Marie,0,4,24,24
1683656524423,BIMM 101,A02,193339,McDonnell; Lisa Marie,1,3,24,23
1683656524423,BIMM 101,B01,193354,McDonnell; Lisa Marie,0,4,24,24
1683656524423,BIMM 101,B02,193357,McDonnell; Lisa Marie,0,3,24,24
1683656525449,BIMM 110,A01,193377,Tat; John,0,11,32,32
1683656525449,BIMM 110,A02,193378,Tat; John,0,10,32,32
1683656526475,BIMM 120,A01,206116,Staff,0,0,32,32
1683656526475,BIMM 120,A02,206117,Staff,6,0,32,26
1683656526475,BIMM 120,A03,206121,Staff,21,0,32,11
1683656527501,BIPN 100,A01,193393,Park; Ji Young,0,15,32,32
1683656527501,BIPN 100,A02,193402,Park; Ji Young,0,14,32,32
1683656527501,BIPN 100,A03,193413,Park; Ji Young,0,14,32,32
1683656527501,BIPN 100,A04,193414,Park; Ji Young,0,13,32,32
1683656528530,BIPN 102,A01,193429,Staff,0,0,32,32
1683656528530,BIPN 102,A02,193438,Staff,18,0,32,14
1683656529559,BIPN 106,A01,193450,Reyes Gonzalez; Catalina,0,2,40,40
1683656530588,BIPN 134,A01,193465,Cooke; James Edward,0,0,32,32
1683656530588,BIPN 134,A02,193474,Cooke; James Edward,25,0,32,7
1683656530588,BIPN 134,A03,193485,Cooke; James Edward,29,0,32,3
1683656530588,BIPN 134,A04,193486,Cooke; James Edward,20,0,32,12
1683656530588,BIPN 134,A05,193491,Cooke; James Edward,31,0,32,1
1683656530588,BIPN 134,A06,193501,Cooke; James Edward,30,0,32,2
1683656530588,BIPN 134,A07,193510,Cooke; James Edward,29,0,32,3
1683656532647,BISP 194,A00,222522,Staff,14,0,32,18
1683656533674,CAT 124,A01,202407,Staff,19,0,25,6
1683656534701,CAT 125,A00,202408,Marchisotto; Jennifer Anne,2,0,20,18
1683656535729,CAT 125R,A00,202409,Smith; Lauryn Alissa,0,11,20,20
1683656535729,CAT 125R,B00,202410,Morales; Celeste Georgianna,0,11,20,20
1683656535729,CAT 125R,C00,202411,Irwin; Matthew Joseph,0,12,20,20
1683656536757,CENG 15,A01,204712,Yang; Kesong,0,1,0,0
1683656537782,CENG 114,A00,202070,Jahed Motlagh; Zeinab,5,0,20,15
1683656538808,CGS 105,A00,185477,Wesling; Megan E.,24,0,40,16
1683656539837,CGS 106,A00,185494,Staff,11,0,22,11
1683656540861,CGS 108,A00,185495,Staff,14,0,20,6
1683656541886,CGS 114,A00,185496,Staff,13,0,18,5
1683656542912,CGS 119,A00,185501,Staff,15,0,20,5
1683656543942,CGS 120,A00,185511,Staff,12,0,20,8
1683656544971,CHEM 4,A01,184675,Bussey; Thomas J,97,0,100,3
1683656545996,CHEM 6A,A01,184677,Staff,33,0,60,27
1683656547019,CHEM 6B,A01,184679,Staff,63,0,100,37
1683656548045,CHEM 6C,A01,184681,Bussey; Thomas J,0,0,50,50
1683656548045,CHEM 6C,A02,184682,Bussey; Thomas J,32,0,50,18
1683656549071,CHEM 40A,A01,184684,Albizati; Kim F.,34,0,100,66
1683656550098,CHEM 40B,A01,184686,Albizati; Kim F.,0,22,100,100
1683656551123,CHEM 41B,A01,184690,Staff,51,0,100,49
1683656552152,COGS 3,A01,184715,Boyle; Mary E. T.,0,27,40,40
1683656553178,COGS 14B,A01,185172,Staff,0,14,38,38
1683656554201,COGS 18,A01,184736,Staff,14,0,80,66
1683656555230,COGS 100,A01,184932,Staff,0,7,73,73
1683656556255,COGS 101A,A01,184935,Staff,0,39,30,30
1683656557277,COGS 101B,A01,184944,Staff,0,2,30,30
1683656558303,COGS 101C,A01,184946,Staff,0,10,30,30
1683656559326,COGS 102A,A01,184951,Johnson; Christine M.,2,0,40,38
1683656560354,COGS 107B,A01,184953,Mooshagian; Eric Frederick,0,51,40,40
1683656561382,COGS 118B,A01,184959,Gupta; Anjum,0,49,40,40
1683656562407,COGS 153,A00,184961,Staff,0,16,30,30
1683656563431,COGS 177,A00,184962,Staff,0,21,30,30
1683656564458,COGS 187A,A01,184969,Boyle; Mary E. T.,0,19,40,40
1683656565487,COMM 10,A01,185174,Staff,0,5,25,25
1683656565487,COMM 10,A02,185189,Staff,0,2,25,25
1683656565487,COMM 10,A03,269821,Staff,0,1,0,0
1683656566514,COMM 100B,A01,185475,Staff,0,1,0,2
1683656566514,COMM 100B,A02,185476,Staff,12,0,25,13
1683656567543,COMM 100C,A01,185314,Staff,1,0,25,24
1683656567543,COMM 100C,A02,185327,Staff,18,0,25,7
1683656568570,COMM 110M,A00,185349,Staff,0,0,40,40
1683656569598,COMM 113T,A00,185352,Staff,25,0,40,15
1683656570623,COMM 114I,A00,185353,Staff,31,0,40,9
1683656571652,COMM 131,A00,185354,Staff,17,0,30,13
1683656572678,CSE 8A,A50,185358,Cao; Yingjun,0,46,10,10
1683656573704,CSE 8B,A01,185362,Staff,0,48,50,50
1683656574732,CSE 11,A01,185416,Cao; Yingjun,0,91,10,10
1683656575763,CSE 20,A01,185445,Briones; Jor-el Thomas Caparas,4,0,25,21
1683656576787,CSE 21,A01,185447,Staff,9,0,50,41
1683656577813,CSE 101,A01,185451,Staff,0,13,50,50
1683656577813,CSE 101,B01,185453,Jones; Miles E,0,13,50,50
1683656579865,CSE 141,A01,185458,Eldon; John,16,0,100,84
1683656580890,CSE 141L,A01,185461,Eldon; John,8,0,100,92
1683656581916,CSE 142,A01,185463,Staff,35,0,60,25
1683656581916,CSE 142,B01,201355,Staff,0,7,60,60
1683656582946,CSE 142L,A01,185470,Staff,35,0,60,25
1683656582946,CSE 142L,B01,201417,Staff,0,6,60,60
1683656583972,CSE 190,A00,201433,Staff,32,0,49,17
1683656585003,DOC 1,A01,259136,Strom; Megan C.,7,0,15,8
1683656585003,DOC 1,A02,259137,Strom; Megan C.,14,0,15,1
1683656585003,DOC 1,A03,259138,Strom; Megan C.,14,0,15,1
1683656585003,DOC 1,A04,259139,Strom; Megan C.,14,0,15,1
1683656586032,DOC 100D,A00,259140,Pass; Natalye Joann,14,0,25,11
1683656587057,DSGN 1,A01,184749,Rill; Bryan,0,26,30,30
1683656588139,DSGN 100,A01,185168,Staff,0,2,25,25
1683656589170,ECE 5,A01,185626,Morris; Karcher William,0,11,0,0
1683656590194,ECE 101,A01,185628,Staff,14,0,70,56
1683656591223,ECE 107,A01,185635,Baghdadchi; Saharnaz,0,0,20,20
1683656591223,ECE 107,A02,185638,Baghdadchi; Saharnaz,2,0,20,18
1683656592251,ECE 148,A01,185647,Silberman; Jack,0,0,16,16
1683656593276,ECON 1,A01,185537,Crane; Meredith Helen,54,0,70,16
1683656594305,ECON 3,A01,185549,Crane; Meredith Helen,29,0,70,41
1683656595332,ECON 4,A01,203354,Anderson; John Charles,0,5,10,10
1683656596358,ECON 100A,A01,185574,Staff,0,5,40,40
1683656597382,ECON 100B,A01,185576,Staff,0,12,50,50
1683656598407,ECON 100C,A01,185589,Newhouse; Herbert S,30,0,70,40
1683656599433,ECON 105,A00,185608,Vespa; Emanuel Ignacio,19,0,35,16
1683656600459,ECON 109,A01,185610,Shishkin; Denis,9,0,35,26
1683656601483,ECON 110A,A01,185612,Staff,9,0,40,31
1683656602512,ECON 120A,A01,185615,Staff,20,0,40,20
1683656603538,ECON 120C,A01,185617,Sun; Yixiao,0,20,70,70
1683656604561,ECON 144,A00,203346,Squires; Dale E,2,0,35,33
1683656605587,ECON 171,A01,203349,Newhouse; Herbert S,0,1,35,35
1683656606616,ECON 173A,A01,185621,Toda; Alexis Akira,21,0,35,14
1683656607643,EDS 25,A01,202413,Staff,0,1,0,0
1683656607643,EDS 25,A02,202414,Staff,0,1,0,0
1683656607643,EDS 25,A03,202415,Staff,0,0,0,0
1683656607643,EDS 25,A04,202416,Staff,0,1,0,0
1683656607643,EDS 25,A05,202439,Staff,0,0,0,0
1683656607643,EDS 25,A06,202440,Staff,0,0,0,0
1683656607643,EDS 25,B01,202631,Staff,0,0,0,0
1683656607643,EDS 25,B02,202632,Staff,0,0,0,0
1683656607643,EDS 25,B03,202639,Staff,0,0,0,0
1683656607643,EDS 25,B04,202640,Staff,0,0,0,0
1683656607643,EDS 25,B05,202643,Staff,0,0,0,0
1683656607643,EDS 25,B06,202644,Staff,0,0,0,0
1683656608668,EDS 38,A01,202659,Black; Alison Michelle,24,0,25,1
1683656609693,EDS 115,A00,202652,Staff,18,0,30,12
1683656610720,EDS 125,A00,202649,Staff,13,0,30,17
1683656611746,EDS 126,A01,203332,Staff,30,0,30,0
1683656612770,EDS 139,A00,202838,Staff,16,0,25,9
1683656613798,EDS 146,A01,202655,Staff,14,0,25,11
1683656614826,ENG 15,A00,185667,Staff,0,1,0,0
1683656614826,ENG 15,B00,185672,Staff,0,0,0,0
1683656614826,ENG 15,C00,185675,Staff,0,0,0,0
1683656614826,ENG 15,D00,185682,Staff,0,0,0,0
1683656614826,ENG 15,E00,185684,Staff,0,0,0,0
1683656615853,ETHN 103,A00,185710,Staff,0,8,35,35
1683656616879,ETHN 103A,A00,199228,Man; Simeon S,0,0,9,9
1683656617906,ETHN 109,A00,185711,Staff,16,0,35,19
1683656618931,ETHN 142,A00,185726,Staff,0,4,30,30
1683656619957,ETHN 163J,A00,199229,Man; Simeon S,5,0,8,3
1683656620987,ETHN 168,A00,185727,Staff,7,0,10,3
1683656622011,ETHN 182,A00,185728,Staff,0,0,35,35
1683656623036,ETHN 183,A00,185737,Staff,9,0,18,9
1683656624065,GLBH 111,A01,209361,Burgos; Jose L.,0,0,0,0
1683656626115,HIEU 104,A00,185792,Staff,14,0,20,6
1683656627143,HIEU 115,A00,185800,Staff,0,0,20,20
1683656628168,HIEU 128,A00,185801,Staff,0,9,20,20
1683656629195,HIEU 147,A00,185802,Staff,15,0,20,5
1683656630220,HIEU 154,A00,185823,Staff,11,0,20,9
1683656631245,HILA 102,A00,185826,Staff,14,0,20,6
1683656632269,HILD 2C,A01,185778,Staff,0,13,20,20
1683656633295,HILD 7B,A01,185780,Kwak; Nancy,0,17,32,32
1683656633295,HILD 7B,A02,185781,Kwak; Nancy,0,18,32,32
1683656634322,HILD 30,A01,185791,Staff,12,0,20,8
1683656635347,HISC 119,A00,185830,Golan; Tal,0,9,20,20
1683656636374,HITO 156GS,A00,185831,Patterson; Patrick H.,0,0,0,23
1683656637398,HIUS 103,A00,185832,Man; Simeon S,0,4,20,20
1683656638426,HIUS 117,A00,185836,Kwak; Nancy,2,0,20,18
1683656639455,HIUS 125,A00,185840,Man; Simeon S,0,2,23,23
1683656640477,HIUS 149,A00,185845,Staff,1,0,20,19
1683656641507,HUM 3,A01,185882,Zavodny; Tatiana Sophia,0,8,50,50
1683656641507,HUM 3,B01,185899,Caldwell; Michael Alan,0,18,50,50
1683656642534,HUM 3GS,A00,185900,Patterson; Patrick H.,0,0,0,23
1683656643559,HUM 4,A01,185938,Zroka; Amy Liane,29,0,50,21
1683656643559,HUM 4,B01,185956,Watkins; Eric,0,4,50,50
1683656643559,HUM 4,B02,202209,Watkins; Eric,0,5,50,50
1683656643559,HUM 4,B03,202210,Watkins; Eric,0,5,50,50
1683656644585,HUM 5,A01,185958,West; Geoffrey Scott,1,0,50,49
1683656644585,HUM 5,A02,202215,West; Geoffrey Scott,0,0,50,50
1683656645611,INTL 190,A00,185959,Gagnon; Jeffrey C,0,0,0,9
1683656645611,INTL 190,B00,185960,Lettieri; Michael Joseph,0,0,0,2
1683656646640,JAPN 180,A00,254509,Staff,5,0,30,25
1683656647670,LATI 10,A01,202853,Kennemore; Amy Michelle,4,0,35,31
1683656647670,LATI 10,A02,202854,Kennemore; Amy Michelle,2,0,35,33
1683656647670,LATI 10,A03,270054,Kennemore; Amy Michelle,30,0,30,0
1683656648699,LATI 180,A00,202855,Kennemore; Amy Michelle,11,0,20,9
1683656649724,LAWS 101,A00,201767,Golan; Tal,0,7,40,40
1683656650753,LIFR 1C,A00,185961,Staff,6,0,20,14
1683656651777,LIFR 1CX,A00,185962,Staff,7,0,20,13
1683656652807,LIFR 1D,A00,185963,Staff,7,0,20,13
1683656653836,LIFR 1DX,A00,185964,Staff,7,0,20,13
1683656654862,LIGN 101,A01,186039,Staff,43,0,50,7
1683656655906,LIGN 165,A00,186040,Staff,15,0,50,35
1683656656934,LTCS 108,A00,186041,Staff,5,0,10,5
1683656657962,LTCS 119,A00,186042,Staff,15,0,20,5
1683656658990,LTCS 130,A00,186043,Wesling; Megan E.,15,0,25,10
1683656661046,LTEA 138,A00,186119,Staff,14,0,40,26
1683656662074,LTEN 124,A00,186148,Staff,5,0,25,20
1683656663101,LTEN 178,A00,186149,Staff,7,0,15,8
1683656664128,LTEN 181,A00,186150,Blanco; John D,34,0,40,6
1683656665156,LTWL 120,A00,186160,Staff,20,0,25,5
1683656666187,LTWL 165,A00,186161,Staff,22,0,25,3
1683656667213,LTWR 100,A00,186162,Staff,0,5,15,15
1683656668237,LTWR 102,A00,186163,Doller; Ben,5,0,15,10
1683656669266,MAE 8,A01,186412,Staff,0,0,0,0
1683656670292,MAE 30B,A00,186445,Bahadori; Mohammad Yousef,82,0,100,18
1683656671318,MAE 40,A00,186592,Bewley; Thomas R,10,0,50,40
1683656672343,MAE 101B,A00,186593,Bahadori; Mohammad Yousef,80,0,100,20
1683656673369,MAE 105,A00,186594,Bandaru; Prabhakar,10,0,50,40
1683656674394,MAE 107,A00,186599,Pham; Hieu Tan,0,7,120,120
1683656675419,MAE 148,A01,186660,Silberman; Jack,3,0,16,13
1683656676445,MATH 10A,A01,188095,Staff,0,6,35,35
1683656677471,MATH 10B,A01,188097,Bowers; Adam R.,0,12,30,30
1683656677471,MATH 10B,A02,188099,Bowers; Adam R.,0,11,30,30
1683656677471,MATH 10B,B01,188104,Bowers; Adam R.,0,10,30,30
1683656677471,MATH 10B,B02,188106,Bowers; Adam R.,1,9,30,29
1683656678497,MATH 10C,A01,188111,Staff,0,18,30,30
1683656678497,MATH 10C,A02,188127,Staff,0,19,30,30
1683656678497,MATH 10C,A03,188131,Staff,0,19,30,30
1683656678497,MATH 10C,B01,188218,Staff,17,0,30,13
1683656678497,MATH 10C,B02,188244,Staff,13,0,30,17
1683656678497,MATH 10C,B03,188277,Staff,14,0,30,16
1683656679524,MATH 18,A01,188344,Bach; Quang Tran,18,0,30,12
1683656679524,MATH 18,A02,188345,Bach; Quang Tran,11,0,30,19
1683656679524,MATH 18,B01,188353,Bach; Quang Tran,11,0,30,19
1683656679524,MATH 18,B02,188354,Bach; Quang Tran,19,0,30,11
1683656680553,MATH 20A,A01,188374,Staff,11,0,35,24
1683656681580,MATH 20B,A01,188382,Ohm; Ko Woon,7,0,30,23
1683656681580,MATH 20B,A02,188383,Ohm; Ko Woon,22,0,30,8
1683656681580,MATH 20B,B01,188385,Ohm; Ko Woon,7,0,30,23
1683656681580,MATH 20B,B02,188392,Ohm; Ko Woon,22,0,30,8
1683656682604,MATH 20C,A01,188394,Harel; Guershon,11,0,30,19
1683656682604,MATH 20C,A02,188395,Harel; Guershon,13,0,30,17
1683656682604,MATH 20C,B01,188404,Harel; Guershon,5,0,30,25
1683656682604,MATH 20C,B02,188405,Harel; Guershon,18,0,30,12
1683656683631,MATH 20D,A01,188414,Hammock; Frances H,0,1,30,30
1683656683631,MATH 20D,A02,188415,Hammock; Frances H,0,1,30,30
1683656683631,MATH 20D,B01,188447,Hammock; Frances H,0,1,30,30
1683656683631,MATH 20D,B02,188486,Hammock; Frances H,4,0,30,26
1683656684656,MATH 20E,A01,188649,Staff,21,0,30,9
1683656684656,MATH 20E,A02,188650,Staff,21,0,30,9
1683656684656,MATH 20E,A03,188673,Staff,0,0,30,30
1683656685682,MATH 102,A01,188675,Staff,0,36,35,35
1683656686712,MATH 103B,A01,188681,Staff,3,0,35,32
1683656686712,MATH 103B,B01,188692,Staff,5,0,35,30
1683656687738,MATH 109,A01,188695,Salehi Golsefidy; Alireza,24,0,35,11
1683656687738,MATH 109,A02,188696,Salehi Golsefidy; Alireza,25,0,35,10
1683656688772,MATH 120A,A01,188698,Eggers; John Dietrich,7,0,35,28
1683656689801,MATH 142B,A01,188736,Ioana; Adrian,0,1,30,30
1683656689801,MATH 142B,A02,188741,Ioana; Adrian,0,1,30,30
1683656689801,MATH 142B,A03,188743,Ioana; Adrian,0,1,30,30
1683656690827,MATH 168A,A01,188790,Staff,0,10,35,35
1683656691911,MATH 170A,A01,188803,Nie; Jiawang,0,2,35,35
1683656691911,MATH 170A,A02,188811,Nie; Jiawang,0,0,35,35
1683656691911,MATH 170A,A03,188814,Nie; Jiawang,0,0,35,35
1683656691911,MATH 170A,A04,188815,Nie; Jiawang,10,0,35,25
1683656692936,MATH 193B,A01,188817,Staff,0,0,35,35
1683656692936,MATH 193B,A02,188818,Staff,5,0,35,30
1683656693963,MGT 4,A01,202857,Anderson; John Charles,61,0,80,19
1683656694992,MGT 12,A00,202858,Lindenberger; Wade Douglas,40,0,90,50
1683656696018,MGT 18,A00,202859,Staff,74,0,90,16
1683656697044,MGT 18GS,A00,202860,McKay; Michael J,13,0,28,15
1683656698073,MGT 45,A00,202861,Pecore; Joseph P.,12,0,90,78
1683656699099,MGT 100,A00,202863,Yavorsky; Daniel Ryan,28,0,90,62
1683656700127,MGT 103,A00,202864,Ehrich; Kristine R,0,17,90,90
1683656701154,MGT 112,A00,202865,Ehrich; Kristine R,15,0,90,75
1683656702179,MGT 121A,A00,202868,Staff,90,20,90,0
1683656703204,MGT 131B,A00,202869,Anderson; John Charles,59,0,90,31
1683656704234,MGT 136,A00,202871,Lindenberger; Wade Douglas,83,0,90,7
1683656705259,MGT 164,A00,202873,Staff,0,66,90,91
1683656706282,MGT 164GS,A00,202874,McKay; Mary A,13,0,28,15
1683656707308,MGT 180,A00,202875,Staff,0,50,90,91
1683656708338,MMW 11R,A01,205019,Herbst; Matthew,2,0,30,28
1683656708338,MMW 11R,A02,205026,Herbst; Matthew,29,0,30,1
1683656709362,MMW 15,A01,193512,Chang; Edmond Yi-Teh,0,8,28,28
1683656709362,MMW 15,A02,193513,Chang; Edmond Yi-Teh,0,5,28,28
1683656709362,MMW 15,A03,193514,Chang; Edmond Yi-Teh,0,5,28,28
1683656709362,MMW 15,A04,193515,Chang; Edmond Yi-Teh,0,5,28,28
1683656709362,MMW 15,A05,193516,Chang; Edmond Yi-Teh,0,5,28,28
1683656709362,MMW 15,A06,193517,Chang; Edmond Yi-Teh,0,6,28,28
1683656709362,MMW 15,B01,193519,Chang; Edmond Yi-Teh,0,5,28,28
1683656709362,MMW 15,B02,193520,Chang; Edmond Yi-Teh,0,5,28,28
1683656709362,MMW 15,B03,193521,Chang; Edmond Yi-Teh,0,5,28,28
1683656709362,MMW 15,B04,193522,Chang; Edmond Yi-Teh,0,5,28,28
1683656709362,MMW 15,B05,193523,Chang; Edmond Yi-Teh,0,5,28,28
1683656709362,MMW 15,B06,193524,Chang; Edmond Yi-Teh,0,5,28,28
1683656710387,MMW 122,A01,193526,Rahimi; Babak,0,16,28,28
1683656710387,MMW 122,A02,193527,Rahimi; Babak,0,15,28,28
1683656710387,MMW 122,A03,193528,Rahimi; Babak,0,0,0,0
1683656710387,MMW 122,A04,193529,Rahimi; Babak,0,0,0,0
1683656711416,MUS 1A,A01,186663,Staff,1,20,35,34
1683656712443,MUS 4,A01,186715,Staff,0,12,35,35
1683656713468,MUS 5R,A01,186796,Dubnov; Shlomo,0,17,35,35
1683656714494,MUS 6,A01,186798,Staff,0,5,25,25
1683656715523,MUS 7,A01,186830,Staff,11,0,35,24
1683656716548,MUS 8,A01,186930,Staff,0,26,35,35
1683656717576,MUS 15,A01,186932,Staff,0,16,35,35
1683656717576,MUS 15,B01,186934,Staff,0,17,35,35
1683656718604,MUS 80,A00,186935,Staff,0,0,20,20
1683656718604,MUS 80,B00,186936,Staff,24,0,25,1
1683656719629,NANO 11,A00,204702,Lipomi; Darren John,0,0,0,0
1683656720657,NANO 15,A01,204709,Yang; Kesong,0,1,0,0
1683656721687,NANO 114,A00,202069,Jahed Motlagh; Zeinab,3,0,10,7
1683656722715,PHIL 1,A00,186955,Grush; Rick Scott,31,0,40,9
1683656723740,PHIL 10,A01,186973,Grush; Rick Scott,27,0,35,8
1683656723740,PHIL 10,A02,186974,Grush; Rick Scott,33,0,35,2
1683656724765,PHIL 13,A01,186976,Staff,3,0,35,32
1683656724765,PHIL 13,A02,186977,Staff,16,0,35,19
1683656725789,PHIL 14,A01,186979,Staff,31,0,35,4
1683656725789,PHIL 14,A02,186986,Staff,32,0,35,3
1683656726815,PHIL 28,A01,186988,Staff,16,0,30,14
1683656726815,PHIL 28,A02,186989,Staff,1,0,30,29
1683656726815,PHIL 28,A03,186990,Staff,10,0,30,20
1683656726815,PHIL 28,A04,186991,Staff,26,0,30,4
1683656727842,PHIL 120,A00,186997,Staff,23,0,40,17
1683656728869,PHIL 137,A00,187003,Staff,7,0,40,33
1683656729898,PHIL 150,A00,187015,Staff,47,0,70,23
1683656730924,PHIL 167,A00,187021,Lamey; Andy M.,34,0,40,6
1683656731953,PHIL 174,A01,202226,Staff,17,0,20,3
1683656731953,PHIL 174,A02,202235,Staff,20,0,20,0
1683656732977,PHIL 191A,A00,258918,Staff,0,0,1,1
1683656734004,PHYS 1A,A00,187028,Staff,26,0,60,34
1683656735034,PHYS 1AL,001,187036,Staff,3,0,30,27
1683656735034,PHYS 1AL,002,187049,Staff,18,0,30,12
1683656736060,PHYS 1B,A00,187058,Staff,22,0,60,38
1683656737085,PHYS 1BL,001,187064,Staff,0,1,30,30
1683656737085,PHYS 1BL,002,187070,Staff,4,0,30,26
1683656738111,PHYS 1C,A00,187082,Staff,29,0,120,91
1683656739140,PHYS 1CL,001,187088,Staff,0,9,30,30
1683656739140,PHYS 1CL,002,187089,Staff,0,1,30,30
1683656739140,PHYS 1CL,009,262693,Staff,9,0,30,21
1683656740164,PHYS 2B,A01,187097,Staff,55,0,115,60
1683656741190,PHYS 2C,A01,187099,Staff,63,0,115,52
1683656742218,PHYS 2CL,A01,187101,Staff,5,0,28,23
1683656742218,PHYS 2CL,A02,187102,Staff,15,0,28,13
1683656743242,PHYS 2D,A01,187123,Shotwell; Brian,95,0,115,20
1683656744270,PHYS 4B,A01,187133,Grinstein; Benjamin,35,0,50,15
1683656745296,POLI 10,A00,188819,Staff,0,4,50,50
1683656746322,POLI 11,A00,188827,Staff,43,0,50,7
1683656747347,POLI 13R,A00,188828,Staff,0,1,20,20
1683656748380,POLI 27,A01,188830,Elgin; Samuel Zincke,0,2,70,70
1683656749406,POLI 30,A00,188832,Desposato; Scott,30,0,50,20
1683656750434,POLI 102F,A00,188834,Staff,0,0,40,40
1683656751460,POLI 104A,A00,188852,Staff,13,0,30,17
1683656752488,POLI 104I,A00,188853,Staff,0,7,20,20
1683656753513,POLI 110B,A00,188854,Wiens; David,6,0,20,14
1683656754541,POLI 112A,A00,188855,Wiens; David,3,0,30,27
1683656755569,POLI 117R,A00,188856,Forman; Fonna,0,12,20,20
1683656756596,POLI 118,A00,188857,Ingham; Sean,8,0,20,12
1683656757622,POLI 120G,A00,188858,Staff,8,0,30,22
1683656758650,POLI 131CR,A00,188863,Hoston; Germaine,21,0,50,29
1683656759678,POLI 133,A00,188864,Nellis; Gareth Hb,44,0,50,6
1683656760707,POLI 134D,A00,188865,Desposato; Scott,27,0,30,3
1683656761733,POLI 142A,A00,188871,Gartzke; Erik,21,0,50,29
1683656762761,POLI 142K,A00,188874,Staff,38,0,50,12
1683656763791,POLI 143,A00,188940,Gartzke; Erik,16,0,30,14
1683656764819,POLI 153,A00,188943,Staff,2,0,20,18
1683656765846,POLI 160AA,A00,188944,Staff,11,0,40,29
1683656766875,POLI 170A,A00,188945,Staff,11,0,30,19
1683656768926,PSYC 1,A00,188952,Staff,36,0,90,54
1683656769954,PSYC 2,B00,188953,Staff,19,0,35,16
1683656770978,PSYC 6,A00,188970,Staff,47,0,60,13
1683656772002,PSYC 7,A00,188973,Staff,35,0,45,10
1683656773028,PSYC 60,A01,188980,Rickard; Timothy C.,42,0,60,18
1683656774057,PSYC 70,A01,189001,Steiner; Eric Tomas,22,0,45,23
1683656775083,PSYC 100,A00,189005,Lacefield; Katharine I,0,99,120,120
1683656776108,PSYC 102,A00,189008,Staff,8,0,30,22
1683656777138,PSYC 106,B00,189026,Gorman; Michael R.,27,0,60,33
1683656778167,PSYC 114,B01,189033,Winkielman; Piotr,0,31,30,30
1683656779191,PSYC 131,A00,189036,Anagnostaras; Stephan,0,43,60,60
1683656780220,PSYC 136,A00,189041,Lowe; Angela Beth,0,7,25,25
1683656781245,PSYC 137,A00,189057,Winkielman; Piotr,0,37,25,25
1683656782268,PSYC 144,A00,189107,Wixted; John T,0,11,50,50
1683656784321,PSYC 162,A00,189142,Staff,0,9,85,85
1683656785346,PSYC 172,A00,189144,Gorman; Michael R.,0,6,30,30
1683656787397,PSYC 179,A00,189146,Lacefield; Katharine I,0,87,120,120
1683656788421,PSYC 181,A00,189147,Anagnostaras; Stephan,0,44,90,90
1683656789446,PSYC 190R,A00,189148,Barner; David A.,0,23,80,80
1683656790470,PSYC 191,A00,189275,Rickard; Timothy C.,0,10,25,25
1683656791495,PSYC 193,A00,189276,Chapman; Eddie Nathaniel,0,1,0,4
1683656792521,PSYC 193L,A01,189281,Lowe; Angela Beth,10,0,20,10
1683656792521,PSYC 193L,B01,189285,Staff,28,0,35,7
1683656793547,RELI 149,A00,187137,Rahimi; Babak,7,0,40,33
1683656794573,SE 9,A01,187315,Staff,0,2,18,18
1683656795653,SE 101B,A00,187409,Staff,24,0,30,6
1683656796680,SE 110B,A00,187444,Staff,10,0,40,30
1683656797709,SE 130B,A00,187449,Staff,31,0,40,9
1683656798738,SE 150A,A00,187516,Staff,9,0,20,11
1683656799762,SE 154,A00,187528,Staff,29,0,50,21
1683656800788,SIO 3,A01,258171,Staff,35,0,40,5
1683656801814,SIO 10,A00,187144,Cook; Geoffrey W,0,6,75,75
1683656802839,SIO 45,A00,187152,Cook; Geoffrey W,0,4,100,100
1683656803867,SIO 109R,A00,194486,Staff,0,4,20,20
1683656805923,SIO 187,A01,187233,Kacev; David,12,0,40,28
1683656806948,SOCI 1,A01,258656,Thorpe; Charles Robert,28,0,30,2
1683656806948,SOCI 1,A02,258658,Thorpe; Charles Robert,30,0,30,0
1683656806948,SOCI 1,A03,258661,Thorpe; Charles Robert,25,0,25,0
1683656806948,SOCI 1,A04,258666,Thorpe; Charles Robert,22,0,25,3
1683656806948,SOCI 1,A05,258897,Thorpe; Charles Robert,22,0,25,3
1683656806948,SOCI 1,A06,258898,Thorpe; Charles Robert,25,0,25,0
1683656807976,SOCI 30,A01,258903,Pardo Guerra; Juan Pablo,14,0,30,16
1683656809005,SOCI 102,A00,258904,Staff,9,0,25,16
1683656810033,SOCI 106,A00,258905,Staff,19,0,25,6
1683656811059,SOCI 111,A00,258907,Ribas Norris; Janet Vanesa,26,0,30,4
1683656812086,SOCI 121R,A00,258908,Pardo Guerra; Juan Pablo,8,0,30,22
1683656813111,SOCI 126,A01,203330,Staff,14,0,20,6
1683656814134,SOCI 131,A00,258909,Thorpe; Charles Robert,30,0,60,30
1683656815161,SOCI 135,A00,258910,Payne; Christine Anna,0,11,30,30
1683656816187,SOCI 157,A00,258911,Staff,12,0,30,18
1683656817212,SOCI 184,A00,258912,Staff,25,0,30,5
1683656818235,SOCI 188D,A00,258913,Staff,22,0,30,8
1683656819260,SYN 2,001,187529,Staff,9,0,16,7
1683656819260,SYN 2,002,201452,Staff,0,20,16,16
1683656819260,SYN 2,003,201469,Staff,2,0,16,14
1683656820286,SYN 100,A01,187531,Staff,0,9,20,20
1683656820286,SYN 100,B01,201491,Staff,0,10,20,20
1683656821312,TDAC 1,A00,189286,Walsh; Kim C.,3,0,20,17
1683656821312,TDAC 1,B00,189287,Harting; Carla Kelso,10,0,20,10
1683656822338,TDAC 101,A00,189300,Walsh; Kim C.,16,0,20,4
1683656822338,TDAC 101,B00,189301,Harting; Carla Kelso,18,0,20,2
1683656823363,TDAC 102,A00,189304,Basso; Beatrice,14,0,20,6
1683656824391,TDAC 108,A00,189305,Staff,18,0,20,2
1683656825416,TDDE 131,A00,189310,Staff,19,0,20,1
1683656825416,TDDE 131,B00,189314,Staff,19,0,20,1
1683656825416,TDDE 131,C00,189315,Staff,48,0,50,2
1683656825416,TDDE 131,D00,189316,Staff,14,0,15,1
1683656825416,TDDE 131,E00,204841,Staff,20,0,20,0
1683656826445,TDGE 10,A00,189289,Staff,27,0,50,23
1683656826445,TDGE 10,B00,189290,Havis; Allan,0,0,50,50
1683656827469,TDGE 11,A00,189291,Fulton; Julia,0,4,50,50
1683656827469,TDGE 11,B00,189292,Staff,20,0,25,5
1683656827469,TDGE 11,C00,260270,Staff,0,0,0,0
1683656828497,TDGE 25,A00,189294,Staff,2,0,20,18
1683656829522,TDGE 124,A00,189318,Fulton; Julia,0,8,50,50
1683656830551,TDGE 125,A00,189319,Staff,13,0,25,12
1683656830551,TDGE 125,B00,189320,Staff,23,0,25,2
1683656831576,TDGE 127,A00,189322,Havis; Allan,0,0,50,50
1683656832602,TDHT 101,A00,189323,Staff,18,0,25,7
1683656832602,TDHT 101,B00,189324,Staff,25,0,25,0
1683656833630,TDHT 102,A00,189325,Staff,49,0,50,1
1683656834657,TDMV 1,A00,189295,Arcidiacono; Kristin,20,0,30,10
1683656834657,TDMV 1,B00,189296,Caligagan; Maria T.,24,0,30,6
1683656835685,TDMV 2,A00,189297,Sammartano; Tonnie,27,0,30,3
1683656835685,TDMV 2,B00,189299,Arcidiacono; Kristin,23,0,30,7
1683656836710,TDMV 3,A00,204998,Rincon; Alicia,22,0,30,8
1683656837736,TDMV 120,A00,189458,Sammartano; Tonnie,28,0,30,2
1683656838765,TDMV 138,A00,189541,Jun; Grace Shin Hae,20,0,40,20
1683656839800,TDMV 142,A00,189717,Caligagan; Tony,25,0,30,5
1683656839800,TDMV 142,B00,189718,Caligagan; Maria T.,25,0,30,5
1683656840825,TMC 2,A01,187533,Staff,25,0,25,0
1683656840825,TMC 2,A02,187534,Staff,25,0,25,0
1683656841852,USP 1,A01,187536,Kwak; Nancy,0,16,25,25
1683656842880,USP 5,A01,187538,Staff,9,0,25,16
1683656843908,USP 101,A00,199253,Staff,0,4,0,0
1683656844933,USP 124,A00,187562,Boomhower; Matthew Charles,0,0,30,30
1683656845958,USP 138,A00,187582,Staff,20,0,25,5
1683656846983,USP 152,A01,187597,Staff,3,0,25,22
1683656848008,USP 153,A00,187598,Staff,19,0,25,6
1683656849034,USP 168,A00,187607,Kwak; Nancy,2,0,5,3
1683656850060,USP 173,A00,187619,Staff,4,0,25,21
1683656851086,USP 181,A00,187638,Staff,0,4,25,25
1683656852111,VIS 103,A00,187650,Cruz; Edwin Teddy,18,0,75,57
1683656853136,VIS 110D,A00,187669,Staff,13,0,22,9
1683656854161,VIS 127C,A00,187720,Shen; Kuiyi,67,0,146,79
1683656855189,VIS 149,A00,187731,Yoldas; Pinar,0,14,22,22
1683656856215,VIS 151,A01,188091,Staff,22,0,34,12
1683656856215,VIS 151,A02,188092,Staff,11,0,34,23
1683656857239,VIS 160B,A00,188093,Stalbaum; Brett,0,1,10,10
1683656859295,WCWP 10B,A00,201720,Staff,10,0,15,5
1683656859295,WCWP 10B,B00,201722,Staff,9,0,15,6
1683656860322,WCWP 100,A00,201725,Gagnon; Jeffrey C,0,0,2,2
1683656860322,WCWP 100,B00,201727,Staff,0,4,15,15
1683656863457,ANBI 133,A00,258401,Wilder; Linnea Lorene,34,0,40,6
1683656864482,ANBI 140,A00,258395,Hrvoj Mihic; Branka,18,0,25,7
1683656865513,ANSC 120,A00,258402,Bialecki; Jon Anthony,26,0,40,14
1683656866538,ANSC 144,A00,258400,Staff,12,0,40,28
1683656868590,ANSC 166,A00,258396,Parish; Steven Martin,156,0,175,19
1683656869618,ANSC 180,A00,193533,Staff,8,0,20,12
1683656870644,ANSC 188,A00,258397,Jassal; Aftab,34,0,40,6
1683656871670,ANTH 3,A01,258316,Staff,23,0,30,7
1683656872696,ANTH 5,A00,258394,Semendeferi; Ekaterini,16,0,20,4
1683656873723,ANTH 21,A01,258331,Staff,4,0,40,36
1683656874749,ANTH 103,A00,258398,Varma; Saiba,15,0,25,10
1683656875779,AWP 10,001,202034,Staff,0,0,0,0
1683656875779,AWP 10,002,202035,Staff,0,0,0,0
1683656875779,AWP 10,003,202036,Staff,0,0,0,0
1683656875779,AWP 10,004,202037,Staff,0,0,0,0
1683656875779,AWP 10,005,202038,Staff,0,0,0,0
1683656875779,AWP 10,006,202039,Staff,0,0,0,0
1683656875779,AWP 10,007,202040,Staff,0,0,0,0
1683656875779,AWP 10,008,202041,Staff,0,0,0,0
1683656875779,AWP 10,009,202042,Staff,0,0,0,0
1683656875779,AWP 10,010,202043,Staff,0,0,0,0
1683656875779,AWP 10,011,202044,Staff,0,0,0,0
1683656875779,AWP 10,012,202045,Staff,0,0,0,0
1683656875779,AWP 10,013,202046,Staff,0,0,0,0
1683656875779,AWP 10,014,202047,Staff,0,0,0,0
1683656875779,AWP 10,015,202048,Staff,0,0,0,0
1683656875779,AWP 10,016,202049,Staff,0,0,0,0
1683656875779,AWP 10,017,202050,Staff,0,0,0,0
1683656875779,AWP 10,018,202051,Staff,0,0,0,0
1683656875779,AWP 10,019,202052,Staff,0,0,0,0
1683656875779,AWP 10,020,202053,Staff,0,0,0,0
1683656875779,AWP 10,021,202054,Staff,0,0,0,0
1683656875779,AWP 10,022,202055,Staff,0,0,0,0
1683656875779,AWP 10,023,202056,Staff,0,0,0,0
1683656875779,AWP 10,024,202057,Staff,0,0,0,0
1683656875779,AWP 10,025,202058,Staff,0,0,0,0
1683656875779,AWP 10,026,202059,Staff,0,0,0,0
1683656876803,AWP 102,001,202032,Staff,0,0,0,0
1683656876803,AWP 102,002,202033,Staff,0,0,0,0
1683656877830,BENG 100,A01,254234,Taylor Amos; Alyssa C,31,0,40,9
1683656878859,BENG 196,001,270013,Engler; Adam J.,9999,0,9999,0
1683656879889,BICD 100R,A01,202018,Smith; Laurie,0,7,32,32
1683656879889,BICD 100R,A02,202019,Smith; Laurie,0,3,32,32
1683656879889,BICD 100R,A03,202020,Smith; Laurie,0,1,32,32
1683656879889,BICD 100R,A04,202021,Smith; Laurie,6,0,32,26
1683656879889,BICD 100R,A05,202022,Smith; Laurie,11,0,32,21
1683656880917,BICD 136,A01,193242,Gustafson-Brown; Cindy,0,2,32,32
1683656880917,BICD 136,A02,193244,Gustafson-Brown; Cindy,13,0,32,19
1683656881946,BIEB 102,A01,193249,Butler; Shannon Rhey,0,2,32,32
1683656881946,BIEB 102,A02,193251,Butler; Shannon Rhey,0,0,32,32
1683656881946,BIEB 102,A03,193253,Butler; Shannon Rhey,0,0,32,32
1683656881946,BIEB 102,A04,193255,Butler; Shannon Rhey,14,0,32,18
1683656881946,BIEB 102,A05,193265,Butler; Shannon Rhey,26,0,32,6
1683656881946,BIEB 102,A06,193269,Butler; Shannon Rhey,14,0,32,18
1683656883999,BIEB 150,A01,193274,Staff,0,0,32,32
1683656883999,BIEB 150,A02,193285,Staff,24,0,32,8
1683656885024,BIEB 194,A00,193286,Kurle; Carolyn M.,20,0,32,12
1683656886056,BILD 1,A01,192291,Staff,15,0,32,17
1683656886056,BILD 1,A02,192292,Staff,30,0,32,2
1683656886056,BILD 1,B01,192520,Reuther; Keefe,0,1,0,0
1683656886056,BILD 1,B02,192532,Reuther; Keefe,0,1,0,0
1683656887082,BILD 3,A01,192556,Butler; Shannon Rhey,0,0,32,32
1683656887082,BILD 3,A02,192581,Butler; Shannon Rhey,1,0,32,31
1683656887082,BILD 3,A03,192611,Butler; Shannon Rhey,21,0,32,11
1683656887082,BILD 3,A04,192612,Butler; Shannon Rhey,24,0,32,8
1683656887082,BILD 3,A05,192613,Butler; Shannon Rhey,26,0,32,6
1683656887082,BILD 3,A06,192679,Butler; Shannon Rhey,27,0,32,5
1683656887082,BILD 3,A07,192682,Butler; Shannon Rhey,20,0,32,12
1683656888114,BILD 4,A01,192836,Reuther; Keefe,1,0,24,23
1683656888114,BILD 4,A02,193044,Reuther; Keefe,4,0,24,20
1683656889143,BILD 10,A01,193142,Gustafson-Brown; Cindy,29,0,32,3
1683656889143,BILD 10,A02,193149,Gustafson-Brown; Cindy,31,0,32,1
1683656890170,BIMM 100,A01,193301,Staff,0,6,32,32
1683656890170,BIMM 100,A02,193312,Staff,0,7,32,32
1683656890170,BIMM 100,A03,193323,Staff,0,9,32,32
1683656891201,BIMM 101,A01,193329,McDonnell; Lisa Marie,0,4,24,24
1683656891201,BIMM 101,A02,193339,McDonnell; Lisa Marie,1,3,24,23
1683656891201,BIMM 101,B01,193354,McDonnell; Lisa Marie,0,4,24,24
1683656891201,BIMM 101,B02,193357,McDonnell; Lisa Marie,0,3,24,24
1683656892226,BIMM 110,A01,193377,Tat; John,0,11,32,32
1683656892226,BIMM 110,A02,193378,Tat; John,0,10,32,32
1683656893255,BIMM 120,A01,206116,Staff,0,0,32,32
1683656893255,BIMM 120,A02,206117,Staff,6,0,32,26
1683656893255,BIMM 120,A03,206121,Staff,21,0,32,11
1683656894297,BIPN 100,A01,193393,Park; Ji Young,0,15,32,32
1683656894297,BIPN 100,A02,193402,Park; Ji Young,0,14,32,32
1683656894297,BIPN 100,A03,193413,Park; Ji Young,0,14,32,32
1683656894297,BIPN 100,A04,193414,Park; Ji Young,0,13,32,32
1683656895325,BIPN 102,A01,193429,Staff,0,0,32,32
1683656895325,BIPN 102,A02,193438,Staff,18,0,32,14
1683656896352,BIPN 106,A01,193450,Reyes Gonzalez; Catalina,0,2,40,40
1683656897385,BIPN 134,A01,193465,Cooke; James Edward,0,0,32,32
1683656897385,BIPN 134,A02,193474,Cooke; James Edward,25,0,32,7
1683656897385,BIPN 134,A03,193485,Cooke; James Edward,29,0,32,3
1683656897385,BIPN 134,A04,193486,Cooke; James Edward,20,0,32,12
1683656897385,BIPN 134,A05,193491,Cooke; James Edward,31,0,32,1
1683656897385,BIPN 134,A06,193501,Cooke; James Edward,30,0,32,2
1683656897385,BIPN 134,A07,193510,Cooke; James Edward,29,0,32,3
1683656899497,BISP 194,A00,222522,Staff,14,0,32,18
1683656900525,CAT 124,A01,202407,Staff,19,0,25,6
1683656901557,CAT 125,A00,202408,Marchisotto; Jennifer Anne,2,0,20,18
1683656902584,CAT 125R,A00,202409,Smith; Lauryn Alissa,0,11,20,20
1683656902584,CAT 125R,B00,202410,Morales; Celeste Georgianna,0,11,20,20
1683656902584,CAT 125R,C00,202411,Irwin; Matthew Joseph,0,12,20,20
1683656903609,CENG 15,A01,204712,Yang; Kesong,0,1,0,0
1683656904634,CENG 114,A00,202070,Jahed Motlagh; Zeinab,5,0,20,15
1683656905660,CGS 105,A00,185477,Wesling; Megan E.,24,0,40,16
1683656906689,CGS 106,A00,185494,Staff,11,0,22,11
1683656907715,CGS 108,A00,185495,Staff,14,0,20,6
1683656908741,CGS 114,A00,185496,Staff,13,0,18,5
1683656909764,CGS 119,A00,185501,Staff,15,0,20,5
1683656910790,CGS 120,A00,185511,Staff,12,0,20,8
1683656911814,CHEM 4,A01,184675,Bussey; Thomas J,97,0,100,3
1683656912840,CHEM 6A,A01,184677,Staff,33,0,60,27
1683656913868,CHEM 6B,A01,184679,Staff,63,0,100,37
1683656914893,CHEM 6C,A01,184681,Bussey; Thomas J,0,0,50,50
1683656914893,CHEM 6C,A02,184682,Bussey; Thomas J,32,0,50,18
1683656915921,CHEM 40A,A01,184684,Albizati; Kim F.,34,0,100,66
1683656916951,CHEM 40B,A01,184686,Albizati; Kim F.,0,22,100,100
1683656917981,CHEM 41B,A01,184690,Staff,51,0,100,49
1683656919008,COGS 3,A01,184715,Boyle; Mary E. T.,0,27,40,40
1683656920035,COGS 14B,A01,185172,Staff,0,14,38,38
1683656921061,COGS 18,A01,184736,Staff,14,0,80,66
1683656922088,COGS 100,A01,184932,Staff,0,7,73,73
1683656923113,COGS 101A,A01,184935,Staff,0,39,30,30
1683656924139,COGS 101B,A01,184944,Staff,0,2,30,30
1683656925164,COGS 101C,A01,184946,Staff,0,10,30,30
1683656926188,COGS 102A,A01,184951,Johnson; Christine M.,2,0,40,38
1683656927217,COGS 107B,A01,184953,Mooshagian; Eric Frederick,0,51,40,40
1683656928247,COGS 118B,A01,184959,Gupta; Anjum,0,49,40,40
1683656929272,COGS 153,A00,184961,Staff,0,16,30,30
1683656930297,COGS 177,A00,184962,Staff,0,21,30,30
1683656931329,COGS 187A,A01,184969,Boyle; Mary E. T.,0,19,40,40
1683656932354,COMM 10,A01,185174,Staff,0,5,25,25
1683656932354,COMM 10,A02,185189,Staff,0,2,25,25
1683656932354,COMM 10,A03,269821,Staff,0,1,0,0
1683656933382,COMM 100B,A01,185475,Staff,0,1,0,2
1683656933382,COMM 100B,A02,185476,Staff,12,0,25,13
1683656934412,COMM 100C,A01,185314,Staff,1,0,25,24
1683656934412,COMM 100C,A02,185327,Staff,18,0,25,7
1683656935436,COMM 110M,A00,185349,Staff,0,0,40,40
1683656936461,COMM 113T,A00,185352,Staff,25,0,40,15
1683656937486,COMM 114I,A00,185353,Staff,31,0,40,9
1683656938513,COMM 131,A00,185354,Staff,17,0,30,13
1683656939537,CSE 8A,A50,185358,Cao; Yingjun,0,46,10,10
1683656940560,CSE 8B,A01,185362,Staff,0,48,50,50
1683656941586,CSE 11,A01,185416,Cao; Yingjun,0,91,10,10
1683656942610,CSE 20,A01,185445,Briones; Jor-el Thomas Caparas,4,0,25,21
1683656943639,CSE 21,A01,185447,Staff,9,0,50,41
1683656944668,CSE 101,A01,185451,Staff,0,13,50,50
1683656944668,CSE 101,B01,185453,Jones; Miles E,0,13,50,50
1683656946724,CSE 141,A01,185458,Eldon; John,16,0,100,84
1683656947751,CSE 141L,A01,185461,Eldon; John,8,0,100,92
1683656948774,CSE 142,A01,185463,Staff,34,0,60,26
1683656948774,CSE 142,B01,201355,Staff,0,7,60,60
1683656949811,CSE 142L,A01,185470,Staff,34,0,60,26
1683656949811,CSE 142L,B01,201417,Staff,0,6,60,60
1683656950840,CSE 190,A00,201433,Staff,32,0,49,17
1683656951866,DOC 1,A01,259136,Strom; Megan C.,7,0,15,8
1683656951866,DOC 1,A02,259137,Strom; Megan C.,14,0,15,1
1683656951866,DOC 1,A03,259138,Strom; Megan C.,14,0,15,1
1683656951866,DOC 1,A04,259139,Strom; Megan C.,14,0,15,1
1683656952894,DOC 100D,A00,259140,Pass; Natalye Joann,14,0,25,11
1683656953922,DSGN 1,A01,184749,Rill; Bryan,0,26,30,30
1683656954946,DSGN 100,A01,185168,Staff,0,2,25,25
1683656955972,ECE 5,A01,185626,Morris; Karcher William,0,11,0,0
1683656957012,ECE 101,A01,185628,Staff,14,0,70,56
1683656958041,ECE 107,A01,185635,Baghdadchi; Saharnaz,0,0,20,20
1683656958041,ECE 107,A02,185638,Baghdadchi; Saharnaz,2,0,20,18
1683656959069,ECE 148,A01,185647,Silberman; Jack,0,0,16,16
1683656960094,ECON 1,A01,185537,Crane; Meredith Helen,54,0,70,16
1683656961120,ECON 3,A01,185549,Crane; Meredith Helen,29,0,70,41
1683656962146,ECON 4,A01,203354,Anderson; John Charles,0,5,10,10
1683656963174,ECON 100A,A01,185574,Staff,0,5,40,40
1683656964199,ECON 100B,A01,185576,Staff,0,12,50,50
1683656965223,ECON 100C,A01,185589,Newhouse; Herbert S,30,0,70,40
1683656966248,ECON 105,A00,185608,Vespa; Emanuel Ignacio,19,0,35,16
1683656967272,ECON 109,A01,185610,Shishkin; Denis,9,0,35,26
1683656968294,ECON 110A,A01,185612,Staff,9,0,40,31
1683656969320,ECON 120A,A01,185615,Staff,20,0,40,20
1683656970343,ECON 120C,A01,185617,Sun; Yixiao,0,20,70,70
1683656971371,ECON 144,A00,203346,Squires; Dale E,2,0,35,33
1683656972397,ECON 171,A01,203349,Newhouse; Herbert S,0,1,35,35
1683656973429,ECON 173A,A01,185621,Toda; Alexis Akira,20,0,35,15
1683656974462,EDS 25,A01,202413,Staff,0,1,0,0
1683656974462,EDS 25,A02,202414,Staff,0,1,0,0
1683656974462,EDS 25,A03,202415,Staff,0,0,0,0
1683656974462,EDS 25,A04,202416,Staff,0,1,0,0
1683656974462,EDS 25,A05,202439,Staff,0,0,0,0
1683656974462,EDS 25,A06,202440,Staff,0,0,0,0
1683656974462,EDS 25,B01,202631,Staff,0,0,0,0
1683656974462,EDS 25,B02,202632,Staff,0,0,0,0
1683656974462,EDS 25,B03,202639,Staff,0,0,0,0
1683656974462,EDS 25,B04,202640,Staff,0,0,0,0
1683656974462,EDS 25,B05,202643,Staff,0,0,0,0
1683656974462,EDS 25,B06,202644,Staff,0,0,0,0
1683656975487,EDS 38,A01,202659,Black; Alison Michelle,24,0,25,1
1683656976514,EDS 115,A00,202652,Staff,18,0,30,12
1683656977537,EDS 125,A00,202649,Staff,13,0,30,17
1683656978564,EDS 126,A01,203332,Staff,30,0,30,0
1683656979588,EDS 139,A00,202838,Staff,16,0,25,9
1683656980616,EDS 146,A01,202655,Staff,14,0,25,11
1683656981647,ENG 15,A00,185667,Staff,0,1,0,0
1683656981647,ENG 15,B00,185672,Staff,0,0,0,0
1683656981647,ENG 15,C00,185675,Staff,0,0,0,0
1683656981647,ENG 15,D00,185682,Staff,0,0,0,0
1683656981647,ENG 15,E00,185684,Staff,0,0,0,0
1683656982673,ETHN 103,A00,185710,Staff,0,8,35,35
1683656983701,ETHN 103A,A00,199228,Man; Simeon S,0,0,9,9
1683656984723,ETHN 109,A00,185711,Staff,16,0,35,19
1683656985750,ETHN 142,A00,185726,Staff,0,4,30,30
1683656986776,ETHN 163J,A00,199229,Man; Simeon S,5,0,8,3
1683656987803,ETHN 168,A00,185727,Staff,7,0,10,3
1683656988832,ETHN 182,A00,185728,Staff,0,0,35,35
1683656989855,ETHN 183,A00,185737,Staff,9,0,18,9
1683656990880,GLBH 111,A01,209361,Burgos; Jose L.,0,0,0,0
1683656992931,HIEU 104,A00,185792,Staff,14,0,20,6
1683656993955,HIEU 115,A00,185800,Staff,0,0,20,20
1683656994979,HIEU 128,A00,185801,Staff,0,9,20,20
1683656996009,HIEU 147,A00,185802,Staff,15,0,20,5
1683656997035,HIEU 154,A00,185823,Staff,11,0,20,9
1683656998062,HILA 102,A00,185826,Staff,14,0,20,6
1683656999090,HILD 2C,A01,185778,Staff,0,13,20,20
1683657000118,HILD 7B,A01,185780,Kwak; Nancy,0,17,32,32
1683657000118,HILD 7B,A02,185781,Kwak; Nancy,0,18,32,32
1683657001143,HILD 30,A01,185791,Staff,12,0,20,8
1683657002171,HISC 119,A00,185830,Golan; Tal,0,9,20,20
1683657003261,HITO 156GS,A00,185831,Patterson; Patrick H.,0,0,0,23
1683657004285,HIUS 103,A00,185832,Man; Simeon S,0,4,20,20
1683657005312,HIUS 117,A00,185836,Kwak; Nancy,2,0,20,18
1683657006337,HIUS 125,A00,185840,Man; Simeon S,0,2,23,23
1683657007364,HIUS 149,A00,185845,Staff,1,0,20,19
1683657008389,HUM 3,A01,185882,Zavodny; Tatiana Sophia,0,8,50,50
1683657008389,HUM 3,B01,185899,Caldwell; Michael Alan,0,18,50,50
1683657009413,HUM 3GS,A00,185900,Patterson; Patrick H.,0,0,0,23
1683657010444,HUM 4,A01,185938,Zroka; Amy Liane,29,0,50,21
1683657010444,HUM 4,B01,185956,Watkins; Eric,0,4,50,50
1683657010444,HUM 4,B02,202209,Watkins; Eric,0,5,50,50
1683657010444,HUM 4,B03,202210,Watkins; Eric,0,5,50,50
1683657011468,HUM 5,A01,185958,West; Geoffrey Scott,1,0,50,49
1683657011468,HUM 5,A02,202215,West; Geoffrey Scott,0,0,50,50
1683657012494,INTL 190,A00,185959,Gagnon; Jeffrey C,0,0,0,9
1683657012494,INTL 190,B00,185960,Lettieri; Michael Joseph,0,0,0,2
1683657013521,JAPN 180,A00,254509,Staff,5,0,30,25
1683657014548,LATI 10,A01,202853,Kennemore; Amy Michelle,4,0,35,31
1683657014548,LATI 10,A02,202854,Kennemore; Amy Michelle,2,0,35,33
1683657014548,LATI 10,A03,270054,Kennemore; Amy Michelle,30,0,30,0
1683657015576,LATI 180,A00,202855,Kennemore; Amy Michelle,11,0,20,9
1683657016601,LAWS 101,A00,201767,Golan; Tal,0,7,40,40
1683657017628,LIFR 1C,A00,185961,Staff,6,0,20,14
1683657018653,LIFR 1CX,A00,185962,Staff,7,0,20,13
1683657019679,LIFR 1D,A00,185963,Staff,7,0,20,13
1683657020710,LIFR 1DX,A00,185964,Staff,7,0,20,13
1683657021743,LIGN 101,A01,186039,Staff,43,0,50,7
1683657022772,LIGN 165,A00,186040,Staff,15,0,50,35
1683657023799,LTCS 108,A00,186041,Staff,5,0,10,5
1683657024826,LTCS 119,A00,186042,Staff,15,0,20,5
1683657025854,LTCS 130,A00,186043,Wesling; Megan E.,15,0,25,10
1683657027904,LTEA 138,A00,186119,Staff,14,0,40,26
1683657028932,LTEN 124,A00,186148,Staff,5,0,25,20
1683657029956,LTEN 178,A00,186149,Staff,7,0,15,8
1683657030985,LTEN 181,A00,186150,Blanco; John D,34,0,40,6
1683657032012,LTWL 120,A00,186160,Staff,20,0,25,5
1683657033039,LTWL 165,A00,186161,Staff,22,0,25,3
1683657034061,LTWR 100,A00,186162,Staff,0,5,15,15
1683657035088,LTWR 102,A00,186163,Doller; Ben,5,0,15,10
1683657036117,MAE 8,A01,186412,Staff,0,0,0,0
1683657037144,MAE 30B,A00,186445,Bahadori; Mohammad Yousef,82,0,100,18
1683657038170,MAE 40,A00,186592,Bewley; Thomas R,10,0,50,40
1683657039197,MAE 101B,A00,186593,Bahadori; Mohammad Yousef,80,0,100,20
1683657040223,MAE 105,A00,186594,Bandaru; Prabhakar,10,0,50,40
1683657041249,MAE 107,A00,186599,Pham; Hieu Tan,0,7,120,120
1683657042277,MAE 148,A01,186660,Silberman; Jack,3,0,16,13
1683657043302,MATH 10A,A01,188095,Staff,0,6,35,35
1683657044334,MATH 10B,A01,188097,Bowers; Adam R.,0,12,30,30
1683657044334,MATH 10B,A02,188099,Bowers; Adam R.,0,11,30,30
1683657044334,MATH 10B,B01,188104,Bowers; Adam R.,0,10,30,30
1683657044334,MATH 10B,B02,188106,Bowers; Adam R.,1,9,30,29
1683657045358,MATH 10C,A01,188111,Staff,0,18,30,30
1683657045358,MATH 10C,A02,188127,Staff,0,19,30,30
1683657045358,MATH 10C,A03,188131,Staff,0,19,30,30
1683657045358,MATH 10C,B01,188218,Staff,17,0,30,13
1683657045358,MATH 10C,B02,188244,Staff,13,0,30,17
1683657045358,MATH 10C,B03,188277,Staff,14,0,30,16
1683657046390,MATH 18,A01,188344,Bach; Quang Tran,18,0,30,12
1683657046390,MATH 18,A02,188345,Bach; Quang Tran,11,0,30,19
1683657046390,MATH 18,B01,188353,Bach; Quang Tran,11,0,30,19
1683657046390,MATH 18,B02,188354,Bach; Quang Tran,19,0,30,11
1683657047417,MATH 20A,A01,188374,Staff,11,0,35,24
1683657048443,MATH 20B,A01,188382,Ohm; Ko Woon,7,0,30,23
1683657048443,MATH 20B,A02,188383,Ohm; Ko Woon,22,0,30,8
1683657048443,MATH 20B,B01,188385,Ohm; Ko Woon,7,0,30,23
1683657048443,MATH 20B,B02,188392,Ohm; Ko Woon,22,0,30,8
1683657049468,MATH 20C,A01,188394,Harel; Guershon,11,0,30,19
1683657049468,MATH 20C,A02,188395,Harel; Guershon,13,0,30,17
1683657049468,MATH 20C,B01,188404,Harel; Guershon,5,0,30,25
1683657049468,MATH 20C,B02,188405,Harel; Guershon,18,0,30,12
1683657050492,MATH 20D,A01,188414,Hammock; Frances H,0,1,30,30
1683657050492,MATH 20D,A02,188415,Hammock; Frances H,0,1,30,30
1683657050492,MATH 20D,B01,188447,Hammock; Frances H,0,1,30,30
1683657050492,MATH 20D,B02,188486,Hammock; Frances H,4,0,30,26
1683657051520,MATH 20E,A01,188649,Staff,21,0,30,9
1683657051520,MATH 20E,A02,188650,Staff,21,0,30,9
1683657051520,MATH 20E,A03,188673,Staff,0,0,30,30
1683657052550,MATH 102,A01,188675,Staff,0,36,35,35
1683657053578,MATH 103B,A01,188681,Staff,3,0,35,32
1683657053578,MATH 103B,B01,188692,Staff,5,0,35,30
1683657054604,MATH 109,A01,188695,Salehi Golsefidy; Alireza,24,0,35,11
1683657054604,MATH 109,A02,188696,Salehi Golsefidy; Alireza,25,0,35,10
1683657055629,MATH 120A,A01,188698,Eggers; John Dietrich,7,0,35,28
1683657056660,MATH 142B,A01,188736,Ioana; Adrian,0,1,30,30
1683657056660,MATH 142B,A02,188741,Ioana; Adrian,0,1,30,30
1683657056660,MATH 142B,A03,188743,Ioana; Adrian,0,1,30,30
1683657057685,MATH 168A,A01,188790,Staff,0,10,35,35
1683657058712,MATH 170A,A01,188803,Nie; Jiawang,0,2,35,35
1683657058712,MATH 170A,A02,188811,Nie; Jiawang,0,0,35,35
1683657058712,MATH 170A,A03,188814,Nie; Jiawang,0,0,35,35
1683657058712,MATH 170A,A04,188815,Nie; Jiawang,10,0,35,25
1683657059739,MATH 193B,A01,188817,Staff,0,0,35,35
1683657059739,MATH 193B,A02,188818,Staff,5,0,35,30
1683657060768,MGT 4,A01,202857,Anderson; John Charles,61,0,80,19
1683657061793,MGT 12,A00,202858,Lindenberger; Wade Douglas,40,0,90,50
1683657062818,MGT 18,A00,202859,Staff,74,0,90,16
1683657063845,MGT 18GS,A00,202860,McKay; Michael J,13,0,28,15
1683657064873,MGT 45,A00,202861,Pecore; Joseph P.,12,0,90,78
1683657065898,MGT 100,A00,202863,Yavorsky; Daniel Ryan,28,0,90,62
1683657066923,MGT 103,A00,202864,Ehrich; Kristine R,0,17,90,90
1683657067948,MGT 112,A00,202865,Ehrich; Kristine R,15,0,90,75
1683657068973,MGT 121A,A00,202868,Staff,90,20,90,0
1683657069999,MGT 131B,A00,202869,Anderson; John Charles,59,0,90,31
1683657071025,MGT 136,A00,202871,Lindenberger; Wade Douglas,83,0,90,7
1683657072055,MGT 164,A00,202873,Staff,0,66,90,91
1683657073080,MGT 164GS,A00,202874,McKay; Mary A,13,0,28,15
1683657074106,MGT 180,A00,202875,Staff,0,50,90,91
1683657075130,MMW 11R,A01,205019,Herbst; Matthew,2,0,30,28
1683657075130,MMW 11R,A02,205026,Herbst; Matthew,29,0,30,1
1683657076156,MMW 15,A01,193512,Chang; Edmond Yi-Teh,0,8,28,28
1683657076156,MMW 15,A02,193513,Chang; Edmond Yi-Teh,0,5,28,28
1683657076156,MMW 15,A03,193514,Chang; Edmond Yi-Teh,0,5,28,28
1683657076156,MMW 15,A04,193515,Chang; Edmond Yi-Teh,0,5,28,28
1683657076156,MMW 15,A05,193516,Chang; Edmond Yi-Teh,0,5,28,28
1683657076156,MMW 15,A06,193517,Chang; Edmond Yi-Teh,0,6,28,28
1683657076156,MMW 15,B01,193519,Chang; Edmond Yi-Teh,0,5,28,28
1683657076156,MMW 15,B02,193520,Chang; Edmond Yi-Teh,0,5,28,28
1683657076156,MMW 15,B03,193521,Chang; Edmond Yi-Teh,0,5,28,28
1683657076156,MMW 15,B04,193522,Chang; Edmond Yi-Teh,0,5,28,28
1683657076156,MMW 15,B05,193523,Chang; Edmond Yi-Teh,0,5,28,28
1683657076156,MMW 15,B06,193524,Chang; Edmond Yi-Teh,0,5,28,28
1683657077181,MMW 122,A01,193526,Rahimi; Babak,0,16,28,28
1683657077181,MMW 122,A02,193527,Rahimi; Babak,0,15,28,28
1683657077181,MMW 122,A03,193528,Rahimi; Babak,0,0,0,0
1683657077181,MMW 122,A04,193529,Rahimi; Babak,0,0,0,0
1683657078206,MUS 1A,A01,186663,Staff,1,20,35,34
1683657079230,MUS 4,A01,186715,Staff,0,12,35,35
1683657080255,MUS 5R,A01,186796,Dubnov; Shlomo,0,17,35,35
1683657081280,MUS 6,A01,186798,Staff,0,5,25,25
1683657082307,MUS 7,A01,186830,Staff,11,0,35,24
1683657083334,MUS 8,A01,186930,Staff,0,26,35,35
1683657084361,MUS 15,A01,186932,Staff,0,16,35,35
1683657084361,MUS 15,B01,186934,Staff,0,17,35,35
1683657085385,MUS 80,A00,186935,Staff,0,0,20,20
1683657085385,MUS 80,B00,186936,Staff,24,0,25,1
1683657086413,NANO 11,A00,204702,Lipomi; Darren John,0,0,0,0
1683657087439,NANO 15,A01,204709,Yang; Kesong,0,1,0,0
1683657088465,NANO 114,A00,202069,Jahed Motlagh; Zeinab,3,0,10,7
1683657089493,PHIL 1,A00,186955,Grush; Rick Scott,31,0,40,9
1683657090520,PHIL 10,A01,186973,Grush; Rick Scott,27,0,35,8
1683657090520,PHIL 10,A02,186974,Grush; Rick Scott,33,0,35,2
1683657091548,PHIL 13,A01,186976,Staff,3,0,35,32
1683657091548,PHIL 13,A02,186977,Staff,16,0,35,19
1683657092573,PHIL 14,A01,186979,Staff,31,0,35,4
1683657092573,PHIL 14,A02,186986,Staff,32,0,35,3
1683657093597,PHIL 28,A01,186988,Staff,16,0,30,14
1683657093597,PHIL 28,A02,186989,Staff,1,0,30,29
1683657093597,PHIL 28,A03,186990,Staff,10,0,30,20
1683657093597,PHIL 28,A04,186991,Staff,26,0,30,4
1683657094626,PHIL 120,A00,186997,Staff,23,0,40,17
1683657095653,PHIL 137,A00,187003,Staff,7,0,40,33
1683657096678,PHIL 150,A00,187015,Staff,47,0,70,23
1683657097704,PHIL 167,A00,187021,Lamey; Andy M.,34,0,40,6
1683657098729,PHIL 174,A01,202226,Staff,17,0,20,3
1683657098729,PHIL 174,A02,202235,Staff,20,0,20,0
1683657099757,PHIL 191A,A00,258918,Staff,0,0,1,1
1683657100781,PHYS 1A,A00,187028,Staff,26,0,60,34
1683657101810,PHYS 1AL,001,187036,Staff,3,0,30,27
1683657101810,PHYS 1AL,002,187049,Staff,18,0,30,12
1683657102841,PHYS 1B,A00,187058,Staff,22,0,60,38
1683657103870,PHYS 1BL,001,187064,Staff,0,1,30,30
1683657103870,PHYS 1BL,002,187070,Staff,4,0,30,26
1683657104895,PHYS 1C,A00,187082,Staff,29,0,120,91
1683657105920,PHYS 1CL,001,187088,Staff,0,9,30,30
1683657105920,PHYS 1CL,002,187089,Staff,0,1,30,30
1683657105920,PHYS 1CL,009,262693,Staff,9,0,30,21
1683657107010,PHYS 2B,A01,187097,Staff,55,0,115,60
1683657108033,PHYS 2C,A01,187099,Staff,63,0,115,52
1683657109057,PHYS 2CL,A01,187101,Staff,5,0,28,23
1683657109057,PHYS 2CL,A02,187102,Staff,15,0,28,13
1683657110084,PHYS 2D,A01,187123,Shotwell; Brian,95,0,115,20
1683657111114,PHYS 4B,A01,187133,Grinstein; Benjamin,35,0,50,15
1683657112140,POLI 10,A00,188819,Staff,0,4,50,50
1683657113165,POLI 11,A00,188827,Staff,43,0,50,7
1683657114194,POLI 13R,A00,188828,Staff,0,1,20,20
1683657115223,POLI 27,A01,188830,Elgin; Samuel Zincke,0,2,70,70
1683657116249,POLI 30,A00,188832,Desposato; Scott,30,0,50,20
1683657117274,POLI 102F,A00,188834,Staff,0,1,40,40
1683657118300,POLI 104A,A00,188852,Staff,13,0,30,17
1683657119325,POLI 104I,A00,188853,Staff,0,7,20,20
1683657120349,POLI 110B,A00,188854,Wiens; David,6,0,20,14
1683657121376,POLI 112A,A00,188855,Wiens; David,3,0,30,27
1683657122400,POLI 117R,A00,188856,Forman; Fonna,0,12,20,20
1683657123427,POLI 118,A00,188857,Ingham; Sean,8,0,20,12
1683657124455,POLI 120G,A00,188858,Staff,8,0,30,22
1683657125480,POLI 131CR,A00,188863,Hoston; Germaine,21,0,50,29
1683657126504,POLI 133,A00,188864,Nellis; Gareth Hb,44,0,50,6
1683657127532,POLI 134D,A00,188865,Desposato; Scott,27,0,30,3
1683657128561,POLI 142A,A00,188871,Gartzke; Erik,21,0,50,29
1683657129586,POLI 142K,A00,188874,Staff,38,0,50,12
1683657130609,POLI 143,A00,188940,Gartzke; Erik,16,0,30,14
1683657131639,POLI 153,A00,188943,Staff,2,0,20,18
1683657132665,POLI 160AA,A00,188944,Staff,11,0,40,29
1683657133693,POLI 170A,A00,188945,Staff,11,0,30,19
1683657135746,PSYC 1,A00,188952,Staff,36,0,90,54
1683657136775,PSYC 2,B00,188953,Staff,19,0,35,16
1683657137809,PSYC 6,A00,188970,Staff,47,0,60,13
1683657138842,PSYC 7,A00,188973,Staff,35,0,45,10
1683657139867,PSYC 60,A01,188980,Rickard; Timothy C.,42,0,60,18
1683657140896,PSYC 70,A01,189001,Steiner; Eric Tomas,22,0,45,23
1683657141920,PSYC 100,A00,189005,Lacefield; Katharine I,0,99,120,120
1683657142945,PSYC 102,A00,189008,Staff,8,0,30,22
1683657143971,PSYC 106,B00,189026,Gorman; Michael R.,27,0,60,33
1683657144996,PSYC 114,B01,189033,Winkielman; Piotr,0,31,30,30
1683657146021,PSYC 131,A00,189036,Anagnostaras; Stephan,0,43,60,60
1683657147046,PSYC 136,A00,189041,Lowe; Angela Beth,0,7,25,25
1683657148069,PSYC 137,A00,189057,Winkielman; Piotr,0,37,25,25
1683657149093,PSYC 144,A00,189107,Wixted; John T,0,11,50,50
1683657151145,PSYC 162,A00,189142,Staff,0,9,85,85
1683657152172,PSYC 172,A00,189144,Gorman; Michael R.,0,6,30,30
1683657154222,PSYC 179,A00,189146,Lacefield; Katharine I,0,87,120,120
1683657155246,PSYC 181,A00,189147,Anagnostaras; Stephan,0,44,90,90
1683657156273,PSYC 190R,A00,189148,Barner; David A.,0,23,80,80
1683657157298,PSYC 191,A00,189275,Rickard; Timothy C.,0,10,25,25
1683657158324,PSYC 193,A00,189276,Chapman; Eddie Nathaniel,0,1,0,4
1683657159353,PSYC 193L,A01,189281,Lowe; Angela Beth,10,0,20,10
1683657159353,PSYC 193L,B01,189285,Staff,28,0,35,7
1683657160380,RELI 149,A00,187137,Rahimi; Babak,7,0,40,33
1683657161402,SE 9,A01,187315,Staff,0,2,18,18
1683657162430,SE 101B,A00,187409,Staff,24,0,30,6
1683657163454,SE 110B,A00,187444,Staff,10,0,40,30
1683657164486,SE 130B,A00,187449,Staff,31,0,40,9
1683657165514,SE 150A,A00,187516,Staff,9,0,20,11
1683657166538,SE 154,A00,187528,Staff,29,0,50,21
1683657167567,SIO 3,A01,258171,Staff,35,0,40,5
1683657168592,SIO 10,A00,187144,Cook; Geoffrey W,0,6,75,75
1683657169615,SIO 45,A00,187152,Cook; Geoffrey W,0,4,100,100
1683657170640,SIO 109R,A00,194486,Staff,0,4,20,20
1683657172690,SIO 187,A01,187233,Kacev; David,12,0,40,28
1683657173717,SOCI 1,A01,258656,Thorpe; Charles Robert,28,0,30,2
1683657173717,SOCI 1,A02,258658,Thorpe; Charles Robert,30,0,30,0
1683657173717,SOCI 1,A03,258661,Thorpe; Charles Robert,25,0,25,0
1683657173717,SOCI 1,A04,258666,Thorpe; Charles Robert,22,0,25,3
1683657173717,SOCI 1,A05,258897,Thorpe; Charles Robert,22,0,25,3
1683657173717,SOCI 1,A06,258898,Thorpe; Charles Robert,25,0,25,0
1683657174742,SOCI 30,A01,258903,Pardo Guerra; Juan Pablo,14,0,30,16
1683657175773,SOCI 102,A00,258904,Staff,9,0,25,16
1683657176802,SOCI 106,A00,258905,Staff,19,0,25,6
1683657177826,SOCI 111,A00,258907,Ribas Norris; Janet Vanesa,26,0,30,4
1683657178851,SOCI 121R,A00,258908,Pardo Guerra; Juan Pablo,8,0,30,22
1683657179877,SOCI 126,A01,203330,Staff,14,0,20,6
1683657180904,SOCI 131,A00,258909,Thorpe; Charles Robert,30,0,60,30
1683657181934,SOCI 135,A00,258910,Payne; Christine Anna,0,11,30,30
1683657182961,SOCI 157,A00,258911,Staff,12,0,30,18
1683657183983,SOCI 184,A00,258912,Staff,25,0,30,5
1683657185011,SOCI 188D,A00,258913,Staff,22,0,30,8
1683657186038,SYN 2,001,187529,Staff,9,0,16,7
1683657186038,SYN 2,002,201452,Staff,0,20,16,16
1683657186038,SYN 2,003,201469,Staff,2,0,16,14
1683657187063,SYN 100,A01,187531,Staff,0,9,20,20
1683657187063,SYN 100,B01,201491,Staff,0,10,20,20
1683657188087,TDAC 1,A00,189286,Walsh; Kim C.,3,0,20,17
1683657188087,TDAC 1,B00,189287,Harting; Carla Kelso,10,0,20,10
1683657189111,TDAC 101,A00,189300,Walsh; Kim C.,16,0,20,4
1683657189111,TDAC 101,B00,189301,Harting; Carla Kelso,18,0,20,2
1683657190134,TDAC 102,A00,189304,Basso; Beatrice,14,0,20,6
1683657191159,TDAC 108,A00,189305,Staff,18,0,20,2
1683657192185,TDDE 131,A00,189310,Staff,19,0,20,1
1683657192185,TDDE 131,B00,189314,Staff,19,0,20,1
1683657192185,TDDE 131,C00,189315,Staff,48,0,50,2
1683657192185,TDDE 131,D00,189316,Staff,14,0,15,1
1683657192185,TDDE 131,E00,204841,Staff,20,0,20,0
1683657193209,TDGE 10,A00,189289,Staff,27,0,50,23
1683657193209,TDGE 10,B00,189290,Havis; Allan,0,0,50,50
1683657194238,TDGE 11,A00,189291,Fulton; Julia,0,4,50,50
1683657194238,TDGE 11,B00,189292,Staff,20,0,25,5
1683657194238,TDGE 11,C00,260270,Staff,0,0,0,0
1683657195268,TDGE 25,A00,189294,Staff,2,0,20,18
1683657196296,TDGE 124,A00,189318,Fulton; Julia,0,8,50,50
1683657197323,TDGE 125,A00,189319,Staff,13,0,25,12
1683657197323,TDGE 125,B00,189320,Staff,23,0,25,2
1683657198348,TDGE 127,A00,189322,Havis; Allan,0,0,50,50
1683657199374,TDHT 101,A00,189323,Staff,18,0,25,7
1683657199374,TDHT 101,B00,189324,Staff,25,0,25,0
1683657200402,TDHT 102,A00,189325,Staff,49,0,50,1
1683657201427,TDMV 1,A00,189295,Arcidiacono; Kristin,20,0,30,10
1683657201427,TDMV 1,B00,189296,Caligagan; Maria T.,24,0,30,6
1683657202455,TDMV 2,A00,189297,Sammartano; Tonnie,27,0,30,3
1683657202455,TDMV 2,B00,189299,Arcidiacono; Kristin,23,0,30,7
1683657203485,TDMV 3,A00,204998,Rincon; Alicia,22,0,30,8
1683657204511,TDMV 120,A00,189458,Sammartano; Tonnie,28,0,30,2
1683657205536,TDMV 138,A00,189541,Jun; Grace Shin Hae,20,0,40,20
1683657206566,TDMV 142,A00,189717,Caligagan; Tony,25,0,30,5
1683657206566,TDMV 142,B00,189718,Caligagan; Maria T.,25,0,30,5
1683657207593,TMC 2,A01,187533,Staff,25,0,25,0
1683657207593,TMC 2,A02,187534,Staff,25,0,25,0
1683657208621,USP 1,A01,187536,Kwak; Nancy,0,16,25,25
1683657209649,USP 5,A01,187538,Staff,9,0,25,16
1683657210735,USP 101,A00,199253,Staff,0,4,0,0
1683657211806,USP 124,A00,187562,Boomhower; Matthew Charles,0,0,30,30
1683657212831,USP 138,A00,187582,Staff,20,0,25,5
1683657213855,USP 152,A01,187597,Staff,3,0,25,22
1683657214880,USP 153,A00,187598,Staff,19,0,25,6
1683657215909,USP 168,A00,187607,Kwak; Nancy,2,0,5,3
1683657216934,USP 173,A00,187619,Staff,4,0,25,21
1683657217958,USP 181,A00,187638,Staff,0,4,25,25
1683657218985,VIS 103,A00,187650,Cruz; Edwin Teddy,18,0,75,57
1683657220010,VIS 110D,A00,187669,Staff,13,0,22,9
1683657221036,VIS 127C,A00,187720,Shen; Kuiyi,67,0,146,79
1683657222064,VIS 149,A00,187731,Yoldas; Pinar,0,14,22,22
1683657223087,VIS 151,A01,188091,Staff,22,0,34,12
1683657223087,VIS 151,A02,188092,Staff,11,0,34,23
1683657224116,VIS 160B,A00,188093,Stalbaum; Brett,0,1,10,10
1683657226169,WCWP 10B,A00,201720,Staff,10,0,15,5
1683657226169,WCWP 10B,B00,201722,Staff,9,0,15,6
1683657227196,WCWP 100,A00,201725,Gagnon; Jeffrey C,0,0,2,2
1683657227196,WCWP 100,B00,201727,Staff,0,4,15,15
1683657230298,ANBI 133,A00,258401,Wilder; Linnea Lorene,34,0,40,6
1683657231323,ANBI 140,A00,258395,Hrvoj Mihic; Branka,18,0,25,7
1683657232347,ANSC 120,A00,258402,Bialecki; Jon Anthony,26,0,40,14
1683657233372,ANSC 144,A00,258400,Staff,12,0,40,28
1683657235426,ANSC 166,A00,258396,Parish; Steven Martin,156,0,175,19
1683657236451,ANSC 180,A00,193533,Staff,8,0,20,12
1683657237478,ANSC 188,A00,258397,Jassal; Aftab,34,0,40,6
1683657238503,ANTH 3,A01,258316,Staff,23,0,30,7
1683657239528,ANTH 5,A00,258394,Semendeferi; Ekaterini,16,0,20,4
1683657240553,ANTH 21,A01,258331,Staff,4,0,40,36
1683657241578,ANTH 103,A00,258398,Varma; Saiba,15,0,25,10
1683657242609,AWP 10,001,202034,Staff,0,0,0,0
1683657242609,AWP 10,002,202035,Staff,0,0,0,0
1683657242609,AWP 10,003,202036,Staff,0,0,0,0
1683657242609,AWP 10,004,202037,Staff,0,0,0,0
1683657242609,AWP 10,005,202038,Staff,0,0,0,0
1683657242609,AWP 10,006,202039,Staff,0,0,0,0
1683657242609,AWP 10,007,202040,Staff,0,0,0,0
1683657242609,AWP 10,008,202041,Staff,0,0,0,0
1683657242609,AWP 10,009,202042,Staff,0,0,0,0
1683657242609,AWP 10,010,202043,Staff,0,0,0,0
1683657242609,AWP 10,011,202044,Staff,0,0,0,0
1683657242609,AWP 10,012,202045,Staff,0,0,0,0
1683657242609,AWP 10,013,202046,Staff,0,0,0,0
1683657242609,AWP 10,014,202047,Staff,0,0,0,0
1683657242609,AWP 10,015,202048,Staff,0,0,0,0
1683657242609,AWP 10,016,202049,Staff,0,0,0,0
1683657242609,AWP 10,017,202050,Staff,0,0,0,0
1683657242609,AWP 10,018,202051,Staff,0,0,0,0
1683657242609,AWP 10,019,202052,Staff,0,0,0,0
1683657242609,AWP 10,020,202053,Staff,0,0,0,0
1683657242609,AWP 10,021,202054,Staff,0,0,0,0
1683657242609,AWP 10,022,202055,Staff,0,0,0,0
1683657242609,AWP 10,023,202056,Staff,0,0,0,0
1683657242609,AWP 10,024,202057,Staff,0,0,0,0
1683657242609,AWP 10,025,202058,Staff,0,0,0,0
1683657242609,AWP 10,026,202059,Staff,0,0,0,0
1683657243635,AWP 102,001,202032,Staff,0,0,0,0
1683657243635,AWP 102,002,202033,Staff,0,0,0,0
1683657244661,BENG 100,A01,254234,Taylor Amos; Alyssa C,31,0,40,9
1683657245688,BENG 196,001,270013,Engler; Adam J.,9999,0,9999,0
1683657246714,BICD 100R,A01,202018,Smith; Laurie,0,7,32,32
1683657246714,BICD 100R,A02,202019,Smith; Laurie,0,3,32,32
1683657246714,BICD 100R,A03,202020,Smith; Laurie,0,1,32,32
1683657246714,BICD 100R,A04,202021,Smith; Laurie,6,0,32,26
1683657246714,BICD 100R,A05,202022,Smith; Laurie,11,0,32,21
1683657247741,BICD 136,A01,193242,Gustafson-Brown; Cindy,0,2,32,32
1683657247741,BICD 136,A02,193244,Gustafson-Brown; Cindy,13,0,32,19
1683657248766,BIEB 102,A01,193249,Butler; Shannon Rhey,0,2,32,32
1683657248766,BIEB 102,A02,193251,Butler; Shannon Rhey,0,0,32,32
1683657248766,BIEB 102,A03,193253,Butler; Shannon Rhey,0,0,32,32
1683657248766,BIEB 102,A04,193255,Butler; Shannon Rhey,14,0,32,18
1683657248766,BIEB 102,A05,193265,Butler; Shannon Rhey,26,0,32,6
1683657248766,BIEB 102,A06,193269,Butler; Shannon Rhey,14,0,32,18
1683657250817,BIEB 150,A01,193274,Staff,0,0,32,32
1683657250817,BIEB 150,A02,193285,Staff,24,0,32,8
1683657251845,BIEB 194,A00,193286,Kurle; Carolyn M.,20,0,32,12
1683657252873,BILD 1,A01,192291,Staff,15,0,32,17
1683657252873,BILD 1,A02,192292,Staff,30,0,32,2
1683657252873,BILD 1,B01,192520,Reuther; Keefe,0,1,0,0
1683657252873,BILD 1,B02,192532,Reuther; Keefe,0,1,0,0
1683657253900,BILD 3,A01,192556,Butler; Shannon Rhey,0,0,32,32
1683657253900,BILD 3,A02,192581,Butler; Shannon Rhey,1,0,32,31
1683657253900,BILD 3,A03,192611,Butler; Shannon Rhey,21,0,32,11
1683657253900,BILD 3,A04,192612,Butler; Shannon Rhey,24,0,32,8
1683657253900,BILD 3,A05,192613,Butler; Shannon Rhey,26,0,32,6
1683657253900,BILD 3,A06,192679,Butler; Shannon Rhey,27,0,32,5
1683657253900,BILD 3,A07,192682,Butler; Shannon Rhey,20,0,32,12
1683657254931,BILD 4,A01,192836,Reuther; Keefe,1,0,24,23
1683657254931,BILD 4,A02,193044,Reuther; Keefe,4,0,24,20
1683657255957,BILD 10,A01,193142,Gustafson-Brown; Cindy,29,0,32,3
1683657255957,BILD 10,A02,193149,Gustafson-Brown; Cindy,31,0,32,1
1683657256983,BIMM 100,A01,193301,Staff,0,6,32,32
1683657256983,BIMM 100,A02,193312,Staff,0,7,32,32
1683657256983,BIMM 100,A03,193323,Staff,0,9,32,32
1683657258008,BIMM 101,A01,193329,McDonnell; Lisa Marie,0,4,24,24
1683657258008,BIMM 101,A02,193339,McDonnell; Lisa Marie,1,3,24,23
1683657258008,BIMM 101,B01,193354,McDonnell; Lisa Marie,0,4,24,24
1683657258008,BIMM 101,B02,193357,McDonnell; Lisa Marie,0,3,24,24
1683657259037,BIMM 110,A01,193377,Tat; John,0,11,32,32
1683657259037,BIMM 110,A02,193378,Tat; John,0,10,32,32
1683657260063,BIMM 120,A01,206116,Staff,0,0,32,32
1683657260063,BIMM 120,A02,206117,Staff,6,0,32,26
1683657260063,BIMM 120,A03,206121,Staff,21,0,32,11
1683657261089,BIPN 100,A01,193393,Park; Ji Young,0,15,32,32
1683657261089,BIPN 100,A02,193402,Park; Ji Young,0,14,32,32
1683657261089,BIPN 100,A03,193413,Park; Ji Young,0,14,32,32
1683657261089,BIPN 100,A04,193414,Park; Ji Young,0,13,32,32
1683657262112,BIPN 102,A01,193429,Staff,0,0,32,32
1683657262112,BIPN 102,A02,193438,Staff,18,0,32,14
1683657263140,BIPN 106,A01,193450,Reyes Gonzalez; Catalina,0,2,40,40
1683657264166,BIPN 134,A01,193465,Cooke; James Edward,0,0,32,32
1683657264166,BIPN 134,A02,193474,Cooke; James Edward,25,0,32,7
1683657264166,BIPN 134,A03,193485,Cooke; James Edward,29,0,32,3
1683657264166,BIPN 134,A04,193486,Cooke; James Edward,20,0,32,12
1683657264166,BIPN 134,A05,193491,Cooke; James Edward,31,0,32,1
1683657264166,BIPN 134,A06,193501,Cooke; James Edward,30,0,32,2
1683657264166,BIPN 134,A07,193510,Cooke; James Edward,29,0,32,3
1683657266217,BISP 194,A00,222522,Staff,14,0,32,18
1683657267245,CAT 124,A01,202407,Staff,19,0,25,6
1683657268272,CAT 125,A00,202408,Marchisotto; Jennifer Anne,2,0,20,18
1683657269301,CAT 125R,A00,202409,Smith; Lauryn Alissa,0,11,20,20
1683657269301,CAT 125R,B00,202410,Morales; Celeste Georgianna,0,11,20,20
1683657269301,CAT 125R,C00,202411,Irwin; Matthew Joseph,0,12,20,20
1683657270328,CENG 15,A01,204712,Yang; Kesong,0,1,0,0
1683657271358,CENG 114,A00,202070,Jahed Motlagh; Zeinab,5,0,20,15
1683657272383,CGS 105,A00,185477,Wesling; Megan E.,24,0,40,16
1683657273409,CGS 106,A00,185494,Staff,11,0,22,11
1683657274438,CGS 108,A00,185495,Staff,14,0,20,6
1683657275466,CGS 114,A00,185496,Staff,13,0,18,5
1683657276494,CGS 119,A00,185501,Staff,15,0,20,5
1683657277518,CGS 120,A00,185511,Staff,12,0,20,8
1683657278542,CHEM 4,A01,184675,Bussey; Thomas J,97,0,100,3
1683657279569,CHEM 6A,A01,184677,Staff,33,0,60,27
1683657280594,CHEM 6B,A01,184679,Staff,63,0,100,37
1683657281623,CHEM 6C,A01,184681,Bussey; Thomas J,0,0,50,50
1683657281623,CHEM 6C,A02,184682,Bussey; Thomas J,32,0,50,18
1683657282648,CHEM 40A,A01,184684,Albizati; Kim F.,34,0,100,66
1683657283676,CHEM 40B,A01,184686,Albizati; Kim F.,0,22,100,100
1683657284703,CHEM 41B,A01,184690,Staff,51,0,100,49
1683657285729,COGS 3,A01,184715,Boyle; Mary E. T.,0,27,40,40
1683657286754,COGS 14B,A01,185172,Staff,0,14,38,38
1683657287781,COGS 18,A01,184736,Staff,14,0,80,66
1683657288805,COGS 100,A01,184932,Staff,0,7,73,73
1683657289830,COGS 101A,A01,184935,Staff,0,39,30,30
1683657290853,COGS 101B,A01,184944,Staff,0,2,30,30
1683657291877,COGS 101C,A01,184946,Staff,0,10,30,30
1683657292903,COGS 102A,A01,184951,Johnson; Christine M.,2,0,40,38
1683657293931,COGS 107B,A01,184953,Mooshagian; Eric Frederick,0,51,40,40
1683657294958,COGS 118B,A01,184959,Gupta; Anjum,0,49,40,40
1683657295989,COGS 153,A00,184961,Staff,0,16,30,30
1683657297015,COGS 177,A00,184962,Staff,0,21,30,30
1683657298039,COGS 187A,A01,184969,Boyle; Mary E. T.,0,19,40,40
1683657299064,COMM 10,A01,185174,Staff,0,5,25,25
1683657299064,COMM 10,A02,185189,Staff,0,2,25,25
1683657299064,COMM 10,A03,269821,Staff,0,1,0,0
1683657300089,COMM 100B,A01,185475,Staff,0,1,0,2
1683657300089,COMM 100B,A02,185476,Staff,12,0,25,13
1683657301127,COMM 100C,A01,185314,Staff,1,0,25,24
1683657301127,COMM 100C,A02,185327,Staff,18,0,25,7
1683657302157,COMM 110M,A00,185349,Staff,0,0,40,40
1683657303184,COMM 113T,A00,185352,Staff,25,0,40,15
1683657304209,COMM 114I,A00,185353,Staff,31,0,40,9
1683657305232,COMM 131,A00,185354,Staff,17,0,30,13
1683657306259,CSE 8A,A50,185358,Cao; Yingjun,0,46,10,10
1683657307284,CSE 8B,A01,185362,Staff,0,48,50,50
1683657308314,CSE 11,A01,185416,Cao; Yingjun,0,91,10,10
1683657309338,CSE 20,A01,185445,Briones; Jor-el Thomas Caparas,4,0,25,21
1683657310365,CSE 21,A01,185447,Staff,9,0,50,41
1683657311394,CSE 101,A01,185451,Staff,0,13,50,50
1683657311394,CSE 101,B01,185453,Jones; Miles E,0,13,50,50
1683657313450,CSE 141,A01,185458,Eldon; John,16,0,100,84
1683657314555,CSE 141L,A01,185461,Eldon; John,8,0,100,92
1683657315585,CSE 142,A01,185463,Staff,34,0,60,26
1683657315585,CSE 142,B01,201355,Staff,0,7,60,60
1683657316610,CSE 142L,A01,185470,Staff,34,0,60,26
1683657316610,CSE 142L,B01,201417,Staff,0,6,60,60
1683657317636,CSE 190,A00,201433,Staff,32,0,49,17
1683657318665,DOC 1,A01,259136,Strom; Megan C.,7,0,15,8
1683657318665,DOC 1,A02,259137,Strom; Megan C.,14,0,15,1
1683657318665,DOC 1,A03,259138,Strom; Megan C.,14,0,15,1
1683657318665,DOC 1,A04,259139,Strom; Megan C.,14,0,15,1
1683657319695,DOC 100D,A00,259140,Pass; Natalye Joann,14,0,25,11
1683657320724,DSGN 1,A01,184749,Rill; Bryan,0,26,30,30
1683657321751,DSGN 100,A01,185168,Staff,0,2,25,25
1683657322774,ECE 5,A01,185626,Morris; Karcher William,0,11,0,0
1683657323799,ECE 101,A01,185628,Staff,14,0,70,56
1683657324829,ECE 107,A01,185635,Baghdadchi; Saharnaz,0,0,20,20
1683657324829,ECE 107,A02,185638,Baghdadchi; Saharnaz,2,0,20,18
1683657325858,ECE 148,A01,185647,Silberman; Jack,0,0,16,16
1683657326881,ECON 1,A01,185537,Crane; Meredith Helen,54,0,70,16
1683657327906,ECON 3,A01,185549,Crane; Meredith Helen,29,0,70,41
1683657328931,ECON 4,A01,203354,Anderson; John Charles,0,5,10,10
1683657329959,ECON 100A,A01,185574,Staff,0,5,40,40
1683657330984,ECON 100B,A01,185576,Staff,0,12,50,50
1683657332012,ECON 100C,A01,185589,Newhouse; Herbert S,30,0,70,40
1683657333036,ECON 105,A00,185608,Vespa; Emanuel Ignacio,19,0,35,16
1683657334063,ECON 109,A01,185610,Shishkin; Denis,9,0,35,26
1683657335088,ECON 110A,A01,185612,Staff,9,0,40,31
1683657336116,ECON 120A,A01,185615,Staff,20,0,40,20
1683657337139,ECON 120C,A01,185617,Sun; Yixiao,0,20,70,70
1683657338167,ECON 144,A00,203346,Squires; Dale E,2,0,35,33
1683657339191,ECON 171,A01,203349,Newhouse; Herbert S,0,1,35,35
1683657340214,ECON 173A,A01,185621,Toda; Alexis Akira,20,0,35,15
1683657341245,EDS 25,A01,202413,Staff,0,1,0,0
1683657341245,EDS 25,A02,202414,Staff,0,1,0,0
1683657341245,EDS 25,A03,202415,Staff,0,0,0,0
1683657341245,EDS 25,A04,202416,Staff,0,1,0,0
1683657341245,EDS 25,A05,202439,Staff,0,0,0,0
1683657341245,EDS 25,A06,202440,Staff,0,0,0,0
1683657341245,EDS 25,B01,202631,Staff,0,0,0,0
1683657341245,EDS 25,B02,202632,Staff,0,0,0,0
1683657341245,EDS 25,B03,202639,Staff,0,0,0,0
1683657341245,EDS 25,B04,202640,Staff,0,0,0,0
1683657341245,EDS 25,B05,202643,Staff,0,0,0,0
1683657341245,EDS 25,B06,202644,Staff,0,0,0,0
1683657342273,EDS 38,A01,202659,Black; Alison Michelle,24,0,25,1
1683657343297,EDS 115,A00,202652,Staff,18,0,30,12
1683657344322,EDS 125,A00,202649,Staff,13,0,30,17
1683657345347,EDS 126,A01,203332,Staff,30,0,30,0
1683657346369,EDS 139,A00,202838,Staff,16,0,25,9
1683657347394,EDS 146,A01,202655,Staff,14,0,25,11
1683657348417,ENG 15,A00,185667,Staff,0,1,0,0
1683657348417,ENG 15,B00,185672,Staff,0,0,0,0
1683657348417,ENG 15,C00,185675,Staff,0,0,0,0
1683657348417,ENG 15,D00,185682,Staff,0,0,0,0
1683657348417,ENG 15,E00,185684,Staff,0,0,0,0
1683657349441,ETHN 103,A00,185710,Staff,0,8,35,35
1683657350470,ETHN 103A,A00,199228,Man; Simeon S,0,0,9,9
1683657351497,ETHN 109,A00,185711,Staff,16,0,35,19
1683657352524,ETHN 142,A00,185726,Staff,0,4,30,30
1683657353549,ETHN 163J,A00,199229,Man; Simeon S,5,0,8,3
1683657354572,ETHN 168,A00,185727,Staff,7,0,10,3
1683657355599,ETHN 182,A00,185728,Staff,0,0,35,35
1683657356625,ETHN 183,A00,185737,Staff,9,0,18,9
1683657357652,GLBH 111,A01,209361,Burgos; Jose L.,0,0,0,0
1683657359707,HIEU 104,A00,185792,Staff,14,0,20,6
1683657360734,HIEU 115,A00,185800,Staff,0,0,20,20
1683657361759,HIEU 128,A00,185801,Staff,0,9,20,20
1683657362782,HIEU 147,A00,185802,Staff,15,0,20,5
1683657363812,HIEU 154,A00,185823,Staff,11,0,20,9
1683657364841,HILA 102,A00,185826,Staff,14,0,20,6
1683657365866,HILD 2C,A01,185778,Staff,0,13,20,20
1683657366894,HILD 7B,A01,185780,Kwak; Nancy,0,17,32,32
1683657366894,HILD 7B,A02,185781,Kwak; Nancy,0,18,32,32
1683657367919,HILD 30,A01,185791,Staff,12,0,20,8
1683657368944,HISC 119,A00,185830,Golan; Tal,0,9,20,20
1683657369971,HITO 156GS,A00,185831,Patterson; Patrick H.,0,0,0,23
1683657370998,HIUS 103,A00,185832,Man; Simeon S,0,4,20,20
1683657372025,HIUS 117,A00,185836,Kwak; Nancy,2,0,20,18
1683657373054,HIUS 125,A00,185840,Man; Simeon S,0,2,23,23
1683657374079,HIUS 149,A00,185845,Staff,1,0,20,19
1683657375104,HUM 3,A01,185882,Zavodny; Tatiana Sophia,0,8,50,50
1683657375104,HUM 3,B01,185899,Caldwell; Michael Alan,0,18,50,50
1683657376127,HUM 3GS,A00,185900,Patterson; Patrick H.,0,0,0,23
1683657377153,HUM 4,A01,185938,Zroka; Amy Liane,29,0,50,21
1683657377153,HUM 4,B01,185956,Watkins; Eric,0,4,50,50
1683657377153,HUM 4,B02,202209,Watkins; Eric,0,5,50,50
1683657377153,HUM 4,B03,202210,Watkins; Eric,0,5,50,50
1683657378179,HUM 5,A01,185958,West; Geoffrey Scott,1,0,50,49
1683657378179,HUM 5,A02,202215,West; Geoffrey Scott,0,0,50,50
1683657379209,INTL 190,A00,185959,Gagnon; Jeffrey C,0,0,0,9
1683657379209,INTL 190,B00,185960,Lettieri; Michael Joseph,0,0,0,2
1683657380235,JAPN 180,A00,254509,Staff,5,0,30,25
1683657381265,LATI 10,A01,202853,Kennemore; Amy Michelle,4,0,35,31
1683657381265,LATI 10,A02,202854,Kennemore; Amy Michelle,2,0,35,33
1683657381265,LATI 10,A03,270054,Kennemore; Amy Michelle,30,0,30,0
1683657382288,LATI 180,A00,202855,Kennemore; Amy Michelle,11,0,20,9
1683657383314,LAWS 101,A00,201767,Golan; Tal,0,7,40,40
1683657384339,LIFR 1C,A00,185961,Staff,6,0,20,14
1683657385367,LIFR 1CX,A00,185962,Staff,7,0,20,13
1683657386393,LIFR 1D,A00,185963,Staff,7,0,20,13
1683657387421,LIFR 1DX,A00,185964,Staff,7,0,20,13
1683657388448,LIGN 101,A01,186039,Staff,43,0,50,7
1683657389474,LIGN 165,A00,186040,Staff,15,0,50,35
1683657390503,LTCS 108,A00,186041,Staff,5,0,10,5
1683657391530,LTCS 119,A00,186042,Staff,15,0,20,5
1683657392558,LTCS 130,A00,186043,Wesling; Megan E.,15,0,25,10
1683657394608,LTEA 138,A00,186119,Staff,14,0,40,26
1683657395631,LTEN 124,A00,186148,Staff,5,0,25,20
1683657396657,LTEN 178,A00,186149,Staff,7,0,15,8
1683657397680,LTEN 181,A00,186150,Blanco; John D,34,0,40,6
1683657398709,LTWL 120,A00,186160,Staff,20,0,25,5
1683657399733,LTWL 165,A00,186161,Staff,22,0,25,3
1683657400757,LTWR 100,A00,186162,Staff,0,5,15,15
1683657401781,LTWR 102,A00,186163,Doller; Ben,5,0,15,10
1683657402809,MAE 8,A01,186412,Staff,0,0,0,0
1683657403835,MAE 30B,A00,186445,Bahadori; Mohammad Yousef,82,0,100,18
1683657404860,MAE 40,A00,186592,Bewley; Thomas R,10,0,50,40
1683657405885,MAE 101B,A00,186593,Bahadori; Mohammad Yousef,80,0,100,20
1683657406909,MAE 105,A00,186594,Bandaru; Prabhakar,10,0,50,40
1683657407938,MAE 107,A00,186599,Pham; Hieu Tan,0,7,120,120
1683657408963,MAE 148,A01,186660,Silberman; Jack,3,0,16,13
1683657409988,MATH 10A,A01,188095,Staff,0,6,35,35
1683657411019,MATH 10B,A01,188097,Bowers; Adam R.,0,12,30,30
1683657411019,MATH 10B,A02,188099,Bowers; Adam R.,0,11,30,30
1683657411019,MATH 10B,B01,188104,Bowers; Adam R.,0,10,30,30
1683657411019,MATH 10B,B02,188106,Bowers; Adam R.,1,9,30,29
1683657412052,MATH 10C,A01,188111,Staff,0,18,30,30
1683657412052,MATH 10C,A02,188127,Staff,0,19,30,30
1683657412052,MATH 10C,A03,188131,Staff,0,19,30,30
1683657412052,MATH 10C,B01,188218,Staff,17,0,30,13
1683657412052,MATH 10C,B02,188244,Staff,13,0,30,17
1683657412052,MATH 10C,B03,188277,Staff,14,0,30,16
1683657413082,MATH 18,A01,188344,Bach; Quang Tran,18,0,30,12
1683657413082,MATH 18,A02,188345,Bach; Quang Tran,11,0,30,19
1683657413082,MATH 18,B01,188353,Bach; Quang Tran,11,0,30,19
1683657413082,MATH 18,B02,188354,Bach; Quang Tran,19,0,30,11
1683657414108,MATH 20A,A01,188374,Staff,11,0,35,24
1683657415134,MATH 20B,A01,188382,Ohm; Ko Woon,7,0,30,23
1683657415134,MATH 20B,A02,188383,Ohm; Ko Woon,22,0,30,8
1683657415134,MATH 20B,B01,188385,Ohm; Ko Woon,7,0,30,23
1683657415134,MATH 20B,B02,188392,Ohm; Ko Woon,22,0,30,8
1683657416160,MATH 20C,A01,188394,Harel; Guershon,11,0,30,19
1683657416160,MATH 20C,A02,188395,Harel; Guershon,13,0,30,17
1683657416160,MATH 20C,B01,188404,Harel; Guershon,5,0,30,25
1683657416160,MATH 20C,B02,188405,Harel; Guershon,18,0,30,12
1683657417186,MATH 20D,A01,188414,Hammock; Frances H,0,1,30,30
1683657417186,MATH 20D,A02,188415,Hammock; Frances H,0,1,30,30
1683657417186,MATH 20D,B01,188447,Hammock; Frances H,0,1,30,30
1683657417186,MATH 20D,B02,188486,Hammock; Frances H,4,0,30,26
1683657418267,MATH 20E,A01,188649,Staff,21,0,30,9
1683657418267,MATH 20E,A02,188650,Staff,21,0,30,9
1683657418267,MATH 20E,A03,188673,Staff,0,0,30,30
1683657419293,MATH 102,A01,188675,Staff,0,36,35,35
1683657420317,MATH 103B,A01,188681,Staff,3,0,35,32
1683657420317,MATH 103B,B01,188692,Staff,5,0,35,30
1683657421340,MATH 109,A01,188695,Salehi Golsefidy; Alireza,24,0,35,11
1683657421340,MATH 109,A02,188696,Salehi Golsefidy; Alireza,25,0,35,10
1683657422368,MATH 120A,A01,188698,Eggers; John Dietrich,7,0,35,28
1683657423392,MATH 142B,A01,188736,Ioana; Adrian,0,1,30,30
1683657423392,MATH 142B,A02,188741,Ioana; Adrian,0,1,30,30
1683657423392,MATH 142B,A03,188743,Ioana; Adrian,0,1,30,30
1683657424421,MATH 168A,A01,188790,Staff,0,10,35,35
1683657425450,MATH 170A,A01,188803,Nie; Jiawang,0,2,35,35
1683657425450,MATH 170A,A02,188811,Nie; Jiawang,0,0,35,35
1683657425450,MATH 170A,A03,188814,Nie; Jiawang,0,0,35,35
1683657425450,MATH 170A,A04,188815,Nie; Jiawang,10,0,35,25
1683657426477,MATH 193B,A01,188817,Staff,0,0,35,35
1683657426477,MATH 193B,A02,188818,Staff,5,0,35,30
1683657427504,MGT 4,A01,202857,Anderson; John Charles,61,0,80,19
1683657428530,MGT 12,A00,202858,Lindenberger; Wade Douglas,40,0,90,50
1683657429555,MGT 18,A00,202859,Staff,74,0,90,16
1683657430578,MGT 18GS,A00,202860,McKay; Michael J,13,0,28,15
1683657431602,MGT 45,A00,202861,Pecore; Joseph P.,12,0,90,78
1683657432629,MGT 100,A00,202863,Yavorsky; Daniel Ryan,28,0,90,62
1683657433655,MGT 103,A00,202864,Ehrich; Kristine R,0,17,90,90
1683657434678,MGT 112,A00,202865,Ehrich; Kristine R,15,0,90,75
1683657435704,MGT 121A,A00,202868,Staff,90,20,90,0
1683657436733,MGT 131B,A00,202869,Anderson; John Charles,59,0,90,31
1683657437761,MGT 136,A00,202871,Lindenberger; Wade Douglas,83,0,90,7
1683657438789,MGT 164,A00,202873,Staff,0,66,90,91
1683657439814,MGT 164GS,A00,202874,McKay; Mary A,13,0,28,15
1683657440840,MGT 180,A00,202875,Staff,0,50,90,91
1683657441866,MMW 11R,A01,205019,Herbst; Matthew,2,0,30,28
1683657441866,MMW 11R,A02,205026,Herbst; Matthew,29,0,30,1
1683657442892,MMW 15,A01,193512,Chang; Edmond Yi-Teh,0,8,28,28
1683657442892,MMW 15,A02,193513,Chang; Edmond Yi-Teh,0,5,28,28
1683657442892,MMW 15,A03,193514,Chang; Edmond Yi-Teh,0,5,28,28
1683657442892,MMW 15,A04,193515,Chang; Edmond Yi-Teh,0,5,28,28
1683657442892,MMW 15,A05,193516,Chang; Edmond Yi-Teh,0,5,28,28
1683657442892,MMW 15,A06,193517,Chang; Edmond Yi-Teh,0,6,28,28
1683657442892,MMW 15,B01,193519,Chang; Edmond Yi-Teh,0,5,28,28
1683657442892,MMW 15,B02,193520,Chang; Edmond Yi-Teh,0,5,28,28
1683657442892,MMW 15,B03,193521,Chang; Edmond Yi-Teh,0,5,28,28
1683657442892,MMW 15,B04,193522,Chang; Edmond Yi-Teh,0,5,28,28
1683657442892,MMW 15,B05,193523,Chang; Edmond Yi-Teh,0,5,28,28
1683657442892,MMW 15,B06,193524,Chang; Edmond Yi-Teh,0,5,28,28
1683657443917,MMW 122,A01,193526,Rahimi; Babak,0,16,28,28
1683657443917,MMW 122,A02,193527,Rahimi; Babak,0,15,28,28
1683657443917,MMW 122,A03,193528,Rahimi; Babak,0,0,0,0
1683657443917,MMW 122,A04,193529,Rahimi; Babak,0,0,0,0
1683657444968,MUS 1A,A01,186663,Staff,1,20,35,34
1683657445992,MUS 4,A01,186715,Staff,0,12,35,35
1683657447018,MUS 5R,A01,186796,Dubnov; Shlomo,0,17,35,35
1683657448045,MUS 6,A01,186798,Staff,0,5,25,25
1683657449073,MUS 7,A01,186830,Staff,11,0,35,24
1683657450097,MUS 8,A01,186930,Staff,0,26,35,35
1683657451123,MUS 15,A01,186932,Staff,0,16,35,35
1683657451123,MUS 15,B01,186934,Staff,0,17,35,35
1683657452150,MUS 80,A00,186935,Staff,0,0,20,20
1683657452150,MUS 80,B00,186936,Staff,24,0,25,1
1683657453176,NANO 11,A00,204702,Lipomi; Darren John,0,0,0,0
1683657454206,NANO 15,A01,204709,Yang; Kesong,0,1,0,0
1683657455235,NANO 114,A00,202069,Jahed Motlagh; Zeinab,3,0,10,7
1683657456261,PHIL 1,A00,186955,Grush; Rick Scott,31,0,40,9
1683657457287,PHIL 10,A01,186973,Grush; Rick Scott,27,0,35,8
1683657457287,PHIL 10,A02,186974,Grush; Rick Scott,33,0,35,2
1683657458315,PHIL 13,A01,186976,Staff,3,0,35,32
1683657458315,PHIL 13,A02,186977,Staff,16,0,35,19
1683657459343,PHIL 14,A01,186979,Staff,31,0,35,4
1683657459343,PHIL 14,A02,186986,Staff,32,0,35,3
1683657460368,PHIL 28,A01,186988,Staff,16,0,30,14
1683657460368,PHIL 28,A02,186989,Staff,1,0,30,29
1683657460368,PHIL 28,A03,186990,Staff,10,0,30,20
1683657460368,PHIL 28,A04,186991,Staff,26,0,30,4
1683657461397,PHIL 120,A00,186997,Staff,23,0,40,17
1683657462426,PHIL 137,A00,187003,Staff,7,0,40,33
1683657463452,PHIL 150,A00,187015,Staff,47,0,70,23
1683657464479,PHIL 167,A00,187021,Lamey; Andy M.,34,0,40,6
1683657465504,PHIL 174,A01,202226,Staff,17,0,20,3
1683657465504,PHIL 174,A02,202235,Staff,20,0,20,0
1683657466529,PHIL 191A,A00,258918,Staff,0,0,1,1
1683657467557,PHYS 1A,A00,187028,Staff,26,0,60,34
1683657468586,PHYS 1AL,001,187036,Staff,3,0,30,27
1683657468586,PHYS 1AL,002,187049,Staff,18,0,30,12
1683657469611,PHYS 1B,A00,187058,Staff,22,0,60,38
1683657470637,PHYS 1BL,001,187064,Staff,0,1,30,30
1683657470637,PHYS 1BL,002,187070,Staff,4,0,30,26
1683657471666,PHYS 1C,A00,187082,Staff,29,0,120,91
1683657472695,PHYS 1CL,001,187088,Staff,0,9,30,30
1683657472695,PHYS 1CL,002,187089,Staff,0,1,30,30
1683657472695,PHYS 1CL,009,262693,Staff,9,0,30,21
1683657473724,PHYS 2B,A01,187097,Staff,55,0,115,60
1683657474752,PHYS 2C,A01,187099,Staff,63,0,115,52
1683657475778,PHYS 2CL,A01,187101,Staff,5,0,28,23
1683657475778,PHYS 2CL,A02,187102,Staff,15,0,28,13
1683657476809,PHYS 2D,A01,187123,Shotwell; Brian,95,0,115,20
1683657477836,PHYS 4B,A01,187133,Grinstein; Benjamin,35,0,50,15
1683657478859,POLI 10,A00,188819,Staff,0,4,50,50
1683657479883,POLI 11,A00,188827,Staff,43,0,50,7
1683657480910,POLI 13R,A00,188828,Staff,0,1,20,20
1683657481935,POLI 27,A01,188830,Elgin; Samuel Zincke,0,2,70,70
1683657482965,POLI 30,A00,188832,Desposato; Scott,30,0,50,20
1683657483996,POLI 102F,A00,188834,Staff,0,0,40,40
1683657485026,POLI 104A,A00,188852,Staff,13,0,30,17
1683657486055,POLI 104I,A00,188853,Staff,0,7,20,20
1683657487082,POLI 110B,A00,188854,Wiens; David,6,0,20,14
1683657488107,POLI 112A,A00,188855,Wiens; David,3,0,30,27
1683657489135,POLI 117R,A00,188856,Forman; Fonna,0,12,20,20
1683657490163,POLI 118,A00,188857,Ingham; Sean,8,0,20,12
1683657491191,POLI 120G,A00,188858,Staff,8,0,30,22
1683657492221,POLI 131CR,A00,188863,Hoston; Germaine,21,0,50,29
1683657493268,POLI 133,A00,188864,Nellis; Gareth Hb,44,0,50,6
1683657494299,POLI 134D,A00,188865,Desposato; Scott,27,0,30,3
1683657495324,POLI 142A,A00,188871,Gartzke; Erik,21,0,50,29
1683657496349,POLI 142K,A00,188874,Staff,38,0,50,12
1683657497377,POLI 143,A00,188940,Gartzke; Erik,16,0,30,14
1683657498403,POLI 153,A00,188943,Staff,2,0,20,18
1683657499429,POLI 160AA,A00,188944,Staff,11,0,40,29
1683657500453,POLI 170A,A00,188945,Staff,11,0,30,19
1683657502501,PSYC 1,A00,188952,Staff,36,0,90,54
1683657503525,PSYC 2,B00,188953,Staff,19,0,35,16
1683657504552,PSYC 6,A00,188970,Staff,47,0,60,13
1683657505577,PSYC 7,A00,188973,Staff,35,0,45,10
1683657506603,PSYC 60,A01,188980,Rickard; Timothy C.,42,0,60,18
1683657507632,PSYC 70,A01,189001,Steiner; Eric Tomas,22,0,45,23
1683657508658,PSYC 100,A00,189005,Lacefield; Katharine I,0,99,120,120
1683657509683,PSYC 102,A00,189008,Staff,8,0,30,22
1683657510712,PSYC 106,B00,189026,Gorman; Michael R.,27,0,60,33
1683657511737,PSYC 114,B01,189033,Winkielman; Piotr,0,31,30,30
1683657512762,PSYC 131,A00,189036,Anagnostaras; Stephan,0,43,60,60
1683657513785,PSYC 136,A00,189041,Lowe; Angela Beth,0,7,25,25
1683657514810,PSYC 137,A00,189057,Winkielman; Piotr,0,37,25,25
1683657515835,PSYC 144,A00,189107,Wixted; John T,0,11,50,50
1683657517887,PSYC 162,A00,189142,Staff,0,9,85,85
1683657518911,PSYC 172,A00,189144,Gorman; Michael R.,0,6,30,30
1683657520963,PSYC 179,A00,189146,Lacefield; Katharine I,0,87,120,120
1683657522048,PSYC 181,A00,189147,Anagnostaras; Stephan,0,44,90,90
1683657523075,PSYC 190R,A00,189148,Barner; David A.,0,23,80,80
1683657524100,PSYC 191,A00,189275,Rickard; Timothy C.,0,10,25,25
1683657525123,PSYC 193,A00,189276,Chapman; Eddie Nathaniel,0,1,0,4
1683657526152,PSYC 193L,A01,189281,Lowe; Angela Beth,10,0,20,10
1683657526152,PSYC 193L,B01,189285,Staff,28,0,35,7
1683657527178,RELI 149,A00,187137,Rahimi; Babak,7,0,40,33
1683657528203,SE 9,A01,187315,Staff,0,2,18,18
1683657529227,SE 101B,A00,187409,Staff,24,0,30,6
1683657530251,SE 110B,A00,187444,Staff,10,0,40,30
1683657531281,SE 130B,A00,187449,Staff,31,0,40,9
1683657532309,SE 150A,A00,187516,Staff,9,0,20,11
1683657533336,SE 154,A00,187528,Staff,29,0,50,21
1683657534365,SIO 3,A01,258171,Staff,35,0,40,5
1683657535390,SIO 10,A00,187144,Cook; Geoffrey W,0,6,75,75
1683657536418,SIO 45,A00,187152,Cook; Geoffrey W,0,4,100,100
1683657537446,SIO 109R,A00,194486,Staff,0,4,20,20
1683657539497,SIO 187,A01,187233,Kacev; David,12,0,40,28
1683657540525,SOCI 1,A01,258656,Thorpe; Charles Robert,28,0,30,2
1683657540525,SOCI 1,A02,258658,Thorpe; Charles Robert,30,0,30,0
1683657540525,SOCI 1,A03,258661,Thorpe; Charles Robert,25,0,25,0
1683657540525,SOCI 1,A04,258666,Thorpe; Charles Robert,22,0,25,3
1683657540525,SOCI 1,A05,258897,Thorpe; Charles Robert,22,0,25,3
1683657540525,SOCI 1,A06,258898,Thorpe; Charles Robert,25,0,25,0
1683657541557,SOCI 30,A01,258903,Pardo Guerra; Juan Pablo,14,0,30,16
1683657542583,SOCI 102,A00,258904,Staff,9,0,25,16
1683657543611,SOCI 106,A00,258905,Staff,19,0,25,6
1683657544638,SOCI 111,A00,258907,Ribas Norris; Janet Vanesa,26,0,30,4
1683657545666,SOCI 121R,A00,258908,Pardo Guerra; Juan Pablo,8,0,30,22
1683657546693,SOCI 126,A01,203330,Staff,14,0,20,6
1683657547718,SOCI 131,A00,258909,Thorpe; Charles Robert,30,0,60,30
1683657548744,SOCI 135,A00,258910,Payne; Christine Anna,0,11,30,30
1683657549769,SOCI 157,A00,258911,Staff,12,0,30,18
1683657550794,SOCI 184,A00,258912,Staff,25,0,30,5
1683657551819,SOCI 188D,A00,258913,Staff,22,0,30,8
1683657552850,SYN 2,001,187529,Staff,9,0,16,7
1683657552850,SYN 2,002,201452,Staff,0,20,16,16
1683657552850,SYN 2,003,201469,Staff,1,0,16,15
1683657553875,SYN 100,A01,187531,Staff,0,9,20,20
1683657553875,SYN 100,B01,201491,Staff,0,10,20,20
1683657554904,TDAC 1,A00,189286,Walsh; Kim C.,3,0,20,17
1683657554904,TDAC 1,B00,189287,Harting; Carla Kelso,10,0,20,10
1683657555932,TDAC 101,A00,189300,Walsh; Kim C.,16,0,20,4
1683657555932,TDAC 101,B00,189301,Harting; Carla Kelso,18,0,20,2
1683657556957,TDAC 102,A00,189304,Basso; Beatrice,14,0,20,6
1683657557982,TDAC 108,A00,189305,Staff,18,0,20,2
1683657559009,TDDE 131,A00,189310,Staff,19,0,20,1
1683657559009,TDDE 131,B00,189314,Staff,19,0,20,1
1683657559009,TDDE 131,C00,189315,Staff,48,0,50,2
1683657559009,TDDE 131,D00,189316,Staff,14,0,15,1
1683657559009,TDDE 131,E00,204841,Staff,20,0,20,0
1683657560036,TDGE 10,A00,189289,Staff,27,0,50,23
1683657560036,TDGE 10,B00,189290,Havis; Allan,0,0,50,50
1683657561061,TDGE 11,A00,189291,Fulton; Julia,0,4,50,50
1683657561061,TDGE 11,B00,189292,Staff,20,0,25,5
1683657561061,TDGE 11,C00,260270,Staff,0,0,0,0
1683657562093,TDGE 25,A00,189294,Staff,2,0,20,18
1683657563124,TDGE 124,A00,189318,Fulton; Julia,0,8,50,50
1683657564153,TDGE 125,A00,189319,Staff,13,0,25,12
1683657564153,TDGE 125,B00,189320,Staff,23,0,25,2
1683657565178,TDGE 127,A00,189322,Havis; Allan,0,0,50,50
1683657566202,TDHT 101,A00,189323,Staff,18,0,25,7
1683657566202,TDHT 101,B00,189324,Staff,25,0,25,0
1683657567230,TDHT 102,A00,189325,Staff,49,0,50,1
1683657568256,TDMV 1,A00,189295,Arcidiacono; Kristin,20,0,30,10
1683657568256,TDMV 1,B00,189296,Caligagan; Maria T.,24,0,30,6
1683657569280,TDMV 2,A00,189297,Sammartano; Tonnie,27,0,30,3
1683657569280,TDMV 2,B00,189299,Arcidiacono; Kristin,23,0,30,7
1683657570310,TDMV 3,A00,204998,Rincon; Alicia,22,0,30,8
1683657571335,TDMV 120,A00,189458,Sammartano; Tonnie,28,0,30,2
1683657572364,TDMV 138,A00,189541,Jun; Grace Shin Hae,20,0,40,20
1683657573490,TDMV 142,A00,189717,Caligagan; Tony,25,0,30,5
1683657573490,TDMV 142,B00,189718,Caligagan; Maria T.,25,0,30,5
1683657574514,TMC 2,A01,187533,Staff,25,0,25,0
1683657574514,TMC 2,A02,187534,Staff,25,0,25,0
1683657575538,USP 1,A01,187536,Kwak; Nancy,0,16,25,25
1683657576562,USP 5,A01,187538,Staff,9,0,25,16
1683657577589,USP 101,A00,199253,Staff,0,4,0,0
1683657578613,USP 124,A00,187562,Boomhower; Matthew Charles,0,0,30,30
1683657579638,USP 138,A00,187582,Staff,20,0,25,5
1683657580669,USP 152,A01,187597,Staff,3,0,25,22
1683657581693,USP 153,A00,187598,Staff,19,0,25,6
1683657582718,USP 168,A00,187607,Kwak; Nancy,2,0,5,3
1683657583745,USP 173,A00,187619,Staff,4,0,25,21
1683657584770,USP 181,A00,187638,Staff,0,4,25,25
1683657585795,VIS 103,A00,187650,Cruz; Edwin Teddy,18,0,75,57
1683657586822,VIS 110D,A00,187669,Staff,13,0,22,9
1683657587850,VIS 127C,A00,187720,Shen; Kuiyi,67,0,146,79
1683657588875,VIS 149,A00,187731,Yoldas; Pinar,0,14,22,22
1683657589899,VIS 151,A01,188091,Staff,22,0,34,12
1683657589899,VIS 151,A02,188092,Staff,11,0,34,23
1683657590926,VIS 160B,A00,188093,Stalbaum; Brett,0,1,10,10
1683657592975,WCWP 10B,A00,201720,Staff,10,0,15,5
1683657592975,WCWP 10B,B00,201722,Staff,9,0,15,6
1683657594003,WCWP 100,A00,201725,Gagnon; Jeffrey C,0,0,2,2
1683657594003,WCWP 100,B00,201727,Staff,0,4,15,15
1683657597102,ANBI 133,A00,258401,Wilder; Linnea Lorene,34,0,40,6
1683657598126,ANBI 140,A00,258395,Hrvoj Mihic; Branka,18,0,25,7
1683657599154,ANSC 120,A00,258402,Bialecki; Jon Anthony,26,0,40,14
1683657600180,ANSC 144,A00,258400,Staff,12,0,40,28
1683657602233,ANSC 166,A00,258396,Parish; Steven Martin,156,0,175,19
1683657603261,ANSC 180,A00,193533,Staff,8,0,20,12
1683657604289,ANSC 188,A00,258397,Jassal; Aftab,34,0,40,6
1683657605317,ANTH 3,A01,258316,Staff,23,0,30,7
1683657606342,ANTH 5,A00,258394,Semendeferi; Ekaterini,16,0,20,4
1683657607370,ANTH 21,A01,258331,Staff,4,0,40,36
1683657608395,ANTH 103,A00,258398,Varma; Saiba,15,0,25,10
1683657609422,AWP 10,001,202034,Staff,0,0,0,0
1683657609422,AWP 10,002,202035,Staff,0,0,0,0
1683657609422,AWP 10,003,202036,Staff,0,0,0,0
1683657609422,AWP 10,004,202037,Staff,0,0,0,0
1683657609422,AWP 10,005,202038,Staff,0,0,0,0
1683657609422,AWP 10,006,202039,Staff,0,0,0,0
1683657609422,AWP 10,007,202040,Staff,0,0,0,0
1683657609422,AWP 10,008,202041,Staff,0,0,0,0
1683657609422,AWP 10,009,202042,Staff,0,0,0,0
1683657609422,AWP 10,010,202043,Staff,0,0,0,0
1683657609422,AWP 10,011,202044,Staff,0,0,0,0
1683657609422,AWP 10,012,202045,Staff,0,0,0,0
1683657609422,AWP 10,013,202046,Staff,0,0,0,0
1683657609422,AWP 10,014,202047,Staff,0,0,0,0
1683657609422,AWP 10,015,202048,Staff,0,0,0,0
1683657609422,AWP 10,016,202049,Staff,0,0,0,0
1683657609422,AWP 10,017,202050,Staff,0,0,0,0
1683657609422,AWP 10,018,202051,Staff,0,0,0,0
1683657609422,AWP 10,019,202052,Staff,0,0,0,0
1683657609422,AWP 10,020,202053,Staff,0,0,0,0
1683657609422,AWP 10,021,202054,Staff,0,0,0,0
1683657609422,AWP 10,022,202055,Staff,0,0,0,0
1683657609422,AWP 10,023,202056,Staff,0,0,0,0
1683657609422,AWP 10,024,202057,Staff,0,0,0,0
1683657609422,AWP 10,025,202058,Staff,0,0,0,0
1683657609422,AWP 10,026,202059,Staff,0,0,0,0
1683657610449,AWP 102,001,202032,Staff,0,0,0,0
1683657610449,AWP 102,002,202033,Staff,0,0,0,0
1683657611475,BENG 100,A01,254234,Taylor Amos; Alyssa C,31,0,40,9
1683657612499,BENG 196,001,270013,Engler; Adam J.,9999,0,9999,0
1683657613525,BICD 100R,A01,202018,Smith; Laurie,0,7,32,32
1683657613525,BICD 100R,A02,202019,Smith; Laurie,0,3,32,32
1683657613525,BICD 100R,A03,202020,Smith; Laurie,0,1,32,32
1683657613525,BICD 100R,A04,202021,Smith; Laurie,6,0,32,26
1683657613525,BICD 100R,A05,202022,Smith; Laurie,11,0,32,21
1683657614554,BICD 136,A01,193242,Gustafson-Brown; Cindy,0,2,32,32
1683657614554,BICD 136,A02,193244,Gustafson-Brown; Cindy,13,0,32,19
1683657615584,BIEB 102,A01,193249,Butler; Shannon Rhey,1,2,32,31
1683657615584,BIEB 102,A02,193251,Butler; Shannon Rhey,0,0,32,32
1683657615584,BIEB 102,A03,193253,Butler; Shannon Rhey,0,0,32,32
1683657615584,BIEB 102,A04,193255,Butler; Shannon Rhey,14,0,32,18
1683657615584,BIEB 102,A05,193265,Butler; Shannon Rhey,26,0,32,6
1683657615584,BIEB 102,A06,193269,Butler; Shannon Rhey,14,0,32,18
1683657617632,BIEB 150,A01,193274,Staff,0,0,32,32
1683657617632,BIEB 150,A02,193285,Staff,24,0,32,8
1683657618659,BIEB 194,A00,193286,Kurle; Carolyn M.,20,0,32,12
1683657619690,BILD 1,A01,192291,Staff,15,0,32,17
1683657619690,BILD 1,A02,192292,Staff,30,0,32,2
1683657619690,BILD 1,B01,192520,Reuther; Keefe,0,1,0,0
1683657619690,BILD 1,B02,192532,Reuther; Keefe,0,1,0,0
1683657620717,BILD 3,A01,192556,Butler; Shannon Rhey,0,0,32,32
1683657620717,BILD 3,A02,192581,Butler; Shannon Rhey,1,0,32,31
1683657620717,BILD 3,A03,192611,Butler; Shannon Rhey,21,0,32,11
1683657620717,BILD 3,A04,192612,Butler; Shannon Rhey,24,0,32,8
1683657620717,BILD 3,A05,192613,Butler; Shannon Rhey,26,0,32,6
1683657620717,BILD 3,A06,192679,Butler; Shannon Rhey,27,0,32,5
1683657620717,BILD 3,A07,192682,Butler; Shannon Rhey,20,0,32,12
1683657621742,BILD 4,A01,192836,Reuther; Keefe,1,0,24,23
1683657621742,BILD 4,A02,193044,Reuther; Keefe,4,0,24,20
1683657622770,BILD 10,A01,193142,Gustafson-Brown; Cindy,29,0,32,3
1683657622770,BILD 10,A02,193149,Gustafson-Brown; Cindy,31,0,32,1
1683657623795,BIMM 100,A01,193301,Staff,0,6,32,32
1683657623795,BIMM 100,A02,193312,Staff,0,7,32,32
1683657623795,BIMM 100,A03,193323,Staff,0,9,32,32
1683657624826,BIMM 101,A01,193329,McDonnell; Lisa Marie,0,4,24,24
1683657624826,BIMM 101,A02,193339,McDonnell; Lisa Marie,1,3,24,23
1683657624826,BIMM 101,B01,193354,McDonnell; Lisa Marie,0,4,24,24
1683657624826,BIMM 101,B02,193357,McDonnell; Lisa Marie,0,3,24,24
1683657625925,BIMM 110,A01,193377,Tat; John,0,11,32,32
1683657625925,BIMM 110,A02,193378,Tat; John,0,10,32,32
1683657626952,BIMM 120,A01,206116,Staff,0,0,32,32
1683657626952,BIMM 120,A02,206117,Staff,6,0,32,26
1683657626952,BIMM 120,A03,206121,Staff,21,0,32,11
1683657627981,BIPN 100,A01,193393,Park; Ji Young,0,15,32,32
1683657627981,BIPN 100,A02,193402,Park; Ji Young,0,14,32,32
1683657627981,BIPN 100,A03,193413,Park; Ji Young,0,14,32,32
1683657627981,BIPN 100,A04,193414,Park; Ji Young,0,13,32,32
1683657629009,BIPN 102,A01,193429,Staff,0,0,32,32
1683657629009,BIPN 102,A02,193438,Staff,18,0,32,14
1683657630037,BIPN 106,A01,193450,Reyes Gonzalez; Catalina,0,2,40,40
1683657631067,BIPN 134,A01,193465,Cooke; James Edward,0,0,32,32
1683657631067,BIPN 134,A02,193474,Cooke; James Edward,25,0,32,7
1683657631067,BIPN 134,A03,193485,Cooke; James Edward,29,0,32,3
1683657631067,BIPN 134,A04,193486,Cooke; James Edward,20,0,32,12
1683657631067,BIPN 134,A05,193491,Cooke; James Edward,31,0,32,1
1683657631067,BIPN 134,A06,193501,Cooke; James Edward,30,0,32,2
1683657631067,BIPN 134,A07,193510,Cooke; James Edward,29,0,32,3
1683657633124,BISP 194,A00,222522,Staff,14,0,32,18
1683657634149,CAT 124,A01,202407,Staff,19,0,25,6
1683657635174,CAT 125,A00,202408,Marchisotto; Jennifer Anne,2,0,20,18
1683657636198,CAT 125R,A00,202409,Smith; Lauryn Alissa,0,11,20,20
1683657636198,CAT 125R,B00,202410,Morales; Celeste Georgianna,0,11,20,20
1683657636198,CAT 125R,C00,202411,Irwin; Matthew Joseph,0,12,20,20
1683657637225,CENG 15,A01,204712,Yang; Kesong,0,1,0,0
1683657638254,CENG 114,A00,202070,Jahed Motlagh; Zeinab,5,0,20,15
1683657639283,CGS 105,A00,185477,Wesling; Megan E.,24,0,40,16
1683657640310,CGS 106,A00,185494,Staff,11,0,22,11
1683657641335,CGS 108,A00,185495,Staff,14,0,20,6
1683657642360,CGS 114,A00,185496,Staff,13,0,18,5
1683657643387,CGS 119,A00,185501,Staff,15,0,20,5
1683657644414,CGS 120,A00,185511,Staff,12,0,20,8
1683657645444,CHEM 4,A01,184675,Bussey; Thomas J,97,0,100,3
1683657646469,CHEM 6A,A01,184677,Staff,33,0,60,27
1683657647498,CHEM 6B,A01,184679,Staff,63,0,100,37
1683657648527,CHEM 6C,A01,184681,Bussey; Thomas J,0,0,50,50
1683657648527,CHEM 6C,A02,184682,Bussey; Thomas J,32,0,50,18
1683657649555,CHEM 40A,A01,184684,Albizati; Kim F.,34,0,100,66
1683657650579,CHEM 40B,A01,184686,Albizati; Kim F.,0,22,100,100
1683657651603,CHEM 41B,A01,184690,Staff,51,0,100,49
1683657652628,COGS 3,A01,184715,Boyle; Mary E. T.,0,27,40,40
1683657653657,COGS 14B,A01,185172,Staff,0,14,38,38
1683657654687,COGS 18,A01,184736,Staff,14,0,80,66
1683657655715,COGS 100,A01,184932,Staff,0,7,73,73
1683657656741,COGS 101A,A01,184935,Staff,0,39,30,30
1683657657769,COGS 101B,A01,184944,Staff,0,2,30,30
1683657658796,COGS 101C,A01,184946,Staff,0,10,30,30
1683657659823,COGS 102A,A01,184951,Johnson; Christine M.,2,0,40,38
1683657660848,COGS 107B,A01,184953,Mooshagian; Eric Frederick,0,51,40,40
1683657661873,COGS 118B,A01,184959,Gupta; Anjum,0,49,40,40
1683657662903,COGS 153,A00,184961,Staff,0,16,30,30
1683657663926,COGS 177,A00,184962,Staff,0,21,30,30
1683657664951,COGS 187A,A01,184969,Boyle; Mary E. T.,0,19,40,40
1683657665978,COMM 10,A01,185174,Staff,0,5,25,25
1683657665978,COMM 10,A02,185189,Staff,0,2,25,25
1683657665978,COMM 10,A03,269821,Staff,0,1,0,0
1683657667007,COMM 100B,A01,185475,Staff,0,1,0,2
1683657667007,COMM 100B,A02,185476,Staff,12,0,25,13
1683657668031,COMM 100C,A01,185314,Staff,1,0,25,24
1683657668031,COMM 100C,A02,185327,Staff,18,0,25,7
1683657669058,COMM 110M,A00,185349,Staff,0,0,40,40
1683657670085,COMM 113T,A00,185352,Staff,25,0,40,15
1683657671112,COMM 114I,A00,185353,Staff,31,0,40,9
1683657672141,COMM 131,A00,185354,Staff,17,0,30,13
1683657673166,CSE 8A,A50,185358,Cao; Yingjun,0,46,10,10
1683657674192,CSE 8B,A01,185362,Staff,0,48,50,50
1683657675221,CSE 11,A01,185416,Cao; Yingjun,0,91,10,10
1683657676249,CSE 20,A01,185445,Briones; Jor-el Thomas Caparas,4,0,25,21
1683657677277,CSE 21,A01,185447,Staff,9,0,50,41
1683657678309,CSE 101,A01,185451,Staff,0,13,50,50
1683657678309,CSE 101,B01,185453,Jones; Miles E,0,13,50,50
1683657680359,CSE 141,A01,185458,Eldon; John,16,0,100,84
1683657681388,CSE 141L,A01,185461,Eldon; John,8,0,100,92
1683657682417,CSE 142,A01,185463,Staff,34,0,60,26
1683657682417,CSE 142,B01,201355,Staff,0,7,60,60
1683657683444,CSE 142L,A01,185470,Staff,34,0,60,26
1683657683444,CSE 142L,B01,201417,Staff,0,6,60,60
1683657684473,CSE 190,A00,201433,Staff,32,0,49,17
1683657685498,DOC 1,A01,259136,Strom; Megan C.,7,0,15,8
1683657685498,DOC 1,A02,259137,Strom; Megan C.,14,0,15,1
1683657685498,DOC 1,A03,259138,Strom; Megan C.,14,0,15,1
1683657685498,DOC 1,A04,259139,Strom; Megan C.,14,0,15,1
1683657686526,DOC 100D,A00,259140,Pass; Natalye Joann,14,0,25,11
1683657687555,DSGN 1,A01,184749,Rill; Bryan,0,26,30,30
1683657688577,DSGN 100,A01,185168,Staff,0,2,25,25
1683657689603,ECE 5,A01,185626,Morris; Karcher William,0,11,0,0
1683657690629,ECE 101,A01,185628,Staff,14,0,70,56
1683657691659,ECE 107,A01,185635,Baghdadchi; Saharnaz,0,0,20,20
1683657691659,ECE 107,A02,185638,Baghdadchi; Saharnaz,2,0,20,18
1683657692684,ECE 148,A01,185647,Silberman; Jack,0,0,16,16
1683657693719,ECON 1,A01,185537,Crane; Meredith Helen,54,0,70,16
1683657694746,ECON 3,A01,185549,Crane; Meredith Helen,29,0,70,41
1683657695773,ECON 4,A01,203354,Anderson; John Charles,0,5,10,10
1683657696797,ECON 100A,A01,185574,Staff,0,5,40,40
1683657697825,ECON 100B,A01,185576,Staff,0,12,50,50
1683657698850,ECON 100C,A01,185589,Newhouse; Herbert S,30,0,70,40
1683657699875,ECON 105,A00,185608,Vespa; Emanuel Ignacio,19,0,35,16
1683657700900,ECON 109,A01,185610,Shishkin; Denis,9,0,35,26
1683657701928,ECON 110A,A01,185612,Staff,9,0,40,31
1683657702954,ECON 120A,A01,185615,Staff,20,0,40,20
1683657703979,ECON 120C,A01,185617,Sun; Yixiao,0,20,70,70
1683657705003,ECON 144,A00,203346,Squires; Dale E,2,0,35,33
1683657706031,ECON 171,A01,203349,Newhouse; Herbert S,0,1,35,35
1683657707056,ECON 173A,A01,185621,Toda; Alexis Akira,20,0,35,15
1683657708086,EDS 25,A01,202413,Staff,0,1,0,0
1683657708086,EDS 25,A02,202414,Staff,0,1,0,0
1683657708086,EDS 25,A03,202415,Staff,0,0,0,0
1683657708086,EDS 25,A04,202416,Staff,0,1,0,0
1683657708086,EDS 25,A05,202439,Staff,0,0,0,0
1683657708086,EDS 25,A06,202440,Staff,0,0,0,0
1683657708086,EDS 25,B01,202631,Staff,0,0,0,0
1683657708086,EDS 25,B02,202632,Staff,0,0,0,0
1683657708086,EDS 25,B03,202639,Staff,0,0,0,0
1683657708086,EDS 25,B04,202640,Staff,0,0,0,0
1683657708086,EDS 25,B05,202643,Staff,0,0,0,0
1683657708086,EDS 25,B06,202644,Staff,0,0,0,0
1683657709113,EDS 38,A01,202659,Black; Alison Michelle,24,0,25,1
1683657710140,EDS 115,A00,202652,Staff,18,0,30,12
1683657711165,EDS 125,A00,202649,Staff,13,0,30,17
1683657712189,EDS 126,A01,203332,Staff,30,0,30,0
1683657713212,EDS 139,A00,202838,Staff,16,0,25,9
1683657714236,EDS 146,A01,202655,Staff,14,0,25,11
1683657715260,ENG 15,A00,185667,Staff,0,1,0,0
1683657715260,ENG 15,B00,185672,Staff,0,0,0,0
1683657715260,ENG 15,C00,185675,Staff,0,0,0,0
1683657715260,ENG 15,D00,185682,Staff,0,0,0,0
1683657715260,ENG 15,E00,185684,Staff,0,0,0,0
1683657716287,ETHN 103,A00,185710,Staff,0,8,35,35
1683657717315,ETHN 103A,A00,199228,Man; Simeon S,0,0,9,9
1683657718339,ETHN 109,A00,185711,Staff,16,0,35,19
1683657719364,ETHN 142,A00,185726,Staff,0,4,30,30
1683657720392,ETHN 163J,A00,199229,Man; Simeon S,5,0,8,3
1683657721415,ETHN 168,A00,185727,Staff,7,0,10,3
1683657722438,ETHN 182,A00,185728,Staff,0,0,35,35
1683657723465,ETHN 183,A00,185737,Staff,9,0,18,9
1683657724490,GLBH 111,A01,209361,Burgos; Jose L.,0,0,0,0
1683657726539,HIEU 104,A00,185792,Staff,14,0,20,6
1683657727563,HIEU 115,A00,185800,Staff,0,0,20,20
1683657728587,HIEU 128,A00,185801,Staff,0,9,20,20
1683657729676,HIEU 147,A00,185802,Staff,15,0,20,5
1683657730701,HIEU 154,A00,185823,Staff,11,0,20,9
1683657731726,HILA 102,A00,185826,Staff,14,0,20,6
1683657732750,HILD 2C,A01,185778,Staff,0,13,20,20
1683657733775,HILD 7B,A01,185780,Kwak; Nancy,0,17,32,32
1683657733775,HILD 7B,A02,185781,Kwak; Nancy,0,18,32,32
1683657734799,HILD 30,A01,185791,Staff,12,0,20,8
1683657735823,HISC 119,A00,185830,Golan; Tal,0,9,20,20
1683657736847,HITO 156GS,A00,185831,Patterson; Patrick H.,0,0,0,23
1683657737874,HIUS 103,A00,185832,Man; Simeon S,0,4,20,20
1683657738899,HIUS 117,A00,185836,Kwak; Nancy,2,0,20,18
1683657739923,HIUS 125,A00,185840,Man; Simeon S,0,2,23,23
1683657740948,HIUS 149,A00,185845,Staff,1,0,20,19
1683657741977,HUM 3,A01,185882,Zavodny; Tatiana Sophia,0,8,50,50
1683657741977,HUM 3,B01,185899,Caldwell; Michael Alan,0,18,50,50
1683657743004,HUM 3GS,A00,185900,Patterson; Patrick H.,0,0,0,23
1683657744033,HUM 4,A01,185938,Zroka; Amy Liane,29,0,50,21
1683657744033,HUM 4,B01,185956,Watkins; Eric,0,4,50,50
1683657744033,HUM 4,B02,202209,Watkins; Eric,0,5,50,50
1683657744033,HUM 4,B03,202210,Watkins; Eric,0,5,50,50
1683657745061,HUM 5,A01,185958,West; Geoffrey Scott,1,0,50,49
1683657745061,HUM 5,A02,202215,West; Geoffrey Scott,0,0,50,50
1683657746086,INTL 190,A00,185959,Gagnon; Jeffrey C,0,0,0,9
1683657746086,INTL 190,B00,185960,Lettieri; Michael Joseph,0,0,0,2
1683657747110,JAPN 180,A00,254509,Staff,5,0,30,25
1683657748144,LATI 10,A01,202853,Kennemore; Amy Michelle,4,0,35,31
1683657748144,LATI 10,A02,202854,Kennemore; Amy Michelle,2,0,35,33
1683657748144,LATI 10,A03,270054,Kennemore; Amy Michelle,30,0,30,0
1683657749170,LATI 180,A00,202855,Kennemore; Amy Michelle,11,0,20,9
1683657750194,LAWS 101,A00,201767,Golan; Tal,0,7,40,40
1683657751218,LIFR 1C,A00,185961,Staff,6,0,20,14
1683657752245,LIFR 1CX,A00,185962,Staff,7,0,20,13
1683657753270,LIFR 1D,A00,185963,Staff,7,0,20,13
1683657754293,LIFR 1DX,A00,185964,Staff,7,0,20,13
1683657755319,LIGN 101,A01,186039,Staff,43,0,50,7
1683657756342,LIGN 165,A00,186040,Staff,15,0,50,35
1683657757386,LTCS 108,A00,186041,Staff,5,0,10,5
1683657758412,LTCS 119,A00,186042,Staff,15,0,20,5
1683657759438,LTCS 130,A00,186043,Wesling; Megan E.,15,0,25,10
1683657761490,LTEA 138,A00,186119,Staff,14,0,40,26
1683657762517,LTEN 124,A00,186148,Staff,5,0,25,20
1683657763543,LTEN 178,A00,186149,Staff,7,0,15,8
1683657764571,LTEN 181,A00,186150,Blanco; John D,34,0,40,6
1683657765609,LTWL 120,A00,186160,Staff,20,0,25,5
1683657766638,LTWL 165,A00,186161,Staff,22,0,25,3
1683657767662,LTWR 100,A00,186162,Staff,0,5,15,15
1683657768690,LTWR 102,A00,186163,Doller; Ben,5,0,15,10
1683657769714,MAE 8,A01,186412,Staff,0,0,0,0
1683657770742,MAE 30B,A00,186445,Bahadori; Mohammad Yousef,82,0,100,18
1683657771768,MAE 40,A00,186592,Bewley; Thomas R,10,0,50,40
1683657772793,MAE 101B,A00,186593,Bahadori; Mohammad Yousef,80,0,100,20
1683657773818,MAE 105,A00,186594,Bandaru; Prabhakar,10,0,50,40
1683657774847,MAE 107,A00,186599,Pham; Hieu Tan,0,7,120,120
1683657775875,MAE 148,A01,186660,Silberman; Jack,3,0,16,13
1683657776904,MATH 10A,A01,188095,Staff,0,6,35,35
1683657777930,MATH 10B,A01,188097,Bowers; Adam R.,0,12,30,30
1683657777930,MATH 10B,A02,188099,Bowers; Adam R.,0,11,30,30
1683657777930,MATH 10B,B01,188104,Bowers; Adam R.,0,10,30,30
1683657777930,MATH 10B,B02,188106,Bowers; Adam R.,1,9,30,29
1683657778957,MATH 10C,A01,188111,Staff,0,18,30,30
1683657778957,MATH 10C,A02,188127,Staff,0,19,30,30
1683657778957,MATH 10C,A03,188131,Staff,0,19,30,30
1683657778957,MATH 10C,B01,188218,Staff,17,0,30,13
1683657778957,MATH 10C,B02,188244,Staff,13,0,30,17
1683657778957,MATH 10C,B03,188277,Staff,14,0,30,16
1683657779993,MATH 18,A01,188344,Bach; Quang Tran,18,0,30,12
1683657779993,MATH 18,A02,188345,Bach; Quang Tran,11,0,30,19
1683657779993,MATH 18,B01,188353,Bach; Quang Tran,11,0,30,19
1683657779993,MATH 18,B02,188354,Bach; Quang Tran,19,0,30,11
1683657781018,MATH 20A,A01,188374,Staff,11,0,35,24
1683657782041,MATH 20B,A01,188382,Ohm; Ko Woon,7,0,30,23
1683657782041,MATH 20B,A02,188383,Ohm; Ko Woon,22,0,30,8
1683657782041,MATH 20B,B01,188385,Ohm; Ko Woon,7,0,30,23
1683657782041,MATH 20B,B02,188392,Ohm; Ko Woon,22,0,30,8
1683657783071,MATH 20C,A01,188394,Harel; Guershon,11,0,30,19
1683657783071,MATH 20C,A02,188395,Harel; Guershon,13,0,30,17
1683657783071,MATH 20C,B01,188404,Harel; Guershon,5,0,30,25
1683657783071,MATH 20C,B02,188405,Harel; Guershon,18,0,30,12
1683657784099,MATH 20D,A01,188414,Hammock; Frances H,0,1,30,30
1683657784099,MATH 20D,A02,188415,Hammock; Frances H,0,1,30,30
1683657784099,MATH 20D,B01,188447,Hammock; Frances H,0,1,30,30
1683657784099,MATH 20D,B02,188486,Hammock; Frances H,4,0,30,26
1683657785124,MATH 20E,A01,188649,Staff,21,0,30,9
1683657785124,MATH 20E,A02,188650,Staff,21,0,30,9
1683657785124,MATH 20E,A03,188673,Staff,0,0,30,30
1683657786149,MATH 102,A01,188675,Staff,0,36,35,35
1683657787174,MATH 103B,A01,188681,Staff,3,0,35,32
1683657787174,MATH 103B,B01,188692,Staff,5,0,35,30
1683657788197,MATH 109,A01,188695,Salehi Golsefidy; Alireza,24,0,35,11
1683657788197,MATH 109,A02,188696,Salehi Golsefidy; Alireza,25,0,35,10
1683657789223,MATH 120A,A01,188698,Eggers; John Dietrich,7,0,35,28
1683657790251,MATH 142B,A01,188736,Ioana; Adrian,0,1,30,30
1683657790251,MATH 142B,A02,188741,Ioana; Adrian,0,1,30,30
1683657790251,MATH 142B,A03,188743,Ioana; Adrian,0,1,30,30
1683657791276,MATH 168A,A01,188790,Staff,0,10,35,35
1683657792302,MATH 170A,A01,188803,Nie; Jiawang,0,2,35,35
1683657792302,MATH 170A,A02,188811,Nie; Jiawang,0,0,35,35
1683657792302,MATH 170A,A03,188814,Nie; Jiawang,0,0,35,35
1683657792302,MATH 170A,A04,188815,Nie; Jiawang,10,0,35,25
1683657793326,MATH 193B,A01,188817,Staff,0,0,35,35
1683657793326,MATH 193B,A02,188818,Staff,5,0,35,30
1683657794352,MGT 4,A01,202857,Anderson; John Charles,61,0,80,19
1683657795376,MGT 12,A00,202858,Lindenberger; Wade Douglas,40,0,90,50
1683657796402,MGT 18,A00,202859,Staff,74,0,90,16
1683657797428,MGT 18GS,A00,202860,McKay; Michael J,13,0,28,15
1683657798455,MGT 45,A00,202861,Pecore; Joseph P.,12,0,90,78
1683657799482,MGT 100,A00,202863,Yavorsky; Daniel Ryan,28,0,90,62
1683657800512,MGT 103,A00,202864,Ehrich; Kristine R,0,17,90,90
1683657801539,MGT 112,A00,202865,Ehrich; Kristine R,15,0,90,75
1683657802566,MGT 121A,A00,202868,Staff,90,20,90,0
1683657803593,MGT 131B,A00,202869,Anderson; John Charles,59,0,90,31
1683657804621,MGT 136,A00,202871,Lindenberger; Wade Douglas,83,0,90,7
1683657805647,MGT 164,A00,202873,Staff,0,67,90,91
1683657806673,MGT 164GS,A00,202874,McKay; Mary A,13,0,28,15
1683657807697,MGT 180,A00,202875,Staff,0,50,90,91
1683657808724,MMW 11R,A01,205019,Herbst; Matthew,2,0,30,28
1683657808724,MMW 11R,A02,205026,Herbst; Matthew,29,0,30,1
1683657809754,MMW 15,A01,193512,Chang; Edmond Yi-Teh,0,8,28,28
1683657809754,MMW 15,A02,193513,Chang; Edmond Yi-Teh,0,5,28,28
1683657809754,MMW 15,A03,193514,Chang; Edmond Yi-Teh,0,5,28,28
1683657809754,MMW 15,A04,193515,Chang; Edmond Yi-Teh,0,5,28,28
1683657809754,MMW 15,A05,193516,Chang; Edmond Yi-Teh,0,5,28,28
1683657809754,MMW 15,A06,193517,Chang; Edmond Yi-Teh,0,6,28,28
1683657809754,MMW 15,B01,193519,Chang; Edmond Yi-Teh,0,5,28,28
1683657809754,MMW 15,B02,193520,Chang; Edmond Yi-Teh,0,5,28,28
1683657809754,MMW 15,B03,193521,Chang; Edmond Yi-Teh,0,5,28,28
1683657809754,MMW 15,B04,193522,Chang; Edmond Yi-Teh,0,5,28,28
1683657809754,MMW 15,B05,193523,Chang; Edmond Yi-Teh,0,5,28,28
1683657809754,MMW 15,B06,193524,Chang; Edmond Yi-Teh,0,5,28,28
1683657810779,MMW 122,A01,193526,Rahimi; Babak,0,16,28,28
1683657810779,MMW 122,A02,193527,Rahimi; Babak,0,15,28,28
1683657810779,MMW 122,A03,193528,Rahimi; Babak,0,0,0,0
1683657810779,MMW 122,A04,193529,Rahimi; Babak,0,0,0,0
1683657811808,MUS 1A,A01,186663,Staff,1,20,35,34
1683657812832,MUS 4,A01,186715,Staff,0,12,35,35
1683657813856,MUS 5R,A01,186796,Dubnov; Shlomo,0,17,35,35
1683657814882,MUS 6,A01,186798,Staff,0,5,25,25
1683657815911,MUS 7,A01,186830,Staff,11,0,35,24
1683657816938,MUS 8,A01,186930,Staff,0,26,35,35
1683657817965,MUS 15,A01,186932,Staff,0,16,35,35
1683657817965,MUS 15,B01,186934,Staff,1,17,35,34
1683657818989,MUS 80,A00,186935,Staff,0,0,20,20
1683657818989,MUS 80,B00,186936,Staff,24,0,25,1
1683657820014,NANO 11,A00,204702,Lipomi; Darren John,0,0,0,0
1683657821038,NANO 15,A01,204709,Yang; Kesong,0,1,0,0
1683657822063,NANO 114,A00,202069,Jahed Motlagh; Zeinab,3,0,10,7
1683657823090,PHIL 1,A00,186955,Grush; Rick Scott,31,0,40,9
1683657824118,PHIL 10,A01,186973,Grush; Rick Scott,27,0,35,8
1683657824118,PHIL 10,A02,186974,Grush; Rick Scott,33,0,35,2
1683657825143,PHIL 13,A01,186976,Staff,3,0,35,32
1683657825143,PHIL 13,A02,186977,Staff,16,0,35,19
1683657826169,PHIL 14,A01,186979,Staff,31,0,35,4
1683657826169,PHIL 14,A02,186986,Staff,32,0,35,3
1683657827195,PHIL 28,A01,186988,Staff,16,0,30,14
1683657827195,PHIL 28,A02,186989,Staff,1,0,30,29
1683657827195,PHIL 28,A03,186990,Staff,10,0,30,20
1683657827195,PHIL 28,A04,186991,Staff,26,0,30,4
1683657828222,PHIL 120,A00,186997,Staff,23,0,40,17
1683657829247,PHIL 137,A00,187003,Staff,7,0,40,33
1683657830272,PHIL 150,A00,187015,Staff,47,0,70,23
1683657831298,PHIL 167,A00,187021,Lamey; Andy M.,34,0,40,6
1683657832323,PHIL 174,A01,202226,Staff,17,0,20,3
1683657832323,PHIL 174,A02,202235,Staff,20,0,20,0
1683657833425,PHIL 191A,A00,258918,Staff,0,0,1,1
1683657834449,PHYS 1A,A00,187028,Staff,26,0,60,34
1683657835475,PHYS 1AL,001,187036,Staff,3,0,30,27
1683657835475,PHYS 1AL,002,187049,Staff,18,0,30,12
1683657836505,PHYS 1B,A00,187058,Staff,22,0,60,38
1683657837531,PHYS 1BL,001,187064,Staff,0,1,30,30
1683657837531,PHYS 1BL,002,187070,Staff,4,0,30,26
1683657838556,PHYS 1C,A00,187082,Staff,29,0,120,91
1683657839584,PHYS 1CL,001,187088,Staff,0,9,30,30
1683657839584,PHYS 1CL,002,187089,Staff,0,1,30,30
1683657839584,PHYS 1CL,009,262693,Staff,9,0,30,21
1683657840608,PHYS 2B,A01,187097,Staff,55,0,115,60
1683657841634,PHYS 2C,A01,187099,Staff,62,0,115,53
1683657842665,PHYS 2CL,A01,187101,Staff,5,0,28,23
1683657842665,PHYS 2CL,A02,187102,Staff,15,0,28,13
1683657843691,PHYS 2D,A01,187123,Shotwell; Brian,95,0,115,20
1683657844719,PHYS 4B,A01,187133,Grinstein; Benjamin,35,0,50,15
1683657845743,POLI 10,A00,188819,Staff,0,4,50,50
1683657846768,POLI 11,A00,188827,Staff,43,0,50,7
1683657847793,POLI 13R,A00,188828,Staff,0,1,20,20
1683657848821,POLI 27,A01,188830,Elgin; Samuel Zincke,0,2,70,70
1683657849849,POLI 30,A00,188832,Desposato; Scott,30,0,50,20
1683657850878,POLI 102F,A00,188834,Staff,0,0,40,40
1683657851908,POLI 104A,A00,188852,Staff,13,0,30,17
1683657852937,POLI 104I,A00,188853,Staff,0,7,20,20
1683657853961,POLI 110B,A00,188854,Wiens; David,6,0,20,14
1683657854989,POLI 112A,A00,188855,Wiens; David,3,0,30,27
1683657856017,POLI 117R,A00,188856,Forman; Fonna,0,12,20,20
1683657857045,POLI 118,A00,188857,Ingham; Sean,8,0,20,12
1683657858072,POLI 120G,A00,188858,Staff,8,0,30,22
1683657859096,POLI 131CR,A00,188863,Hoston; Germaine,21,0,50,29
1683657860121,POLI 133,A00,188864,Nellis; Gareth Hb,44,0,50,6
1683657861149,POLI 134D,A00,188865,Desposato; Scott,27,0,30,3
1683657862172,POLI 142A,A00,188871,Gartzke; Erik,21,0,50,29
1683657863200,POLI 142K,A00,188874,Staff,38,0,50,12
1683657864229,POLI 143,A00,188940,Gartzke; Erik,16,0,30,14
1683657865252,POLI 153,A00,188943,Staff,2,0,20,18
1683657866276,POLI 160AA,A00,188944,Staff,11,0,40,29
1683657867300,POLI 170A,A00,188945,Staff,11,0,30,19
1683657869347,PSYC 1,A00,188952,Staff,36,0,90,54
1683657870372,PSYC 2,B00,188953,Staff,19,0,35,16
1683657871398,PSYC 6,A00,188970,Staff,47,0,60,13
1683657872423,PSYC 7,A00,188973,Staff,35,0,45,10
1683657873447,PSYC 60,A01,188980,Rickard; Timothy C.,42,0,60,18
1683657874475,PSYC 70,A01,189001,Steiner; Eric Tomas,22,0,45,23
1683657875504,PSYC 100,A00,189005,Lacefield; Katharine I,0,99,120,120
1683657876531,PSYC 102,A00,189008,Staff,8,0,30,22
1683657877559,PSYC 106,B00,189026,Gorman; Michael R.,27,0,60,33
1683657878587,PSYC 114,B01,189033,Winkielman; Piotr,0,31,30,30
1683657879610,PSYC 131,A00,189036,Anagnostaras; Stephan,0,43,60,60
1683657880635,PSYC 136,A00,189041,Lowe; Angela Beth,0,7,25,25
1683657881660,PSYC 137,A00,189057,Winkielman; Piotr,0,37,25,25
1683657882688,PSYC 144,A00,189107,Wixted; John T,0,11,50,50
1683657884735,PSYC 162,A00,189142,Staff,0,9,85,85
1683657885759,PSYC 172,A00,189144,Gorman; Michael R.,0,6,30,30
1683657887810,PSYC 179,A00,189146,Lacefield; Katharine I,0,87,120,120
1683657888834,PSYC 181,A00,189147,Anagnostaras; Stephan,0,44,90,90
1683657889859,PSYC 190R,A00,189148,Barner; David A.,0,23,80,80
1683657890883,PSYC 191,A00,189275,Rickard; Timothy C.,0,10,25,25
1683657891910,PSYC 193,A00,189276,Chapman; Eddie Nathaniel,0,1,0,4
1683657892938,PSYC 193L,A01,189281,Lowe; Angela Beth,10,0,20,10
1683657892938,PSYC 193L,B01,189285,Staff,28,0,35,7
1683657893962,RELI 149,A00,187137,Rahimi; Babak,7,0,40,33
1683657894995,SE 9,A01,187315,Staff,0,2,18,18
1683657896020,SE 101B,A00,187409,Staff,24,0,30,6
1683657897048,SE 110B,A00,187444,Staff,10,0,40,30
1683657898073,SE 130B,A00,187449,Staff,31,0,40,9
1683657899098,SE 150A,A00,187516,Staff,9,0,20,11
1683657900124,SE 154,A00,187528,Staff,29,0,50,21
1683657901152,SIO 3,A01,258171,Staff,35,0,40,5
1683657902179,SIO 10,A00,187144,Cook; Geoffrey W,0,6,75,75
1683657903212,SIO 45,A00,187152,Cook; Geoffrey W,0,4,100,100
1683657904237,SIO 109R,A00,194486,Staff,0,4,20,20
1683657906287,SIO 187,A01,187233,Kacev; David,12,0,40,28
1683657907310,SOCI 1,A01,258656,Thorpe; Charles Robert,28,0,30,2
1683657907310,SOCI 1,A02,258658,Thorpe; Charles Robert,30,0,30,0
1683657907310,SOCI 1,A03,258661,Thorpe; Charles Robert,25,0,25,0
1683657907310,SOCI 1,A04,258666,Thorpe; Charles Robert,22,0,25,3
1683657907310,SOCI 1,A05,258897,Thorpe; Charles Robert,22,0,25,3
1683657907310,SOCI 1,A06,258898,Thorpe; Charles Robert,25,0,25,0
1683657908339,SOCI 30,A01,258903,Pardo Guerra; Juan Pablo,14,0,30,16
1683657909365,SOCI 102,A00,258904,Staff,9,0,25,16
1683657910387,SOCI 106,A00,258905,Staff,19,0,25,6
1683657911416,SOCI 111,A00,258907,Ribas Norris; Janet Vanesa,26,0,30,4
1683657912441,SOCI 121R,A00,258908,Pardo Guerra; Juan Pablo,8,0,30,22
1683657913466,SOCI 126,A01,203330,Staff,14,0,20,6
1683657914493,SOCI 131,A00,258909,Thorpe; Charles Robert,30,0,60,30
1683657915521,SOCI 135,A00,258910,Payne; Christine Anna,0,11,30,30
1683657916545,SOCI 157,A00,258911,Staff,12,0,30,18
1683657917568,SOCI 184,A00,258912,Staff,25,0,30,5
1683657918595,SOCI 188D,A00,258913,Staff,22,0,30,8
1683657919623,SYN 2,001,187529,Staff,9,0,16,7
1683657919623,SYN 2,002,201452,Staff,0,20,16,16
1683657919623,SYN 2,003,201469,Staff,1,0,16,15
1683657920647,SYN 100,A01,187531,Staff,0,9,20,20
1683657920647,SYN 100,B01,201491,Staff,0,10,20,20
1683657921672,TDAC 1,A00,189286,Walsh; Kim C.,3,0,20,17
1683657921672,TDAC 1,B00,189287,Harting; Carla Kelso,10,0,20,10
1683657922698,TDAC 101,A00,189300,Walsh; Kim C.,16,0,20,4
1683657922698,TDAC 101,B00,189301,Harting; Carla Kelso,18,0,20,2
1683657923726,TDAC 102,A00,189304,Basso; Beatrice,14,0,20,6
1683657924756,TDAC 108,A00,189305,Staff,18,0,20,2
1683657925779,TDDE 131,A00,189310,Staff,19,0,20,1
1683657925779,TDDE 131,B00,189314,Staff,19,0,20,1
1683657925779,TDDE 131,C00,189315,Staff,48,0,50,2
1683657925779,TDDE 131,D00,189316,Staff,14,0,15,1
1683657925779,TDDE 131,E00,204841,Staff,20,0,20,0
1683657926807,TDGE 10,A00,189289,Staff,27,0,50,23
1683657926807,TDGE 10,B00,189290,Havis; Allan,0,0,50,50
1683657927832,TDGE 11,A00,189291,Fulton; Julia,0,4,50,50
1683657927832,TDGE 11,B00,189292,Staff,20,0,25,5
1683657927832,TDGE 11,C00,260270,Staff,0,0,0,0
1683657928857,TDGE 25,A00,189294,Staff,2,0,20,18
1683657929882,TDGE 124,A00,189318,Fulton; Julia,0,8,50,50
1683657930909,TDGE 125,A00,189319,Staff,13,0,25,12
1683657930909,TDGE 125,B00,189320,Staff,23,0,25,2
1683657931936,TDGE 127,A00,189322,Havis; Allan,0,0,50,50
1683657932959,TDHT 101,A00,189323,Staff,18,0,25,7
1683657932959,TDHT 101,B00,189324,Staff,25,0,25,0
1683657933984,TDHT 102,A00,189325,Staff,49,0,50,1
1683657935008,TDMV 1,A00,189295,Arcidiacono; Kristin,20,0,30,10
1683657935008,TDMV 1,B00,189296,Caligagan; Maria T.,24,0,30,6
1683657936034,TDMV 2,A00,189297,Sammartano; Tonnie,27,0,30,3
1683657936034,TDMV 2,B00,189299,Arcidiacono; Kristin,23,0,30,7
1683657937113,TDMV 3,A00,204998,Rincon; Alicia,22,0,30,8
1683657938137,TDMV 120,A00,189458,Sammartano; Tonnie,28,0,30,2
1683657939162,TDMV 138,A00,189541,Jun; Grace Shin Hae,20,0,40,20
1683657940190,TDMV 142,A00,189717,Caligagan; Tony,25,0,30,5
1683657940190,TDMV 142,B00,189718,Caligagan; Maria T.,25,0,30,5
1683657941212,TMC 2,A01,187533,Staff,25,0,25,0
1683657941212,TMC 2,A02,187534,Staff,25,0,25,0
1683657942237,USP 1,A01,187536,Kwak; Nancy,0,16,25,25
1683657943262,USP 5,A01,187538,Staff,9,0,25,16
1683657944290,USP 101,A00,199253,Staff,0,4,0,0
1683657945314,USP 124,A00,187562,Boomhower; Matthew Charles,0,0,30,30
1683657946341,USP 138,A00,187582,Staff,20,0,25,5
1683657947366,USP 152,A01,187597,Staff,3,0,25,22
1683657948391,USP 153,A00,187598,Staff,19,0,25,6
1683657949414,USP 168,A00,187607,Kwak; Nancy,2,0,5,3
1683657950439,USP 173,A00,187619,Staff,4,0,25,21
1683657951463,USP 181,A00,187638,Staff,0,4,25,25
1683657952490,VIS 103,A00,187650,Cruz; Edwin Teddy,18,0,75,57
1683657953514,VIS 110D,A00,187669,Staff,13,0,22,9
1683657954539,VIS 127C,A00,187720,Shen; Kuiyi,67,0,146,79
1683657955565,VIS 149,A00,187731,Yoldas; Pinar,0,14,22,22
1683657956590,VIS 151,A01,188091,Staff,22,0,34,12
1683657956590,VIS 151,A02,188092,Staff,11,0,34,23
1683657957615,VIS 160B,A00,188093,Stalbaum; Brett,0,1,10,10
1683657959663,WCWP 10B,A00,201720,Staff,10,0,15,5
1683657959663,WCWP 10B,B00,201722,Staff,9,0,15,6
1683657960690,WCWP 100,A00,201725,Gagnon; Jeffrey C,0,0,2,2
1683657960690,WCWP 100,B00,201727,Staff,0,4,15,15
1683657963782,ANBI 133,A00,258401,Wilder; Linnea Lorene,34,0,40,6
1683657964806,ANBI 140,A00,258395,Hrvoj Mihic; Branka,18,0,25,7
1683657965831,ANSC 120,A00,258402,Bialecki; Jon Anthony,26,0,40,14
1683657966853,ANSC 144,A00,258400,Staff,12,0,40,28
1683657968904,ANSC 166,A00,258396,Parish; Steven Martin,156,0,175,19
1683657969931,ANSC 180,A00,193533,Staff,8,0,20,12
1683657970955,ANSC 188,A00,258397,Jassal; Aftab,34,0,40,6
1683657971981,ANTH 3,A01,258316,Staff,23,0,30,7
1683657973009,ANTH 5,A00,258394,Semendeferi; Ekaterini,16,0,20,4
1683657974036,ANTH 21,A01,258331,Staff,4,0,40,36
1683657975060,ANTH 103,A00,258398,Varma; Saiba,15,0,25,10
1683657976094,AWP 10,001,202034,Staff,0,0,0,0
1683657976094,AWP 10,002,202035,Staff,0,0,0,0
1683657976094,AWP 10,003,202036,Staff,0,0,0,0
1683657976094,AWP 10,004,202037,Staff,0,0,0,0
1683657976094,AWP 10,005,202038,Staff,0,0,0,0
1683657976094,AWP 10,006,202039,Staff,0,0,0,0
1683657976094,AWP 10,007,202040,Staff,0,0,0,0
1683657976094,AWP 10,008,202041,Staff,0,0,0,0
1683657976094,AWP 10,009,202042,Staff,0,0,0,0
1683657976094,AWP 10,010,202043,Staff,0,0,0,0
1683657976094,AWP 10,011,202044,Staff,0,0,0,0
1683657976094,AWP 10,012,202045,Staff,0,0,0,0
1683657976094,AWP 10,013,202046,Staff,0,0,0,0
1683657976094,AWP 10,014,202047,Staff,0,0,0,0
1683657976094,AWP 10,015,202048,Staff,0,0,0,0
1683657976094,AWP 10,016,202049,Staff,0,0,0,0
1683657976094,AWP 10,017,202050,Staff,0,0,0,0
1683657976094,AWP 10,018,202051,Staff,0,0,0,0
1683657976094,AWP 10,019,202052,Staff,0,0,0,0
1683657976094,AWP 10,020,202053,Staff,0,0,0,0
1683657976094,AWP 10,021,202054,Staff,0,0,0,0
1683657976094,AWP 10,022,202055,Staff,0,0,0,0
1683657976094,AWP 10,023,202056,Staff,0,0,0,0
1683657976094,AWP 10,024,202057,Staff,0,0,0,0
1683657976094,AWP 10,025,202058,Staff,0,0,0,0
1683657976094,AWP 10,026,202059,Staff,0,0,0,0
1683657977121,AWP 102,001,202032,Staff,0,0,0,0
1683657977121,AWP 102,002,202033,Staff,0,0,0,0
1683657978150,BENG 100,A01,254234,Taylor Amos; Alyssa C,31,0,40,9
1683657979176,BENG 196,001,270013,Engler; Adam J.,9999,0,9999,0
1683657980202,BICD 100R,A01,202018,Smith; Laurie,0,7,32,32
1683657980202,BICD 100R,A02,202019,Smith; Laurie,0,3,32,32
1683657980202,BICD 100R,A03,202020,Smith; Laurie,0,1,32,32
1683657980202,BICD 100R,A04,202021,Smith; Laurie,6,0,32,26
1683657980202,BICD 100R,A05,202022,Smith; Laurie,11,0,32,21
1683657981243,BICD 136,A01,193242,Gustafson-Brown; Cindy,0,2,32,32
1683657981243,BICD 136,A02,193244,Gustafson-Brown; Cindy,13,0,32,19
1683657982270,BIEB 102,A01,193249,Butler; Shannon Rhey,1,2,32,31
1683657982270,BIEB 102,A02,193251,Butler; Shannon Rhey,0,0,32,32
1683657982270,BIEB 102,A03,193253,Butler; Shannon Rhey,0,0,32,32
1683657982270,BIEB 102,A04,193255,Butler; Shannon Rhey,14,0,32,18
1683657982270,BIEB 102,A05,193265,Butler; Shannon Rhey,26,0,32,6
1683657982270,BIEB 102,A06,193269,Butler; Shannon Rhey,14,0,32,18
1683657984321,BIEB 150,A01,193274,Staff,0,0,32,32
1683657984321,BIEB 150,A02,193285,Staff,24,0,32,8
1683657985345,BIEB 194,A00,193286,Kurle; Carolyn M.,20,0,32,12
1683657986370,BILD 1,A01,192291,Staff,15,0,32,17
1683657986370,BILD 1,A02,192292,Staff,30,0,32,2
1683657986370,BILD 1,B01,192520,Reuther; Keefe,0,1,0,0
1683657986370,BILD 1,B02,192532,Reuther; Keefe,0,1,0,0
1683657987396,BILD 3,A01,192556,Butler; Shannon Rhey,0,0,32,32
1683657987396,BILD 3,A02,192581,Butler; Shannon Rhey,1,0,32,31
1683657987396,BILD 3,A03,192611,Butler; Shannon Rhey,21,0,32,11
1683657987396,BILD 3,A04,192612,Butler; Shannon Rhey,24,0,32,8
1683657987396,BILD 3,A05,192613,Butler; Shannon Rhey,26,0,32,6
1683657987396,BILD 3,A06,192679,Butler; Shannon Rhey,27,0,32,5
1683657987396,BILD 3,A07,192682,Butler; Shannon Rhey,20,0,32,12
1683657988422,BILD 4,A01,192836,Reuther; Keefe,1,0,24,23
1683657988422,BILD 4,A02,193044,Reuther; Keefe,4,0,24,20
1683657989447,BILD 10,A01,193142,Gustafson-Brown; Cindy,29,0,32,3
1683657989447,BILD 10,A02,193149,Gustafson-Brown; Cindy,31,0,32,1
1683657990475,BIMM 100,A01,193301,Staff,0,6,32,32
1683657990475,BIMM 100,A02,193312,Staff,0,7,32,32
1683657990475,BIMM 100,A03,193323,Staff,0,9,32,32
1683657991500,BIMM 101,A01,193329,McDonnell; Lisa Marie,0,4,24,24
1683657991500,BIMM 101,A02,193339,McDonnell; Lisa Marie,1,3,24,23
1683657991500,BIMM 101,B01,193354,McDonnell; Lisa Marie,0,4,24,24
1683657991500,BIMM 101,B02,193357,McDonnell; Lisa Marie,0,3,24,24
1683657992525,BIMM 110,A01,193377,Tat; John,0,11,32,32
1683657992525,BIMM 110,A02,193378,Tat; John,0,10,32,32
1683657993550,BIMM 120,A01,206116,Staff,0,0,32,32
1683657993550,BIMM 120,A02,206117,Staff,6,0,32,26
1683657993550,BIMM 120,A03,206121,Staff,21,0,32,11
1683657994575,BIPN 100,A01,193393,Park; Ji Young,0,15,32,32
1683657994575,BIPN 100,A02,193402,Park; Ji Young,0,14,32,32
1683657994575,BIPN 100,A03,193413,Park; Ji Young,0,14,32,32
1683657994575,BIPN 100,A04,193414,Park; Ji Young,0,13,32,32
1683657995598,BIPN 102,A01,193429,Staff,0,0,32,32
1683657995598,BIPN 102,A02,193438,Staff,18,0,32,14
1683657996622,BIPN 106,A01,193450,Reyes Gonzalez; Catalina,0,2,40,40
1683657997652,BIPN 134,A01,193465,Cooke; James Edward,0,0,32,32
1683657997652,BIPN 134,A02,193474,Cooke; James Edward,25,0,32,7
1683657997652,BIPN 134,A03,193485,Cooke; James Edward,29,0,32,3
1683657997652,BIPN 134,A04,193486,Cooke; James Edward,20,0,32,12
1683657997652,BIPN 134,A05,193491,Cooke; James Edward,31,0,32,1
1683657997652,BIPN 134,A06,193501,Cooke; James Edward,30,0,32,2
1683657997652,BIPN 134,A07,193510,Cooke; James Edward,29,0,32,3
1683657999704,BISP 194,A00,222522,Staff,14,0,32,18
1683658000728,CAT 124,A01,202407,Staff,19,0,25,6
1683658001756,CAT 125,A00,202408,Marchisotto; Jennifer Anne,2,0,20,18
1683658002785,CAT 125R,A00,202409,Smith; Lauryn Alissa,0,11,20,20
1683658002785,CAT 125R,B00,202410,Morales; Celeste Georgianna,0,11,20,20
1683658002785,CAT 125R,C00,202411,Irwin; Matthew Joseph,0,12,20,20
1683658003813,CENG 15,A01,204712,Yang; Kesong,0,1,0,0
1683658004836,CENG 114,A00,202070,Jahed Motlagh; Zeinab,5,0,20,15
1683658005859,CGS 105,A00,185477,Wesling; Megan E.,24,0,40,16
1683658006884,CGS 106,A00,185494,Staff,11,0,22,11
1683658007909,CGS 108,A00,185495,Staff,14,0,20,6
1683658008931,CGS 114,A00,185496,Staff,13,0,18,5
1683658009957,CGS 119,A00,185501,Staff,15,0,20,5
1683658010983,CGS 120,A00,185511,Staff,12,0,20,8
1683658012008,CHEM 4,A01,184675,Bussey; Thomas J,97,0,100,3
1683658013032,CHEM 6A,A01,184677,Staff,33,0,60,27
1683658014060,CHEM 6B,A01,184679,Staff,63,0,100,37
1683658015085,CHEM 6C,A01,184681,Bussey; Thomas J,0,0,50,50
1683658015085,CHEM 6C,A02,184682,Bussey; Thomas J,32,0,50,18
1683658016110,CHEM 40A,A01,184684,Albizati; Kim F.,34,0,100,66
1683658017137,CHEM 40B,A01,184686,Albizati; Kim F.,0,22,100,100
1683658018162,CHEM 41B,A01,184690,Staff,51,0,100,49
1683658019190,COGS 3,A01,184715,Boyle; Mary E. T.,0,27,40,40
1683658020219,COGS 14B,A01,185172,Staff,0,14,38,38
1683658021253,COGS 18,A01,184736,Staff,14,0,80,66
1683658022279,COGS 100,A01,184932,Staff,0,7,73,73
1683658023303,COGS 101A,A01,184935,Staff,0,39,30,30
1683658024335,COGS 101B,A01,184944,Staff,0,2,30,30
1683658025361,COGS 101C,A01,184946,Staff,0,10,30,30
1683658026385,COGS 102A,A01,184951,Johnson; Christine M.,2,0,40,38
1683658027411,COGS 107B,A01,184953,Mooshagian; Eric Frederick,0,51,40,40
1683658028436,COGS 118B,A01,184959,Gupta; Anjum,0,49,40,40
1683658029461,COGS 153,A00,184961,Staff,0,16,30,30
1683658030486,COGS 177,A00,184962,Staff,0,21,30,30
1683658031514,COGS 187A,A01,184969,Boyle; Mary E. T.,0,19,40,40
1683658032538,COMM 10,A01,185174,Staff,0,5,25,25
1683658032538,COMM 10,A02,185189,Staff,0,2,25,25
1683658032538,COMM 10,A03,269821,Staff,0,1,0,0
1683658033562,COMM 100B,A01,185475,Staff,0,1,0,2
1683658033562,COMM 100B,A02,185476,Staff,12,0,25,13
1683658034587,COMM 100C,A01,185314,Staff,1,0,25,24
1683658034587,COMM 100C,A02,185327,Staff,18,0,25,7
1683658035613,COMM 110M,A00,185349,Staff,0,0,40,40
1683658036638,COMM 113T,A00,185352,Staff,25,0,40,15
1683658037666,COMM 114I,A00,185353,Staff,31,0,40,9
1683658038692,COMM 131,A00,185354,Staff,17,0,30,13
1683658039721,CSE 8A,A50,185358,Cao; Yingjun,0,46,10,10
1683658040808,CSE 8B,A01,185362,Staff,0,48,50,50
1683658041833,CSE 11,A01,185416,Cao; Yingjun,0,91,10,10
1683658042861,CSE 20,A01,185445,Briones; Jor-el Thomas Caparas,4,0,25,21
1683658043885,CSE 21,A01,185447,Staff,9,0,50,41
1683658044910,CSE 101,A01,185451,Staff,0,13,50,50
1683658044910,CSE 101,B01,185453,Jones; Miles E,0,13,50,50
1683658046961,CSE 141,A01,185458,Eldon; John,16,0,100,84
1683658047986,CSE 141L,A01,185461,Eldon; John,8,0,100,92
1683658049013,CSE 142,A01,185463,Staff,34,0,60,26
1683658049013,CSE 142,B01,201355,Staff,0,7,60,60
1683658050040,CSE 142L,A01,185470,Staff,34,0,60,26
1683658050040,CSE 142L,B01,201417,Staff,0,6,60,60
1683658051067,CSE 190,A00,201433,Staff,32,0,49,17
1683658052092,DOC 1,A01,259136,Strom; Megan C.,7,0,15,8
1683658052092,DOC 1,A02,259137,Strom; Megan C.,14,0,15,1
1683658052092,DOC 1,A03,259138,Strom; Megan C.,14,0,15,1
1683658052092,DOC 1,A04,259139,Strom; Megan C.,14,0,15,1
1683658053117,DOC 100D,A00,259140,Pass; Natalye Joann,14,0,25,11
1683658054145,DSGN 1,A01,184749,Rill; Bryan,0,26,30,30
1683658055169,DSGN 100,A01,185168,Staff,0,2,25,25
1683658056198,ECE 5,A01,185626,Morris; Karcher William,0,11,0,0
1683658057222,ECE 101,A01,185628,Staff,14,0,70,56
1683658058248,ECE 107,A01,185635,Baghdadchi; Saharnaz,0,0,20,20
1683658058248,ECE 107,A02,185638,Baghdadchi; Saharnaz,2,0,20,18
1683658059275,ECE 148,A01,185647,Silberman; Jack,0,0,16,16
1683658060299,ECON 1,A01,185537,Crane; Meredith Helen,54,0,70,16
1683658061327,ECON 3,A01,185549,Crane; Meredith Helen,29,0,70,41
1683658062351,ECON 4,A01,203354,Anderson; John Charles,0,5,10,10
1683658063377,ECON 100A,A01,185574,Staff,0,5,40,40
1683658064415,ECON 100B,A01,185576,Staff,0,12,50,50
1683658065442,ECON 100C,A01,185589,Newhouse; Herbert S,30,0,70,40
1683658066469,ECON 105,A00,185608,Vespa; Emanuel Ignacio,19,0,35,16
1683658067495,ECON 109,A01,185610,Shishkin; Denis,9,0,35,26
1683658068521,ECON 110A,A01,185612,Staff,9,0,40,31
1683658069549,ECON 120A,A01,185615,Staff,20,0,40,20
1683658070575,ECON 120C,A01,185617,Sun; Yixiao,0,20,70,70
1683658071601,ECON 144,A00,203346,Squires; Dale E,2,0,35,33
1683658072630,ECON 171,A01,203349,Newhouse; Herbert S,0,1,35,35
1683658073658,ECON 173A,A01,185621,Toda; Alexis Akira,20,0,35,15
1683658074686,EDS 25,A01,202413,Staff,0,1,0,0
1683658074686,EDS 25,A02,202414,Staff,0,1,0,0
1683658074686,EDS 25,A03,202415,Staff,0,0,0,0
1683658074686,EDS 25,A04,202416,Staff,0,1,0,0
1683658074686,EDS 25,A05,202439,Staff,0,0,0,0
1683658074686,EDS 25,A06,202440,Staff,0,0,0,0
1683658074686,EDS 25,B01,202631,Staff,0,0,0,0
1683658074686,EDS 25,B02,202632,Staff,0,0,0,0
1683658074686,EDS 25,B03,202639,Staff,0,0,0,0
1683658074686,EDS 25,B04,202640,Staff,0,0,0,0
1683658074686,EDS 25,B05,202643,Staff,0,0,0,0
1683658074686,EDS 25,B06,202644,Staff,0,0,0,0
1683658075715,EDS 38,A01,202659,Black; Alison Michelle,24,0,25,1
1683658076746,EDS 115,A00,202652,Staff,18,0,30,12
1683658077770,EDS 125,A00,202649,Staff,13,0,30,17
1683658078797,EDS 126,A01,203332,Staff,30,0,30,0
1683658079821,EDS 139,A00,202838,Staff,16,0,25,9
1683658080845,EDS 146,A01,202655,Staff,14,0,25,11
1683658081869,ENG 15,A00,185667,Staff,0,1,0,0
1683658081869,ENG 15,B00,185672,Staff,0,0,0,0
1683658081869,ENG 15,C00,185675,Staff,0,0,0,0
1683658081869,ENG 15,D00,185682,Staff,0,0,0,0
1683658081869,ENG 15,E00,185684,Staff,0,0,0,0
1683658082893,ETHN 103,A00,185710,Staff,0,8,35,35
1683658083919,ETHN 103A,A00,199228,Man; Simeon S,0,0,9,9
1683658084942,ETHN 109,A00,185711,Staff,16,0,35,19
1683658085966,ETHN 142,A00,185726,Staff,0,4,30,30
1683658086994,ETHN 163J,A00,199229,Man; Simeon S,5,0,8,3
1683658088024,ETHN 168,A00,185727,Staff,7,0,10,3
1683658089051,ETHN 182,A00,185728,Staff,0,0,35,35
1683658090074,ETHN 183,A00,185737,Staff,9,0,18,9
1683658091099,GLBH 111,A01,209361,Burgos; Jose L.,0,0,0,0
1683658093146,HIEU 104,A00,185792,Staff,14,0,20,6
1683658094174,HIEU 115,A00,185800,Staff,0,0,20,20
1683658095201,HIEU 128,A00,185801,Staff,0,9,20,20
1683658096223,HIEU 147,A00,185802,Staff,15,0,20,5
1683658097250,HIEU 154,A00,185823,Staff,11,0,20,9
1683658098276,HILA 102,A00,185826,Staff,14,0,20,6
1683658099302,HILD 2C,A01,185778,Staff,0,13,20,20
1683658100330,HILD 7B,A01,185780,Kwak; Nancy,0,17,32,32
1683658100330,HILD 7B,A02,185781,Kwak; Nancy,0,18,32,32
1683658101361,HILD 30,A01,185791,Staff,12,0,20,8
1683658102384,HISC 119,A00,185830,Golan; Tal,0,9,20,20
1683658103412,HITO 156GS,A00,185831,Patterson; Patrick H.,0,0,0,23
1683658104436,HIUS 103,A00,185832,Man; Simeon S,0,4,20,20
1683658105463,HIUS 117,A00,185836,Kwak; Nancy,2,0,20,18
1683658106487,HIUS 125,A00,185840,Man; Simeon S,0,2,23,23
1683658107514,HIUS 149,A00,185845,Staff,1,0,20,19
1683658108542,HUM 3,A01,185882,Zavodny; Tatiana Sophia,0,8,50,50
1683658108542,HUM 3,B01,185899,Caldwell; Michael Alan,0,18,50,50
1683658109571,HUM 3GS,A00,185900,Patterson; Patrick H.,0,0,0,23
1683658110597,HUM 4,A01,185938,Zroka; Amy Liane,29,0,50,21
1683658110597,HUM 4,B01,185956,Watkins; Eric,0,4,50,50
1683658110597,HUM 4,B02,202209,Watkins; Eric,0,5,50,50
1683658110597,HUM 4,B03,202210,Watkins; Eric,0,5,50,50
1683658111621,HUM 5,A01,185958,West; Geoffrey Scott,1,0,50,49
1683658111621,HUM 5,A02,202215,West; Geoffrey Scott,0,0,50,50
1683658112645,INTL 190,A00,185959,Gagnon; Jeffrey C,0,0,0,9
1683658112645,INTL 190,B00,185960,Lettieri; Michael Joseph,0,0,0,2
1683658113672,JAPN 180,A00,254509,Staff,5,0,30,25
1683658114699,LATI 10,A01,202853,Kennemore; Amy Michelle,4,0,35,31
1683658114699,LATI 10,A02,202854,Kennemore; Amy Michelle,2,0,35,33
1683658114699,LATI 10,A03,270054,Kennemore; Amy Michelle,30,0,30,0
1683658115724,LATI 180,A00,202855,Kennemore; Amy Michelle,11,0,20,9
1683658116748,LAWS 101,A00,201767,Golan; Tal,0,7,40,40
1683658117775,LIFR 1C,A00,185961,Staff,6,0,20,14
1683658118807,LIFR 1CX,A00,185962,Staff,7,0,20,13
1683658119831,LIFR 1D,A00,185963,Staff,7,0,20,13
1683658120856,LIFR 1DX,A00,185964,Staff,7,0,20,13
1683658121884,LIGN 101,A01,186039,Staff,43,0,50,7
1683658122909,LIGN 165,A00,186040,Staff,15,0,50,35
1683658123936,LTCS 108,A00,186041,Staff,5,0,10,5
1683658124960,LTCS 119,A00,186042,Staff,15,0,20,5
1683658125983,LTCS 130,A00,186043,Wesling; Megan E.,15,0,25,10
1683658128036,LTEA 138,A00,186119,Staff,14,0,40,26
1683658129061,LTEN 124,A00,186148,Staff,5,0,25,20
1683658130088,LTEN 178,A00,186149,Staff,7,0,15,8
1683658131112,LTEN 181,A00,186150,Blanco; John D,34,0,40,6
1683658132139,LTWL 120,A00,186160,Staff,20,0,25,5
1683658133165,LTWL 165,A00,186161,Staff,22,0,25,3
1683658134190,LTWR 100,A00,186162,Staff,0,5,15,15
1683658135214,LTWR 102,A00,186163,Doller; Ben,5,0,15,10
1683658136237,MAE 8,A01,186412,Staff,0,0,0,0
1683658137263,MAE 30B,A00,186445,Bahadori; Mohammad Yousef,82,0,100,18
1683658138289,MAE 40,A00,186592,Bewley; Thomas R,10,0,50,40
1683658139314,MAE 101B,A00,186593,Bahadori; Mohammad Yousef,80,0,100,20
1683658140339,MAE 105,A00,186594,Bandaru; Prabhakar,10,0,50,40
1683658141367,MAE 107,A00,186599,Pham; Hieu Tan,0,7,120,120
1683658142396,MAE 148,A01,186660,Silberman; Jack,3,0,16,13
1683658143423,MATH 10A,A01,188095,Staff,0,6,35,35
1683658144518,MATH 10B,A01,188097,Bowers; Adam R.,0,12,30,30
1683658144518,MATH 10B,A02,188099,Bowers; Adam R.,0,11,30,30
1683658144518,MATH 10B,B01,188104,Bowers; Adam R.,0,10,30,30
1683658144518,MATH 10B,B02,188106,Bowers; Adam R.,1,9,30,29
1683658145542,MATH 10C,A01,188111,Staff,0,18,30,30
1683658145542,MATH 10C,A02,188127,Staff,0,19,30,30
1683658145542,MATH 10C,A03,188131,Staff,0,19,30,30
1683658145542,MATH 10C,B01,188218,Staff,17,0,30,13
1683658145542,MATH 10C,B02,188244,Staff,13,0,30,17
1683658145542,MATH 10C,B03,188277,Staff,14,0,30,16
1683658146568,MATH 18,A01,188344,Bach; Quang Tran,18,0,30,12
1683658146568,MATH 18,A02,188345,Bach; Quang Tran,11,0,30,19
1683658146568,MATH 18,B01,188353,Bach; Quang Tran,11,0,30,19
1683658146568,MATH 18,B02,188354,Bach; Quang Tran,19,0,30,11
1683658147597,MATH 20A,A01,188374,Staff,11,0,35,24
1683658148624,MATH 20B,A01,188382,Ohm; Ko Woon,7,0,30,23
1683658148624,MATH 20B,A02,188383,Ohm; Ko Woon,22,0,30,8
1683658148624,MATH 20B,B01,188385,Ohm; Ko Woon,7,0,30,23
1683658148624,MATH 20B,B02,188392,Ohm; Ko Woon,22,0,30,8
1683658149652,MATH 20C,A01,188394,Harel; Guershon,11,0,30,19
1683658149652,MATH 20C,A02,188395,Harel; Guershon,13,0,30,17
1683658149652,MATH 20C,B01,188404,Harel; Guershon,5,0,30,25
1683658149652,MATH 20C,B02,188405,Harel; Guershon,18,0,30,12
1683658150680,MATH 20D,A01,188414,Hammock; Frances H,0,1,30,30
1683658150680,MATH 20D,A02,188415,Hammock; Frances H,0,1,30,30
1683658150680,MATH 20D,B01,188447,Hammock; Frances H,0,1,30,30
1683658150680,MATH 20D,B02,188486,Hammock; Frances H,4,0,30,26
1683658151710,MATH 20E,A01,188649,Staff,21,0,30,9
1683658151710,MATH 20E,A02,188650,Staff,21,0,30,9
1683658151710,MATH 20E,A03,188673,Staff,0,0,30,30
1683658152736,MATH 102,A01,188675,Staff,0,36,35,35
1683658153764,MATH 103B,A01,188681,Staff,3,0,35,32
1683658153764,MATH 103B,B01,188692,Staff,5,0,35,30
1683658154789,MATH 109,A01,188695,Salehi Golsefidy; Alireza,24,0,35,11
1683658154789,MATH 109,A02,188696,Salehi Golsefidy; Alireza,25,0,35,10
1683658155817,MATH 120A,A01,188698,Eggers; John Dietrich,7,0,35,28
1683658156846,MATH 142B,A01,188736,Ioana; Adrian,0,1,30,30
1683658156846,MATH 142B,A02,188741,Ioana; Adrian,0,1,30,30
1683658156846,MATH 142B,A03,188743,Ioana; Adrian,0,1,30,30
1683658157872,MATH 168A,A01,188790,Staff,0,10,35,35
1683658158901,MATH 170A,A01,188803,Nie; Jiawang,0,2,35,35
1683658158901,MATH 170A,A02,188811,Nie; Jiawang,0,0,35,35
1683658158901,MATH 170A,A03,188814,Nie; Jiawang,0,0,35,35
1683658158901,MATH 170A,A04,188815,Nie; Jiawang,10,0,35,25
1683658159929,MATH 193B,A01,188817,Staff,0,0,35,35
1683658159929,MATH 193B,A02,188818,Staff,5,0,35,30
1683658160957,MGT 4,A01,202857,Anderson; John Charles,61,0,80,19
1683658161986,MGT 12,A00,202858,Lindenberger; Wade Douglas,40,0,90,50
1683658163013,MGT 18,A00,202859,Staff,74,0,90,16
1683658164037,MGT 18GS,A00,202860,McKay; Michael J,13,0,28,15
1683658165063,MGT 45,A00,202861,Pecore; Joseph P.,12,0,90,78
1683658166090,MGT 100,A00,202863,Yavorsky; Daniel Ryan,28,0,90,62
1683658167118,MGT 103,A00,202864,Ehrich; Kristine R,0,17,90,90
1683658168141,MGT 112,A00,202865,Ehrich; Kristine R,15,0,90,75
1683658169166,MGT 121A,A00,202868,Staff,90,20,90,0
1683658170190,MGT 131B,A00,202869,Anderson; John Charles,59,0,90,31
1683658171217,MGT 136,A00,202871,Lindenberger; Wade Douglas,83,0,90,7
1683658172245,MGT 164,A00,202873,Staff,0,67,90,91
1683658173270,MGT 164GS,A00,202874,McKay; Mary A,13,0,28,15
1683658174297,MGT 180,A00,202875,Staff,0,50,90,91
1683658175325,MMW 11R,A01,205019,Herbst; Matthew,1,0,30,29
1683658175325,MMW 11R,A02,205026,Herbst; Matthew,29,0,30,1
1683658176353,MMW 15,A01,193512,Chang; Edmond Yi-Teh,0,8,28,28
1683658176353,MMW 15,A02,193513,Chang; Edmond Yi-Teh,0,5,28,28
1683658176353,MMW 15,A03,193514,Chang; Edmond Yi-Teh,0,5,28,28
1683658176353,MMW 15,A04,193515,Chang; Edmond Yi-Teh,0,5,28,28
1683658176353,MMW 15,A05,193516,Chang; Edmond Yi-Teh,0,5,28,28
1683658176353,MMW 15,A06,193517,Chang; Edmond Yi-Teh,0,6,28,28
1683658176353,MMW 15,B01,193519,Chang; Edmond Yi-Teh,0,5,28,28
1683658176353,MMW 15,B02,193520,Chang; Edmond Yi-Teh,0,5,28,28
1683658176353,MMW 15,B03,193521,Chang; Edmond Yi-Teh,0,5,28,28
1683658176353,MMW 15,B04,193522,Chang; Edmond Yi-Teh,0,5,28,28
1683658176353,MMW 15,B05,193523,Chang; Edmond Yi-Teh,0,5,28,28
1683658176353,MMW 15,B06,193524,Chang; Edmond Yi-Teh,0,5,28,28
1683658177380,MMW 122,A01,193526,Rahimi; Babak,0,16,28,28
1683658177380,MMW 122,A02,193527,Rahimi; Babak,0,15,28,28
1683658177380,MMW 122,A03,193528,Rahimi; Babak,0,0,0,0
1683658177380,MMW 122,A04,193529,Rahimi; Babak,0,0,0,0
1683658178404,MUS 1A,A01,186663,Staff,1,20,35,34
1683658179428,MUS 4,A01,186715,Staff,0,12,35,35
1683658180452,MUS 5R,A01,186796,Dubnov; Shlomo,0,17,35,35
1683658181476,MUS 6,A01,186798,Staff,0,5,25,25
1683658182504,MUS 7,A01,186830,Staff,11,0,35,24
1683658183531,MUS 8,A01,186930,Staff,0,26,35,35
1683658184556,MUS 15,A01,186932,Staff,0,16,35,35
1683658184556,MUS 15,B01,186934,Staff,1,17,35,34
1683658185580,MUS 80,A00,186935,Staff,0,0,20,20
1683658185580,MUS 80,B00,186936,Staff,24,0,25,1
1683658186605,NANO 11,A00,204702,Lipomi; Darren John,0,0,0,0
1683658187629,NANO 15,A01,204709,Yang; Kesong,0,1,0,0
1683658188657,NANO 114,A00,202069,Jahed Motlagh; Zeinab,3,0,10,7
1683658189685,PHIL 1,A00,186955,Grush; Rick Scott,31,0,40,9
1683658190711,PHIL 10,A01,186973,Grush; Rick Scott,27,0,35,8
1683658190711,PHIL 10,A02,186974,Grush; Rick Scott,33,0,35,2
1683658191734,PHIL 13,A01,186976,Staff,3,0,35,32
1683658191734,PHIL 13,A02,186977,Staff,16,0,35,19
1683658192759,PHIL 14,A01,186979,Staff,31,0,35,4
1683658192759,PHIL 14,A02,186986,Staff,32,0,35,3
1683658193784,PHIL 28,A01,186988,Staff,16,0,30,14
1683658193784,PHIL 28,A02,186989,Staff,1,0,30,29
1683658193784,PHIL 28,A03,186990,Staff,10,0,30,20
1683658193784,PHIL 28,A04,186991,Staff,26,0,30,4
1683658194808,PHIL 120,A00,186997,Staff,23,0,40,17
1683658195834,PHIL 137,A00,187003,Staff,7,0,40,33
1683658196859,PHIL 150,A00,187015,Staff,47,0,70,23
1683658197886,PHIL 167,A00,187021,Lamey; Andy M.,34,0,40,6
1683658198911,PHIL 174,A01,202226,Staff,17,0,20,3
1683658198911,PHIL 174,A02,202235,Staff,20,0,20,0
1683658199937,PHIL 191A,A00,258918,Staff,0,0,1,1
1683658200963,PHYS 1A,A00,187028,Staff,26,0,60,34
1683658201989,PHYS 1AL,001,187036,Staff,3,0,30,27
1683658201989,PHYS 1AL,002,187049,Staff,18,0,30,12
1683658203016,PHYS 1B,A00,187058,Staff,22,0,60,38
1683658204044,PHYS 1BL,001,187064,Staff,0,1,30,30
1683658204044,PHYS 1BL,002,187070,Staff,4,0,30,26
1683658205067,PHYS 1C,A00,187082,Staff,29,0,120,91
1683658206094,PHYS 1CL,001,187088,Staff,0,9,30,30
1683658206094,PHYS 1CL,002,187089,Staff,0,1,30,30
1683658206094,PHYS 1CL,009,262693,Staff,9,0,30,21
1683658207118,PHYS 2B,A01,187097,Staff,55,0,115,60
1683658208141,PHYS 2C,A01,187099,Staff,63,0,115,52
1683658209165,PHYS 2CL,A01,187101,Staff,5,0,28,23
1683658209165,PHYS 2CL,A02,187102,Staff,15,0,28,13
1683658210190,PHYS 2D,A01,187123,Shotwell; Brian,95,0,115,20
1683658211215,PHYS 4B,A01,187133,Grinstein; Benjamin,35,0,50,15
1683658212239,POLI 10,A00,188819,Staff,0,4,50,50
1683658213263,POLI 11,A00,188827,Staff,43,0,50,7
1683658214286,POLI 13R,A00,188828,Staff,0,1,20,20
1683658215311,POLI 27,A01,188830,Elgin; Samuel Zincke,0,2,70,70
1683658216337,POLI 30,A00,188832,Desposato; Scott,30,0,50,20
1683658217363,POLI 102F,A00,188834,Staff,0,0,40,40
1683658218390,POLI 104A,A00,188852,Staff,13,0,30,17
1683658219419,POLI 104I,A00,188853,Staff,0,7,20,20
1683658220444,POLI 110B,A00,188854,Wiens; David,6,0,20,14
1683658221467,POLI 112A,A00,188855,Wiens; David,3,0,30,27
1683658222493,POLI 117R,A00,188856,Forman; Fonna,0,12,20,20
1683658223518,POLI 118,A00,188857,Ingham; Sean,8,0,20,12
1683658224542,POLI 120G,A00,188858,Staff,8,0,30,22
1683658225566,POLI 131CR,A00,188863,Hoston; Germaine,21,0,50,29
1683658226589,POLI 133,A00,188864,Nellis; Gareth Hb,44,0,50,6
1683658227615,POLI 134D,A00,188865,Desposato; Scott,27,0,30,3
1683658228643,POLI 142A,A00,188871,Gartzke; Erik,21,0,50,29
1683658229667,POLI 142K,A00,188874,Staff,38,0,50,12
1683658230691,POLI 143,A00,188940,Gartzke; Erik,16,0,30,14
1683658231715,POLI 153,A00,188943,Staff,2,0,20,18
1683658232738,POLI 160AA,A00,188944,Staff,11,0,40,29
1683658233762,POLI 170A,A00,188945,Staff,11,0,30,19
1683658235810,PSYC 1,A00,188952,Staff,36,0,90,54
1683658236836,PSYC 2,B00,188953,Staff,19,0,35,16
1683658237864,PSYC 6,A00,188970,Staff,47,0,60,13
1683658238892,PSYC 7,A00,188973,Staff,35,0,45,10
1683658239916,PSYC 60,A01,188980,Rickard; Timothy C.,42,0,60,18
1683658240944,PSYC 70,A01,189001,Steiner; Eric Tomas,22,0,45,23
1683658241969,PSYC 100,A00,189005,Lacefield; Katharine I,0,99,120,120
1683658242998,PSYC 102,A00,189008,Staff,8,0,30,22
1683658244025,PSYC 106,B00,189026,Gorman; Michael R.,27,0,60,33
1683658245050,PSYC 114,B01,189033,Winkielman; Piotr,0,31,30,30
1683658246078,PSYC 131,A00,189036,Anagnostaras; Stephan,0,43,60,60
1683658247101,PSYC 136,A00,189041,Lowe; Angela Beth,0,7,25,25
1683658248184,PSYC 137,A00,189057,Winkielman; Piotr,0,37,25,25
1683658249207,PSYC 144,A00,189107,Wixted; John T,0,11,50,50
1683658251258,PSYC 162,A00,189142,Staff,0,9,85,85
1683658252284,PSYC 172,A00,189144,Gorman; Michael R.,0,6,30,30
1683658254336,PSYC 179,A00,189146,Lacefield; Katharine I,0,87,120,120
1683658255361,PSYC 181,A00,189147,Anagnostaras; Stephan,0,44,90,90
1683658256388,PSYC 190R,A00,189148,Barner; David A.,0,23,80,80
1683658257414,PSYC 191,A00,189275,Rickard; Timothy C.,0,10,25,25
1683658258440,PSYC 193,A00,189276,Chapman; Eddie Nathaniel,0,1,0,4
1683658259464,PSYC 193L,A01,189281,Lowe; Angela Beth,10,0,20,10
1683658259464,PSYC 193L,B01,189285,Staff,28,0,35,7
1683658260488,RELI 149,A00,187137,Rahimi; Babak,7,0,40,33
1683658261516,SE 9,A01,187315,Staff,0,2,18,18
1683658262542,SE 101B,A00,187409,Staff,24,0,30,6
1683658263569,SE 110B,A00,187444,Staff,10,0,40,30
1683658264594,SE 130B,A00,187449,Staff,31,0,40,9
1683658265619,SE 150A,A00,187516,Staff,9,0,20,11
1683658266643,SE 154,A00,187528,Staff,29,0,50,21
1683658267667,SIO 3,A01,258171,Staff,35,0,40,5
1683658268691,SIO 10,A00,187144,Cook; Geoffrey W,0,6,75,75
1683658269720,SIO 45,A00,187152,Cook; Geoffrey W,0,4,100,100
1683658270744,SIO 109R,A00,194486,Staff,0,4,20,20
1683658272799,SIO 187,A01,187233,Kacev; David,12,0,40,28
1683658273829,SOCI 1,A01,258656,Thorpe; Charles Robert,28,0,30,2
1683658273829,SOCI 1,A02,258658,Thorpe; Charles Robert,30,0,30,0
1683658273829,SOCI 1,A03,258661,Thorpe; Charles Robert,25,0,25,0
1683658273829,SOCI 1,A04,258666,Thorpe; Charles Robert,22,0,25,3
1683658273829,SOCI 1,A05,258897,Thorpe; Charles Robert,22,0,25,3
1683658273829,SOCI 1,A06,258898,Thorpe; Charles Robert,25,0,25,0
1683658274854,SOCI 30,A01,258903,Pardo Guerra; Juan Pablo,14,0,30,16
1683658275877,SOCI 102,A00,258904,Staff,9,0,25,16
1683658276903,SOCI 106,A00,258905,Staff,19,0,25,6
1683658277928,SOCI 111,A00,258907,Ribas Norris; Janet Vanesa,26,0,30,4
1683658278951,SOCI 121R,A00,258908,Pardo Guerra; Juan Pablo,8,0,30,22
1683658279976,SOCI 126,A01,203330,Staff,14,0,20,6
1683658281000,SOCI 131,A00,258909,Thorpe; Charles Robert,30,0,60,30
1683658282024,SOCI 135,A00,258910,Payne; Christine Anna,0,11,30,30
1683658283049,SOCI 157,A00,258911,Staff,12,0,30,18
1683658284075,SOCI 184,A00,258912,Staff,25,0,30,5
1683658285101,SOCI 188D,A00,258913,Staff,22,0,30,8
1683658286126,SYN 2,001,187529,Staff,9,0,16,7
1683658286126,SYN 2,002,201452,Staff,0,20,16,16
1683658286126,SYN 2,003,201469,Staff,1,0,16,15
1683658287152,SYN 100,A01,187531,Staff,0,9,20,20
1683658287152,SYN 100,B01,201491,Staff,0,10,20,20
1683658288178,TDAC 1,A00,189286,Walsh; Kim C.,3,0,20,17
1683658288178,TDAC 1,B00,189287,Harting; Carla Kelso,10,0,20,10
1683658289203,TDAC 101,A00,189300,Walsh; Kim C.,16,0,20,4
1683658289203,TDAC 101,B00,189301,Harting; Carla Kelso,18,0,20,2
1683658290227,TDAC 102,A00,189304,Basso; Beatrice,14,0,20,6
1683658291255,TDAC 108,A00,189305,Staff,18,0,20,2
1683658292282,TDDE 131,A00,189310,Staff,19,0,20,1
1683658292282,TDDE 131,B00,189314,Staff,19,0,20,1
1683658292282,TDDE 131,C00,189315,Staff,48,0,50,2
1683658292282,TDDE 131,D00,189316,Staff,14,0,15,1
1683658292282,TDDE 131,E00,204841,Staff,20,0,20,0
1683658293307,TDGE 10,A00,189289,Staff,27,0,50,23
1683658293307,TDGE 10,B00,189290,Havis; Allan,0,0,50,50
1683658294332,TDGE 11,A00,189291,Fulton; Julia,0,4,50,50
1683658294332,TDGE 11,B00,189292,Staff,20,0,25,5
1683658294332,TDGE 11,C00,260270,Staff,0,0,0,0
1683658295360,TDGE 25,A00,189294,Staff,2,0,20,18
1683658296383,TDGE 124,A00,189318,Fulton; Julia,0,8,50,50
1683658297410,TDGE 125,A00,189319,Staff,13,0,25,12
1683658297410,TDGE 125,B00,189320,Staff,23,0,25,2
1683658298437,TDGE 127,A00,189322,Havis; Allan,0,0,50,50
1683658299462,TDHT 101,A00,189323,Staff,18,0,25,7
1683658299462,TDHT 101,B00,189324,Staff,25,0,25,0
1683658300489,TDHT 102,A00,189325,Staff,49,0,50,1
1683658301517,TDMV 1,A00,189295,Arcidiacono; Kristin,20,0,30,10
1683658301517,TDMV 1,B00,189296,Caligagan; Maria T.,24,0,30,6
1683658302541,TDMV 2,A00,189297,Sammartano; Tonnie,27,0,30,3
1683658302541,TDMV 2,B00,189299,Arcidiacono; Kristin,23,0,30,7
1683658303568,TDMV 3,A00,204998,Rincon; Alicia,22,0,30,8
1683658304595,TDMV 120,A00,189458,Sammartano; Tonnie,28,0,30,2
1683658305621,TDMV 138,A00,189541,Jun; Grace Shin Hae,20,0,40,20
1683658306647,TDMV 142,A00,189717,Caligagan; Tony,25,0,30,5
1683658306647,TDMV 142,B00,189718,Caligagan; Maria T.,25,0,30,5
1683658307673,TMC 2,A01,187533,Staff,25,0,25,0
1683658307673,TMC 2,A02,187534,Staff,25,0,25,0
1683658308700,USP 1,A01,187536,Kwak; Nancy,0,16,25,25
1683658309727,USP 5,A01,187538,Staff,9,0,25,16
1683658310751,USP 101,A00,199253,Staff,0,4,0,0
1683658311781,USP 124,A00,187562,Boomhower; Matthew Charles,0,0,30,30
1683658312806,USP 138,A00,187582,Staff,20,0,25,5
1683658313833,USP 152,A01,187597,Staff,3,0,25,22
1683658314860,USP 153,A00,187598,Staff,19,0,25,6
1683658315886,USP 168,A00,187607,Kwak; Nancy,2,0,5,3
1683658316913,USP 173,A00,187619,Staff,4,0,25,21
1683658317938,USP 181,A00,187638,Staff,0,4,25,25
1683658318963,VIS 103,A00,187650,Cruz; Edwin Teddy,18,0,75,57
1683658319990,VIS 110D,A00,187669,Staff,13,0,22,9
1683658321014,VIS 127C,A00,187720,Shen; Kuiyi,67,0,146,79
1683658322039,VIS 149,A00,187731,Yoldas; Pinar,0,14,22,22
1683658323064,VIS 151,A01,188091,Staff,22,0,34,12
1683658323064,VIS 151,A02,188092,Staff,11,0,34,23
1683658324090,VIS 160B,A00,188093,Stalbaum; Brett,0,1,10,10
1683658326140,WCWP 10B,A00,201720,Staff,10,0,15,5
1683658326140,WCWP 10B,B00,201722,Staff,9,0,15,6
1683658327163,WCWP 100,A00,201725,Gagnon; Jeffrey C,0,0,2,2
1683658327163,WCWP 100,B00,201727,Staff,0,4,15,15
1683658330292,ANBI 133,A00,258401,Wilder; Linnea Lorene,34,0,40,6
1683658331320,ANBI 140,A00,258395,Hrvoj Mihic; Branka,18,0,25,7
1683658332345,ANSC 120,A00,258402,Bialecki; Jon Anthony,26,0,40,14
1683658333372,ANSC 144,A00,258400,Staff,12,0,40,28
1683658335420,ANSC 166,A00,258396,Parish; Steven Martin,156,0,175,19
1683658336443,ANSC 180,A00,193533,Staff,8,0,20,12
1683658337470,ANSC 188,A00,258397,Jassal; Aftab,34,0,40,6
1683658338497,ANTH 3,A01,258316,Staff,23,0,30,7
1683658339525,ANTH 5,A00,258394,Semendeferi; Ekaterini,16,0,20,4
1683658340549,ANTH 21,A01,258331,Staff,4,0,40,36
1683658341578,ANTH 103,A00,258398,Varma; Saiba,15,0,25,10
1683658342606,AWP 10,001,202034,Staff,0,0,0,0
1683658342606,AWP 10,002,202035,Staff,0,0,0,0
1683658342606,AWP 10,003,202036,Staff,0,0,0,0
1683658342606,AWP 10,004,202037,Staff,0,0,0,0
1683658342606,AWP 10,005,202038,Staff,0,0,0,0
1683658342606,AWP 10,006,202039,Staff,0,0,0,0
1683658342606,AWP 10,007,202040,Staff,0,0,0,0
1683658342606,AWP 10,008,202041,Staff,0,0,0,0
1683658342606,AWP 10,009,202042,Staff,0,0,0,0
1683658342606,AWP 10,010,202043,Staff,0,0,0,0
1683658342606,AWP 10,011,202044,Staff,0,0,0,0
1683658342606,AWP 10,012,202045,Staff,0,0,0,0
1683658342606,AWP 10,013,202046,Staff,0,0,0,0
1683658342606,AWP 10,014,202047,Staff,0,0,0,0
1683658342606,AWP 10,015,202048,Staff,0,0,0,0
1683658342606,AWP 10,016,202049,Staff,0,0,0,0
1683658342606,AWP 10,017,202050,Staff,0,0,0,0
1683658342606,AWP 10,018,202051,Staff,0,0,0,0
1683658342606,AWP 10,019,202052,Staff,0,0,0,0
1683658342606,AWP 10,020,202053,Staff,0,0,0,0
1683658342606,AWP 10,021,202054,Staff,0,0,0,0
1683658342606,AWP 10,022,202055,Staff,0,0,0,0
1683658342606,AWP 10,023,202056,Staff,0,0,0,0
1683658342606,AWP 10,024,202057,Staff,0,0,0,0
1683658342606,AWP 10,025,202058,Staff,0,0,0,0
1683658342606,AWP 10,026,202059,Staff,0,0,0,0
1683658343629,AWP 102,001,202032,Staff,0,0,0,0
1683658343629,AWP 102,002,202033,Staff,0,0,0,0
1683658344658,BENG 100,A01,254234,Taylor Amos; Alyssa C,31,0,40,9
1683658345685,BENG 196,001,270013,Engler; Adam J.,9999,0,9999,0
1683658346713,BICD 100R,A01,202018,Smith; Laurie,0,7,32,32
1683658346713,BICD 100R,A02,202019,Smith; Laurie,0,3,32,32
1683658346713,BICD 100R,A03,202020,Smith; Laurie,0,1,32,32
1683658346713,BICD 100R,A04,202021,Smith; Laurie,6,0,32,26
1683658346713,BICD 100R,A05,202022,Smith; Laurie,11,0,32,21
1683658347741,BICD 136,A01,193242,Gustafson-Brown; Cindy,0,2,32,32
1683658347741,BICD 136,A02,193244,Gustafson-Brown; Cindy,13,0,32,19
1683658348774,BIEB 102,A01,193249,Butler; Shannon Rhey,1,2,32,31
1683658348774,BIEB 102,A02,193251,Butler; Shannon Rhey,0,0,32,32
1683658348774,BIEB 102,A03,193253,Butler; Shannon Rhey,0,0,32,32
1683658348774,BIEB 102,A04,193255,Butler; Shannon Rhey,14,0,32,18
1683658348774,BIEB 102,A05,193265,Butler; Shannon Rhey,26,0,32,6
1683658348774,BIEB 102,A06,193269,Butler; Shannon Rhey,14,0,32,18
1683658350825,BIEB 150,A01,193274,Staff,0,0,32,32
1683658350825,BIEB 150,A02,193285,Staff,24,0,32,8
1683658351923,BIEB 194,A00,193286,Kurle; Carolyn M.,20,0,32,12
1683658352953,BILD 1,A01,192291,Staff,15,0,32,17
1683658352953,BILD 1,A02,192292,Staff,30,0,32,2
1683658352953,BILD 1,B01,192520,Reuther; Keefe,0,1,0,0
1683658352953,BILD 1,B02,192532,Reuther; Keefe,0,1,0,0
1683658353982,BILD 3,A01,192556,Butler; Shannon Rhey,0,0,32,32
1683658353982,BILD 3,A02,192581,Butler; Shannon Rhey,1,0,32,31
1683658353982,BILD 3,A03,192611,Butler; Shannon Rhey,21,0,32,11
1683658353982,BILD 3,A04,192612,Butler; Shannon Rhey,24,0,32,8
1683658353982,BILD 3,A05,192613,Butler; Shannon Rhey,26,0,32,6
1683658353982,BILD 3,A06,192679,Butler; Shannon Rhey,27,0,32,5
1683658353982,BILD 3,A07,192682,Butler; Shannon Rhey,20,0,32,12
1683658355008,BILD 4,A01,192836,Reuther; Keefe,1,0,24,23
1683658355008,BILD 4,A02,193044,Reuther; Keefe,4,0,24,20
1683658356033,BILD 10,A01,193142,Gustafson-Brown; Cindy,29,0,32,3
1683658356033,BILD 10,A02,193149,Gustafson-Brown; Cindy,31,0,32,1
1683658357060,BIMM 100,A01,193301,Staff,0,6,32,32
1683658357060,BIMM 100,A02,193312,Staff,0,7,32,32
1683658357060,BIMM 100,A03,193323,Staff,0,9,32,32
1683658358086,BIMM 101,A01,193329,McDonnell; Lisa Marie,0,4,24,24
1683658358086,BIMM 101,A02,193339,McDonnell; Lisa Marie,1,3,24,23
1683658358086,BIMM 101,B01,193354,McDonnell; Lisa Marie,0,4,24,24
1683658358086,BIMM 101,B02,193357,McDonnell; Lisa Marie,0,3,24,24
1683658359126,BIMM 110,A01,193377,Tat; John,0,11,32,32
1683658359126,BIMM 110,A02,193378,Tat; John,0,10,32,32
1683658360149,BIMM 120,A01,206116,Staff,0,0,32,32
1683658360149,BIMM 120,A02,206117,Staff,6,0,32,26
1683658360149,BIMM 120,A03,206121,Staff,21,0,32,11
1683658361177,BIPN 100,A01,193393,Park; Ji Young,0,15,32,32
1683658361177,BIPN 100,A02,193402,Park; Ji Young,0,14,32,32
1683658361177,BIPN 100,A03,193413,Park; Ji Young,0,14,32,32
1683658361177,BIPN 100,A04,193414,Park; Ji Young,0,13,32,32
1683658362205,BIPN 102,A01,193429,Staff,0,0,32,32
1683658362205,BIPN 102,A02,193438,Staff,18,0,32,14
1683658363231,BIPN 106,A01,193450,Reyes Gonzalez; Catalina,0,2,40,40
1683658364256,BIPN 134,A01,193465,Cooke; James Edward,0,0,32,32
1683658364256,BIPN 134,A02,193474,Cooke; James Edward,25,0,32,7
1683658364256,BIPN 134,A03,193485,Cooke; James Edward,29,0,32,3
1683658364256,BIPN 134,A04,193486,Cooke; James Edward,20,0,32,12
1683658364256,BIPN 134,A05,193491,Cooke; James Edward,31,0,32,1
1683658364256,BIPN 134,A06,193501,Cooke; James Edward,30,0,32,2
1683658364256,BIPN 134,A07,193510,Cooke; James Edward,29,0,32,3
1683658366307,BISP 194,A00,222522,Staff,14,0,32,18
1683658367332,CAT 124,A01,202407,Staff,19,0,25,6
1683658368356,CAT 125,A00,202408,Marchisotto; Jennifer Anne,2,0,20,18
1683658369384,CAT 125R,A00,202409,Smith; Lauryn Alissa,0,11,20,20
1683658369384,CAT 125R,B00,202410,Morales; Celeste Georgianna,0,11,20,20
1683658369384,CAT 125R,C00,202411,Irwin; Matthew Joseph,0,12,20,20
1683658370411,CENG 15,A01,204712,Yang; Kesong,0,1,0,0
1683658371435,CENG 114,A00,202070,Jahed Motlagh; Zeinab,5,0,20,15
1683658372461,CGS 105,A00,185477,Wesling; Megan E.,24,0,40,16
1683658373489,CGS 106,A00,185494,Staff,11,0,22,11
1683658374512,CGS 108,A00,185495,Staff,14,0,20,6
1683658375540,CGS 114,A00,185496,Staff,13,0,18,5
1683658376563,CGS 119,A00,185501,Staff,15,0,20,5
1683658377587,CGS 120,A00,185511,Staff,12,0,20,8
1683658378613,CHEM 4,A01,184675,Bussey; Thomas J,97,0,100,3
1683658379638,CHEM 6A,A01,184677,Staff,33,0,60,27
1683658380664,CHEM 6B,A01,184679,Staff,63,0,100,37
1683658381689,CHEM 6C,A01,184681,Bussey; Thomas J,0,0,50,50
1683658381689,CHEM 6C,A02,184682,Bussey; Thomas J,32,0,50,18
1683658382713,CHEM 40A,A01,184684,Albizati; Kim F.,34,0,100,66
1683658383738,CHEM 40B,A01,184686,Albizati; Kim F.,0,22,100,100
1683658384762,CHEM 41B,A01,184690,Staff,51,0,100,49
1683658385791,COGS 3,A01,184715,Boyle; Mary E. T.,0,27,40,40
1683658386818,COGS 14B,A01,185172,Staff,0,14,38,38
1683658387843,COGS 18,A01,184736,Staff,14,0,80,66
1683658388867,COGS 100,A01,184932,Staff,0,7,73,73
1683658389892,COGS 101A,A01,184935,Staff,0,39,30,30
1683658390917,COGS 101B,A01,184944,Staff,0,2,30,30
1683658391943,COGS 101C,A01,184946,Staff,0,10,30,30
1683658392967,COGS 102A,A01,184951,Johnson; Christine M.,2,0,40,38
1683658393990,COGS 107B,A01,184953,Mooshagian; Eric Frederick,0,51,40,40
1683658395014,COGS 118B,A01,184959,Gupta; Anjum,0,49,40,40
1683658396041,COGS 153,A00,184961,Staff,0,16,30,30
1683658397068,COGS 177,A00,184962,Staff,0,21,30,30
1683658398096,COGS 187A,A01,184969,Boyle; Mary E. T.,0,19,40,40
1683658399122,COMM 10,A01,185174,Staff,0,5,25,25
1683658399122,COMM 10,A02,185189,Staff,0,2,25,25
1683658399122,COMM 10,A03,269821,Staff,0,1,0,0
1683658400150,COMM 100B,A01,185475,Staff,0,1,0,2
1683658400150,COMM 100B,A02,185476,Staff,12,0,25,13
1683658401174,COMM 100C,A01,185314,Staff,1,0,25,24
1683658401174,COMM 100C,A02,185327,Staff,18,0,25,7
1683658402196,COMM 110M,A00,185349,Staff,0,0,40,40
1683658403223,COMM 113T,A00,185352,Staff,25,0,40,15
1683658404253,COMM 114I,A00,185353,Staff,31,0,40,9
1683658405279,COMM 131,A00,185354,Staff,17,0,30,13
1683658406308,CSE 8A,A50,185358,Cao; Yingjun,0,46,10,10
1683658407336,CSE 8B,A01,185362,Staff,0,48,50,50
1683658408359,CSE 11,A01,185416,Cao; Yingjun,0,91,10,10
1683658409382,CSE 20,A01,185445,Briones; Jor-el Thomas Caparas,4,0,25,21
1683658410410,CSE 21,A01,185447,Staff,9,0,50,41
1683658411439,CSE 101,A01,185451,Staff,0,13,50,50
1683658411439,CSE 101,B01,185453,Jones; Miles E,0,13,50,50
1683658413491,CSE 141,A01,185458,Eldon; John,16,0,100,84
1683658414518,CSE 141L,A01,185461,Eldon; John,8,0,100,92
1683658415545,CSE 142,A01,185463,Staff,34,0,60,26
1683658415545,CSE 142,B01,201355,Staff,0,7,60,60
1683658416572,CSE 142L,A01,185470,Staff,34,0,60,26
1683658416572,CSE 142L,B01,201417,Staff,0,6,60,60
1683658417599,CSE 190,A00,201433,Staff,32,0,49,17
1683658418626,DOC 1,A01,259136,Strom; Megan C.,7,0,15,8
1683658418626,DOC 1,A02,259137,Strom; Megan C.,14,0,15,1
1683658418626,DOC 1,A03,259138,Strom; Megan C.,14,0,15,1
1683658418626,DOC 1,A04,259139,Strom; Megan C.,14,0,15,1
1683658419649,DOC 100D,A00,259140,Pass; Natalye Joann,14,0,25,11
1683658420673,DSGN 1,A01,184749,Rill; Bryan,0,26,30,30
1683658421700,DSGN 100,A01,185168,Staff,0,2,25,25
1683658422723,ECE 5,A01,185626,Morris; Karcher William,0,11,0,0
1683658423747,ECE 101,A01,185628,Staff,14,0,70,56
1683658424772,ECE 107,A01,185635,Baghdadchi; Saharnaz,0,0,20,20
1683658424772,ECE 107,A02,185638,Baghdadchi; Saharnaz,2,0,20,18
1683658425795,ECE 148,A01,185647,Silberman; Jack,0,0,16,16
1683658426819,ECON 1,A01,185537,Crane; Meredith Helen,54,0,70,16
1683658427846,ECON 3,A01,185549,Crane; Meredith Helen,29,0,70,41
1683658428873,ECON 4,A01,203354,Anderson; John Charles,0,5,10,10
1683658429901,ECON 100A,A01,185574,Staff,0,5,40,40
1683658430927,ECON 100B,A01,185576,Staff,0,12,50,50
1683658431952,ECON 100C,A01,185589,Newhouse; Herbert S,30,0,70,40
1683658432977,ECON 105,A00,185608,Vespa; Emanuel Ignacio,19,0,35,16
1683658434006,ECON 109,A01,185610,Shishkin; Denis,9,0,35,26
1683658435058,ECON 110A,A01,185612,Staff,9,0,40,31
1683658436081,ECON 120A,A01,185615,Staff,20,0,40,20
1683658437105,ECON 120C,A01,185617,Sun; Yixiao,0,20,70,70
1683658438130,ECON 144,A00,203346,Squires; Dale E,2,0,35,33
1683658439154,ECON 171,A01,203349,Newhouse; Herbert S,0,1,35,35
1683658440178,ECON 173A,A01,185621,Toda; Alexis Akira,20,0,35,15
1683658441209,EDS 25,A01,202413,Staff,0,1,0,0
1683658441209,EDS 25,A02,202414,Staff,0,1,0,0
1683658441209,EDS 25,A03,202415,Staff,0,0,0,0
1683658441209,EDS 25,A04,202416,Staff,0,1,0,0
1683658441209,EDS 25,A05,202439,Staff,0,0,0,0
1683658441209,EDS 25,A06,202440,Staff,0,0,0,0
1683658441209,EDS 25,B01,202631,Staff,0,0,0,0
1683658441209,EDS 25,B02,202632,Staff,0,0,0,0
1683658441209,EDS 25,B03,202639,Staff,0,0,0,0
1683658441209,EDS 25,B04,202640,Staff,0,0,0,0
1683658441209,EDS 25,B05,202643,Staff,0,0,0,0
1683658441209,EDS 25,B06,202644,Staff,0,0,0,0
1683658442237,EDS 38,A01,202659,Black; Alison Michelle,24,0,25,1
1683658443263,EDS 115,A00,202652,Staff,18,0,30,12
1683658444290,EDS 125,A00,202649,Staff,13,0,30,17
1683658445317,EDS 126,A01,203332,Staff,30,0,30,0
1683658446344,EDS 139,A00,202838,Staff,16,0,25,9
1683658447370,EDS 146,A01,202655,Staff,14,0,25,11
1683658448397,ENG 15,A00,185667,Staff,0,1,0,0
1683658448397,ENG 15,B00,185672,Staff,0,0,0,0
1683658448397,ENG 15,C00,185675,Staff,0,0,0,0
1683658448397,ENG 15,D00,185682,Staff,0,0,0,0
1683658448397,ENG 15,E00,185684,Staff,0,0,0,0
1683658449421,ETHN 103,A00,185710,Staff,0,8,35,35
1683658450444,ETHN 103A,A00,199228,Man; Simeon S,0,0,9,9
1683658451466,ETHN 109,A00,185711,Staff,16,0,35,19
1683658452493,ETHN 142,A00,185726,Staff,0,4,30,30
1683658453520,ETHN 163J,A00,199229,Man; Simeon S,5,0,8,3
1683658454545,ETHN 168,A00,185727,Staff,7,0,10,3
1683658455625,ETHN 182,A00,185728,Staff,0,0,35,35
1683658456648,ETHN 183,A00,185737,Staff,9,0,18,9
1683658457677,GLBH 111,A01,209361,Burgos; Jose L.,0,0,0,0
1683658459726,HIEU 104,A00,185792,Staff,14,0,20,6
1683658460749,HIEU 115,A00,185800,Staff,0,0,20,20
1683658461773,HIEU 128,A00,185801,Staff,0,9,20,20
1683658462796,HIEU 147,A00,185802,Staff,15,0,20,5
1683658463818,HIEU 154,A00,185823,Staff,11,0,20,9
1683658464843,HILA 102,A00,185826,Staff,14,0,20,6
1683658465872,HILD 2C,A01,185778,Staff,0,13,20,20
1683658466896,HILD 7B,A01,185780,Kwak; Nancy,0,17,32,32
1683658466896,HILD 7B,A02,185781,Kwak; Nancy,0,18,32,32
1683658467923,HILD 30,A01,185791,Staff,12,0,20,8
1683658468949,HISC 119,A00,185830,Golan; Tal,0,9,20,20
1683658469978,HITO 156GS,A00,185831,Patterson; Patrick H.,0,0,0,23
1683658471001,HIUS 103,A00,185832,Man; Simeon S,0,4,20,20
1683658472026,HIUS 117,A00,185836,Kwak; Nancy,2,0,20,18
1683658473050,HIUS 125,A00,185840,Man; Simeon S,0,2,23,23
1683658474075,HIUS 149,A00,185845,Staff,1,0,20,19
1683658475100,HUM 3,A01,185882,Zavodny; Tatiana Sophia,0,8,50,50
1683658475100,HUM 3,B01,185899,Caldwell; Michael Alan,0,18,50,50
1683658476124,HUM 3GS,A00,185900,Patterson; Patrick H.,0,0,0,23
1683658477148,HUM 4,A01,185938,Zroka; Amy Liane,29,0,50,21
1683658477148,HUM 4,B01,185956,Watkins; Eric,0,4,50,50
1683658477148,HUM 4,B02,202209,Watkins; Eric,0,5,50,50
1683658477148,HUM 4,B03,202210,Watkins; Eric,0,5,50,50
1683658478172,HUM 5,A01,185958,West; Geoffrey Scott,1,0,50,49
1683658478172,HUM 5,A02,202215,West; Geoffrey Scott,0,0,50,50
1683658479200,INTL 190,A00,185959,Gagnon; Jeffrey C,0,0,0,9
1683658479200,INTL 190,B00,185960,Lettieri; Michael Joseph,0,0,0,2
1683658480223,JAPN 180,A00,254509,Staff,5,0,30,25
1683658481247,LATI 10,A01,202853,Kennemore; Amy Michelle,4,0,35,31
1683658481247,LATI 10,A02,202854,Kennemore; Amy Michelle,2,0,35,33
1683658481247,LATI 10,A03,270054,Kennemore; Amy Michelle,30,0,30,0
1683658482271,LATI 180,A00,202855,Kennemore; Amy Michelle,11,0,20,9
1683658483299,LAWS 101,A00,201767,Golan; Tal,0,7,40,40
1683658484323,LIFR 1C,A00,185961,Staff,6,0,20,14
1683658485347,LIFR 1CX,A00,185962,Staff,7,0,20,13
1683658486370,LIFR 1D,A00,185963,Staff,7,0,20,13
1683658487396,LIFR 1DX,A00,185964,Staff,7,0,20,13
1683658488421,LIGN 101,A01,186039,Staff,43,0,50,7
1683658489443,LIGN 165,A00,186040,Staff,15,0,50,35
1683658490465,LTCS 108,A00,186041,Staff,5,0,10,5
1683658491491,LTCS 119,A00,186042,Staff,15,0,20,5
1683658492517,LTCS 130,A00,186043,Wesling; Megan E.,15,0,25,10
1683658494568,LTEA 138,A00,186119,Staff,14,0,40,26
1683658495590,LTEN 124,A00,186148,Staff,5,0,25,20
1683658496615,LTEN 178,A00,186149,Staff,7,0,15,8
1683658497639,LTEN 181,A00,186150,Blanco; John D,34,0,40,6
1683658498664,LTWL 120,A00,186160,Staff,20,0,25,5
1683658499688,LTWL 165,A00,186161,Staff,22,0,25,3
1683658500713,LTWR 100,A00,186162,Staff,0,5,15,15
1683658501740,LTWR 102,A00,186163,Doller; Ben,5,0,15,10
1683658502763,MAE 8,A01,186412,Staff,0,0,0,0
1683658503791,MAE 30B,A00,186445,Bahadori; Mohammad Yousef,82,0,100,18
1683658504821,MAE 40,A00,186592,Bewley; Thomas R,10,0,50,40
1683658505845,MAE 101B,A00,186593,Bahadori; Mohammad Yousef,80,0,100,20
1683658506872,MAE 105,A00,186594,Bandaru; Prabhakar,10,0,50,40
1683658507899,MAE 107,A00,186599,Pham; Hieu Tan,0,7,120,120
1683658508924,MAE 148,A01,186660,Silberman; Jack,3,0,16,13
1683658509947,MATH 10A,A01,188095,Staff,0,6,35,35
1683658510972,MATH 10B,A01,188097,Bowers; Adam R.,0,12,30,30
1683658510972,MATH 10B,A02,188099,Bowers; Adam R.,0,11,30,30
1683658510972,MATH 10B,B01,188104,Bowers; Adam R.,0,10,30,30
1683658510972,MATH 10B,B02,188106,Bowers; Adam R.,1,9,30,29
1683658511994,MATH 10C,A01,188111,Staff,0,18,30,30
1683658511994,MATH 10C,A02,188127,Staff,0,19,30,30
1683658511994,MATH 10C,A03,188131,Staff,0,19,30,30
1683658511994,MATH 10C,B01,188218,Staff,17,0,30,13
1683658511994,MATH 10C,B02,188244,Staff,13,0,30,17
1683658511994,MATH 10C,B03,188277,Staff,14,0,30,16
1683658513018,MATH 18,A01,188344,Bach; Quang Tran,18,0,30,12
1683658513018,MATH 18,A02,188345,Bach; Quang Tran,11,0,30,19
1683658513018,MATH 18,B01,188353,Bach; Quang Tran,11,0,30,19
1683658513018,MATH 18,B02,188354,Bach; Quang Tran,19,0,30,11
1683658514043,MATH 20A,A01,188374,Staff,11,0,35,24
1683658515070,MATH 20B,A01,188382,Ohm; Ko Woon,7,0,30,23
1683658515070,MATH 20B,A02,188383,Ohm; Ko Woon,22,0,30,8
1683658515070,MATH 20B,B01,188385,Ohm; Ko Woon,7,0,30,23
1683658515070,MATH 20B,B02,188392,Ohm; Ko Woon,22,0,30,8
1683658516101,MATH 20C,A01,188394,Harel; Guershon,11,0,30,19
1683658516101,MATH 20C,A02,188395,Harel; Guershon,13,0,30,17
1683658516101,MATH 20C,B01,188404,Harel; Guershon,5,0,30,25
1683658516101,MATH 20C,B02,188405,Harel; Guershon,18,0,30,12
1683658517125,MATH 20D,A01,188414,Hammock; Frances H,0,1,30,30
1683658517125,MATH 20D,A02,188415,Hammock; Frances H,0,1,30,30
1683658517125,MATH 20D,B01,188447,Hammock; Frances H,0,1,30,30
1683658517125,MATH 20D,B02,188486,Hammock; Frances H,4,0,30,26
1683658518148,MATH 20E,A01,188649,Staff,21,0,30,9
1683658518148,MATH 20E,A02,188650,Staff,21,0,30,9
1683658518148,MATH 20E,A03,188673,Staff,0,0,30,30
1683658519171,MATH 102,A01,188675,Staff,0,36,35,35
1683658520195,MATH 103B,A01,188681,Staff,3,0,35,32
1683658520195,MATH 103B,B01,188692,Staff,5,0,35,30
1683658521221,MATH 109,A01,188695,Salehi Golsefidy; Alireza,24,0,35,11
1683658521221,MATH 109,A02,188696,Salehi Golsefidy; Alireza,25,0,35,10
1683658522249,MATH 120A,A01,188698,Eggers; John Dietrich,7,0,35,28
1683658523275,MATH 142B,A01,188736,Ioana; Adrian,0,1,30,30
1683658523275,MATH 142B,A02,188741,Ioana; Adrian,0,1,30,30
1683658523275,MATH 142B,A03,188743,Ioana; Adrian,0,1,30,30
1683658524303,MATH 168A,A01,188790,Staff,0,10,35,35
1683658525332,MATH 170A,A01,188803,Nie; Jiawang,0,2,35,35
1683658525332,MATH 170A,A02,188811,Nie; Jiawang,0,0,35,35
1683658525332,MATH 170A,A03,188814,Nie; Jiawang,0,0,35,35
1683658525332,MATH 170A,A04,188815,Nie; Jiawang,9,0,35,26
1683658526355,MATH 193B,A01,188817,Staff,0,0,35,35
1683658526355,MATH 193B,A02,188818,Staff,5,0,35,30
1683658527379,MGT 4,A01,202857,Anderson; John Charles,61,0,80,19
1683658528405,MGT 12,A00,202858,Lindenberger; Wade Douglas,40,0,90,50
1683658529431,MGT 18,A00,202859,Staff,74,0,90,16
1683658530457,MGT 18GS,A00,202860,McKay; Michael J,13,0,28,15
1683658531481,MGT 45,A00,202861,Pecore; Joseph P.,12,0,90,78
1683658532505,MGT 100,A00,202863,Yavorsky; Daniel Ryan,28,0,90,62
1683658533533,MGT 103,A00,202864,Ehrich; Kristine R,0,17,90,90
1683658534560,MGT 112,A00,202865,Ehrich; Kristine R,15,0,90,75
1683658535586,MGT 121A,A00,202868,Staff,90,20,90,0
1683658536611,MGT 131B,A00,202869,Anderson; John Charles,59,0,90,31
1683658537638,MGT 136,A00,202871,Lindenberger; Wade Douglas,83,0,90,7
1683658538665,MGT 164,A00,202873,Staff,0,67,90,91
1683658539688,MGT 164GS,A00,202874,McKay; Mary A,13,0,28,15
1683658540714,MGT 180,A00,202875,Staff,0,50,90,91
1683658541744,MMW 11R,A01,205019,Herbst; Matthew,1,0,30,29
1683658541744,MMW 11R,A02,205026,Herbst; Matthew,29,0,30,1
1683658542772,MMW 15,A01,193512,Chang; Edmond Yi-Teh,0,8,28,28
1683658542772,MMW 15,A02,193513,Chang; Edmond Yi-Teh,0,5,28,28
1683658542772,MMW 15,A03,193514,Chang; Edmond Yi-Teh,0,5,28,28
1683658542772,MMW 15,A04,193515,Chang; Edmond Yi-Teh,0,5,28,28
1683658542772,MMW 15,A05,193516,Chang; Edmond Yi-Teh,0,5,28,28
1683658542772,MMW 15,A06,193517,Chang; Edmond Yi-Teh,0,6,28,28
1683658542772,MMW 15,B01,193519,Chang; Edmond Yi-Teh,0,5,28,28
1683658542772,MMW 15,B02,193520,Chang; Edmond Yi-Teh,0,5,28,28
1683658542772,MMW 15,B03,193521,Chang; Edmond Yi-Teh,0,5,28,28
1683658542772,MMW 15,B04,193522,Chang; Edmond Yi-Teh,0,5,28,28
1683658542772,MMW 15,B05,193523,Chang; Edmond Yi-Teh,0,5,28,28
1683658542772,MMW 15,B06,193524,Chang; Edmond Yi-Teh,0,5,28,28
1683658543797,MMW 122,A01,193526,Rahimi; Babak,0,16,28,28
1683658543797,MMW 122,A02,193527,Rahimi; Babak,0,15,28,28
1683658543797,MMW 122,A03,193528,Rahimi; Babak,0,0,0,0
1683658543797,MMW 122,A04,193529,Rahimi; Babak,0,0,0,0
1683658544824,MUS 1A,A01,186663,Staff,1,20,35,34
1683658545850,MUS 4,A01,186715,Staff,0,12,35,35
1683658546874,MUS 5R,A01,186796,Dubnov; Shlomo,0,17,35,35
1683658547898,MUS 6,A01,186798,Staff,0,5,25,25
1683658548924,MUS 7,A01,186830,Staff,11,0,35,24
1683658549949,MUS 8,A01,186930,Staff,0,26,35,35
1683658550973,MUS 15,A01,186932,Staff,0,16,35,35
1683658550973,MUS 15,B01,186934,Staff,1,17,35,34
1683658551999,MUS 80,A00,186935,Staff,0,0,20,20
1683658551999,MUS 80,B00,186936,Staff,24,0,25,1
1683658553023,NANO 11,A00,204702,Lipomi; Darren John,0,0,0,0
1683658554050,NANO 15,A01,204709,Yang; Kesong,0,1,0,0
1683658555075,NANO 114,A00,202069,Jahed Motlagh; Zeinab,3,0,10,7
1683658556099,PHIL 1,A00,186955,Grush; Rick Scott,31,0,40,9
1683658557124,PHIL 10,A01,186973,Grush; Rick Scott,27,0,35,8
1683658557124,PHIL 10,A02,186974,Grush; Rick Scott,33,0,35,2
1683658558145,PHIL 13,A01,186976,Staff,3,0,35,32
1683658558145,PHIL 13,A02,186977,Staff,16,0,35,19
1683658559222,PHIL 14,A01,186979,Staff,31,0,35,4
1683658559222,PHIL 14,A02,186986,Staff,32,0,35,3
1683658560249,PHIL 28,A01,186988,Staff,16,0,30,14
1683658560249,PHIL 28,A02,186989,Staff,1,0,30,29
1683658560249,PHIL 28,A03,186990,Staff,10,0,30,20
1683658560249,PHIL 28,A04,186991,Staff,26,0,30,4
1683658561274,PHIL 120,A00,186997,Staff,23,0,40,17
1683658562300,PHIL 137,A00,187003,Staff,7,0,40,33
1683658563328,PHIL 150,A00,187015,Staff,47,0,70,23
1683658564357,PHIL 167,A00,187021,Lamey; Andy M.,34,0,40,6
1683658565384,PHIL 174,A01,202226,Staff,17,0,20,3
1683658565384,PHIL 174,A02,202235,Staff,20,0,20,0
1683658566407,PHIL 191A,A00,258918,Staff,0,0,1,1
1683658567433,PHYS 1A,A00,187028,Staff,26,0,60,34
1683658568457,PHYS 1AL,001,187036,Staff,3,0,30,27
1683658568457,PHYS 1AL,002,187049,Staff,18,0,30,12
1683658569484,PHYS 1B,A00,187058,Staff,22,0,60,38
1683658570511,PHYS 1BL,001,187064,Staff,0,1,30,30
1683658570511,PHYS 1BL,002,187070,Staff,4,0,30,26
1683658571535,PHYS 1C,A00,187082,Staff,29,0,120,91
1683658572565,PHYS 1CL,001,187088,Staff,0,9,30,30
1683658572565,PHYS 1CL,002,187089,Staff,0,1,30,30
1683658572565,PHYS 1CL,009,262693,Staff,9,0,30,21
1683658573590,PHYS 2B,A01,187097,Staff,55,0,115,60
1683658574613,PHYS 2C,A01,187099,Staff,63,0,115,52
1683658575640,PHYS 2CL,A01,187101,Staff,5,0,28,23
1683658575640,PHYS 2CL,A02,187102,Staff,15,0,28,13
1683658576666,PHYS 2D,A01,187123,Shotwell; Brian,95,0,115,20
1683658577690,PHYS 4B,A01,187133,Grinstein; Benjamin,35,0,50,15
1683658578713,POLI 10,A00,188819,Staff,0,4,50,50
1683658579737,POLI 11,A00,188827,Staff,43,0,50,7
1683658580760,POLI 13R,A00,188828,Staff,0,1,20,20
1683658581786,POLI 27,A01,188830,Elgin; Samuel Zincke,0,2,70,70
1683658582813,POLI 30,A00,188832,Desposato; Scott,30,0,50,20
1683658583839,POLI 102F,A00,188834,Staff,0,0,40,40
1683658584865,POLI 104A,A00,188852,Staff,13,0,30,17
1683658585891,POLI 104I,A00,188853,Staff,0,7,20,20
1683658586919,POLI 110B,A00,188854,Wiens; David,6,0,20,14
1683658587941,POLI 112A,A00,188855,Wiens; David,3,0,30,27
1683658588965,POLI 117R,A00,188856,Forman; Fonna,0,12,20,20
1683658589991,POLI 118,A00,188857,Ingham; Sean,8,0,20,12
1683658591017,POLI 120G,A00,188858,Staff,8,0,30,22
1683658592043,POLI 131CR,A00,188863,Hoston; Germaine,21,0,50,29
1683658593069,POLI 133,A00,188864,Nellis; Gareth Hb,44,0,50,6
1683658594092,POLI 134D,A00,188865,Desposato; Scott,27,0,30,3
1683658595119,POLI 142A,A00,188871,Gartzke; Erik,21,0,50,29
1683658596145,POLI 142K,A00,188874,Staff,38,0,50,12
1683658597168,POLI 143,A00,188940,Gartzke; Erik,16,0,30,14
1683658598192,POLI 153,A00,188943,Staff,2,0,20,18
1683658599219,POLI 160AA,A00,188944,Staff,11,0,40,29
1683658600243,POLI 170A,A00,188945,Staff,11,0,30,19
1683658602297,PSYC 1,A00,188952,Staff,36,0,90,54
1683658603324,PSYC 2,B00,188953,Staff,19,0,35,16
1683658604351,PSYC 6,A00,188970,Staff,47,0,60,13
1683658605374,PSYC 7,A00,188973,Staff,35,0,45,10
1683658606398,PSYC 60,A01,188980,Rickard; Timothy C.,42,0,60,18
1683658607424,PSYC 70,A01,189001,Steiner; Eric Tomas,22,0,45,23
1683658608452,PSYC 100,A00,189005,Lacefield; Katharine I,0,99,120,120
1683658609476,PSYC 102,A00,189008,Staff,8,0,30,22
1683658610506,PSYC 106,B00,189026,Gorman; Michael R.,27,0,60,33
1683658611531,PSYC 114,B01,189033,Winkielman; Piotr,0,31,30,30
1683658612556,PSYC 131,A00,189036,Anagnostaras; Stephan,0,43,60,60
1683658613584,PSYC 136,A00,189041,Lowe; Angela Beth,0,7,25,25
1683658614612,PSYC 137,A00,189057,Winkielman; Piotr,0,37,25,25
1683658615638,PSYC 144,A00,189107,Wixted; John T,0,11,50,50
1683658617689,PSYC 162,A00,189142,Staff,0,9,85,85
1683658618716,PSYC 172,A00,189144,Gorman; Michael R.,0,6,30,30
1683658620766,PSYC 179,A00,189146,Lacefield; Katharine I,0,87,120,120
1683658621793,PSYC 181,A00,189147,Anagnostaras; Stephan,0,44,90,90
1683658622822,PSYC 190R,A00,189148,Barner; David A.,0,23,80,80
1683658623851,PSYC 191,A00,189275,Rickard; Timothy C.,0,10,25,25
1683658624880,PSYC 193,A00,189276,Chapman; Eddie Nathaniel,0,1,0,4
1683658625907,PSYC 193L,A01,189281,Lowe; Angela Beth,10,0,20,10
1683658625907,PSYC 193L,B01,189285,Staff,28,0,35,7
1683658626932,RELI 149,A00,187137,Rahimi; Babak,7,0,40,33
1683658627959,SE 9,A01,187315,Staff,0,2,18,18
1683658628986,SE 101B,A00,187409,Staff,24,0,30,6
1683658630012,SE 110B,A00,187444,Staff,10,0,40,30
1683658631035,SE 130B,A00,187449,Staff,31,0,40,9
1683658632059,SE 150A,A00,187516,Staff,9,0,20,11
1683658633087,SE 154,A00,187528,Staff,29,0,50,21
1683658634114,SIO 3,A01,258171,Staff,35,0,40,5
1683658635138,SIO 10,A00,187144,Cook; Geoffrey W,0,6,75,75
1683658636161,SIO 45,A00,187152,Cook; Geoffrey W,0,4,100,100
1683658637188,SIO 109R,A00,194486,Staff,0,4,20,20
1683658639235,SIO 187,A01,187233,Kacev; David,12,0,40,28
1683658640260,SOCI 1,A01,258656,Thorpe; Charles Robert,28,0,30,2
1683658640260,SOCI 1,A02,258658,Thorpe; Charles Robert,30,0,30,0
1683658640260,SOCI 1,A03,258661,Thorpe; Charles Robert,25,0,25,0
1683658640260,SOCI 1,A04,258666,Thorpe; Charles Robert,22,0,25,3
1683658640260,SOCI 1,A05,258897,Thorpe; Charles Robert,22,0,25,3
1683658640260,SOCI 1,A06,258898,Thorpe; Charles Robert,25,0,25,0
1683658641285,SOCI 30,A01,258903,Pardo Guerra; Juan Pablo,14,0,30,16
1683658642313,SOCI 102,A00,258904,Staff,9,0,25,16
1683658643344,SOCI 106,A00,258905,Staff,19,0,25,6
1683658644371,SOCI 111,A00,258907,Ribas Norris; Janet Vanesa,26,0,30,4
1683658645400,SOCI 121R,A00,258908,Pardo Guerra; Juan Pablo,8,0,30,22
1683658646425,SOCI 126,A01,203330,Staff,14,0,20,6
1683658647449,SOCI 131,A00,258909,Thorpe; Charles Robert,30,0,60,30
1683658648477,SOCI 135,A00,258910,Payne; Christine Anna,0,11,30,30
1683658649501,SOCI 157,A00,258911,Staff,12,0,30,18
1683658650524,SOCI 184,A00,258912,Staff,25,0,30,5
1683658651550,SOCI 188D,A00,258913,Staff,22,0,30,8
1683658652575,SYN 2,001,187529,Staff,9,0,16,7
1683658652575,SYN 2,002,201452,Staff,0,20,16,16
1683658652575,SYN 2,003,201469,Staff,1,0,16,15
1683658653599,SYN 100,A01,187531,Staff,0,9,20,20
1683658653599,SYN 100,B01,201491,Staff,0,10,20,20
1683658654627,TDAC 1,A00,189286,Walsh; Kim C.,3,0,20,17
1683658654627,TDAC 1,B00,189287,Harting; Carla Kelso,10,0,20,10
1683658655652,TDAC 101,A00,189300,Walsh; Kim C.,16,0,20,4
1683658655652,TDAC 101,B00,189301,Harting; Carla Kelso,18,0,20,2
1683658656675,TDAC 102,A00,189304,Basso; Beatrice,14,0,20,6
1683658657699,TDAC 108,A00,189305,Staff,18,0,20,2
1683658658728,TDDE 131,A00,189310,Staff,19,0,20,1
1683658658728,TDDE 131,B00,189314,Staff,19,0,20,1
1683658658728,TDDE 131,C00,189315,Staff,48,0,50,2
1683658658728,TDDE 131,D00,189316,Staff,14,0,15,1
1683658658728,TDDE 131,E00,204841,Staff,20,0,20,0
1683658659758,TDGE 10,A00,189289,Staff,27,0,50,23
1683658659758,TDGE 10,B00,189290,Havis; Allan,0,0,50,50
1683658660783,TDGE 11,A00,189291,Fulton; Julia,0,4,50,50
1683658660783,TDGE 11,B00,189292,Staff,20,0,25,5
1683658660783,TDGE 11,C00,260270,Staff,0,0,0,0
1683658661813,TDGE 25,A00,189294,Staff,2,0,20,18
1683658662893,TDGE 124,A00,189318,Fulton; Julia,0,8,50,50
1683658663917,TDGE 125,A00,189319,Staff,13,0,25,12
1683658663917,TDGE 125,B00,189320,Staff,23,0,25,2
1683658664944,TDGE 127,A00,189322,Havis; Allan,0,0,50,50
1683658665971,TDHT 101,A00,189323,Staff,18,0,25,7
1683658665971,TDHT 101,B00,189324,Staff,25,0,25,0
1683658666999,TDHT 102,A00,189325,Staff,49,0,50,1
1683658668025,TDMV 1,A00,189295,Arcidiacono; Kristin,20,0,30,10
1683658668025,TDMV 1,B00,189296,Caligagan; Maria T.,24,0,30,6
1683658669050,TDMV 2,A00,189297,Sammartano; Tonnie,27,0,30,3
1683658669050,TDMV 2,B00,189299,Arcidiacono; Kristin,23,0,30,7
1683658670074,TDMV 3,A00,204998,Rincon; Alicia,22,0,30,8
1683658671102,TDMV 120,A00,189458,Sammartano; Tonnie,28,0,30,2
1683658672130,TDMV 138,A00,189541,Jun; Grace Shin Hae,20,0,40,20
1683658673158,TDMV 142,A00,189717,Caligagan; Tony,25,0,30,5
1683658673158,TDMV 142,B00,189718,Caligagan; Maria T.,25,0,30,5
1683658674186,TMC 2,A01,187533,Staff,25,0,25,0
1683658674186,TMC 2,A02,187534,Staff,25,0,25,0
1683658675209,USP 1,A01,187536,Kwak; Nancy,0,16,25,25
1683658676233,USP 5,A01,187538,Staff,9,0,25,16
1683658677259,USP 101,A00,199253,Staff,0,4,0,0
1683658678285,USP 124,A00,187562,Boomhower; Matthew Charles,0,0,30,30
1683658679309,USP 138,A00,187582,Staff,20,0,25,5
1683658680334,USP 152,A01,187597,Staff,3,0,25,22
1683658681361,USP 153,A00,187598,Staff,19,0,25,6
1683658682385,USP 168,A00,187607,Kwak; Nancy,2,0,5,3
1683658683409,USP 173,A00,187619,Staff,4,0,25,21
1683658684434,USP 181,A00,187638,Staff,0,4,25,25
1683658685461,VIS 103,A00,187650,Cruz; Edwin Teddy,18,0,75,57
1683658686486,VIS 110D,A00,187669,Staff,13,0,22,9
1683658687510,VIS 127C,A00,187720,Shen; Kuiyi,67,0,146,79
1683658688532,VIS 149,A00,187731,Yoldas; Pinar,0,14,22,22
1683658689560,VIS 151,A01,188091,Staff,22,0,34,12
1683658689560,VIS 151,A02,188092,Staff,11,0,34,23
1683658690584,VIS 160B,A00,188093,Stalbaum; Brett,0,1,10,10
1683658692637,WCWP 10B,A00,201720,Staff,10,0,15,5
1683658692637,WCWP 10B,B00,201722,Staff,9,0,15,6
1683658693665,WCWP 100,A00,201725,Gagnon; Jeffrey C,0,0,2,2
1683658693665,WCWP 100,B00,201727,Staff,0,4,15,15
1683658696752,ANBI 133,A00,258401,Wilder; Linnea Lorene,34,0,40,6
1683658697777,ANBI 140,A00,258395,Hrvoj Mihic; Branka,18,0,25,7
1683658698800,ANSC 120,A00,258402,Bialecki; Jon Anthony,26,0,40,14
1683658699824,ANSC 144,A00,258400,Staff,12,0,40,28
1683658701876,ANSC 166,A00,258396,Parish; Steven Martin,156,0,175,19
1683658702903,ANSC 180,A00,193533,Staff,8,0,20,12
1683658703929,ANSC 188,A00,258397,Jassal; Aftab,34,0,40,6
1683658704954,ANTH 3,A01,258316,Staff,23,0,30,7
1683658705979,ANTH 5,A00,258394,Semendeferi; Ekaterini,16,0,20,4
1683658707004,ANTH 21,A01,258331,Staff,4,0,40,36
1683658708031,ANTH 103,A00,258398,Varma; Saiba,15,0,25,10
1683658709065,AWP 10,001,202034,Staff,0,0,0,0
1683658709065,AWP 10,002,202035,Staff,0,0,0,0
1683658709065,AWP 10,003,202036,Staff,0,0,0,0
1683658709065,AWP 10,004,202037,Staff,0,0,0,0
1683658709065,AWP 10,005,202038,Staff,0,0,0,0
1683658709065,AWP 10,006,202039,Staff,0,0,0,0
1683658709065,AWP 10,007,202040,Staff,0,0,0,0
1683658709065,AWP 10,008,202041,Staff,0,0,0,0
1683658709065,AWP 10,009,202042,Staff,0,0,0,0
1683658709065,AWP 10,010,202043,Staff,0,0,0,0
1683658709065,AWP 10,011,202044,Staff,0,0,0,0
1683658709065,AWP 10,012,202045,Staff,0,0,0,0
1683658709065,AWP 10,013,202046,Staff,0,0,0,0
1683658709065,AWP 10,014,202047,Staff,0,0,0,0
1683658709065,AWP 10,015,202048,Staff,0,0,0,0
1683658709065,AWP 10,016,202049,Staff,0,0,0,0
1683658709065,AWP 10,017,202050,Staff,0,0,0,0
1683658709065,AWP 10,018,202051,Staff,0,0,0,0
1683658709065,AWP 10,019,202052,Staff,0,0,0,0
1683658709065,AWP 10,020,202053,Staff,0,0,0,0
1683658709065,AWP 10,021,202054,Staff,0,0,0,0
1683658709065,AWP 10,022,202055,Staff,0,0,0,0
1683658709065,AWP 10,023,202056,Staff,0,0,0,0
1683658709065,AWP 10,024,202057,Staff,0,0,0,0
1683658709065,AWP 10,025,202058,Staff,0,0,0,0
1683658709065,AWP 10,026,202059,Staff,0,0,0,0
1683658710090,AWP 102,001,202032,Staff,0,0,0,0
1683658710090,AWP 102,002,202033,Staff,0,0,0,0
1683658711114,BENG 100,A01,254234,Taylor Amos; Alyssa C,31,0,40,9
1683658712138,BENG 196,001,270013,Engler; Adam J.,9999,0,9999,0
1683658713169,BICD 100R,A01,202018,Smith; Laurie,0,7,32,32
1683658713169,BICD 100R,A02,202019,Smith; Laurie,0,3,32,32
1683658713169,BICD 100R,A03,202020,Smith; Laurie,0,1,32,32
1683658713169,BICD 100R,A04,202021,Smith; Laurie,6,0,32,26
1683658713169,BICD 100R,A05,202022,Smith; Laurie,11,0,32,21
1683658714194,BICD 136,A01,193242,Gustafson-Brown; Cindy,0,2,32,32
1683658714194,BICD 136,A02,193244,Gustafson-Brown; Cindy,13,0,32,19
1683658715218,BIEB 102,A01,193249,Butler; Shannon Rhey,1,2,32,31
1683658715218,BIEB 102,A02,193251,Butler; Shannon Rhey,0,0,32,32
1683658715218,BIEB 102,A03,193253,Butler; Shannon Rhey,0,0,32,32
1683658715218,BIEB 102,A04,193255,Butler; Shannon Rhey,14,0,32,18
1683658715218,BIEB 102,A05,193265,Butler; Shannon Rhey,26,0,32,6
1683658715218,BIEB 102,A06,193269,Butler; Shannon Rhey,14,0,32,18
1683658717266,BIEB 150,A01,193274,Staff,0,0,32,32
1683658717266,BIEB 150,A02,193285,Staff,24,0,32,8
1683658718291,BIEB 194,A00,193286,Kurle; Carolyn M.,20,0,32,12
1683658719320,BILD 1,A01,192291,Staff,15,0,32,17
1683658719320,BILD 1,A02,192292,Staff,30,0,32,2
1683658719320,BILD 1,B01,192520,Reuther; Keefe,0,1,0,0
1683658719320,BILD 1,B02,192532,Reuther; Keefe,0,1,0,0
1683658720349,BILD 3,A01,192556,Butler; Shannon Rhey,0,0,32,32
1683658720349,BILD 3,A02,192581,Butler; Shannon Rhey,1,0,32,31
1683658720349,BILD 3,A03,192611,Butler; Shannon Rhey,21,0,32,11
1683658720349,BILD 3,A04,192612,Butler; Shannon Rhey,24,0,32,8
1683658720349,BILD 3,A05,192613,Butler; Shannon Rhey,26,0,32,6
1683658720349,BILD 3,A06,192679,Butler; Shannon Rhey,27,0,32,5
1683658720349,BILD 3,A07,192682,Butler; Shannon Rhey,20,0,32,12
1683658721375,BILD 4,A01,192836,Reuther; Keefe,1,0,24,23
1683658721375,BILD 4,A02,193044,Reuther; Keefe,4,0,24,20
1683658722404,BILD 10,A01,193142,Gustafson-Brown; Cindy,29,0,32,3
1683658722404,BILD 10,A02,193149,Gustafson-Brown; Cindy,31,0,32,1
1683658723431,BIMM 100,A01,193301,Staff,0,6,32,32
1683658723431,BIMM 100,A02,193312,Staff,0,7,32,32
1683658723431,BIMM 100,A03,193323,Staff,0,9,32,32
1683658724457,BIMM 101,A01,193329,McDonnell; Lisa Marie,0,4,24,24
1683658724457,BIMM 101,A02,193339,McDonnell; Lisa Marie,1,3,24,23
1683658724457,BIMM 101,B01,193354,McDonnell; Lisa Marie,0,4,24,24
1683658724457,BIMM 101,B02,193357,McDonnell; Lisa Marie,0,3,24,24
1683658725484,BIMM 110,A01,193377,Tat; John,0,11,32,32
1683658725484,BIMM 110,A02,193378,Tat; John,0,10,32,32
1683658726509,BIMM 120,A01,206116,Staff,0,0,32,32
1683658726509,BIMM 120,A02,206117,Staff,6,0,32,26
1683658726509,BIMM 120,A03,206121,Staff,21,0,32,11
1683658727534,BIPN 100,A01,193393,Park; Ji Young,0,15,32,32
1683658727534,BIPN 100,A02,193402,Park; Ji Young,0,14,32,32
1683658727534,BIPN 100,A03,193413,Park; Ji Young,0,14,32,32
1683658727534,BIPN 100,A04,193414,Park; Ji Young,0,13,32,32
1683658728562,BIPN 102,A01,193429,Staff,0,0,32,32
1683658728562,BIPN 102,A02,193438,Staff,18,0,32,14
1683658729586,BIPN 106,A01,193450,Reyes Gonzalez; Catalina,0,2,40,40
1683658730616,BIPN 134,A01,193465,Cooke; James Edward,0,0,32,32
1683658730616,BIPN 134,A02,193474,Cooke; James Edward,25,0,32,7
1683658730616,BIPN 134,A03,193485,Cooke; James Edward,29,0,32,3
1683658730616,BIPN 134,A04,193486,Cooke; James Edward,20,0,32,12
1683658730616,BIPN 134,A05,193491,Cooke; James Edward,31,0,32,1
1683658730616,BIPN 134,A06,193501,Cooke; James Edward,30,0,32,2
1683658730616,BIPN 134,A07,193510,Cooke; James Edward,29,0,32,3
1683658732669,BISP 194,A00,222522,Staff,14,0,32,18
1683658733697,CAT 124,A01,202407,Staff,19,0,25,6
1683658734724,CAT 125,A00,202408,Marchisotto; Jennifer Anne,2,0,20,18
1683658735750,CAT 125R,A00,202409,Smith; Lauryn Alissa,0,11,20,20
1683658735750,CAT 125R,B00,202410,Morales; Celeste Georgianna,0,11,20,20
1683658735750,CAT 125R,C00,202411,Irwin; Matthew Joseph,0,12,20,20
1683658736777,CENG 15,A01,204712,Yang; Kesong,0,1,0,0
1683658737802,CENG 114,A00,202070,Jahed Motlagh; Zeinab,5,0,20,15
1683658738827,CGS 105,A00,185477,Wesling; Megan E.,24,0,40,16
1683658739851,CGS 106,A00,185494,Staff,11,0,22,11
1683658740875,CGS 108,A00,185495,Staff,14,0,20,6
1683658741899,CGS 114,A00,185496,Staff,13,0,18,5
1683658742926,CGS 119,A00,185501,Staff,15,0,20,5
1683658743951,CGS 120,A00,185511,Staff,12,0,20,8
1683658744980,CHEM 4,A01,184675,Bussey; Thomas J,97,0,100,3
1683658746007,CHEM 6A,A01,184677,Staff,32,0,60,28
1683658747039,CHEM 6B,A01,184679,Staff,63,0,100,37
1683658748064,CHEM 6C,A01,184681,Bussey; Thomas J,0,0,50,50
1683658748064,CHEM 6C,A02,184682,Bussey; Thomas J,32,0,50,18
1683658749088,CHEM 40A,A01,184684,Albizati; Kim F.,34,0,100,66
1683658750112,CHEM 40B,A01,184686,Albizati; Kim F.,0,22,100,100
1683658751139,CHEM 41B,A01,184690,Staff,51,0,100,49
1683658752167,COGS 3,A01,184715,Boyle; Mary E. T.,0,27,40,40
1683658753190,COGS 14B,A01,185172,Staff,0,14,38,38
1683658754218,COGS 18,A01,184736,Staff,14,0,80,66
1683658755242,COGS 100,A01,184932,Staff,0,7,73,73
1683658756267,COGS 101A,A01,184935,Staff,0,39,30,30
1683658757291,COGS 101B,A01,184944,Staff,0,2,30,30
1683658758320,COGS 101C,A01,184946,Staff,0,10,30,30
1683658759346,COGS 102A,A01,184951,Johnson; Christine M.,2,0,40,38
1683658760370,COGS 107B,A01,184953,Mooshagian; Eric Frederick,0,51,40,40
1683658761394,COGS 118B,A01,184959,Gupta; Anjum,0,49,40,40
1683658762420,COGS 153,A00,184961,Staff,0,16,30,30
1683658763445,COGS 177,A00,184962,Staff,0,21,30,30
1683658764473,COGS 187A,A01,184969,Boyle; Mary E. T.,0,19,40,40
1683658765497,COMM 10,A01,185174,Staff,0,5,25,25
1683658765497,COMM 10,A02,185189,Staff,0,2,25,25
1683658765497,COMM 10,A03,269821,Staff,0,1,0,0
1683658766577,COMM 100B,A01,185475,Staff,0,1,0,2
1683658766577,COMM 100B,A02,185476,Staff,12,0,25,13
1683658767603,COMM 100C,A01,185314,Staff,1,0,25,24
1683658767603,COMM 100C,A02,185327,Staff,18,0,25,7
1683658768631,COMM 110M,A00,185349,Staff,0,0,40,40
1683658769658,COMM 113T,A00,185352,Staff,25,0,40,15
1683658770682,COMM 114I,A00,185353,Staff,31,0,40,9
1683658771709,COMM 131,A00,185354,Staff,17,0,30,13
1683658772736,CSE 8A,A50,185358,Cao; Yingjun,0,46,10,10
1683658773760,CSE 8B,A01,185362,Staff,0,48,50,50
1683658774785,CSE 11,A01,185416,Cao; Yingjun,0,91,10,10
1683658775808,CSE 20,A01,185445,Briones; Jor-el Thomas Caparas,4,0,25,21
1683658776833,CSE 21,A01,185447,Staff,9,0,50,41
1683658777866,CSE 101,A01,185451,Staff,0,13,50,50
1683658777866,CSE 101,B01,185453,Jones; Miles E,0,13,50,50
1683658779916,CSE 141,A01,185458,Eldon; John,16,0,100,84
1683658780941,CSE 141L,A01,185461,Eldon; John,8,0,100,92
1683658781965,CSE 142,A01,185463,Staff,34,0,60,26
1683658781965,CSE 142,B01,201355,Staff,0,7,60,60
1683658782993,CSE 142L,A01,185470,Staff,34,0,60,26
1683658782993,CSE 142L,B01,201417,Staff,0,6,60,60
1683658784022,CSE 190,A00,201433,Staff,32,0,49,17
1683658785047,DOC 1,A01,259136,Strom; Megan C.,7,0,15,8
1683658785047,DOC 1,A02,259137,Strom; Megan C.,14,0,15,1
1683658785047,DOC 1,A03,259138,Strom; Megan C.,14,0,15,1
1683658785047,DOC 1,A04,259139,Strom; Megan C.,14,0,15,1
1683658786070,DOC 100D,A00,259140,Pass; Natalye Joann,14,0,25,11
1683658787095,DSGN 1,A01,184749,Rill; Bryan,0,26,30,30
1683658788122,DSGN 100,A01,185168,Staff,0,2,25,25
1683658789146,ECE 5,A01,185626,Morris; Karcher William,0,11,0,0
1683658790170,ECE 101,A01,185628,Staff,14,0,70,56
1683658791193,ECE 107,A01,185635,Baghdadchi; Saharnaz,0,0,20,20
1683658791193,ECE 107,A02,185638,Baghdadchi; Saharnaz,2,0,20,18
1683658792217,ECE 148,A01,185647,Silberman; Jack,0,0,16,16
1683658793242,ECON 1,A01,185537,Crane; Meredith Helen,54,0,70,16
1683658794271,ECON 3,A01,185549,Crane; Meredith Helen,29,0,70,41
1683658795297,ECON 4,A01,203354,Anderson; John Charles,0,5,10,10
1683658796322,ECON 100A,A01,185574,Staff,0,5,40,40
1683658797345,ECON 100B,A01,185576,Staff,0,12,50,50
1683658798372,ECON 100C,A01,185589,Newhouse; Herbert S,30,0,70,40
1683658799399,ECON 105,A00,185608,Vespa; Emanuel Ignacio,19,0,35,16
1683658800426,ECON 109,A01,185610,Shishkin; Denis,9,0,35,26
1683658801450,ECON 110A,A01,185612,Staff,9,0,40,31
1683658802475,ECON 120A,A01,185615,Staff,20,0,40,20
1683658803499,ECON 120C,A01,185617,Sun; Yixiao,0,20,70,70
1683658804522,ECON 144,A00,203346,Squires; Dale E,2,0,35,33
1683658805547,ECON 171,A01,203349,Newhouse; Herbert S,0,1,35,35
1683658806570,ECON 173A,A01,185621,Toda; Alexis Akira,20,0,35,15
1683658807596,EDS 25,A01,202413,Staff,0,1,0,0
1683658807596,EDS 25,A02,202414,Staff,0,1,0,0
1683658807596,EDS 25,A03,202415,Staff,0,0,0,0
1683658807596,EDS 25,A04,202416,Staff,0,1,0,0
1683658807596,EDS 25,A05,202439,Staff,0,0,0,0
1683658807596,EDS 25,A06,202440,Staff,0,0,0,0
1683658807596,EDS 25,B01,202631,Staff,0,0,0,0
1683658807596,EDS 25,B02,202632,Staff,0,0,0,0
1683658807596,EDS 25,B03,202639,Staff,0,0,0,0
1683658807596,EDS 25,B04,202640,Staff,0,0,0,0
1683658807596,EDS 25,B05,202643,Staff,0,0,0,0
1683658807596,EDS 25,B06,202644,Staff,0,0,0,0
1683658808621,EDS 38,A01,202659,Black; Alison Michelle,24,0,25,1
1683658809647,EDS 115,A00,202652,Staff,18,0,30,12
1683658810673,EDS 125,A00,202649,Staff,13,0,30,17
1683658811700,EDS 126,A01,203332,Staff,30,0,30,0
1683658812724,EDS 139,A00,202838,Staff,16,0,25,9
1683658813751,EDS 146,A01,202655,Staff,14,0,25,11
1683658814776,ENG 15,A00,185667,Staff,0,1,0,0
1683658814776,ENG 15,B00,185672,Staff,0,0,0,0
1683658814776,ENG 15,C00,185675,Staff,0,0,0,0
1683658814776,ENG 15,D00,185682,Staff,0,0,0,0
1683658814776,ENG 15,E00,185684,Staff,0,0,0,0
1683658815803,ETHN 103,A00,185710,Staff,0,8,35,35
1683658816831,ETHN 103A,A00,199228,Man; Simeon S,0,0,9,9
1683658817858,ETHN 109,A00,185711,Staff,16,0,35,19
1683658818885,ETHN 142,A00,185726,Staff,0,4,30,30
1683658819909,ETHN 163J,A00,199229,Man; Simeon S,5,0,8,3
1683658820938,ETHN 168,A00,185727,Staff,7,0,10,3
1683658821966,ETHN 182,A00,185728,Staff,0,0,35,35
1683658822989,ETHN 183,A00,185737,Staff,9,0,18,9
1683658824014,GLBH 111,A01,209361,Burgos; Jose L.,0,0,0,0
1683658826065,HIEU 104,A00,185792,Staff,14,0,20,6
1683658827089,HIEU 115,A00,185800,Staff,0,0,20,20
1683658828111,HIEU 128,A00,185801,Staff,0,9,20,20
1683658829135,HIEU 147,A00,185802,Staff,15,0,20,5
1683658830159,HIEU 154,A00,185823,Staff,11,0,20,9
1683658831181,HILA 102,A00,185826,Staff,14,0,20,6
1683658832205,HILD 2C,A01,185778,Staff,0,13,20,20
1683658833231,HILD 7B,A01,185780,Kwak; Nancy,0,17,32,32
1683658833231,HILD 7B,A02,185781,Kwak; Nancy,0,18,32,32
1683658834255,HILD 30,A01,185791,Staff,12,0,20,8
1683658835282,HISC 119,A00,185830,Golan; Tal,0,9,20,20
1683658836306,HITO 156GS,A00,185831,Patterson; Patrick H.,0,0,0,23
1683658837334,HIUS 103,A00,185832,Man; Simeon S,0,4,20,20
1683658838356,HIUS 117,A00,185836,Kwak; Nancy,2,0,20,18
1683658839380,HIUS 125,A00,185840,Man; Simeon S,0,2,23,23
1683658840403,HIUS 149,A00,185845,Staff,1,0,20,19
1683658841429,HUM 3,A01,185882,Zavodny; Tatiana Sophia,0,8,50,50
1683658841429,HUM 3,B01,185899,Caldwell; Michael Alan,0,18,50,50
1683658842453,HUM 3GS,A00,185900,Patterson; Patrick H.,0,0,0,23
1683658843483,HUM 4,A01,185938,Zroka; Amy Liane,29,0,50,21
1683658843483,HUM 4,B01,185956,Watkins; Eric,0,4,50,50
1683658843483,HUM 4,B02,202209,Watkins; Eric,0,5,50,50
1683658843483,HUM 4,B03,202210,Watkins; Eric,0,5,50,50
1683658844512,HUM 5,A01,185958,West; Geoffrey Scott,1,0,50,49
1683658844512,HUM 5,A02,202215,West; Geoffrey Scott,0,0,50,50
1683658845536,INTL 190,A00,185959,Gagnon; Jeffrey C,0,0,0,9
1683658845536,INTL 190,B00,185960,Lettieri; Michael Joseph,0,0,0,2
1683658846560,JAPN 180,A00,254509,Staff,5,0,30,25
1683658847585,LATI 10,A01,202853,Kennemore; Amy Michelle,4,0,35,31
1683658847585,LATI 10,A02,202854,Kennemore; Amy Michelle,2,0,35,33
1683658847585,LATI 10,A03,270054,Kennemore; Amy Michelle,30,0,30,0
1683658848608,LATI 180,A00,202855,Kennemore; Amy Michelle,11,0,20,9
1683658849630,LAWS 101,A00,201767,Golan; Tal,0,7,40,40
1683658850656,LIFR 1C,A00,185961,Staff,6,0,20,14
1683658851681,LIFR 1CX,A00,185962,Staff,7,0,20,13
1683658852710,LIFR 1D,A00,185963,Staff,7,0,20,13
1683658853734,LIFR 1DX,A00,185964,Staff,7,0,20,13
1683658854761,LIGN 101,A01,186039,Staff,43,0,50,7
1683658855785,LIGN 165,A00,186040,Staff,15,0,50,35
1683658856809,LTCS 108,A00,186041,Staff,5,0,10,5
1683658857833,LTCS 119,A00,186042,Staff,15,0,20,5
1683658858860,LTCS 130,A00,186043,Wesling; Megan E.,15,0,25,10
1683658860912,LTEA 138,A00,186119,Staff,14,0,40,26
1683658861939,LTEN 124,A00,186148,Staff,5,0,25,20
1683658862964,LTEN 178,A00,186149,Staff,7,0,15,8
1683658863991,LTEN 181,A00,186150,Blanco; John D,34,0,40,6
1683658865017,LTWL 120,A00,186160,Staff,20,0,25,5
1683658866042,LTWL 165,A00,186161,Staff,22,0,25,3
1683658867068,LTWR 100,A00,186162,Staff,0,5,15,15
1683658868096,LTWR 102,A00,186163,Doller; Ben,5,0,15,10
1683658869124,MAE 8,A01,186412,Staff,0,0,0,0
1683658870228,MAE 30B,A00,186445,Bahadori; Mohammad Yousef,82,0,100,18
1683658871255,MAE 40,A00,186592,Bewley; Thomas R,10,0,50,40
1683658872283,MAE 101B,A00,186593,Bahadori; Mohammad Yousef,80,0,100,20
1683658873312,MAE 105,A00,186594,Bandaru; Prabhakar,10,0,50,40
1683658874336,MAE 107,A00,186599,Pham; Hieu Tan,0,7,120,120
1683658875361,MAE 148,A01,186660,Silberman; Jack,3,0,16,13
1683658876385,MATH 10A,A01,188095,Staff,0,6,35,35
1683658877413,MATH 10B,A01,188097,Bowers; Adam R.,0,12,30,30
1683658877413,MATH 10B,A02,188099,Bowers; Adam R.,0,11,30,30
1683658877413,MATH 10B,B01,188104,Bowers; Adam R.,0,10,30,30
1683658877413,MATH 10B,B02,188106,Bowers; Adam R.,1,9,30,29
1683658878442,MATH 10C,A01,188111,Staff,0,18,30,30
1683658878442,MATH 10C,A02,188127,Staff,0,19,30,30
1683658878442,MATH 10C,A03,188131,Staff,0,19,30,30
1683658878442,MATH 10C,B01,188218,Staff,17,0,30,13
1683658878442,MATH 10C,B02,188244,Staff,13,0,30,17
1683658878442,MATH 10C,B03,188277,Staff,14,0,30,16
1683658879471,MATH 18,A01,188344,Bach; Quang Tran,18,0,30,12
1683658879471,MATH 18,A02,188345,Bach; Quang Tran,11,0,30,19
1683658879471,MATH 18,B01,188353,Bach; Quang Tran,11,0,30,19
1683658879471,MATH 18,B02,188354,Bach; Quang Tran,19,0,30,11
1683658880498,MATH 20A,A01,188374,Staff,11,0,35,24
1683658881531,MATH 20B,A01,188382,Ohm; Ko Woon,7,0,30,23
1683658881531,MATH 20B,A02,188383,Ohm; Ko Woon,22,0,30,8
1683658881531,MATH 20B,B01,188385,Ohm; Ko Woon,7,0,30,23
1683658881531,MATH 20B,B02,188392,Ohm; Ko Woon,22,0,30,8
1683658882556,MATH 20C,A01,188394,Harel; Guershon,10,0,30,20
1683658882556,MATH 20C,A02,188395,Harel; Guershon,13,0,30,17
1683658882556,MATH 20C,B01,188404,Harel; Guershon,5,0,30,25
1683658882556,MATH 20C,B02,188405,Harel; Guershon,18,0,30,12
1683658883581,MATH 20D,A01,188414,Hammock; Frances H,0,1,30,30
1683658883581,MATH 20D,A02,188415,Hammock; Frances H,0,1,30,30
1683658883581,MATH 20D,B01,188447,Hammock; Frances H,0,1,30,30
1683658883581,MATH 20D,B02,188486,Hammock; Frances H,4,0,30,26
1683658884608,MATH 20E,A01,188649,Staff,21,0,30,9
1683658884608,MATH 20E,A02,188650,Staff,21,0,30,9
1683658884608,MATH 20E,A03,188673,Staff,0,0,30,30
1683658885634,MATH 102,A01,188675,Staff,0,36,35,35
1683658886659,MATH 103B,A01,188681,Staff,3,0,35,32
1683658886659,MATH 103B,B01,188692,Staff,5,0,35,30
1683658887685,MATH 109,A01,188695,Salehi Golsefidy; Alireza,24,0,35,11
1683658887685,MATH 109,A02,188696,Salehi Golsefidy; Alireza,25,0,35,10
1683658888816,MATH 120A,A01,188698,Eggers; John Dietrich,7,0,35,28
1683658889845,MATH 142B,A01,188736,Ioana; Adrian,0,1,30,30
1683658889845,MATH 142B,A02,188741,Ioana; Adrian,0,1,30,30
1683658889845,MATH 142B,A03,188743,Ioana; Adrian,0,1,30,30
1683658890870,MATH 168A,A01,188790,Staff,0,10,35,35
1683658891898,MATH 170A,A01,188803,Nie; Jiawang,0,2,35,35
1683658891898,MATH 170A,A02,188811,Nie; Jiawang,0,0,35,35
1683658891898,MATH 170A,A03,188814,Nie; Jiawang,0,0,35,35
1683658891898,MATH 170A,A04,188815,Nie; Jiawang,9,0,35,26
1683658892925,MATH 193B,A01,188817,Staff,0,0,35,35
1683658892925,MATH 193B,A02,188818,Staff,5,0,35,30
1683658893950,MGT 4,A01,202857,Anderson; John Charles,61,0,80,19
1683658894974,MGT 12,A00,202858,Lindenberger; Wade Douglas,40,0,90,50
1683658896003,MGT 18,A00,202859,Staff,74,0,90,16
1683658897029,MGT 18GS,A00,202860,McKay; Michael J,13,0,28,15
1683658898053,MGT 45,A00,202861,Pecore; Joseph P.,12,0,90,78
1683658899081,MGT 100,A00,202863,Yavorsky; Daniel Ryan,28,0,90,62
1683658900113,MGT 103,A00,202864,Ehrich; Kristine R,0,17,90,90
1683658901137,MGT 112,A00,202865,Ehrich; Kristine R,14,0,90,76
1683658902162,MGT 121A,A00,202868,Staff,90,20,90,0
1683658903185,MGT 131B,A00,202869,Anderson; John Charles,59,0,90,31
1683658904209,MGT 136,A00,202871,Lindenberger; Wade Douglas,83,0,90,7
1683658905233,MGT 164,A00,202873,Staff,0,67,90,91
1683658906258,MGT 164GS,A00,202874,McKay; Mary A,13,0,28,15
1683658907282,MGT 180,A00,202875,Staff,0,50,90,91
1683658908306,MMW 11R,A01,205019,Herbst; Matthew,1,0,30,29
1683658908306,MMW 11R,A02,205026,Herbst; Matthew,29,0,30,1
1683658909339,MMW 15,A01,193512,Chang; Edmond Yi-Teh,0,8,28,28
1683658909339,MMW 15,A02,193513,Chang; Edmond Yi-Teh,0,5,28,28
1683658909339,MMW 15,A03,193514,Chang; Edmond Yi-Teh,0,5,28,28
1683658909339,MMW 15,A04,193515,Chang; Edmond Yi-Teh,0,5,28,28
1683658909339,MMW 15,A05,193516,Chang; Edmond Yi-Teh,0,5,28,28
1683658909339,MMW 15,A06,193517,Chang; Edmond Yi-Teh,0,6,28,28
1683658909339,MMW 15,B01,193519,Chang; Edmond Yi-Teh,0,5,28,28
1683658909339,MMW 15,B02,193520,Chang; Edmond Yi-Teh,0,5,28,28
1683658909339,MMW 15,B03,193521,Chang; Edmond Yi-Teh,0,5,28,28
1683658909339,MMW 15,B04,193522,Chang; Edmond Yi-Teh,0,5,28,28
1683658909339,MMW 15,B05,193523,Chang; Edmond Yi-Teh,0,5,28,28
1683658909339,MMW 15,B06,193524,Chang; Edmond Yi-Teh,0,5,28,28
1683658910364,MMW 122,A01,193526,Rahimi; Babak,0,16,28,28
1683658910364,MMW 122,A02,193527,Rahimi; Babak,0,15,28,28
1683658910364,MMW 122,A03,193528,Rahimi; Babak,0,0,0,0
1683658910364,MMW 122,A04,193529,Rahimi; Babak,0,0,0,0
1683658911388,MUS 1A,A01,186663,Staff,1,20,35,34
1683658912411,MUS 4,A01,186715,Staff,0,12,35,35
1683658913438,MUS 5R,A01,186796,Dubnov; Shlomo,0,17,35,35
1683658914461,MUS 6,A01,186798,Staff,0,5,25,25
1683658915487,MUS 7,A01,186830,Staff,11,0,35,24
1683658916512,MUS 8,A01,186930,Staff,0,26,35,35
1683658917542,MUS 15,A01,186932,Staff,0,16,35,35
1683658917542,MUS 15,B01,186934,Staff,1,17,35,34
1683658918566,MUS 80,A00,186935,Staff,0,0,20,20
1683658918566,MUS 80,B00,186936,Staff,24,0,25,1
1683658919590,NANO 11,A00,204702,Lipomi; Darren John,0,0,0,0
1683658920614,NANO 15,A01,204709,Yang; Kesong,0,1,0,0
1683658921645,NANO 114,A00,202069,Jahed Motlagh; Zeinab,3,0,10,7
1683658922672,PHIL 1,A00,186955,Grush; Rick Scott,31,0,40,9
1683658923698,PHIL 10,A01,186973,Grush; Rick Scott,27,0,35,8
1683658923698,PHIL 10,A02,186974,Grush; Rick Scott,33,0,35,2
1683658924722,PHIL 13,A01,186976,Staff,3,0,35,32
1683658924722,PHIL 13,A02,186977,Staff,16,0,35,19
1683658925746,PHIL 14,A01,186979,Staff,31,0,35,4
1683658925746,PHIL 14,A02,186986,Staff,32,0,35,3
1683658926772,PHIL 28,A01,186988,Staff,16,0,30,14
1683658926772,PHIL 28,A02,186989,Staff,1,0,30,29
1683658926772,PHIL 28,A03,186990,Staff,10,0,30,20
1683658926772,PHIL 28,A04,186991,Staff,26,0,30,4
1683658927795,PHIL 120,A00,186997,Staff,23,0,40,17
1683658928823,PHIL 137,A00,187003,Staff,7,0,40,33
1683658929847,PHIL 150,A00,187015,Staff,47,0,70,23
1683658930871,PHIL 167,A00,187021,Lamey; Andy M.,34,0,40,6
1683658931895,PHIL 174,A01,202226,Staff,17,0,20,3
1683658931895,PHIL 174,A02,202235,Staff,20,0,20,0
1683658932921,PHIL 191A,A00,258918,Staff,0,0,1,1
1683658933950,PHYS 1A,A00,187028,Staff,26,0,60,34
1683658934977,PHYS 1AL,001,187036,Staff,3,0,30,27
1683658934977,PHYS 1AL,002,187049,Staff,18,0,30,12
1683658936004,PHYS 1B,A00,187058,Staff,22,0,60,38
1683658937033,PHYS 1BL,001,187064,Staff,0,1,30,30
1683658937033,PHYS 1BL,002,187070,Staff,4,0,30,26
1683658938060,PHYS 1C,A00,187082,Staff,29,0,120,91
1683658939086,PHYS 1CL,001,187088,Staff,0,9,30,30
1683658939086,PHYS 1CL,002,187089,Staff,0,1,30,30
1683658939086,PHYS 1CL,009,262693,Staff,9,0,30,21
1683658940115,PHYS 2B,A01,187097,Staff,55,0,115,60
1683658941139,PHYS 2C,A01,187099,Staff,63,0,115,52
1683658942167,PHYS 2CL,A01,187101,Staff,5,0,28,23
1683658942167,PHYS 2CL,A02,187102,Staff,15,0,28,13
1683658943191,PHYS 2D,A01,187123,Shotwell; Brian,95,0,115,20
1683658944219,PHYS 4B,A01,187133,Grinstein; Benjamin,35,0,50,15
1683658945243,POLI 10,A00,188819,Staff,0,4,50,50
1683658946267,POLI 11,A00,188827,Staff,43,0,50,7
1683658947298,POLI 13R,A00,188828,Staff,0,1,20,20
1683658948322,POLI 27,A01,188830,Elgin; Samuel Zincke,0,2,70,70
1683658949347,POLI 30,A00,188832,Desposato; Scott,30,0,50,20
1683658950374,POLI 102F,A00,188834,Staff,0,0,40,40
1683658951401,POLI 104A,A00,188852,Staff,13,0,30,17
1683658952427,POLI 104I,A00,188853,Staff,0,7,20,20
1683658953456,POLI 110B,A00,188854,Wiens; David,6,0,20,14
1683658954479,POLI 112A,A00,188855,Wiens; David,3,0,30,27
1683658955506,POLI 117R,A00,188856,Forman; Fonna,0,12,20,20
1683658956533,POLI 118,A00,188857,Ingham; Sean,8,0,20,12
1683658957560,POLI 120G,A00,188858,Staff,8,0,30,22
1683658958582,POLI 131CR,A00,188863,Hoston; Germaine,21,0,50,29
1683658959609,POLI 133,A00,188864,Nellis; Gareth Hb,44,0,50,6
1683658960634,POLI 134D,A00,188865,Desposato; Scott,27,0,30,3
1683658961659,POLI 142A,A00,188871,Gartzke; Erik,21,0,50,29
1683658962683,POLI 142K,A00,188874,Staff,38,0,50,12
1683658963707,POLI 143,A00,188940,Gartzke; Erik,16,0,30,14
1683658964731,POLI 153,A00,188943,Staff,2,0,20,18
1683658965753,POLI 160AA,A00,188944,Staff,11,0,40,29
1683658966783,POLI 170A,A00,188945,Staff,11,0,30,19
1683658968838,PSYC 1,A00,188952,Staff,36,0,90,54
1683658969862,PSYC 2,B00,188953,Staff,19,0,35,16
1683658970886,PSYC 6,A00,188970,Staff,47,0,60,13
1683658971910,PSYC 7,A00,188973,Staff,35,0,45,10
1683658972936,PSYC 60,A01,188980,Rickard; Timothy C.,42,0,60,18
1683658974033,PSYC 70,A01,189001,Steiner; Eric Tomas,22,0,45,23
1683658975058,PSYC 100,A00,189005,Lacefield; Katharine I,0,99,120,120
1683658976082,PSYC 102,A00,189008,Staff,8,0,30,22
1683658977104,PSYC 106,B00,189026,Gorman; Michael R.,27,0,60,33
1683658978130,PSYC 114,B01,189033,Winkielman; Piotr,0,31,30,30
1683658979154,PSYC 131,A00,189036,Anagnostaras; Stephan,0,43,60,60
1683658980180,PSYC 136,A00,189041,Lowe; Angela Beth,0,7,25,25
1683658981354,PSYC 137,A00,189057,Winkielman; Piotr,0,37,25,25
1683658982380,PSYC 144,A00,189107,Wixted; John T,0,11,50,50
1683658984428,PSYC 162,A00,189142,Staff,0,9,85,85
1683658985452,PSYC 172,A00,189144,Gorman; Michael R.,0,6,30,30
1683658987502,PSYC 179,A00,189146,Lacefield; Katharine I,0,87,120,120
1683658988526,PSYC 181,A00,189147,Anagnostaras; Stephan,0,44,90,90
1683658989552,PSYC 190R,A00,189148,Barner; David A.,0,23,80,80
1683658990576,PSYC 191,A00,189275,Rickard; Timothy C.,0,10,25,25
1683658991602,PSYC 193,A00,189276,Chapman; Eddie Nathaniel,0,1,0,4
1683658992625,PSYC 193L,A01,189281,Lowe; Angela Beth,10,0,20,10
1683658992625,PSYC 193L,B01,189285,Staff,28,0,35,7
1683658993648,RELI 149,A00,187137,Rahimi; Babak,7,0,40,33
1683658994675,SE 9,A01,187315,Staff,0,2,18,18
1683658995702,SE 101B,A00,187409,Staff,24,0,30,6
1683658996734,SE 110B,A00,187444,Staff,10,0,40,30
1683658997760,SE 130B,A00,187449,Staff,31,0,40,9
1683658998787,SE 150A,A00,187516,Staff,9,0,20,11
1683658999810,SE 154,A00,187528,Staff,29,0,50,21
1683659000835,SIO 3,A01,258171,Staff,35,0,40,5
1683659001859,SIO 10,A00,187144,Cook; Geoffrey W,0,6,75,75
1683659002884,SIO 45,A00,187152,Cook; Geoffrey W,0,4,100,100
1683659003907,SIO 109R,A00,194486,Staff,0,4,20,20
1683659005954,SIO 187,A01,187233,Kacev; David,12,0,40,28
1683659006978,SOCI 1,A01,258656,Thorpe; Charles Robert,28,0,30,2
1683659006978,SOCI 1,A02,258658,Thorpe; Charles Robert,30,0,30,0
1683659006978,SOCI 1,A03,258661,Thorpe; Charles Robert,25,0,25,0
1683659006978,SOCI 1,A04,258666,Thorpe; Charles Robert,22,0,25,3
1683659006978,SOCI 1,A05,258897,Thorpe; Charles Robert,22,0,25,3
1683659006978,SOCI 1,A06,258898,Thorpe; Charles Robert,25,0,25,0
1683659008010,SOCI 30,A01,258903,Pardo Guerra; Juan Pablo,14,0,30,16
1683659009037,SOCI 102,A00,258904,Staff,9,0,25,16
1683659010061,SOCI 106,A00,258905,Staff,19,0,25,6
1683659011089,SOCI 111,A00,258907,Ribas Norris; Janet Vanesa,26,0,30,4
1683659012116,SOCI 121R,A00,258908,Pardo Guerra; Juan Pablo,8,0,30,22
1683659013140,SOCI 126,A01,203330,Staff,14,0,20,6
1683659014163,SOCI 131,A00,258909,Thorpe; Charles Robert,30,0,60,30
1683659015187,SOCI 135,A00,258910,Payne; Christine Anna,0,11,30,30
1683659016214,SOCI 157,A00,258911,Staff,12,0,30,18
1683659017236,SOCI 184,A00,258912,Staff,25,0,30,5
1683659018264,SOCI 188D,A00,258913,Staff,22,0,30,8
1683659019287,SYN 2,001,187529,Staff,9,0,16,7
1683659019287,SYN 2,002,201452,Staff,0,20,16,16
1683659019287,SYN 2,003,201469,Staff,1,0,16,15
1683659020314,SYN 100,A01,187531,Staff,0,9,20,20
1683659020314,SYN 100,B01,201491,Staff,0,10,20,20
1683659021341,TDAC 1,A00,189286,Walsh; Kim C.,3,0,20,17
1683659021341,TDAC 1,B00,189287,Harting; Carla Kelso,10,0,20,10
1683659022369,TDAC 101,A00,189300,Walsh; Kim C.,16,0,20,4
1683659022369,TDAC 101,B00,189301,Harting; Carla Kelso,18,0,20,2
1683659023396,TDAC 102,A00,189304,Basso; Beatrice,14,0,20,6
1683659024422,TDAC 108,A00,189305,Staff,18,0,20,2
1683659025447,TDDE 131,A00,189310,Staff,19,0,20,1
1683659025447,TDDE 131,B00,189314,Staff,19,0,20,1
1683659025447,TDDE 131,C00,189315,Staff,48,0,50,2
1683659025447,TDDE 131,D00,189316,Staff,14,0,15,1
1683659025447,TDDE 131,E00,204841,Staff,20,0,20,0
1683659026471,TDGE 10,A00,189289,Staff,27,0,50,23
1683659026471,TDGE 10,B00,189290,Havis; Allan,0,0,50,50
1683659027500,TDGE 11,A00,189291,Fulton; Julia,0,4,50,50
1683659027500,TDGE 11,B00,189292,Staff,20,0,25,5
1683659027500,TDGE 11,C00,260270,Staff,0,0,0,0
1683659028526,TDGE 25,A00,189294,Staff,2,0,20,18
1683659029554,TDGE 124,A00,189318,Fulton; Julia,0,8,50,50
1683659030578,TDGE 125,A00,189319,Staff,13,0,25,12
1683659030578,TDGE 125,B00,189320,Staff,23,0,25,2
1683659031602,TDGE 127,A00,189322,Havis; Allan,0,0,50,50
1683659032626,TDHT 101,A00,189323,Staff,18,0,25,7
1683659032626,TDHT 101,B00,189324,Staff,25,0,25,0
1683659033653,TDHT 102,A00,189325,Staff,49,0,50,1
1683659034676,TDMV 1,A00,189295,Arcidiacono; Kristin,20,0,30,10
1683659034676,TDMV 1,B00,189296,Caligagan; Maria T.,24,0,30,6
1683659035701,TDMV 2,A00,189297,Sammartano; Tonnie,27,0,30,3
1683659035701,TDMV 2,B00,189299,Arcidiacono; Kristin,23,0,30,7
1683659036727,TDMV 3,A00,204998,Rincon; Alicia,22,0,30,8
1683659037751,TDMV 120,A00,189458,Sammartano; Tonnie,28,0,30,2
1683659038778,TDMV 138,A00,189541,Jun; Grace Shin Hae,20,0,40,20
1683659039802,TDMV 142,A00,189717,Caligagan; Tony,25,0,30,5
1683659039802,TDMV 142,B00,189718,Caligagan; Maria T.,25,0,30,5
1683659040827,TMC 2,A01,187533,Staff,25,0,25,0
1683659040827,TMC 2,A02,187534,Staff,25,0,25,0
1683659041853,USP 1,A01,187536,Kwak; Nancy,0,16,25,25
1683659042879,USP 5,A01,187538,Staff,9,0,25,16
1683659043906,USP 101,A00,199253,Staff,0,4,0,0
1683659044930,USP 124,A00,187562,Boomhower; Matthew Charles,0,0,30,30
1683659045955,USP 138,A00,187582,Staff,20,0,25,5
1683659046977,USP 152,A01,187597,Staff,3,0,25,22
1683659048006,USP 153,A00,187598,Staff,19,0,25,6
1683659049033,USP 168,A00,187607,Kwak; Nancy,2,0,5,3
1683659050062,USP 173,A00,187619,Staff,4,0,25,21
1683659051083,USP 181,A00,187638,Staff,0,4,25,25
1683659052107,VIS 103,A00,187650,Cruz; Edwin Teddy,18,0,75,57
1683659053131,VIS 110D,A00,187669,Staff,13,0,22,9
1683659054154,VIS 127C,A00,187720,Shen; Kuiyi,67,0,146,79
1683659055177,VIS 149,A00,187731,Yoldas; Pinar,0,14,22,22
1683659056205,VIS 151,A01,188091,Staff,22,0,34,12
1683659056205,VIS 151,A02,188092,Staff,11,0,34,23
1683659057230,VIS 160B,A00,188093,Stalbaum; Brett,0,1,10,10
1683659059279,WCWP 10B,A00,201720,Staff,10,0,15,5
1683659059279,WCWP 10B,B00,201722,Staff,9,0,15,6
1683659060305,WCWP 100,A00,201725,Gagnon; Jeffrey C,0,0,2,2
1683659060305,WCWP 100,B00,201727,Staff,0,4,15,15
1683659063429,ANBI 133,A00,258401,Wilder; Linnea Lorene,34,0,40,6
1683659064456,ANBI 140,A00,258395,Hrvoj Mihic; Branka,18,0,25,7
1683659065481,ANSC 120,A00,258402,Bialecki; Jon Anthony,26,0,40,14
1683659066506,ANSC 144,A00,258400,Staff,12,0,40,28
1683659068555,ANSC 166,A00,258396,Parish; Steven Martin,156,0,175,19
1683659069578,ANSC 180,A00,193533,Staff,8,0,20,12
1683659070603,ANSC 188,A00,258397,Jassal; Aftab,34,0,40,6
1683659071627,ANTH 3,A01,258316,Staff,23,0,30,7
1683659072655,ANTH 5,A00,258394,Semendeferi; Ekaterini,16,0,20,4
1683659073679,ANTH 21,A01,258331,Staff,4,0,40,36
1683659074703,ANTH 103,A00,258398,Varma; Saiba,15,0,25,10
1683659075736,AWP 10,001,202034,Staff,0,0,0,0
1683659075736,AWP 10,002,202035,Staff,0,0,0,0
1683659075736,AWP 10,003,202036,Staff,0,0,0,0
1683659075736,AWP 10,004,202037,Staff,0,0,0,0
1683659075736,AWP 10,005,202038,Staff,0,0,0,0
1683659075736,AWP 10,006,202039,Staff,0,0,0,0
1683659075736,AWP 10,007,202040,Staff,0,0,0,0
1683659075736,AWP 10,008,202041,Staff,0,0,0,0
1683659075736,AWP 10,009,202042,Staff,0,0,0,0
1683659075736,AWP 10,010,202043,Staff,0,0,0,0
1683659075736,AWP 10,011,202044,Staff,0,0,0,0
1683659075736,AWP 10,012,202045,Staff,0,0,0,0
1683659075736,AWP 10,013,202046,Staff,0,0,0,0
1683659075736,AWP 10,014,202047,Staff,0,0,0,0
1683659075736,AWP 10,015,202048,Staff,0,0,0,0
1683659075736,AWP 10,016,202049,Staff,0,0,0,0
1683659075736,AWP 10,017,202050,Staff,0,0,0,0
1683659075736,AWP 10,018,202051,Staff,0,0,0,0
1683659075736,AWP 10,019,202052,Staff,0,0,0,0
1683659075736,AWP 10,020,202053,Staff,0,0,0,0
1683659075736,AWP 10,021,202054,Staff,0,0,0,0
1683659075736,AWP 10,022,202055,Staff,0,0,0,0
1683659075736,AWP 10,023,202056,Staff,0,0,0,0
1683659075736,AWP 10,024,202057,Staff,0,0,0,0
1683659075736,AWP 10,025,202058,Staff,0,0,0,0
1683659075736,AWP 10,026,202059,Staff,0,0,0,0
1683659076761,AWP 102,001,202032,Staff,0,0,0,0
1683659076761,AWP 102,002,202033,Staff,0,0,0,0
1683659077839,BENG 100,A01,254234,Taylor Amos; Alyssa C,31,0,40,9
1683659078862,BENG 196,001,270013,Engler; Adam J.,9999,0,9999,0
1683659079887,BICD 100R,A01,202018,Smith; Laurie,0,7,32,32
1683659079887,BICD 100R,A02,202019,Smith; Laurie,0,3,32,32
1683659079887,BICD 100R,A03,202020,Smith; Laurie,0,1,32,32
1683659079887,BICD 100R,A04,202021,Smith; Laurie,6,0,32,26
1683659079887,BICD 100R,A05,202022,Smith; Laurie,11,0,32,21
1683659080916,BICD 136,A01,193242,Gustafson-Brown; Cindy,0,2,32,32
1683659080916,BICD 136,A02,193244,Gustafson-Brown; Cindy,13,0,32,19
1683659081947,BIEB 102,A01,193249,Butler; Shannon Rhey,1,2,32,31
1683659081947,BIEB 102,A02,193251,Butler; Shannon Rhey,0,0,32,32
1683659081947,BIEB 102,A03,193253,Butler; Shannon Rhey,0,0,32,32
1683659081947,BIEB 102,A04,193255,Butler; Shannon Rhey,14,0,32,18
1683659081947,BIEB 102,A05,193265,Butler; Shannon Rhey,26,0,32,6
1683659081947,BIEB 102,A06,193269,Butler; Shannon Rhey,14,0,32,18
1683659084002,BIEB 150,A01,193274,Staff,0,0,32,32
1683659084002,BIEB 150,A02,193285,Staff,24,0,32,8
1683659085031,BIEB 194,A00,193286,Kurle; Carolyn M.,20,0,32,12
1683659086055,BILD 1,A01,192291,Staff,15,0,32,17
1683659086055,BILD 1,A02,192292,Staff,30,0,32,2
1683659086055,BILD 1,B01,192520,Reuther; Keefe,0,1,0,0
1683659086055,BILD 1,B02,192532,Reuther; Keefe,0,1,0,0
1683659087081,BILD 3,A01,192556,Butler; Shannon Rhey,0,0,32,32
1683659087081,BILD 3,A02,192581,Butler; Shannon Rhey,1,0,32,31
1683659087081,BILD 3,A03,192611,Butler; Shannon Rhey,21,0,32,11
1683659087081,BILD 3,A04,192612,Butler; Shannon Rhey,24,0,32,8
1683659087081,BILD 3,A05,192613,Butler; Shannon Rhey,26,0,32,6
1683659087081,BILD 3,A06,192679,Butler; Shannon Rhey,27,0,32,5
1683659087081,BILD 3,A07,192682,Butler; Shannon Rhey,20,0,32,12
1683659088108,BILD 4,A01,192836,Reuther; Keefe,1,0,24,23
1683659088108,BILD 4,A02,193044,Reuther; Keefe,4,0,24,20
1683659089135,BILD 10,A01,193142,Gustafson-Brown; Cindy,29,0,32,3
1683659089135,BILD 10,A02,193149,Gustafson-Brown; Cindy,31,0,32,1
1683659090159,BIMM 100,A01,193301,Staff,0,6,32,32
1683659090159,BIMM 100,A02,193312,Staff,0,7,32,32
1683659090159,BIMM 100,A03,193323,Staff,0,9,32,32
1683659091190,BIMM 101,A01,193329,McDonnell; Lisa Marie,0,4,24,24
1683659091190,BIMM 101,A02,193339,McDonnell; Lisa Marie,1,3,24,23
1683659091190,BIMM 101,B01,193354,McDonnell; Lisa Marie,0,4,24,24
1683659091190,BIMM 101,B02,193357,McDonnell; Lisa Marie,0,3,24,24
1683659092217,BIMM 110,A01,193377,Tat; John,0,11,32,32
1683659092217,BIMM 110,A02,193378,Tat; John,0,10,32,32
1683659093244,BIMM 120,A01,206116,Staff,0,0,32,32
1683659093244,BIMM 120,A02,206117,Staff,6,0,32,26
1683659093244,BIMM 120,A03,206121,Staff,21,0,32,11
1683659094274,BIPN 100,A01,193393,Park; Ji Young,0,15,32,32
1683659094274,BIPN 100,A02,193402,Park; Ji Young,0,14,32,32
1683659094274,BIPN 100,A03,193413,Park; Ji Young,0,14,32,32
1683659094274,BIPN 100,A04,193414,Park; Ji Young,0,13,32,32
1683659095298,BIPN 102,A01,193429,Staff,0,0,32,32
1683659095298,BIPN 102,A02,193438,Staff,18,0,32,14
1683659096322,BIPN 106,A01,193450,Reyes Gonzalez; Catalina,0,2,40,40
1683659097350,BIPN 134,A01,193465,Cooke; James Edward,0,0,32,32
1683659097350,BIPN 134,A02,193474,Cooke; James Edward,25,0,32,7
1683659097350,BIPN 134,A03,193485,Cooke; James Edward,29,0,32,3
1683659097350,BIPN 134,A04,193486,Cooke; James Edward,20,0,32,12
1683659097350,BIPN 134,A05,193491,Cooke; James Edward,31,0,32,1
1683659097350,BIPN 134,A06,193501,Cooke; James Edward,30,0,32,2
1683659097350,BIPN 134,A07,193510,Cooke; James Edward,29,0,32,3
1683659099402,BISP 194,A00,222522,Staff,14,0,32,18
1683659100426,CAT 124,A01,202407,Staff,19,0,25,6
1683659101454,CAT 125,A00,202408,Marchisotto; Jennifer Anne,2,0,20,18
1683659102478,CAT 125R,A00,202409,Smith; Lauryn Alissa,0,11,20,20
1683659102478,CAT 125R,B00,202410,Morales; Celeste Georgianna,0,11,20,20
1683659102478,CAT 125R,C00,202411,Irwin; Matthew Joseph,0,12,20,20
1683659103505,CENG 15,A01,204712,Yang; Kesong,0,1,0,0
1683659104533,CENG 114,A00,202070,Jahed Motlagh; Zeinab,5,0,20,15
1683659105559,CGS 105,A00,185477,Wesling; Megan E.,24,0,40,16
1683659106585,CGS 106,A00,185494,Staff,11,0,22,11
1683659107612,CGS 108,A00,185495,Staff,14,0,20,6
1683659108641,CGS 114,A00,185496,Staff,13,0,18,5
1683659109665,CGS 119,A00,185501,Staff,15,0,20,5
1683659110689,CGS 120,A00,185511,Staff,12,0,20,8
1683659111718,CHEM 4,A01,184675,Bussey; Thomas J,97,0,100,3
1683659112745,CHEM 6A,A01,184677,Staff,32,0,60,28
1683659113772,CHEM 6B,A01,184679,Staff,63,0,100,37
1683659114798,CHEM 6C,A01,184681,Bussey; Thomas J,0,0,50,50
1683659114798,CHEM 6C,A02,184682,Bussey; Thomas J,32,0,50,18
1683659115824,CHEM 40A,A01,184684,Albizati; Kim F.,34,0,100,66
1683659116847,CHEM 40B,A01,184686,Albizati; Kim F.,0,22,100,100
1683659117875,CHEM 41B,A01,184690,Staff,51,0,100,49
1683659118900,COGS 3,A01,184715,Boyle; Mary E. T.,0,27,40,40
1683659119922,COGS 14B,A01,185172,Staff,0,14,38,38
1683659120950,COGS 18,A01,184736,Staff,14,0,80,66
1683659121977,COGS 100,A01,184932,Staff,0,7,73,73
1683659123001,COGS 101A,A01,184935,Staff,0,39,30,30
1683659124026,COGS 101B,A01,184944,Staff,0,2,30,30
1683659125048,COGS 101C,A01,184946,Staff,0,10,30,30
1683659126071,COGS 102A,A01,184951,Johnson; Christine M.,2,0,40,38
1683659127098,COGS 107B,A01,184953,Mooshagian; Eric Frederick,0,51,40,40
1683659128123,COGS 118B,A01,184959,Gupta; Anjum,0,49,40,40
1683659129147,COGS 153,A00,184961,Staff,0,16,30,30
1683659130170,COGS 177,A00,184962,Staff,0,21,30,30
1683659131194,COGS 187A,A01,184969,Boyle; Mary E. T.,0,19,40,40
1683659132222,COMM 10,A01,185174,Staff,0,5,25,25
1683659132222,COMM 10,A02,185189,Staff,0,2,25,25
1683659132222,COMM 10,A03,269821,Staff,0,1,0,0
1683659133246,COMM 100B,A01,185475,Staff,0,1,0,2
1683659133246,COMM 100B,A02,185476,Staff,12,0,25,13
1683659134269,COMM 100C,A01,185314,Staff,1,0,25,24
1683659134269,COMM 100C,A02,185327,Staff,18,0,25,7
1683659135293,COMM 110M,A00,185349,Staff,0,0,40,40
1683659136317,COMM 113T,A00,185352,Staff,25,0,40,15
1683659137345,COMM 114I,A00,185353,Staff,31,0,40,9
1683659138371,COMM 131,A00,185354,Staff,17,0,30,13
1683659139399,CSE 8A,A50,185358,Cao; Yingjun,0,46,10,10
1683659140422,CSE 8B,A01,185362,Staff,0,48,50,50
1683659141449,CSE 11,A01,185416,Cao; Yingjun,0,91,10,10
1683659142476,CSE 20,A01,185445,Briones; Jor-el Thomas Caparas,4,0,25,21
1683659143501,CSE 21,A01,185447,Staff,9,0,50,41
1683659144525,CSE 101,A01,185451,Staff,0,13,50,50
1683659144525,CSE 101,B01,185453,Jones; Miles E,0,14,50,50
1683659146572,CSE 141,A01,185458,Eldon; John,16,0,100,84
1683659147599,CSE 141L,A01,185461,Eldon; John,8,0,100,92
1683659148622,CSE 142,A01,185463,Staff,34,0,60,26
1683659148622,CSE 142,B01,201355,Staff,0,7,60,60
1683659149645,CSE 142L,A01,185470,Staff,34,0,60,26
1683659149645,CSE 142L,B01,201417,Staff,0,6,60,60
1683659150669,CSE 190,A00,201433,Staff,32,0,49,17
1683659151697,DOC 1,A01,259136,Strom; Megan C.,7,0,15,8
1683659151697,DOC 1,A02,259137,Strom; Megan C.,14,0,15,1
1683659151697,DOC 1,A03,259138,Strom; Megan C.,14,0,15,1
1683659151697,DOC 1,A04,259139,Strom; Megan C.,14,0,15,1
1683659152722,DOC 100D,A00,259140,Pass; Natalye Joann,14,0,25,11
1683659153751,DSGN 1,A01,184749,Rill; Bryan,0,26,30,30
1683659154775,DSGN 100,A01,185168,Staff,0,2,25,25
1683659155800,ECE 5,A01,185626,Morris; Karcher William,0,11,0,0
1683659156824,ECE 101,A01,185628,Staff,14,0,70,56
1683659157852,ECE 107,A01,185635,Baghdadchi; Saharnaz,0,0,20,20
1683659157852,ECE 107,A02,185638,Baghdadchi; Saharnaz,2,0,20,18
1683659158875,ECE 148,A01,185647,Silberman; Jack,0,0,16,16
1683659159902,ECON 1,A01,185537,Crane; Meredith Helen,54,0,70,16
1683659160927,ECON 3,A01,185549,Crane; Meredith Helen,29,0,70,41
1683659161950,ECON 4,A01,203354,Anderson; John Charles,0,5,10,10
1683659162975,ECON 100A,A01,185574,Staff,0,5,40,40
1683659163998,ECON 100B,A01,185576,Staff,0,12,50,50
1683659165024,ECON 100C,A01,185589,Newhouse; Herbert S,30,0,70,40
1683659166047,ECON 105,A00,185608,Vespa; Emanuel Ignacio,19,0,35,16
1683659167076,ECON 109,A01,185610,Shishkin; Denis,9,0,35,26
1683659168099,ECON 110A,A01,185612,Staff,9,0,40,31
1683659169126,ECON 120A,A01,185615,Staff,20,0,40,20
1683659170154,ECON 120C,A01,185617,Sun; Yixiao,0,20,70,70
1683659171178,ECON 144,A00,203346,Squires; Dale E,2,0,35,33
1683659172205,ECON 171,A01,203349,Newhouse; Herbert S,0,1,35,35
1683659173227,ECON 173A,A01,185621,Toda; Alexis Akira,20,0,35,15
1683659174253,EDS 25,A01,202413,Staff,0,1,0,0
1683659174253,EDS 25,A02,202414,Staff,0,1,0,0
1683659174253,EDS 25,A03,202415,Staff,0,0,0,0
1683659174253,EDS 25,A04,202416,Staff,0,1,0,0
1683659174253,EDS 25,A05,202439,Staff,0,0,0,0
1683659174253,EDS 25,A06,202440,Staff,0,0,0,0
1683659174253,EDS 25,B01,202631,Staff,0,0,0,0
1683659174253,EDS 25,B02,202632,Staff,0,0,0,0
1683659174253,EDS 25,B03,202639,Staff,0,0,0,0
1683659174253,EDS 25,B04,202640,Staff,0,0,0,0
1683659174253,EDS 25,B05,202643,Staff,0,0,0,0
1683659174253,EDS 25,B06,202644,Staff,0,0,0,0
1683659175280,EDS 38,A01,202659,Black; Alison Michelle,24,0,25,1
1683659176305,EDS 115,A00,202652,Staff,18,0,30,12
1683659177329,EDS 125,A00,202649,Staff,13,0,30,17
1683659178356,EDS 126,A01,203332,Staff,30,0,30,0
1683659179378,EDS 139,A00,202838,Staff,16,0,25,9
1683659180404,EDS 146,A01,202655,Staff,14,0,25,11
1683659181504,ENG 15,A00,185667,Staff,0,1,0,0
1683659181504,ENG 15,B00,185672,Staff,0,0,0,0
1683659181504,ENG 15,C00,185675,Staff,0,0,0,0
1683659181504,ENG 15,D00,185682,Staff,0,0,0,0
1683659181504,ENG 15,E00,185684,Staff,0,0,0,0
1683659182531,ETHN 103,A00,185710,Staff,0,8,35,35
1683659183558,ETHN 103A,A00,199228,Man; Simeon S,0,0,9,9
1683659184581,ETHN 109,A00,185711,Staff,16,0,35,19
1683659185605,ETHN 142,A00,185726,Staff,0,4,30,30
1683659186629,ETHN 163J,A00,199229,Man; Simeon S,5,0,8,3
1683659187655,ETHN 168,A00,185727,Staff,7,0,10,3
1683659188681,ETHN 182,A00,185728,Staff,0,0,35,35
1683659189705,ETHN 183,A00,185737,Staff,9,0,18,9
1683659190731,GLBH 111,A01,209361,Burgos; Jose L.,0,0,0,0
1683659192783,HIEU 104,A00,185792,Staff,14,0,20,6
1683659193807,HIEU 115,A00,185800,Staff,0,0,20,20
1683659194832,HIEU 128,A00,185801,Staff,0,9,20,20
1683659195859,HIEU 147,A00,185802,Staff,15,0,20,5
1683659196882,HIEU 154,A00,185823,Staff,11,0,20,9
1683659197909,HILA 102,A00,185826,Staff,14,0,20,6
1683659198935,HILD 2C,A01,185778,Staff,0,13,20,20
1683659199960,HILD 7B,A01,185780,Kwak; Nancy,0,17,32,32
1683659199960,HILD 7B,A02,185781,Kwak; Nancy,0,18,32,32
1683659200984,HILD 30,A01,185791,Staff,12,0,20,8
1683659202016,HISC 119,A00,185830,Golan; Tal,0,9,20,20
1683659203040,HITO 156GS,A00,185831,Patterson; Patrick H.,0,0,0,23
1683659204066,HIUS 103,A00,185832,Man; Simeon S,0,4,20,20
1683659205093,HIUS 117,A00,185836,Kwak; Nancy,2,0,20,18
1683659206132,HIUS 125,A00,185840,Man; Simeon S,0,2,23,23
1683659207156,HIUS 149,A00,185845,Staff,1,0,20,19
1683659208183,HUM 3,A01,185882,Zavodny; Tatiana Sophia,0,8,50,50
1683659208183,HUM 3,B01,185899,Caldwell; Michael Alan,0,18,50,50
1683659209206,HUM 3GS,A00,185900,Patterson; Patrick H.,0,0,0,23
1683659210232,HUM 4,A01,185938,Zroka; Amy Liane,29,0,50,21
1683659210232,HUM 4,B01,185956,Watkins; Eric,0,4,50,50
1683659210232,HUM 4,B02,202209,Watkins; Eric,0,5,50,50
1683659210232,HUM 4,B03,202210,Watkins; Eric,0,5,50,50
1683659211255,HUM 5,A01,185958,West; Geoffrey Scott,0,0,50,50
1683659211255,HUM 5,A02,202215,West; Geoffrey Scott,0,0,50,50
1683659212283,INTL 190,A00,185959,Gagnon; Jeffrey C,0,0,0,9
1683659212283,INTL 190,B00,185960,Lettieri; Michael Joseph,0,0,0,2
1683659213307,JAPN 180,A00,254509,Staff,5,0,30,25
1683659214331,LATI 10,A01,202853,Kennemore; Amy Michelle,4,0,35,31
1683659214331,LATI 10,A02,202854,Kennemore; Amy Michelle,2,0,35,33
1683659214331,LATI 10,A03,270054,Kennemore; Amy Michelle,30,0,30,0
1683659215358,LATI 180,A00,202855,Kennemore; Amy Michelle,11,0,20,9
1683659216383,LAWS 101,A00,201767,Golan; Tal,0,7,40,40
1683659217408,LIFR 1C,A00,185961,Staff,6,0,20,14
1683659218434,LIFR 1CX,A00,185962,Staff,7,0,20,13
1683659219456,LIFR 1D,A00,185963,Staff,7,0,20,13
1683659220483,LIFR 1DX,A00,185964,Staff,7,0,20,13
1683659221506,LIGN 101,A01,186039,Staff,43,0,50,7
1683659222531,LIGN 165,A00,186040,Staff,15,0,50,35
1683659223555,LTCS 108,A00,186041,Staff,5,0,10,5
1683659224580,LTCS 119,A00,186042,Staff,15,0,20,5
1683659225604,LTCS 130,A00,186043,Wesling; Megan E.,15,0,25,10
1683659227654,LTEA 138,A00,186119,Staff,14,0,40,26
1683659228681,LTEN 124,A00,186148,Staff,5,0,25,20
1683659229705,LTEN 178,A00,186149,Staff,7,0,15,8
1683659230732,LTEN 181,A00,186150,Blanco; John D,34,0,40,6
1683659231755,LTWL 120,A00,186160,Staff,20,0,25,5
1683659232778,LTWL 165,A00,186161,Staff,22,0,25,3
1683659233802,LTWR 100,A00,186162,Staff,0,5,15,15
1683659234826,LTWR 102,A00,186163,Doller; Ben,5,0,15,10
1683659235853,MAE 8,A01,186412,Staff,0,0,0,0
1683659236877,MAE 30B,A00,186445,Bahadori; Mohammad Yousef,82,0,100,18
1683659237905,MAE 40,A00,186592,Bewley; Thomas R,10,0,50,40
1683659238929,MAE 101B,A00,186593,Bahadori; Mohammad Yousef,80,0,100,20
1683659239953,MAE 105,A00,186594,Bandaru; Prabhakar,10,0,50,40
1683659240978,MAE 107,A00,186599,Pham; Hieu Tan,0,7,120,120
1683659242006,MAE 148,A01,186660,Silberman; Jack,3,0,16,13
1683659243030,MATH 10A,A01,188095,Staff,0,6,35,35
1683659244059,MATH 10B,A01,188097,Bowers; Adam R.,0,12,30,30
1683659244059,MATH 10B,A02,188099,Bowers; Adam R.,0,11,30,30
1683659244059,MATH 10B,B01,188104,Bowers; Adam R.,0,10,30,30
1683659244059,MATH 10B,B02,188106,Bowers; Adam R.,1,9,30,29
1683659245087,MATH 10C,A01,188111,Staff,0,18,30,30
1683659245087,MATH 10C,A02,188127,Staff,0,19,30,30
1683659245087,MATH 10C,A03,188131,Staff,0,19,30,30
1683659245087,MATH 10C,B01,188218,Staff,17,0,30,13
1683659245087,MATH 10C,B02,188244,Staff,13,0,30,17
1683659245087,MATH 10C,B03,188277,Staff,14,0,30,16
1683659246120,MATH 18,A01,188344,Bach; Quang Tran,18,0,30,12
1683659246120,MATH 18,A02,188345,Bach; Quang Tran,11,0,30,19
1683659246120,MATH 18,B01,188353,Bach; Quang Tran,11,0,30,19
1683659246120,MATH 18,B02,188354,Bach; Quang Tran,19,0,30,11
1683659247144,MATH 20A,A01,188374,Staff,11,0,35,24
1683659248171,MATH 20B,A01,188382,Ohm; Ko Woon,7,0,30,23
1683659248171,MATH 20B,A02,188383,Ohm; Ko Woon,22,0,30,8
1683659248171,MATH 20B,B01,188385,Ohm; Ko Woon,7,0,30,23
1683659248171,MATH 20B,B02,188392,Ohm; Ko Woon,22,0,30,8
1683659249199,MATH 20C,A01,188394,Harel; Guershon,10,0,30,20
1683659249199,MATH 20C,A02,188395,Harel; Guershon,13,0,30,17
1683659249199,MATH 20C,B01,188404,Harel; Guershon,5,0,30,25
1683659249199,MATH 20C,B02,188405,Harel; Guershon,18,0,30,12
1683659250226,MATH 20D,A01,188414,Hammock; Frances H,0,1,30,30
1683659250226,MATH 20D,A02,188415,Hammock; Frances H,0,1,30,30
1683659250226,MATH 20D,B01,188447,Hammock; Frances H,0,1,30,30
1683659250226,MATH 20D,B02,188486,Hammock; Frances H,4,0,30,26
1683659251250,MATH 20E,A01,188649,Staff,21,0,30,9
1683659251250,MATH 20E,A02,188650,Staff,21,0,30,9
1683659251250,MATH 20E,A03,188673,Staff,0,0,30,30
1683659252278,MATH 102,A01,188675,Staff,0,36,35,35
1683659253306,MATH 103B,A01,188681,Staff,3,0,35,32
1683659253306,MATH 103B,B01,188692,Staff,5,0,35,30
1683659254329,MATH 109,A01,188695,Salehi Golsefidy; Alireza,24,0,35,11
1683659254329,MATH 109,A02,188696,Salehi Golsefidy; Alireza,25,0,35,10
1683659255354,MATH 120A,A01,188698,Eggers; John Dietrich,7,0,35,28
1683659256378,MATH 142B,A01,188736,Ioana; Adrian,0,1,30,30
1683659256378,MATH 142B,A02,188741,Ioana; Adrian,0,1,30,30
1683659256378,MATH 142B,A03,188743,Ioana; Adrian,0,1,30,30
1683659257402,MATH 168A,A01,188790,Staff,0,10,35,35
1683659258426,MATH 170A,A01,188803,Nie; Jiawang,0,2,35,35
1683659258426,MATH 170A,A02,188811,Nie; Jiawang,0,0,35,35
1683659258426,MATH 170A,A03,188814,Nie; Jiawang,0,0,35,35
1683659258426,MATH 170A,A04,188815,Nie; Jiawang,9,0,35,26
1683659259451,MATH 193B,A01,188817,Staff,0,0,35,35
1683659259451,MATH 193B,A02,188818,Staff,5,0,35,30
1683659260475,MGT 4,A01,202857,Anderson; John Charles,61,0,80,19
1683659261502,MGT 12,A00,202858,Lindenberger; Wade Douglas,40,0,90,50
1683659262530,MGT 18,A00,202859,Staff,74,0,90,16
1683659263557,MGT 18GS,A00,202860,McKay; Michael J,13,0,28,15
1683659264585,MGT 45,A00,202861,Pecore; Joseph P.,12,0,90,78
1683659265610,MGT 100,A00,202863,Yavorsky; Daniel Ryan,28,0,90,62
1683659266635,MGT 103,A00,202864,Ehrich; Kristine R,0,18,90,90
1683659267660,MGT 112,A00,202865,Ehrich; Kristine R,14,0,90,76
1683659268689,MGT 121A,A00,202868,Staff,90,20,90,0
1683659269715,MGT 131B,A00,202869,Anderson; John Charles,59,0,90,31
1683659270739,MGT 136,A00,202871,Lindenberger; Wade Douglas,83,0,90,7
1683659271764,MGT 164,A00,202873,Staff,0,67,90,91
1683659272791,MGT 164GS,A00,202874,McKay; Mary A,13,0,28,15
1683659273816,MGT 180,A00,202875,Staff,0,50,90,91
1683659274841,MMW 11R,A01,205019,Herbst; Matthew,1,0,30,29
1683659274841,MMW 11R,A02,205026,Herbst; Matthew,29,0,30,1
1683659275866,MMW 15,A01,193512,Chang; Edmond Yi-Teh,0,8,28,28
1683659275866,MMW 15,A02,193513,Chang; Edmond Yi-Teh,0,5,28,28
1683659275866,MMW 15,A03,193514,Chang; Edmond Yi-Teh,0,5,28,28
1683659275866,MMW 15,A04,193515,Chang; Edmond Yi-Teh,0,5,28,28
1683659275866,MMW 15,A05,193516,Chang; Edmond Yi-Teh,0,5,28,28
1683659275866,MMW 15,A06,193517,Chang; Edmond Yi-Teh,0,6,28,28
1683659275866,MMW 15,B01,193519,Chang; Edmond Yi-Teh,0,5,28,28
1683659275866,MMW 15,B02,193520,Chang; Edmond Yi-Teh,0,5,28,28
1683659275866,MMW 15,B03,193521,Chang; Edmond Yi-Teh,0,5,28,28
1683659275866,MMW 15,B04,193522,Chang; Edmond Yi-Teh,0,5,28,28
1683659275866,MMW 15,B05,193523,Chang; Edmond Yi-Teh,0,5,28,28
1683659275866,MMW 15,B06,193524,Chang; Edmond Yi-Teh,0,5,28,28
1683659276892,MMW 122,A01,193526,Rahimi; Babak,0,16,28,28
1683659276892,MMW 122,A02,193527,Rahimi; Babak,0,15,28,28
1683659276892,MMW 122,A03,193528,Rahimi; Babak,0,0,0,0
1683659276892,MMW 122,A04,193529,Rahimi; Babak,0,0,0,0
1683659277918,MUS 1A,A01,186663,Staff,1,20,35,34
1683659278943,MUS 4,A01,186715,Staff,0,12,35,35
1683659279969,MUS 5R,A01,186796,Dubnov; Shlomo,0,17,35,35
1683659280992,MUS 6,A01,186798,Staff,0,5,25,25
1683659282016,MUS 7,A01,186830,Staff,11,0,35,24
1683659283041,MUS 8,A01,186930,Staff,0,26,35,35
1683659284066,MUS 15,A01,186932,Staff,0,16,35,35
1683659284066,MUS 15,B01,186934,Staff,1,17,35,34
1683659285147,MUS 80,A00,186935,Staff,0,0,20,20
1683659285147,MUS 80,B00,186936,Staff,24,0,25,1
1683659286174,NANO 11,A00,204702,Lipomi; Darren John,0,0,0,0
1683659287199,NANO 15,A01,204709,Yang; Kesong,0,1,0,0
1683659288227,NANO 114,A00,202069,Jahed Motlagh; Zeinab,3,0,10,7
1683659289253,PHIL 1,A00,186955,Grush; Rick Scott,31,0,40,9
1683659290282,PHIL 10,A01,186973,Grush; Rick Scott,27,0,35,8
1683659290282,PHIL 10,A02,186974,Grush; Rick Scott,33,0,35,2
1683659291310,PHIL 13,A01,186976,Staff,3,0,35,32
1683659291310,PHIL 13,A02,186977,Staff,16,0,35,19
1683659292335,PHIL 14,A01,186979,Staff,31,0,35,4
1683659292335,PHIL 14,A02,186986,Staff,32,0,35,3
1683659293359,PHIL 28,A01,186988,Staff,16,0,30,14
1683659293359,PHIL 28,A02,186989,Staff,1,0,30,29
1683659293359,PHIL 28,A03,186990,Staff,10,0,30,20
1683659293359,PHIL 28,A04,186991,Staff,26,0,30,4
1683659294384,PHIL 120,A00,186997,Staff,23,0,40,17
1683659295409,PHIL 137,A00,187003,Staff,7,0,40,33
1683659296433,PHIL 150,A00,187015,Staff,47,0,70,23
1683659297457,PHIL 167,A00,187021,Lamey; Andy M.,34,0,40,6
1683659298481,PHIL 174,A01,202226,Staff,17,0,20,3
1683659298481,PHIL 174,A02,202235,Staff,20,0,20,0
1683659299505,PHIL 191A,A00,258918,Staff,0,0,1,1
1683659300529,PHYS 1A,A00,187028,Staff,26,0,60,34
1683659301553,PHYS 1AL,001,187036,Staff,3,0,30,27
1683659301553,PHYS 1AL,002,187049,Staff,18,0,30,12
1683659302580,PHYS 1B,A00,187058,Staff,22,0,60,38
1683659303605,PHYS 1BL,001,187064,Staff,0,1,30,30
1683659303605,PHYS 1BL,002,187070,Staff,4,0,30,26
1683659304633,PHYS 1C,A00,187082,Staff,29,0,120,91
1683659305662,PHYS 1CL,001,187088,Staff,0,9,30,30
1683659305662,PHYS 1CL,002,187089,Staff,0,1,30,30
1683659305662,PHYS 1CL,009,262693,Staff,9,0,30,21
1683659306686,PHYS 2B,A01,187097,Staff,55,0,115,60
1683659307714,PHYS 2C,A01,187099,Staff,63,0,115,52
1683659308739,PHYS 2CL,A01,187101,Staff,5,0,28,23
1683659308739,PHYS 2CL,A02,187102,Staff,15,0,28,13
1683659309767,PHYS 2D,A01,187123,Shotwell; Brian,95,0,115,20
1683659310790,PHYS 4B,A01,187133,Grinstein; Benjamin,35,0,50,15
1683659311814,POLI 10,A00,188819,Staff,0,4,50,50
1683659312838,POLI 11,A00,188827,Staff,43,0,50,7
1683659313864,POLI 13R,A00,188828,Staff,0,1,20,20
1683659314889,POLI 27,A01,188830,Elgin; Samuel Zincke,0,2,70,70
1683659315913,POLI 30,A00,188832,Desposato; Scott,30,0,50,20
1683659316938,POLI 102F,A00,188834,Staff,0,0,40,40
1683659317964,POLI 104A,A00,188852,Staff,13,0,30,17
1683659318987,POLI 104I,A00,188853,Staff,0,7,20,20
1683659320014,POLI 110B,A00,188854,Wiens; David,6,0,20,14
1683659321043,POLI 112A,A00,188855,Wiens; David,3,0,30,27
1683659322069,POLI 117R,A00,188856,Forman; Fonna,0,12,20,20
1683659323093,POLI 118,A00,188857,Ingham; Sean,8,0,20,12
1683659324117,POLI 120G,A00,188858,Staff,8,0,30,22
1683659325141,POLI 131CR,A00,188863,Hoston; Germaine,21,0,50,29
1683659326166,POLI 133,A00,188864,Nellis; Gareth Hb,44,0,50,6
1683659327188,POLI 134D,A00,188865,Desposato; Scott,27,0,30,3
1683659328211,POLI 142A,A00,188871,Gartzke; Erik,21,0,50,29
1683659329237,POLI 142K,A00,188874,Staff,38,0,50,12
1683659330266,POLI 143,A00,188940,Gartzke; Erik,16,0,30,14
1683659331297,POLI 153,A00,188943,Staff,2,0,20,18
1683659332320,POLI 160AA,A00,188944,Staff,11,0,40,29
1683659333343,POLI 170A,A00,188945,Staff,11,0,30,19
1683659335392,PSYC 1,A00,188952,Staff,36,0,90,54
1683659336416,PSYC 2,B00,188953,Staff,19,0,35,16
1683659337443,PSYC 6,A00,188970,Staff,47,0,60,13
1683659338467,PSYC 7,A00,188973,Staff,35,0,45,10
1683659339494,PSYC 60,A01,188980,Rickard; Timothy C.,42,0,60,18
1683659340518,PSYC 70,A01,189001,Steiner; Eric Tomas,22,0,45,23
1683659341542,PSYC 100,A00,189005,Lacefield; Katharine I,0,99,120,120
1683659342565,PSYC 102,A00,189008,Staff,8,0,30,22
1683659343592,PSYC 106,B00,189026,Gorman; Michael R.,27,0,60,33
1683659344616,PSYC 114,B01,189033,Winkielman; Piotr,0,31,30,30
1683659345641,PSYC 131,A00,189036,Anagnostaras; Stephan,0,43,60,60
1683659346670,PSYC 136,A00,189041,Lowe; Angela Beth,0,7,25,25
1683659347693,PSYC 137,A00,189057,Winkielman; Piotr,0,37,25,25
1683659348717,PSYC 144,A00,189107,Wixted; John T,0,11,50,50
1683659350764,PSYC 162,A00,189142,Staff,0,9,85,85
1683659351788,PSYC 172,A00,189144,Gorman; Michael R.,0,6,30,30
1683659353838,PSYC 179,A00,189146,Lacefield; Katharine I,0,87,120,120
1683659354861,PSYC 181,A00,189147,Anagnostaras; Stephan,0,44,90,90
1683659355889,PSYC 190R,A00,189148,Barner; David A.,0,23,80,80
1683659356914,PSYC 191,A00,189275,Rickard; Timothy C.,0,10,25,25
1683659357937,PSYC 193,A00,189276,Chapman; Eddie Nathaniel,0,1,0,4
1683659358959,PSYC 193L,A01,189281,Lowe; Angela Beth,10,0,20,10
1683659358959,PSYC 193L,B01,189285,Staff,28,0,35,7
1683659359984,RELI 149,A00,187137,Rahimi; Babak,7,0,40,33
1683659361013,SE 9,A01,187315,Staff,0,2,18,18
1683659362034,SE 101B,A00,187409,Staff,24,0,30,6
1683659363058,SE 110B,A00,187444,Staff,10,0,40,30
1683659364086,SE 130B,A00,187449,Staff,31,0,40,9
1683659365111,SE 150A,A00,187516,Staff,9,0,20,11
1683659366135,SE 154,A00,187528,Staff,29,0,50,21
1683659367159,SIO 3,A01,258171,Staff,35,0,40,5
1683659368182,SIO 10,A00,187144,Cook; Geoffrey W,0,6,75,75
1683659369212,SIO 45,A00,187152,Cook; Geoffrey W,0,4,100,100
1683659370235,SIO 109R,A00,194486,Staff,0,4,20,20
1683659372285,SIO 187,A01,187233,Kacev; David,12,0,40,28
1683659373311,SOCI 1,A01,258656,Thorpe; Charles Robert,28,0,30,2
1683659373311,SOCI 1,A02,258658,Thorpe; Charles Robert,30,0,30,0
1683659373311,SOCI 1,A03,258661,Thorpe; Charles Robert,25,0,25,0
1683659373311,SOCI 1,A04,258666,Thorpe; Charles Robert,22,0,25,3
1683659373311,SOCI 1,A05,258897,Thorpe; Charles Robert,22,0,25,3
1683659373311,SOCI 1,A06,258898,Thorpe; Charles Robert,25,0,25,0
1683659374334,SOCI 30,A01,258903,Pardo Guerra; Juan Pablo,14,0,30,16
1683659375360,SOCI 102,A00,258904,Staff,9,0,25,16
1683659376390,SOCI 106,A00,258905,Staff,19,0,25,6
1683659377417,SOCI 111,A00,258907,Ribas Norris; Janet Vanesa,26,0,30,4
1683659378441,SOCI 121R,A00,258908,Pardo Guerra; Juan Pablo,8,0,30,22
1683659379469,SOCI 126,A01,203330,Staff,14,0,20,6
1683659380493,SOCI 131,A00,258909,Thorpe; Charles Robert,30,0,60,30
1683659381522,SOCI 135,A00,258910,Payne; Christine Anna,0,11,30,30
1683659382550,SOCI 157,A00,258911,Staff,12,0,30,18
1683659383573,SOCI 184,A00,258912,Staff,25,0,30,5
1683659384597,SOCI 188D,A00,258913,Staff,22,0,30,8
1683659385625,SYN 2,001,187529,Staff,9,0,16,7
1683659385625,SYN 2,002,201452,Staff,0,20,16,16
1683659385625,SYN 2,003,201469,Staff,1,0,16,15
1683659386652,SYN 100,A01,187531,Staff,0,9,20,20
1683659386652,SYN 100,B01,201491,Staff,0,10,20,20
1683659387681,TDAC 1,A00,189286,Walsh; Kim C.,3,0,20,17
1683659387681,TDAC 1,B00,189287,Harting; Carla Kelso,10,0,20,10
1683659388776,TDAC 101,A00,189300,Walsh; Kim C.,16,0,20,4
1683659388776,TDAC 101,B00,189301,Harting; Carla Kelso,18,0,20,2
1683659389804,TDAC 102,A00,189304,Basso; Beatrice,14,0,20,6
1683659390829,TDAC 108,A00,189305,Staff,18,0,20,2
1683659391857,TDDE 131,A00,189310,Staff,19,0,20,1
1683659391857,TDDE 131,B00,189314,Staff,19,0,20,1
1683659391857,TDDE 131,C00,189315,Staff,48,0,50,2
1683659391857,TDDE 131,D00,189316,Staff,14,0,15,1
1683659391857,TDDE 131,E00,204841,Staff,20,0,20,0
1683659392887,TDGE 10,A00,189289,Staff,27,0,50,23
1683659392887,TDGE 10,B00,189290,Havis; Allan,0,0,50,50
1683659393912,TDGE 11,A00,189291,Fulton; Julia,0,4,50,50
1683659393912,TDGE 11,B00,189292,Staff,20,0,25,5
1683659393912,TDGE 11,C00,260270,Staff,0,0,0,0
1683659394939,TDGE 25,A00,189294,Staff,2,0,20,18
1683659395966,TDGE 124,A00,189318,Fulton; Julia,0,8,50,50
1683659396993,TDGE 125,A00,189319,Staff,13,0,25,12
1683659396993,TDGE 125,B00,189320,Staff,23,0,25,2
1683659398018,TDGE 127,A00,189322,Havis; Allan,0,0,50,50
1683659399045,TDHT 101,A00,189323,Staff,18,0,25,7
1683659399045,TDHT 101,B00,189324,Staff,25,0,25,0
1683659400071,TDHT 102,A00,189325,Staff,49,0,50,1
1683659401096,TDMV 1,A00,189295,Arcidiacono; Kristin,20,0,30,10
1683659401096,TDMV 1,B00,189296,Caligagan; Maria T.,24,0,30,6
1683659402127,TDMV 2,A00,189297,Sammartano; Tonnie,27,0,30,3
1683659402127,TDMV 2,B00,189299,Arcidiacono; Kristin,23,0,30,7
1683659403152,TDMV 3,A00,204998,Rincon; Alicia,22,0,30,8
1683659404180,TDMV 120,A00,189458,Sammartano; Tonnie,28,0,30,2
1683659405204,TDMV 138,A00,189541,Jun; Grace Shin Hae,20,0,40,20
1683659406232,TDMV 142,A00,189717,Caligagan; Tony,25,0,30,5
1683659406232,TDMV 142,B00,189718,Caligagan; Maria T.,25,0,30,5
1683659407259,TMC 2,A01,187533,Staff,25,0,25,0
1683659407259,TMC 2,A02,187534,Staff,25,0,25,0
1683659408285,USP 1,A01,187536,Kwak; Nancy,0,16,25,25
1683659409314,USP 5,A01,187538,Staff,9,0,25,16
1683659410339,USP 101,A00,199253,Staff,0,4,0,0
1683659411364,USP 124,A00,187562,Boomhower; Matthew Charles,0,0,30,30
1683659412392,USP 138,A00,187582,Staff,20,0,25,5
1683659413424,USP 152,A01,187597,Staff,3,0,25,22
1683659414451,USP 153,A00,187598,Staff,19,0,25,6
1683659415476,USP 168,A00,187607,Kwak; Nancy,2,0,5,3
1683659416504,USP 173,A00,187619,Staff,4,0,25,21
1683659417528,USP 181,A00,187638,Staff,0,4,25,25
1683659418559,VIS 103,A00,187650,Cruz; Edwin Teddy,18,0,75,57
1683659419583,VIS 110D,A00,187669,Staff,13,0,22,9
1683659420607,VIS 127C,A00,187720,Shen; Kuiyi,67,0,146,79
1683659421634,VIS 149,A00,187731,Yoldas; Pinar,1,14,22,21
1683659422661,VIS 151,A01,188091,Staff,22,0,34,12
1683659422661,VIS 151,A02,188092,Staff,11,0,34,23
1683659423685,VIS 160B,A00,188093,Stalbaum; Brett,0,1,10,10
1683659425733,WCWP 10B,A00,201720,Staff,10,0,15,5
1683659425733,WCWP 10B,B00,201722,Staff,9,0,15,6
1683659426760,WCWP 100,A00,201725,Gagnon; Jeffrey C,0,0,2,2
1683659426760,WCWP 100,B00,201727,Staff,0,4,15,15
1683659429849,ANBI 133,A00,258401,Wilder; Linnea Lorene,34,0,40,6
1683659430883,ANBI 140,A00,258395,Hrvoj Mihic; Branka,18,0,25,7
1683659431907,ANSC 120,A00,258402,Bialecki; Jon Anthony,26,0,40,14
1683659432934,ANSC 144,A00,258400,Staff,12,0,40,28
1683659434987,ANSC 166,A00,258396,Parish; Steven Martin,156,0,175,19
1683659436012,ANSC 180,A00,193533,Staff,8,0,20,12
1683659437040,ANSC 188,A00,258397,Jassal; Aftab,34,0,40,6
1683659438064,ANTH 3,A01,258316,Staff,23,0,30,7
1683659439090,ANTH 5,A00,258394,Semendeferi; Ekaterini,16,0,20,4
1683659440135,ANTH 21,A01,258331,Staff,4,0,40,36
1683659441158,ANTH 103,A00,258398,Varma; Saiba,15,0,25,10
1683659442184,AWP 10,001,202034,Staff,0,0,0,0
1683659442184,AWP 10,002,202035,Staff,0,0,0,0
1683659442184,AWP 10,003,202036,Staff,0,0,0,0
1683659442184,AWP 10,004,202037,Staff,0,0,0,0
1683659442184,AWP 10,005,202038,Staff,0,0,0,0
1683659442184,AWP 10,006,202039,Staff,0,0,0,0
1683659442184,AWP 10,007,202040,Staff,0,0,0,0
1683659442184,AWP 10,008,202041,Staff,0,0,0,0
1683659442184,AWP 10,009,202042,Staff,0,0,0,0
1683659442184,AWP 10,010,202043,Staff,0,0,0,0
1683659442184,AWP 10,011,202044,Staff,0,0,0,0
1683659442184,AWP 10,012,202045,Staff,0,0,0,0
1683659442184,AWP 10,013,202046,Staff,0,0,0,0
1683659442184,AWP 10,014,202047,Staff,0,0,0,0
1683659442184,AWP 10,015,202048,Staff,0,0,0,0
1683659442184,AWP 10,016,202049,Staff,0,0,0,0
1683659442184,AWP 10,017,202050,Staff,0,0,0,0
1683659442184,AWP 10,018,202051,Staff,0,0,0,0
1683659442184,AWP 10,019,202052,Staff,0,0,0,0
1683659442184,AWP 10,020,202053,Staff,0,0,0,0
1683659442184,AWP 10,021,202054,Staff,0,0,0,0
1683659442184,AWP 10,022,202055,Staff,0,0,0,0
1683659442184,AWP 10,023,202056,Staff,0,0,0,0
1683659442184,AWP 10,024,202057,Staff,0,0,0,0
1683659442184,AWP 10,025,202058,Staff,0,0,0,0
1683659442184,AWP 10,026,202059,Staff,0,0,0,0
1683659443207,AWP 102,001,202032,Staff,0,0,0,0
1683659443207,AWP 102,002,202033,Staff,0,0,0,0
1683659444231,BENG 100,A01,254234,Taylor Amos; Alyssa C,31,0,40,9
1683659445256,BENG 196,001,270013,Engler; Adam J.,9999,0,9999,0
1683659446286,BICD 100R,A01,202018,Smith; Laurie,0,7,32,32
1683659446286,BICD 100R,A02,202019,Smith; Laurie,0,3,32,32
1683659446286,BICD 100R,A03,202020,Smith; Laurie,0,1,32,32
1683659446286,BICD 100R,A04,202021,Smith; Laurie,6,0,32,26
1683659446286,BICD 100R,A05,202022,Smith; Laurie,11,0,32,21
1683659447311,BICD 136,A01,193242,Gustafson-Brown; Cindy,0,2,32,32
1683659447311,BICD 136,A02,193244,Gustafson-Brown; Cindy,13,0,32,19
1683659448337,BIEB 102,A01,193249,Butler; Shannon Rhey,1,2,32,31
1683659448337,BIEB 102,A02,193251,Butler; Shannon Rhey,0,0,32,32
1683659448337,BIEB 102,A03,193253,Butler; Shannon Rhey,0,0,32,32
1683659448337,BIEB 102,A04,193255,Butler; Shannon Rhey,14,0,32,18
1683659448337,BIEB 102,A05,193265,Butler; Shannon Rhey,26,0,32,6
1683659448337,BIEB 102,A06,193269,Butler; Shannon Rhey,14,0,32,18
1683659450394,BIEB 150,A01,193274,Staff,0,0,32,32
1683659450394,BIEB 150,A02,193285,Staff,24,0,32,8
1683659451419,BIEB 194,A00,193286,Kurle; Carolyn M.,20,0,32,12
1683659452445,BILD 1,A01,192291,Staff,15,0,32,17
1683659452445,BILD 1,A02,192292,Staff,30,0,32,2
1683659452445,BILD 1,B01,192520,Reuther; Keefe,0,1,0,0
1683659452445,BILD 1,B02,192532,Reuther; Keefe,0,1,0,0
1683659453474,BILD 3,A01,192556,Butler; Shannon Rhey,0,0,32,32
1683659453474,BILD 3,A02,192581,Butler; Shannon Rhey,1,0,32,31
1683659453474,BILD 3,A03,192611,Butler; Shannon Rhey,21,0,32,11
1683659453474,BILD 3,A04,192612,Butler; Shannon Rhey,24,0,32,8
1683659453474,BILD 3,A05,192613,Butler; Shannon Rhey,26,0,32,6
1683659453474,BILD 3,A06,192679,Butler; Shannon Rhey,27,0,32,5
1683659453474,BILD 3,A07,192682,Butler; Shannon Rhey,20,0,32,12
1683659454499,BILD 4,A01,192836,Reuther; Keefe,1,0,24,23
1683659454499,BILD 4,A02,193044,Reuther; Keefe,4,0,24,20
1683659455528,BILD 10,A01,193142,Gustafson-Brown; Cindy,29,0,32,3
1683659455528,BILD 10,A02,193149,Gustafson-Brown; Cindy,31,0,32,1
1683659456552,BIMM 100,A01,193301,Staff,0,6,32,32
1683659456552,BIMM 100,A02,193312,Staff,0,7,32,32
1683659456552,BIMM 100,A03,193323,Staff,0,9,32,32
1683659457581,BIMM 101,A01,193329,McDonnell; Lisa Marie,0,4,24,24
1683659457581,BIMM 101,A02,193339,McDonnell; Lisa Marie,1,3,24,23
1683659457581,BIMM 101,B01,193354,McDonnell; Lisa Marie,0,4,24,24
1683659457581,BIMM 101,B02,193357,McDonnell; Lisa Marie,0,3,24,24
1683659458609,BIMM 110,A01,193377,Tat; John,0,11,32,32
1683659458609,BIMM 110,A02,193378,Tat; John,0,10,32,32
1683659459640,BIMM 120,A01,206116,Staff,0,0,32,32
1683659459640,BIMM 120,A02,206117,Staff,6,0,32,26
1683659459640,BIMM 120,A03,206121,Staff,21,0,32,11
1683659460663,BIPN 100,A01,193393,Park; Ji Young,0,15,32,32
1683659460663,BIPN 100,A02,193402,Park; Ji Young,0,14,32,32
1683659460663,BIPN 100,A03,193413,Park; Ji Young,0,14,32,32
1683659460663,BIPN 100,A04,193414,Park; Ji Young,0,13,32,32
1683659461686,BIPN 102,A01,193429,Staff,0,0,32,32
1683659461686,BIPN 102,A02,193438,Staff,18,0,32,14
1683659462714,BIPN 106,A01,193450,Reyes Gonzalez; Catalina,0,2,40,40
1683659463743,BIPN 134,A01,193465,Cooke; James Edward,0,0,32,32
1683659463743,BIPN 134,A02,193474,Cooke; James Edward,25,0,32,7
1683659463743,BIPN 134,A03,193485,Cooke; James Edward,29,0,32,3
1683659463743,BIPN 134,A04,193486,Cooke; James Edward,20,0,32,12
1683659463743,BIPN 134,A05,193491,Cooke; James Edward,31,0,32,1
1683659463743,BIPN 134,A06,193501,Cooke; James Edward,30,0,32,2
1683659463743,BIPN 134,A07,193510,Cooke; James Edward,29,0,32,3
1683659465792,BISP 194,A00,222522,Staff,14,0,32,18
1683659466818,CAT 124,A01,202407,Staff,19,0,25,6
1683659467842,CAT 125,A00,202408,Marchisotto; Jennifer Anne,2,0,20,18
1683659468866,CAT 125R,A00,202409,Smith; Lauryn Alissa,0,11,20,20
1683659468866,CAT 125R,B00,202410,Morales; Celeste Georgianna,0,11,20,20
1683659468866,CAT 125R,C00,202411,Irwin; Matthew Joseph,0,12,20,20
1683659469893,CENG 15,A01,204712,Yang; Kesong,0,1,0,0
1683659470916,CENG 114,A00,202070,Jahed Motlagh; Zeinab,5,0,20,15
1683659471940,CGS 105,A00,185477,Wesling; Megan E.,24,0,40,16
1683659472966,CGS 106,A00,185494,Staff,11,0,22,11
1683659473991,CGS 108,A00,185495,Staff,14,0,20,6
1683659475016,CGS 114,A00,185496,Staff,13,0,18,5
1683659476041,CGS 119,A00,185501,Staff,15,0,20,5
1683659477065,CGS 120,A00,185511,Staff,12,0,20,8
1683659478090,CHEM 4,A01,184675,Bussey; Thomas J,97,0,100,3
1683659479119,CHEM 6A,A01,184677,Staff,32,0,60,28
1683659480144,CHEM 6B,A01,184679,Staff,63,0,100,37
1683659481168,CHEM 6C,A01,184681,Bussey; Thomas J,0,0,50,50
1683659481168,CHEM 6C,A02,184682,Bussey; Thomas J,32,0,50,18
1683659482195,CHEM 40A,A01,184684,Albizati; Kim F.,34,0,100,66
1683659483222,CHEM 40B,A01,184686,Albizati; Kim F.,0,22,100,100
1683659484248,CHEM 41B,A01,184690,Staff,51,0,100,49
1683659485272,COGS 3,A01,184715,Boyle; Mary E. T.,0,27,40,40
1683659486295,COGS 14B,A01,185172,Staff,0,14,38,38
1683659487321,COGS 18,A01,184736,Staff,14,0,80,66
1683659488344,COGS 100,A01,184932,Staff,0,7,73,73
1683659489369,COGS 101A,A01,184935,Staff,0,39,30,30
1683659490394,COGS 101B,A01,184944,Staff,0,2,30,30
1683659491418,COGS 101C,A01,184946,Staff,0,10,30,30
1683659492501,COGS 102A,A01,184951,Johnson; Christine M.,2,0,40,38
1683659493527,COGS 107B,A01,184953,Mooshagian; Eric Frederick,0,51,40,40
1683659494555,COGS 118B,A01,184959,Gupta; Anjum,0,49,40,40
1683659495582,COGS 153,A00,184961,Staff,0,16,30,30
1683659496606,COGS 177,A00,184962,Staff,0,21,30,30
1683659497636,COGS 187A,A01,184969,Boyle; Mary E. T.,0,19,40,40
1683659498661,COMM 10,A01,185174,Staff,0,5,25,25
1683659498661,COMM 10,A02,185189,Staff,0,2,25,25
1683659498661,COMM 10,A03,269821,Staff,0,1,0,0
1683659499686,COMM 100B,A01,185475,Staff,0,1,0,2
1683659499686,COMM 100B,A02,185476,Staff,12,0,25,13
1683659500714,COMM 100C,A01,185314,Staff,1,0,25,24
1683659500714,COMM 100C,A02,185327,Staff,18,0,25,7
1683659501740,COMM 110M,A00,185349,Staff,0,0,40,40
1683659502767,COMM 113T,A00,185352,Staff,25,0,40,15
1683659503790,COMM 114I,A00,185353,Staff,31,0,40,9
1683659504814,COMM 131,A00,185354,Staff,17,0,30,13
1683659505843,CSE 8A,A50,185358,Cao; Yingjun,0,46,10,10
1683659506870,CSE 8B,A01,185362,Staff,0,48,50,50
1683659507898,CSE 11,A01,185416,Cao; Yingjun,0,91,10,10
1683659508926,CSE 20,A01,185445,Briones; Jor-el Thomas Caparas,4,0,25,21
1683659509958,CSE 21,A01,185447,Staff,9,0,50,41
1683659510982,CSE 101,A01,185451,Staff,0,13,50,50
1683659510982,CSE 101,B01,185453,Jones; Miles E,0,14,50,50
1683659513036,CSE 141,A01,185458,Eldon; John,16,0,100,84
1683659514060,CSE 141L,A01,185461,Eldon; John,8,0,100,92
1683659515085,CSE 142,A01,185463,Staff,34,0,60,26
1683659515085,CSE 142,B01,201355,Staff,0,7,60,60
1683659516108,CSE 142L,A01,185470,Staff,34,0,60,26
1683659516108,CSE 142L,B01,201417,Staff,0,6,60,60
1683659517135,CSE 190,A00,201433,Staff,32,0,49,17
1683659518158,DOC 1,A01,259136,Strom; Megan C.,7,0,15,8
1683659518158,DOC 1,A02,259137,Strom; Megan C.,14,0,15,1
1683659518158,DOC 1,A03,259138,Strom; Megan C.,14,0,15,1
1683659518158,DOC 1,A04,259139,Strom; Megan C.,14,0,15,1
1683659519181,DOC 100D,A00,259140,Pass; Natalye Joann,14,0,25,11
1683659520205,DSGN 1,A01,184749,Rill; Bryan,0,26,30,30
1683659521227,DSGN 100,A01,185168,Staff,0,2,25,25
1683659522251,ECE 5,A01,185626,Morris; Karcher William,0,11,0,0
1683659523280,ECE 101,A01,185628,Staff,14,0,70,56
1683659524308,ECE 107,A01,185635,Baghdadchi; Saharnaz,0,0,20,20
1683659524308,ECE 107,A02,185638,Baghdadchi; Saharnaz,2,0,20,18
1683659525336,ECE 148,A01,185647,Silberman; Jack,0,0,16,16
1683659526361,ECON 1,A01,185537,Crane; Meredith Helen,54,0,70,16
1683659527385,ECON 3,A01,185549,Crane; Meredith Helen,29,0,70,41
1683659528408,ECON 4,A01,203354,Anderson; John Charles,0,5,10,10
1683659529433,ECON 100A,A01,185574,Staff,0,5,40,40
1683659530464,ECON 100B,A01,185576,Staff,0,12,50,50
1683659531494,ECON 100C,A01,185589,Newhouse; Herbert S,30,0,70,40
1683659532518,ECON 105,A00,185608,Vespa; Emanuel Ignacio,19,0,35,16
1683659533542,ECON 109,A01,185610,Shishkin; Denis,9,0,35,26
1683659534571,ECON 110A,A01,185612,Staff,9,0,40,31
1683659535595,ECON 120A,A01,185615,Staff,20,0,40,20
1683659536623,ECON 120C,A01,185617,Sun; Yixiao,0,20,70,70
1683659537647,ECON 144,A00,203346,Squires; Dale E,2,0,35,33
1683659538676,ECON 171,A01,203349,Newhouse; Herbert S,0,1,35,35
1683659539702,ECON 173A,A01,185621,Toda; Alexis Akira,20,0,35,15
1683659540728,EDS 25,A01,202413,Staff,0,1,0,0
1683659540728,EDS 25,A02,202414,Staff,0,1,0,0
1683659540728,EDS 25,A03,202415,Staff,0,0,0,0
1683659540728,EDS 25,A04,202416,Staff,0,1,0,0
1683659540728,EDS 25,A05,202439,Staff,0,0,0,0
1683659540728,EDS 25,A06,202440,Staff,0,0,0,0
1683659540728,EDS 25,B01,202631,Staff,0,0,0,0
1683659540728,EDS 25,B02,202632,Staff,0,0,0,0
1683659540728,EDS 25,B03,202639,Staff,0,0,0,0
1683659540728,EDS 25,B04,202640,Staff,0,0,0,0
1683659540728,EDS 25,B05,202643,Staff,0,0,0,0
1683659540728,EDS 25,B06,202644,Staff,0,0,0,0
1683659541755,EDS 38,A01,202659,Black; Alison Michelle,24,0,25,1
1683659542780,EDS 115,A00,202652,Staff,18,0,30,12
1683659543804,EDS 125,A00,202649,Staff,13,0,30,17
1683659544826,EDS 126,A01,203332,Staff,30,0,30,0
1683659545854,EDS 139,A00,202838,Staff,16,0,25,9
1683659546878,EDS 146,A01,202655,Staff,14,0,25,11
1683659547907,ENG 15,A00,185667,Staff,0,1,0,0
1683659547907,ENG 15,B00,185672,Staff,0,0,0,0
1683659547907,ENG 15,C00,185675,Staff,0,0,0,0
1683659547907,ENG 15,D00,185682,Staff,0,0,0,0
1683659547907,ENG 15,E00,185684,Staff,0,0,0,0
1683659548930,ETHN 103,A00,185710,Staff,0,8,35,35
1683659549954,ETHN 103A,A00,199228,Man; Simeon S,0,0,9,9
1683659550982,ETHN 109,A00,185711,Staff,16,0,35,19
1683659552010,ETHN 142,A00,185726,Staff,0,4,30,30
1683659553037,ETHN 163J,A00,199229,Man; Simeon S,5,0,8,3
1683659554062,ETHN 168,A00,185727,Staff,7,0,10,3
1683659555087,ETHN 182,A00,185728,Staff,0,0,35,35
1683659556111,ETHN 183,A00,185737,Staff,9,0,18,9
1683659557136,GLBH 111,A01,209361,Burgos; Jose L.,0,0,0,0
1683659559188,HIEU 104,A00,185792,Staff,14,0,20,6
1683659560211,HIEU 115,A00,185800,Staff,0,0,20,20
1683659561236,HIEU 128,A00,185801,Staff,0,9,20,20
1683659562264,HIEU 147,A00,185802,Staff,15,0,20,5
1683659563288,HIEU 154,A00,185823,Staff,11,0,20,9
1683659564314,HILA 102,A00,185826,Staff,14,0,20,6
1683659565340,HILD 2C,A01,185778,Staff,0,13,20,20
1683659566364,HILD 7B,A01,185780,Kwak; Nancy,0,17,32,32
1683659566364,HILD 7B,A02,185781,Kwak; Nancy,0,18,32,32
1683659567391,HILD 30,A01,185791,Staff,12,0,20,8
1683659568418,HISC 119,A00,185830,Golan; Tal,0,9,20,20
1683659569445,HITO 156GS,A00,185831,Patterson; Patrick H.,0,0,0,23
1683659570473,HIUS 103,A00,185832,Man; Simeon S,0,4,20,20
1683659571497,HIUS 117,A00,185836,Kwak; Nancy,2,0,20,18
1683659572525,HIUS 125,A00,185840,Man; Simeon S,0,2,23,23
1683659573550,HIUS 149,A00,185845,Staff,1,0,20,19
1683659574578,HUM 3,A01,185882,Zavodny; Tatiana Sophia,0,8,50,50
1683659574578,HUM 3,B01,185899,Caldwell; Michael Alan,0,18,50,50
1683659575605,HUM 3GS,A00,185900,Patterson; Patrick H.,0,0,0,23
1683659576634,HUM 4,A01,185938,Zroka; Amy Liane,29,0,50,21
1683659576634,HUM 4,B01,185956,Watkins; Eric,0,4,50,50
1683659576634,HUM 4,B02,202209,Watkins; Eric,0,5,50,50
1683659576634,HUM 4,B03,202210,Watkins; Eric,0,5,50,50
1683659577659,HUM 5,A01,185958,West; Geoffrey Scott,0,0,50,50
1683659577659,HUM 5,A02,202215,West; Geoffrey Scott,0,0,50,50
1683659578683,INTL 190,A00,185959,Gagnon; Jeffrey C,0,0,0,9
1683659578683,INTL 190,B00,185960,Lettieri; Michael Joseph,0,0,0,2
1683659579711,JAPN 180,A00,254509,Staff,5,0,30,25
1683659580734,LATI 10,A01,202853,Kennemore; Amy Michelle,4,0,35,31
1683659580734,LATI 10,A02,202854,Kennemore; Amy Michelle,2,0,35,33
1683659580734,LATI 10,A03,270054,Kennemore; Amy Michelle,30,0,30,0
1683659581757,LATI 180,A00,202855,Kennemore; Amy Michelle,11,0,20,9
1683659582784,LAWS 101,A00,201767,Golan; Tal,0,7,40,40
1683659583809,LIFR 1C,A00,185961,Staff,6,0,20,14
1683659584836,LIFR 1CX,A00,185962,Staff,7,0,20,13
1683659585860,LIFR 1D,A00,185963,Staff,7,0,20,13
1683659586882,LIFR 1DX,A00,185964,Staff,7,0,20,13
1683659587909,LIGN 101,A01,186039,Staff,43,0,50,7
1683659588932,LIGN 165,A00,186040,Staff,15,0,50,35
1683659589959,LTCS 108,A00,186041,Staff,5,0,10,5
1683659590983,LTCS 119,A00,186042,Staff,15,0,20,5
1683659592008,LTCS 130,A00,186043,Wesling; Megan E.,15,0,25,10
1683659594056,LTEA 138,A00,186119,Staff,14,0,40,26
1683659595082,LTEN 124,A00,186148,Staff,5,0,25,20
1683659596161,LTEN 178,A00,186149,Staff,7,0,15,8
1683659597185,LTEN 181,A00,186150,Blanco; John D,34,0,40,6
1683659598211,LTWL 120,A00,186160,Staff,20,0,25,5
1683659599235,LTWL 165,A00,186161,Staff,22,0,25,3
1683659600260,LTWR 100,A00,186162,Staff,0,5,15,15
1683659601286,LTWR 102,A00,186163,Doller; Ben,5,0,15,10
1683659602310,MAE 8,A01,186412,Staff,0,0,0,0
1683659603335,MAE 30B,A00,186445,Bahadori; Mohammad Yousef,82,0,100,18
1683659604359,MAE 40,A00,186592,Bewley; Thomas R,10,0,50,40
1683659605383,MAE 101B,A00,186593,Bahadori; Mohammad Yousef,80,0,100,20
1683659606412,MAE 105,A00,186594,Bandaru; Prabhakar,10,0,50,40
1683659607436,MAE 107,A00,186599,Pham; Hieu Tan,0,7,120,120
1683659608459,MAE 148,A01,186660,Silberman; Jack,3,0,16,13
1683659609483,MATH 10A,A01,188095,Staff,0,6,35,35
1683659610508,MATH 10B,A01,188097,Bowers; Adam R.,0,12,30,30
1683659610508,MATH 10B,A02,188099,Bowers; Adam R.,0,11,30,30
1683659610508,MATH 10B,B01,188104,Bowers; Adam R.,0,10,30,30
1683659610508,MATH 10B,B02,188106,Bowers; Adam R.,1,9,30,29
1683659611537,MATH 10C,A01,188111,Staff,0,18,30,30
1683659611537,MATH 10C,A02,188127,Staff,0,19,30,30
1683659611537,MATH 10C,A03,188131,Staff,0,19,30,30
1683659611537,MATH 10C,B01,188218,Staff,17,0,30,13
1683659611537,MATH 10C,B02,188244,Staff,13,0,30,17
1683659611537,MATH 10C,B03,188277,Staff,14,0,30,16
1683659612566,MATH 18,A01,188344,Bach; Quang Tran,18,0,30,12
1683659612566,MATH 18,A02,188345,Bach; Quang Tran,11,0,30,19
1683659612566,MATH 18,B01,188353,Bach; Quang Tran,11,0,30,19
1683659612566,MATH 18,B02,188354,Bach; Quang Tran,19,0,30,11
1683659613590,MATH 20A,A01,188374,Staff,11,0,35,24
1683659614618,MATH 20B,A01,188382,Ohm; Ko Woon,7,0,30,23
1683659614618,MATH 20B,A02,188383,Ohm; Ko Woon,22,0,30,8
1683659614618,MATH 20B,B01,188385,Ohm; Ko Woon,7,0,30,23
1683659614618,MATH 20B,B02,188392,Ohm; Ko Woon,22,0,30,8
1683659615643,MATH 20C,A01,188394,Harel; Guershon,10,0,30,20
1683659615643,MATH 20C,A02,188395,Harel; Guershon,13,0,30,17
1683659615643,MATH 20C,B01,188404,Harel; Guershon,5,0,30,25
1683659615643,MATH 20C,B02,188405,Harel; Guershon,18,0,30,12
1683659616667,MATH 20D,A01,188414,Hammock; Frances H,0,1,30,30
1683659616667,MATH 20D,A02,188415,Hammock; Frances H,0,1,30,30
1683659616667,MATH 20D,B01,188447,Hammock; Frances H,0,1,30,30
1683659616667,MATH 20D,B02,188486,Hammock; Frances H,3,0,30,27
1683659617691,MATH 20E,A01,188649,Staff,21,0,30,9
1683659617691,MATH 20E,A02,188650,Staff,21,0,30,9
1683659617691,MATH 20E,A03,188673,Staff,0,0,30,30
1683659618716,MATH 102,A01,188675,Staff,0,36,35,35
1683659619740,MATH 103B,A01,188681,Staff,3,0,35,32
1683659619740,MATH 103B,B01,188692,Staff,5,0,35,30
1683659620767,MATH 109,A01,188695,Salehi Golsefidy; Alireza,24,0,35,11
1683659620767,MATH 109,A02,188696,Salehi Golsefidy; Alireza,25,0,35,10
1683659621821,MATH 120A,A01,188698,Eggers; John Dietrich,7,0,35,28
1683659622845,MATH 142B,A01,188736,Ioana; Adrian,0,1,30,30
1683659622845,MATH 142B,A02,188741,Ioana; Adrian,0,1,30,30
1683659622845,MATH 142B,A03,188743,Ioana; Adrian,0,1,30,30
1683659623869,MATH 168A,A01,188790,Staff,0,10,35,35
1683659624893,MATH 170A,A01,188803,Nie; Jiawang,0,2,35,35
1683659624893,MATH 170A,A02,188811,Nie; Jiawang,0,0,35,35
1683659624893,MATH 170A,A03,188814,Nie; Jiawang,0,0,35,35
1683659624893,MATH 170A,A04,188815,Nie; Jiawang,9,0,35,26
1683659625916,MATH 193B,A01,188817,Staff,0,0,35,35
1683659625916,MATH 193B,A02,188818,Staff,5,0,35,30
1683659626942,MGT 4,A01,202857,Anderson; John Charles,61,0,80,19
1683659627969,MGT 12,A00,202858,Lindenberger; Wade Douglas,40,0,90,50
1683659628996,MGT 18,A00,202859,Staff,74,0,90,16
1683659630022,MGT 18GS,A00,202860,McKay; Michael J,13,0,28,15
1683659631052,MGT 45,A00,202861,Pecore; Joseph P.,12,0,90,78
1683659632076,MGT 100,A00,202863,Yavorsky; Daniel Ryan,28,0,90,62
1683659633100,MGT 103,A00,202864,Ehrich; Kristine R,0,18,90,90
1683659634125,MGT 112,A00,202865,Ehrich; Kristine R,14,0,90,76
1683659635149,MGT 121A,A00,202868,Staff,90,20,90,0
1683659636176,MGT 131B,A00,202869,Anderson; John Charles,59,0,90,31
1683659637204,MGT 136,A00,202871,Lindenberger; Wade Douglas,83,0,90,7
1683659638226,MGT 164,A00,202873,Staff,0,67,90,91
1683659639250,MGT 164GS,A00,202874,McKay; Mary A,13,0,28,15
1683659640278,MGT 180,A00,202875,Staff,0,50,90,91
1683659641301,MMW 11R,A01,205019,Herbst; Matthew,1,0,30,29
1683659641301,MMW 11R,A02,205026,Herbst; Matthew,29,0,30,1
1683659642329,MMW 15,A01,193512,Chang; Edmond Yi-Teh,0,8,28,28
1683659642329,MMW 15,A02,193513,Chang; Edmond Yi-Teh,0,5,28,28
1683659642329,MMW 15,A03,193514,Chang; Edmond Yi-Teh,0,5,28,28
1683659642329,MMW 15,A04,193515,Chang; Edmond Yi-Teh,0,5,28,28
1683659642329,MMW 15,A05,193516,Chang; Edmond Yi-Teh,0,5,28,28
1683659642329,MMW 15,A06,193517,Chang; Edmond Yi-Teh,0,6,28,28
1683659642329,MMW 15,B01,193519,Chang; Edmond Yi-Teh,0,5,28,28
1683659642329,MMW 15,B02,193520,Chang; Edmond Yi-Teh,0,5,28,28
1683659642329,MMW 15,B03,193521,Chang; Edmond Yi-Teh,0,5,28,28
1683659642329,MMW 15,B04,193522,Chang; Edmond Yi-Teh,0,5,28,28
1683659642329,MMW 15,B05,193523,Chang; Edmond Yi-Teh,0,5,28,28
1683659642329,MMW 15,B06,193524,Chang; Edmond Yi-Teh,0,5,28,28
1683659643353,MMW 122,A01,193526,Rahimi; Babak,0,16,28,28
1683659643353,MMW 122,A02,193527,Rahimi; Babak,0,15,28,28
1683659643353,MMW 122,A03,193528,Rahimi; Babak,0,0,0,0
1683659643353,MMW 122,A04,193529,Rahimi; Babak,0,0,0,0
1683659644381,MUS 1A,A01,186663,Staff,1,20,35,34
1683659645412,MUS 4,A01,186715,Staff,0,12,35,35
1683659646438,MUS 5R,A01,186796,Dubnov; Shlomo,0,17,35,35
1683659647463,MUS 6,A01,186798,Staff,0,5,25,25
1683659648487,MUS 7,A01,186830,Staff,11,0,35,24
1683659649512,MUS 8,A01,186930,Staff,0,26,35,35
1683659650538,MUS 15,A01,186932,Staff,0,16,35,35
1683659650538,MUS 15,B01,186934,Staff,1,17,35,34
1683659651564,MUS 80,A00,186935,Staff,0,0,20,20
1683659651564,MUS 80,B00,186936,Staff,24,0,25,1
1683659652591,NANO 11,A00,204702,Lipomi; Darren John,0,0,0,0
1683659653617,NANO 15,A01,204709,Yang; Kesong,0,1,0,0
1683659654645,NANO 114,A00,202069,Jahed Motlagh; Zeinab,3,0,10,7
1683659655673,PHIL 1,A00,186955,Grush; Rick Scott,31,0,40,9
1683659656701,PHIL 10,A01,186973,Grush; Rick Scott,27,0,35,8
1683659656701,PHIL 10,A02,186974,Grush; Rick Scott,33,0,35,2
1683659657728,PHIL 13,A01,186976,Staff,3,0,35,32
1683659657728,PHIL 13,A02,186977,Staff,16,0,35,19
1683659658751,PHIL 14,A01,186979,Staff,31,0,35,4
1683659658751,PHIL 14,A02,186986,Staff,32,0,35,3
1683659659776,PHIL 28,A01,186988,Staff,16,0,30,14
1683659659776,PHIL 28,A02,186989,Staff,1,0,30,29
1683659659776,PHIL 28,A03,186990,Staff,10,0,30,20
1683659659776,PHIL 28,A04,186991,Staff,26,0,30,4
1683659660803,PHIL 120,A00,186997,Staff,23,0,40,17
1683659661827,PHIL 137,A00,187003,Staff,7,0,40,33
1683659662851,PHIL 150,A00,187015,Staff,47,0,70,23
1683659663874,PHIL 167,A00,187021,Lamey; Andy M.,34,0,40,6
1683659664902,PHIL 174,A01,202226,Staff,17,0,20,3
1683659664902,PHIL 174,A02,202235,Staff,20,0,20,0
1683659665928,PHIL 191A,A00,258918,Staff,0,0,1,1
1683659666955,PHYS 1A,A00,187028,Staff,26,0,60,34
1683659667986,PHYS 1AL,001,187036,Staff,3,0,30,27
1683659667986,PHYS 1AL,002,187049,Staff,18,0,30,12
1683659669010,PHYS 1B,A00,187058,Staff,22,0,60,38
1683659670040,PHYS 1BL,001,187064,Staff,0,1,30,30
1683659670040,PHYS 1BL,002,187070,Staff,4,0,30,26
1683659671063,PHYS 1C,A00,187082,Staff,29,0,120,91
1683659672090,PHYS 1CL,001,187088,Staff,0,9,30,30
1683659672090,PHYS 1CL,002,187089,Staff,0,1,30,30
1683659672090,PHYS 1CL,009,262693,Staff,9,0,30,21
1683659673114,PHYS 2B,A01,187097,Staff,55,0,115,60
1683659674138,PHYS 2C,A01,187099,Staff,63,0,115,52
1683659675161,PHYS 2CL,A01,187101,Staff,5,0,28,23
1683659675161,PHYS 2CL,A02,187102,Staff,15,0,28,13
1683659676185,PHYS 2D,A01,187123,Shotwell; Brian,95,0,115,20
1683659677209,PHYS 4B,A01,187133,Grinstein; Benjamin,35,0,50,15
1683659678233,POLI 10,A00,188819,Staff,0,4,50,50
1683659679256,POLI 11,A00,188827,Staff,43,0,50,7
1683659680280,POLI 13R,A00,188828,Staff,0,1,20,20
1683659681308,POLI 27,A01,188830,Elgin; Samuel Zincke,0,2,70,70
1683659682336,POLI 30,A00,188832,Desposato; Scott,30,0,50,20
1683659683362,POLI 102F,A00,188834,Staff,0,0,40,40
1683659684386,POLI 104A,A00,188852,Staff,13,0,30,17
1683659685413,POLI 104I,A00,188853,Staff,0,7,20,20
1683659686438,POLI 110B,A00,188854,Wiens; David,6,0,20,14
1683659687466,POLI 112A,A00,188855,Wiens; David,3,0,30,27
1683659688494,POLI 117R,A00,188856,Forman; Fonna,0,12,20,20
1683659689521,POLI 118,A00,188857,Ingham; Sean,8,0,20,12
1683659690553,POLI 120G,A00,188858,Staff,8,0,30,22
1683659691576,POLI 131CR,A00,188863,Hoston; Germaine,21,0,50,29
1683659692603,POLI 133,A00,188864,Nellis; Gareth Hb,44,0,50,6
1683659693627,POLI 134D,A00,188865,Desposato; Scott,27,0,30,3
1683659694651,POLI 142A,A00,188871,Gartzke; Erik,21,0,50,29
1683659695675,POLI 142K,A00,188874,Staff,38,0,50,12
1683659696699,POLI 143,A00,188940,Gartzke; Erik,16,0,30,14
1683659697727,POLI 153,A00,188943,Staff,2,0,20,18
1683659698751,POLI 160AA,A00,188944,Staff,11,0,40,29
1683659699833,POLI 170A,A00,188945,Staff,11,0,30,19
1683659701887,PSYC 1,A00,188952,Staff,36,0,90,54
1683659702911,PSYC 2,B00,188953,Staff,19,0,35,16
1683659703937,PSYC 6,A00,188970,Staff,47,0,60,13
1683659704962,PSYC 7,A00,188973,Staff,35,0,45,10
1683659706021,PSYC 60,A01,188980,Rickard; Timothy C.,42,0,60,18
1683659707045,PSYC 70,A01,189001,Steiner; Eric Tomas,22,0,45,23
1683659708073,PSYC 100,A00,189005,Lacefield; Katharine I,0,99,120,120
1683659709098,PSYC 102,A00,189008,Staff,8,0,30,22
1683659710122,PSYC 106,B00,189026,Gorman; Michael R.,27,0,60,33
1683659711147,PSYC 114,B01,189033,Winkielman; Piotr,0,31,30,30
1683659712171,PSYC 131,A00,189036,Anagnostaras; Stephan,0,43,60,60
1683659713196,PSYC 136,A00,189041,Lowe; Angela Beth,0,7,25,25
1683659714223,PSYC 137,A00,189057,Winkielman; Piotr,0,37,25,25
1683659715247,PSYC 144,A00,189107,Wixted; John T,0,11,50,50
1683659717299,PSYC 162,A00,189142,Staff,0,9,85,85
1683659718323,PSYC 172,A00,189144,Gorman; Michael R.,0,6,30,30
1683659720372,PSYC 179,A00,189146,Lacefield; Katharine I,0,87,120,120
1683659721395,PSYC 181,A00,189147,Anagnostaras; Stephan,0,44,90,90
1683659722419,PSYC 190R,A00,189148,Barner; David A.,0,23,80,80
1683659723442,PSYC 191,A00,189275,Rickard; Timothy C.,0,10,25,25
1683659724469,PSYC 193,A00,189276,Chapman; Eddie Nathaniel,0,1,0,4
1683659725498,PSYC 193L,A01,189281,Lowe; Angela Beth,10,0,20,10
1683659725498,PSYC 193L,B01,189285,Staff,28,0,35,7
1683659726521,RELI 149,A00,187137,Rahimi; Babak,7,0,40,33
1683659727549,SE 9,A01,187315,Staff,0,2,18,18
1683659728573,SE 101B,A00,187409,Staff,24,0,30,6
1683659729597,SE 110B,A00,187444,Staff,10,0,40,30
1683659730621,SE 130B,A00,187449,Staff,31,0,40,9
1683659731646,SE 150A,A00,187516,Staff,9,0,20,11
1683659732670,SE 154,A00,187528,Staff,29,0,50,21
1683659733697,SIO 3,A01,258171,Staff,35,0,40,5
1683659734725,SIO 10,A00,187144,Cook; Geoffrey W,0,6,75,75
1683659735748,SIO 45,A00,187152,Cook; Geoffrey W,0,4,100,100
1683659736772,SIO 109R,A00,194486,Staff,0,4,20,20
1683659738822,SIO 187,A01,187233,Kacev; David,12,0,40,28
1683659739852,SOCI 1,A01,258656,Thorpe; Charles Robert,28,0,30,2
1683659739852,SOCI 1,A02,258658,Thorpe; Charles Robert,30,0,30,0
1683659739852,SOCI 1,A03,258661,Thorpe; Charles Robert,25,0,25,0
1683659739852,SOCI 1,A04,258666,Thorpe; Charles Robert,22,0,25,3
1683659739852,SOCI 1,A05,258897,Thorpe; Charles Robert,22,0,25,3
1683659739852,SOCI 1,A06,258898,Thorpe; Charles Robert,25,0,25,0
1683659740879,SOCI 30,A01,258903,Pardo Guerra; Juan Pablo,14,0,30,16
1683659741905,SOCI 102,A00,258904,Staff,9,0,25,16
1683659742931,SOCI 106,A00,258905,Staff,19,0,25,6
1683659743958,SOCI 111,A00,258907,Ribas Norris; Janet Vanesa,26,0,30,4
1683659744985,SOCI 121R,A00,258908,Pardo Guerra; Juan Pablo,8,0,30,22
1683659746010,SOCI 126,A01,203330,Staff,14,0,20,6
1683659747034,SOCI 131,A00,258909,Thorpe; Charles Robert,30,0,60,30
1683659748059,SOCI 135,A00,258910,Payne; Christine Anna,0,11,30,30
1683659749082,SOCI 157,A00,258911,Staff,12,0,30,18
1683659750109,SOCI 184,A00,258912,Staff,25,0,30,5
1683659751133,SOCI 188D,A00,258913,Staff,22,0,30,8
1683659752161,SYN 2,001,187529,Staff,9,0,16,7
1683659752161,SYN 2,002,201452,Staff,0,20,16,16
1683659752161,SYN 2,003,201469,Staff,1,0,16,15
1683659753184,SYN 100,A01,187531,Staff,0,9,20,20
1683659753184,SYN 100,B01,201491,Staff,0,10,20,20
1683659754212,TDAC 1,A00,189286,Walsh; Kim C.,3,0,20,17
1683659754212,TDAC 1,B00,189287,Harting; Carla Kelso,10,0,20,10
1683659755238,TDAC 101,A00,189300,Walsh; Kim C.,16,0,20,4
1683659755238,TDAC 101,B00,189301,Harting; Carla Kelso,18,0,20,2
1683659756265,TDAC 102,A00,189304,Basso; Beatrice,14,0,20,6
1683659757289,TDAC 108,A00,189305,Staff,18,0,20,2
1683659758317,TDDE 131,A00,189310,Staff,19,0,20,1
1683659758317,TDDE 131,B00,189314,Staff,19,0,20,1
1683659758317,TDDE 131,C00,189315,Staff,48,0,50,2
1683659758317,TDDE 131,D00,189316,Staff,14,0,15,1
1683659758317,TDDE 131,E00,204841,Staff,20,0,20,0
1683659759342,TDGE 10,A00,189289,Staff,27,0,50,23
1683659759342,TDGE 10,B00,189290,Havis; Allan,0,0,50,50
1683659760366,TDGE 11,A00,189291,Fulton; Julia,0,4,50,50
1683659760366,TDGE 11,B00,189292,Staff,20,0,25,5
1683659760366,TDGE 11,C00,260270,Staff,0,0,0,0
1683659761389,TDGE 25,A00,189294,Staff,2,0,20,18
1683659762420,TDGE 124,A00,189318,Fulton; Julia,0,8,50,50
1683659763444,TDGE 125,A00,189319,Staff,13,0,25,12
1683659763444,TDGE 125,B00,189320,Staff,23,0,25,2
1683659764471,TDGE 127,A00,189322,Havis; Allan,0,0,50,50
1683659765496,TDHT 101,A00,189323,Staff,18,0,25,7
1683659765496,TDHT 101,B00,189324,Staff,25,0,25,0
1683659766521,TDHT 102,A00,189325,Staff,49,0,50,1
1683659767546,TDMV 1,A00,189295,Arcidiacono; Kristin,20,0,30,10
1683659767546,TDMV 1,B00,189296,Caligagan; Maria T.,24,0,30,6
1683659768572,TDMV 2,A00,189297,Sammartano; Tonnie,27,0,30,3
1683659768572,TDMV 2,B00,189299,Arcidiacono; Kristin,23,0,30,7
1683659769601,TDMV 3,A00,204998,Rincon; Alicia,22,0,30,8
1683659770627,TDMV 120,A00,189458,Sammartano; Tonnie,28,0,30,2
1683659771651,TDMV 138,A00,189541,Jun; Grace Shin Hae,20,0,40,20
1683659772679,TDMV 142,A00,189717,Caligagan; Tony,25,0,30,5
1683659772679,TDMV 142,B00,189718,Caligagan; Maria T.,25,0,30,5
1683659773707,TMC 2,A01,187533,Staff,25,0,25,0
1683659773707,TMC 2,A02,187534,Staff,25,0,25,0
1683659774735,USP 1,A01,187536,Kwak; Nancy,0,16,25,25
1683659775763,USP 5,A01,187538,Staff,9,0,25,16
1683659776790,USP 101,A00,199253,Staff,0,4,0,0
1683659777818,USP 124,A00,187562,Boomhower; Matthew Charles,0,0,30,30
1683659778842,USP 138,A00,187582,Staff,20,0,25,5
1683659779870,USP 152,A01,187597,Staff,3,0,25,22
1683659780895,USP 153,A00,187598,Staff,19,0,25,6
1683659781919,USP 168,A00,187607,Kwak; Nancy,2,0,5,3
1683659782944,USP 173,A00,187619,Staff,4,0,25,21
1683659783968,USP 181,A00,187638,Staff,0,4,25,25
1683659784993,VIS 103,A00,187650,Cruz; Edwin Teddy,18,0,75,57
1683659786018,VIS 110D,A00,187669,Staff,13,0,22,9
1683659787042,VIS 127C,A00,187720,Shen; Kuiyi,67,0,146,79
1683659788065,VIS 149,A00,187731,Yoldas; Pinar,1,14,22,21
1683659789089,VIS 151,A01,188091,Staff,22,0,34,12
1683659789089,VIS 151,A02,188092,Staff,11,0,34,23
1683659790115,VIS 160B,A00,188093,Stalbaum; Brett,0,1,10,10
1683659792166,WCWP 10B,A00,201720,Staff,10,0,15,5
1683659792166,WCWP 10B,B00,201722,Staff,9,0,15,6
1683659793190,WCWP 100,A00,201725,Gagnon; Jeffrey C,0,0,2,2
1683659793190,WCWP 100,B00,201727,Staff,0,4,15,15
1683659796282,ANBI 133,A00,258401,Wilder; Linnea Lorene,34,0,40,6
1683659797308,ANBI 140,A00,258395,Hrvoj Mihic; Branka,18,0,25,7
1683659798335,ANSC 120,A00,258402,Bialecki; Jon Anthony,26,0,40,14
1683659799360,ANSC 144,A00,258400,Staff,12,0,40,28
1683659801408,ANSC 166,A00,258396,Parish; Steven Martin,156,0,175,19
1683659802436,ANSC 180,A00,193533,Staff,8,0,20,12
1683659803514,ANSC 188,A00,258397,Jassal; Aftab,34,0,40,6
1683659804537,ANTH 3,A01,258316,Staff,23,0,30,7
1683659805561,ANTH 5,A00,258394,Semendeferi; Ekaterini,16,0,20,4
1683659806585,ANTH 21,A01,258331,Staff,4,0,40,36
1683659807609,ANTH 103,A00,258398,Varma; Saiba,15,0,25,10
1683659808646,AWP 10,001,202034,Staff,0,0,0,0
1683659808646,AWP 10,002,202035,Staff,0,0,0,0
1683659808646,AWP 10,003,202036,Staff,0,0,0,0
1683659808646,AWP 10,004,202037,Staff,0,0,0,0
1683659808646,AWP 10,005,202038,Staff,0,0,0,0
1683659808646,AWP 10,006,202039,Staff,0,0,0,0
1683659808646,AWP 10,007,202040,Staff,0,0,0,0
1683659808646,AWP 10,008,202041,Staff,0,0,0,0
1683659808646,AWP 10,009,202042,Staff,0,0,0,0
1683659808646,AWP 10,010,202043,Staff,0,0,0,0
1683659808646,AWP 10,011,202044,Staff,0,0,0,0
1683659808646,AWP 10,012,202045,Staff,0,0,0,0
1683659808646,AWP 10,013,202046,Staff,0,0,0,0
1683659808646,AWP 10,014,202047,Staff,0,0,0,0
1683659808646,AWP 10,015,202048,Staff,0,0,0,0
1683659808646,AWP 10,016,202049,Staff,0,0,0,0
1683659808646,AWP 10,017,202050,Staff,0,0,0,0
1683659808646,AWP 10,018,202051,Staff,0,0,0,0
1683659808646,AWP 10,019,202052,Staff,0,0,0,0
1683659808646,AWP 10,020,202053,Staff,0,0,0,0
1683659808646,AWP 10,021,202054,Staff,0,0,0,0
1683659808646,AWP 10,022,202055,Staff,0,0,0,0
1683659808646,AWP 10,023,202056,Staff,0,0,0,0
1683659808646,AWP 10,024,202057,Staff,0,0,0,0
1683659808646,AWP 10,025,202058,Staff,0,0,0,0
1683659808646,AWP 10,026,202059,Staff,0,0,0,0
1683659809674,AWP 102,001,202032,Staff,0,0,0,0
1683659809674,AWP 102,002,202033,Staff,0,0,0,0
1683659810698,BENG 100,A01,254234,Taylor Amos; Alyssa C,31,0,40,9
1683659811722,BENG 196,001,270013,Engler; Adam J.,9999,0,9999,0
1683659812749,BICD 100R,A01,202018,Smith; Laurie,0,7,32,32
1683659812749,BICD 100R,A02,202019,Smith; Laurie,0,3,32,32
1683659812749,BICD 100R,A03,202020,Smith; Laurie,0,1,32,32
1683659812749,BICD 100R,A04,202021,Smith; Laurie,6,0,32,26
1683659812749,BICD 100R,A05,202022,Smith; Laurie,11,0,32,21
1683659813776,BICD 136,A01,193242,Gustafson-Brown; Cindy,0,2,32,32
1683659813776,BICD 136,A02,193244,Gustafson-Brown; Cindy,13,0,32,19
1683659814801,BIEB 102,A01,193249,Butler; Shannon Rhey,1,2,32,31
1683659814801,BIEB 102,A02,193251,Butler; Shannon Rhey,0,0,32,32
1683659814801,BIEB 102,A03,193253,Butler; Shannon Rhey,0,0,32,32
1683659814801,BIEB 102,A04,193255,Butler; Shannon Rhey,14,0,32,18
1683659814801,BIEB 102,A05,193265,Butler; Shannon Rhey,26,0,32,6
1683659814801,BIEB 102,A06,193269,Butler; Shannon Rhey,14,0,32,18
1683659816859,BIEB 150,A01,193274,Staff,0,0,32,32
1683659816859,BIEB 150,A02,193285,Staff,24,0,32,8
1683659817884,BIEB 194,A00,193286,Kurle; Carolyn M.,20,0,32,12
1683659818910,BILD 1,A01,192291,Staff,15,0,32,17
1683659818910,BILD 1,A02,192292,Staff,30,0,32,2
1683659818910,BILD 1,B01,192520,Reuther; Keefe,0,1,0,0
1683659818910,BILD 1,B02,192532,Reuther; Keefe,0,1,0,0
1683659819935,BILD 3,A01,192556,Butler; Shannon Rhey,0,0,32,32
1683659819935,BILD 3,A02,192581,Butler; Shannon Rhey,1,0,32,31
1683659819935,BILD 3,A03,192611,Butler; Shannon Rhey,21,0,32,11
1683659819935,BILD 3,A04,192612,Butler; Shannon Rhey,24,0,32,8
1683659819935,BILD 3,A05,192613,Butler; Shannon Rhey,26,0,32,6
1683659819935,BILD 3,A06,192679,Butler; Shannon Rhey,27,0,32,5
1683659819935,BILD 3,A07,192682,Butler; Shannon Rhey,20,0,32,12
1683659820963,BILD 4,A01,192836,Reuther; Keefe,1,0,24,23
1683659820963,BILD 4,A02,193044,Reuther; Keefe,4,0,24,20
1683659821987,BILD 10,A01,193142,Gustafson-Brown; Cindy,29,0,32,3
1683659821987,BILD 10,A02,193149,Gustafson-Brown; Cindy,31,0,32,1
1683659823015,BIMM 100,A01,193301,Staff,0,6,32,32
1683659823015,BIMM 100,A02,193312,Staff,0,7,32,32
1683659823015,BIMM 100,A03,193323,Staff,0,9,32,32
1683659824043,BIMM 101,A01,193329,McDonnell; Lisa Marie,0,4,24,24
1683659824043,BIMM 101,A02,193339,McDonnell; Lisa Marie,1,3,24,23
1683659824043,BIMM 101,B01,193354,McDonnell; Lisa Marie,0,4,24,24
1683659824043,BIMM 101,B02,193357,McDonnell; Lisa Marie,0,3,24,24
1683659825067,BIMM 110,A01,193377,Tat; John,0,11,32,32
1683659825067,BIMM 110,A02,193378,Tat; John,0,10,32,32
1683659826092,BIMM 120,A01,206116,Staff,0,0,32,32
1683659826092,BIMM 120,A02,206117,Staff,6,0,32,26
1683659826092,BIMM 120,A03,206121,Staff,21,0,32,11
1683659827115,BIPN 100,A01,193393,Park; Ji Young,0,15,32,32
1683659827115,BIPN 100,A02,193402,Park; Ji Young,0,14,32,32
1683659827115,BIPN 100,A03,193413,Park; Ji Young,0,14,32,32
1683659827115,BIPN 100,A04,193414,Park; Ji Young,0,13,32,32
1683659828143,BIPN 102,A01,193429,Staff,0,0,32,32
1683659828143,BIPN 102,A02,193438,Staff,18,0,32,14
1683659829170,BIPN 106,A01,193450,Reyes Gonzalez; Catalina,0,2,40,40
1683659830193,BIPN 134,A01,193465,Cooke; James Edward,0,0,32,32
1683659830193,BIPN 134,A02,193474,Cooke; James Edward,25,0,32,7
1683659830193,BIPN 134,A03,193485,Cooke; James Edward,29,0,32,3
1683659830193,BIPN 134,A04,193486,Cooke; James Edward,20,0,32,12
1683659830193,BIPN 134,A05,193491,Cooke; James Edward,31,0,32,1
1683659830193,BIPN 134,A06,193501,Cooke; James Edward,30,0,32,2
1683659830193,BIPN 134,A07,193510,Cooke; James Edward,29,0,32,3
1683659832246,BISP 194,A00,222522,Staff,14,0,32,18
1683659833272,CAT 124,A01,202407,Staff,19,0,25,6
1683659834300,CAT 125,A00,202408,Marchisotto; Jennifer Anne,2,0,20,18
1683659835329,CAT 125R,A00,202409,Smith; Lauryn Alissa,0,11,20,20
1683659835329,CAT 125R,B00,202410,Morales; Celeste Georgianna,0,11,20,20
1683659835329,CAT 125R,C00,202411,Irwin; Matthew Joseph,0,12,20,20
1683659836355,CENG 15,A01,204712,Yang; Kesong,0,1,0,0
1683659837379,CENG 114,A00,202070,Jahed Motlagh; Zeinab,5,0,20,15
1683659838407,CGS 105,A00,185477,Wesling; Megan E.,24,0,40,16
1683659839431,CGS 106,A00,185494,Staff,11,0,22,11
1683659840454,CGS 108,A00,185495,Staff,14,0,20,6
1683659841478,CGS 114,A00,185496,Staff,13,0,18,5
1683659842502,CGS 119,A00,185501,Staff,15,0,20,5
1683659843527,CGS 120,A00,185511,Staff,12,0,20,8
1683659844557,CHEM 4,A01,184675,Bussey; Thomas J,97,0,100,3
1683659845585,CHEM 6A,A01,184677,Staff,32,0,60,28
1683659846613,CHEM 6B,A01,184679,Staff,63,0,100,37
1683659847642,CHEM 6C,A01,184681,Bussey; Thomas J,0,0,50,50
1683659847642,CHEM 6C,A02,184682,Bussey; Thomas J,32,0,50,18
1683659848668,CHEM 40A,A01,184684,Albizati; Kim F.,34,0,100,66
1683659849693,CHEM 40B,A01,184686,Albizati; Kim F.,0,22,100,100
1683659850718,CHEM 41B,A01,184690,Staff,51,0,100,49
1683659851746,COGS 3,A01,184715,Boyle; Mary E. T.,0,27,40,40
1683659852777,COGS 14B,A01,185172,Staff,0,14,38,38
1683659853804,COGS 18,A01,184736,Staff,14,0,80,66
1683659854831,COGS 100,A01,184932,Staff,0,7,73,73
1683659855860,COGS 101A,A01,184935,Staff,0,39,30,30
1683659856884,COGS 101B,A01,184944,Staff,0,2,30,30
1683659857907,COGS 101C,A01,184946,Staff,0,10,30,30
1683659858933,COGS 102A,A01,184951,Johnson; Christine M.,2,0,40,38
1683659859961,COGS 107B,A01,184953,Mooshagian; Eric Frederick,0,51,40,40
1683659860987,COGS 118B,A01,184959,Gupta; Anjum,0,49,40,40
1683659862011,COGS 153,A00,184961,Staff,0,16,30,30
1683659863036,COGS 177,A00,184962,Staff,0,21,30,30
1683659864061,COGS 187A,A01,184969,Boyle; Mary E. T.,0,19,40,40
1683659865086,COMM 10,A01,185174,Staff,0,5,25,25
1683659865086,COMM 10,A02,185189,Staff,0,2,25,25
1683659865086,COMM 10,A03,269821,Staff,0,1,0,0
1683659866111,COMM 100B,A01,185475,Staff,0,1,0,2
1683659866111,COMM 100B,A02,185476,Staff,12,0,25,13
1683659867142,COMM 100C,A01,185314,Staff,1,0,25,24
1683659867142,COMM 100C,A02,185327,Staff,18,0,25,7
1683659868168,COMM 110M,A00,185349,Staff,0,0,40,40
1683659869194,COMM 113T,A00,185352,Staff,25,0,40,15
1683659870218,COMM 114I,A00,185353,Staff,31,0,40,9
1683659871243,COMM 131,A00,185354,Staff,17,0,30,13
1683659872267,CSE 8A,A50,185358,Cao; Yingjun,0,46,10,10
1683659873291,CSE 8B,A01,185362,Staff,0,48,50,50
1683659874316,CSE 11,A01,185416,Cao; Yingjun,0,91,10,10
1683659875343,CSE 20,A01,185445,Briones; Jor-el Thomas Caparas,4,0,25,21
1683659876371,CSE 21,A01,185447,Staff,9,0,50,41
1683659877397,CSE 101,A01,185451,Staff,0,13,50,50
1683659877397,CSE 101,B01,185453,Jones; Miles E,0,14,50,50
1683659879452,CSE 141,A01,185458,Eldon; John,16,0,100,84
1683659880475,CSE 141L,A01,185461,Eldon; John,8,0,100,92
1683659881500,CSE 142,A01,185463,Staff,34,0,60,26
1683659881500,CSE 142,B01,201355,Staff,0,7,60,60
1683659882528,CSE 142L,A01,185470,Staff,34,0,60,26
1683659882528,CSE 142L,B01,201417,Staff,0,6,60,60
1683659883553,CSE 190,A00,201433,Staff,32,0,49,17
1683659884578,DOC 1,A01,259136,Strom; Megan C.,7,0,15,8
1683659884578,DOC 1,A02,259137,Strom; Megan C.,14,0,15,1
1683659884578,DOC 1,A03,259138,Strom; Megan C.,14,0,15,1
1683659884578,DOC 1,A04,259139,Strom; Megan C.,14,0,15,1
1683659885601,DOC 100D,A00,259140,Pass; Natalye Joann,14,0,25,11
1683659886630,DSGN 1,A01,184749,Rill; Bryan,0,26,30,30
1683659887654,DSGN 100,A01,185168,Staff,0,2,25,25
1683659888682,ECE 5,A01,185626,Morris; Karcher William,0,11,0,0
1683659889706,ECE 101,A01,185628,Staff,14,0,70,56
1683659890731,ECE 107,A01,185635,Baghdadchi; Saharnaz,0,0,20,20
1683659890731,ECE 107,A02,185638,Baghdadchi; Saharnaz,2,0,20,18
1683659891757,ECE 148,A01,185647,Silberman; Jack,0,0,16,16
1683659892784,ECON 1,A01,185537,Crane; Meredith Helen,54,0,70,16
1683659893812,ECON 3,A01,185549,Crane; Meredith Helen,29,0,70,41
1683659894840,ECON 4,A01,203354,Anderson; John Charles,0,5,10,10
1683659895869,ECON 100A,A01,185574,Staff,0,5,40,40
1683659896894,ECON 100B,A01,185576,Staff,0,12,50,50
1683659897919,ECON 100C,A01,185589,Newhouse; Herbert S,30,0,70,40
1683659898945,ECON 105,A00,185608,Vespa; Emanuel Ignacio,19,0,35,16
1683659899970,ECON 109,A01,185610,Shishkin; Denis,9,0,35,26
1683659900996,ECON 110A,A01,185612,Staff,9,0,40,31
1683659902020,ECON 120A,A01,185615,Staff,20,0,40,20
1683659903043,ECON 120C,A01,185617,Sun; Yixiao,0,20,70,70
1683659904071,ECON 144,A00,203346,Squires; Dale E,2,0,35,33
1683659905097,ECON 171,A01,203349,Newhouse; Herbert S,0,1,35,35
1683659906125,ECON 173A,A01,185621,Toda; Alexis Akira,20,0,35,15
1683659907211,EDS 25,A01,202413,Staff,0,1,0,0
1683659907211,EDS 25,A02,202414,Staff,0,1,0,0
1683659907211,EDS 25,A03,202415,Staff,0,0,0,0
1683659907211,EDS 25,A04,202416,Staff,0,1,0,0
1683659907211,EDS 25,A05,202439,Staff,0,0,0,0
1683659907211,EDS 25,A06,202440,Staff,0,0,0,0
1683659907211,EDS 25,B01,202631,Staff,0,0,0,0
1683659907211,EDS 25,B02,202632,Staff,0,0,0,0
1683659907211,EDS 25,B03,202639,Staff,0,0,0,0
1683659907211,EDS 25,B04,202640,Staff,0,0,0,0
1683659907211,EDS 25,B05,202643,Staff,0,0,0,0
1683659907211,EDS 25,B06,202644,Staff,0,0,0,0
1683659908237,EDS 38,A01,202659,Black; Alison Michelle,24,0,25,1
1683659909264,EDS 115,A00,202652,Staff,18,0,30,12
1683659910288,EDS 125,A00,202649,Staff,13,0,30,17
1683659911314,EDS 126,A01,203332,Staff,30,0,30,0
1683659912338,EDS 139,A00,202838,Staff,16,0,25,9
1683659913366,EDS 146,A01,202655,Staff,14,0,25,11
1683659914390,ENG 15,A00,185667,Staff,0,1,0,0
1683659914390,ENG 15,B00,185672,Staff,0,0,0,0
1683659914390,ENG 15,C00,185675,Staff,0,0,0,0
1683659914390,ENG 15,D00,185682,Staff,0,0,0,0
1683659914390,ENG 15,E00,185684,Staff,0,0,0,0
1683659915414,ETHN 103,A00,185710,Staff,0,8,35,35
1683659916442,ETHN 103A,A00,199228,Man; Simeon S,0,0,9,9
1683659917469,ETHN 109,A00,185711,Staff,16,0,35,19
1683659918496,ETHN 142,A00,185726,Staff,0,4,30,30
1683659919524,ETHN 163J,A00,199229,Man; Simeon S,5,0,8,3
1683659920546,ETHN 168,A00,185727,Staff,7,0,10,3
1683659921570,ETHN 182,A00,185728,Staff,0,0,35,35
1683659922595,ETHN 183,A00,185737,Staff,9,0,18,9
1683659923620,GLBH 111,A01,209361,Burgos; Jose L.,0,0,0,0
1683659925667,HIEU 104,A00,185792,Staff,14,0,20,6
1683659926690,HIEU 115,A00,185800,Staff,0,0,20,20
1683659927713,HIEU 128,A00,185801,Staff,0,9,20,20
1683659928738,HIEU 147,A00,185802,Staff,15,0,20,5
1683659929763,HIEU 154,A00,185823,Staff,11,0,20,9
1683659930790,HILA 102,A00,185826,Staff,14,0,20,6
1683659931813,HILD 2C,A01,185778,Staff,0,13,20,20
1683659932838,HILD 7B,A01,185780,Kwak; Nancy,0,17,32,32
1683659932838,HILD 7B,A02,185781,Kwak; Nancy,0,18,32,32
1683659933864,HILD 30,A01,185791,Staff,12,0,20,8
1683659934888,HISC 119,A00,185830,Golan; Tal,0,9,20,20
1683659935912,HITO 156GS,A00,185831,Patterson; Patrick H.,0,0,0,23
1683659936936,HIUS 103,A00,185832,Man; Simeon S,0,4,20,20
1683659937962,HIUS 117,A00,185836,Kwak; Nancy,2,0,20,18
1683659938990,HIUS 125,A00,185840,Man; Simeon S,0,2,23,23
1683659940014,HIUS 149,A00,185845,Staff,1,0,20,19
1683659941043,HUM 3,A01,185882,Zavodny; Tatiana Sophia,0,8,50,50
1683659941043,HUM 3,B01,185899,Caldwell; Michael Alan,0,18,50,50
1683659942067,HUM 3GS,A00,185900,Patterson; Patrick H.,0,0,0,23
1683659943094,HUM 4,A01,185938,Zroka; Amy Liane,29,0,50,21
1683659943094,HUM 4,B01,185956,Watkins; Eric,0,4,50,50
1683659943094,HUM 4,B02,202209,Watkins; Eric,0,5,50,50
1683659943094,HUM 4,B03,202210,Watkins; Eric,0,5,50,50
1683659944118,HUM 5,A01,185958,West; Geoffrey Scott,0,0,50,50
1683659944118,HUM 5,A02,202215,West; Geoffrey Scott,0,0,50,50
1683659945146,INTL 190,A00,185959,Gagnon; Jeffrey C,0,0,0,9
1683659945146,INTL 190,B00,185960,Lettieri; Michael Joseph,0,0,0,2
1683659946170,JAPN 180,A00,254509,Staff,5,0,30,25
1683659947195,LATI 10,A01,202853,Kennemore; Amy Michelle,4,0,35,31
1683659947195,LATI 10,A02,202854,Kennemore; Amy Michelle,2,0,35,33
1683659947195,LATI 10,A03,270054,Kennemore; Amy Michelle,30,0,30,0
1683659948220,LATI 180,A00,202855,Kennemore; Amy Michelle,11,0,20,9
1683659949248,LAWS 101,A00,201767,Golan; Tal,0,7,40,40
1683659950273,LIFR 1C,A00,185961,Staff,6,0,20,14
1683659951296,LIFR 1CX,A00,185962,Staff,7,0,20,13
1683659952325,LIFR 1D,A00,185963,Staff,7,0,20,13
1683659953351,LIFR 1DX,A00,185964,Staff,7,0,20,13
1683659954378,LIGN 101,A01,186039,Staff,43,0,50,7
1683659955404,LIGN 165,A00,186040,Staff,15,0,50,35
1683659956427,LTCS 108,A00,186041,Staff,5,0,10,5
1683659957449,LTCS 119,A00,186042,Staff,15,0,20,5
1683659958475,LTCS 130,A00,186043,Wesling; Megan E.,15,0,25,10
1683659960525,LTEA 138,A00,186119,Staff,14,0,40,26
1683659961552,LTEN 124,A00,186148,Staff,5,0,25,20
1683659962578,LTEN 178,A00,186149,Staff,7,0,15,8
1683659963607,LTEN 181,A00,186150,Blanco; John D,34,0,40,6
1683659964632,LTWL 120,A00,186160,Staff,20,0,25,5
1683659965661,LTWL 165,A00,186161,Staff,22,0,25,3
1683659966684,LTWR 100,A00,186162,Staff,0,5,15,15
1683659967708,LTWR 102,A00,186163,Doller; Ben,5,0,15,10
1683659968734,MAE 8,A01,186412,Staff,0,0,0,0
1683659969759,MAE 30B,A00,186445,Bahadori; Mohammad Yousef,82,0,100,18
1683659970783,MAE 40,A00,186592,Bewley; Thomas R,10,0,50,40
1683659971808,MAE 101B,A00,186593,Bahadori; Mohammad Yousef,80,0,100,20
1683659972832,MAE 105,A00,186594,Bandaru; Prabhakar,10,0,50,40
1683659973858,MAE 107,A00,186599,Pham; Hieu Tan,0,7,120,120
1683659974882,MAE 148,A01,186660,Silberman; Jack,3,0,16,13
1683659975907,MATH 10A,A01,188095,Staff,0,6,35,35
1683659976930,MATH 10B,A01,188097,Bowers; Adam R.,0,12,30,30
1683659976930,MATH 10B,A02,188099,Bowers; Adam R.,0,11,30,30
1683659976930,MATH 10B,B01,188104,Bowers; Adam R.,0,10,30,30
1683659976930,MATH 10B,B02,188106,Bowers; Adam R.,1,9,30,29
1683659977959,MATH 10C,A01,188111,Staff,0,18,30,30
1683659977959,MATH 10C,A02,188127,Staff,0,19,30,30
1683659977959,MATH 10C,A03,188131,Staff,0,19,30,30
1683659977959,MATH 10C,B01,188218,Staff,17,0,30,13
1683659977959,MATH 10C,B02,188244,Staff,13,0,30,17
1683659977959,MATH 10C,B03,188277,Staff,14,0,30,16
1683659978988,MATH 18,A01,188344,Bach; Quang Tran,18,0,30,12
1683659978988,MATH 18,A02,188345,Bach; Quang Tran,11,0,30,19
1683659978988,MATH 18,B01,188353,Bach; Quang Tran,11,0,30,19
1683659978988,MATH 18,B02,188354,Bach; Quang Tran,19,0,30,11
1683659980015,MATH 20A,A01,188374,Staff,11,0,35,24
1683659981040,MATH 20B,A01,188382,Ohm; Ko Woon,7,0,30,23
1683659981040,MATH 20B,A02,188383,Ohm; Ko Woon,22,0,30,8
1683659981040,MATH 20B,B01,188385,Ohm; Ko Woon,7,0,30,23
1683659981040,MATH 20B,B02,188392,Ohm; Ko Woon,22,0,30,8
1683659982070,MATH 20C,A01,188394,Harel; Guershon,10,0,30,20
1683659982070,MATH 20C,A02,188395,Harel; Guershon,13,0,30,17
1683659982070,MATH 20C,B01,188404,Harel; Guershon,5,0,30,25
1683659982070,MATH 20C,B02,188405,Harel; Guershon,18,0,30,12
1683659983099,MATH 20D,A01,188414,Hammock; Frances H,0,1,30,30
1683659983099,MATH 20D,A02,188415,Hammock; Frances H,0,1,30,30
1683659983099,MATH 20D,B01,188447,Hammock; Frances H,0,1,30,30
1683659983099,MATH 20D,B02,188486,Hammock; Frances H,3,0,30,27
1683659984127,MATH 20E,A01,188649,Staff,21,0,30,9
1683659984127,MATH 20E,A02,188650,Staff,21,0,30,9
1683659984127,MATH 20E,A03,188673,Staff,0,0,30,30
1683659985152,MATH 102,A01,188675,Staff,0,36,35,35
1683659986179,MATH 103B,A01,188681,Staff,3,0,35,32
1683659986179,MATH 103B,B01,188692,Staff,5,0,35,30
1683659987206,MATH 109,A01,188695,Salehi Golsefidy; Alireza,24,0,35,11
1683659987206,MATH 109,A02,188696,Salehi Golsefidy; Alireza,25,0,35,10
1683659988235,MATH 120A,A01,188698,Eggers; John Dietrich,7,0,35,28
1683659989263,MATH 142B,A01,188736,Ioana; Adrian,0,1,30,30
1683659989263,MATH 142B,A02,188741,Ioana; Adrian,0,1,30,30
1683659989263,MATH 142B,A03,188743,Ioana; Adrian,0,1,30,30
1683659990288,MATH 168A,A01,188790,Staff,0,10,35,35
1683659991316,MATH 170A,A01,188803,Nie; Jiawang,0,2,35,35
1683659991316,MATH 170A,A02,188811,Nie; Jiawang,0,0,35,35
1683659991316,MATH 170A,A03,188814,Nie; Jiawang,0,0,35,35
1683659991316,MATH 170A,A04,188815,Nie; Jiawang,9,0,35,26
1683659992343,MATH 193B,A01,188817,Staff,0,0,35,35
1683659992343,MATH 193B,A02,188818,Staff,5,0,35,30
1683659993368,MGT 4,A01,202857,Anderson; John Charles,61,0,80,19
1683659994392,MGT 12,A00,202858,Lindenberger; Wade Douglas,40,0,90,50
1683659995415,MGT 18,A00,202859,Staff,74,0,90,16
1683659996439,MGT 18GS,A00,202860,McKay; Michael J,13,0,28,15
1683659997463,MGT 45,A00,202861,Pecore; Joseph P.,12,0,90,78
1683659998490,MGT 100,A00,202863,Yavorsky; Daniel Ryan,28,0,90,62
1683659999515,MGT 103,A00,202864,Ehrich; Kristine R,0,18,90,90
1683660000539,MGT 112,A00,202865,Ehrich; Kristine R,14,0,90,76
1683660001567,MGT 121A,A00,202868,Staff,90,20,90,0
1683660002594,MGT 131B,A00,202869,Anderson; John Charles,59,0,90,31
1683660003618,MGT 136,A00,202871,Lindenberger; Wade Douglas,83,0,90,7
1683660004643,MGT 164,A00,202873,Staff,0,67,90,91
1683660005666,MGT 164GS,A00,202874,McKay; Mary A,13,0,28,15
1683660006690,MGT 180,A00,202875,Staff,0,50,90,91
1683660007714,MMW 11R,A01,205019,Herbst; Matthew,1,0,30,29
1683660007714,MMW 11R,A02,205026,Herbst; Matthew,29,0,30,1
1683660008741,MMW 15,A01,193512,Chang; Edmond Yi-Teh,0,8,28,28
1683660008741,MMW 15,A02,193513,Chang; Edmond Yi-Teh,0,5,28,28
1683660008741,MMW 15,A03,193514,Chang; Edmond Yi-Teh,0,5,28,28
1683660008741,MMW 15,A04,193515,Chang; Edmond Yi-Teh,0,5,28,28
1683660008741,MMW 15,A05,193516,Chang; Edmond Yi-Teh,0,5,28,28
1683660008741,MMW 15,A06,193517,Chang; Edmond Yi-Teh,0,6,28,28
1683660008741,MMW 15,B01,193519,Chang; Edmond Yi-Teh,0,5,28,28
1683660008741,MMW 15,B02,193520,Chang; Edmond Yi-Teh,0,5,28,28
1683660008741,MMW 15,B03,193521,Chang; Edmond Yi-Teh,0,5,28,28
1683660008741,MMW 15,B04,193522,Chang; Edmond Yi-Teh,0,5,28,28
1683660008741,MMW 15,B05,193523,Chang; Edmond Yi-Teh,0,5,28,28
1683660008741,MMW 15,B06,193524,Chang; Edmond Yi-Teh,0,5,28,28
1683660009769,MMW 122,A01,193526,Rahimi; Babak,0,16,28,28
1683660009769,MMW 122,A02,193527,Rahimi; Babak,0,15,28,28
1683660009769,MMW 122,A03,193528,Rahimi; Babak,0,0,0,0
1683660009769,MMW 122,A04,193529,Rahimi; Babak,0,0,0,0
1683660010853,MUS 1A,A01,186663,Staff,1,20,35,34
1683660011879,MUS 4,A01,186715,Staff,0,12,35,35
1683660012904,MUS 5R,A01,186796,Dubnov; Shlomo,0,17,35,35
1683660013932,MUS 6,A01,186798,Staff,0,5,25,25
1683660014955,MUS 7,A01,186830,Staff,11,0,35,24
1683660015982,MUS 8,A01,186930,Staff,0,26,35,35
1683660017008,MUS 15,A01,186932,Staff,0,16,35,35
1683660017008,MUS 15,B01,186934,Staff,1,17,35,34
1683660018032,MUS 80,A00,186935,Staff,0,0,20,20
1683660018032,MUS 80,B00,186936,Staff,24,0,25,1
1683660019056,NANO 11,A00,204702,Lipomi; Darren John,0,0,0,0
1683660020080,NANO 15,A01,204709,Yang; Kesong,0,1,0,0
1683660021105,NANO 114,A00,202069,Jahed Motlagh; Zeinab,3,0,10,7
1683660022130,PHIL 1,A00,186955,Grush; Rick Scott,31,0,40,9
1683660023154,PHIL 10,A01,186973,Grush; Rick Scott,27,0,35,8
1683660023154,PHIL 10,A02,186974,Grush; Rick Scott,33,0,35,2
1683660024182,PHIL 13,A01,186976,Staff,3,0,35,32
1683660024182,PHIL 13,A02,186977,Staff,16,0,35,19
1683660025209,PHIL 14,A01,186979,Staff,31,0,35,4
1683660025209,PHIL 14,A02,186986,Staff,32,0,35,3
1683660026237,PHIL 28,A01,186988,Staff,16,0,30,14
1683660026237,PHIL 28,A02,186989,Staff,1,0,30,29
1683660026237,PHIL 28,A03,186990,Staff,10,0,30,20
1683660026237,PHIL 28,A04,186991,Staff,26,0,30,4
1683660027261,PHIL 120,A00,186997,Staff,23,0,40,17
1683660028286,PHIL 137,A00,187003,Staff,7,0,40,33
1683660029313,PHIL 150,A00,187015,Staff,47,0,70,23
1683660030338,PHIL 167,A00,187021,Lamey; Andy M.,34,0,40,6
1683660031362,PHIL 174,A01,202226,Staff,17,0,20,3
1683660031362,PHIL 174,A02,202235,Staff,20,0,20,0
1683660032385,PHIL 191A,A00,258918,Staff,0,0,1,1
1683660033412,PHYS 1A,A00,187028,Staff,26,0,60,34
1683660034439,PHYS 1AL,001,187036,Staff,3,0,30,27
1683660034439,PHYS 1AL,002,187049,Staff,18,0,30,12
1683660035466,PHYS 1B,A00,187058,Staff,22,0,60,38
1683660036491,PHYS 1BL,001,187064,Staff,0,1,30,30
1683660036491,PHYS 1BL,002,187070,Staff,4,0,30,26
1683660037516,PHYS 1C,A00,187082,Staff,29,0,120,91
1683660038545,PHYS 1CL,001,187088,Staff,0,9,30,30
1683660038545,PHYS 1CL,002,187089,Staff,0,1,30,30
1683660038545,PHYS 1CL,009,262693,Staff,9,0,30,21
1683660039568,PHYS 2B,A01,187097,Staff,55,0,115,60
1683660040597,PHYS 2C,A01,187099,Staff,63,0,115,52
1683660041623,PHYS 2CL,A01,187101,Staff,5,0,28,23
1683660041623,PHYS 2CL,A02,187102,Staff,15,0,28,13
1683660042647,PHYS 2D,A01,187123,Shotwell; Brian,95,0,115,20
1683660043671,PHYS 4B,A01,187133,Grinstein; Benjamin,35,0,50,15
1683660044695,POLI 10,A00,188819,Staff,0,4,50,50
1683660045719,POLI 11,A00,188827,Staff,43,0,50,7
1683660046744,POLI 13R,A00,188828,Staff,0,1,20,20
1683660047772,POLI 27,A01,188830,Elgin; Samuel Zincke,0,2,70,70
1683660048795,POLI 30,A00,188832,Desposato; Scott,30,0,50,20
1683660049819,POLI 102F,A00,188834,Staff,0,0,40,40
1683660050845,POLI 104A,A00,188852,Staff,13,0,30,17
1683660051869,POLI 104I,A00,188853,Staff,0,7,20,20
1683660052894,POLI 110B,A00,188854,Wiens; David,6,0,20,14
1683660053917,POLI 112A,A00,188855,Wiens; David,3,0,30,27
1683660054941,POLI 117R,A00,188856,Forman; Fonna,0,12,20,20
1683660055973,POLI 118,A00,188857,Ingham; Sean,8,0,20,12
1683660056997,POLI 120G,A00,188858,Staff,8,0,30,22
1683660058025,POLI 131CR,A00,188863,Hoston; Germaine,21,0,50,29
1683660059050,POLI 133,A00,188864,Nellis; Gareth Hb,44,0,50,6
1683660060075,POLI 134D,A00,188865,Desposato; Scott,27,0,30,3
1683660061102,POLI 142A,A00,188871,Gartzke; Erik,21,0,50,29
1683660062128,POLI 142K,A00,188874,Staff,38,0,50,12
1683660063152,POLI 143,A00,188940,Gartzke; Erik,16,0,30,14
1683660064178,POLI 153,A00,188943,Staff,2,0,20,18
1683660065205,POLI 160AA,A00,188944,Staff,11,0,40,29
1683660066230,POLI 170A,A00,188945,Staff,11,0,30,19
1683660068279,PSYC 1,A00,188952,Staff,36,0,90,54
1683660069306,PSYC 2,B00,188953,Staff,19,0,35,16
1683660070328,PSYC 6,A00,188970,Staff,47,0,60,13
1683660071351,PSYC 7,A00,188973,Staff,35,0,45,10
1683660072374,PSYC 60,A01,188980,Rickard; Timothy C.,42,0,60,18
1683660073400,PSYC 70,A01,189001,Steiner; Eric Tomas,22,0,45,23
1683660074424,PSYC 100,A00,189005,Lacefield; Katharine I,0,99,120,120
1683660075450,PSYC 102,A00,189008,Staff,8,0,30,22
1683660076477,PSYC 106,B00,189026,Gorman; Michael R.,27,0,60,33
1683660077504,PSYC 114,B01,189033,Winkielman; Piotr,0,31,30,30
1683660078528,PSYC 131,A00,189036,Anagnostaras; Stephan,0,43,60,60
1683660079556,PSYC 136,A00,189041,Lowe; Angela Beth,0,7,25,25
1683660080587,PSYC 137,A00,189057,Winkielman; Piotr,0,37,25,25
1683660081611,PSYC 144,A00,189107,Wixted; John T,0,11,50,50
1683660083666,PSYC 162,A00,189142,Staff,0,9,85,85
1683660084694,PSYC 172,A00,189144,Gorman; Michael R.,0,6,30,30
1683660086748,PSYC 179,A00,189146,Lacefield; Katharine I,0,87,120,120
1683660087776,PSYC 181,A00,189147,Anagnostaras; Stephan,0,44,90,90
1683660088808,PSYC 190R,A00,189148,Barner; David A.,0,23,80,80
1683660089832,PSYC 191,A00,189275,Rickard; Timothy C.,0,10,25,25
1683660090857,PSYC 193,A00,189276,Chapman; Eddie Nathaniel,0,1,0,4
1683660091882,PSYC 193L,A01,189281,Lowe; Angela Beth,10,0,20,10
1683660091882,PSYC 193L,B01,189285,Staff,28,0,35,7
1683660092905,RELI 149,A00,187137,Rahimi; Babak,7,0,40,33
1683660093930,SE 9,A01,187315,Staff,0,2,18,18
1683660094954,SE 101B,A00,187409,Staff,24,0,30,6
1683660095978,SE 110B,A00,187444,Staff,10,0,40,30
1683660097002,SE 130B,A00,187449,Staff,31,0,40,9
1683660098025,SE 150A,A00,187516,Staff,9,0,20,11
1683660099050,SE 154,A00,187528,Staff,29,0,50,21
1683660100074,SIO 3,A01,258171,Staff,35,0,40,5
1683660101100,SIO 10,A00,187144,Cook; Geoffrey W,0,6,75,75
1683660102124,SIO 45,A00,187152,Cook; Geoffrey W,0,4,100,100
1683660103148,SIO 109R,A00,194486,Staff,0,4,20,20
1683660105198,SIO 187,A01,187233,Kacev; David,12,0,40,28
1683660106222,SOCI 1,A01,258656,Thorpe; Charles Robert,28,0,30,2
1683660106222,SOCI 1,A02,258658,Thorpe; Charles Robert,30,0,30,0
1683660106222,SOCI 1,A03,258661,Thorpe; Charles Robert,25,0,25,0
1683660106222,SOCI 1,A04,258666,Thorpe; Charles Robert,22,0,25,3
1683660106222,SOCI 1,A05,258897,Thorpe; Charles Robert,22,0,25,3
1683660106222,SOCI 1,A06,258898,Thorpe; Charles Robert,25,0,25,0
1683660107254,SOCI 30,A01,258903,Pardo Guerra; Juan Pablo,14,0,30,16
1683660108277,SOCI 102,A00,258904,Staff,9,0,25,16
1683660109305,SOCI 106,A00,258905,Staff,19,0,25,6
1683660110328,SOCI 111,A00,258907,Ribas Norris; Janet Vanesa,26,0,30,4
1683660111355,SOCI 121R,A00,258908,Pardo Guerra; Juan Pablo,8,0,30,22
1683660112382,SOCI 126,A01,203330,Staff,14,0,20,6
1683660113406,SOCI 131,A00,258909,Thorpe; Charles Robert,30,0,60,30
1683660114485,SOCI 135,A00,258910,Payne; Christine Anna,0,11,30,30
1683660115513,SOCI 157,A00,258911,Staff,12,0,30,18
1683660116540,SOCI 184,A00,258912,Staff,25,0,30,5
1683660117565,SOCI 188D,A00,258913,Staff,22,0,30,8
1683660118592,SYN 2,001,187529,Staff,9,0,16,7
1683660118592,SYN 2,002,201452,Staff,0,20,16,16
1683660118592,SYN 2,003,201469,Staff,1,0,16,15
1683660119620,SYN 100,A01,187531,Staff,0,9,20,20
1683660119620,SYN 100,B01,201491,Staff,0,10,20,20
1683660120644,TDAC 1,A00,189286,Walsh; Kim C.,3,0,20,17
1683660120644,TDAC 1,B00,189287,Harting; Carla Kelso,10,0,20,10
1683660121668,TDAC 101,A00,189300,Walsh; Kim C.,16,0,20,4
1683660121668,TDAC 101,B00,189301,Harting; Carla Kelso,18,0,20,2
1683660122691,TDAC 102,A00,189304,Basso; Beatrice,14,0,20,6
1683660123715,TDAC 108,A00,189305,Staff,18,0,20,2
1683660124742,TDDE 131,A00,189310,Staff,19,0,20,1
1683660124742,TDDE 131,B00,189314,Staff,19,0,20,1
1683660124742,TDDE 131,C00,189315,Staff,48,0,50,2
1683660124742,TDDE 131,D00,189316,Staff,14,0,15,1
1683660124742,TDDE 131,E00,204841,Staff,20,0,20,0
1683660125766,TDGE 10,A00,189289,Staff,27,0,50,23
1683660125766,TDGE 10,B00,189290,Havis; Allan,0,0,50,50
1683660126795,TDGE 11,A00,189291,Fulton; Julia,0,4,50,50
1683660126795,TDGE 11,B00,189292,Staff,20,0,25,5
1683660126795,TDGE 11,C00,260270,Staff,0,0,0,0
1683660127822,TDGE 25,A00,189294,Staff,2,0,20,18
1683660128849,TDGE 124,A00,189318,Fulton; Julia,0,8,50,50
1683660129877,TDGE 125,A00,189319,Staff,13,0,25,12
1683660129877,TDGE 125,B00,189320,Staff,23,0,25,2
1683660130901,TDGE 127,A00,189322,Havis; Allan,0,0,50,50
1683660131925,TDHT 101,A00,189323,Staff,18,0,25,7
1683660131925,TDHT 101,B00,189324,Staff,25,0,25,0
1683660132950,TDHT 102,A00,189325,Staff,49,0,50,1
1683660133977,TDMV 1,A00,189295,Arcidiacono; Kristin,20,0,30,10
1683660133977,TDMV 1,B00,189296,Caligagan; Maria T.,24,0,30,6
1683660135002,TDMV 2,A00,189297,Sammartano; Tonnie,27,0,30,3
1683660135002,TDMV 2,B00,189299,Arcidiacono; Kristin,23,0,30,7
1683660136025,TDMV 3,A00,204998,Rincon; Alicia,22,0,30,8
1683660137049,TDMV 120,A00,189458,Sammartano; Tonnie,28,0,30,2
1683660138075,TDMV 138,A00,189541,Jun; Grace Shin Hae,20,0,40,20
1683660139100,TDMV 142,A00,189717,Caligagan; Tony,25,0,30,5
1683660139100,TDMV 142,B00,189718,Caligagan; Maria T.,25,0,30,5
1683660140127,TMC 2,A01,187533,Staff,25,0,25,0
1683660140127,TMC 2,A02,187534,Staff,25,0,25,0
1683660141152,USP 1,A01,187536,Kwak; Nancy,0,16,25,25
1683660142178,USP 5,A01,187538,Staff,9,0,25,16
1683660143204,USP 101,A00,199253,Staff,0,4,0,0
1683660144229,USP 124,A00,187562,Boomhower; Matthew Charles,0,0,30,30
1683660145255,USP 138,A00,187582,Staff,20,0,25,5
1683660146282,USP 152,A01,187597,Staff,3,0,25,22
1683660147318,USP 153,A00,187598,Staff,19,0,25,6
1683660148343,USP 168,A00,187607,Kwak; Nancy,2,0,5,3
1683660149368,USP 173,A00,187619,Staff,4,0,25,21
1683660150397,USP 181,A00,187638,Staff,0,4,25,25
1683660151420,VIS 103,A00,187650,Cruz; Edwin Teddy,18,0,75,57
1683660152443,VIS 110D,A00,187669,Staff,13,0,22,9
1683660153466,VIS 127C,A00,187720,Shen; Kuiyi,67,0,146,79
1683660154491,VIS 149,A00,187731,Yoldas; Pinar,1,14,22,21
1683660155515,VIS 151,A01,188091,Staff,22,0,34,12
1683660155515,VIS 151,A02,188092,Staff,11,0,34,23
1683660156541,VIS 160B,A00,188093,Stalbaum; Brett,0,1,10,10
1683660158593,WCWP 10B,A00,201720,Staff,10,0,15,5
1683660158593,WCWP 10B,B00,201722,Staff,9,0,15,6
1683660159617,WCWP 100,A00,201725,Gagnon; Jeffrey C,0,0,2,2
1683660159617,WCWP 100,B00,201727,Staff,0,4,15,15
1683660162711,ANBI 133,A00,258401,Wilder; Linnea Lorene,34,0,40,6
1683660163737,ANBI 140,A00,258395,Hrvoj Mihic; Branka,18,0,25,7
1683660164760,ANSC 120,A00,258402,Bialecki; Jon Anthony,26,0,40,14
1683660165787,ANSC 144,A00,258400,Staff,12,0,40,28
1683660167834,ANSC 166,A00,258396,Parish; Steven Martin,156,0,175,19
1683660168860,ANSC 180,A00,193533,Staff,8,0,20,12
1683660169883,ANSC 188,A00,258397,Jassal; Aftab,34,0,40,6
1683660170907,ANTH 3,A01,258316,Staff,23,0,30,7
1683660171939,ANTH 5,A00,258394,Semendeferi; Ekaterini,16,0,20,4
1683660172964,ANTH 21,A01,258331,Staff,4,0,40,36
1683660173992,ANTH 103,A00,258398,Varma; Saiba,15,0,25,10
1683660175018,AWP 10,001,202034,Staff,0,0,0,0
1683660175018,AWP 10,002,202035,Staff,0,0,0,0
1683660175018,AWP 10,003,202036,Staff,0,0,0,0
1683660175018,AWP 10,004,202037,Staff,0,0,0,0
1683660175018,AWP 10,005,202038,Staff,0,0,0,0
1683660175018,AWP 10,006,202039,Staff,0,0,0,0
1683660175018,AWP 10,007,202040,Staff,0,0,0,0
1683660175018,AWP 10,008,202041,Staff,0,0,0,0
1683660175018,AWP 10,009,202042,Staff,0,0,0,0
1683660175018,AWP 10,010,202043,Staff,0,0,0,0
1683660175018,AWP 10,011,202044,Staff,0,0,0,0
1683660175018,AWP 10,012,202045,Staff,0,0,0,0
1683660175018,AWP 10,013,202046,Staff,0,0,0,0
1683660175018,AWP 10,014,202047,Staff,0,0,0,0
1683660175018,AWP 10,015,202048,Staff,0,0,0,0
1683660175018,AWP 10,016,202049,Staff,0,0,0,0
1683660175018,AWP 10,017,202050,Staff,0,0,0,0
1683660175018,AWP 10,018,202051,Staff,0,0,0,0
1683660175018,AWP 10,019,202052,Staff,0,0,0,0
1683660175018,AWP 10,020,202053,Staff,0,0,0,0
1683660175018,AWP 10,021,202054,Staff,0,0,0,0
1683660175018,AWP 10,022,202055,Staff,0,0,0,0
1683660175018,AWP 10,023,202056,Staff,0,0,0,0
1683660175018,AWP 10,024,202057,Staff,0,0,0,0
1683660175018,AWP 10,025,202058,Staff,0,0,0,0
1683660175018,AWP 10,026,202059,Staff,0,0,0,0
1683660176044,AWP 102,001,202032,Staff,0,0,0,0
1683660176044,AWP 102,002,202033,Staff,0,0,0,0
1683660177069,BENG 100,A01,254234,Taylor Amos; Alyssa C,31,0,40,9
1683660178092,BENG 196,001,270013,Engler; Adam J.,9999,0,9999,0
1683660179117,BICD 100R,A01,202018,Smith; Laurie,0,7,32,32
1683660179117,BICD 100R,A02,202019,Smith; Laurie,0,3,32,32
1683660179117,BICD 100R,A03,202020,Smith; Laurie,0,1,32,32
1683660179117,BICD 100R,A04,202021,Smith; Laurie,6,0,32,26
1683660179117,BICD 100R,A05,202022,Smith; Laurie,11,0,32,21
1683660180146,BICD 136,A01,193242,Gustafson-Brown; Cindy,0,2,32,32
1683660180146,BICD 136,A02,193244,Gustafson-Brown; Cindy,13,0,32,19
1683660181171,BIEB 102,A01,193249,Butler; Shannon Rhey,1,2,32,31
1683660181171,BIEB 102,A02,193251,Butler; Shannon Rhey,0,0,32,32
1683660181171,BIEB 102,A03,193253,Butler; Shannon Rhey,0,0,32,32
1683660181171,BIEB 102,A04,193255,Butler; Shannon Rhey,14,0,32,18
1683660181171,BIEB 102,A05,193265,Butler; Shannon Rhey,26,0,32,6
1683660181171,BIEB 102,A06,193269,Butler; Shannon Rhey,14,0,32,18
1683660183225,BIEB 150,A01,193274,Staff,0,0,32,32
1683660183225,BIEB 150,A02,193285,Staff,23,0,32,9
1683660184250,BIEB 194,A00,193286,Kurle; Carolyn M.,20,0,32,12
1683660185278,BILD 1,A01,192291,Staff,15,0,32,17
1683660185278,BILD 1,A02,192292,Staff,30,0,32,2
1683660185278,BILD 1,B01,192520,Reuther; Keefe,0,1,0,0
1683660185278,BILD 1,B02,192532,Reuther; Keefe,0,1,0,0
1683660186307,BILD 3,A01,192556,Butler; Shannon Rhey,0,0,32,32
1683660186307,BILD 3,A02,192581,Butler; Shannon Rhey,1,0,32,31
1683660186307,BILD 3,A03,192611,Butler; Shannon Rhey,21,0,32,11
1683660186307,BILD 3,A04,192612,Butler; Shannon Rhey,24,0,32,8
1683660186307,BILD 3,A05,192613,Butler; Shannon Rhey,26,0,32,6
1683660186307,BILD 3,A06,192679,Butler; Shannon Rhey,27,0,32,5
1683660186307,BILD 3,A07,192682,Butler; Shannon Rhey,20,0,32,12
1683660187336,BILD 4,A01,192836,Reuther; Keefe,1,0,24,23
1683660187336,BILD 4,A02,193044,Reuther; Keefe,4,0,24,20
1683660188364,BILD 10,A01,193142,Gustafson-Brown; Cindy,29,0,32,3
1683660188364,BILD 10,A02,193149,Gustafson-Brown; Cindy,31,0,32,1
1683660189387,BIMM 100,A01,193301,Staff,0,6,32,32
1683660189387,BIMM 100,A02,193312,Staff,0,7,32,32
1683660189387,BIMM 100,A03,193323,Staff,0,9,32,32
1683660190411,BIMM 101,A01,193329,McDonnell; Lisa Marie,0,4,24,24
1683660190411,BIMM 101,A02,193339,McDonnell; Lisa Marie,1,3,24,23
1683660190411,BIMM 101,B01,193354,McDonnell; Lisa Marie,0,4,24,24
1683660190411,BIMM 101,B02,193357,McDonnell; Lisa Marie,0,3,24,24
1683660191438,BIMM 110,A01,193377,Tat; John,0,11,32,32
1683660191438,BIMM 110,A02,193378,Tat; John,0,10,32,32
1683660192464,BIMM 120,A01,206116,Staff,0,0,32,32
1683660192464,BIMM 120,A02,206117,Staff,6,0,32,26
1683660192464,BIMM 120,A03,206121,Staff,21,0,32,11
1683660193491,BIPN 100,A01,193393,Park; Ji Young,0,15,32,32
1683660193491,BIPN 100,A02,193402,Park; Ji Young,0,14,32,32
1683660193491,BIPN 100,A03,193413,Park; Ji Young,0,14,32,32
1683660193491,BIPN 100,A04,193414,Park; Ji Young,0,13,32,32
1683660194520,BIPN 102,A01,193429,Staff,0,0,32,32
1683660194520,BIPN 102,A02,193438,Staff,18,0,32,14
1683660195546,BIPN 106,A01,193450,Reyes Gonzalez; Catalina,0,2,40,40
1683660196571,BIPN 134,A01,193465,Cooke; James Edward,0,0,32,32
1683660196571,BIPN 134,A02,193474,Cooke; James Edward,25,0,32,7
1683660196571,BIPN 134,A03,193485,Cooke; James Edward,29,0,32,3
1683660196571,BIPN 134,A04,193486,Cooke; James Edward,20,0,32,12
1683660196571,BIPN 134,A05,193491,Cooke; James Edward,31,0,32,1
1683660196571,BIPN 134,A06,193501,Cooke; James Edward,30,0,32,2
1683660196571,BIPN 134,A07,193510,Cooke; James Edward,29,0,32,3
1683660198626,BISP 194,A00,222522,Staff,14,0,32,18
1683660199651,CAT 124,A01,202407,Staff,19,0,25,6
1683660200676,CAT 125,A00,202408,Marchisotto; Jennifer Anne,2,0,20,18
1683660201700,CAT 125R,A00,202409,Smith; Lauryn Alissa,0,11,20,20
1683660201700,CAT 125R,B00,202410,Morales; Celeste Georgianna,0,11,20,20
1683660201700,CAT 125R,C00,202411,Irwin; Matthew Joseph,0,12,20,20
1683660202727,CENG 15,A01,204712,Yang; Kesong,0,1,0,0
1683660203753,CENG 114,A00,202070,Jahed Motlagh; Zeinab,5,0,20,15
1683660204780,CGS 105,A00,185477,Wesling; Megan E.,24,0,40,16
1683660205806,CGS 106,A00,185494,Staff,11,0,22,11
1683660206831,CGS 108,A00,185495,Staff,14,0,20,6
1683660207855,CGS 114,A00,185496,Staff,13,0,18,5
1683660208881,CGS 119,A00,185501,Staff,15,0,20,5
1683660209910,CGS 120,A00,185511,Staff,12,0,20,8
1683660210933,CHEM 4,A01,184675,Bussey; Thomas J,97,0,100,3
1683660211959,CHEM 6A,A01,184677,Staff,32,0,60,28
1683660212983,CHEM 6B,A01,184679,Staff,63,0,100,37
1683660214011,CHEM 6C,A01,184681,Bussey; Thomas J,0,0,50,50
1683660214011,CHEM 6C,A02,184682,Bussey; Thomas J,32,0,50,18
1683660215038,CHEM 40A,A01,184684,Albizati; Kim F.,34,0,100,66
1683660216065,CHEM 40B,A01,184686,Albizati; Kim F.,0,22,100,100
1683660217091,CHEM 41B,A01,184690,Staff,51,0,100,49
1683660218188,COGS 3,A01,184715,Boyle; Mary E. T.,0,27,40,40
1683660219218,COGS 14B,A01,185172,Staff,0,14,38,38
1683660220240,COGS 18,A01,184736,Staff,14,0,80,66
1683660221264,COGS 100,A01,184932,Staff,0,7,73,73
1683660222290,COGS 101A,A01,184935,Staff,0,39,30,30
1683660223314,COGS 101B,A01,184944,Staff,0,2,30,30
1683660224340,COGS 101C,A01,184946,Staff,0,10,30,30
1683660225363,COGS 102A,A01,184951,Johnson; Christine M.,1,0,40,39
1683660226391,COGS 107B,A01,184953,Mooshagian; Eric Frederick,0,51,40,40
1683660227416,COGS 118B,A01,184959,Gupta; Anjum,0,49,40,40
1683660228443,COGS 153,A00,184961,Staff,0,16,30,30
1683660229467,COGS 177,A00,184962,Staff,0,21,30,30
1683660230495,COGS 187A,A01,184969,Boyle; Mary E. T.,0,19,40,40
1683660231520,COMM 10,A01,185174,Staff,0,5,25,25
1683660231520,COMM 10,A02,185189,Staff,0,2,25,25
1683660231520,COMM 10,A03,269821,Staff,0,1,0,0
1683660232543,COMM 100B,A01,185475,Staff,0,1,0,2
1683660232543,COMM 100B,A02,185476,Staff,12,0,25,13
1683660233571,COMM 100C,A01,185314,Staff,1,0,25,24
1683660233571,COMM 100C,A02,185327,Staff,18,0,25,7
1683660234597,COMM 110M,A00,185349,Staff,0,0,40,40
1683660235621,COMM 113T,A00,185352,Staff,25,0,40,15
1683660236646,COMM 114I,A00,185353,Staff,31,0,40,9
1683660237669,COMM 131,A00,185354,Staff,17,0,30,13
1683660238693,CSE 8A,A50,185358,Cao; Yingjun,0,46,10,10
1683660239716,CSE 8B,A01,185362,Staff,0,48,50,50
1683660240740,CSE 11,A01,185416,Cao; Yingjun,0,91,10,10
1683660241767,CSE 20,A01,185445,Briones; Jor-el Thomas Caparas,4,0,25,21
1683660242791,CSE 21,A01,185447,Staff,9,0,50,41
1683660243817,CSE 101,A01,185451,Staff,0,13,50,50
1683660243817,CSE 101,B01,185453,Jones; Miles E,0,14,50,50
1683660245867,CSE 141,A01,185458,Eldon; John,16,0,100,84
1683660246892,CSE 141L,A01,185461,Eldon; John,8,0,100,92
1683660247916,CSE 142,A01,185463,Staff,34,0,60,26
1683660247916,CSE 142,B01,201355,Staff,0,7,60,60
1683660248941,CSE 142L,A01,185470,Staff,34,0,60,26
1683660248941,CSE 142L,B01,201417,Staff,0,6,60,60
1683660249968,CSE 190,A00,201433,Staff,32,0,49,17
1683660250996,DOC 1,A01,259136,Strom; Megan C.,7,0,15,8
1683660250996,DOC 1,A02,259137,Strom; Megan C.,14,0,15,1
1683660250996,DOC 1,A03,259138,Strom; Megan C.,14,0,15,1
1683660250996,DOC 1,A04,259139,Strom; Megan C.,14,0,15,1
1683660252020,DOC 100D,A00,259140,Pass; Natalye Joann,14,0,25,11
1683660253044,DSGN 1,A01,184749,Rill; Bryan,0,26,30,30
1683660254071,DSGN 100,A01,185168,Staff,0,2,25,25
1683660255095,ECE 5,A01,185626,Morris; Karcher William,0,11,0,0
1683660256123,ECE 101,A01,185628,Staff,14,0,70,56
1683660257147,ECE 107,A01,185635,Baghdadchi; Saharnaz,0,0,20,20
1683660257147,ECE 107,A02,185638,Baghdadchi; Saharnaz,2,0,20,18
1683660258174,ECE 148,A01,185647,Silberman; Jack,0,0,16,16
1683660259198,ECON 1,A01,185537,Crane; Meredith Helen,54,0,70,16
1683660260224,ECON 3,A01,185549,Crane; Meredith Helen,29,0,70,41
1683660261249,ECON 4,A01,203354,Anderson; John Charles,0,5,10,10
1683660262272,ECON 100A,A01,185574,Staff,0,5,40,40
1683660263299,ECON 100B,A01,185576,Staff,0,12,50,50
1683660264324,ECON 100C,A01,185589,Newhouse; Herbert S,30,0,70,40
1683660265348,ECON 105,A00,185608,Vespa; Emanuel Ignacio,19,0,35,16
1683660266376,ECON 109,A01,185610,Shishkin; Denis,9,0,35,26
1683660267404,ECON 110A,A01,185612,Staff,9,0,40,31
1683660268429,ECON 120A,A01,185615,Staff,20,0,40,20
1683660269452,ECON 120C,A01,185617,Sun; Yixiao,0,20,70,70
1683660270476,ECON 144,A00,203346,Squires; Dale E,2,0,35,33
1683660271504,ECON 171,A01,203349,Newhouse; Herbert S,0,1,35,35
1683660272532,ECON 173A,A01,185621,Toda; Alexis Akira,20,0,35,15
1683660273557,EDS 25,A01,202413,Staff,0,1,0,0
1683660273557,EDS 25,A02,202414,Staff,0,1,0,0
1683660273557,EDS 25,A03,202415,Staff,0,0,0,0
1683660273557,EDS 25,A04,202416,Staff,0,1,0,0
1683660273557,EDS 25,A05,202439,Staff,0,0,0,0
1683660273557,EDS 25,A06,202440,Staff,0,0,0,0
1683660273557,EDS 25,B01,202631,Staff,0,0,0,0
1683660273557,EDS 25,B02,202632,Staff,0,0,0,0
1683660273557,EDS 25,B03,202639,Staff,0,0,0,0
1683660273557,EDS 25,B04,202640,Staff,0,0,0,0
1683660273557,EDS 25,B05,202643,Staff,0,0,0,0
1683660273557,EDS 25,B06,202644,Staff,0,0,0,0
1683660274584,EDS 38,A01,202659,Black; Alison Michelle,24,0,25,1
1683660275608,EDS 115,A00,202652,Staff,18,0,30,12
1683660276632,EDS 125,A00,202649,Staff,13,0,30,17
1683660277657,EDS 126,A01,203332,Staff,30,0,30,0
1683660278680,EDS 139,A00,202838,Staff,16,0,25,9
1683660279704,EDS 146,A01,202655,Staff,14,0,25,11
1683660280731,ENG 15,A00,185667,Staff,0,1,0,0
1683660280731,ENG 15,B00,185672,Staff,0,0,0,0
1683660280731,ENG 15,C00,185675,Staff,0,0,0,0
1683660280731,ENG 15,D00,185682,Staff,0,0,0,0
1683660280731,ENG 15,E00,185684,Staff,0,0,0,0
1683660281756,ETHN 103,A00,185710,Staff,0,8,35,35
1683660282780,ETHN 103A,A00,199228,Man; Simeon S,0,0,9,9
1683660283804,ETHN 109,A00,185711,Staff,16,0,35,19
1683660284828,ETHN 142,A00,185726,Staff,0,4,30,30
1683660285855,ETHN 163J,A00,199229,Man; Simeon S,5,0,8,3
1683660286882,ETHN 168,A00,185727,Staff,7,0,10,3
1683660287907,ETHN 182,A00,185728,Staff,0,0,35,35
1683660288934,ETHN 183,A00,185737,Staff,9,0,18,9
1683660289958,GLBH 111,A01,209361,Burgos; Jose L.,0,0,0,0
1683660292011,HIEU 104,A00,185792,Staff,14,0,20,6
1683660293035,HIEU 115,A00,185800,Staff,0,0,20,20
1683660294063,HIEU 128,A00,185801,Staff,0,9,20,20
1683660295086,HIEU 147,A00,185802,Staff,15,0,20,5
1683660296110,HIEU 154,A00,185823,Staff,11,0,20,9
1683660297134,HILA 102,A00,185826,Staff,14,0,20,6
1683660298159,HILD 2C,A01,185778,Staff,0,13,20,20
1683660299188,HILD 7B,A01,185780,Kwak; Nancy,0,17,32,32
1683660299188,HILD 7B,A02,185781,Kwak; Nancy,0,18,32,32
1683660300213,HILD 30,A01,185791,Staff,12,0,20,8
1683660301345,HISC 119,A00,185830,Golan; Tal,0,9,20,20
1683660302369,HITO 156GS,A00,185831,Patterson; Patrick H.,0,0,0,23
1683660303392,HIUS 103,A00,185832,Man; Simeon S,0,4,20,20
1683660304416,HIUS 117,A00,185836,Kwak; Nancy,2,0,20,18
1683660305444,HIUS 125,A00,185840,Man; Simeon S,0,2,23,23
1683660306467,HIUS 149,A00,185845,Staff,1,0,20,19
1683660307495,HUM 3,A01,185882,Zavodny; Tatiana Sophia,0,8,50,50
1683660307495,HUM 3,B01,185899,Caldwell; Michael Alan,0,18,50,50
1683660308518,HUM 3GS,A00,185900,Patterson; Patrick H.,0,0,0,23
1683660309541,HUM 4,A01,185938,Zroka; Amy Liane,29,0,50,21
1683660309541,HUM 4,B01,185956,Watkins; Eric,0,4,50,50
1683660309541,HUM 4,B02,202209,Watkins; Eric,0,5,50,50
1683660309541,HUM 4,B03,202210,Watkins; Eric,0,5,50,50
1683660310566,HUM 5,A01,185958,West; Geoffrey Scott,0,0,50,50
1683660310566,HUM 5,A02,202215,West; Geoffrey Scott,0,0,50,50
1683660311594,INTL 190,A00,185959,Gagnon; Jeffrey C,0,0,0,9
1683660311594,INTL 190,B00,185960,Lettieri; Michael Joseph,0,0,0,2
1683660312618,JAPN 180,A00,254509,Staff,5,0,30,25
1683660313646,LATI 10,A01,202853,Kennemore; Amy Michelle,4,0,35,31
1683660313646,LATI 10,A02,202854,Kennemore; Amy Michelle,2,0,35,33
1683660313646,LATI 10,A03,270054,Kennemore; Amy Michelle,30,0,30,0
1683660314674,LATI 180,A00,202855,Kennemore; Amy Michelle,11,0,20,9
1683660315698,LAWS 101,A00,201767,Golan; Tal,0,7,40,40
1683660316722,LIFR 1C,A00,185961,Staff,6,0,20,14
1683660317749,LIFR 1CX,A00,185962,Staff,7,0,20,13
1683660318776,LIFR 1D,A00,185963,Staff,7,0,20,13
1683660319802,LIFR 1DX,A00,185964,Staff,7,0,20,13
1683660320827,LIGN 101,A01,186039,Staff,43,0,50,7
1683660321906,LIGN 165,A00,186040,Staff,15,0,50,35
1683660322932,LTCS 108,A00,186041,Staff,5,0,10,5
1683660323955,LTCS 119,A00,186042,Staff,15,0,20,5
1683660324982,LTCS 130,A00,186043,Wesling; Megan E.,15,0,25,10
1683660327034,LTEA 138,A00,186119,Staff,14,0,40,26
1683660328057,LTEN 124,A00,186148,Staff,5,0,25,20
1683660329080,LTEN 178,A00,186149,Staff,7,0,15,8
1683660330102,LTEN 181,A00,186150,Blanco; John D,34,0,40,6
1683660331127,LTWL 120,A00,186160,Staff,20,0,25,5
1683660332149,LTWL 165,A00,186161,Staff,22,0,25,3
1683660333180,LTWR 100,A00,186162,Staff,0,5,15,15
1683660334205,LTWR 102,A00,186163,Doller; Ben,5,0,15,10
1683660335230,MAE 8,A01,186412,Staff,0,0,0,0
1683660336286,MAE 30B,A00,186445,Bahadori; Mohammad Yousef,82,0,100,18
1683660337314,MAE 40,A00,186592,Bewley; Thomas R,10,0,50,40
1683660338340,MAE 101B,A00,186593,Bahadori; Mohammad Yousef,80,0,100,20
1683660339367,MAE 105,A00,186594,Bandaru; Prabhakar,10,0,50,40
1683660340395,MAE 107,A00,186599,Pham; Hieu Tan,0,7,120,120
1683660341422,MAE 148,A01,186660,Silberman; Jack,3,0,16,13
1683660342455,MATH 10A,A01,188095,Staff,0,6,35,35
1683660343482,MATH 10B,A01,188097,Bowers; Adam R.,0,12,30,30
1683660343482,MATH 10B,A02,188099,Bowers; Adam R.,0,11,30,30
1683660343482,MATH 10B,B01,188104,Bowers; Adam R.,0,10,30,30
1683660343482,MATH 10B,B02,188106,Bowers; Adam R.,1,9,30,29
1683660344507,MATH 10C,A01,188111,Staff,0,18,30,30
1683660344507,MATH 10C,A02,188127,Staff,0,19,30,30
1683660344507,MATH 10C,A03,188131,Staff,0,19,30,30
1683660344507,MATH 10C,B01,188218,Staff,17,0,30,13
1683660344507,MATH 10C,B02,188244,Staff,13,0,30,17
1683660344507,MATH 10C,B03,188277,Staff,14,0,30,16
1683660345532,MATH 18,A01,188344,Bach; Quang Tran,18,0,30,12
1683660345532,MATH 18,A02,188345,Bach; Quang Tran,11,0,30,19
1683660345532,MATH 18,B01,188353,Bach; Quang Tran,11,0,30,19
1683660345532,MATH 18,B02,188354,Bach; Quang Tran,19,0,30,11
1683660346556,MATH 20A,A01,188374,Staff,11,0,35,24
1683660347581,MATH 20B,A01,188382,Ohm; Ko Woon,7,0,30,23
1683660347581,MATH 20B,A02,188383,Ohm; Ko Woon,22,0,30,8
1683660347581,MATH 20B,B01,188385,Ohm; Ko Woon,7,0,30,23
1683660347581,MATH 20B,B02,188392,Ohm; Ko Woon,22,0,30,8
1683660348610,MATH 20C,A01,188394,Harel; Guershon,10,0,30,20
1683660348610,MATH 20C,A02,188395,Harel; Guershon,13,0,30,17
1683660348610,MATH 20C,B01,188404,Harel; Guershon,5,0,30,25
1683660348610,MATH 20C,B02,188405,Harel; Guershon,18,0,30,12
1683660349638,MATH 20D,A01,188414,Hammock; Frances H,0,1,30,30
1683660349638,MATH 20D,A02,188415,Hammock; Frances H,0,1,30,30
1683660349638,MATH 20D,B01,188447,Hammock; Frances H,0,1,30,30
1683660349638,MATH 20D,B02,188486,Hammock; Frances H,3,0,30,27
1683660350666,MATH 20E,A01,188649,Staff,21,0,30,9
1683660350666,MATH 20E,A02,188650,Staff,21,0,30,9
1683660350666,MATH 20E,A03,188673,Staff,0,0,30,30
1683660351690,MATH 102,A01,188675,Staff,0,36,35,35
1683660352719,MATH 103B,A01,188681,Staff,3,0,35,32
1683660352719,MATH 103B,B01,188692,Staff,5,0,35,30
1683660353744,MATH 109,A01,188695,Salehi Golsefidy; Alireza,24,0,35,11
1683660353744,MATH 109,A02,188696,Salehi Golsefidy; Alireza,25,0,35,10
1683660354770,MATH 120A,A01,188698,Eggers; John Dietrich,7,0,35,28
1683660355796,MATH 142B,A01,188736,Ioana; Adrian,0,1,30,30
1683660355796,MATH 142B,A02,188741,Ioana; Adrian,0,1,30,30
1683660355796,MATH 142B,A03,188743,Ioana; Adrian,0,1,30,30
1683660356820,MATH 168A,A01,188790,Staff,0,10,35,35
1683660357844,MATH 170A,A01,188803,Nie; Jiawang,0,2,35,35
1683660357844,MATH 170A,A02,188811,Nie; Jiawang,0,0,35,35
1683660357844,MATH 170A,A03,188814,Nie; Jiawang,0,0,35,35
1683660357844,MATH 170A,A04,188815,Nie; Jiawang,9,0,35,26
1683660358870,MATH 193B,A01,188817,Staff,0,0,35,35
1683660358870,MATH 193B,A02,188818,Staff,5,0,35,30
1683660359894,MGT 4,A01,202857,Anderson; John Charles,61,0,80,19
1683660360918,MGT 12,A00,202858,Lindenberger; Wade Douglas,40,0,90,50
1683660361947,MGT 18,A00,202859,Staff,74,0,90,16
1683660362973,MGT 18GS,A00,202860,McKay; Michael J,13,0,28,15
1683660363998,MGT 45,A00,202861,Pecore; Joseph P.,12,0,90,78
1683660365022,MGT 100,A00,202863,Yavorsky; Daniel Ryan,28,0,90,62
1683660366047,MGT 103,A00,202864,Ehrich; Kristine R,0,18,90,90
1683660367074,MGT 112,A00,202865,Ehrich; Kristine R,14,0,90,76
1683660368100,MGT 121A,A00,202868,Staff,90,20,90,0
1683660369125,MGT 131B,A00,202869,Anderson; John Charles,59,0,90,31
1683660370148,MGT 136,A00,202871,Lindenberger; Wade Douglas,83,0,90,7
1683660371172,MGT 164,A00,202873,Staff,0,67,90,91
1683660372198,MGT 164GS,A00,202874,McKay; Mary A,13,0,28,15
1683660373221,MGT 180,A00,202875,Staff,0,50,90,91
1683660374248,MMW 11R,A01,205019,Herbst; Matthew,1,0,30,29
1683660374248,MMW 11R,A02,205026,Herbst; Matthew,29,0,30,1
1683660375274,MMW 15,A01,193512,Chang; Edmond Yi-Teh,0,8,28,28
1683660375274,MMW 15,A02,193513,Chang; Edmond Yi-Teh,0,5,28,28
1683660375274,MMW 15,A03,193514,Chang; Edmond Yi-Teh,0,5,28,28
1683660375274,MMW 15,A04,193515,Chang; Edmond Yi-Teh,0,5,28,28
1683660375274,MMW 15,A05,193516,Chang; Edmond Yi-Teh,0,5,28,28
1683660375274,MMW 15,A06,193517,Chang; Edmond Yi-Teh,0,6,28,28
1683660375274,MMW 15,B01,193519,Chang; Edmond Yi-Teh,0,5,28,28
1683660375274,MMW 15,B02,193520,Chang; Edmond Yi-Teh,0,5,28,28
1683660375274,MMW 15,B03,193521,Chang; Edmond Yi-Teh,0,5,28,28
1683660375274,MMW 15,B04,193522,Chang; Edmond Yi-Teh,0,5,28,28
1683660375274,MMW 15,B05,193523,Chang; Edmond Yi-Teh,0,5,28,28
1683660375274,MMW 15,B06,193524,Chang; Edmond Yi-Teh,0,5,28,28
1683660376302,MMW 122,A01,193526,Rahimi; Babak,0,16,28,28
1683660376302,MMW 122,A02,193527,Rahimi; Babak,0,15,28,28
1683660376302,MMW 122,A03,193528,Rahimi; Babak,0,0,0,0
1683660376302,MMW 122,A04,193529,Rahimi; Babak,0,0,0,0
1683660377325,MUS 1A,A01,186663,Staff,1,20,35,34
1683660378348,MUS 4,A01,186715,Staff,0,12,35,35
1683660379372,MUS 5R,A01,186796,Dubnov; Shlomo,0,17,35,35
1683660380396,MUS 6,A01,186798,Staff,0,5,25,25
1683660381420,MUS 7,A01,186830,Staff,11,0,35,24
1683660382447,MUS 8,A01,186930,Staff,0,26,35,35
1683660383471,MUS 15,A01,186932,Staff,0,16,35,35
1683660383471,MUS 15,B01,186934,Staff,1,17,35,34
1683660384498,MUS 80,A00,186935,Staff,0,0,20,20
1683660384498,MUS 80,B00,186936,Staff,24,0,25,1
1683660385525,NANO 11,A00,204702,Lipomi; Darren John,0,0,0,0
1683660386551,NANO 15,A01,204709,Yang; Kesong,0,1,0,0
1683660387575,NANO 114,A00,202069,Jahed Motlagh; Zeinab,3,0,10,7
1683660388598,PHIL 1,A00,186955,Grush; Rick Scott,31,0,40,9
1683660389626,PHIL 10,A01,186973,Grush; Rick Scott,27,0,35,8
1683660389626,PHIL 10,A02,186974,Grush; Rick Scott,33,0,35,2
1683660390664,PHIL 13,A01,186976,Staff,3,0,35,32
1683660390664,PHIL 13,A02,186977,Staff,16,0,35,19
1683660391696,PHIL 14,A01,186979,Staff,31,0,35,4
1683660391696,PHIL 14,A02,186986,Staff,32,0,35,3
1683660392720,PHIL 28,A01,186988,Staff,16,0,30,14
1683660392720,PHIL 28,A02,186989,Staff,1,0,30,29
1683660392720,PHIL 28,A03,186990,Staff,10,0,30,20
1683660392720,PHIL 28,A04,186991,Staff,26,0,30,4
1683660393743,PHIL 120,A00,186997,Staff,23,0,40,17
1683660394770,PHIL 137,A00,187003,Staff,7,0,40,33
1683660395792,PHIL 150,A00,187015,Staff,47,0,70,23
1683660396820,PHIL 167,A00,187021,Lamey; Andy M.,34,0,40,6
1683660397845,PHIL 174,A01,202226,Staff,17,0,20,3
1683660397845,PHIL 174,A02,202235,Staff,20,0,20,0
1683660398872,PHIL 191A,A00,258918,Staff,0,0,1,1
1683660399896,PHYS 1A,A00,187028,Staff,26,0,60,34
1683660400920,PHYS 1AL,001,187036,Staff,3,0,30,27
1683660400920,PHYS 1AL,002,187049,Staff,18,0,30,12
1683660401950,PHYS 1B,A00,187058,Staff,22,0,60,38
1683660402978,PHYS 1BL,001,187064,Staff,0,1,30,30
1683660402978,PHYS 1BL,002,187070,Staff,4,0,30,26
1683660404001,PHYS 1C,A00,187082,Staff,29,0,120,91
1683660405030,PHYS 1CL,001,187088,Staff,0,9,30,30
1683660405030,PHYS 1CL,002,187089,Staff,0,1,30,30
1683660405030,PHYS 1CL,009,262693,Staff,9,0,30,21
1683660406055,PHYS 2B,A01,187097,Staff,55,0,115,60
1683660407082,PHYS 2C,A01,187099,Staff,63,0,115,52
1683660408108,PHYS 2CL,A01,187101,Staff,5,0,28,23
1683660408108,PHYS 2CL,A02,187102,Staff,15,0,28,13
1683660409132,PHYS 2D,A01,187123,Shotwell; Brian,95,0,115,20
1683660410157,PHYS 4B,A01,187133,Grinstein; Benjamin,35,0,50,15
1683660411180,POLI 10,A00,188819,Staff,0,4,50,50
1683660412205,POLI 11,A00,188827,Staff,43,0,50,7
1683660413228,POLI 13R,A00,188828,Staff,0,1,20,20
1683660414254,POLI 27,A01,188830,Elgin; Samuel Zincke,0,2,70,70
1683660415277,POLI 30,A00,188832,Desposato; Scott,30,0,50,20
1683660416307,POLI 102F,A00,188834,Staff,0,0,40,40
1683660417331,POLI 104A,A00,188852,Staff,13,0,30,17
1683660418353,POLI 104I,A00,188853,Staff,0,7,20,20
1683660419378,POLI 110B,A00,188854,Wiens; David,6,0,20,14
1683660420402,POLI 112A,A00,188855,Wiens; David,3,0,30,27
1683660421426,POLI 117R,A00,188856,Forman; Fonna,0,12,20,20
1683660422453,POLI 118,A00,188857,Ingham; Sean,8,0,20,12
1683660423476,POLI 120G,A00,188858,Staff,8,0,30,22
1683660424504,POLI 131CR,A00,188863,Hoston; Germaine,21,0,50,29
1683660425589,POLI 133,A00,188864,Nellis; Gareth Hb,44,0,50,6
1683660426616,POLI 134D,A00,188865,Desposato; Scott,27,0,30,3
1683660427639,POLI 142A,A00,188871,Gartzke; Erik,21,0,50,29
1683660428665,POLI 142K,A00,188874,Staff,38,0,50,12
1683660429692,POLI 143,A00,188940,Gartzke; Erik,16,0,30,14
1683660430716,POLI 153,A00,188943,Staff,2,0,20,18
1683660431740,POLI 160AA,A00,188944,Staff,11,0,40,29
1683660432768,POLI 170A,A00,188945,Staff,11,0,30,19
1683660434820,PSYC 1,A00,188952,Staff,36,0,90,54
1683660435848,PSYC 2,B00,188953,Staff,19,0,35,16
1683660436872,PSYC 6,A00,188970,Staff,47,0,60,13
1683660437899,PSYC 7,A00,188973,Staff,35,0,45,10
1683660438926,PSYC 60,A01,188980,Rickard; Timothy C.,42,0,60,18
1683660439949,PSYC 70,A01,189001,Steiner; Eric Tomas,22,0,45,23
1683660440976,PSYC 100,A00,189005,Lacefield; Katharine I,0,99,120,120
1683660442000,PSYC 102,A00,189008,Staff,8,0,30,22
1683660443028,PSYC 106,B00,189026,Gorman; Michael R.,27,0,60,33
1683660444051,PSYC 114,B01,189033,Winkielman; Piotr,0,31,30,30
1683660445080,PSYC 131,A00,189036,Anagnostaras; Stephan,0,43,60,60
1683660446104,PSYC 136,A00,189041,Lowe; Angela Beth,0,7,25,25
1683660447128,PSYC 137,A00,189057,Winkielman; Piotr,0,37,25,25
1683660448155,PSYC 144,A00,189107,Wixted; John T,0,11,50,50
1683660450207,PSYC 162,A00,189142,Staff,0,9,85,85
1683660451231,PSYC 172,A00,189144,Gorman; Michael R.,0,6,30,30
1683660453283,PSYC 179,A00,189146,Lacefield; Katharine I,0,87,120,120
1683660454307,PSYC 181,A00,189147,Anagnostaras; Stephan,0,44,90,90
1683660455334,PSYC 190R,A00,189148,Barner; David A.,0,23,80,80
1683660456361,PSYC 191,A00,189275,Rickard; Timothy C.,0,10,25,25
1683660457384,PSYC 193,A00,189276,Chapman; Eddie Nathaniel,0,1,0,4
1683660458412,PSYC 193L,A01,189281,Lowe; Angela Beth,10,0,20,10
1683660458412,PSYC 193L,B01,189285,Staff,28,0,35,7
1683660459441,RELI 149,A00,187137,Rahimi; Babak,7,0,40,33
1683660460465,SE 9,A01,187315,Staff,0,2,18,18
1683660461489,SE 101B,A00,187409,Staff,24,0,30,6
1683660462513,SE 110B,A00,187444,Staff,10,0,40,30
1683660463538,SE 130B,A00,187449,Staff,31,0,40,9
1683660464565,SE 150A,A00,187516,Staff,9,0,20,11
1683660465589,SE 154,A00,187528,Staff,29,0,50,21
1683660466613,SIO 3,A01,258171,Staff,35,0,40,5
1683660467637,SIO 10,A00,187144,Cook; Geoffrey W,0,6,75,75
1683660468665,SIO 45,A00,187152,Cook; Geoffrey W,0,4,100,100
1683660469692,SIO 109R,A00,194486,Staff,0,4,20,20
1683660471742,SIO 187,A01,187233,Kacev; David,12,0,40,28
1683660472768,SOCI 1,A01,258656,Thorpe; Charles Robert,28,0,30,2
1683660472768,SOCI 1,A02,258658,Thorpe; Charles Robert,30,0,30,0
1683660472768,SOCI 1,A03,258661,Thorpe; Charles Robert,25,0,25,0
1683660472768,SOCI 1,A04,258666,Thorpe; Charles Robert,22,0,25,3
1683660472768,SOCI 1,A05,258897,Thorpe; Charles Robert,22,0,25,3
1683660472768,SOCI 1,A06,258898,Thorpe; Charles Robert,25,0,25,0
1683660473801,SOCI 30,A01,258903,Pardo Guerra; Juan Pablo,14,0,30,16
1683660474826,SOCI 102,A00,258904,Staff,9,0,25,16
1683660475851,SOCI 106,A00,258905,Staff,19,0,25,6
1683660476879,SOCI 111,A00,258907,Ribas Norris; Janet Vanesa,26,0,30,4
1683660477902,SOCI 121R,A00,258908,Pardo Guerra; Juan Pablo,8,0,30,22
1683660478930,SOCI 126,A01,203330,Staff,14,0,20,6
1683660479954,SOCI 131,A00,258909,Thorpe; Charles Robert,30,0,60,30
1683660480985,SOCI 135,A00,258910,Payne; Christine Anna,0,11,30,30
1683660482012,SOCI 157,A00,258911,Staff,12,0,30,18
1683660483036,SOCI 184,A00,258912,Staff,25,0,30,5
1683660484064,SOCI 188D,A00,258913,Staff,22,0,30,8
1683660485088,SYN 2,001,187529,Staff,9,0,16,7
1683660485088,SYN 2,002,201452,Staff,0,20,16,16
1683660485088,SYN 2,003,201469,Staff,1,0,16,15
1683660486112,SYN 100,A01,187531,Staff,0,9,20,20
1683660486112,SYN 100,B01,201491,Staff,0,10,20,20
1683660487140,TDAC 1,A00,189286,Walsh; Kim C.,3,0,20,17
1683660487140,TDAC 1,B00,189287,Harting; Carla Kelso,10,0,20,10
1683660488167,TDAC 101,A00,189300,Walsh; Kim C.,16,0,20,4
1683660488167,TDAC 101,B00,189301,Harting; Carla Kelso,18,0,20,2
1683660489194,TDAC 102,A00,189304,Basso; Beatrice,14,0,20,6
1683660490217,TDAC 108,A00,189305,Staff,18,0,20,2
1683660491247,TDDE 131,A00,189310,Staff,19,0,20,1
1683660491247,TDDE 131,B00,189314,Staff,19,0,20,1
1683660491247,TDDE 131,C00,189315,Staff,48,0,50,2
1683660491247,TDDE 131,D00,189316,Staff,14,0,15,1
1683660491247,TDDE 131,E00,204841,Staff,20,0,20,0
1683660492271,TDGE 10,A00,189289,Staff,27,0,50,23
1683660492271,TDGE 10,B00,189290,Havis; Allan,0,0,50,50
1683660493296,TDGE 11,A00,189291,Fulton; Julia,0,4,50,50
1683660493296,TDGE 11,B00,189292,Staff,20,0,25,5
1683660493296,TDGE 11,C00,260270,Staff,0,0,0,0
1683660494323,TDGE 25,A00,189294,Staff,2,0,20,18
1683660495350,TDGE 124,A00,189318,Fulton; Julia,0,8,50,50
1683660496378,TDGE 125,A00,189319,Staff,13,0,25,12
1683660496378,TDGE 125,B00,189320,Staff,23,0,25,2
1683660497406,TDGE 127,A00,189322,Havis; Allan,0,0,50,50
1683660498431,TDHT 101,A00,189323,Staff,18,0,25,7
1683660498431,TDHT 101,B00,189324,Staff,25,0,25,0
1683660499458,TDHT 102,A00,189325,Staff,49,0,50,1
1683660500483,TDMV 1,A00,189295,Arcidiacono; Kristin,20,0,30,10
1683660500483,TDMV 1,B00,189296,Caligagan; Maria T.,24,0,30,6
1683660501511,TDMV 2,A00,189297,Sammartano; Tonnie,27,0,30,3
1683660501511,TDMV 2,B00,189299,Arcidiacono; Kristin,23,0,30,7
1683660502536,TDMV 3,A00,204998,Rincon; Alicia,22,0,30,8
1683660503559,TDMV 120,A00,189458,Sammartano; Tonnie,28,0,30,2
1683660504584,TDMV 138,A00,189541,Jun; Grace Shin Hae,20,0,40,20
1683660505608,TDMV 142,A00,189717,Caligagan; Tony,25,0,30,5
1683660505608,TDMV 142,B00,189718,Caligagan; Maria T.,25,0,30,5
1683660506633,TMC 2,A01,187533,Staff,25,0,25,0
1683660506633,TMC 2,A02,187534,Staff,25,0,25,0
1683660507656,USP 1,A01,187536,Kwak; Nancy,0,16,25,25
1683660508679,USP 5,A01,187538,Staff,9,0,25,16
1683660509703,USP 101,A00,199253,Staff,0,4,0,0
1683660510729,USP 124,A00,187562,Boomhower; Matthew Charles,0,0,30,30
1683660511753,USP 138,A00,187582,Staff,20,0,25,5
1683660512777,USP 152,A01,187597,Staff,3,0,25,22
1683660513801,USP 153,A00,187598,Staff,19,0,25,6
1683660514825,USP 168,A00,187607,Kwak; Nancy,2,0,5,3
1683660515850,USP 173,A00,187619,Staff,4,0,25,21
1683660516873,USP 181,A00,187638,Staff,0,4,25,25
1683660517895,VIS 103,A00,187650,Cruz; Edwin Teddy,18,0,75,57
1683660518919,VIS 110D,A00,187669,Staff,13,0,22,9
1683660519943,VIS 127C,A00,187720,Shen; Kuiyi,67,0,146,79
1683660520966,VIS 149,A00,187731,Yoldas; Pinar,1,14,22,21
1683660521990,VIS 151,A01,188091,Staff,22,0,34,12
1683660521990,VIS 151,A02,188092,Staff,11,0,34,23
1683660523015,VIS 160B,A00,188093,Stalbaum; Brett,0,1,10,10
1683660525068,WCWP 10B,A00,201720,Staff,10,0,15,5
1683660525068,WCWP 10B,B00,201722,Staff,9,0,15,6
1683660526094,WCWP 100,A00,201725,Gagnon; Jeffrey C,0,0,2,2
1683660526094,WCWP 100,B00,201727,Staff,0,4,15,15
1683660529279,ANBI 133,A00,258401,Wilder; Linnea Lorene,34,0,40,6
1683660530303,ANBI 140,A00,258395,Hrvoj Mihic; Branka,18,0,25,7
1683660531330,ANSC 120,A00,258402,Bialecki; Jon Anthony,26,0,40,14
1683660532358,ANSC 144,A00,258400,Staff,12,0,40,28
1683660534414,ANSC 166,A00,258396,Parish; Steven Martin,156,0,175,19
1683660535440,ANSC 180,A00,193533,Staff,8,0,20,12
1683660536466,ANSC 188,A00,258397,Jassal; Aftab,34,0,40,6
1683660537490,ANTH 3,A01,258316,Staff,23,0,30,7
1683660538518,ANTH 5,A00,258394,Semendeferi; Ekaterini,16,0,20,4
1683660539584,ANTH 21,A01,258331,Staff,4,0,40,36
1683660540607,ANTH 103,A00,258398,Varma; Saiba,15,0,25,10
1683660541633,AWP 10,001,202034,Staff,0,0,0,0
1683660541633,AWP 10,002,202035,Staff,0,0,0,0
1683660541633,AWP 10,003,202036,Staff,0,0,0,0
1683660541633,AWP 10,004,202037,Staff,0,0,0,0
1683660541633,AWP 10,005,202038,Staff,0,0,0,0
1683660541633,AWP 10,006,202039,Staff,0,0,0,0
1683660541633,AWP 10,007,202040,Staff,0,0,0,0
1683660541633,AWP 10,008,202041,Staff,0,0,0,0
1683660541633,AWP 10,009,202042,Staff,0,0,0,0
1683660541633,AWP 10,010,202043,Staff,0,0,0,0
1683660541633,AWP 10,011,202044,Staff,0,0,0,0
1683660541633,AWP 10,012,202045,Staff,0,0,0,0
1683660541633,AWP 10,013,202046,Staff,0,0,0,0
1683660541633,AWP 10,014,202047,Staff,0,0,0,0
1683660541633,AWP 10,015,202048,Staff,0,0,0,0
1683660541633,AWP 10,016,202049,Staff,0,0,0,0
1683660541633,AWP 10,017,202050,Staff,0,0,0,0
1683660541633,AWP 10,018,202051,Staff,0,0,0,0
1683660541633,AWP 10,019,202052,Staff,0,0,0,0
1683660541633,AWP 10,020,202053,Staff,0,0,0,0
1683660541633,AWP 10,021,202054,Staff,0,0,0,0
1683660541633,AWP 10,022,202055,Staff,0,0,0,0
1683660541633,AWP 10,023,202056,Staff,0,0,0,0
1683660541633,AWP 10,024,202057,Staff,0,0,0,0
1683660541633,AWP 10,025,202058,Staff,0,0,0,0
1683660541633,AWP 10,026,202059,Staff,0,0,0,0
1683660542656,AWP 102,001,202032,Staff,0,0,0,0
1683660542656,AWP 102,002,202033,Staff,0,0,0,0
1683660543686,BENG 100,A01,254234,Taylor Amos; Alyssa C,31,0,40,9
1683660544769,BENG 196,001,270013,Engler; Adam J.,9999,0,9999,0
1683660545792,BICD 100R,A01,202018,Smith; Laurie,0,7,32,32
1683660545792,BICD 100R,A02,202019,Smith; Laurie,0,3,32,32
1683660545792,BICD 100R,A03,202020,Smith; Laurie,0,1,32,32
1683660545792,BICD 100R,A04,202021,Smith; Laurie,6,0,32,26
1683660545792,BICD 100R,A05,202022,Smith; Laurie,11,0,32,21
1683660546820,BICD 136,A01,193242,Gustafson-Brown; Cindy,0,2,32,32
1683660546820,BICD 136,A02,193244,Gustafson-Brown; Cindy,13,0,32,19
1683660547845,BIEB 102,A01,193249,Butler; Shannon Rhey,1,2,32,31
1683660547845,BIEB 102,A02,193251,Butler; Shannon Rhey,0,0,32,32
1683660547845,BIEB 102,A03,193253,Butler; Shannon Rhey,0,0,32,32
1683660547845,BIEB 102,A04,193255,Butler; Shannon Rhey,14,0,32,18
1683660547845,BIEB 102,A05,193265,Butler; Shannon Rhey,26,0,32,6
1683660547845,BIEB 102,A06,193269,Butler; Shannon Rhey,14,0,32,18
1683660549896,BIEB 150,A01,193274,Staff,0,0,32,32
1683660549896,BIEB 150,A02,193285,Staff,23,0,32,9
1683660550919,BIEB 194,A00,193286,Kurle; Carolyn M.,20,0,32,12
1683660551944,BILD 1,A01,192291,Staff,15,0,32,17
1683660551944,BILD 1,A02,192292,Staff,30,0,32,2
1683660551944,BILD 1,B01,192520,Reuther; Keefe,0,1,0,0
1683660551944,BILD 1,B02,192532,Reuther; Keefe,0,1,0,0
1683660552975,BILD 3,A01,192556,Butler; Shannon Rhey,0,0,32,32
1683660552975,BILD 3,A02,192581,Butler; Shannon Rhey,1,0,32,31
1683660552975,BILD 3,A03,192611,Butler; Shannon Rhey,21,0,32,11
1683660552975,BILD 3,A04,192612,Butler; Shannon Rhey,24,0,32,8
1683660552975,BILD 3,A05,192613,Butler; Shannon Rhey,26,0,32,6
1683660552975,BILD 3,A06,192679,Butler; Shannon Rhey,27,0,32,5
1683660552975,BILD 3,A07,192682,Butler; Shannon Rhey,20,0,32,12
1683660554000,BILD 4,A01,192836,Reuther; Keefe,1,0,24,23
1683660554000,BILD 4,A02,193044,Reuther; Keefe,4,0,24,20
1683660555025,BILD 10,A01,193142,Gustafson-Brown; Cindy,29,0,32,3
1683660555025,BILD 10,A02,193149,Gustafson-Brown; Cindy,31,0,32,1
1683660556054,BIMM 100,A01,193301,Staff,0,6,32,32
1683660556054,BIMM 100,A02,193312,Staff,0,7,32,32
1683660556054,BIMM 100,A03,193323,Staff,0,9,32,32
1683660557084,BIMM 101,A01,193329,McDonnell; Lisa Marie,0,4,24,24
1683660557084,BIMM 101,A02,193339,McDonnell; Lisa Marie,1,3,24,23
1683660557084,BIMM 101,B01,193354,McDonnell; Lisa Marie,0,4,24,24
1683660557084,BIMM 101,B02,193357,McDonnell; Lisa Marie,0,3,24,24
1683660558111,BIMM 110,A01,193377,Tat; John,0,11,32,32
1683660558111,BIMM 110,A02,193378,Tat; John,0,10,32,32
1683660559135,BIMM 120,A01,206116,Staff,0,0,32,32
1683660559135,BIMM 120,A02,206117,Staff,6,0,32,26
1683660559135,BIMM 120,A03,206121,Staff,21,0,32,11
1683660560162,BIPN 100,A01,193393,Park; Ji Young,0,15,32,32
1683660560162,BIPN 100,A02,193402,Park; Ji Young,0,14,32,32
1683660560162,BIPN 100,A03,193413,Park; Ji Young,0,14,32,32
1683660560162,BIPN 100,A04,193414,Park; Ji Young,0,13,32,32
1683660561186,BIPN 102,A01,193429,Staff,0,0,32,32
1683660561186,BIPN 102,A02,193438,Staff,18,0,32,14
1683660562213,BIPN 106,A01,193450,Reyes Gonzalez; Catalina,0,2,40,40
1683660563240,BIPN 134,A01,193465,Cooke; James Edward,0,0,32,32
1683660563240,BIPN 134,A02,193474,Cooke; James Edward,25,0,32,7
1683660563240,BIPN 134,A03,193485,Cooke; James Edward,29,0,32,3
1683660563240,BIPN 134,A04,193486,Cooke; James Edward,20,0,32,12
1683660563240,BIPN 134,A05,193491,Cooke; James Edward,31,0,32,1
1683660563240,BIPN 134,A06,193501,Cooke; James Edward,30,0,32,2
1683660563240,BIPN 134,A07,193510,Cooke; James Edward,29,0,32,3
1683660565292,BISP 194,A00,222522,Staff,14,0,32,18
1683660566317,CAT 124,A01,202407,Staff,19,0,25,6
1683660567340,CAT 125,A00,202408,Marchisotto; Jennifer Anne,2,0,20,18
1683660568367,CAT 125R,A00,202409,Smith; Lauryn Alissa,0,11,20,20
1683660568367,CAT 125R,B00,202410,Morales; Celeste Georgianna,0,11,20,20
1683660568367,CAT 125R,C00,202411,Irwin; Matthew Joseph,0,12,20,20
1683660569390,CENG 15,A01,204712,Yang; Kesong,0,1,0,0
1683660570414,CENG 114,A00,202070,Jahed Motlagh; Zeinab,5,0,20,15
1683660571438,CGS 105,A00,185477,Wesling; Megan E.,24,0,40,16
1683660572462,CGS 106,A00,185494,Staff,11,0,22,11
1683660573488,CGS 108,A00,185495,Staff,14,0,20,6
1683660574513,CGS 114,A00,185496,Staff,13,0,18,5
1683660575537,CGS 119,A00,185501,Staff,15,0,20,5
1683660576561,CGS 120,A00,185511,Staff,12,0,20,8
1683660577588,CHEM 4,A01,184675,Bussey; Thomas J,97,0,100,3
1683660578612,CHEM 6A,A01,184677,Staff,32,0,60,28
1683660579639,CHEM 6B,A01,184679,Staff,63,0,100,37
1683660580663,CHEM 6C,A01,184681,Bussey; Thomas J,0,0,50,50
1683660580663,CHEM 6C,A02,184682,Bussey; Thomas J,32,0,50,18
1683660581688,CHEM 40A,A01,184684,Albizati; Kim F.,34,0,100,66
1683660582711,CHEM 40B,A01,184686,Albizati; Kim F.,0,22,100,100
1683660583736,CHEM 41B,A01,184690,Staff,51,0,100,49
1683660584760,COGS 3,A01,184715,Boyle; Mary E. T.,0,27,40,40
1683660585784,COGS 14B,A01,185172,Staff,0,14,38,38
1683660586809,COGS 18,A01,184736,Staff,14,0,80,66
1683660587834,COGS 100,A01,184932,Staff,0,7,73,73
1683660588860,COGS 101A,A01,184935,Staff,0,39,30,30
1683660589883,COGS 101B,A01,184944,Staff,0,2,30,30
1683660590910,COGS 101C,A01,184946,Staff,0,10,30,30
1683660591938,COGS 102A,A01,184951,Johnson; Christine M.,2,0,40,38
1683660592967,COGS 107B,A01,184953,Mooshagian; Eric Frederick,0,51,40,40
1683660593994,COGS 118B,A01,184959,Gupta; Anjum,0,49,40,40
1683660595021,COGS 153,A00,184961,Staff,0,16,30,30
1683660596052,COGS 177,A00,184962,Staff,0,21,30,30
1683660597079,COGS 187A,A01,184969,Boyle; Mary E. T.,0,19,40,40
1683660598104,COMM 10,A01,185174,Staff,0,5,25,25
1683660598104,COMM 10,A02,185189,Staff,0,2,25,25
1683660598104,COMM 10,A03,269821,Staff,0,1,0,0
1683660599129,COMM 100B,A01,185475,Staff,0,1,0,2
1683660599129,COMM 100B,A02,185476,Staff,12,0,25,13
1683660600155,COMM 100C,A01,185314,Staff,1,0,25,24
1683660600155,COMM 100C,A02,185327,Staff,18,0,25,7
1683660601180,COMM 110M,A00,185349,Staff,0,0,40,40
1683660602205,COMM 113T,A00,185352,Staff,25,0,40,15
1683660603229,COMM 114I,A00,185353,Staff,31,0,40,9
1683660604251,COMM 131,A00,185354,Staff,17,0,30,13
1683660605278,CSE 8A,A50,185358,Cao; Yingjun,0,46,10,10
1683660606302,CSE 8B,A01,185362,Staff,0,48,50,50
1683660607325,CSE 11,A01,185416,Cao; Yingjun,0,91,10,10
1683660608349,CSE 20,A01,185445,Briones; Jor-el Thomas Caparas,4,0,25,21
1683660609372,CSE 21,A01,185447,Staff,9,0,50,41
1683660610397,CSE 101,A01,185451,Staff,0,13,50,50
1683660610397,CSE 101,B01,185453,Jones; Miles E,0,14,50,50
1683660612451,CSE 141,A01,185458,Eldon; John,16,0,100,84
1683660613476,CSE 141L,A01,185461,Eldon; John,8,0,100,92
1683660614504,CSE 142,A01,185463,Staff,34,0,60,26
1683660614504,CSE 142,B01,201355,Staff,0,7,60,60
1683660615528,CSE 142L,A01,185470,Staff,34,0,60,26
1683660615528,CSE 142L,B01,201417,Staff,0,6,60,60
1683660616553,CSE 190,A00,201433,Staff,32,0,49,17
1683660617577,DOC 1,A01,259136,Strom; Megan C.,7,0,15,8
1683660617577,DOC 1,A02,259137,Strom; Megan C.,14,0,15,1
1683660617577,DOC 1,A03,259138,Strom; Megan C.,14,0,15,1
1683660617577,DOC 1,A04,259139,Strom; Megan C.,14,0,15,1
1683660618602,DOC 100D,A00,259140,Pass; Natalye Joann,14,0,25,11
1683660619625,DSGN 1,A01,184749,Rill; Bryan,0,26,30,30
1683660620651,DSGN 100,A01,185168,Staff,0,2,25,25
1683660621675,ECE 5,A01,185626,Morris; Karcher William,0,11,0,0
1683660622698,ECE 101,A01,185628,Staff,14,0,70,56
1683660623727,ECE 107,A01,185635,Baghdadchi; Saharnaz,0,0,20,20
1683660623727,ECE 107,A02,185638,Baghdadchi; Saharnaz,2,0,20,18
1683660624755,ECE 148,A01,185647,Silberman; Jack,0,0,16,16
1683660625779,ECON 1,A01,185537,Crane; Meredith Helen,54,0,70,16
1683660626806,ECON 3,A01,185549,Crane; Meredith Helen,29,0,70,41
1683660627833,ECON 4,A01,203354,Anderson; John Charles,0,5,10,10
1683660628860,ECON 100A,A01,185574,Staff,0,5,40,40
1683660629890,ECON 100B,A01,185576,Staff,0,12,50,50
1683660630913,ECON 100C,A01,185589,Newhouse; Herbert S,30,0,70,40
1683660631936,ECON 105,A00,185608,Vespa; Emanuel Ignacio,19,0,35,16
1683660633017,ECON 109,A01,185610,Shishkin; Denis,9,0,35,26
1683660634043,ECON 110A,A01,185612,Staff,9,0,40,31
1683660635067,ECON 120A,A01,185615,Staff,20,0,40,20
1683660636091,ECON 120C,A01,185617,Sun; Yixiao,0,20,70,70
1683660637116,ECON 144,A00,203346,Squires; Dale E,2,0,35,33
1683660638140,ECON 171,A01,203349,Newhouse; Herbert S,0,1,35,35
1683660639163,ECON 173A,A01,185621,Toda; Alexis Akira,20,0,35,15
1683660640193,EDS 25,A01,202413,Staff,0,1,0,0
1683660640193,EDS 25,A02,202414,Staff,0,1,0,0
1683660640193,EDS 25,A03,202415,Staff,0,0,0,0
1683660640193,EDS 25,A04,202416,Staff,0,1,0,0
1683660640193,EDS 25,A05,202439,Staff,0,0,0,0
1683660640193,EDS 25,A06,202440,Staff,0,0,0,0
1683660640193,EDS 25,B01,202631,Staff,0,0,0,0
1683660640193,EDS 25,B02,202632,Staff,0,0,0,0
1683660640193,EDS 25,B03,202639,Staff,0,0,0,0
1683660640193,EDS 25,B04,202640,Staff,0,0,0,0
1683660640193,EDS 25,B05,202643,Staff,0,0,0,0
1683660640193,EDS 25,B06,202644,Staff,0,0,0,0
1683660641219,EDS 38,A01,202659,Black; Alison Michelle,24,0,25,1
1683660642244,EDS 115,A00,202652,Staff,18,0,30,12
1683660643266,EDS 125,A00,202649,Staff,13,0,30,17
1683660644292,EDS 126,A01,203332,Staff,30,0,30,0
1683660645316,EDS 139,A00,202838,Staff,16,0,25,9
1683660646339,EDS 146,A01,202655,Staff,14,0,25,11
1683660647368,ENG 15,A00,185667,Staff,0,1,0,0
1683660647368,ENG 15,B00,185672,Staff,0,0,0,0
1683660647368,ENG 15,C00,185675,Staff,0,0,0,0
1683660647368,ENG 15,D00,185682,Staff,0,0,0,0
1683660647368,ENG 15,E00,185684,Staff,0,0,0,0
1683660648394,ETHN 103,A00,185710,Staff,0,8,35,35
1683660649422,ETHN 103A,A00,199228,Man; Simeon S,0,0,9,9
1683660650448,ETHN 109,A00,185711,Staff,16,0,35,19
1683660651475,ETHN 142,A00,185726,Staff,0,4,30,30
1683660652499,ETHN 163J,A00,199229,Man; Simeon S,5,0,8,3
1683660653526,ETHN 168,A00,185727,Staff,7,0,10,3
1683660654553,ETHN 182,A00,185728,Staff,0,0,35,35
1683660655578,ETHN 183,A00,185737,Staff,9,0,18,9
1683660656603,GLBH 111,A01,209361,Burgos; Jose L.,0,0,0,0
1683660658650,HIEU 104,A00,185792,Staff,14,0,20,6
1683660659678,HIEU 115,A00,185800,Staff,0,0,20,20
1683660660701,HIEU 128,A00,185801,Staff,0,9,20,20
1683660661728,HIEU 147,A00,185802,Staff,15,0,20,5
1683660662756,HIEU 154,A00,185823,Staff,11,0,20,9
1683660663779,HILA 102,A00,185826,Staff,14,0,20,6
1683660664804,HILD 2C,A01,185778,Staff,0,13,20,20
1683660665829,HILD 7B,A01,185780,Kwak; Nancy,0,17,32,32
1683660665829,HILD 7B,A02,185781,Kwak; Nancy,0,18,32,32
1683660666853,HILD 30,A01,185791,Staff,12,0,20,8
1683660667880,HISC 119,A00,185830,Golan; Tal,0,9,20,20
1683660668904,HITO 156GS,A00,185831,Patterson; Patrick H.,0,0,0,23
1683660669928,HIUS 103,A00,185832,Man; Simeon S,0,4,20,20
1683660670952,HIUS 117,A00,185836,Kwak; Nancy,2,0,20,18
1683660671977,HIUS 125,A00,185840,Man; Simeon S,0,2,23,23
1683660673002,HIUS 149,A00,185845,Staff,1,0,20,19
1683660674026,HUM 3,A01,185882,Zavodny; Tatiana Sophia,0,8,50,50
1683660674026,HUM 3,B01,185899,Caldwell; Michael Alan,0,18,50,50
1683660675051,HUM 3GS,A00,185900,Patterson; Patrick H.,0,0,0,23
1683660676078,HUM 4,A01,185938,Zroka; Amy Liane,29,0,50,21
1683660676078,HUM 4,B01,185956,Watkins; Eric,0,4,50,50
1683660676078,HUM 4,B02,202209,Watkins; Eric,0,5,50,50
1683660676078,HUM 4,B03,202210,Watkins; Eric,0,5,50,50
1683660677108,HUM 5,A01,185958,West; Geoffrey Scott,0,0,50,50
1683660677108,HUM 5,A02,202215,West; Geoffrey Scott,0,0,50,50
1683660678131,INTL 190,A00,185959,Gagnon; Jeffrey C,0,0,0,9
1683660678131,INTL 190,B00,185960,Lettieri; Michael Joseph,0,0,0,2
1683660679158,JAPN 180,A00,254509,Staff,5,0,30,25
1683660680184,LATI 10,A01,202853,Kennemore; Amy Michelle,4,0,35,31
1683660680184,LATI 10,A02,202854,Kennemore; Amy Michelle,2,0,35,33
1683660680184,LATI 10,A03,270054,Kennemore; Amy Michelle,30,0,30,0
1683660681214,LATI 180,A00,202855,Kennemore; Amy Michelle,11,0,20,9
1683660682237,LAWS 101,A00,201767,Golan; Tal,0,7,40,40
1683660683261,LIFR 1C,A00,185961,Staff,6,0,20,14
1683660684286,LIFR 1CX,A00,185962,Staff,7,0,20,13
1683660685309,LIFR 1D,A00,185963,Staff,7,0,20,13
1683660686337,LIFR 1DX,A00,185964,Staff,7,0,20,13
1683660687364,LIGN 101,A01,186039,Staff,43,0,50,7
1683660688389,LIGN 165,A00,186040,Staff,15,0,50,35
1683660689416,LTCS 108,A00,186041,Staff,5,0,10,5
1683660690442,LTCS 119,A00,186042,Staff,15,0,20,5
1683660691469,LTCS 130,A00,186043,Wesling; Megan E.,15,0,25,10
1683660693521,LTEA 138,A00,186119,Staff,14,0,40,26
1683660694545,LTEN 124,A00,186148,Staff,5,0,25,20
1683660695570,LTEN 178,A00,186149,Staff,7,0,15,8
1683660696595,LTEN 181,A00,186150,Blanco; John D,34,0,40,6
1683660697619,LTWL 120,A00,186160,Staff,20,0,25,5
1683660698646,LTWL 165,A00,186161,Staff,22,0,25,3
1683660699673,LTWR 100,A00,186162,Staff,0,5,15,15
1683660700699,LTWR 102,A00,186163,Doller; Ben,5,0,15,10
1683660701726,MAE 8,A01,186412,Staff,0,0,0,0
1683660702754,MAE 30B,A00,186445,Bahadori; Mohammad Yousef,82,0,100,18
1683660703781,MAE 40,A00,186592,Bewley; Thomas R,10,0,50,40
1683660704803,MAE 101B,A00,186593,Bahadori; Mohammad Yousef,80,0,100,20
1683660705827,MAE 105,A00,186594,Bandaru; Prabhakar,10,0,50,40
1683660706851,MAE 107,A00,186599,Pham; Hieu Tan,0,7,120,120
1683660707884,MAE 148,A01,186660,Silberman; Jack,3,0,16,13
1683660708912,MATH 10A,A01,188095,Staff,0,6,35,35
1683660709941,MATH 10B,A01,188097,Bowers; Adam R.,0,12,30,30
1683660709941,MATH 10B,A02,188099,Bowers; Adam R.,0,11,30,30
1683660709941,MATH 10B,B01,188104,Bowers; Adam R.,0,10,30,30
1683660709941,MATH 10B,B02,188106,Bowers; Adam R.,1,9,30,29
1683660710966,MATH 10C,A01,188111,Staff,0,18,30,30
1683660710966,MATH 10C,A02,188127,Staff,0,19,30,30
1683660710966,MATH 10C,A03,188131,Staff,0,19,30,30
1683660710966,MATH 10C,B01,188218,Staff,17,0,30,13
1683660710966,MATH 10C,B02,188244,Staff,13,0,30,17
1683660710966,MATH 10C,B03,188277,Staff,14,0,30,16
1683660711994,MATH 18,A01,188344,Bach; Quang Tran,18,0,30,12
1683660711994,MATH 18,A02,188345,Bach; Quang Tran,11,0,30,19
1683660711994,MATH 18,B01,188353,Bach; Quang Tran,11,0,30,19
1683660711994,MATH 18,B02,188354,Bach; Quang Tran,19,0,30,11
1683660713018,MATH 20A,A01,188374,Staff,11,0,35,24
1683660714043,MATH 20B,A01,188382,Ohm; Ko Woon,7,0,30,23
1683660714043,MATH 20B,A02,188383,Ohm; Ko Woon,22,0,30,8
1683660714043,MATH 20B,B01,188385,Ohm; Ko Woon,7,0,30,23
1683660714043,MATH 20B,B02,188392,Ohm; Ko Woon,22,0,30,8
1683660715068,MATH 20C,A01,188394,Harel; Guershon,10,0,30,20
1683660715068,MATH 20C,A02,188395,Harel; Guershon,13,0,30,17
1683660715068,MATH 20C,B01,188404,Harel; Guershon,5,0,30,25
1683660715068,MATH 20C,B02,188405,Harel; Guershon,18,0,30,12
1683660716097,MATH 20D,A01,188414,Hammock; Frances H,0,1,30,30
1683660716097,MATH 20D,A02,188415,Hammock; Frances H,0,1,30,30
1683660716097,MATH 20D,B01,188447,Hammock; Frances H,0,1,30,30
1683660716097,MATH 20D,B02,188486,Hammock; Frances H,3,0,30,27
1683660717126,MATH 20E,A01,188649,Staff,21,0,30,9
1683660717126,MATH 20E,A02,188650,Staff,21,0,30,9
1683660717126,MATH 20E,A03,188673,Staff,0,0,30,30
1683660718148,MATH 102,A01,188675,Staff,0,36,35,35
1683660719172,MATH 103B,A01,188681,Staff,3,0,35,32
1683660719172,MATH 103B,B01,188692,Staff,5,0,35,30
1683660720199,MATH 109,A01,188695,Salehi Golsefidy; Alireza,24,0,35,11
1683660720199,MATH 109,A02,188696,Salehi Golsefidy; Alireza,25,0,35,10
1683660721222,MATH 120A,A01,188698,Eggers; John Dietrich,7,0,35,28
1683660722253,MATH 142B,A01,188736,Ioana; Adrian,0,1,30,30
1683660722253,MATH 142B,A02,188741,Ioana; Adrian,0,1,30,30
1683660722253,MATH 142B,A03,188743,Ioana; Adrian,0,1,30,30
1683660723280,MATH 168A,A01,188790,Staff,0,10,35,35
1683660724309,MATH 170A,A01,188803,Nie; Jiawang,0,2,35,35
1683660724309,MATH 170A,A02,188811,Nie; Jiawang,0,0,35,35
1683660724309,MATH 170A,A03,188814,Nie; Jiawang,0,0,35,35
1683660724309,MATH 170A,A04,188815,Nie; Jiawang,9,0,35,26
1683660725332,MATH 193B,A01,188817,Staff,0,0,35,35
1683660725332,MATH 193B,A02,188818,Staff,5,0,35,30
1683660726360,MGT 4,A01,202857,Anderson; John Charles,61,0,80,19
1683660727387,MGT 12,A00,202858,Lindenberger; Wade Douglas,40,0,90,50
1683660728415,MGT 18,A00,202859,Staff,74,0,90,16
1683660729443,MGT 18GS,A00,202860,McKay; Michael J,13,0,28,15
1683660730466,MGT 45,A00,202861,Pecore; Joseph P.,12,0,90,78
1683660731493,MGT 100,A00,202863,Yavorsky; Daniel Ryan,28,0,90,62
1683660732521,MGT 103,A00,202864,Ehrich; Kristine R,0,18,90,90
1683660733548,MGT 112,A00,202865,Ehrich; Kristine R,14,0,90,76
1683660734576,MGT 121A,A00,202868,Staff,90,20,90,0
1683660735600,MGT 131B,A00,202869,Anderson; John Charles,59,0,90,31
1683660736700,MGT 136,A00,202871,Lindenberger; Wade Douglas,83,0,90,7
1683660737728,MGT 164,A00,202873,Staff,0,67,90,91
1683660738754,MGT 164GS,A00,202874,McKay; Mary A,13,0,28,15
1683660739778,MGT 180,A00,202875,Staff,0,50,90,91
1683660740801,MMW 11R,A01,205019,Herbst; Matthew,1,0,30,29
1683660740801,MMW 11R,A02,205026,Herbst; Matthew,29,0,30,1
1683660741830,MMW 15,A01,193512,Chang; Edmond Yi-Teh,0,8,28,28
1683660741830,MMW 15,A02,193513,Chang; Edmond Yi-Teh,0,5,28,28
1683660741830,MMW 15,A03,193514,Chang; Edmond Yi-Teh,0,5,28,28
1683660741830,MMW 15,A04,193515,Chang; Edmond Yi-Teh,0,5,28,28
1683660741830,MMW 15,A05,193516,Chang; Edmond Yi-Teh,0,5,28,28
1683660741830,MMW 15,A06,193517,Chang; Edmond Yi-Teh,0,6,28,28
1683660741830,MMW 15,B01,193519,Chang; Edmond Yi-Teh,0,5,28,28
1683660741830,MMW 15,B02,193520,Chang; Edmond Yi-Teh,0,5,28,28
1683660741830,MMW 15,B03,193521,Chang; Edmond Yi-Teh,0,5,28,28
1683660741830,MMW 15,B04,193522,Chang; Edmond Yi-Teh,0,5,28,28
1683660741830,MMW 15,B05,193523,Chang; Edmond Yi-Teh,0,5,28,28
1683660741830,MMW 15,B06,193524,Chang; Edmond Yi-Teh,0,5,28,28
1683660742858,MMW 122,A01,193526,Rahimi; Babak,0,16,28,28
1683660742858,MMW 122,A02,193527,Rahimi; Babak,0,15,28,28
1683660742858,MMW 122,A03,193528,Rahimi; Babak,0,0,0,0
1683660742858,MMW 122,A04,193529,Rahimi; Babak,0,0,0,0
1683660743883,MUS 1A,A01,186663,Staff,1,20,35,34
1683660744907,MUS 4,A01,186715,Staff,0,12,35,35
1683660745931,MUS 5R,A01,186796,Dubnov; Shlomo,0,17,35,35
1683660746958,MUS 6,A01,186798,Staff,0,5,25,25
1683660747983,MUS 7,A01,186830,Staff,11,0,35,24
1683660749007,MUS 8,A01,186930,Staff,0,26,35,35
1683660750044,MUS 15,A01,186932,Staff,0,16,35,35
1683660750044,MUS 15,B01,186934,Staff,1,17,35,34
1683660751072,MUS 80,A00,186935,Staff,0,0,20,20
1683660751072,MUS 80,B00,186936,Staff,24,0,25,1
1683660752094,NANO 11,A00,204702,Lipomi; Darren John,0,0,0,0
1683660753122,NANO 15,A01,204709,Yang; Kesong,0,1,0,0
1683660754147,NANO 114,A00,202069,Jahed Motlagh; Zeinab,3,0,10,7
1683660755169,PHIL 1,A00,186955,Grush; Rick Scott,31,0,40,9
1683660756193,PHIL 10,A01,186973,Grush; Rick Scott,27,0,35,8
1683660756193,PHIL 10,A02,186974,Grush; Rick Scott,33,0,35,2
1683660757221,PHIL 13,A01,186976,Staff,3,0,35,32
1683660757221,PHIL 13,A02,186977,Staff,16,0,35,19
1683660758244,PHIL 14,A01,186979,Staff,31,0,35,4
1683660758244,PHIL 14,A02,186986,Staff,32,0,35,3
1683660759268,PHIL 28,A01,186988,Staff,16,0,30,14
1683660759268,PHIL 28,A02,186989,Staff,1,0,30,29
1683660759268,PHIL 28,A03,186990,Staff,10,0,30,20
1683660759268,PHIL 28,A04,186991,Staff,26,0,30,4
1683660760290,PHIL 120,A00,186997,Staff,23,0,40,17
1683660761319,PHIL 137,A00,187003,Staff,7,0,40,33
1683660762346,PHIL 150,A00,187015,Staff,47,0,70,23
1683660763371,PHIL 167,A00,187021,Lamey; Andy M.,34,0,40,6
1683660764399,PHIL 174,A01,202226,Staff,17,0,20,3
1683660764399,PHIL 174,A02,202235,Staff,20,0,20,0
1683660765424,PHIL 191A,A00,258918,Staff,0,0,1,1
1683660766450,PHYS 1A,A00,187028,Staff,26,0,60,34
1683660767477,PHYS 1AL,001,187036,Staff,3,0,30,27
1683660767477,PHYS 1AL,002,187049,Staff,18,0,30,12
1683660768503,PHYS 1B,A00,187058,Staff,22,0,60,38
1683660769527,PHYS 1BL,001,187064,Staff,0,1,30,30
1683660769527,PHYS 1BL,002,187070,Staff,4,0,30,26
1683660770555,PHYS 1C,A00,187082,Staff,29,0,120,91
1683660771582,PHYS 1CL,001,187088,Staff,0,9,30,30
1683660771582,PHYS 1CL,002,187089,Staff,0,1,30,30
1683660771582,PHYS 1CL,009,262693,Staff,9,0,30,21
1683660772606,PHYS 2B,A01,187097,Staff,55,0,115,60
1683660773633,PHYS 2C,A01,187099,Staff,63,0,115,52
1683660774660,PHYS 2CL,A01,187101,Staff,5,0,28,23
1683660774660,PHYS 2CL,A02,187102,Staff,15,0,28,13
1683660775684,PHYS 2D,A01,187123,Shotwell; Brian,95,0,115,20
1683660776712,PHYS 4B,A01,187133,Grinstein; Benjamin,35,0,50,15
1683660777739,POLI 10,A00,188819,Staff,0,4,50,50
1683660778762,POLI 11,A00,188827,Staff,43,0,50,7
1683660779788,POLI 13R,A00,188828,Staff,0,1,20,20
1683660780815,POLI 27,A01,188830,Elgin; Samuel Zincke,0,2,70,70
1683660781841,POLI 30,A00,188832,Desposato; Scott,30,0,50,20
1683660782868,POLI 102F,A00,188834,Staff,0,0,40,40
1683660783892,POLI 104A,A00,188852,Staff,13,0,30,17
1683660784917,POLI 104I,A00,188853,Staff,0,7,20,20
1683660785944,POLI 110B,A00,188854,Wiens; David,6,0,20,14
1683660786968,POLI 112A,A00,188855,Wiens; David,3,0,30,27
1683660787995,POLI 117R,A00,188856,Forman; Fonna,0,12,20,20
1683660789022,POLI 118,A00,188857,Ingham; Sean,8,0,20,12
1683660790047,POLI 120G,A00,188858,Staff,8,0,30,22
1683660791071,POLI 131CR,A00,188863,Hoston; Germaine,21,0,50,29
1683660792094,POLI 133,A00,188864,Nellis; Gareth Hb,44,0,50,6
1683660793119,POLI 134D,A00,188865,Desposato; Scott,27,0,30,3
1683660794146,POLI 142A,A00,188871,Gartzke; Erik,21,0,50,29
1683660795174,POLI 142K,A00,188874,Staff,38,0,50,12
1683660796198,POLI 143,A00,188940,Gartzke; Erik,16,0,30,14
1683660797224,POLI 153,A00,188943,Staff,2,0,20,18
1683660798247,POLI 160AA,A00,188944,Staff,11,0,40,29
1683660799271,POLI 170A,A00,188945,Staff,11,0,30,19
1683660801324,PSYC 1,A00,188952,Staff,36,0,90,54
1683660802348,PSYC 2,B00,188953,Staff,19,0,35,16
1683660803382,PSYC 6,A00,188970,Staff,47,0,60,13
1683660804407,PSYC 7,A00,188973,Staff,35,0,45,10
1683660805432,PSYC 60,A01,188980,Rickard; Timothy C.,42,0,60,18
1683660806461,PSYC 70,A01,189001,Steiner; Eric Tomas,22,0,45,23
1683660807488,PSYC 100,A00,189005,Lacefield; Katharine I,0,99,120,120
1683660808514,PSYC 102,A00,189008,Staff,8,0,30,22
1683660809538,PSYC 106,B00,189026,Gorman; Michael R.,27,0,60,33
1683660810566,PSYC 114,B01,189033,Winkielman; Piotr,0,31,30,30
1683660811590,PSYC 131,A00,189036,Anagnostaras; Stephan,0,43,60,60
1683660812614,PSYC 136,A00,189041,Lowe; Angela Beth,0,7,25,25
1683660813641,PSYC 137,A00,189057,Winkielman; Piotr,0,37,25,25
1683660814671,PSYC 144,A00,189107,Wixted; John T,0,11,50,50
1683660816724,PSYC 162,A00,189142,Staff,0,9,85,85
1683660817747,PSYC 172,A00,189144,Gorman; Michael R.,0,6,30,30
1683660819794,PSYC 179,A00,189146,Lacefield; Katharine I,0,87,120,120
1683660820821,PSYC 181,A00,189147,Anagnostaras; Stephan,0,44,90,90
1683660821849,PSYC 190R,A00,189148,Barner; David A.,0,23,80,80
1683660822877,PSYC 191,A00,189275,Rickard; Timothy C.,0,10,25,25
1683660823903,PSYC 193,A00,189276,Chapman; Eddie Nathaniel,0,1,0,4
1683660824932,PSYC 193L,A01,189281,Lowe; Angela Beth,10,0,20,10
1683660824932,PSYC 193L,B01,189285,Staff,28,0,35,7
1683660825965,RELI 149,A00,187137,Rahimi; Babak,7,0,40,33
1683660826992,SE 9,A01,187315,Staff,0,2,18,18
1683660828015,SE 101B,A00,187409,Staff,24,0,30,6
1683660829040,SE 110B,A00,187444,Staff,10,0,40,30
1683660830069,SE 130B,A00,187449,Staff,31,0,40,9
1683660831093,SE 150A,A00,187516,Staff,9,0,20,11
1683660832119,SE 154,A00,187528,Staff,29,0,50,21
1683660833143,SIO 3,A01,258171,Staff,35,0,40,5
1683660834171,SIO 10,A00,187144,Cook; Geoffrey W,0,6,75,75
1683660835197,SIO 45,A00,187152,Cook; Geoffrey W,0,4,100,100
1683660836224,SIO 109R,A00,194486,Staff,0,4,20,20
1683660838272,SIO 187,A01,187233,Kacev; David,12,0,40,28
1683660839297,SOCI 1,A01,258656,Thorpe; Charles Robert,28,0,30,2
1683660839297,SOCI 1,A02,258658,Thorpe; Charles Robert,30,0,30,0
1683660839297,SOCI 1,A03,258661,Thorpe; Charles Robert,25,0,25,0
1683660839297,SOCI 1,A04,258666,Thorpe; Charles Robert,22,0,25,3
1683660839297,SOCI 1,A05,258897,Thorpe; Charles Robert,22,0,25,3
1683660839297,SOCI 1,A06,258898,Thorpe; Charles Robert,25,0,25,0
1683660840374,SOCI 30,A01,258903,Pardo Guerra; Juan Pablo,14,0,30,16
1683660841399,SOCI 102,A00,258904,Staff,9,0,25,16
1683660842426,SOCI 106,A00,258905,Staff,19,0,25,6
1683660843449,SOCI 111,A00,258907,Ribas Norris; Janet Vanesa,26,0,30,4
1683660844476,SOCI 121R,A00,258908,Pardo Guerra; Juan Pablo,8,0,30,22
1683660845502,SOCI 126,A01,203330,Staff,14,0,20,6
1683660846530,SOCI 131,A00,258909,Thorpe; Charles Robert,30,0,60,30
1683660847554,SOCI 135,A00,258910,Payne; Christine Anna,0,11,30,30
1683660848581,SOCI 157,A00,258911,Staff,12,0,30,18
1683660849606,SOCI 184,A00,258912,Staff,25,0,30,5
1683660850633,SOCI 188D,A00,258913,Staff,22,0,30,8
1683660851659,SYN 2,001,187529,Staff,9,0,16,7
1683660851659,SYN 2,002,201452,Staff,0,20,16,16
1683660851659,SYN 2,003,201469,Staff,1,0,16,15
1683660852682,SYN 100,A01,187531,Staff,0,9,20,20
1683660852682,SYN 100,B01,201491,Staff,0,10,20,20
1683660853706,TDAC 1,A00,189286,Walsh; Kim C.,3,0,20,17
1683660853706,TDAC 1,B00,189287,Harting; Carla Kelso,10,0,20,10
1683660854734,TDAC 101,A00,189300,Walsh; Kim C.,16,0,20,4
1683660854734,TDAC 101,B00,189301,Harting; Carla Kelso,18,0,20,2
1683660855758,TDAC 102,A00,189304,Basso; Beatrice,14,0,20,6
1683660856786,TDAC 108,A00,189305,Staff,18,0,20,2
1683660857812,TDDE 131,A00,189310,Staff,19,0,20,1
1683660857812,TDDE 131,B00,189314,Staff,19,0,20,1
1683660857812,TDDE 131,C00,189315,Staff,48,0,50,2
1683660857812,TDDE 131,D00,189316,Staff,14,0,15,1
1683660857812,TDDE 131,E00,204841,Staff,20,0,20,0
1683660858836,TDGE 10,A00,189289,Staff,27,0,50,23
1683660858836,TDGE 10,B00,189290,Havis; Allan,0,0,50,50
1683660859861,TDGE 11,A00,189291,Fulton; Julia,0,4,50,50
1683660859861,TDGE 11,B00,189292,Staff,20,0,25,5
1683660859861,TDGE 11,C00,260270,Staff,0,0,0,0
1683660860887,TDGE 25,A00,189294,Staff,2,0,20,18
1683660861912,TDGE 124,A00,189318,Fulton; Julia,0,8,50,50
1683660862938,TDGE 125,A00,189319,Staff,13,0,25,12
1683660862938,TDGE 125,B00,189320,Staff,23,0,25,2
1683660863963,TDGE 127,A00,189322,Havis; Allan,0,0,50,50
1683660864987,TDHT 101,A00,189323,Staff,18,0,25,7
1683660864987,TDHT 101,B00,189324,Staff,25,0,25,0
1683660866011,TDHT 102,A00,189325,Staff,49,0,50,1
1683660867039,TDMV 1,A00,189295,Arcidiacono; Kristin,20,0,30,10
1683660867039,TDMV 1,B00,189296,Caligagan; Maria T.,24,0,30,6
1683660868062,TDMV 2,A00,189297,Sammartano; Tonnie,27,0,30,3
1683660868062,TDMV 2,B00,189299,Arcidiacono; Kristin,23,0,30,7
1683660869090,TDMV 3,A00,204998,Rincon; Alicia,22,0,30,8
1683660870113,TDMV 120,A00,189458,Sammartano; Tonnie,28,0,30,2
1683660871139,TDMV 138,A00,189541,Jun; Grace Shin Hae,20,0,40,20
1683660872166,TDMV 142,A00,189717,Caligagan; Tony,25,0,30,5
1683660872166,TDMV 142,B00,189718,Caligagan; Maria T.,25,0,30,5
1683660873197,TMC 2,A01,187533,Staff,25,0,25,0
1683660873197,TMC 2,A02,187534,Staff,25,0,25,0
1683660874225,USP 1,A01,187536,Kwak; Nancy,0,16,25,25
1683660875251,USP 5,A01,187538,Staff,9,0,25,16
1683660876274,USP 101,A00,199253,Staff,0,4,0,0
1683660877301,USP 124,A00,187562,Boomhower; Matthew Charles,0,0,30,30
1683660878324,USP 138,A00,187582,Staff,20,0,25,5
1683660879351,USP 152,A01,187597,Staff,3,0,25,22
1683660880375,USP 153,A00,187598,Staff,19,0,25,6
1683660881402,USP 168,A00,187607,Kwak; Nancy,2,0,5,3
1683660882426,USP 173,A00,187619,Staff,4,0,25,21
1683660883451,USP 181,A00,187638,Staff,0,4,25,25
1683660884473,VIS 103,A00,187650,Cruz; Edwin Teddy,17,0,75,58
1683660885498,VIS 110D,A00,187669,Staff,13,0,22,9
1683660886522,VIS 127C,A00,187720,Shen; Kuiyi,68,0,146,78
1683660887548,VIS 149,A00,187731,Yoldas; Pinar,1,14,22,21
1683660888573,VIS 151,A01,188091,Staff,22,0,34,12
1683660888573,VIS 151,A02,188092,Staff,11,0,34,23
1683660889596,VIS 160B,A00,188093,Stalbaum; Brett,0,1,10,10
1683660891640,WCWP 10B,A00,201720,Staff,10,0,15,5
1683660891640,WCWP 10B,B00,201722,Staff,9,0,15,6
1683660892664,WCWP 100,A00,201725,Gagnon; Jeffrey C,0,0,2,2
1683660892664,WCWP 100,B00,201727,Staff,0,4,15,15
1683660895759,ANBI 133,A00,258401,Wilder; Linnea Lorene,34,0,40,6
1683660896784,ANBI 140,A00,258395,Hrvoj Mihic; Branka,18,0,25,7
1683660897810,ANSC 120,A00,258402,Bialecki; Jon Anthony,26,0,40,14
1683660898836,ANSC 144,A00,258400,Staff,12,0,40,28
1683660900882,ANSC 166,A00,258396,Parish; Steven Martin,156,0,175,19
1683660901906,ANSC 180,A00,193533,Staff,8,0,20,12
1683660902932,ANSC 188,A00,258397,Jassal; Aftab,34,0,40,6
1683660903958,ANTH 3,A01,258316,Staff,23,0,30,7
1683660904986,ANTH 5,A00,258394,Semendeferi; Ekaterini,16,0,20,4
1683660906013,ANTH 21,A01,258331,Staff,4,0,40,36
1683660907039,ANTH 103,A00,258398,Varma; Saiba,15,0,25,10
1683660908071,AWP 10,001,202034,Staff,0,0,0,0
1683660908071,AWP 10,002,202035,Staff,0,0,0,0
1683660908071,AWP 10,003,202036,Staff,0,0,0,0
1683660908071,AWP 10,004,202037,Staff,0,0,0,0
1683660908071,AWP 10,005,202038,Staff,0,0,0,0
1683660908071,AWP 10,006,202039,Staff,0,0,0,0
1683660908071,AWP 10,007,202040,Staff,0,0,0,0
1683660908071,AWP 10,008,202041,Staff,0,0,0,0
1683660908071,AWP 10,009,202042,Staff,0,0,0,0
1683660908071,AWP 10,010,202043,Staff,0,0,0,0
1683660908071,AWP 10,011,202044,Staff,0,0,0,0
1683660908071,AWP 10,012,202045,Staff,0,0,0,0
1683660908071,AWP 10,013,202046,Staff,0,0,0,0
1683660908071,AWP 10,014,202047,Staff,0,0,0,0
1683660908071,AWP 10,015,202048,Staff,0,0,0,0
1683660908071,AWP 10,016,202049,Staff,0,0,0,0
1683660908071,AWP 10,017,202050,Staff,0,0,0,0
1683660908071,AWP 10,018,202051,Staff,0,0,0,0
1683660908071,AWP 10,019,202052,Staff,0,0,0,0
1683660908071,AWP 10,020,202053,Staff,0,0,0,0
1683660908071,AWP 10,021,202054,Staff,0,0,0,0
1683660908071,AWP 10,022,202055,Staff,0,0,0,0
1683660908071,AWP 10,023,202056,Staff,0,0,0,0
1683660908071,AWP 10,024,202057,Staff,0,0,0,0
1683660908071,AWP 10,025,202058,Staff,0,0,0,0
1683660908071,AWP 10,026,202059,Staff,0,0,0,0
1683660909096,AWP 102,001,202032,Staff,0,0,0,0
1683660909096,AWP 102,002,202033,Staff,0,0,0,0
1683660910119,BENG 100,A01,254234,Taylor Amos; Alyssa C,31,0,40,9
1683660911146,BENG 196,001,270013,Engler; Adam J.,9999,0,9999,0
1683660912175,BICD 100R,A01,202018,Smith; Laurie,0,7,32,32
1683660912175,BICD 100R,A02,202019,Smith; Laurie,0,3,32,32
1683660912175,BICD 100R,A03,202020,Smith; Laurie,0,1,32,32
1683660912175,BICD 100R,A04,202021,Smith; Laurie,6,0,32,26
1683660912175,BICD 100R,A05,202022,Smith; Laurie,11,0,32,21
1683660913199,BICD 136,A01,193242,Gustafson-Brown; Cindy,0,2,32,32
1683660913199,BICD 136,A02,193244,Gustafson-Brown; Cindy,13,0,32,19
1683660914224,BIEB 102,A01,193249,Butler; Shannon Rhey,1,2,32,31
1683660914224,BIEB 102,A02,193251,Butler; Shannon Rhey,0,0,32,32
1683660914224,BIEB 102,A03,193253,Butler; Shannon Rhey,0,0,32,32
1683660914224,BIEB 102,A04,193255,Butler; Shannon Rhey,14,0,32,18
1683660914224,BIEB 102,A05,193265,Butler; Shannon Rhey,26,0,32,6
1683660914224,BIEB 102,A06,193269,Butler; Shannon Rhey,14,0,32,18
1683660916276,BIEB 150,A01,193274,Staff,0,0,32,32
1683660916276,BIEB 150,A02,193285,Staff,23,0,32,9
1683660917301,BIEB 194,A00,193286,Kurle; Carolyn M.,20,0,32,12
1683660918329,BILD 1,A01,192291,Staff,15,0,32,17
1683660918329,BILD 1,A02,192292,Staff,30,0,32,2
1683660918329,BILD 1,B01,192520,Reuther; Keefe,0,1,0,0
1683660918329,BILD 1,B02,192532,Reuther; Keefe,0,1,0,0
1683660919357,BILD 3,A01,192556,Butler; Shannon Rhey,0,0,32,32
1683660919357,BILD 3,A02,192581,Butler; Shannon Rhey,1,0,32,31
1683660919357,BILD 3,A03,192611,Butler; Shannon Rhey,21,0,32,11
1683660919357,BILD 3,A04,192612,Butler; Shannon Rhey,24,0,32,8
1683660919357,BILD 3,A05,192613,Butler; Shannon Rhey,26,0,32,6
1683660919357,BILD 3,A06,192679,Butler; Shannon Rhey,27,0,32,5
1683660919357,BILD 3,A07,192682,Butler; Shannon Rhey,20,0,32,12
1683660920384,BILD 4,A01,192836,Reuther; Keefe,1,0,24,23
1683660920384,BILD 4,A02,193044,Reuther; Keefe,4,0,24,20
1683660921406,BILD 10,A01,193142,Gustafson-Brown; Cindy,29,0,32,3
1683660921406,BILD 10,A02,193149,Gustafson-Brown; Cindy,31,0,32,1
1683660922431,BIMM 100,A01,193301,Staff,0,6,32,32
1683660922431,BIMM 100,A02,193312,Staff,0,7,32,32
1683660922431,BIMM 100,A03,193323,Staff,0,9,32,32
1683660923459,BIMM 101,A01,193329,McDonnell; Lisa Marie,0,4,24,24
1683660923459,BIMM 101,A02,193339,McDonnell; Lisa Marie,1,3,24,23
1683660923459,BIMM 101,B01,193354,McDonnell; Lisa Marie,0,4,24,24
1683660923459,BIMM 101,B02,193357,McDonnell; Lisa Marie,0,3,24,24
1683660924484,BIMM 110,A01,193377,Tat; John,0,11,32,32
1683660924484,BIMM 110,A02,193378,Tat; John,0,10,32,32
1683660925509,BIMM 120,A01,206116,Staff,0,0,32,32
1683660925509,BIMM 120,A02,206117,Staff,6,0,32,26
1683660925509,BIMM 120,A03,206121,Staff,21,0,32,11
1683660926537,BIPN 100,A01,193393,Park; Ji Young,0,15,32,32
1683660926537,BIPN 100,A02,193402,Park; Ji Young,0,14,32,32
1683660926537,BIPN 100,A03,193413,Park; Ji Young,0,14,32,32
1683660926537,BIPN 100,A04,193414,Park; Ji Young,0,13,32,32
1683660927565,BIPN 102,A01,193429,Staff,0,0,32,32
1683660927565,BIPN 102,A02,193438,Staff,18,0,32,14
1683660928592,BIPN 106,A01,193450,Reyes Gonzalez; Catalina,0,2,40,40
1683660929620,BIPN 134,A01,193465,Cooke; James Edward,0,0,32,32
1683660929620,BIPN 134,A02,193474,Cooke; James Edward,25,0,32,7
1683660929620,BIPN 134,A03,193485,Cooke; James Edward,29,0,32,3
1683660929620,BIPN 134,A04,193486,Cooke; James Edward,20,0,32,12
1683660929620,BIPN 134,A05,193491,Cooke; James Edward,31,0,32,1
1683660929620,BIPN 134,A06,193501,Cooke; James Edward,30,0,32,2
1683660929620,BIPN 134,A07,193510,Cooke; James Edward,29,0,32,3
1683660931673,BISP 194,A00,222522,Staff,14,0,32,18
1683660932697,CAT 124,A01,202407,Staff,19,0,25,6
1683660933724,CAT 125,A00,202408,Marchisotto; Jennifer Anne,2,0,20,18
1683660934752,CAT 125R,A00,202409,Smith; Lauryn Alissa,0,11,20,20
1683660934752,CAT 125R,B00,202410,Morales; Celeste Georgianna,0,11,20,20
1683660934752,CAT 125R,C00,202411,Irwin; Matthew Joseph,0,12,20,20
1683660935779,CENG 15,A01,204712,Yang; Kesong,0,1,0,0
1683660936807,CENG 114,A00,202070,Jahed Motlagh; Zeinab,5,0,20,15
1683660937837,CGS 105,A00,185477,Wesling; Megan E.,24,0,40,16
1683660938863,CGS 106,A00,185494,Staff,11,0,22,11
1683660939889,CGS 108,A00,185495,Staff,14,0,20,6
1683660940915,CGS 114,A00,185496,Staff,13,0,18,5
1683660941940,CGS 119,A00,185501,Staff,15,0,20,5
1683660942964,CGS 120,A00,185511,Staff,12,0,20,8
1683660944063,CHEM 4,A01,184675,Bussey; Thomas J,97,0,100,3
1683660945091,CHEM 6A,A01,184677,Staff,32,0,60,28
1683660946117,CHEM 6B,A01,184679,Staff,63,0,100,37
1683660947145,CHEM 6C,A01,184681,Bussey; Thomas J,0,0,50,50
1683660947145,CHEM 6C,A02,184682,Bussey; Thomas J,32,0,50,18
1683660948171,CHEM 40A,A01,184684,Albizati; Kim F.,34,0,100,66
1683660949196,CHEM 40B,A01,184686,Albizati; Kim F.,0,22,100,100
1683660950219,CHEM 41B,A01,184690,Staff,51,0,100,49
1683660951243,COGS 3,A01,184715,Boyle; Mary E. T.,0,27,40,40
1683660952268,COGS 14B,A01,185172,Staff,0,14,38,38
1683660953292,COGS 18,A01,184736,Staff,14,0,80,66
1683660954315,COGS 100,A01,184932,Staff,0,7,73,73
1683660955340,COGS 101A,A01,184935,Staff,0,39,30,30
1683660956363,COGS 101B,A01,184944,Staff,0,2,30,30
1683660957387,COGS 101C,A01,184946,Staff,0,10,30,30
1683660958413,COGS 102A,A01,184951,Johnson; Christine M.,2,0,40,38
1683660959435,COGS 107B,A01,184953,Mooshagian; Eric Frederick,0,51,40,40
1683660960462,COGS 118B,A01,184959,Gupta; Anjum,0,49,40,40
1683660961486,COGS 153,A00,184961,Staff,0,16,30,30
1683660962512,COGS 177,A00,184962,Staff,0,21,30,30
1683660963536,COGS 187A,A01,184969,Boyle; Mary E. T.,0,19,40,40
1683660964562,COMM 10,A01,185174,Staff,0,5,25,25
1683660964562,COMM 10,A02,185189,Staff,0,2,25,25
1683660964562,COMM 10,A03,269821,Staff,0,1,0,0
1683660965586,COMM 100B,A01,185475,Staff,0,1,0,2
1683660965586,COMM 100B,A02,185476,Staff,12,0,25,13
1683660966610,COMM 100C,A01,185314,Staff,1,0,25,24
1683660966610,COMM 100C,A02,185327,Staff,18,0,25,7
1683660967637,COMM 110M,A00,185349,Staff,0,0,40,40
1683660968663,COMM 113T,A00,185352,Staff,25,0,40,15
1683660969690,COMM 114I,A00,185353,Staff,31,0,40,9
1683660970717,COMM 131,A00,185354,Staff,17,0,30,13
1683660971741,CSE 8A,A50,185358,Cao; Yingjun,0,46,10,10
1683660972764,CSE 8B,A01,185362,Staff,0,48,50,50
1683660973792,CSE 11,A01,185416,Cao; Yingjun,0,91,10,10
1683660974817,CSE 20,A01,185445,Briones; Jor-el Thomas Caparas,4,0,25,21
1683660975841,CSE 21,A01,185447,Staff,9,0,50,41
1683660976866,CSE 101,A01,185451,Staff,0,13,50,50
1683660976866,CSE 101,B01,185453,Jones; Miles E,0,14,50,50
1683660978919,CSE 141,A01,185458,Eldon; John,16,0,100,84
1683660979942,CSE 141L,A01,185461,Eldon; John,8,0,100,92
1683660980969,CSE 142,A01,185463,Staff,34,0,60,26
1683660980969,CSE 142,B01,201355,Staff,0,7,60,60
1683660981993,CSE 142L,A01,185470,Staff,34,0,60,26
1683660981993,CSE 142L,B01,201417,Staff,0,6,60,60
1683660983019,CSE 190,A00,201433,Staff,32,0,49,17
1683660984042,DOC 1,A01,259136,Strom; Megan C.,7,0,15,8
1683660984042,DOC 1,A02,259137,Strom; Megan C.,14,0,15,1
1683660984042,DOC 1,A03,259138,Strom; Megan C.,14,0,15,1
1683660984042,DOC 1,A04,259139,Strom; Megan C.,14,0,15,1
1683660985068,DOC 100D,A00,259140,Pass; Natalye Joann,14,0,25,11
1683660986092,DSGN 1,A01,184749,Rill; Bryan,0,26,30,30
1683660987118,DSGN 100,A01,185168,Staff,0,2,25,25
1683660988141,ECE 5,A01,185626,Morris; Karcher William,0,11,0,0
1683660989167,ECE 101,A01,185628,Staff,14,0,70,56
1683660990194,ECE 107,A01,185635,Baghdadchi; Saharnaz,0,0,20,20
1683660990194,ECE 107,A02,185638,Baghdadchi; Saharnaz,2,0,20,18
1683660991217,ECE 148,A01,185647,Silberman; Jack,0,0,16,16
1683660992241,ECON 1,A01,185537,Crane; Meredith Helen,54,0,70,16
1683660993267,ECON 3,A01,185549,Crane; Meredith Helen,29,0,70,41
1683660994294,ECON 4,A01,203354,Anderson; John Charles,0,5,10,10
1683660995320,ECON 100A,A01,185574,Staff,0,5,40,40
1683660996344,ECON 100B,A01,185576,Staff,0,12,50,50
1683660997366,ECON 100C,A01,185589,Newhouse; Herbert S,30,0,70,40
1683660998394,ECON 105,A00,185608,Vespa; Emanuel Ignacio,19,0,35,16
1683660999422,ECON 109,A01,185610,Shishkin; Denis,9,0,35,26
1683661000445,ECON 110A,A01,185612,Staff,9,0,40,31
1683661001472,ECON 120A,A01,185615,Staff,20,0,40,20
1683661002505,ECON 120C,A01,185617,Sun; Yixiao,0,20,70,70
1683661003533,ECON 144,A00,203346,Squires; Dale E,2,0,35,33
1683661004558,ECON 171,A01,203349,Newhouse; Herbert S,0,1,35,35
1683661005586,ECON 173A,A01,185621,Toda; Alexis Akira,20,0,35,15
1683661006616,EDS 25,A01,202413,Staff,0,1,0,0
1683661006616,EDS 25,A02,202414,Staff,0,1,0,0
1683661006616,EDS 25,A03,202415,Staff,0,0,0,0
1683661006616,EDS 25,A04,202416,Staff,0,1,0,0
1683661006616,EDS 25,A05,202439,Staff,0,0,0,0
1683661006616,EDS 25,A06,202440,Staff,0,0,0,0
1683661006616,EDS 25,B01,202631,Staff,0,0,0,0
1683661006616,EDS 25,B02,202632,Staff,0,0,0,0
1683661006616,EDS 25,B03,202639,Staff,0,0,0,0
1683661006616,EDS 25,B04,202640,Staff,0,0,0,0
1683661006616,EDS 25,B05,202643,Staff,0,0,0,0
1683661006616,EDS 25,B06,202644,Staff,0,0,0,0
1683661007642,EDS 38,A01,202659,Black; Alison Michelle,24,0,25,1
1683661008665,EDS 115,A00,202652,Staff,18,0,30,12
1683661009691,EDS 125,A00,202649,Staff,13,0,30,17
1683661010718,EDS 126,A01,203332,Staff,30,0,30,0
1683661011742,EDS 139,A00,202838,Staff,16,0,25,9
1683661012774,EDS 146,A01,202655,Staff,14,0,25,11
1683661013801,ENG 15,A00,185667,Staff,0,1,0,0
1683661013801,ENG 15,B00,185672,Staff,0,0,0,0
1683661013801,ENG 15,C00,185675,Staff,0,0,0,0
1683661013801,ENG 15,D00,185682,Staff,0,0,0,0
1683661013801,ENG 15,E00,185684,Staff,0,0,0,0
1683661014827,ETHN 103,A00,185710,Staff,0,8,35,35
1683661015851,ETHN 103A,A00,199228,Man; Simeon S,0,0,9,9
1683661016874,ETHN 109,A00,185711,Staff,16,0,35,19
1683661017897,ETHN 142,A00,185726,Staff,0,4,30,30
1683661018921,ETHN 163J,A00,199229,Man; Simeon S,5,0,8,3
1683661019946,ETHN 168,A00,185727,Staff,7,0,10,3
1683661020970,ETHN 182,A00,185728,Staff,0,0,35,35
1683661021994,ETHN 183,A00,185737,Staff,9,0,18,9
1683661023020,GLBH 111,A01,209361,Burgos; Jose L.,0,0,0,0
1683661025072,HIEU 104,A00,185792,Staff,14,0,20,6
1683661026095,HIEU 115,A00,185800,Staff,0,0,20,20
1683661027118,HIEU 128,A00,185801,Staff,0,9,20,20
1683661028142,HIEU 147,A00,185802,Staff,15,0,20,5
1683661029166,HIEU 154,A00,185823,Staff,11,0,20,9
1683661030195,HILA 102,A00,185826,Staff,14,0,20,6
1683661031224,HILD 2C,A01,185778,Staff,0,13,20,20
1683661032251,HILD 7B,A01,185780,Kwak; Nancy,0,17,32,32
1683661032251,HILD 7B,A02,185781,Kwak; Nancy,0,18,32,32
1683661033275,HILD 30,A01,185791,Staff,12,0,20,8
1683661034302,HISC 119,A00,185830,Golan; Tal,0,9,20,20
1683661035328,HITO 156GS,A00,185831,Patterson; Patrick H.,0,0,0,23
1683661036352,HIUS 103,A00,185832,Man; Simeon S,0,4,20,20
1683661037379,HIUS 117,A00,185836,Kwak; Nancy,2,0,20,18
1683661038402,HIUS 125,A00,185840,Man; Simeon S,0,2,23,23
1683661039425,HIUS 149,A00,185845,Staff,1,0,20,19
1683661040451,HUM 3,A01,185882,Zavodny; Tatiana Sophia,0,8,50,50
1683661040451,HUM 3,B01,185899,Caldwell; Michael Alan,0,18,50,50
1683661041475,HUM 3GS,A00,185900,Patterson; Patrick H.,0,0,0,23
1683661042498,HUM 4,A01,185938,Zroka; Amy Liane,29,0,50,21
1683661042498,HUM 4,B01,185956,Watkins; Eric,0,4,50,50
1683661042498,HUM 4,B02,202209,Watkins; Eric,0,5,50,50
1683661042498,HUM 4,B03,202210,Watkins; Eric,0,5,50,50
1683661043524,HUM 5,A01,185958,West; Geoffrey Scott,0,0,50,50
1683661043524,HUM 5,A02,202215,West; Geoffrey Scott,0,0,50,50
1683661044548,INTL 190,A00,185959,Gagnon; Jeffrey C,0,0,0,9
1683661044548,INTL 190,B00,185960,Lettieri; Michael Joseph,0,0,0,2
1683661045572,JAPN 180,A00,254509,Staff,5,0,30,25
1683661046597,LATI 10,A01,202853,Kennemore; Amy Michelle,4,0,35,31
1683661046597,LATI 10,A02,202854,Kennemore; Amy Michelle,2,0,35,33
1683661046597,LATI 10,A03,270054,Kennemore; Amy Michelle,30,0,30,0
1683661047679,LATI 180,A00,202855,Kennemore; Amy Michelle,11,0,20,9
1683661048702,LAWS 101,A00,201767,Golan; Tal,0,7,40,40
1683661049729,LIFR 1C,A00,185961,Staff,6,0,20,14
1683661050755,LIFR 1CX,A00,185962,Staff,7,0,20,13
1683661051778,LIFR 1D,A00,185963,Staff,7,0,20,13
1683661052805,LIFR 1DX,A00,185964,Staff,7,0,20,13
1683661053829,LIGN 101,A01,186039,Staff,43,0,50,7
1683661054853,LIGN 165,A00,186040,Staff,15,0,50,35
1683661055876,LTCS 108,A00,186041,Staff,5,0,10,5
1683661056900,LTCS 119,A00,186042,Staff,15,0,20,5
1683661057924,LTCS 130,A00,186043,Wesling; Megan E.,15,0,25,10
1683661059976,LTEA 138,A00,186119,Staff,14,0,40,26
1683661061003,LTEN 124,A00,186148,Staff,5,0,25,20
1683661062030,LTEN 178,A00,186149,Staff,7,0,15,8
1683661063055,LTEN 181,A00,186150,Blanco; John D,34,0,40,6
1683661064079,LTWL 120,A00,186160,Staff,20,0,25,5
1683661065103,LTWL 165,A00,186161,Staff,22,0,25,3
1683661066125,LTWR 100,A00,186162,Staff,0,5,15,15
1683661067149,LTWR 102,A00,186163,Doller; Ben,5,0,15,10
1683661068176,MAE 8,A01,186412,Staff,0,0,0,0
1683661069200,MAE 30B,A00,186445,Bahadori; Mohammad Yousef,82,0,100,18
1683661070223,MAE 40,A00,186592,Bewley; Thomas R,10,0,50,40
1683661071257,MAE 101B,A00,186593,Bahadori; Mohammad Yousef,80,0,100,20
1683661072283,MAE 105,A00,186594,Bandaru; Prabhakar,10,0,50,40
1683661073308,MAE 107,A00,186599,Pham; Hieu Tan,0,7,120,120
1683661074336,MAE 148,A01,186660,Silberman; Jack,3,0,16,13
1683661075363,MATH 10A,A01,188095,Staff,0,6,35,35
1683661076388,MATH 10B,A01,188097,Bowers; Adam R.,0,12,30,30
1683661076388,MATH 10B,A02,188099,Bowers; Adam R.,0,11,30,30
1683661076388,MATH 10B,B01,188104,Bowers; Adam R.,0,10,30,30
1683661076388,MATH 10B,B02,188106,Bowers; Adam R.,1,9,30,29
1683661077414,MATH 10C,A01,188111,Staff,0,18,30,30
1683661077414,MATH 10C,A02,188127,Staff,0,19,30,30
1683661077414,MATH 10C,A03,188131,Staff,0,19,30,30
1683661077414,MATH 10C,B01,188218,Staff,17,0,30,13
1683661077414,MATH 10C,B02,188244,Staff,13,0,30,17
1683661077414,MATH 10C,B03,188277,Staff,14,0,30,16
1683661078438,MATH 18,A01,188344,Bach; Quang Tran,18,0,30,12
1683661078438,MATH 18,A02,188345,Bach; Quang Tran,11,0,30,19
1683661078438,MATH 18,B01,188353,Bach; Quang Tran,11,0,30,19
1683661078438,MATH 18,B02,188354,Bach; Quang Tran,19,0,30,11
1683661079478,MATH 20A,A01,188374,Staff,11,0,35,24
1683661080506,MATH 20B,A01,188382,Ohm; Ko Woon,7,0,30,23
1683661080506,MATH 20B,A02,188383,Ohm; Ko Woon,22,0,30,8
1683661080506,MATH 20B,B01,188385,Ohm; Ko Woon,7,0,30,23
1683661080506,MATH 20B,B02,188392,Ohm; Ko Woon,22,0,30,8
1683661081536,MATH 20C,A01,188394,Harel; Guershon,10,0,30,20
1683661081536,MATH 20C,A02,188395,Harel; Guershon,13,0,30,17
1683661081536,MATH 20C,B01,188404,Harel; Guershon,5,0,30,25
1683661081536,MATH 20C,B02,188405,Harel; Guershon,18,0,30,12
1683661082565,MATH 20D,A01,188414,Hammock; Frances H,0,1,30,30
1683661082565,MATH 20D,A02,188415,Hammock; Frances H,0,1,30,30
1683661082565,MATH 20D,B01,188447,Hammock; Frances H,0,1,30,30
1683661082565,MATH 20D,B02,188486,Hammock; Frances H,3,0,30,27
1683661083594,MATH 20E,A01,188649,Staff,21,0,30,9
1683661083594,MATH 20E,A02,188650,Staff,21,0,30,9
1683661083594,MATH 20E,A03,188673,Staff,0,0,30,30
1683661084618,MATH 102,A01,188675,Staff,0,36,35,35
1683661085647,MATH 103B,A01,188681,Staff,3,0,35,32
1683661085647,MATH 103B,B01,188692,Staff,5,0,35,30
1683661086672,MATH 109,A01,188695,Salehi Golsefidy; Alireza,24,0,35,11
1683661086672,MATH 109,A02,188696,Salehi Golsefidy; Alireza,25,0,35,10
1683661087700,MATH 120A,A01,188698,Eggers; John Dietrich,7,0,35,28
1683661088725,MATH 142B,A01,188736,Ioana; Adrian,0,1,30,30
1683661088725,MATH 142B,A02,188741,Ioana; Adrian,0,1,30,30
1683661088725,MATH 142B,A03,188743,Ioana; Adrian,0,1,30,30
1683661089752,MATH 168A,A01,188790,Staff,0,10,35,35
1683661090777,MATH 170A,A01,188803,Nie; Jiawang,0,2,35,35
1683661090777,MATH 170A,A02,188811,Nie; Jiawang,0,0,35,35
1683661090777,MATH 170A,A03,188814,Nie; Jiawang,0,0,35,35
1683661090777,MATH 170A,A04,188815,Nie; Jiawang,9,0,35,26
1683661091802,MATH 193B,A01,188817,Staff,0,0,35,35
1683661091802,MATH 193B,A02,188818,Staff,5,0,35,30
1683661092833,MGT 4,A01,202857,Anderson; John Charles,61,0,80,19
1683661093860,MGT 12,A00,202858,Lindenberger; Wade Douglas,40,0,90,50
1683661094887,MGT 18,A00,202859,Staff,74,0,90,16
1683661095913,MGT 18GS,A00,202860,McKay; Michael J,13,0,28,15
1683661096938,MGT 45,A00,202861,Pecore; Joseph P.,11,0,90,79
1683661097961,MGT 100,A00,202863,Yavorsky; Daniel Ryan,28,0,90,62
1683661098989,MGT 103,A00,202864,Ehrich; Kristine R,0,18,90,90
1683661100013,MGT 112,A00,202865,Ehrich; Kristine R,14,0,90,76
1683661101046,MGT 121A,A00,202868,Staff,90,20,90,0
1683661102074,MGT 131B,A00,202869,Anderson; John Charles,59,0,90,31
1683661103100,MGT 136,A00,202871,Lindenberger; Wade Douglas,83,0,90,7
1683661104126,MGT 164,A00,202873,Staff,0,67,90,91
1683661105158,MGT 164GS,A00,202874,McKay; Mary A,13,0,28,15
1683661106186,MGT 180,A00,202875,Staff,0,50,90,91
1683661107214,MMW 11R,A01,205019,Herbst; Matthew,1,0,30,29
1683661107214,MMW 11R,A02,205026,Herbst; Matthew,29,0,30,1
1683661108244,MMW 15,A01,193512,Chang; Edmond Yi-Teh,0,8,28,28
1683661108244,MMW 15,A02,193513,Chang; Edmond Yi-Teh,0,5,28,28
1683661108244,MMW 15,A03,193514,Chang; Edmond Yi-Teh,0,5,28,28
1683661108244,MMW 15,A04,193515,Chang; Edmond Yi-Teh,0,5,28,28
1683661108244,MMW 15,A05,193516,Chang; Edmond Yi-Teh,0,5,28,28
1683661108244,MMW 15,A06,193517,Chang; Edmond Yi-Teh,0,6,28,28
1683661108244,MMW 15,B01,193519,Chang; Edmond Yi-Teh,0,5,28,28
1683661108244,MMW 15,B02,193520,Chang; Edmond Yi-Teh,0,5,28,28
1683661108244,MMW 15,B03,193521,Chang; Edmond Yi-Teh,0,5,28,28
1683661108244,MMW 15,B04,193522,Chang; Edmond Yi-Teh,0,5,28,28
1683661108244,MMW 15,B05,193523,Chang; Edmond Yi-Teh,0,5,28,28
1683661108244,MMW 15,B06,193524,Chang; Edmond Yi-Teh,0,5,28,28
1683661109269,MMW 122,A01,193526,Rahimi; Babak,0,16,28,28
1683661109269,MMW 122,A02,193527,Rahimi; Babak,0,15,28,28
1683661109269,MMW 122,A03,193528,Rahimi; Babak,0,0,0,0
1683661109269,MMW 122,A04,193529,Rahimi; Babak,0,0,0,0
1683661110293,MUS 1A,A01,186663,Staff,1,20,35,34
1683661111319,MUS 4,A01,186715,Staff,0,12,35,35
1683661112343,MUS 5R,A01,186796,Dubnov; Shlomo,0,17,35,35
1683661113371,MUS 6,A01,186798,Staff,0,5,25,25
1683661114394,MUS 7,A01,186830,Staff,11,0,35,24
1683661115422,MUS 8,A01,186930,Staff,0,26,35,35
1683661116449,MUS 15,A01,186932,Staff,0,16,35,35
1683661116449,MUS 15,B01,186934,Staff,1,17,35,34
1683661117473,MUS 80,A00,186935,Staff,0,0,20,20
1683661117473,MUS 80,B00,186936,Staff,24,0,25,1
1683661118497,NANO 11,A00,204702,Lipomi; Darren John,0,0,0,0
1683661119524,NANO 15,A01,204709,Yang; Kesong,0,1,0,0
1683661120549,NANO 114,A00,202069,Jahed Motlagh; Zeinab,3,0,10,7
1683661121572,PHIL 1,A00,186955,Grush; Rick Scott,31,0,40,9
1683661122597,PHIL 10,A01,186973,Grush; Rick Scott,27,0,35,8
1683661122597,PHIL 10,A02,186974,Grush; Rick Scott,33,0,35,2
1683661123626,PHIL 13,A01,186976,Staff,3,0,35,32
1683661123626,PHIL 13,A02,186977,Staff,16,0,35,19
1683661124657,PHIL 14,A01,186979,Staff,31,0,35,4
1683661124657,PHIL 14,A02,186986,Staff,32,0,35,3
1683661125681,PHIL 28,A01,186988,Staff,16,0,30,14
1683661125681,PHIL 28,A02,186989,Staff,1,0,30,29
1683661125681,PHIL 28,A03,186990,Staff,10,0,30,20
1683661125681,PHIL 28,A04,186991,Staff,26,0,30,4
1683661126718,PHIL 120,A00,186997,Staff,23,0,40,17
1683661127745,PHIL 137,A00,187003,Staff,7,0,40,33
1683661128770,PHIL 150,A00,187015,Staff,47,0,70,23
1683661129799,PHIL 167,A00,187021,Lamey; Andy M.,34,0,40,6
1683661130821,PHIL 174,A01,202226,Staff,17,0,20,3
1683661130821,PHIL 174,A02,202235,Staff,20,0,20,0
1683661131847,PHIL 191A,A00,258918,Staff,0,0,1,1
1683661132873,PHYS 1A,A00,187028,Staff,26,0,60,34
1683661133898,PHYS 1AL,001,187036,Staff,3,0,30,27
1683661133898,PHYS 1AL,002,187049,Staff,18,0,30,12
1683661134924,PHYS 1B,A00,187058,Staff,22,0,60,38
1683661135947,PHYS 1BL,001,187064,Staff,0,1,30,30
1683661135947,PHYS 1BL,002,187070,Staff,4,0,30,26
1683661136971,PHYS 1C,A00,187082,Staff,29,0,120,91
1683661137995,PHYS 1CL,001,187088,Staff,0,9,30,30
1683661137995,PHYS 1CL,002,187089,Staff,0,1,30,30
1683661137995,PHYS 1CL,009,262693,Staff,9,0,30,21
1683661139022,PHYS 2B,A01,187097,Staff,55,0,115,60
1683661140046,PHYS 2C,A01,187099,Staff,63,0,115,52
1683661141071,PHYS 2CL,A01,187101,Staff,5,0,28,23
1683661141071,PHYS 2CL,A02,187102,Staff,15,0,28,13
1683661142097,PHYS 2D,A01,187123,Shotwell; Brian,95,0,115,20
1683661143125,PHYS 4B,A01,187133,Grinstein; Benjamin,35,0,50,15
1683661144152,POLI 10,A00,188819,Staff,0,4,50,50
1683661145178,POLI 11,A00,188827,Staff,43,0,50,7
1683661146202,POLI 13R,A00,188828,Staff,0,1,20,20
1683661147227,POLI 27,A01,188830,Elgin; Samuel Zincke,0,2,70,70
1683661148250,POLI 30,A00,188832,Desposato; Scott,30,0,50,20
1683661149275,POLI 102F,A00,188834,Staff,0,0,40,40
1683661150298,POLI 104A,A00,188852,Staff,13,0,30,17
1683661151378,POLI 104I,A00,188853,Staff,0,7,20,20
1683661152401,POLI 110B,A00,188854,Wiens; David,6,0,20,14
1683661153426,POLI 112A,A00,188855,Wiens; David,3,0,30,27
1683661154455,POLI 117R,A00,188856,Forman; Fonna,0,12,20,20
1683661155482,POLI 118,A00,188857,Ingham; Sean,8,0,20,12
1683661156506,POLI 120G,A00,188858,Staff,8,0,30,22
1683661157534,POLI 131CR,A00,188863,Hoston; Germaine,21,0,50,29
1683661158556,POLI 133,A00,188864,Nellis; Gareth Hb,44,0,50,6
1683661159583,POLI 134D,A00,188865,Desposato; Scott,27,0,30,3
1683661160609,POLI 142A,A00,188871,Gartzke; Erik,21,0,50,29
1683661161634,POLI 142K,A00,188874,Staff,38,0,50,12
1683661162658,POLI 143,A00,188940,Gartzke; Erik,16,0,30,14
1683661163684,POLI 153,A00,188943,Staff,2,0,20,18
1683661164711,POLI 160AA,A00,188944,Staff,11,0,40,29
1683661165737,POLI 170A,A00,188945,Staff,11,0,30,19
1683661167790,PSYC 1,A00,188952,Staff,36,0,90,54
1683661168814,PSYC 2,B00,188953,Staff,19,0,35,16
1683661169840,PSYC 6,A00,188970,Staff,47,0,60,13
1683661170867,PSYC 7,A00,188973,Staff,35,0,45,10
1683661171896,PSYC 60,A01,188980,Rickard; Timothy C.,42,0,60,18
1683661172921,PSYC 70,A01,189001,Steiner; Eric Tomas,22,0,45,23
1683661173946,PSYC 100,A00,189005,Lacefield; Katharine I,0,99,120,120
1683661174973,PSYC 102,A00,189008,Staff,8,0,30,22
1683661175996,PSYC 106,B00,189026,Gorman; Michael R.,27,0,60,33
1683661177024,PSYC 114,B01,189033,Winkielman; Piotr,0,31,30,30
1683661178048,PSYC 131,A00,189036,Anagnostaras; Stephan,0,43,60,60
1683661179072,PSYC 136,A00,189041,Lowe; Angela Beth,0,7,25,25
1683661180094,PSYC 137,A00,189057,Winkielman; Piotr,0,37,25,25
1683661181121,PSYC 144,A00,189107,Wixted; John T,0,11,50,50
1683661183170,PSYC 162,A00,189142,Staff,0,9,85,85
1683661184194,PSYC 172,A00,189144,Gorman; Michael R.,0,6,30,30
1683661186244,PSYC 179,A00,189146,Lacefield; Katharine I,0,87,120,120
1683661187271,PSYC 181,A00,189147,Anagnostaras; Stephan,0,44,90,90
1683661188298,PSYC 190R,A00,189148,Barner; David A.,0,23,80,80
1683661189324,PSYC 191,A00,189275,Rickard; Timothy C.,0,10,25,25
1683661190348,PSYC 193,A00,189276,Chapman; Eddie Nathaniel,0,1,0,4
1683661191372,PSYC 193L,A01,189281,Lowe; Angela Beth,10,0,20,10
1683661191372,PSYC 193L,B01,189285,Staff,28,0,35,7
1683661192400,RELI 149,A00,187137,Rahimi; Babak,7,0,40,33
1683661193430,SE 9,A01,187315,Staff,0,2,18,18
1683661194454,SE 101B,A00,187409,Staff,24,0,30,6
1683661195479,SE 110B,A00,187444,Staff,10,0,40,30
1683661196502,SE 130B,A00,187449,Staff,31,0,40,9
1683661197529,SE 150A,A00,187516,Staff,9,0,20,11
1683661198558,SE 154,A00,187528,Staff,29,0,50,21
1683661199583,SIO 3,A01,258171,Staff,35,0,40,5
1683661200609,SIO 10,A00,187144,Cook; Geoffrey W,0,6,75,75
1683661201633,SIO 45,A00,187152,Cook; Geoffrey W,0,4,100,100
1683661202658,SIO 109R,A00,194486,Staff,0,4,20,20
1683661204708,SIO 187,A01,187233,Kacev; David,12,0,40,28
1683661205732,SOCI 1,A01,258656,Thorpe; Charles Robert,28,0,30,2
1683661205732,SOCI 1,A02,258658,Thorpe; Charles Robert,30,0,30,0
1683661205732,SOCI 1,A03,258661,Thorpe; Charles Robert,25,0,25,0
1683661205732,SOCI 1,A04,258666,Thorpe; Charles Robert,22,0,25,3
1683661205732,SOCI 1,A05,258897,Thorpe; Charles Robert,22,0,25,3
1683661205732,SOCI 1,A06,258898,Thorpe; Charles Robert,25,0,25,0
1683661206755,SOCI 30,A01,258903,Pardo Guerra; Juan Pablo,14,0,30,16
1683661207779,SOCI 102,A00,258904,Staff,9,0,25,16
1683661208806,SOCI 106,A00,258905,Staff,19,0,25,6
1683661209832,SOCI 111,A00,258907,Ribas Norris; Janet Vanesa,26,0,30,4
1683661210859,SOCI 121R,A00,258908,Pardo Guerra; Juan Pablo,8,0,30,22
1683661211885,SOCI 126,A01,203330,Staff,14,0,20,6
1683661212942,SOCI 131,A00,258909,Thorpe; Charles Robert,30,0,60,30
1683661213966,SOCI 135,A00,258910,Payne; Christine Anna,0,11,30,30
1683661214992,SOCI 157,A00,258911,Staff,12,0,30,18
1683661216016,SOCI 184,A00,258912,Staff,25,0,30,5
1683661217041,SOCI 188D,A00,258913,Staff,22,0,30,8
1683661218065,SYN 2,001,187529,Staff,9,0,16,7
1683661218065,SYN 2,002,201452,Staff,0,20,16,16
1683661218065,SYN 2,003,201469,Staff,1,0,16,15
1683661219089,SYN 100,A01,187531,Staff,0,9,20,20
1683661219089,SYN 100,B01,201491,Staff,0,10,20,20
1683661220114,TDAC 1,A00,189286,Walsh; Kim C.,3,0,20,17
1683661220114,TDAC 1,B00,189287,Harting; Carla Kelso,10,0,20,10
1683661221145,TDAC 101,A00,189300,Walsh; Kim C.,16,0,20,4
1683661221145,TDAC 101,B00,189301,Harting; Carla Kelso,18,0,20,2
1683661222169,TDAC 102,A00,189304,Basso; Beatrice,14,0,20,6
1683661223193,TDAC 108,A00,189305,Staff,18,0,20,2
1683661224218,TDDE 131,A00,189310,Staff,19,0,20,1
1683661224218,TDDE 131,B00,189314,Staff,19,0,20,1
1683661224218,TDDE 131,C00,189315,Staff,48,0,50,2
1683661224218,TDDE 131,D00,189316,Staff,14,0,15,1
1683661224218,TDDE 131,E00,204841,Staff,20,0,20,0
1683661225245,TDGE 10,A00,189289,Staff,27,0,50,23
1683661225245,TDGE 10,B00,189290,Havis; Allan,0,0,50,50
1683661226272,TDGE 11,A00,189291,Fulton; Julia,0,4,50,50
1683661226272,TDGE 11,B00,189292,Staff,20,0,25,5
1683661226272,TDGE 11,C00,260270,Staff,0,0,0,0
1683661227296,TDGE 25,A00,189294,Staff,2,0,20,18
1683661228318,TDGE 124,A00,189318,Fulton; Julia,0,8,50,50
1683661229342,TDGE 125,A00,189319,Staff,13,0,25,12
1683661229342,TDGE 125,B00,189320,Staff,23,0,25,2
1683661230365,TDGE 127,A00,189322,Havis; Allan,0,0,50,50
1683661231390,TDHT 101,A00,189323,Staff,18,0,25,7
1683661231390,TDHT 101,B00,189324,Staff,25,0,25,0
1683661232416,TDHT 102,A00,189325,Staff,49,0,50,1
1683661233441,TDMV 1,A00,189295,Arcidiacono; Kristin,20,0,30,10
1683661233441,TDMV 1,B00,189296,Caligagan; Maria T.,24,0,30,6
1683661234468,TDMV 2,A00,189297,Sammartano; Tonnie,27,0,30,3
1683661234468,TDMV 2,B00,189299,Arcidiacono; Kristin,23,0,30,7
1683661235495,TDMV 3,A00,204998,Rincon; Alicia,22,0,30,8
1683661236519,TDMV 120,A00,189458,Sammartano; Tonnie,28,0,30,2
1683661237542,TDMV 138,A00,189541,Jun; Grace Shin Hae,20,0,40,20
1683661238566,TDMV 142,A00,189717,Caligagan; Tony,25,0,30,5
1683661238566,TDMV 142,B00,189718,Caligagan; Maria T.,25,0,30,5
1683661239593,TMC 2,A01,187533,Staff,25,0,25,0
1683661239593,TMC 2,A02,187534,Staff,25,0,25,0
1683661240618,USP 1,A01,187536,Kwak; Nancy,0,16,25,25
1683661241643,USP 5,A01,187538,Staff,9,0,25,16
1683661242670,USP 101,A00,199253,Staff,0,4,0,0
1683661243699,USP 124,A00,187562,Boomhower; Matthew Charles,0,0,30,30
1683661244722,USP 138,A00,187582,Staff,20,0,25,5
1683661245749,USP 152,A01,187597,Staff,3,0,25,22
1683661246774,USP 153,A00,187598,Staff,19,0,25,6
1683661247797,USP 168,A00,187607,Kwak; Nancy,2,0,5,3
1683661248828,USP 173,A00,187619,Staff,4,0,25,21
1683661249850,USP 181,A00,187638,Staff,0,4,25,25
1683661250874,VIS 103,A00,187650,Cruz; Edwin Teddy,17,0,75,58
1683661251897,VIS 110D,A00,187669,Staff,13,0,22,9
1683661252920,VIS 127C,A00,187720,Shen; Kuiyi,68,0,146,78
1683661253944,VIS 149,A00,187731,Yoldas; Pinar,1,14,22,21
1683661255044,VIS 151,A01,188091,Staff,22,0,34,12
1683661255044,VIS 151,A02,188092,Staff,11,0,34,23
1683661256070,VIS 160B,A00,188093,Stalbaum; Brett,0,1,10,10
1683661258119,WCWP 10B,A00,201720,Staff,10,0,15,5
1683661258119,WCWP 10B,B00,201722,Staff,9,0,15,6
1683661259145,WCWP 100,A00,201725,Gagnon; Jeffrey C,0,0,2,2
1683661259145,WCWP 100,B00,201727,Staff,0,4,15,15
1683661262269,ANBI 133,A00,258401,Wilder; Linnea Lorene,34,0,40,6
1683661263296,ANBI 140,A00,258395,Hrvoj Mihic; Branka,18,0,25,7
1683661264320,ANSC 120,A00,258402,Bialecki; Jon Anthony,26,0,40,14
1683661265349,ANSC 144,A00,258400,Staff,12,0,40,28
1683661267400,ANSC 166,A00,258396,Parish; Steven Martin,156,0,175,19
1683661268424,ANSC 180,A00,193533,Staff,8,0,20,12
1683661269452,ANSC 188,A00,258397,Jassal; Aftab,34,0,40,6
1683661270478,ANTH 3,A01,258316,Staff,23,0,30,7
1683661271502,ANTH 5,A00,258394,Semendeferi; Ekaterini,16,0,20,4
1683661272526,ANTH 21,A01,258331,Staff,4,0,40,36
1683661273551,ANTH 103,A00,258398,Varma; Saiba,15,0,25,10
1683661274584,AWP 10,001,202034,Staff,0,0,0,0
1683661274584,AWP 10,002,202035,Staff,0,0,0,0
1683661274584,AWP 10,003,202036,Staff,0,0,0,0
1683661274584,AWP 10,004,202037,Staff,0,0,0,0
1683661274584,AWP 10,005,202038,Staff,0,0,0,0
1683661274584,AWP 10,006,202039,Staff,0,0,0,0
1683661274584,AWP 10,007,202040,Staff,0,0,0,0
1683661274584,AWP 10,008,202041,Staff,0,0,0,0
1683661274584,AWP 10,009,202042,Staff,0,0,0,0
1683661274584,AWP 10,010,202043,Staff,0,0,0,0
1683661274584,AWP 10,011,202044,Staff,0,0,0,0
1683661274584,AWP 10,012,202045,Staff,0,0,0,0
1683661274584,AWP 10,013,202046,Staff,0,0,0,0
1683661274584,AWP 10,014,202047,Staff,0,0,0,0
1683661274584,AWP 10,015,202048,Staff,0,0,0,0
1683661274584,AWP 10,016,202049,Staff,0,0,0,0
1683661274584,AWP 10,017,202050,Staff,0,0,0,0
1683661274584,AWP 10,018,202051,Staff,0,0,0,0
1683661274584,AWP 10,019,202052,Staff,0,0,0,0
1683661274584,AWP 10,020,202053,Staff,0,0,0,0
1683661274584,AWP 10,021,202054,Staff,0,0,0,0
1683661274584,AWP 10,022,202055,Staff,0,0,0,0
1683661274584,AWP 10,023,202056,Staff,0,0,0,0
1683661274584,AWP 10,024,202057,Staff,0,0,0,0
1683661274584,AWP 10,025,202058,Staff,0,0,0,0
1683661274584,AWP 10,026,202059,Staff,0,0,0,0
1683661275610,AWP 102,001,202032,Staff,0,0,0,0
1683661275610,AWP 102,002,202033,Staff,0,0,0,0
1683661276635,BENG 100,A01,254234,Taylor Amos; Alyssa C,31,0,40,9
1683661277660,BENG 196,001,270013,Engler; Adam J.,9999,0,9999,0
1683661278690,BICD 100R,A01,202018,Smith; Laurie,0,7,32,32
1683661278690,BICD 100R,A02,202019,Smith; Laurie,0,3,32,32
1683661278690,BICD 100R,A03,202020,Smith; Laurie,0,1,32,32
1683661278690,BICD 100R,A04,202021,Smith; Laurie,6,0,32,26
1683661278690,BICD 100R,A05,202022,Smith; Laurie,11,0,32,21
1683661279715,BICD 136,A01,193242,Gustafson-Brown; Cindy,0,2,32,32
1683661279715,BICD 136,A02,193244,Gustafson-Brown; Cindy,13,0,32,19
1683661280745,BIEB 102,A01,193249,Butler; Shannon Rhey,1,2,32,31
1683661280745,BIEB 102,A02,193251,Butler; Shannon Rhey,0,0,32,32
1683661280745,BIEB 102,A03,193253,Butler; Shannon Rhey,0,0,32,32
1683661280745,BIEB 102,A04,193255,Butler; Shannon Rhey,14,0,32,18
1683661280745,BIEB 102,A05,193265,Butler; Shannon Rhey,25,0,32,7
1683661280745,BIEB 102,A06,193269,Butler; Shannon Rhey,14,0,32,18
1683661282795,BIEB 150,A01,193274,Staff,0,0,32,32
1683661282795,BIEB 150,A02,193285,Staff,24,0,32,8
1683661283820,BIEB 194,A00,193286,Kurle; Carolyn M.,20,0,32,12
1683661284844,BILD 1,A01,192291,Staff,15,0,32,17
1683661284844,BILD 1,A02,192292,Staff,30,0,32,2
1683661284844,BILD 1,B01,192520,Reuther; Keefe,0,1,0,0
1683661284844,BILD 1,B02,192532,Reuther; Keefe,0,1,0,0
1683661285874,BILD 3,A01,192556,Butler; Shannon Rhey,0,0,32,32
1683661285874,BILD 3,A02,192581,Butler; Shannon Rhey,1,0,32,31
1683661285874,BILD 3,A03,192611,Butler; Shannon Rhey,21,0,32,11
1683661285874,BILD 3,A04,192612,Butler; Shannon Rhey,24,0,32,8
1683661285874,BILD 3,A05,192613,Butler; Shannon Rhey,26,0,32,6
1683661285874,BILD 3,A06,192679,Butler; Shannon Rhey,27,0,32,5
1683661285874,BILD 3,A07,192682,Butler; Shannon Rhey,20,0,32,12
1683661286901,BILD 4,A01,192836,Reuther; Keefe,1,0,24,23
1683661286901,BILD 4,A02,193044,Reuther; Keefe,4,0,24,20
1683661287926,BILD 10,A01,193142,Gustafson-Brown; Cindy,29,0,32,3
1683661287926,BILD 10,A02,193149,Gustafson-Brown; Cindy,31,0,32,1
1683661288951,BIMM 100,A01,193301,Staff,0,6,32,32
1683661288951,BIMM 100,A02,193312,Staff,0,7,32,32
1683661288951,BIMM 100,A03,193323,Staff,0,9,32,32
1683661289977,BIMM 101,A01,193329,McDonnell; Lisa Marie,0,4,24,24
1683661289977,BIMM 101,A02,193339,McDonnell; Lisa Marie,1,3,24,23
1683661289977,BIMM 101,B01,193354,McDonnell; Lisa Marie,0,4,24,24
1683661289977,BIMM 101,B02,193357,McDonnell; Lisa Marie,0,3,24,24
1683661291001,BIMM 110,A01,193377,Tat; John,0,11,32,32
1683661291001,BIMM 110,A02,193378,Tat; John,0,10,32,32
1683661292030,BIMM 120,A01,206116,Staff,0,0,32,32
1683661292030,BIMM 120,A02,206117,Staff,6,0,32,26
1683661292030,BIMM 120,A03,206121,Staff,21,0,32,11
1683661293055,BIPN 100,A01,193393,Park; Ji Young,0,15,32,32
1683661293055,BIPN 100,A02,193402,Park; Ji Young,0,14,32,32
1683661293055,BIPN 100,A03,193413,Park; Ji Young,0,14,32,32
1683661293055,BIPN 100,A04,193414,Park; Ji Young,0,13,32,32
1683661294078,BIPN 102,A01,193429,Staff,0,0,32,32
1683661294078,BIPN 102,A02,193438,Staff,18,0,32,14
1683661295102,BIPN 106,A01,193450,Reyes Gonzalez; Catalina,0,2,40,40
1683661296126,BIPN 134,A01,193465,Cooke; James Edward,0,0,32,32
1683661296126,BIPN 134,A02,193474,Cooke; James Edward,25,0,32,7
1683661296126,BIPN 134,A03,193485,Cooke; James Edward,29,0,32,3
1683661296126,BIPN 134,A04,193486,Cooke; James Edward,20,0,32,12
1683661296126,BIPN 134,A05,193491,Cooke; James Edward,31,0,32,1
1683661296126,BIPN 134,A06,193501,Cooke; James Edward,30,0,32,2
1683661296126,BIPN 134,A07,193510,Cooke; James Edward,29,0,32,3
1683661298180,BISP 194,A00,222522,Staff,14,0,32,18
1683661299202,CAT 124,A01,202407,Staff,19,0,25,6
1683661300227,CAT 125,A00,202408,Marchisotto; Jennifer Anne,2,0,20,18
1683661301255,CAT 125R,A00,202409,Smith; Lauryn Alissa,0,11,20,20
1683661301255,CAT 125R,B00,202410,Morales; Celeste Georgianna,0,11,20,20
1683661301255,CAT 125R,C00,202411,Irwin; Matthew Joseph,0,12,20,20
1683661302280,CENG 15,A01,204712,Yang; Kesong,0,1,0,0
1683661303303,CENG 114,A00,202070,Jahed Motlagh; Zeinab,5,0,20,15
1683661304329,CGS 105,A00,185477,Wesling; Megan E.,24,0,40,16
1683661305354,CGS 106,A00,185494,Staff,11,0,22,11
1683661306377,CGS 108,A00,185495,Staff,14,0,20,6
1683661307401,CGS 114,A00,185496,Staff,13,0,18,5
1683661308424,CGS 119,A00,185501,Staff,15,0,20,5
1683661309449,CGS 120,A00,185511,Staff,12,0,20,8
1683661310590,CHEM 4,A01,184675,Bussey; Thomas J,97,0,100,3
1683661311627,CHEM 6A,A01,184677,Staff,32,0,60,28
1683661312650,CHEM 6B,A01,184679,Staff,63,0,100,37
1683661313674,CHEM 6C,A01,184681,Bussey; Thomas J,0,0,50,50
1683661313674,CHEM 6C,A02,184682,Bussey; Thomas J,32,0,50,18
1683661314698,CHEM 40A,A01,184684,Albizati; Kim F.,34,0,100,66
1683661315726,CHEM 40B,A01,184686,Albizati; Kim F.,0,22,100,100
1683661316753,CHEM 41B,A01,184690,Staff,51,0,100,49
1683661317781,COGS 3,A01,184715,Boyle; Mary E. T.,0,27,40,40
1683661318811,COGS 14B,A01,185172,Staff,0,14,38,38
1683661319835,COGS 18,A01,184736,Staff,14,0,80,66
1683661320861,COGS 100,A01,184932,Staff,0,7,73,73
1683661321885,COGS 101A,A01,184935,Staff,0,39,30,30
1683661322909,COGS 101B,A01,184944,Staff,0,2,30,30
1683661323938,COGS 101C,A01,184946,Staff,0,10,30,30
1683661324962,COGS 102A,A01,184951,Johnson; Christine M.,2,0,40,38
1683661325987,COGS 107B,A01,184953,Mooshagian; Eric Frederick,0,51,40,40
1683661327013,COGS 118B,A01,184959,Gupta; Anjum,0,49,40,40
1683661328038,COGS 153,A00,184961,Staff,0,16,30,30
1683661329062,COGS 177,A00,184962,Staff,0,21,30,30
1683661330088,COGS 187A,A01,184969,Boyle; Mary E. T.,0,19,40,40
1683661331116,COMM 10,A01,185174,Staff,0,5,25,25
1683661331116,COMM 10,A02,185189,Staff,0,2,25,25
1683661331116,COMM 10,A03,269821,Staff,0,1,0,0
1683661332142,COMM 100B,A01,185475,Staff,0,1,0,2
1683661332142,COMM 100B,A02,185476,Staff,12,0,25,13
1683661333165,COMM 100C,A01,185314,Staff,1,0,25,24
1683661333165,COMM 100C,A02,185327,Staff,18,0,25,7
1683661334191,COMM 110M,A00,185349,Staff,0,0,40,40
1683661335218,COMM 113T,A00,185352,Staff,25,0,40,15
1683661336243,COMM 114I,A00,185353,Staff,31,0,40,9
1683661337267,COMM 131,A00,185354,Staff,17,0,30,13
1683661338291,CSE 8A,A50,185358,Cao; Yingjun,0,46,10,10
1683661339318,CSE 8B,A01,185362,Staff,0,48,50,50
1683661340347,CSE 11,A01,185416,Cao; Yingjun,0,91,10,10
1683661341375,CSE 20,A01,185445,Briones; Jor-el Thomas Caparas,4,0,25,21
1683661342402,CSE 21,A01,185447,Staff,9,0,50,41
1683661343426,CSE 101,A01,185451,Staff,0,13,50,50
1683661343426,CSE 101,B01,185453,Jones; Miles E,0,14,50,50
1683661345477,CSE 141,A01,185458,Eldon; John,16,0,100,84
1683661346505,CSE 141L,A01,185461,Eldon; John,8,0,100,92
1683661347529,CSE 142,A01,185463,Staff,34,0,60,26
1683661347529,CSE 142,B01,201355,Staff,0,7,60,60
1683661348554,CSE 142L,A01,185470,Staff,34,0,60,26
1683661348554,CSE 142L,B01,201417,Staff,0,6,60,60
1683661349580,CSE 190,A00,201433,Staff,32,0,49,17
1683661350604,DOC 1,A01,259136,Strom; Megan C.,7,0,15,8
1683661350604,DOC 1,A02,259137,Strom; Megan C.,14,0,15,1
1683661350604,DOC 1,A03,259138,Strom; Megan C.,14,0,15,1
1683661350604,DOC 1,A04,259139,Strom; Megan C.,14,0,15,1
1683661351629,DOC 100D,A00,259140,Pass; Natalye Joann,14,0,25,11
1683661352657,DSGN 1,A01,184749,Rill; Bryan,0,26,30,30
1683661353683,DSGN 100,A01,185168,Staff,0,2,25,25
1683661354707,ECE 5,A01,185626,Morris; Karcher William,0,11,0,0
1683661355733,ECE 101,A01,185628,Staff,14,0,70,56
1683661356767,ECE 107,A01,185635,Baghdadchi; Saharnaz,0,0,20,20
1683661356767,ECE 107,A02,185638,Baghdadchi; Saharnaz,2,0,20,18
1683661357794,ECE 148,A01,185647,Silberman; Jack,0,0,16,16
1683661358879,ECON 1,A01,185537,Crane; Meredith Helen,54,0,70,16
1683661359902,ECON 3,A01,185549,Crane; Meredith Helen,29,0,70,41
1683661360926,ECON 4,A01,203354,Anderson; John Charles,0,5,10,10
1683661361953,ECON 100A,A01,185574,Staff,0,5,40,40
1683661362977,ECON 100B,A01,185576,Staff,0,12,50,50
1683661364002,ECON 100C,A01,185589,Newhouse; Herbert S,30,0,70,40
1683661365027,ECON 105,A00,185608,Vespa; Emanuel Ignacio,19,0,35,16
1683661366052,ECON 109,A01,185610,Shishkin; Denis,9,0,35,26
1683661367079,ECON 110A,A01,185612,Staff,9,0,40,31
1683661368107,ECON 120A,A01,185615,Staff,20,0,40,20
1683661369131,ECON 120C,A01,185617,Sun; Yixiao,0,20,70,70
1683661370159,ECON 144,A00,203346,Squires; Dale E,2,0,35,33
1683661371183,ECON 171,A01,203349,Newhouse; Herbert S,0,1,35,35
1683661372210,ECON 173A,A01,185621,Toda; Alexis Akira,20,0,35,15
1683661373236,EDS 25,A01,202413,Staff,0,1,0,0
1683661373236,EDS 25,A02,202414,Staff,0,1,0,0
1683661373236,EDS 25,A03,202415,Staff,0,0,0,0
1683661373236,EDS 25,A04,202416,Staff,0,1,0,0
1683661373236,EDS 25,A05,202439,Staff,0,0,0,0
1683661373236,EDS 25,A06,202440,Staff,0,0,0,0
1683661373236,EDS 25,B01,202631,Staff,0,0,0,0
1683661373236,EDS 25,B02,202632,Staff,0,0,0,0
1683661373236,EDS 25,B03,202639,Staff,0,0,0,0
1683661373236,EDS 25,B04,202640,Staff,0,0,0,0
1683661373236,EDS 25,B05,202643,Staff,0,0,0,0
1683661373236,EDS 25,B06,202644,Staff,0,0,0,0
1683661374263,EDS 38,A01,202659,Black; Alison Michelle,24,0,25,1
1683661375292,EDS 115,A00,202652,Staff,18,0,30,12
1683661376321,EDS 125,A00,202649,Staff,13,0,30,17
1683661377345,EDS 126,A01,203332,Staff,30,0,30,0
1683661378372,EDS 139,A00,202838,Staff,16,0,25,9
1683661379398,EDS 146,A01,202655,Staff,14,0,25,11
1683661380426,ENG 15,A00,185667,Staff,0,1,0,0
1683661380426,ENG 15,B00,185672,Staff,0,0,0,0
1683661380426,ENG 15,C00,185675,Staff,0,0,0,0
1683661380426,ENG 15,D00,185682,Staff,0,0,0,0
1683661380426,ENG 15,E00,185684,Staff,0,0,0,0
1683661381451,ETHN 103,A00,185710,Staff,0,8,35,35
1683661382480,ETHN 103A,A00,199228,Man; Simeon S,0,0,9,9
1683661383508,ETHN 109,A00,185711,Staff,16,0,35,19
1683661384534,ETHN 142,A00,185726,Staff,0,4,30,30
1683661385558,ETHN 163J,A00,199229,Man; Simeon S,5,0,8,3
1683661386583,ETHN 168,A00,185727,Staff,7,0,10,3
1683661387610,ETHN 182,A00,185728,Staff,0,0,35,35
1683661388634,ETHN 183,A00,185737,Staff,9,0,18,9
1683661389662,GLBH 111,A01,209361,Burgos; Jose L.,0,0,0,0
1683661391710,HIEU 104,A00,185792,Staff,14,0,20,6
1683661392738,HIEU 115,A00,185800,Staff,0,0,20,20
1683661393767,HIEU 128,A00,185801,Staff,0,9,20,20
1683661394791,HIEU 147,A00,185802,Staff,15,0,20,5
1683661395818,HIEU 154,A00,185823,Staff,11,0,20,9
1683661396845,HILA 102,A00,185826,Staff,14,0,20,6
1683661397870,HILD 2C,A01,185778,Staff,0,13,20,20
1683661398899,HILD 7B,A01,185780,Kwak; Nancy,0,17,32,32
1683661398899,HILD 7B,A02,185781,Kwak; Nancy,0,18,32,32
1683661399924,HILD 30,A01,185791,Staff,12,0,20,8
1683661400949,HISC 119,A00,185830,Golan; Tal,0,9,20,20
1683661401976,HITO 156GS,A00,185831,Patterson; Patrick H.,0,0,0,23
1683661403004,HIUS 103,A00,185832,Man; Simeon S,0,4,20,20
1683661404027,HIUS 117,A00,185836,Kwak; Nancy,2,0,20,18
1683661405053,HIUS 125,A00,185840,Man; Simeon S,0,2,23,23
1683661406079,HIUS 149,A00,185845,Staff,1,0,20,19
1683661407105,HUM 3,A01,185882,Zavodny; Tatiana Sophia,0,8,50,50
1683661407105,HUM 3,B01,185899,Caldwell; Michael Alan,0,18,50,50
1683661408126,HUM 3GS,A00,185900,Patterson; Patrick H.,0,0,0,23
1683661409152,HUM 4,A01,185938,Zroka; Amy Liane,29,0,50,21
1683661409152,HUM 4,B01,185956,Watkins; Eric,0,4,50,50
1683661409152,HUM 4,B02,202209,Watkins; Eric,0,5,50,50
1683661409152,HUM 4,B03,202210,Watkins; Eric,0,5,50,50
1683661410180,HUM 5,A01,185958,West; Geoffrey Scott,0,0,50,50
1683661410180,HUM 5,A02,202215,West; Geoffrey Scott,0,0,50,50
1683661411207,INTL 190,A00,185959,Gagnon; Jeffrey C,0,0,0,9
1683661411207,INTL 190,B00,185960,Lettieri; Michael Joseph,0,0,0,2
1683661412232,JAPN 180,A00,254509,Staff,5,0,30,25
1683661413256,LATI 10,A01,202853,Kennemore; Amy Michelle,4,0,35,31
1683661413256,LATI 10,A02,202854,Kennemore; Amy Michelle,2,0,35,33
1683661413256,LATI 10,A03,270054,Kennemore; Amy Michelle,30,0,30,0
1683661414280,LATI 180,A00,202855,Kennemore; Amy Michelle,11,0,20,9
1683661415307,LAWS 101,A00,201767,Golan; Tal,0,7,40,40
1683661416333,LIFR 1C,A00,185961,Staff,6,0,20,14
1683661417360,LIFR 1CX,A00,185962,Staff,7,0,20,13
1683661418384,LIFR 1D,A00,185963,Staff,7,0,20,13
1683661419411,LIFR 1DX,A00,185964,Staff,7,0,20,13
1683661420435,LIGN 101,A01,186039,Staff,43,0,50,7
1683661421460,LIGN 165,A00,186040,Staff,15,0,50,35
1683661422484,LTCS 108,A00,186041,Staff,5,0,10,5
1683661423507,LTCS 119,A00,186042,Staff,15,0,20,5
1683661424531,LTCS 130,A00,186043,Wesling; Megan E.,15,0,25,10
1683661426581,LTEA 138,A00,186119,Staff,14,0,40,26
1683661427604,LTEN 124,A00,186148,Staff,5,0,25,20
1683661428630,LTEN 178,A00,186149,Staff,7,0,15,8
1683661429653,LTEN 181,A00,186150,Blanco; John D,34,0,40,6
1683661430677,LTWL 120,A00,186160,Staff,20,0,25,5
1683661431703,LTWL 165,A00,186161,Staff,22,0,25,3
1683661432730,LTWR 100,A00,186162,Staff,0,5,15,15
1683661433754,LTWR 102,A00,186163,Doller; Ben,5,0,15,10
1683661434782,MAE 8,A01,186412,Staff,0,0,0,0
1683661435809,MAE 30B,A00,186445,Bahadori; Mohammad Yousef,82,0,100,18
1683661436833,MAE 40,A00,186592,Bewley; Thomas R,10,0,50,40
1683661437856,MAE 101B,A00,186593,Bahadori; Mohammad Yousef,80,0,100,20
1683661438880,MAE 105,A00,186594,Bandaru; Prabhakar,10,0,50,40
1683661439906,MAE 107,A00,186599,Pham; Hieu Tan,0,7,120,120
1683661440934,MAE 148,A01,186660,Silberman; Jack,3,0,16,13
1683661441962,MATH 10A,A01,188095,Staff,0,6,35,35
1683661442990,MATH 10B,A01,188097,Bowers; Adam R.,0,12,30,30
1683661442990,MATH 10B,A02,188099,Bowers; Adam R.,0,11,30,30
1683661442990,MATH 10B,B01,188104,Bowers; Adam R.,0,10,30,30
1683661442990,MATH 10B,B02,188106,Bowers; Adam R.,1,9,30,29
1683661444018,MATH 10C,A01,188111,Staff,0,18,30,30
1683661444018,MATH 10C,A02,188127,Staff,0,19,30,30
1683661444018,MATH 10C,A03,188131,Staff,0,19,30,30
1683661444018,MATH 10C,B01,188218,Staff,17,0,30,13
1683661444018,MATH 10C,B02,188244,Staff,13,0,30,17
1683661444018,MATH 10C,B03,188277,Staff,14,0,30,16
1683661445046,MATH 18,A01,188344,Bach; Quang Tran,18,0,30,12
1683661445046,MATH 18,A02,188345,Bach; Quang Tran,11,0,30,19
1683661445046,MATH 18,B01,188353,Bach; Quang Tran,11,0,30,19
1683661445046,MATH 18,B02,188354,Bach; Quang Tran,19,0,30,11
1683661446070,MATH 20A,A01,188374,Staff,11,0,35,24
1683661447099,MATH 20B,A01,188382,Ohm; Ko Woon,7,0,30,23
1683661447099,MATH 20B,A02,188383,Ohm; Ko Woon,22,0,30,8
1683661447099,MATH 20B,B01,188385,Ohm; Ko Woon,7,0,30,23
1683661447099,MATH 20B,B02,188392,Ohm; Ko Woon,22,0,30,8
1683661448131,MATH 20C,A01,188394,Harel; Guershon,10,0,30,20
1683661448131,MATH 20C,A02,188395,Harel; Guershon,13,0,30,17
1683661448131,MATH 20C,B01,188404,Harel; Guershon,5,0,30,25
1683661448131,MATH 20C,B02,188405,Harel; Guershon,18,0,30,12
1683661449160,MATH 20D,A01,188414,Hammock; Frances H,0,1,30,30
1683661449160,MATH 20D,A02,188415,Hammock; Frances H,0,1,30,30
1683661449160,MATH 20D,B01,188447,Hammock; Frances H,0,1,30,30
1683661449160,MATH 20D,B02,188486,Hammock; Frances H,3,0,30,27
1683661450186,MATH 20E,A01,188649,Staff,21,0,30,9
1683661450186,MATH 20E,A02,188650,Staff,21,0,30,9
1683661450186,MATH 20E,A03,188673,Staff,0,0,30,30
1683661451214,MATH 102,A01,188675,Staff,0,36,35,35
1683661452242,MATH 103B,A01,188681,Staff,3,0,35,32
1683661452242,MATH 103B,B01,188692,Staff,5,0,35,30
1683661453267,MATH 109,A01,188695,Salehi Golsefidy; Alireza,24,0,35,11
1683661453267,MATH 109,A02,188696,Salehi Golsefidy; Alireza,25,0,35,10
1683661454296,MATH 120A,A01,188698,Eggers; John Dietrich,7,0,35,28
1683661455320,MATH 142B,A01,188736,Ioana; Adrian,0,1,30,30
1683661455320,MATH 142B,A02,188741,Ioana; Adrian,0,1,30,30
1683661455320,MATH 142B,A03,188743,Ioana; Adrian,0,1,30,30
1683661456346,MATH 168A,A01,188790,Staff,0,10,35,35
1683661457373,MATH 170A,A01,188803,Nie; Jiawang,0,2,35,35
1683661457373,MATH 170A,A02,188811,Nie; Jiawang,0,0,35,35
1683661457373,MATH 170A,A03,188814,Nie; Jiawang,0,0,35,35
1683661457373,MATH 170A,A04,188815,Nie; Jiawang,9,0,35,26
1683661458401,MATH 193B,A01,188817,Staff,0,0,35,35
1683661458401,MATH 193B,A02,188818,Staff,5,0,35,30
1683661459425,MGT 4,A01,202857,Anderson; John Charles,61,0,80,19
1683661460448,MGT 12,A00,202858,Lindenberger; Wade Douglas,40,0,90,50
1683661461475,MGT 18,A00,202859,Staff,74,0,90,16
1683661462555,MGT 18GS,A00,202860,McKay; Michael J,13,0,28,15
1683661463579,MGT 45,A00,202861,Pecore; Joseph P.,11,0,90,79
1683661464603,MGT 100,A00,202863,Yavorsky; Daniel Ryan,28,0,90,62
1683661465630,MGT 103,A00,202864,Ehrich; Kristine R,0,18,90,90
1683661466654,MGT 112,A00,202865,Ehrich; Kristine R,14,0,90,76
1683661467678,MGT 121A,A00,202868,Staff,90,20,90,0
1683661468703,MGT 131B,A00,202869,Anderson; John Charles,59,0,90,31
1683661469737,MGT 136,A00,202871,Lindenberger; Wade Douglas,83,0,90,7
1683661470765,MGT 164,A00,202873,Staff,0,67,90,91
1683661471788,MGT 164GS,A00,202874,McKay; Mary A,13,0,28,15
1683661472815,MGT 180,A00,202875,Staff,0,50,90,91
1683661473842,MMW 11R,A01,205019,Herbst; Matthew,1,0,30,29
1683661473842,MMW 11R,A02,205026,Herbst; Matthew,29,0,30,1
1683661474874,MMW 15,A01,193512,Chang; Edmond Yi-Teh,0,8,28,28
1683661474874,MMW 15,A02,193513,Chang; Edmond Yi-Teh,0,5,28,28
1683661474874,MMW 15,A03,193514,Chang; Edmond Yi-Teh,0,5,28,28
1683661474874,MMW 15,A04,193515,Chang; Edmond Yi-Teh,0,5,28,28
1683661474874,MMW 15,A05,193516,Chang; Edmond Yi-Teh,0,5,28,28
1683661474874,MMW 15,A06,193517,Chang; Edmond Yi-Teh,0,6,28,28
1683661474874,MMW 15,B01,193519,Chang; Edmond Yi-Teh,0,5,28,28
1683661474874,MMW 15,B02,193520,Chang; Edmond Yi-Teh,0,5,28,28
1683661474874,MMW 15,B03,193521,Chang; Edmond Yi-Teh,0,5,28,28
1683661474874,MMW 15,B04,193522,Chang; Edmond Yi-Teh,0,5,28,28
1683661474874,MMW 15,B05,193523,Chang; Edmond Yi-Teh,0,5,28,28
1683661474874,MMW 15,B06,193524,Chang; Edmond Yi-Teh,0,5,28,28
1683661475898,MMW 122,A01,193526,Rahimi; Babak,0,16,28,28
1683661475898,MMW 122,A02,193527,Rahimi; Babak,0,15,28,28
1683661475898,MMW 122,A03,193528,Rahimi; Babak,0,0,0,0
1683661475898,MMW 122,A04,193529,Rahimi; Babak,0,0,0,0
1683661476928,MUS 1A,A01,186663,Staff,1,20,35,34
1683661477955,MUS 4,A01,186715,Staff,0,12,35,35
1683661478979,MUS 5R,A01,186796,Dubnov; Shlomo,0,17,35,35
1683661480003,MUS 6,A01,186798,Staff,0,5,25,25
1683661481029,MUS 7,A01,186830,Staff,11,0,35,24
1683661482056,MUS 8,A01,186930,Staff,0,26,35,35
1683661483080,MUS 15,A01,186932,Staff,0,16,35,35
1683661483080,MUS 15,B01,186934,Staff,1,17,35,34
1683661484104,MUS 80,A00,186935,Staff,0,0,20,20
1683661484104,MUS 80,B00,186936,Staff,24,0,25,1
1683661485129,NANO 11,A00,204702,Lipomi; Darren John,0,0,0,0
1683661486156,NANO 15,A01,204709,Yang; Kesong,0,1,0,0
1683661487180,NANO 114,A00,202069,Jahed Motlagh; Zeinab,3,0,10,7
1683661488204,PHIL 1,A00,186955,Grush; Rick Scott,31,0,40,9
1683661489234,PHIL 10,A01,186973,Grush; Rick Scott,27,0,35,8
1683661489234,PHIL 10,A02,186974,Grush; Rick Scott,33,0,35,2
1683661490258,PHIL 13,A01,186976,Staff,3,0,35,32
1683661490258,PHIL 13,A02,186977,Staff,16,0,35,19
1683661491282,PHIL 14,A01,186979,Staff,31,0,35,4
1683661491282,PHIL 14,A02,186986,Staff,32,0,35,3
1683661492306,PHIL 28,A01,186988,Staff,16,0,30,14
1683661492306,PHIL 28,A02,186989,Staff,1,0,30,29
1683661492306,PHIL 28,A03,186990,Staff,10,0,30,20
1683661492306,PHIL 28,A04,186991,Staff,26,0,30,4
1683661493330,PHIL 120,A00,186997,Staff,23,0,40,17
1683661494353,PHIL 137,A00,187003,Staff,7,0,40,33
1683661495376,PHIL 150,A00,187015,Staff,47,0,70,23
1683661496400,PHIL 167,A00,187021,Lamey; Andy M.,34,0,40,6
1683661497425,PHIL 174,A01,202226,Staff,17,0,20,3
1683661497425,PHIL 174,A02,202235,Staff,20,0,20,0
1683661498449,PHIL 191A,A00,258918,Staff,0,0,1,1
1683661499475,PHYS 1A,A00,187028,Staff,26,0,60,34
1683661500497,PHYS 1AL,001,187036,Staff,3,0,30,27
1683661500497,PHYS 1AL,002,187049,Staff,18,0,30,12
1683661501520,PHYS 1B,A00,187058,Staff,22,0,60,38
1683661502542,PHYS 1BL,001,187064,Staff,0,1,30,30
1683661502542,PHYS 1BL,002,187070,Staff,4,0,30,26
1683661503565,PHYS 1C,A00,187082,Staff,29,0,120,91
1683661504588,PHYS 1CL,001,187088,Staff,0,9,30,30
1683661504588,PHYS 1CL,002,187089,Staff,0,1,30,30
1683661504588,PHYS 1CL,009,262693,Staff,9,0,30,21
1683661505616,PHYS 2B,A01,187097,Staff,55,0,115,60
1683661506641,PHYS 2C,A01,187099,Staff,63,0,115,52
1683661507666,PHYS 2CL,A01,187101,Staff,5,0,28,23
1683661507666,PHYS 2CL,A02,187102,Staff,15,0,28,13
1683661508693,PHYS 2D,A01,187123,Shotwell; Brian,95,0,115,20
1683661509717,PHYS 4B,A01,187133,Grinstein; Benjamin,35,0,50,15
1683661510744,POLI 10,A00,188819,Staff,0,4,50,50
1683661511772,POLI 11,A00,188827,Staff,43,0,50,7
1683661512798,POLI 13R,A00,188828,Staff,0,1,20,20
1683661513826,POLI 27,A01,188830,Elgin; Samuel Zincke,0,2,70,70
1683661514849,POLI 30,A00,188832,Desposato; Scott,30,0,50,20
1683661515873,POLI 102F,A00,188834,Staff,0,0,40,40
1683661516896,POLI 104A,A00,188852,Staff,13,0,30,17
1683661517919,POLI 104I,A00,188853,Staff,0,7,20,20
1683661518942,POLI 110B,A00,188854,Wiens; David,6,0,20,14
1683661519963,POLI 112A,A00,188855,Wiens; David,3,0,30,27
1683661520988,POLI 117R,A00,188856,Forman; Fonna,0,12,20,20
1683661522016,POLI 118,A00,188857,Ingham; Sean,8,0,20,12
1683661523040,POLI 120G,A00,188858,Staff,8,0,30,22
1683661524064,POLI 131CR,A00,188863,Hoston; Germaine,21,0,50,29
1683661525091,POLI 133,A00,188864,Nellis; Gareth Hb,44,0,50,6
1683661526114,POLI 134D,A00,188865,Desposato; Scott,27,0,30,3
1683661527137,POLI 142A,A00,188871,Gartzke; Erik,21,0,50,29
1683661528159,POLI 142K,A00,188874,Staff,38,0,50,12
1683661529186,POLI 143,A00,188940,Gartzke; Erik,16,0,30,14
1683661530210,POLI 153,A00,188943,Staff,2,0,20,18
1683661531238,POLI 160AA,A00,188944,Staff,11,0,40,29
1683661532262,POLI 170A,A00,188945,Staff,11,0,30,19
1683661534312,PSYC 1,A00,188952,Staff,36,0,90,54
1683661535336,PSYC 2,B00,188953,Staff,19,0,35,16
1683661536363,PSYC 6,A00,188970,Staff,47,0,60,13
1683661537390,PSYC 7,A00,188973,Staff,35,0,45,10
1683661538418,PSYC 60,A01,188980,Rickard; Timothy C.,42,0,60,18
1683661539445,PSYC 70,A01,189001,Steiner; Eric Tomas,22,0,45,23
1683661540472,PSYC 100,A00,189005,Lacefield; Katharine I,0,99,120,120
1683661541494,PSYC 102,A00,189008,Staff,8,0,30,22
1683661542520,PSYC 106,B00,189026,Gorman; Michael R.,27,0,60,33
1683661543549,PSYC 114,B01,189033,Winkielman; Piotr,0,31,30,30
1683661544581,PSYC 131,A00,189036,Anagnostaras; Stephan,0,43,60,60
1683661545605,PSYC 136,A00,189041,Lowe; Angela Beth,0,7,25,25
1683661546632,PSYC 137,A00,189057,Winkielman; Piotr,0,37,25,25
1683661547656,PSYC 144,A00,189107,Wixted; John T,0,11,50,50
1683661549705,PSYC 162,A00,189142,Staff,0,9,85,85
1683661550732,PSYC 172,A00,189144,Gorman; Michael R.,0,6,30,30
1683661552784,PSYC 179,A00,189146,Lacefield; Katharine I,0,87,120,120
1683661553808,PSYC 181,A00,189147,Anagnostaras; Stephan,0,44,90,90
1683661554832,PSYC 190R,A00,189148,Barner; David A.,0,23,80,80
1683661555858,PSYC 191,A00,189275,Rickard; Timothy C.,0,10,25,25
1683661556883,PSYC 193,A00,189276,Chapman; Eddie Nathaniel,0,1,0,4
1683661557907,PSYC 193L,A01,189281,Lowe; Angela Beth,10,0,20,10
1683661557907,PSYC 193L,B01,189285,Staff,28,0,35,7
1683661558932,RELI 149,A00,187137,Rahimi; Babak,7,0,40,33
1683661559958,SE 9,A01,187315,Staff,0,2,18,18
1683661560986,SE 101B,A00,187409,Staff,24,0,30,6
1683661562011,SE 110B,A00,187444,Staff,10,0,40,30
1683661563034,SE 130B,A00,187449,Staff,31,0,40,9
1683661564059,SE 150A,A00,187516,Staff,9,0,20,11
1683661565083,SE 154,A00,187528,Staff,29,0,50,21
1683661566165,SIO 3,A01,258171,Staff,35,0,40,5
1683661567191,SIO 10,A00,187144,Cook; Geoffrey W,0,7,75,75
1683661568215,SIO 45,A00,187152,Cook; Geoffrey W,0,5,100,100
1683661569241,SIO 109R,A00,194486,Staff,0,4,20,20
1683661571294,SIO 187,A01,187233,Kacev; David,12,0,40,28
1683661572323,SOCI 1,A01,258656,Thorpe; Charles Robert,28,0,30,2
1683661572323,SOCI 1,A02,258658,Thorpe; Charles Robert,30,0,30,0
1683661572323,SOCI 1,A03,258661,Thorpe; Charles Robert,25,0,25,0
1683661572323,SOCI 1,A04,258666,Thorpe; Charles Robert,22,0,25,3
1683661572323,SOCI 1,A05,258897,Thorpe; Charles Robert,22,0,25,3
1683661572323,SOCI 1,A06,258898,Thorpe; Charles Robert,25,0,25,0
1683661573347,SOCI 30,A01,258903,Pardo Guerra; Juan Pablo,14,0,30,16
1683661574373,SOCI 102,A00,258904,Staff,9,0,25,16
1683661575398,SOCI 106,A00,258905,Staff,19,0,25,6
1683661576425,SOCI 111,A00,258907,Ribas Norris; Janet Vanesa,26,0,30,4
1683661577452,SOCI 121R,A00,258908,Pardo Guerra; Juan Pablo,8,0,30,22
1683661578476,SOCI 126,A01,203330,Staff,14,0,20,6
1683661579505,SOCI 131,A00,258909,Thorpe; Charles Robert,30,0,60,30
1683661580532,SOCI 135,A00,258910,Payne; Christine Anna,0,11,30,30
1683661581555,SOCI 157,A00,258911,Staff,12,0,30,18
1683661582582,SOCI 184,A00,258912,Staff,25,0,30,5
1683661583606,SOCI 188D,A00,258913,Staff,22,0,30,8
1683661584632,SYN 2,001,187529,Staff,9,0,16,7
1683661584632,SYN 2,002,201452,Staff,0,20,16,16
1683661584632,SYN 2,003,201469,Staff,1,0,16,15
1683661585657,SYN 100,A01,187531,Staff,0,9,20,20
1683661585657,SYN 100,B01,201491,Staff,0,10,20,20
1683661586685,TDAC 1,A00,189286,Walsh; Kim C.,3,0,20,17
1683661586685,TDAC 1,B00,189287,Harting; Carla Kelso,10,0,20,10
1683661587708,TDAC 101,A00,189300,Walsh; Kim C.,16,0,20,4
1683661587708,TDAC 101,B00,189301,Harting; Carla Kelso,18,0,20,2
1683661588735,TDAC 102,A00,189304,Basso; Beatrice,14,0,20,6
1683661589761,TDAC 108,A00,189305,Staff,18,0,20,2
1683661590790,TDDE 131,A00,189310,Staff,19,0,20,1
1683661590790,TDDE 131,B00,189314,Staff,19,0,20,1
1683661590790,TDDE 131,C00,189315,Staff,48,0,50,2
1683661590790,TDDE 131,D00,189316,Staff,14,0,15,1
1683661590790,TDDE 131,E00,204841,Staff,20,0,20,0
1683661591814,TDGE 10,A00,189289,Staff,27,0,50,23
1683661591814,TDGE 10,B00,189290,Havis; Allan,0,0,50,50
1683661592841,TDGE 11,A00,189291,Fulton; Julia,0,4,50,50
1683661592841,TDGE 11,B00,189292,Staff,20,0,25,5
1683661592841,TDGE 11,C00,260270,Staff,0,0,0,0
1683661593863,TDGE 25,A00,189294,Staff,2,0,20,18
1683661594887,TDGE 124,A00,189318,Fulton; Julia,0,8,50,50
1683661595914,TDGE 125,A00,189319,Staff,13,0,25,12
1683661595914,TDGE 125,B00,189320,Staff,23,0,25,2
1683661596936,TDGE 127,A00,189322,Havis; Allan,0,0,50,50
1683661597960,TDHT 101,A00,189323,Staff,18,0,25,7
1683661597960,TDHT 101,B00,189324,Staff,25,0,25,0
1683661598987,TDHT 102,A00,189325,Staff,49,0,50,1
1683661600015,TDMV 1,A00,189295,Arcidiacono; Kristin,20,0,30,10
1683661600015,TDMV 1,B00,189296,Caligagan; Maria T.,24,0,30,6
1683661601042,TDMV 2,A00,189297,Sammartano; Tonnie,27,0,30,3
1683661601042,TDMV 2,B00,189299,Arcidiacono; Kristin,23,0,30,7
1683661602070,TDMV 3,A00,204998,Rincon; Alicia,22,0,30,8
1683661603098,TDMV 120,A00,189458,Sammartano; Tonnie,28,0,30,2
1683661604124,TDMV 138,A00,189541,Jun; Grace Shin Hae,20,0,40,20
1683661605149,TDMV 142,A00,189717,Caligagan; Tony,25,0,30,5
1683661605149,TDMV 142,B00,189718,Caligagan; Maria T.,25,0,30,5
1683661606172,TMC 2,A01,187533,Staff,25,0,25,0
1683661606172,TMC 2,A02,187534,Staff,25,0,25,0
1683661607198,USP 1,A01,187536,Kwak; Nancy,0,16,25,25
1683661608221,USP 5,A01,187538,Staff,9,0,25,16
1683661609248,USP 101,A00,199253,Staff,0,4,0,0
1683661610272,USP 124,A00,187562,Boomhower; Matthew Charles,0,0,30,30
1683661611298,USP 138,A00,187582,Staff,20,0,25,5
1683661612324,USP 152,A01,187597,Staff,3,0,25,22
1683661613348,USP 153,A00,187598,Staff,19,0,25,6
1683661614371,USP 168,A00,187607,Kwak; Nancy,2,0,5,3
1683661615394,USP 173,A00,187619,Staff,4,0,25,21
1683661616421,USP 181,A00,187638,Staff,0,4,25,25
1683661617446,VIS 103,A00,187650,Cruz; Edwin Teddy,17,0,75,58
1683661618468,VIS 110D,A00,187669,Staff,13,0,22,9
1683661619492,VIS 127C,A00,187720,Shen; Kuiyi,68,0,146,78
1683661620517,VIS 149,A00,187731,Yoldas; Pinar,1,14,22,21
1683661621541,VIS 151,A01,188091,Staff,22,0,34,12
1683661621541,VIS 151,A02,188092,Staff,11,0,34,23
1683661622565,VIS 160B,A00,188093,Stalbaum; Brett,0,1,10,10
1683661624612,WCWP 10B,A00,201720,Staff,10,0,15,5
1683661624612,WCWP 10B,B00,201722,Staff,9,0,15,6
1683661625637,WCWP 100,A00,201725,Gagnon; Jeffrey C,0,0,2,2
1683661625637,WCWP 100,B00,201727,Staff,0,4,15,15
1683661628733,ANBI 133,A00,258401,Wilder; Linnea Lorene,34,0,40,6
1683661629763,ANBI 140,A00,258395,Hrvoj Mihic; Branka,18,0,25,7
1683661630787,ANSC 120,A00,258402,Bialecki; Jon Anthony,26,0,40,14
1683661631820,ANSC 144,A00,258400,Staff,12,0,40,28
1683661633871,ANSC 166,A00,258396,Parish; Steven Martin,156,0,175,19
1683661634896,ANSC 180,A00,193533,Staff,8,0,20,12
1683661635924,ANSC 188,A00,258397,Jassal; Aftab,34,0,40,6
1683661636948,ANTH 3,A01,258316,Staff,23,0,30,7
1683661637971,ANTH 5,A00,258394,Semendeferi; Ekaterini,16,0,20,4
1683661638996,ANTH 21,A01,258331,Staff,4,0,40,36
1683661640019,ANTH 103,A00,258398,Varma; Saiba,15,0,25,10
1683661641052,AWP 10,001,202034,Staff,0,0,0,0
1683661641052,AWP 10,002,202035,Staff,0,0,0,0
1683661641052,AWP 10,003,202036,Staff,0,0,0,0
1683661641052,AWP 10,004,202037,Staff,0,0,0,0
1683661641052,AWP 10,005,202038,Staff,0,0,0,0
1683661641052,AWP 10,006,202039,Staff,0,0,0,0
1683661641052,AWP 10,007,202040,Staff,0,0,0,0
1683661641052,AWP 10,008,202041,Staff,0,0,0,0
1683661641052,AWP 10,009,202042,Staff,0,0,0,0
1683661641052,AWP 10,010,202043,Staff,0,0,0,0
1683661641052,AWP 10,011,202044,Staff,0,0,0,0
1683661641052,AWP 10,012,202045,Staff,0,0,0,0
1683661641052,AWP 10,013,202046,Staff,0,0,0,0
1683661641052,AWP 10,014,202047,Staff,0,0,0,0
1683661641052,AWP 10,015,202048,Staff,0,0,0,0
1683661641052,AWP 10,016,202049,Staff,0,0,0,0
1683661641052,AWP 10,017,202050,Staff,0,0,0,0
1683661641052,AWP 10,018,202051,Staff,0,0,0,0
1683661641052,AWP 10,019,202052,Staff,0,0,0,0
1683661641052,AWP 10,020,202053,Staff,0,0,0,0
1683661641052,AWP 10,021,202054,Staff,0,0,0,0
1683661641052,AWP 10,022,202055,Staff,0,0,0,0
1683661641052,AWP 10,023,202056,Staff,0,0,0,0
1683661641052,AWP 10,024,202057,Staff,0,0,0,0
1683661641052,AWP 10,025,202058,Staff,0,0,0,0
1683661641052,AWP 10,026,202059,Staff,0,0,0,0
1683661642080,AWP 102,001,202032,Staff,0,0,0,0
1683661642080,AWP 102,002,202033,Staff,0,0,0,0
1683661643104,BENG 100,A01,254234,Taylor Amos; Alyssa C,31,0,40,9
1683661644130,BENG 196,001,270013,Engler; Adam J.,9999,0,9999,0
1683661645158,BICD 100R,A01,202018,Smith; Laurie,0,7,32,32
1683661645158,BICD 100R,A02,202019,Smith; Laurie,0,3,32,32
1683661645158,BICD 100R,A03,202020,Smith; Laurie,0,1,32,32
1683661645158,BICD 100R,A04,202021,Smith; Laurie,6,0,32,26
1683661645158,BICD 100R,A05,202022,Smith; Laurie,11,0,32,21
1683661646183,BICD 136,A01,193242,Gustafson-Brown; Cindy,0,2,32,32
1683661646183,BICD 136,A02,193244,Gustafson-Brown; Cindy,13,0,32,19
1683661647212,BIEB 102,A01,193249,Butler; Shannon Rhey,1,2,32,31
1683661647212,BIEB 102,A02,193251,Butler; Shannon Rhey,0,0,32,32
1683661647212,BIEB 102,A03,193253,Butler; Shannon Rhey,0,0,32,32
1683661647212,BIEB 102,A04,193255,Butler; Shannon Rhey,14,0,32,18
1683661647212,BIEB 102,A05,193265,Butler; Shannon Rhey,25,0,32,7
1683661647212,BIEB 102,A06,193269,Butler; Shannon Rhey,14,0,32,18
1683661649258,BIEB 150,A01,193274,Staff,0,0,32,32
1683661649258,BIEB 150,A02,193285,Staff,24,0,32,8
1683661650288,BIEB 194,A00,193286,Kurle; Carolyn M.,20,0,32,12
1683661651318,BILD 1,A01,192291,Staff,15,0,32,17
1683661651318,BILD 1,A02,192292,Staff,30,0,32,2
1683661651318,BILD 1,B01,192520,Reuther; Keefe,0,1,0,0
1683661651318,BILD 1,B02,192532,Reuther; Keefe,0,1,0,0
1683661652345,BILD 3,A01,192556,Butler; Shannon Rhey,0,0,32,32
1683661652345,BILD 3,A02,192581,Butler; Shannon Rhey,1,0,32,31
1683661652345,BILD 3,A03,192611,Butler; Shannon Rhey,21,0,32,11
1683661652345,BILD 3,A04,192612,Butler; Shannon Rhey,24,0,32,8
1683661652345,BILD 3,A05,192613,Butler; Shannon Rhey,26,0,32,6
1683661652345,BILD 3,A06,192679,Butler; Shannon Rhey,27,0,32,5
1683661652345,BILD 3,A07,192682,Butler; Shannon Rhey,20,0,32,12
1683661653370,BILD 4,A01,192836,Reuther; Keefe,1,0,24,23
1683661653370,BILD 4,A02,193044,Reuther; Keefe,4,0,24,20
1683661654395,BILD 10,A01,193142,Gustafson-Brown; Cindy,29,0,32,3
1683661654395,BILD 10,A02,193149,Gustafson-Brown; Cindy,31,0,32,1
1683661655425,BIMM 100,A01,193301,Staff,0,6,32,32
1683661655425,BIMM 100,A02,193312,Staff,0,7,32,32
1683661655425,BIMM 100,A03,193323,Staff,0,9,32,32
1683661656454,BIMM 101,A01,193329,McDonnell; Lisa Marie,0,4,24,24
1683661656454,BIMM 101,A02,193339,McDonnell; Lisa Marie,1,3,24,23
1683661656454,BIMM 101,B01,193354,McDonnell; Lisa Marie,0,4,24,24
1683661656454,BIMM 101,B02,193357,McDonnell; Lisa Marie,0,3,24,24
1683661657482,BIMM 110,A01,193377,Tat; John,0,11,32,32
1683661657482,BIMM 110,A02,193378,Tat; John,0,10,32,32
1683661658508,BIMM 120,A01,206116,Staff,0,0,32,32
1683661658508,BIMM 120,A02,206117,Staff,6,0,32,26
1683661658508,BIMM 120,A03,206121,Staff,21,0,32,11
1683661659531,BIPN 100,A01,193393,Park; Ji Young,0,15,32,32
1683661659531,BIPN 100,A02,193402,Park; Ji Young,0,14,32,32
1683661659531,BIPN 100,A03,193413,Park; Ji Young,0,14,32,32
1683661659531,BIPN 100,A04,193414,Park; Ji Young,0,13,32,32
1683661660559,BIPN 102,A01,193429,Staff,0,0,32,32
1683661660559,BIPN 102,A02,193438,Staff,18,0,32,14
1683661661583,BIPN 106,A01,193450,Reyes Gonzalez; Catalina,0,2,40,40
1683661662609,BIPN 134,A01,193465,Cooke; James Edward,0,0,32,32
1683661662609,BIPN 134,A02,193474,Cooke; James Edward,25,0,32,7
1683661662609,BIPN 134,A03,193485,Cooke; James Edward,29,0,32,3
1683661662609,BIPN 134,A04,193486,Cooke; James Edward,20,0,32,12
1683661662609,BIPN 134,A05,193491,Cooke; James Edward,31,0,32,1
1683661662609,BIPN 134,A06,193501,Cooke; James Edward,30,0,32,2
1683661662609,BIPN 134,A07,193510,Cooke; James Edward,29,0,32,3
1683661664659,BISP 194,A00,222522,Staff,14,0,32,18
1683661665686,CAT 124,A01,202407,Staff,19,0,25,6
1683661666713,CAT 125,A00,202408,Marchisotto; Jennifer Anne,2,0,20,18
1683661667739,CAT 125R,A00,202409,Smith; Lauryn Alissa,0,11,20,20
1683661667739,CAT 125R,B00,202410,Morales; Celeste Georgianna,0,11,20,20
1683661667739,CAT 125R,C00,202411,Irwin; Matthew Joseph,0,12,20,20
1683661668768,CENG 15,A01,204712,Yang; Kesong,0,1,0,0
1683661669850,CENG 114,A00,202070,Jahed Motlagh; Zeinab,5,0,20,15
1683661670874,CGS 105,A00,185477,Wesling; Megan E.,24,0,40,16
1683661671899,CGS 106,A00,185494,Staff,11,0,22,11
1683661672923,CGS 108,A00,185495,Staff,14,0,20,6
1683661673947,CGS 114,A00,185496,Staff,13,0,18,5
1683661674971,CGS 119,A00,185501,Staff,15,0,20,5
1683661675995,CGS 120,A00,185511,Staff,12,0,20,8
1683661677021,CHEM 4,A01,184675,Bussey; Thomas J,97,0,100,3
1683661678046,CHEM 6A,A01,184677,Staff,32,0,60,28
1683661679068,CHEM 6B,A01,184679,Staff,63,0,100,37
1683661680097,CHEM 6C,A01,184681,Bussey; Thomas J,0,0,50,50
1683661680097,CHEM 6C,A02,184682,Bussey; Thomas J,32,0,50,18
1683661681125,CHEM 40A,A01,184684,Albizati; Kim F.,34,0,100,66
1683661682150,CHEM 40B,A01,184686,Albizati; Kim F.,0,22,100,100
1683661683177,CHEM 41B,A01,184690,Staff,51,0,100,49
1683661684205,COGS 3,A01,184715,Boyle; Mary E. T.,0,27,40,40
1683661685232,COGS 14B,A01,185172,Staff,0,14,38,38
1683661686260,COGS 18,A01,184736,Staff,14,0,80,66
1683661687287,COGS 100,A01,184932,Staff,0,7,73,73
1683661688315,COGS 101A,A01,184935,Staff,0,40,30,30
1683661689340,COGS 101B,A01,184944,Staff,0,2,30,30
1683661690368,COGS 101C,A01,184946,Staff,0,10,30,30
1683661691393,COGS 102A,A01,184951,Johnson; Christine M.,2,0,40,38
1683661692423,COGS 107B,A01,184953,Mooshagian; Eric Frederick,0,51,40,40
1683661693446,COGS 118B,A01,184959,Gupta; Anjum,0,49,40,40
1683661694471,COGS 153,A00,184961,Staff,0,16,30,30
1683661695499,COGS 177,A00,184962,Staff,0,21,30,30
1683661696527,COGS 187A,A01,184969,Boyle; Mary E. T.,0,19,40,40
1683661697552,COMM 10,A01,185174,Staff,0,5,25,25
1683661697552,COMM 10,A02,185189,Staff,0,2,25,25
1683661697552,COMM 10,A03,269821,Staff,0,1,0,0
1683661698577,COMM 100B,A01,185475,Staff,0,1,0,2
1683661698577,COMM 100B,A02,185476,Staff,12,0,25,13
1683661699602,COMM 100C,A01,185314,Staff,1,0,25,24
1683661699602,COMM 100C,A02,185327,Staff,18,0,25,7
1683661700629,COMM 110M,A00,185349,Staff,0,0,40,40
1683661701653,COMM 113T,A00,185352,Staff,25,0,40,15
1683661702680,COMM 114I,A00,185353,Staff,31,0,40,9
1683661703710,COMM 131,A00,185354,Staff,17,0,30,13
1683661704734,CSE 8A,A50,185358,Cao; Yingjun,0,46,10,10
1683661705759,CSE 8B,A01,185362,Staff,0,48,50,50
1683661706787,CSE 11,A01,185416,Cao; Yingjun,0,91,10,10
1683661707812,CSE 20,A01,185445,Briones; Jor-el Thomas Caparas,4,0,25,21
1683661708836,CSE 21,A01,185447,Staff,9,0,50,41
1683661709859,CSE 101,A01,185451,Staff,0,13,50,50
1683661709859,CSE 101,B01,185453,Jones; Miles E,0,14,50,50
1683661711909,CSE 141,A01,185458,Eldon; John,16,0,100,84
1683661712937,CSE 141L,A01,185461,Eldon; John,8,0,100,92
1683661713964,CSE 142,A01,185463,Staff,34,0,60,26
1683661713964,CSE 142,B01,201355,Staff,0,7,60,60
1683661714989,CSE 142L,A01,185470,Staff,34,0,60,26
1683661714989,CSE 142L,B01,201417,Staff,0,6,60,60
1683661716013,CSE 190,A00,201433,Staff,32,0,49,17
1683661717042,DOC 1,A01,259136,Strom; Megan C.,7,0,15,8
1683661717042,DOC 1,A02,259137,Strom; Megan C.,14,0,15,1
1683661717042,DOC 1,A03,259138,Strom; Megan C.,14,0,15,1
1683661717042,DOC 1,A04,259139,Strom; Megan C.,14,0,15,1
1683661718065,DOC 100D,A00,259140,Pass; Natalye Joann,14,0,25,11
1683661719092,DSGN 1,A01,184749,Rill; Bryan,0,26,30,30
1683661720117,DSGN 100,A01,185168,Staff,0,2,25,25
1683661721144,ECE 5,A01,185626,Morris; Karcher William,0,11,0,0
1683661722168,ECE 101,A01,185628,Staff,14,0,70,56
1683661723195,ECE 107,A01,185635,Baghdadchi; Saharnaz,0,0,20,20
1683661723195,ECE 107,A02,185638,Baghdadchi; Saharnaz,2,0,20,18
1683661724218,ECE 148,A01,185647,Silberman; Jack,0,0,16,16
1683661725243,ECON 1,A01,185537,Crane; Meredith Helen,54,0,70,16
1683661726269,ECON 3,A01,185549,Crane; Meredith Helen,29,0,70,41
1683661727294,ECON 4,A01,203354,Anderson; John Charles,0,5,10,10
1683661728318,ECON 100A,A01,185574,Staff,0,5,40,40
1683661729343,ECON 100B,A01,185576,Staff,0,12,50,50
1683661730367,ECON 100C,A01,185589,Newhouse; Herbert S,30,0,70,40
1683661731391,ECON 105,A00,185608,Vespa; Emanuel Ignacio,19,0,35,16
1683661732415,ECON 109,A01,185610,Shishkin; Denis,9,0,35,26
1683661733442,ECON 110A,A01,185612,Staff,9,0,40,31
1683661734467,ECON 120A,A01,185615,Staff,20,0,40,20
1683661735497,ECON 120C,A01,185617,Sun; Yixiao,0,20,70,70
1683661736522,ECON 144,A00,203346,Squires; Dale E,2,0,35,33
1683661737547,ECON 171,A01,203349,Newhouse; Herbert S,0,1,35,35
1683661738573,ECON 173A,A01,185621,Toda; Alexis Akira,20,0,35,15
1683661739599,EDS 25,A01,202413,Staff,0,1,0,0
1683661739599,EDS 25,A02,202414,Staff,0,1,0,0
1683661739599,EDS 25,A03,202415,Staff,0,0,0,0
1683661739599,EDS 25,A04,202416,Staff,0,1,0,0
1683661739599,EDS 25,A05,202439,Staff,0,0,0,0
1683661739599,EDS 25,A06,202440,Staff,0,0,0,0
1683661739599,EDS 25,B01,202631,Staff,0,0,0,0
1683661739599,EDS 25,B02,202632,Staff,0,0,0,0
1683661739599,EDS 25,B03,202639,Staff,0,0,0,0
1683661739599,EDS 25,B04,202640,Staff,0,0,0,0
1683661739599,EDS 25,B05,202643,Staff,0,0,0,0
1683661739599,EDS 25,B06,202644,Staff,0,0,0,0
1683661740627,EDS 38,A01,202659,Black; Alison Michelle,24,0,25,1
1683661741658,EDS 115,A00,202652,Staff,18,0,30,12
1683661742684,EDS 125,A00,202649,Staff,13,0,30,17
1683661743710,EDS 126,A01,203332,Staff,30,0,30,0
1683661744734,EDS 139,A00,202838,Staff,16,0,25,9
1683661745758,EDS 146,A01,202655,Staff,14,0,25,11
1683661746785,ENG 15,A00,185667,Staff,0,1,0,0
1683661746785,ENG 15,B00,185672,Staff,0,0,0,0
1683661746785,ENG 15,C00,185675,Staff,0,0,0,0
1683661746785,ENG 15,D00,185682,Staff,0,0,0,0
1683661746785,ENG 15,E00,185684,Staff,0,0,0,0
1683661747812,ETHN 103,A00,185710,Staff,0,8,35,35
1683661748836,ETHN 103A,A00,199228,Man; Simeon S,0,0,9,9
1683661749858,ETHN 109,A00,185711,Staff,16,0,35,19
1683661750882,ETHN 142,A00,185726,Staff,0,4,30,30
1683661751905,ETHN 163J,A00,199229,Man; Simeon S,5,0,8,3
1683661752929,ETHN 168,A00,185727,Staff,7,0,10,3
1683661753956,ETHN 182,A00,185728,Staff,0,0,35,35
1683661754980,ETHN 183,A00,185737,Staff,9,0,18,9
1683661756009,GLBH 111,A01,209361,Burgos; Jose L.,0,0,0,0
1683661758062,HIEU 104,A00,185792,Staff,14,0,20,6
1683661759085,HIEU 115,A00,185800,Staff,0,0,20,20
1683661760109,HIEU 128,A00,185801,Staff,0,9,20,20
1683661761133,HIEU 147,A00,185802,Staff,15,0,20,5
1683661762159,HIEU 154,A00,185823,Staff,11,0,20,9
1683661763184,HILA 102,A00,185826,Staff,14,0,20,6
1683661764211,HILD 2C,A01,185778,Staff,0,13,20,20
1683661765235,HILD 7B,A01,185780,Kwak; Nancy,0,17,32,32
1683661765235,HILD 7B,A02,185781,Kwak; Nancy,0,18,32,32
1683661766263,HILD 30,A01,185791,Staff,12,0,20,8
1683661767290,HISC 119,A00,185830,Golan; Tal,0,9,20,20
1683661768316,HITO 156GS,A00,185831,Patterson; Patrick H.,0,0,0,23
1683661769341,HIUS 103,A00,185832,Man; Simeon S,0,4,20,20
1683661770365,HIUS 117,A00,185836,Kwak; Nancy,2,0,20,18
1683661771392,HIUS 125,A00,185840,Man; Simeon S,0,2,23,23
1683661772421,HIUS 149,A00,185845,Staff,1,0,20,19
1683661773516,HUM 3,A01,185882,Zavodny; Tatiana Sophia,0,8,50,50
1683661773516,HUM 3,B01,185899,Caldwell; Michael Alan,0,18,50,50
1683661774542,HUM 3GS,A00,185900,Patterson; Patrick H.,0,0,0,23
1683661775566,HUM 4,A01,185938,Zroka; Amy Liane,29,0,50,21
1683661775566,HUM 4,B01,185956,Watkins; Eric,0,4,50,50
1683661775566,HUM 4,B02,202209,Watkins; Eric,0,5,50,50
1683661775566,HUM 4,B03,202210,Watkins; Eric,0,5,50,50
1683661776594,HUM 5,A01,185958,West; Geoffrey Scott,0,0,50,50
1683661776594,HUM 5,A02,202215,West; Geoffrey Scott,0,0,50,50
1683661777617,INTL 190,A00,185959,Gagnon; Jeffrey C,0,0,0,9
1683661777617,INTL 190,B00,185960,Lettieri; Michael Joseph,0,0,0,2
1683661778640,JAPN 180,A00,254509,Staff,5,0,30,25
1683661779665,LATI 10,A01,202853,Kennemore; Amy Michelle,4,0,35,31
1683661779665,LATI 10,A02,202854,Kennemore; Amy Michelle,2,0,35,33
1683661779665,LATI 10,A03,270054,Kennemore; Amy Michelle,30,0,30,0
1683661780689,LATI 180,A00,202855,Kennemore; Amy Michelle,11,0,20,9
1683661781720,LAWS 101,A00,201767,Golan; Tal,0,7,40,40
1683661782744,LIFR 1C,A00,185961,Staff,6,0,20,14
1683661783769,LIFR 1CX,A00,185962,Staff,7,0,20,13
1683661784793,LIFR 1D,A00,185963,Staff,7,0,20,13
1683661785818,LIFR 1DX,A00,185964,Staff,7,0,20,13
1683661786844,LIGN 101,A01,186039,Staff,43,0,50,7
1683661787871,LIGN 165,A00,186040,Staff,15,0,50,35
1683661788895,LTCS 108,A00,186041,Staff,5,0,10,5
1683661789923,LTCS 119,A00,186042,Staff,15,0,20,5
1683661790950,LTCS 130,A00,186043,Wesling; Megan E.,15,0,25,10
1683661793002,LTEA 138,A00,186119,Staff,14,0,40,26
1683661794031,LTEN 124,A00,186148,Staff,5,0,25,20
1683661795059,LTEN 178,A00,186149,Staff,7,0,15,8
1683661796089,LTEN 181,A00,186150,Blanco; John D,34,0,40,6
1683661797118,LTWL 120,A00,186160,Staff,20,0,25,5
1683661798144,LTWL 165,A00,186161,Staff,22,0,25,3
1683661799169,LTWR 100,A00,186162,Staff,0,5,15,15
1683661800191,LTWR 102,A00,186163,Doller; Ben,5,0,15,10
1683661801225,MAE 8,A01,186412,Staff,0,0,0,0
1683661802258,MAE 30B,A00,186445,Bahadori; Mohammad Yousef,82,0,100,18
1683661803286,MAE 40,A00,186592,Bewley; Thomas R,10,0,50,40
1683661804310,MAE 101B,A00,186593,Bahadori; Mohammad Yousef,80,0,100,20
1683661805342,MAE 105,A00,186594,Bandaru; Prabhakar,10,0,50,40
1683661806368,MAE 107,A00,186599,Pham; Hieu Tan,0,7,120,120
1683661807396,MAE 148,A01,186660,Silberman; Jack,3,0,16,13
1683661808422,MATH 10A,A01,188095,Staff,0,6,35,35
1683661809449,MATH 10B,A01,188097,Bowers; Adam R.,0,12,30,30
1683661809449,MATH 10B,A02,188099,Bowers; Adam R.,0,11,30,30
1683661809449,MATH 10B,B01,188104,Bowers; Adam R.,0,10,30,30
1683661809449,MATH 10B,B02,188106,Bowers; Adam R.,1,9,30,29
1683661810473,MATH 10C,A01,188111,Staff,0,18,30,30
1683661810473,MATH 10C,A02,188127,Staff,0,19,30,30
1683661810473,MATH 10C,A03,188131,Staff,0,19,30,30
1683661810473,MATH 10C,B01,188218,Staff,17,0,30,13
1683661810473,MATH 10C,B02,188244,Staff,13,0,30,17
1683661810473,MATH 10C,B03,188277,Staff,14,0,30,16
1683661811499,MATH 18,A01,188344,Bach; Quang Tran,18,0,30,12
1683661811499,MATH 18,A02,188345,Bach; Quang Tran,11,0,30,19
1683661811499,MATH 18,B01,188353,Bach; Quang Tran,11,0,30,19
1683661811499,MATH 18,B02,188354,Bach; Quang Tran,19,0,30,11
1683661812528,MATH 20A,A01,188374,Staff,11,0,35,24
1683661813555,MATH 20B,A01,188382,Ohm; Ko Woon,7,0,30,23
1683661813555,MATH 20B,A02,188383,Ohm; Ko Woon,22,0,30,8
1683661813555,MATH 20B,B01,188385,Ohm; Ko Woon,7,0,30,23
1683661813555,MATH 20B,B02,188392,Ohm; Ko Woon,22,0,30,8
1683661814580,MATH 20C,A01,188394,Harel; Guershon,10,0,30,20
1683661814580,MATH 20C,A02,188395,Harel; Guershon,13,0,30,17
1683661814580,MATH 20C,B01,188404,Harel; Guershon,5,0,30,25
1683661814580,MATH 20C,B02,188405,Harel; Guershon,18,0,30,12
1683661815607,MATH 20D,A01,188414,Hammock; Frances H,0,1,30,30
1683661815607,MATH 20D,A02,188415,Hammock; Frances H,0,1,30,30
1683661815607,MATH 20D,B01,188447,Hammock; Frances H,0,1,30,30
1683661815607,MATH 20D,B02,188486,Hammock; Frances H,3,0,30,27
1683661816631,MATH 20E,A01,188649,Staff,21,0,30,9
1683661816631,MATH 20E,A02,188650,Staff,21,0,30,9
1683661816631,MATH 20E,A03,188673,Staff,0,0,30,30
1683661817656,MATH 102,A01,188675,Staff,0,36,35,35
1683661818683,MATH 103B,A01,188681,Staff,3,0,35,32
1683661818683,MATH 103B,B01,188692,Staff,5,0,35,30
1683661819709,MATH 109,A01,188695,Salehi Golsefidy; Alireza,24,0,35,11
1683661819709,MATH 109,A02,188696,Salehi Golsefidy; Alireza,25,0,35,10
1683661820734,MATH 120A,A01,188698,Eggers; John Dietrich,7,0,35,28
1683661821758,MATH 142B,A01,188736,Ioana; Adrian,0,1,30,30
1683661821758,MATH 142B,A02,188741,Ioana; Adrian,0,1,30,30
1683661821758,MATH 142B,A03,188743,Ioana; Adrian,0,1,30,30
1683661822785,MATH 168A,A01,188790,Staff,0,10,35,35
1683661823808,MATH 170A,A01,188803,Nie; Jiawang,0,2,35,35
1683661823808,MATH 170A,A02,188811,Nie; Jiawang,0,0,35,35
1683661823808,MATH 170A,A03,188814,Nie; Jiawang,0,0,35,35
1683661823808,MATH 170A,A04,188815,Nie; Jiawang,9,0,35,26
1683661824835,MATH 193B,A01,188817,Staff,0,0,35,35
1683661824835,MATH 193B,A02,188818,Staff,5,0,35,30
1683661825859,MGT 4,A01,202857,Anderson; John Charles,61,0,80,19
1683661826883,MGT 12,A00,202858,Lindenberger; Wade Douglas,40,0,90,50
1683661827906,MGT 18,A00,202859,Staff,74,0,90,16
1683661828929,MGT 18GS,A00,202860,McKay; Michael J,13,0,28,15
1683661829955,MGT 45,A00,202861,Pecore; Joseph P.,11,0,90,79
1683661830981,MGT 100,A00,202863,Yavorsky; Daniel Ryan,28,0,90,62
1683661832005,MGT 103,A00,202864,Ehrich; Kristine R,0,18,90,90
1683661833027,MGT 112,A00,202865,Ehrich; Kristine R,14,0,90,76
1683661834054,MGT 121A,A00,202868,Staff,90,20,90,0
1683661835081,MGT 131B,A00,202869,Anderson; John Charles,59,0,90,31
1683661836104,MGT 136,A00,202871,Lindenberger; Wade Douglas,83,0,90,7
1683661837127,MGT 164,A00,202873,Staff,0,67,90,91
1683661838150,MGT 164GS,A00,202874,McKay; Mary A,13,0,28,15
1683661839173,MGT 180,A00,202875,Staff,0,50,90,91
1683661840196,MMW 11R,A01,205019,Herbst; Matthew,1,0,30,29
1683661840196,MMW 11R,A02,205026,Herbst; Matthew,29,0,30,1
1683661841223,MMW 15,A01,193512,Chang; Edmond Yi-Teh,0,8,28,28
1683661841223,MMW 15,A02,193513,Chang; Edmond Yi-Teh,0,5,28,28
1683661841223,MMW 15,A03,193514,Chang; Edmond Yi-Teh,0,5,28,28
1683661841223,MMW 15,A04,193515,Chang; Edmond Yi-Teh,0,5,28,28
1683661841223,MMW 15,A05,193516,Chang; Edmond Yi-Teh,0,5,28,28
1683661841223,MMW 15,A06,193517,Chang; Edmond Yi-Teh,0,6,28,28
1683661841223,MMW 15,B01,193519,Chang; Edmond Yi-Teh,0,5,28,28
1683661841223,MMW 15,B02,193520,Chang; Edmond Yi-Teh,0,5,28,28
1683661841223,MMW 15,B03,193521,Chang; Edmond Yi-Teh,0,5,28,28
1683661841223,MMW 15,B04,193522,Chang; Edmond Yi-Teh,0,5,28,28
1683661841223,MMW 15,B05,193523,Chang; Edmond Yi-Teh,0,5,28,28
1683661841223,MMW 15,B06,193524,Chang; Edmond Yi-Teh,0,5,28,28
1683661842249,MMW 122,A01,193526,Rahimi; Babak,0,16,28,28
1683661842249,MMW 122,A02,193527,Rahimi; Babak,0,15,28,28
1683661842249,MMW 122,A03,193528,Rahimi; Babak,0,0,0,0
1683661842249,MMW 122,A04,193529,Rahimi; Babak,0,0,0,0
1683661843276,MUS 1A,A01,186663,Staff,1,20,35,34
1683661844304,MUS 4,A01,186715,Staff,0,12,35,35
1683661845328,MUS 5R,A01,186796,Dubnov; Shlomo,0,17,35,35
1683661846354,MUS 6,A01,186798,Staff,0,5,25,25
1683661847379,MUS 7,A01,186830,Staff,11,0,35,24
1683661848406,MUS 8,A01,186930,Staff,0,26,35,35
1683661849434,MUS 15,A01,186932,Staff,0,16,35,35
1683661849434,MUS 15,B01,186934,Staff,1,17,35,34
1683661850461,MUS 80,A00,186935,Staff,0,0,20,20
1683661850461,MUS 80,B00,186936,Staff,24,0,25,1
1683661851485,NANO 11,A00,204702,Lipomi; Darren John,0,0,0,0
1683661852512,NANO 15,A01,204709,Yang; Kesong,0,1,0,0
1683661853537,NANO 114,A00,202069,Jahed Motlagh; Zeinab,3,0,10,7
1683661854563,PHIL 1,A00,186955,Grush; Rick Scott,31,0,40,9
1683661855588,PHIL 10,A01,186973,Grush; Rick Scott,27,0,35,8
1683661855588,PHIL 10,A02,186974,Grush; Rick Scott,33,0,35,2
1683661856610,PHIL 13,A01,186976,Staff,3,0,35,32
1683661856610,PHIL 13,A02,186977,Staff,16,0,35,19
1683661857636,PHIL 14,A01,186979,Staff,31,0,35,4
1683661857636,PHIL 14,A02,186986,Staff,32,0,35,3
1683661858660,PHIL 28,A01,186988,Staff,16,0,30,14
1683661858660,PHIL 28,A02,186989,Staff,1,0,30,29
1683661858660,PHIL 28,A03,186990,Staff,10,0,30,20
1683661858660,PHIL 28,A04,186991,Staff,26,0,30,4
1683661859682,PHIL 120,A00,186997,Staff,23,0,40,17
1683661860710,PHIL 137,A00,187003,Staff,7,0,40,33
1683661861735,PHIL 150,A00,187015,Staff,47,0,70,23
1683661862760,PHIL 167,A00,187021,Lamey; Andy M.,34,0,40,6
1683661863783,PHIL 174,A01,202226,Staff,17,0,20,3
1683661863783,PHIL 174,A02,202235,Staff,20,0,20,0
1683661864806,PHIL 191A,A00,258918,Staff,0,0,1,1
1683661865833,PHYS 1A,A00,187028,Staff,26,0,60,34
1683661866857,PHYS 1AL,001,187036,Staff,3,0,30,27
1683661866857,PHYS 1AL,002,187049,Staff,18,0,30,12
1683661867879,PHYS 1B,A00,187058,Staff,22,0,60,38
1683661868904,PHYS 1BL,001,187064,Staff,0,1,30,30
1683661868904,PHYS 1BL,002,187070,Staff,4,0,30,26
1683661869928,PHYS 1C,A00,187082,Staff,29,0,120,91
1683661870956,PHYS 1CL,001,187088,Staff,0,9,30,30
1683661870956,PHYS 1CL,002,187089,Staff,0,1,30,30
1683661870956,PHYS 1CL,009,262693,Staff,9,0,30,21
1683661871984,PHYS 2B,A01,187097,Staff,55,0,115,60
1683661873011,PHYS 2C,A01,187099,Staff,63,0,115,52
1683661874039,PHYS 2CL,A01,187101,Staff,5,0,28,23
1683661874039,PHYS 2CL,A02,187102,Staff,15,0,28,13
1683661875065,PHYS 2D,A01,187123,Shotwell; Brian,95,0,115,20
1683661876090,PHYS 4B,A01,187133,Grinstein; Benjamin,35,0,50,15
1683661877172,POLI 10,A00,188819,Staff,0,4,50,50
1683661878196,POLI 11,A00,188827,Staff,43,0,50,7
1683661879219,POLI 13R,A00,188828,Staff,0,1,20,20
1683661880246,POLI 27,A01,188830,Elgin; Samuel Zincke,0,2,70,70
1683661881270,POLI 30,A00,188832,Desposato; Scott,30,0,50,20
1683661882292,POLI 102F,A00,188834,Staff,0,0,40,40
1683661883316,POLI 104A,A00,188852,Staff,13,0,30,17
1683661884340,POLI 104I,A00,188853,Staff,0,7,20,20
1683661885363,POLI 110B,A00,188854,Wiens; David,6,0,20,14
1683661886387,POLI 112A,A00,188855,Wiens; David,3,0,30,27
1683661887411,POLI 117R,A00,188856,Forman; Fonna,0,12,20,20
1683661888438,POLI 118,A00,188857,Ingham; Sean,8,0,20,12
1683661889465,POLI 120G,A00,188858,Staff,8,0,30,22
1683661890488,POLI 131CR,A00,188863,Hoston; Germaine,21,0,50,29
1683661891511,POLI 133,A00,188864,Nellis; Gareth Hb,44,0,50,6
1683661892534,POLI 134D,A00,188865,Desposato; Scott,27,0,30,3
1683661893558,POLI 142A,A00,188871,Gartzke; Erik,21,0,50,29
1683661894583,POLI 142K,A00,188874,Staff,38,0,50,12
1683661895610,POLI 143,A00,188940,Gartzke; Erik,16,0,30,14
1683661896634,POLI 153,A00,188943,Staff,2,0,20,18
1683661897657,POLI 160AA,A00,188944,Staff,11,0,40,29
1683661898685,POLI 170A,A00,188945,Staff,11,0,30,19
1683661900735,PSYC 1,A00,188952,Staff,36,0,90,54
1683661901760,PSYC 2,B00,188953,Staff,19,0,35,16
1683661902785,PSYC 6,A00,188970,Staff,47,0,60,13
1683661903813,PSYC 7,A00,188973,Staff,35,0,45,10
1683661904837,PSYC 60,A01,188980,Rickard; Timothy C.,42,0,60,18
1683661905862,PSYC 70,A01,189001,Steiner; Eric Tomas,22,0,45,23
1683661906886,PSYC 100,A00,189005,Lacefield; Katharine I,0,99,120,120
1683661907909,PSYC 102,A00,189008,Staff,8,0,30,22
1683661908937,PSYC 106,B00,189026,Gorman; Michael R.,27,0,60,33
1683661909965,PSYC 114,B01,189033,Winkielman; Piotr,0,31,30,30
1683661910992,PSYC 131,A00,189036,Anagnostaras; Stephan,0,43,60,60
1683661912017,PSYC 136,A00,189041,Lowe; Angela Beth,0,7,25,25
1683661913043,PSYC 137,A00,189057,Winkielman; Piotr,0,37,25,25
1683661914071,PSYC 144,A00,189107,Wixted; John T,0,11,50,50
1683661916121,PSYC 162,A00,189142,Staff,0,9,85,85
1683661917145,PSYC 172,A00,189144,Gorman; Michael R.,0,6,30,30
1683661919196,PSYC 179,A00,189146,Lacefield; Katharine I,0,87,120,120
1683661920221,PSYC 181,A00,189147,Anagnostaras; Stephan,0,44,90,90
1683661921249,PSYC 190R,A00,189148,Barner; David A.,0,23,80,80
1683661922276,PSYC 191,A00,189275,Rickard; Timothy C.,0,10,25,25
1683661923303,PSYC 193,A00,189276,Chapman; Eddie Nathaniel,0,1,0,4
1683661924331,PSYC 193L,A01,189281,Lowe; Angela Beth,10,0,20,10
1683661924331,PSYC 193L,B01,189285,Staff,28,0,35,7
1683661925354,RELI 149,A00,187137,Rahimi; Babak,7,0,40,33
1683661926379,SE 9,A01,187315,Staff,0,2,18,18
1683661927405,SE 101B,A00,187409,Staff,24,0,30,6
1683661928433,SE 110B,A00,187444,Staff,10,0,40,30
1683661929459,SE 130B,A00,187449,Staff,31,0,40,9
1683661930483,SE 150A,A00,187516,Staff,9,0,20,11
1683661931507,SE 154,A00,187528,Staff,29,0,50,21
1683661932534,SIO 3,A01,258171,Staff,35,0,40,5
1683661933561,SIO 10,A00,187144,Cook; Geoffrey W,0,7,75,75
1683661934585,SIO 45,A00,187152,Cook; Geoffrey W,0,5,100,100
1683661935609,SIO 109R,A00,194486,Staff,0,4,20,20
1683661937663,SIO 187,A01,187233,Kacev; David,12,0,40,28
1683661938689,SOCI 1,A01,258656,Thorpe; Charles Robert,28,0,30,2
1683661938689,SOCI 1,A02,258658,Thorpe; Charles Robert,30,0,30,0
1683661938689,SOCI 1,A03,258661,Thorpe; Charles Robert,25,0,25,0
1683661938689,SOCI 1,A04,258666,Thorpe; Charles Robert,22,0,25,3
1683661938689,SOCI 1,A05,258897,Thorpe; Charles Robert,22,0,25,3
1683661938689,SOCI 1,A06,258898,Thorpe; Charles Robert,25,0,25,0
1683661939719,SOCI 30,A01,258903,Pardo Guerra; Juan Pablo,14,0,30,16
1683661940746,SOCI 102,A00,258904,Staff,9,0,25,16
1683661941771,SOCI 106,A00,258905,Staff,19,0,25,6
1683661942797,SOCI 111,A00,258907,Ribas Norris; Janet Vanesa,26,0,30,4
1683661943825,SOCI 121R,A00,258908,Pardo Guerra; Juan Pablo,8,0,30,22
1683661944850,SOCI 126,A01,203330,Staff,14,0,20,6
1683661945874,SOCI 131,A00,258909,Thorpe; Charles Robert,30,0,60,30
1683661946897,SOCI 135,A00,258910,Payne; Christine Anna,0,11,30,30
1683661947927,SOCI 157,A00,258911,Staff,12,0,30,18
1683661948952,SOCI 184,A00,258912,Staff,25,0,30,5
1683661949976,SOCI 188D,A00,258913,Staff,22,0,30,8
1683661951000,SYN 2,001,187529,Staff,9,0,16,7
1683661951000,SYN 2,002,201452,Staff,0,20,16,16
1683661951000,SYN 2,003,201469,Staff,1,0,16,15
1683661952028,SYN 100,A01,187531,Staff,0,9,20,20
1683661952028,SYN 100,B01,201491,Staff,0,10,20,20
1683661953052,TDAC 1,A00,189286,Walsh; Kim C.,3,0,20,17
1683661953052,TDAC 1,B00,189287,Harting; Carla Kelso,10,0,20,10
1683661954081,TDAC 101,A00,189300,Walsh; Kim C.,16,0,20,4
1683661954081,TDAC 101,B00,189301,Harting; Carla Kelso,18,0,20,2
1683661955105,TDAC 102,A00,189304,Basso; Beatrice,14,0,20,6
1683661956129,TDAC 108,A00,189305,Staff,18,0,20,2
1683661957156,TDDE 131,A00,189310,Staff,19,0,20,1
1683661957156,TDDE 131,B00,189314,Staff,19,0,20,1
1683661957156,TDDE 131,C00,189315,Staff,48,0,50,2
1683661957156,TDDE 131,D00,189316,Staff,14,0,15,1
1683661957156,TDDE 131,E00,204841,Staff,20,0,20,0
1683661958180,TDGE 10,A00,189289,Staff,27,0,50,23
1683661958180,TDGE 10,B00,189290,Havis; Allan,0,0,50,50
1683661959205,TDGE 11,A00,189291,Fulton; Julia,0,4,50,50
1683661959205,TDGE 11,B00,189292,Staff,20,0,25,5
1683661959205,TDGE 11,C00,260270,Staff,0,0,0,0
1683661960228,TDGE 25,A00,189294,Staff,2,0,20,18
1683661961252,TDGE 124,A00,189318,Fulton; Julia,0,8,50,50
1683661962284,TDGE 125,A00,189319,Staff,13,0,25,12
1683661962284,TDGE 125,B00,189320,Staff,23,0,25,2
1683661963311,TDGE 127,A00,189322,Havis; Allan,0,0,50,50
1683661964337,TDHT 101,A00,189323,Staff,18,0,25,7
1683661964337,TDHT 101,B00,189324,Staff,25,0,25,0
1683661965361,TDHT 102,A00,189325,Staff,49,0,50,1
1683661966385,TDMV 1,A00,189295,Arcidiacono; Kristin,20,0,30,10
1683661966385,TDMV 1,B00,189296,Caligagan; Maria T.,24,0,30,6
1683661967413,TDMV 2,A00,189297,Sammartano; Tonnie,27,0,30,3
1683661967413,TDMV 2,B00,189299,Arcidiacono; Kristin,23,0,30,7
1683661968442,TDMV 3,A00,204998,Rincon; Alicia,22,0,30,8
1683661969468,TDMV 120,A00,189458,Sammartano; Tonnie,28,0,30,2
1683661970494,TDMV 138,A00,189541,Jun; Grace Shin Hae,20,0,40,20
1683661971519,TDMV 142,A00,189717,Caligagan; Tony,25,0,30,5
1683661971519,TDMV 142,B00,189718,Caligagan; Maria T.,25,0,30,5
1683661972543,TMC 2,A01,187533,Staff,25,0,25,0
1683661972543,TMC 2,A02,187534,Staff,25,0,25,0
1683661973568,USP 1,A01,187536,Kwak; Nancy,0,16,25,25
1683661974592,USP 5,A01,187538,Staff,9,0,25,16
1683661975620,USP 101,A00,199253,Staff,0,4,0,0
1683661976644,USP 124,A00,187562,Boomhower; Matthew Charles,0,0,30,30
1683661977669,USP 138,A00,187582,Staff,20,0,25,5
1683661978692,USP 152,A01,187597,Staff,3,0,25,22
1683661979716,USP 153,A00,187598,Staff,19,0,25,6
1683661980815,USP 168,A00,187607,Kwak; Nancy,2,0,5,3
1683661981845,USP 173,A00,187619,Staff,4,0,25,21
1683661982869,USP 181,A00,187638,Staff,0,4,25,25
1683661983896,VIS 103,A00,187650,Cruz; Edwin Teddy,17,0,75,58
1683661984923,VIS 110D,A00,187669,Staff,13,0,22,9
1683661985948,VIS 127C,A00,187720,Shen; Kuiyi,68,0,146,78
1683661986973,VIS 149,A00,187731,Yoldas; Pinar,1,14,22,21
1683661988000,VIS 151,A01,188091,Staff,22,0,34,12
1683661988000,VIS 151,A02,188092,Staff,11,0,34,23
1683661989029,VIS 160B,A00,188093,Stalbaum; Brett,0,1,10,10
1683661991080,WCWP 10B,A00,201720,Staff,10,0,15,5
1683661991080,WCWP 10B,B00,201722,Staff,9,0,15,6
1683661992107,WCWP 100,A00,201725,Gagnon; Jeffrey C,0,0,2,2
1683661992107,WCWP 100,B00,201727,Staff,0,4,15,15
1683661995206,ANBI 133,A00,258401,Wilder; Linnea Lorene,34,0,40,6
1683661996229,ANBI 140,A00,258395,Hrvoj Mihic; Branka,18,0,25,7
1683661997253,ANSC 120,A00,258402,Bialecki; Jon Anthony,26,0,40,14
1683661998278,ANSC 144,A00,258400,Staff,12,0,40,28
1683662000330,ANSC 166,A00,258396,Parish; Steven Martin,156,0,175,19
1683662001358,ANSC 180,A00,193533,Staff,8,0,20,12
1683662002385,ANSC 188,A00,258397,Jassal; Aftab,34,0,40,6
1683662003409,ANTH 3,A01,258316,Staff,23,0,30,7
1683662004434,ANTH 5,A00,258394,Semendeferi; Ekaterini,16,0,20,4
1683662005458,ANTH 21,A01,258331,Staff,4,0,40,36
1683662006483,ANTH 103,A00,258398,Varma; Saiba,15,0,25,10
1683662007510,AWP 10,001,202034,Staff,0,0,0,0
1683662007510,AWP 10,002,202035,Staff,0,0,0,0
1683662007510,AWP 10,003,202036,Staff,0,0,0,0
1683662007510,AWP 10,004,202037,Staff,0,0,0,0
1683662007510,AWP 10,005,202038,Staff,0,0,0,0
1683662007510,AWP 10,006,202039,Staff,0,0,0,0
1683662007510,AWP 10,007,202040,Staff,0,0,0,0
1683662007510,AWP 10,008,202041,Staff,0,0,0,0
1683662007510,AWP 10,009,202042,Staff,0,0,0,0
1683662007510,AWP 10,010,202043,Staff,0,0,0,0
1683662007510,AWP 10,011,202044,Staff,0,0,0,0
1683662007510,AWP 10,012,202045,Staff,0,0,0,0
1683662007510,AWP 10,013,202046,Staff,0,0,0,0
1683662007510,AWP 10,014,202047,Staff,0,0,0,0
1683662007510,AWP 10,015,202048,Staff,0,0,0,0
1683662007510,AWP 10,016,202049,Staff,0,0,0,0
1683662007510,AWP 10,017,202050,Staff,0,0,0,0
1683662007510,AWP 10,018,202051,Staff,0,0,0,0
1683662007510,AWP 10,019,202052,Staff,0,0,0,0
1683662007510,AWP 10,020,202053,Staff,0,0,0,0
1683662007510,AWP 10,021,202054,Staff,0,0,0,0
1683662007510,AWP 10,022,202055,Staff,0,0,0,0
1683662007510,AWP 10,023,202056,Staff,0,0,0,0
1683662007510,AWP 10,024,202057,Staff,0,0,0,0
1683662007510,AWP 10,025,202058,Staff,0,0,0,0
1683662007510,AWP 10,026,202059,Staff,0,0,0,0
1683662008535,AWP 102,001,202032,Staff,0,0,0,0
1683662008535,AWP 102,002,202033,Staff,0,0,0,0
1683662009565,BENG 100,A01,254234,Taylor Amos; Alyssa C,31,0,40,9
1683662010589,BENG 196,001,270013,Engler; Adam J.,9999,0,9999,0
1683662011619,BICD 100R,A01,202018,Smith; Laurie,0,7,32,32
1683662011619,BICD 100R,A02,202019,Smith; Laurie,0,3,32,32
1683662011619,BICD 100R,A03,202020,Smith; Laurie,0,1,32,32
1683662011619,BICD 100R,A04,202021,Smith; Laurie,6,0,32,26
1683662011619,BICD 100R,A05,202022,Smith; Laurie,11,0,32,21
1683662012644,BICD 136,A01,193242,Gustafson-Brown; Cindy,0,2,32,32
1683662012644,BICD 136,A02,193244,Gustafson-Brown; Cindy,13,0,32,19
1683662013669,BIEB 102,A01,193249,Butler; Shannon Rhey,1,2,32,31
1683662013669,BIEB 102,A02,193251,Butler; Shannon Rhey,0,0,32,32
1683662013669,BIEB 102,A03,193253,Butler; Shannon Rhey,0,0,32,32
1683662013669,BIEB 102,A04,193255,Butler; Shannon Rhey,14,0,32,18
1683662013669,BIEB 102,A05,193265,Butler; Shannon Rhey,25,0,32,7
1683662013669,BIEB 102,A06,193269,Butler; Shannon Rhey,14,0,32,18
1683662015721,BIEB 150,A01,193274,Staff,0,0,32,32
1683662015721,BIEB 150,A02,193285,Staff,24,0,32,8
1683662016748,BIEB 194,A00,193286,Kurle; Carolyn M.,20,0,32,12
1683662017775,BILD 1,A01,192291,Staff,15,0,32,17
1683662017775,BILD 1,A02,192292,Staff,30,0,32,2
1683662017775,BILD 1,B01,192520,Reuther; Keefe,0,1,0,0
1683662017775,BILD 1,B02,192532,Reuther; Keefe,0,1,0,0
1683662018800,BILD 3,A01,192556,Butler; Shannon Rhey,0,0,32,32
1683662018800,BILD 3,A02,192581,Butler; Shannon Rhey,0,0,32,32
1683662018800,BILD 3,A03,192611,Butler; Shannon Rhey,21,0,32,11
1683662018800,BILD 3,A04,192612,Butler; Shannon Rhey,24,0,32,8
1683662018800,BILD 3,A05,192613,Butler; Shannon Rhey,26,0,32,6
1683662018800,BILD 3,A06,192679,Butler; Shannon Rhey,27,0,32,5
1683662018800,BILD 3,A07,192682,Butler; Shannon Rhey,20,0,32,12
1683662019826,BILD 4,A01,192836,Reuther; Keefe,1,0,24,23
1683662019826,BILD 4,A02,193044,Reuther; Keefe,4,0,24,20
1683662020855,BILD 10,A01,193142,Gustafson-Brown; Cindy,29,0,32,3
1683662020855,BILD 10,A02,193149,Gustafson-Brown; Cindy,31,0,32,1
1683662021886,BIMM 100,A01,193301,Staff,0,6,32,32
1683662021886,BIMM 100,A02,193312,Staff,0,7,32,32
1683662021886,BIMM 100,A03,193323,Staff,0,9,32,32
1683662022912,BIMM 101,A01,193329,McDonnell; Lisa Marie,0,4,24,24
1683662022912,BIMM 101,A02,193339,McDonnell; Lisa Marie,1,4,24,23
1683662022912,BIMM 101,B01,193354,McDonnell; Lisa Marie,0,4,24,24
1683662022912,BIMM 101,B02,193357,McDonnell; Lisa Marie,0,3,24,24
1683662023940,BIMM 110,A01,193377,Tat; John,0,11,32,32
1683662023940,BIMM 110,A02,193378,Tat; John,0,10,32,32
1683662024967,BIMM 120,A01,206116,Staff,0,0,32,32
1683662024967,BIMM 120,A02,206117,Staff,6,0,32,26
1683662024967,BIMM 120,A03,206121,Staff,21,0,32,11
1683662025996,BIPN 100,A01,193393,Park; Ji Young,0,15,32,32
1683662025996,BIPN 100,A02,193402,Park; Ji Young,0,14,32,32
1683662025996,BIPN 100,A03,193413,Park; Ji Young,0,14,32,32
1683662025996,BIPN 100,A04,193414,Park; Ji Young,0,13,32,32
1683662027020,BIPN 102,A01,193429,Staff,0,0,32,32
1683662027020,BIPN 102,A02,193438,Staff,18,0,32,14
1683662028045,BIPN 106,A01,193450,Reyes Gonzalez; Catalina,0,2,40,40
1683662029071,BIPN 134,A01,193465,Cooke; James Edward,0,0,32,32
1683662029071,BIPN 134,A02,193474,Cooke; James Edward,25,0,32,7
1683662029071,BIPN 134,A03,193485,Cooke; James Edward,29,0,32,3
1683662029071,BIPN 134,A04,193486,Cooke; James Edward,20,0,32,12
1683662029071,BIPN 134,A05,193491,Cooke; James Edward,31,0,32,1
1683662029071,BIPN 134,A06,193501,Cooke; James Edward,30,0,32,2
1683662029071,BIPN 134,A07,193510,Cooke; James Edward,29,0,32,3
1683662031124,BISP 194,A00,222522,Staff,14,0,32,18
1683662032148,CAT 124,A01,202407,Staff,19,0,25,6
1683662033171,CAT 125,A00,202408,Marchisotto; Jennifer Anne,2,0,20,18
1683662034200,CAT 125R,A00,202409,Smith; Lauryn Alissa,0,11,20,20
1683662034200,CAT 125R,B00,202410,Morales; Celeste Georgianna,0,11,20,20
1683662034200,CAT 125R,C00,202411,Irwin; Matthew Joseph,0,12,20,20
1683662035224,CENG 15,A01,204712,Yang; Kesong,0,1,0,0
1683662036252,CENG 114,A00,202070,Jahed Motlagh; Zeinab,5,0,20,15
1683662037277,CGS 105,A00,185477,Wesling; Megan E.,24,0,40,16
1683662038303,CGS 106,A00,185494,Staff,11,0,22,11
1683662039327,CGS 108,A00,185495,Staff,14,0,20,6
1683662040353,CGS 114,A00,185496,Staff,13,0,18,5
1683662041377,CGS 119,A00,185501,Staff,15,0,20,5
1683662042402,CGS 120,A00,185511,Staff,12,0,20,8
1683662043428,CHEM 4,A01,184675,Bussey; Thomas J,97,0,100,3
1683662044455,CHEM 6A,A01,184677,Staff,32,0,60,28
1683662045482,CHEM 6B,A01,184679,Staff,63,0,100,37
1683662046509,CHEM 6C,A01,184681,Bussey; Thomas J,0,0,50,50
1683662046509,CHEM 6C,A02,184682,Bussey; Thomas J,32,0,50,18
1683662047537,CHEM 40A,A01,184684,Albizati; Kim F.,34,0,100,66
1683662048564,CHEM 40B,A01,184686,Albizati; Kim F.,0,22,100,100
1683662049588,CHEM 41B,A01,184690,Staff,51,0,100,49
1683662050612,COGS 3,A01,184715,Boyle; Mary E. T.,0,27,40,40
1683662051635,COGS 14B,A01,185172,Staff,0,14,38,38
1683662052661,COGS 18,A01,184736,Staff,14,0,80,66
1683662053685,COGS 100,A01,184932,Staff,0,7,73,73
1683662054713,COGS 101A,A01,184935,Staff,0,40,30,30
1683662055738,COGS 101B,A01,184944,Staff,0,2,30,30
1683662056763,COGS 101C,A01,184946,Staff,0,10,30,30
1683662057790,COGS 102A,A01,184951,Johnson; Christine M.,2,0,40,38
1683662058816,COGS 107B,A01,184953,Mooshagian; Eric Frederick,0,51,40,40
1683662059839,COGS 118B,A01,184959,Gupta; Anjum,0,49,40,40
1683662060861,COGS 153,A00,184961,Staff,0,16,30,30
1683662061886,COGS 177,A00,184962,Staff,0,21,30,30
1683662062911,COGS 187A,A01,184969,Boyle; Mary E. T.,0,19,40,40
1683662063935,COMM 10,A01,185174,Staff,0,5,25,25
1683662063935,COMM 10,A02,185189,Staff,0,2,25,25
1683662063935,COMM 10,A03,269821,Staff,0,1,0,0
1683662064961,COMM 100B,A01,185475,Staff,0,1,0,2
1683662064961,COMM 100B,A02,185476,Staff,12,0,25,13
1683662065984,COMM 100C,A01,185314,Staff,1,0,25,24
1683662065984,COMM 100C,A02,185327,Staff,18,0,25,7
1683662067010,COMM 110M,A00,185349,Staff,0,0,40,40
1683662068033,COMM 113T,A00,185352,Staff,25,0,40,15
1683662069062,COMM 114I,A00,185353,Staff,31,0,40,9
1683662070089,COMM 131,A00,185354,Staff,17,0,30,13
1683662071116,CSE 8A,A50,185358,Cao; Yingjun,0,46,10,10
1683662072144,CSE 8B,A01,185362,Staff,0,48,50,50
1683662073171,CSE 11,A01,185416,Cao; Yingjun,0,91,10,10
1683662074195,CSE 20,A01,185445,Briones; Jor-el Thomas Caparas,4,0,25,21
1683662075219,CSE 21,A01,185447,Staff,9,0,50,41
1683662076246,CSE 101,A01,185451,Staff,0,13,50,50
1683662076246,CSE 101,B01,185453,Jones; Miles E,0,14,50,50
1683662078292,CSE 141,A01,185458,Eldon; John,16,0,100,84
1683662079314,CSE 141L,A01,185461,Eldon; John,8,0,100,92
1683662080342,CSE 142,A01,185463,Staff,34,0,60,26
1683662080342,CSE 142,B01,201355,Staff,0,7,60,60
1683662081368,CSE 142L,A01,185470,Staff,34,0,60,26
1683662081368,CSE 142L,B01,201417,Staff,0,6,60,60
1683662082395,CSE 190,A00,201433,Staff,32,0,49,17
1683662083419,DOC 1,A01,259136,Strom; Megan C.,7,0,15,8
1683662083419,DOC 1,A02,259137,Strom; Megan C.,14,0,15,1
1683662083419,DOC 1,A03,259138,Strom; Megan C.,14,0,15,1
1683662083419,DOC 1,A04,259139,Strom; Megan C.,14,0,15,1
1683662084515,DOC 100D,A00,259140,Pass; Natalye Joann,14,0,25,11
1683662085541,DSGN 1,A01,184749,Rill; Bryan,0,26,30,30
1683662086568,DSGN 100,A01,185168,Staff,0,2,25,25
1683662087596,ECE 5,A01,185626,Morris; Karcher William,0,11,0,0
1683662088619,ECE 101,A01,185628,Staff,14,0,70,56
1683662089644,ECE 107,A01,185635,Baghdadchi; Saharnaz,0,0,20,20
1683662089644,ECE 107,A02,185638,Baghdadchi; Saharnaz,2,0,20,18
1683662090671,ECE 148,A01,185647,Silberman; Jack,0,0,16,16
1683662091697,ECON 1,A01,185537,Crane; Meredith Helen,54,0,70,16
1683662092723,ECON 3,A01,185549,Crane; Meredith Helen,29,0,70,41
1683662093747,ECON 4,A01,203354,Anderson; John Charles,0,5,10,10
1683662094774,ECON 100A,A01,185574,Staff,0,5,40,40
1683662095798,ECON 100B,A01,185576,Staff,0,12,50,50
1683662096823,ECON 100C,A01,185589,Newhouse; Herbert S,30,0,70,40
1683662097847,ECON 105,A00,185608,Vespa; Emanuel Ignacio,19,0,35,16
1683662098871,ECON 109,A01,185610,Shishkin; Denis,9,0,35,26
1683662099898,ECON 110A,A01,185612,Staff,9,0,40,31
1683662100921,ECON 120A,A01,185615,Staff,20,0,40,20
1683662101955,ECON 120C,A01,185617,Sun; Yixiao,0,20,70,70
1683662102980,ECON 144,A00,203346,Squires; Dale E,2,0,35,33
1683662104004,ECON 171,A01,203349,Newhouse; Herbert S,0,1,35,35
1683662105028,ECON 173A,A01,185621,Toda; Alexis Akira,20,0,35,15
1683662106053,EDS 25,A01,202413,Staff,0,1,0,0
1683662106053,EDS 25,A02,202414,Staff,0,1,0,0
1683662106053,EDS 25,A03,202415,Staff,0,0,0,0
1683662106053,EDS 25,A04,202416,Staff,0,1,0,0
1683662106053,EDS 25,A05,202439,Staff,0,0,0,0
1683662106053,EDS 25,A06,202440,Staff,0,0,0,0
1683662106053,EDS 25,B01,202631,Staff,0,0,0,0
1683662106053,EDS 25,B02,202632,Staff,0,0,0,0
1683662106053,EDS 25,B03,202639,Staff,0,0,0,0
1683662106053,EDS 25,B04,202640,Staff,0,0,0,0
1683662106053,EDS 25,B05,202643,Staff,0,0,0,0
1683662106053,EDS 25,B06,202644,Staff,0,0,0,0
1683662107076,EDS 38,A01,202659,Black; Alison Michelle,24,0,25,1
1683662108103,EDS 115,A00,202652,Staff,18,0,30,12
1683662109126,EDS 125,A00,202649,Staff,13,0,30,17
1683662110152,EDS 126,A01,203332,Staff,30,0,30,0
1683662111175,EDS 139,A00,202838,Staff,16,0,25,9
1683662112200,EDS 146,A01,202655,Staff,14,0,25,11
1683662113224,ENG 15,A00,185667,Staff,0,1,0,0
1683662113224,ENG 15,B00,185672,Staff,0,0,0,0
1683662113224,ENG 15,C00,185675,Staff,0,0,0,0
1683662113224,ENG 15,D00,185682,Staff,0,0,0,0
1683662113224,ENG 15,E00,185684,Staff,0,0,0,0
1683662114249,ETHN 103,A00,185710,Staff,0,8,35,35
1683662115278,ETHN 103A,A00,199228,Man; Simeon S,0,0,9,9
1683662116301,ETHN 109,A00,185711,Staff,16,0,35,19
1683662117325,ETHN 142,A00,185726,Staff,0,4,30,30
1683662118348,ETHN 163J,A00,199229,Man; Simeon S,5,0,8,3
1683662119375,ETHN 168,A00,185727,Staff,7,0,10,3
1683662120402,ETHN 182,A00,185728,Staff,0,0,35,35
1683662121424,ETHN 183,A00,185737,Staff,9,0,18,9
1683662122447,GLBH 111,A01,209361,Burgos; Jose L.,0,0,0,0
1683662124497,HIEU 104,A00,185792,Staff,14,0,20,6
1683662125518,HIEU 115,A00,185800,Staff,0,0,20,20
1683662126541,HIEU 128,A00,185801,Staff,0,9,20,20
1683662127565,HIEU 147,A00,185802,Staff,15,0,20,5
1683662128594,HIEU 154,A00,185823,Staff,11,0,20,9
1683662129621,HILA 102,A00,185826,Staff,14,0,20,6
1683662130644,HILD 2C,A01,185778,Staff,0,13,20,20
1683662131669,HILD 7B,A01,185780,Kwak; Nancy,0,17,32,32
1683662131669,HILD 7B,A02,185781,Kwak; Nancy,0,18,32,32
1683662132695,HILD 30,A01,185791,Staff,12,0,20,8
1683662133722,HISC 119,A00,185830,Golan; Tal,0,9,20,20
1683662134747,HITO 156GS,A00,185831,Patterson; Patrick H.,0,0,0,23
1683662135771,HIUS 103,A00,185832,Man; Simeon S,0,4,20,20
1683662136796,HIUS 117,A00,185836,Kwak; Nancy,2,0,20,18
1683662137820,HIUS 125,A00,185840,Man; Simeon S,0,2,23,23
1683662138845,HIUS 149,A00,185845,Staff,1,0,20,19
1683662139873,HUM 3,A01,185882,Zavodny; Tatiana Sophia,0,8,50,50
1683662139873,HUM 3,B01,185899,Caldwell; Michael Alan,0,18,50,50
1683662140896,HUM 3GS,A00,185900,Patterson; Patrick H.,0,0,0,23
1683662141925,HUM 4,A01,185938,Zroka; Amy Liane,29,0,50,21
1683662141925,HUM 4,B01,185956,Watkins; Eric,0,4,50,50
1683662141925,HUM 4,B02,202209,Watkins; Eric,0,5,50,50
1683662141925,HUM 4,B03,202210,Watkins; Eric,0,5,50,50
1683662142949,HUM 5,A01,185958,West; Geoffrey Scott,0,0,50,50
1683662142949,HUM 5,A02,202215,West; Geoffrey Scott,0,0,50,50
1683662143972,INTL 190,A00,185959,Gagnon; Jeffrey C,0,0,0,9
1683662143972,INTL 190,B00,185960,Lettieri; Michael Joseph,0,0,0,2
1683662144996,JAPN 180,A00,254509,Staff,5,0,30,25
1683662146020,LATI 10,A01,202853,Kennemore; Amy Michelle,4,0,35,31
1683662146020,LATI 10,A02,202854,Kennemore; Amy Michelle,2,0,35,33
1683662146020,LATI 10,A03,270054,Kennemore; Amy Michelle,30,0,30,0
1683662147043,LATI 180,A00,202855,Kennemore; Amy Michelle,11,0,20,9
1683662148070,LAWS 101,A00,201767,Golan; Tal,0,7,40,40
1683662149097,LIFR 1C,A00,185961,Staff,6,0,20,14
1683662150121,LIFR 1CX,A00,185962,Staff,7,0,20,13
1683662151148,LIFR 1D,A00,185963,Staff,7,0,20,13
1683662152177,LIFR 1DX,A00,185964,Staff,7,0,20,13
1683662153201,LIGN 101,A01,186039,Staff,43,0,50,7
1683662154227,LIGN 165,A00,186040,Staff,15,0,50,35
1683662155250,LTCS 108,A00,186041,Staff,5,0,10,5
1683662156274,LTCS 119,A00,186042,Staff,15,0,20,5
1683662157302,LTCS 130,A00,186043,Wesling; Megan E.,15,0,25,10
1683662159348,LTEA 138,A00,186119,Staff,14,0,40,26
1683662160373,LTEN 124,A00,186148,Staff,5,0,25,20
1683662161397,LTEN 178,A00,186149,Staff,7,0,15,8
1683662162423,LTEN 181,A00,186150,Blanco; John D,34,0,40,6
1683662163451,LTWL 120,A00,186160,Staff,20,0,25,5
1683662164478,LTWL 165,A00,186161,Staff,22,0,25,3
1683662165505,LTWR 100,A00,186162,Staff,0,5,15,15
1683662166530,LTWR 102,A00,186163,Doller; Ben,5,0,15,10
1683662167558,MAE 8,A01,186412,Staff,0,0,0,0
1683662168584,MAE 30B,A00,186445,Bahadori; Mohammad Yousef,82,0,100,18
1683662169609,MAE 40,A00,186592,Bewley; Thomas R,10,0,50,40
1683662170633,MAE 101B,A00,186593,Bahadori; Mohammad Yousef,80,0,100,20
1683662171657,MAE 105,A00,186594,Bandaru; Prabhakar,10,0,50,40
1683662172681,MAE 107,A00,186599,Pham; Hieu Tan,0,7,120,120
1683662173712,MAE 148,A01,186660,Silberman; Jack,3,0,16,13
1683662174737,MATH 10A,A01,188095,Staff,0,6,35,35
1683662175767,MATH 10B,A01,188097,Bowers; Adam R.,0,12,30,30
1683662175767,MATH 10B,A02,188099,Bowers; Adam R.,0,11,30,30
1683662175767,MATH 10B,B01,188104,Bowers; Adam R.,0,10,30,30
1683662175767,MATH 10B,B02,188106,Bowers; Adam R.,1,9,30,29
1683662176793,MATH 10C,A01,188111,Staff,0,18,30,30
1683662176793,MATH 10C,A02,188127,Staff,0,19,30,30
1683662176793,MATH 10C,A03,188131,Staff,0,19,30,30
1683662176793,MATH 10C,B01,188218,Staff,17,0,30,13
1683662176793,MATH 10C,B02,188244,Staff,13,0,30,17
1683662176793,MATH 10C,B03,188277,Staff,14,0,30,16
1683662177818,MATH 18,A01,188344,Bach; Quang Tran,18,0,30,12
1683662177818,MATH 18,A02,188345,Bach; Quang Tran,11,0,30,19
1683662177818,MATH 18,B01,188353,Bach; Quang Tran,11,0,30,19
1683662177818,MATH 18,B02,188354,Bach; Quang Tran,19,0,30,11
1683662178841,MATH 20A,A01,188374,Staff,11,0,35,24
1683662179867,MATH 20B,A01,188382,Ohm; Ko Woon,7,0,30,23
1683662179867,MATH 20B,A02,188383,Ohm; Ko Woon,22,0,30,8
1683662179867,MATH 20B,B01,188385,Ohm; Ko Woon,7,0,30,23
1683662179867,MATH 20B,B02,188392,Ohm; Ko Woon,22,0,30,8
1683662180896,MATH 20C,A01,188394,Harel; Guershon,10,0,30,20
1683662180896,MATH 20C,A02,188395,Harel; Guershon,13,0,30,17
1683662180896,MATH 20C,B01,188404,Harel; Guershon,5,0,30,25
1683662180896,MATH 20C,B02,188405,Harel; Guershon,18,0,30,12
1683662181927,MATH 20D,A01,188414,Hammock; Frances H,0,1,30,30
1683662181927,MATH 20D,A02,188415,Hammock; Frances H,0,1,30,30
1683662181927,MATH 20D,B01,188447,Hammock; Frances H,0,1,30,30
1683662181927,MATH 20D,B02,188486,Hammock; Frances H,3,0,30,27
1683662182951,MATH 20E,A01,188649,Staff,21,0,30,9
1683662182951,MATH 20E,A02,188650,Staff,21,0,30,9
1683662182951,MATH 20E,A03,188673,Staff,0,0,30,30
1683662183975,MATH 102,A01,188675,Staff,0,36,35,35
1683662185000,MATH 103B,A01,188681,Staff,3,0,35,32
1683662185000,MATH 103B,B01,188692,Staff,5,0,35,30
1683662186025,MATH 109,A01,188695,Salehi Golsefidy; Alireza,24,0,35,11
1683662186025,MATH 109,A02,188696,Salehi Golsefidy; Alireza,25,0,35,10
1683662187053,MATH 120A,A01,188698,Eggers; John Dietrich,7,0,35,28
1683662188137,MATH 142B,A01,188736,Ioana; Adrian,1,1,30,29
1683662188137,MATH 142B,A02,188741,Ioana; Adrian,0,1,30,30
1683662188137,MATH 142B,A03,188743,Ioana; Adrian,0,1,30,30
1683662189165,MATH 168A,A01,188790,Staff,0,10,35,35
1683662190193,MATH 170A,A01,188803,Nie; Jiawang,0,2,35,35
1683662190193,MATH 170A,A02,188811,Nie; Jiawang,0,0,35,35
1683662190193,MATH 170A,A03,188814,Nie; Jiawang,0,0,35,35
1683662190193,MATH 170A,A04,188815,Nie; Jiawang,9,0,35,26
1683662191221,MATH 193B,A01,188817,Staff,0,0,35,35
1683662191221,MATH 193B,A02,188818,Staff,5,0,35,30
1683662192247,MGT 4,A01,202857,Anderson; John Charles,61,0,80,19
1683662193273,MGT 12,A00,202858,Lindenberger; Wade Douglas,40,0,90,50
1683662194299,MGT 18,A00,202859,Staff,74,0,90,16
1683662195323,MGT 18GS,A00,202860,McKay; Michael J,13,0,28,15
1683662196346,MGT 45,A00,202861,Pecore; Joseph P.,11,0,90,79
1683662197368,MGT 100,A00,202863,Yavorsky; Daniel Ryan,28,0,90,62
1683662198393,MGT 103,A00,202864,Ehrich; Kristine R,0,18,90,90
1683662199422,MGT 112,A00,202865,Ehrich; Kristine R,14,0,90,76
1683662200446,MGT 121A,A00,202868,Staff,90,20,90,0
1683662201473,MGT 131B,A00,202869,Anderson; John Charles,59,0,90,31
1683662202498,MGT 136,A00,202871,Lindenberger; Wade Douglas,83,0,90,7
1683662203522,MGT 164,A00,202873,Staff,0,67,90,91
1683662204549,MGT 164GS,A00,202874,McKay; Mary A,13,0,28,15
1683662205577,MGT 180,A00,202875,Staff,0,51,90,91
1683662206605,MMW 11R,A01,205019,Herbst; Matthew,1,0,30,29
1683662206605,MMW 11R,A02,205026,Herbst; Matthew,29,0,30,1
1683662207631,MMW 15,A01,193512,Chang; Edmond Yi-Teh,0,8,28,28
1683662207631,MMW 15,A02,193513,Chang; Edmond Yi-Teh,0,5,28,28
1683662207631,MMW 15,A03,193514,Chang; Edmond Yi-Teh,0,5,28,28
1683662207631,MMW 15,A04,193515,Chang; Edmond Yi-Teh,0,5,28,28
1683662207631,MMW 15,A05,193516,Chang; Edmond Yi-Teh,0,5,28,28
1683662207631,MMW 15,A06,193517,Chang; Edmond Yi-Teh,0,6,28,28
1683662207631,MMW 15,B01,193519,Chang; Edmond Yi-Teh,0,5,28,28
1683662207631,MMW 15,B02,193520,Chang; Edmond Yi-Teh,0,5,28,28
1683662207631,MMW 15,B03,193521,Chang; Edmond Yi-Teh,0,5,28,28
1683662207631,MMW 15,B04,193522,Chang; Edmond Yi-Teh,0,5,28,28
1683662207631,MMW 15,B05,193523,Chang; Edmond Yi-Teh,0,5,28,28
1683662207631,MMW 15,B06,193524,Chang; Edmond Yi-Teh,0,5,28,28
1683662208655,MMW 122,A01,193526,Rahimi; Babak,0,16,28,28
1683662208655,MMW 122,A02,193527,Rahimi; Babak,0,15,28,28
1683662208655,MMW 122,A03,193528,Rahimi; Babak,0,0,0,0
1683662208655,MMW 122,A04,193529,Rahimi; Babak,0,0,0,0
1683662209680,MUS 1A,A01,186663,Staff,1,20,35,34
1683662210705,MUS 4,A01,186715,Staff,0,12,35,35
1683662211727,MUS 5R,A01,186796,Dubnov; Shlomo,0,17,35,35
1683662212750,MUS 6,A01,186798,Staff,0,5,25,25
1683662213775,MUS 7,A01,186830,Staff,11,0,35,24
1683662214799,MUS 8,A01,186930,Staff,0,26,35,35
1683662215823,MUS 15,A01,186932,Staff,0,16,35,35
1683662215823,MUS 15,B01,186934,Staff,1,17,35,34
1683662216850,MUS 80,A00,186935,Staff,0,0,20,20
1683662216850,MUS 80,B00,186936,Staff,24,0,25,1
1683662217876,NANO 11,A00,204702,Lipomi; Darren John,0,0,0,0
1683662218899,NANO 15,A01,204709,Yang; Kesong,0,1,0,0
1683662219927,NANO 114,A00,202069,Jahed Motlagh; Zeinab,3,0,10,7
1683662220951,PHIL 1,A00,186955,Grush; Rick Scott,31,0,40,9
1683662221982,PHIL 10,A01,186973,Grush; Rick Scott,27,0,35,8
1683662221982,PHIL 10,A02,186974,Grush; Rick Scott,33,0,35,2
1683662223010,PHIL 13,A01,186976,Staff,3,0,35,32
1683662223010,PHIL 13,A02,186977,Staff,16,0,35,19
1683662224034,PHIL 14,A01,186979,Staff,31,0,35,4
1683662224034,PHIL 14,A02,186986,Staff,32,0,35,3
1683662225059,PHIL 28,A01,186988,Staff,16,0,30,14
1683662225059,PHIL 28,A02,186989,Staff,1,0,30,29
1683662225059,PHIL 28,A03,186990,Staff,10,0,30,20
1683662225059,PHIL 28,A04,186991,Staff,26,0,30,4
1683662226083,PHIL 120,A00,186997,Staff,23,0,40,17
1683662227110,PHIL 137,A00,187003,Staff,7,0,40,33
1683662228141,PHIL 150,A00,187015,Staff,47,0,70,23
1683662229168,PHIL 167,A00,187021,Lamey; Andy M.,34,0,40,6
1683662230193,PHIL 174,A01,202226,Staff,17,0,20,3
1683662230193,PHIL 174,A02,202235,Staff,20,0,20,0
1683662231219,PHIL 191A,A00,258918,Staff,0,0,1,1
1683662232244,PHYS 1A,A00,187028,Staff,26,0,60,34
1683662233272,PHYS 1AL,001,187036,Staff,3,0,30,27
1683662233272,PHYS 1AL,002,187049,Staff,18,0,30,12
1683662234299,PHYS 1B,A00,187058,Staff,22,0,60,38
1683662235327,PHYS 1BL,001,187064,Staff,0,1,30,30
1683662235327,PHYS 1BL,002,187070,Staff,4,0,30,26
1683662236350,PHYS 1C,A00,187082,Staff,29,0,120,91
1683662237378,PHYS 1CL,001,187088,Staff,0,9,30,30
1683662237378,PHYS 1CL,002,187089,Staff,0,1,30,30
1683662237378,PHYS 1CL,009,262693,Staff,9,0,30,21
1683662238407,PHYS 2B,A01,187097,Staff,55,0,115,60
1683662239433,PHYS 2C,A01,187099,Staff,63,0,115,52
1683662240458,PHYS 2CL,A01,187101,Staff,5,0,28,23
1683662240458,PHYS 2CL,A02,187102,Staff,15,0,28,13
1683662241486,PHYS 2D,A01,187123,Shotwell; Brian,95,0,115,20
1683662242511,PHYS 4B,A01,187133,Grinstein; Benjamin,35,0,50,15
1683662243538,POLI 10,A00,188819,Staff,0,4,50,50
1683662244563,POLI 11,A00,188827,Staff,43,0,50,7
1683662245587,POLI 13R,A00,188828,Staff,0,1,20,20
1683662246616,POLI 27,A01,188830,Elgin; Samuel Zincke,0,2,70,70
1683662247640,POLI 30,A00,188832,Desposato; Scott,30,0,50,20
1683662248667,POLI 102F,A00,188834,Staff,0,0,40,40
1683662249692,POLI 104A,A00,188852,Staff,13,0,30,17
1683662250725,POLI 104I,A00,188853,Staff,0,7,20,20
1683662251752,POLI 110B,A00,188854,Wiens; David,6,0,20,14
1683662252779,POLI 112A,A00,188855,Wiens; David,3,0,30,27
1683662253807,POLI 117R,A00,188856,Forman; Fonna,0,12,20,20
1683662254832,POLI 118,A00,188857,Ingham; Sean,8,0,20,12
1683662255859,POLI 120G,A00,188858,Staff,8,0,30,22
1683662256884,POLI 131CR,A00,188863,Hoston; Germaine,21,0,50,29
1683662257911,POLI 133,A00,188864,Nellis; Gareth Hb,44,0,50,6
1683662258935,POLI 134D,A00,188865,Desposato; Scott,27,0,30,3
1683662259960,POLI 142A,A00,188871,Gartzke; Erik,21,0,50,29
1683662260987,POLI 142K,A00,188874,Staff,38,0,50,12
1683662262011,POLI 143,A00,188940,Gartzke; Erik,16,0,30,14
1683662263035,POLI 153,A00,188943,Staff,2,0,20,18
1683662264060,POLI 160AA,A00,188944,Staff,11,0,40,29
1683662265085,POLI 170A,A00,188945,Staff,11,0,30,19
1683662267139,PSYC 1,A00,188952,Staff,36,0,90,54
1683662268165,PSYC 2,B00,188953,Staff,19,0,35,16
1683662269189,PSYC 6,A00,188970,Staff,47,0,60,13
1683662270213,PSYC 7,A00,188973,Staff,35,0,45,10
1683662271237,PSYC 60,A01,188980,Rickard; Timothy C.,42,0,60,18
1683662272260,PSYC 70,A01,189001,Steiner; Eric Tomas,22,0,45,23
1683662273285,PSYC 100,A00,189005,Lacefield; Katharine I,0,99,120,120
1683662274309,PSYC 102,A00,189008,Staff,8,0,30,22
1683662275334,PSYC 106,B00,189026,Gorman; Michael R.,27,0,60,33
1683662276362,PSYC 114,B01,189033,Winkielman; Piotr,0,31,30,30
1683662277386,PSYC 131,A00,189036,Anagnostaras; Stephan,0,43,60,60
1683662278413,PSYC 136,A00,189041,Lowe; Angela Beth,0,7,25,25
1683662279438,PSYC 137,A00,189057,Winkielman; Piotr,0,37,25,25
1683662280465,PSYC 144,A00,189107,Wixted; John T,0,11,50,50
1683662282522,PSYC 162,A00,189142,Staff,0,9,85,85
1683662283548,PSYC 172,A00,189144,Gorman; Michael R.,0,6,30,30
1683662285598,PSYC 179,A00,189146,Lacefield; Katharine I,0,87,120,120
1683662286625,PSYC 181,A00,189147,Anagnostaras; Stephan,0,44,90,90
1683662287653,PSYC 190R,A00,189148,Barner; David A.,0,23,80,80
1683662288680,PSYC 191,A00,189275,Rickard; Timothy C.,0,10,25,25
1683662289709,PSYC 193,A00,189276,Chapman; Eddie Nathaniel,0,1,0,4
1683662290737,PSYC 193L,A01,189281,Lowe; Angela Beth,10,0,20,10
1683662290737,PSYC 193L,B01,189285,Staff,28,0,35,7
1683662291818,RELI 149,A00,187137,Rahimi; Babak,7,0,40,33
1683662292843,SE 9,A01,187315,Staff,0,2,18,18
1683662293870,SE 101B,A00,187409,Staff,24,0,30,6
1683662294895,SE 110B,A00,187444,Staff,10,0,40,30
1683662295920,SE 130B,A00,187449,Staff,31,0,40,9
1683662296944,SE 150A,A00,187516,Staff,9,0,20,11
1683662297969,SE 154,A00,187528,Staff,29,0,50,21
1683662298994,SIO 3,A01,258171,Staff,35,0,40,5
1683662300017,SIO 10,A00,187144,Cook; Geoffrey W,0,7,75,75
1683662301045,SIO 45,A00,187152,Cook; Geoffrey W,0,5,100,100
1683662302070,SIO 109R,A00,194486,Staff,0,4,20,20
1683662304122,SIO 187,A01,187233,Kacev; David,12,0,40,28
1683662305151,SOCI 1,A01,258656,Thorpe; Charles Robert,28,0,30,2
1683662305151,SOCI 1,A02,258658,Thorpe; Charles Robert,30,0,30,0
1683662305151,SOCI 1,A03,258661,Thorpe; Charles Robert,25,0,25,0
1683662305151,SOCI 1,A04,258666,Thorpe; Charles Robert,22,0,25,3
1683662305151,SOCI 1,A05,258897,Thorpe; Charles Robert,22,0,25,3
1683662305151,SOCI 1,A06,258898,Thorpe; Charles Robert,25,0,25,0
1683662306181,SOCI 30,A01,258903,Pardo Guerra; Juan Pablo,14,0,30,16
1683662307205,SOCI 102,A00,258904,Staff,9,0,25,16
1683662308228,SOCI 106,A00,258905,Staff,19,0,25,6
1683662309254,SOCI 111,A00,258907,Ribas Norris; Janet Vanesa,26,0,30,4
1683662310279,SOCI 121R,A00,258908,Pardo Guerra; Juan Pablo,8,0,30,22
1683662311306,SOCI 126,A01,203330,Staff,14,0,20,6
1683662312331,SOCI 131,A00,258909,Thorpe; Charles Robert,30,0,60,30
1683662313356,SOCI 135,A00,258910,Payne; Christine Anna,0,11,30,30
1683662314381,SOCI 157,A00,258911,Staff,12,0,30,18
1683662315405,SOCI 184,A00,258912,Staff,25,0,30,5
1683662316433,SOCI 188D,A00,258913,Staff,22,0,30,8
1683662317466,SYN 2,001,187529,Staff,9,0,16,7
1683662317466,SYN 2,002,201452,Staff,0,20,16,16
1683662317466,SYN 2,003,201469,Staff,1,0,16,15
1683662318491,SYN 100,A01,187531,Staff,0,9,20,20
1683662318491,SYN 100,B01,201491,Staff,0,10,20,20
1683662319518,TDAC 1,A00,189286,Walsh; Kim C.,3,0,20,17
1683662319518,TDAC 1,B00,189287,Harting; Carla Kelso,10,0,20,10
1683662320542,TDAC 101,A00,189300,Walsh; Kim C.,16,0,20,4
1683662320542,TDAC 101,B00,189301,Harting; Carla Kelso,18,0,20,2
1683662321571,TDAC 102,A00,189304,Basso; Beatrice,14,0,20,6
1683662322594,TDAC 108,A00,189305,Staff,18,0,20,2
1683662323620,TDDE 131,A00,189310,Staff,19,0,20,1
1683662323620,TDDE 131,B00,189314,Staff,19,0,20,1
1683662323620,TDDE 131,C00,189315,Staff,48,0,50,2
1683662323620,TDDE 131,D00,189316,Staff,14,0,15,1
1683662323620,TDDE 131,E00,204841,Staff,20,0,20,0
1683662324648,TDGE 10,A00,189289,Staff,27,0,50,23
1683662324648,TDGE 10,B00,189290,Havis; Allan,0,0,50,50
1683662325674,TDGE 11,A00,189291,Fulton; Julia,0,4,50,50
1683662325674,TDGE 11,B00,189292,Staff,20,0,25,5
1683662325674,TDGE 11,C00,260270,Staff,0,0,0,0
1683662326700,TDGE 25,A00,189294,Staff,2,0,20,18
1683662327724,TDGE 124,A00,189318,Fulton; Julia,0,8,50,50
1683662328756,TDGE 125,A00,189319,Staff,13,0,25,12
1683662328756,TDGE 125,B00,189320,Staff,23,0,25,2
1683662329780,TDGE 127,A00,189322,Havis; Allan,1,0,50,49
1683662330806,TDHT 101,A00,189323,Staff,18,0,25,7
1683662330806,TDHT 101,B00,189324,Staff,25,0,25,0
1683662331832,TDHT 102,A00,189325,Staff,49,0,50,1
1683662332856,TDMV 1,A00,189295,Arcidiacono; Kristin,20,0,30,10
1683662332856,TDMV 1,B00,189296,Caligagan; Maria T.,24,0,30,6
1683662333883,TDMV 2,A00,189297,Sammartano; Tonnie,27,0,30,3
1683662333883,TDMV 2,B00,189299,Arcidiacono; Kristin,23,0,30,7
1683662334906,TDMV 3,A00,204998,Rincon; Alicia,22,0,30,8
1683662335930,TDMV 120,A00,189458,Sammartano; Tonnie,28,0,30,2
1683662336955,TDMV 138,A00,189541,Jun; Grace Shin Hae,20,0,40,20
1683662337979,TDMV 142,A00,189717,Caligagan; Tony,25,0,30,5
1683662337979,TDMV 142,B00,189718,Caligagan; Maria T.,25,0,30,5
1683662339004,TMC 2,A01,187533,Staff,25,0,25,0
1683662339004,TMC 2,A02,187534,Staff,25,0,25,0
1683662340031,USP 1,A01,187536,Kwak; Nancy,0,16,25,25
1683662341067,USP 5,A01,187538,Staff,9,0,25,16
1683662342090,USP 101,A00,199253,Staff,0,4,0,0
1683662343117,USP 124,A00,187562,Boomhower; Matthew Charles,0,0,30,30
1683662344142,USP 138,A00,187582,Staff,20,0,25,5
1683662345166,USP 152,A01,187597,Staff,3,0,25,22
1683662346192,USP 153,A00,187598,Staff,19,0,25,6
1683662347217,USP 168,A00,187607,Kwak; Nancy,2,0,5,3
1683662348241,USP 173,A00,187619,Staff,4,0,25,21
1683662349266,USP 181,A00,187638,Staff,0,4,25,25
1683662350293,VIS 103,A00,187650,Cruz; Edwin Teddy,17,0,75,58
1683662351317,VIS 110D,A00,187669,Staff,13,0,22,9
1683662352341,VIS 127C,A00,187720,Shen; Kuiyi,68,0,146,78
1683662353365,VIS 149,A00,187731,Yoldas; Pinar,1,14,22,21
1683662354391,VIS 151,A01,188091,Staff,22,0,34,12
1683662354391,VIS 151,A02,188092,Staff,11,0,34,23
1683662355415,VIS 160B,A00,188093,Stalbaum; Brett,0,1,10,10
1683662357466,WCWP 10B,A00,201720,Staff,10,0,15,5
1683662357466,WCWP 10B,B00,201722,Staff,9,0,15,6
1683662358493,WCWP 100,A00,201725,Gagnon; Jeffrey C,0,0,2,2
1683662358493,WCWP 100,B00,201727,Staff,0,4,15,15
1683662361624,ANBI 133,A00,258401,Wilder; Linnea Lorene,34,0,40,6
1683662362648,ANBI 140,A00,258395,Hrvoj Mihic; Branka,18,0,25,7
1683662363672,ANSC 120,A00,258402,Bialecki; Jon Anthony,26,0,40,14
1683662364695,ANSC 144,A00,258400,Staff,12,0,40,28
1683662366746,ANSC 166,A00,258396,Parish; Steven Martin,156,0,175,19
1683662367777,ANSC 180,A00,193533,Staff,8,0,20,12
1683662368801,ANSC 188,A00,258397,Jassal; Aftab,34,0,40,6
1683662369826,ANTH 3,A01,258316,Staff,23,0,30,7
1683662370853,ANTH 5,A00,258394,Semendeferi; Ekaterini,16,0,20,4
1683662371878,ANTH 21,A01,258331,Staff,4,0,40,36
1683662372901,ANTH 103,A00,258398,Varma; Saiba,15,0,25,10
1683662373928,AWP 10,001,202034,Staff,0,0,0,0
1683662373928,AWP 10,002,202035,Staff,0,0,0,0
1683662373928,AWP 10,003,202036,Staff,0,0,0,0
1683662373928,AWP 10,004,202037,Staff,0,0,0,0
1683662373928,AWP 10,005,202038,Staff,0,0,0,0
1683662373928,AWP 10,006,202039,Staff,0,0,0,0
1683662373928,AWP 10,007,202040,Staff,0,0,0,0
1683662373928,AWP 10,008,202041,Staff,0,0,0,0
1683662373928,AWP 10,009,202042,Staff,0,0,0,0
1683662373928,AWP 10,010,202043,Staff,0,0,0,0
1683662373928,AWP 10,011,202044,Staff,0,0,0,0
1683662373928,AWP 10,012,202045,Staff,0,0,0,0
1683662373928,AWP 10,013,202046,Staff,0,0,0,0
1683662373928,AWP 10,014,202047,Staff,0,0,0,0
1683662373928,AWP 10,015,202048,Staff,0,0,0,0
1683662373928,AWP 10,016,202049,Staff,0,0,0,0
1683662373928,AWP 10,017,202050,Staff,0,0,0,0
1683662373928,AWP 10,018,202051,Staff,0,0,0,0
1683662373928,AWP 10,019,202052,Staff,0,0,0,0
1683662373928,AWP 10,020,202053,Staff,0,0,0,0
1683662373928,AWP 10,021,202054,Staff,0,0,0,0
1683662373928,AWP 10,022,202055,Staff,0,0,0,0
1683662373928,AWP 10,023,202056,Staff,0,0,0,0
1683662373928,AWP 10,024,202057,Staff,0,0,0,0
1683662373928,AWP 10,025,202058,Staff,0,0,0,0
1683662373928,AWP 10,026,202059,Staff,0,0,0,0
1683662374956,AWP 102,001,202032,Staff,0,0,0,0
1683662374956,AWP 102,002,202033,Staff,0,0,0,0
1683662375982,BENG 100,A01,254234,Taylor Amos; Alyssa C,31,0,40,9
1683662377006,BENG 196,001,270013,Engler; Adam J.,9999,0,9999,0
1683662378031,BICD 100R,A01,202018,Smith; Laurie,0,7,32,32
1683662378031,BICD 100R,A02,202019,Smith; Laurie,0,3,32,32
1683662378031,BICD 100R,A03,202020,Smith; Laurie,0,1,32,32
1683662378031,BICD 100R,A04,202021,Smith; Laurie,6,0,32,26
1683662378031,BICD 100R,A05,202022,Smith; Laurie,11,0,32,21
1683662379055,BICD 136,A01,193242,Gustafson-Brown; Cindy,0,2,32,32
1683662379055,BICD 136,A02,193244,Gustafson-Brown; Cindy,13,0,32,19
1683662380084,BIEB 102,A01,193249,Butler; Shannon Rhey,1,2,32,31
1683662380084,BIEB 102,A02,193251,Butler; Shannon Rhey,0,0,32,32
1683662380084,BIEB 102,A03,193253,Butler; Shannon Rhey,0,0,32,32
1683662380084,BIEB 102,A04,193255,Butler; Shannon Rhey,14,0,32,18
1683662380084,BIEB 102,A05,193265,Butler; Shannon Rhey,25,0,32,7
1683662380084,BIEB 102,A06,193269,Butler; Shannon Rhey,14,0,32,18
1683662382135,BIEB 150,A01,193274,Staff,0,0,32,32
1683662382135,BIEB 150,A02,193285,Staff,24,0,32,8
1683662383161,BIEB 194,A00,193286,Kurle; Carolyn M.,20,0,32,12
1683662384189,BILD 1,A01,192291,Staff,15,0,32,17
1683662384189,BILD 1,A02,192292,Staff,30,0,32,2
1683662384189,BILD 1,B01,192520,Reuther; Keefe,0,1,0,0
1683662384189,BILD 1,B02,192532,Reuther; Keefe,0,1,0,0
1683662385218,BILD 3,A01,192556,Butler; Shannon Rhey,0,0,32,32
1683662385218,BILD 3,A02,192581,Butler; Shannon Rhey,0,0,32,32
1683662385218,BILD 3,A03,192611,Butler; Shannon Rhey,21,0,32,11
1683662385218,BILD 3,A04,192612,Butler; Shannon Rhey,24,0,32,8
1683662385218,BILD 3,A05,192613,Butler; Shannon Rhey,26,0,32,6
1683662385218,BILD 3,A06,192679,Butler; Shannon Rhey,27,0,32,5
1683662385218,BILD 3,A07,192682,Butler; Shannon Rhey,20,0,32,12
1683662386248,BILD 4,A01,192836,Reuther; Keefe,1,0,24,23
1683662386248,BILD 4,A02,193044,Reuther; Keefe,4,0,24,20
1683662387276,BILD 10,A01,193142,Gustafson-Brown; Cindy,29,0,32,3
1683662387276,BILD 10,A02,193149,Gustafson-Brown; Cindy,31,0,32,1
1683662388300,BIMM 100,A01,193301,Staff,0,6,32,32
1683662388300,BIMM 100,A02,193312,Staff,0,7,32,32
1683662388300,BIMM 100,A03,193323,Staff,0,9,32,32
1683662389333,BIMM 101,A01,193329,McDonnell; Lisa Marie,0,4,24,24
1683662389333,BIMM 101,A02,193339,McDonnell; Lisa Marie,1,4,24,23
1683662389333,BIMM 101,B01,193354,McDonnell; Lisa Marie,0,4,24,24
1683662389333,BIMM 101,B02,193357,McDonnell; Lisa Marie,0,3,24,24
1683662390358,BIMM 110,A01,193377,Tat; John,0,11,32,32
1683662390358,BIMM 110,A02,193378,Tat; John,0,10,32,32
1683662391384,BIMM 120,A01,206116,Staff,0,0,32,32
1683662391384,BIMM 120,A02,206117,Staff,6,0,32,26
1683662391384,BIMM 120,A03,206121,Staff,21,0,32,11
1683662392409,BIPN 100,A01,193393,Park; Ji Young,0,15,32,32
1683662392409,BIPN 100,A02,193402,Park; Ji Young,0,14,32,32
1683662392409,BIPN 100,A03,193413,Park; Ji Young,0,14,32,32
1683662392409,BIPN 100,A04,193414,Park; Ji Young,0,13,32,32
1683662393435,BIPN 102,A01,193429,Staff,0,0,32,32
1683662393435,BIPN 102,A02,193438,Staff,18,0,32,14
1683662394461,BIPN 106,A01,193450,Reyes Gonzalez; Catalina,0,2,40,40
1683662395539,BIPN 134,A01,193465,Cooke; James Edward,0,0,32,32
1683662395539,BIPN 134,A02,193474,Cooke; James Edward,25,0,32,7
1683662395539,BIPN 134,A03,193485,Cooke; James Edward,29,0,32,3
1683662395539,BIPN 134,A04,193486,Cooke; James Edward,20,0,32,12
1683662395539,BIPN 134,A05,193491,Cooke; James Edward,31,0,32,1
1683662395539,BIPN 134,A06,193501,Cooke; James Edward,30,0,32,2
1683662395539,BIPN 134,A07,193510,Cooke; James Edward,29,0,32,3
1683662397589,BISP 194,A00,222522,Staff,14,0,32,18
1683662398612,CAT 124,A01,202407,Staff,19,0,25,6
1683662399635,CAT 125,A00,202408,Marchisotto; Jennifer Anne,2,0,20,18
1683662400665,CAT 125R,A00,202409,Smith; Lauryn Alissa,0,11,20,20
1683662400665,CAT 125R,B00,202410,Morales; Celeste Georgianna,0,11,20,20
1683662400665,CAT 125R,C00,202411,Irwin; Matthew Joseph,0,12,20,20
1683662401688,CENG 15,A01,204712,Yang; Kesong,0,1,0,0
1683662402712,CENG 114,A00,202070,Jahed Motlagh; Zeinab,5,0,20,15
1683662403741,CGS 105,A00,185477,Wesling; Megan E.,24,0,40,16
1683662404766,CGS 106,A00,185494,Staff,11,0,22,11
1683662405792,CGS 108,A00,185495,Staff,14,0,20,6
1683662406816,CGS 114,A00,185496,Staff,13,0,18,5
1683662407844,CGS 119,A00,185501,Staff,15,0,20,5
1683662408871,CGS 120,A00,185511,Staff,12,0,20,8
1683662409898,CHEM 4,A01,184675,Bussey; Thomas J,97,0,100,3
1683662410923,CHEM 6A,A01,184677,Staff,32,0,60,28
1683662411947,CHEM 6B,A01,184679,Staff,63,0,100,37
1683662412976,CHEM 6C,A01,184681,Bussey; Thomas J,0,0,50,50
1683662412976,CHEM 6C,A02,184682,Bussey; Thomas J,32,0,50,18
1683662414003,CHEM 40A,A01,184684,Albizati; Kim F.,34,0,100,66
1683662415030,CHEM 40B,A01,184686,Albizati; Kim F.,0,22,100,100
1683662416057,CHEM 41B,A01,184690,Staff,51,0,100,49
1683662417081,COGS 3,A01,184715,Boyle; Mary E. T.,0,27,40,40
1683662418105,COGS 14B,A01,185172,Staff,0,14,38,38
1683662419129,COGS 18,A01,184736,Staff,14,0,80,66
1683662420153,COGS 100,A01,184932,Staff,0,7,73,73
1683662421181,COGS 101A,A01,184935,Staff,0,40,30,30
1683662422206,COGS 101B,A01,184944,Staff,0,2,30,30
1683662423230,COGS 101C,A01,184946,Staff,0,10,30,30
1683662424254,COGS 102A,A01,184951,Johnson; Christine M.,2,0,40,38
1683662425281,COGS 107B,A01,184953,Mooshagian; Eric Frederick,0,51,40,40
1683662426310,COGS 118B,A01,184959,Gupta; Anjum,0,49,40,40
1683662427337,COGS 153,A00,184961,Staff,0,16,30,30
1683662428364,COGS 177,A00,184962,Staff,0,21,30,30
1683662429388,COGS 187A,A01,184969,Boyle; Mary E. T.,0,19,40,40
1683662430413,COMM 10,A01,185174,Staff,0,5,25,25
1683662430413,COMM 10,A02,185189,Staff,0,2,25,25
1683662430413,COMM 10,A03,269821,Staff,0,1,0,0
1683662431440,COMM 100B,A01,185475,Staff,0,1,0,2
1683662431440,COMM 100B,A02,185476,Staff,12,0,25,13
1683662432466,COMM 100C,A01,185314,Staff,1,0,25,24
1683662432466,COMM 100C,A02,185327,Staff,18,0,25,7
1683662433494,COMM 110M,A00,185349,Staff,0,0,40,40
1683662434518,COMM 113T,A00,185352,Staff,25,0,40,15
1683662435543,COMM 114I,A00,185353,Staff,31,0,40,9
1683662436567,COMM 131,A00,185354,Staff,17,0,30,13
1683662437591,CSE 8A,A50,185358,Cao; Yingjun,0,46,10,10
1683662438619,CSE 8B,A01,185362,Staff,0,48,50,50
1683662439647,CSE 11,A01,185416,Cao; Yingjun,0,91,10,10
1683662440675,CSE 20,A01,185445,Briones; Jor-el Thomas Caparas,4,0,25,21
1683662441702,CSE 21,A01,185447,Staff,9,0,50,41
1683662442733,CSE 101,A01,185451,Staff,0,13,50,50
1683662442733,CSE 101,B01,185453,Jones; Miles E,0,14,50,50
1683662444786,CSE 141,A01,185458,Eldon; John,16,0,100,84
1683662445810,CSE 141L,A01,185461,Eldon; John,8,0,100,92
1683662446836,CSE 142,A01,185463,Staff,34,0,60,26
1683662446836,CSE 142,B01,201355,Staff,0,7,60,60
1683662447862,CSE 142L,A01,185470,Staff,34,0,60,26
1683662447862,CSE 142L,B01,201417,Staff,0,6,60,60
1683662448886,CSE 190,A00,201433,Staff,32,0,49,17
1683662449910,DOC 1,A01,259136,Strom; Megan C.,7,0,15,8
1683662449910,DOC 1,A02,259137,Strom; Megan C.,14,0,15,1
1683662449910,DOC 1,A03,259138,Strom; Megan C.,14,0,15,1
1683662449910,DOC 1,A04,259139,Strom; Megan C.,14,0,15,1
1683662450934,DOC 100D,A00,259140,Pass; Natalye Joann,14,0,25,11
1683662451958,DSGN 1,A01,184749,Rill; Bryan,0,26,30,30
1683662452985,DSGN 100,A01,185168,Staff,0,2,25,25
1683662454008,ECE 5,A01,185626,Morris; Karcher William,0,11,0,0
1683662455033,ECE 101,A01,185628,Staff,14,0,70,56
1683662456057,ECE 107,A01,185635,Baghdadchi; Saharnaz,0,0,20,20
1683662456057,ECE 107,A02,185638,Baghdadchi; Saharnaz,2,0,20,18
1683662457080,ECE 148,A01,185647,Silberman; Jack,0,0,16,16
1683662458105,ECON 1,A01,185537,Crane; Meredith Helen,54,0,70,16
1683662459133,ECON 3,A01,185549,Crane; Meredith Helen,29,0,70,41
1683662460160,ECON 4,A01,203354,Anderson; John Charles,0,5,10,10
1683662461188,ECON 100A,A01,185574,Staff,0,5,40,40
1683662462213,ECON 100B,A01,185576,Staff,0,12,50,50
1683662463239,ECON 100C,A01,185589,Newhouse; Herbert S,30,0,70,40
1683662464263,ECON 105,A00,185608,Vespa; Emanuel Ignacio,19,0,35,16
1683662465288,ECON 109,A01,185610,Shishkin; Denis,9,0,35,26
1683662466320,ECON 110A,A01,185612,Staff,9,0,40,31
1683662467343,ECON 120A,A01,185615,Staff,20,0,40,20
1683662468367,ECON 120C,A01,185617,Sun; Yixiao,0,20,70,70
1683662469392,ECON 144,A00,203346,Squires; Dale E,2,0,35,33
1683662470420,ECON 171,A01,203349,Newhouse; Herbert S,0,1,35,35
1683662471447,ECON 173A,A01,185621,Toda; Alexis Akira,20,0,35,15
1683662472478,EDS 25,A01,202413,Staff,0,1,0,0
1683662472478,EDS 25,A02,202414,Staff,0,1,0,0
1683662472478,EDS 25,A03,202415,Staff,0,0,0,0
1683662472478,EDS 25,A04,202416,Staff,0,1,0,0
1683662472478,EDS 25,A05,202439,Staff,0,0,0,0
1683662472478,EDS 25,A06,202440,Staff,0,0,0,0
1683662472478,EDS 25,B01,202631,Staff,0,0,0,0
1683662472478,EDS 25,B02,202632,Staff,0,0,0,0
1683662472478,EDS 25,B03,202639,Staff,0,0,0,0
1683662472478,EDS 25,B04,202640,Staff,0,0,0,0
1683662472478,EDS 25,B05,202643,Staff,0,0,0,0
1683662472478,EDS 25,B06,202644,Staff,0,0,0,0
1683662473505,EDS 38,A01,202659,Black; Alison Michelle,24,0,25,1
1683662474529,EDS 115,A00,202652,Staff,18,0,30,12
1683662475552,EDS 125,A00,202649,Staff,13,0,30,17
1683662476577,EDS 126,A01,203332,Staff,30,0,30,0
1683662477607,EDS 139,A00,202838,Staff,16,0,25,9
1683662478631,EDS 146,A01,202655,Staff,14,0,25,11
1683662479657,ENG 15,A00,185667,Staff,0,1,0,0
1683662479657,ENG 15,B00,185672,Staff,0,0,0,0
1683662479657,ENG 15,C00,185675,Staff,0,0,0,0
1683662479657,ENG 15,D00,185682,Staff,0,0,0,0
1683662479657,ENG 15,E00,185684,Staff,0,0,0,0
1683662480683,ETHN 103,A00,185710,Staff,0,8,35,35
1683662481710,ETHN 103A,A00,199228,Man; Simeon S,0,0,9,9
1683662482735,ETHN 109,A00,185711,Staff,16,0,35,19
1683662483761,ETHN 142,A00,185726,Staff,0,4,30,30
1683662484788,ETHN 163J,A00,199229,Man; Simeon S,5,0,8,3
1683662485812,ETHN 168,A00,185727,Staff,7,0,10,3
1683662486840,ETHN 182,A00,185728,Staff,0,0,35,35
1683662487863,ETHN 183,A00,185737,Staff,9,0,18,9
1683662488887,GLBH 111,A01,209361,Burgos; Jose L.,0,0,0,0
1683662490943,HIEU 104,A00,185792,Staff,14,0,20,6
1683662491966,HIEU 115,A00,185800,Staff,0,0,20,20
1683662492993,HIEU 128,A00,185801,Staff,0,9,20,20
1683662494017,HIEU 147,A00,185802,Staff,15,0,20,5
1683662495044,HIEU 154,A00,185823,Staff,11,0,20,9
1683662496068,HILA 102,A00,185826,Staff,14,0,20,6
1683662497096,HILD 2C,A01,185778,Staff,0,13,20,20
1683662498121,HILD 7B,A01,185780,Kwak; Nancy,0,17,32,32
1683662498121,HILD 7B,A02,185781,Kwak; Nancy,0,18,32,32
1683662499217,HILD 30,A01,185791,Staff,12,0,20,8
1683662500242,HISC 119,A00,185830,Golan; Tal,0,9,20,20
1683662501266,HITO 156GS,A00,185831,Patterson; Patrick H.,0,0,0,23
1683662502292,HIUS 103,A00,185832,Man; Simeon S,0,4,20,20
1683662503318,HIUS 117,A00,185836,Kwak; Nancy,2,0,20,18
1683662504341,HIUS 125,A00,185840,Man; Simeon S,0,2,23,23
1683662505365,HIUS 149,A00,185845,Staff,1,0,20,19
1683662506389,HUM 3,A01,185882,Zavodny; Tatiana Sophia,0,8,50,50
1683662506389,HUM 3,B01,185899,Caldwell; Michael Alan,0,18,50,50
1683662507415,HUM 3GS,A00,185900,Patterson; Patrick H.,0,0,0,23
1683662508441,HUM 4,A01,185938,Zroka; Amy Liane,29,0,50,21
1683662508441,HUM 4,B01,185956,Watkins; Eric,0,4,50,50
1683662508441,HUM 4,B02,202209,Watkins; Eric,0,5,50,50
1683662508441,HUM 4,B03,202210,Watkins; Eric,0,5,50,50
1683662509465,HUM 5,A01,185958,West; Geoffrey Scott,0,0,50,50
1683662509465,HUM 5,A02,202215,West; Geoffrey Scott,0,0,50,50
1683662510493,INTL 190,A00,185959,Gagnon; Jeffrey C,0,0,0,9
1683662510493,INTL 190,B00,185960,Lettieri; Michael Joseph,0,0,0,2
1683662511520,JAPN 180,A00,254509,Staff,5,0,30,25
1683662512542,LATI 10,A01,202853,Kennemore; Amy Michelle,4,0,35,31
1683662512542,LATI 10,A02,202854,Kennemore; Amy Michelle,2,0,35,33
1683662512542,LATI 10,A03,270054,Kennemore; Amy Michelle,30,0,30,0
1683662513573,LATI 180,A00,202855,Kennemore; Amy Michelle,11,0,20,9
1683662514639,LAWS 101,A00,201767,Golan; Tal,0,7,40,40
1683662515664,LIFR 1C,A00,185961,Staff,6,0,20,14
1683662516688,LIFR 1CX,A00,185962,Staff,7,0,20,13
1683662517714,LIFR 1D,A00,185963,Staff,7,0,20,13
1683662518738,LIFR 1DX,A00,185964,Staff,7,0,20,13
1683662519764,LIGN 101,A01,186039,Staff,43,0,50,7
1683662520790,LIGN 165,A00,186040,Staff,15,0,50,35
1683662521817,LTCS 108,A00,186041,Staff,5,0,10,5
1683662522841,LTCS 119,A00,186042,Staff,15,0,20,5
1683662523870,LTCS 130,A00,186043,Wesling; Megan E.,15,0,25,10
1683662525916,LTEA 138,A00,186119,Staff,14,0,40,26
1683662526944,LTEN 124,A00,186148,Staff,5,0,25,20
1683662527968,LTEN 178,A00,186149,Staff,7,0,15,8
1683662528993,LTEN 181,A00,186150,Blanco; John D,34,0,40,6
1683662530021,LTWL 120,A00,186160,Staff,20,0,25,5
1683662531049,LTWL 165,A00,186161,Staff,22,0,25,3
1683662532075,LTWR 100,A00,186162,Staff,0,5,15,15
1683662533101,LTWR 102,A00,186163,Doller; Ben,5,0,15,10
1683662534125,MAE 8,A01,186412,Staff,0,0,0,0
1683662535149,MAE 30B,A00,186445,Bahadori; Mohammad Yousef,82,0,100,18
1683662536173,MAE 40,A00,186592,Bewley; Thomas R,10,0,50,40
1683662537198,MAE 101B,A00,186593,Bahadori; Mohammad Yousef,80,0,100,20
1683662538222,MAE 105,A00,186594,Bandaru; Prabhakar,10,0,50,40
1683662539246,MAE 107,A00,186599,Pham; Hieu Tan,0,7,120,120
1683662540269,MAE 148,A01,186660,Silberman; Jack,3,0,16,13
1683662541294,MATH 10A,A01,188095,Staff,0,6,35,35
1683662542321,MATH 10B,A01,188097,Bowers; Adam R.,0,12,30,30
1683662542321,MATH 10B,A02,188099,Bowers; Adam R.,0,11,30,30
1683662542321,MATH 10B,B01,188104,Bowers; Adam R.,0,10,30,30
1683662542321,MATH 10B,B02,188106,Bowers; Adam R.,1,9,30,29
1683662543346,MATH 10C,A01,188111,Staff,0,18,30,30
1683662543346,MATH 10C,A02,188127,Staff,0,19,30,30
1683662543346,MATH 10C,A03,188131,Staff,0,19,30,30
1683662543346,MATH 10C,B01,188218,Staff,17,0,30,13
1683662543346,MATH 10C,B02,188244,Staff,13,0,30,17
1683662543346,MATH 10C,B03,188277,Staff,14,0,30,16
1683662544370,MATH 18,A01,188344,Bach; Quang Tran,18,0,30,12
1683662544370,MATH 18,A02,188345,Bach; Quang Tran,11,0,30,19
1683662544370,MATH 18,B01,188353,Bach; Quang Tran,11,0,30,19
1683662544370,MATH 18,B02,188354,Bach; Quang Tran,19,0,30,11
1683662545393,MATH 20A,A01,188374,Staff,11,0,35,24
1683662546418,MATH 20B,A01,188382,Ohm; Ko Woon,7,0,30,23
1683662546418,MATH 20B,A02,188383,Ohm; Ko Woon,22,0,30,8
1683662546418,MATH 20B,B01,188385,Ohm; Ko Woon,7,0,30,23
1683662546418,MATH 20B,B02,188392,Ohm; Ko Woon,22,0,30,8
1683662547444,MATH 20C,A01,188394,Harel; Guershon,10,0,30,20
1683662547444,MATH 20C,A02,188395,Harel; Guershon,13,0,30,17
1683662547444,MATH 20C,B01,188404,Harel; Guershon,5,0,30,25
1683662547444,MATH 20C,B02,188405,Harel; Guershon,18,0,30,12
1683662548469,MATH 20D,A01,188414,Hammock; Frances H,0,1,30,30
1683662548469,MATH 20D,A02,188415,Hammock; Frances H,0,1,30,30
1683662548469,MATH 20D,B01,188447,Hammock; Frances H,0,1,30,30
1683662548469,MATH 20D,B02,188486,Hammock; Frances H,3,0,30,27
1683662549493,MATH 20E,A01,188649,Staff,21,0,30,9
1683662549493,MATH 20E,A02,188650,Staff,21,0,30,9
1683662549493,MATH 20E,A03,188673,Staff,0,0,30,30
1683662550519,MATH 102,A01,188675,Staff,0,36,35,35
1683662551543,MATH 103B,A01,188681,Staff,3,0,35,32
1683662551543,MATH 103B,B01,188692,Staff,5,0,35,30
1683662552567,MATH 109,A01,188695,Salehi Golsefidy; Alireza,24,0,35,11
1683662552567,MATH 109,A02,188696,Salehi Golsefidy; Alireza,25,0,35,10
1683662553597,MATH 120A,A01,188698,Eggers; John Dietrich,7,0,35,28
1683662554624,MATH 142B,A01,188736,Ioana; Adrian,1,1,30,29
1683662554624,MATH 142B,A02,188741,Ioana; Adrian,0,1,30,30
1683662554624,MATH 142B,A03,188743,Ioana; Adrian,0,1,30,30
1683662555651,MATH 168A,A01,188790,Staff,0,10,35,35
1683662556675,MATH 170A,A01,188803,Nie; Jiawang,0,2,35,35
1683662556675,MATH 170A,A02,188811,Nie; Jiawang,0,0,35,35
1683662556675,MATH 170A,A03,188814,Nie; Jiawang,0,0,35,35
1683662556675,MATH 170A,A04,188815,Nie; Jiawang,9,0,35,26
1683662557698,MATH 193B,A01,188817,Staff,0,0,35,35
1683662557698,MATH 193B,A02,188818,Staff,5,0,35,30
1683662558720,MGT 4,A01,202857,Anderson; John Charles,61,0,80,19
1683662559744,MGT 12,A00,202858,Lindenberger; Wade Douglas,40,0,90,50
1683662560769,MGT 18,A00,202859,Staff,74,0,90,16
1683662561792,MGT 18GS,A00,202860,McKay; Michael J,13,0,28,15
1683662562816,MGT 45,A00,202861,Pecore; Joseph P.,11,0,90,79
1683662563841,MGT 100,A00,202863,Yavorsky; Daniel Ryan,28,0,90,62
1683662564869,MGT 103,A00,202864,Ehrich; Kristine R,0,18,90,90
1683662565893,MGT 112,A00,202865,Ehrich; Kristine R,14,0,90,76
1683662566919,MGT 121A,A00,202868,Staff,90,20,90,0
1683662567941,MGT 131B,A00,202869,Anderson; John Charles,59,0,90,31
1683662568967,MGT 136,A00,202871,Lindenberger; Wade Douglas,83,0,90,7
1683662569994,MGT 164,A00,202873,Staff,0,67,90,91
1683662571019,MGT 164GS,A00,202874,McKay; Mary A,13,0,28,15
1683662572043,MGT 180,A00,202875,Staff,0,51,90,91
1683662573069,MMW 11R,A01,205019,Herbst; Matthew,1,0,30,29
1683662573069,MMW 11R,A02,205026,Herbst; Matthew,29,0,30,1
1683662574095,MMW 15,A01,193512,Chang; Edmond Yi-Teh,0,8,28,28
1683662574095,MMW 15,A02,193513,Chang; Edmond Yi-Teh,0,5,28,28
1683662574095,MMW 15,A03,193514,Chang; Edmond Yi-Teh,0,5,28,28
1683662574095,MMW 15,A04,193515,Chang; Edmond Yi-Teh,0,5,28,28
1683662574095,MMW 15,A05,193516,Chang; Edmond Yi-Teh,0,5,28,28
1683662574095,MMW 15,A06,193517,Chang; Edmond Yi-Teh,0,6,28,28
1683662574095,MMW 15,B01,193519,Chang; Edmond Yi-Teh,0,5,28,28
1683662574095,MMW 15,B02,193520,Chang; Edmond Yi-Teh,0,5,28,28
1683662574095,MMW 15,B03,193521,Chang; Edmond Yi-Teh,0,5,28,28
1683662574095,MMW 15,B04,193522,Chang; Edmond Yi-Teh,0,5,28,28
1683662574095,MMW 15,B05,193523,Chang; Edmond Yi-Teh,0,5,28,28
1683662574095,MMW 15,B06,193524,Chang; Edmond Yi-Teh,0,5,28,28
1683662575122,MMW 122,A01,193526,Rahimi; Babak,0,16,28,28
1683662575122,MMW 122,A02,193527,Rahimi; Babak,0,15,28,28
1683662575122,MMW 122,A03,193528,Rahimi; Babak,0,0,0,0
1683662575122,MMW 122,A04,193529,Rahimi; Babak,0,0,0,0
1683662576149,MUS 1A,A01,186663,Staff,1,20,35,34
1683662577173,MUS 4,A01,186715,Staff,0,12,35,35
1683662578199,MUS 5R,A01,186796,Dubnov; Shlomo,0,17,35,35
1683662579224,MUS 6,A01,186798,Staff,0,5,25,25
1683662580251,MUS 7,A01,186830,Staff,11,0,35,24
1683662581287,MUS 8,A01,186930,Staff,0,26,35,35
1683662582311,MUS 15,A01,186932,Staff,0,16,35,35
1683662582311,MUS 15,B01,186934,Staff,1,17,35,34
1683662583337,MUS 80,A00,186935,Staff,0,0,20,20
1683662583337,MUS 80,B00,186936,Staff,24,0,25,1
1683662584365,NANO 11,A00,204702,Lipomi; Darren John,0,0,0,0
1683662585396,NANO 15,A01,204709,Yang; Kesong,0,1,0,0
1683662586421,NANO 114,A00,202069,Jahed Motlagh; Zeinab,3,0,10,7
1683662587450,PHIL 1,A00,186955,Grush; Rick Scott,31,0,40,9
1683662588478,PHIL 10,A01,186973,Grush; Rick Scott,27,0,35,8
1683662588478,PHIL 10,A02,186974,Grush; Rick Scott,33,0,35,2
1683662589502,PHIL 13,A01,186976,Staff,3,0,35,32
1683662589502,PHIL 13,A02,186977,Staff,16,0,35,19
1683662590527,PHIL 14,A01,186979,Staff,31,0,35,4
1683662590527,PHIL 14,A02,186986,Staff,32,0,35,3
1683662591551,PHIL 28,A01,186988,Staff,16,0,30,14
1683662591551,PHIL 28,A02,186989,Staff,1,0,30,29
1683662591551,PHIL 28,A03,186990,Staff,10,0,30,20
1683662591551,PHIL 28,A04,186991,Staff,26,0,30,4
1683662592579,PHIL 120,A00,186997,Staff,23,0,40,17
1683662593603,PHIL 137,A00,187003,Staff,7,0,40,33
1683662594627,PHIL 150,A00,187015,Staff,47,0,70,23
1683662595651,PHIL 167,A00,187021,Lamey; Andy M.,34,0,40,6
1683662596676,PHIL 174,A01,202226,Staff,17,0,20,3
1683662596676,PHIL 174,A02,202235,Staff,20,0,20,0
1683662597706,PHIL 191A,A00,258918,Staff,0,0,1,1
1683662598731,PHYS 1A,A00,187028,Staff,26,0,60,34
1683662599757,PHYS 1AL,001,187036,Staff,3,0,30,27
1683662599757,PHYS 1AL,002,187049,Staff,18,0,30,12
1683662600781,PHYS 1B,A00,187058,Staff,22,0,60,38
1683662601807,PHYS 1BL,001,187064,Staff,0,1,30,30
1683662601807,PHYS 1BL,002,187070,Staff,4,0,30,26
1683662602911,PHYS 1C,A00,187082,Staff,29,0,120,91
1683662603936,PHYS 1CL,001,187088,Staff,0,9,30,30
1683662603936,PHYS 1CL,002,187089,Staff,0,1,30,30
1683662603936,PHYS 1CL,009,262693,Staff,9,0,30,21
1683662604964,PHYS 2B,A01,187097,Staff,55,0,115,60
1683662605992,PHYS 2C,A01,187099,Staff,63,0,115,52
1683662607016,PHYS 2CL,A01,187101,Staff,5,0,28,23
1683662607016,PHYS 2CL,A02,187102,Staff,15,0,28,13
1683662608039,PHYS 2D,A01,187123,Shotwell; Brian,95,0,115,20
1683662609063,PHYS 4B,A01,187133,Grinstein; Benjamin,35,0,50,15
1683662610087,POLI 10,A00,188819,Staff,0,4,50,50
1683662611116,POLI 11,A00,188827,Staff,43,0,50,7
1683662612144,POLI 13R,A00,188828,Staff,0,1,20,20
1683662613169,POLI 27,A01,188830,Elgin; Samuel Zincke,0,2,70,70
1683662614197,POLI 30,A00,188832,Desposato; Scott,30,0,50,20
1683662615221,POLI 102F,A00,188834,Staff,0,0,40,40
1683662616248,POLI 104A,A00,188852,Staff,13,0,30,17
1683662617271,POLI 104I,A00,188853,Staff,0,7,20,20
1683662618296,POLI 110B,A00,188854,Wiens; David,6,0,20,14
1683662619324,POLI 112A,A00,188855,Wiens; David,3,0,30,27
1683662620351,POLI 117R,A00,188856,Forman; Fonna,0,12,20,20
1683662621375,POLI 118,A00,188857,Ingham; Sean,8,0,20,12
1683662622398,POLI 120G,A00,188858,Staff,8,0,30,22
1683662623423,POLI 131CR,A00,188863,Hoston; Germaine,21,0,50,29
1683662624448,POLI 133,A00,188864,Nellis; Gareth Hb,44,0,50,6
1683662625472,POLI 134D,A00,188865,Desposato; Scott,27,0,30,3
1683662626497,POLI 142A,A00,188871,Gartzke; Erik,21,0,50,29
1683662627520,POLI 142K,A00,188874,Staff,38,0,50,12
1683662628544,POLI 143,A00,188940,Gartzke; Erik,16,0,30,14
1683662629568,POLI 153,A00,188943,Staff,2,0,20,18
1683662630596,POLI 160AA,A00,188944,Staff,11,0,40,29
1683662631620,POLI 170A,A00,188945,Staff,11,0,30,19
1683662633667,PSYC 1,A00,188952,Staff,36,0,90,54
1683662634692,PSYC 2,B00,188953,Staff,19,0,35,16
1683662635715,PSYC 6,A00,188970,Staff,47,0,60,13
1683662636739,PSYC 7,A00,188973,Staff,35,0,45,10
1683662637767,PSYC 60,A01,188980,Rickard; Timothy C.,42,0,60,18
1683662638791,PSYC 70,A01,189001,Steiner; Eric Tomas,22,0,45,23
1683662639815,PSYC 100,A00,189005,Lacefield; Katharine I,0,99,120,120
1683662640841,PSYC 102,A00,189008,Staff,8,0,30,22
1683662641864,PSYC 106,B00,189026,Gorman; Michael R.,27,0,60,33
1683662642888,PSYC 114,B01,189033,Winkielman; Piotr,0,31,30,30
1683662643917,PSYC 131,A00,189036,Anagnostaras; Stephan,0,43,60,60
1683662644941,PSYC 136,A00,189041,Lowe; Angela Beth,0,7,25,25
1683662645965,PSYC 137,A00,189057,Winkielman; Piotr,0,37,25,25
1683662646993,PSYC 144,A00,189107,Wixted; John T,0,11,50,50
1683662649044,PSYC 162,A00,189142,Staff,0,9,85,85
1683662650069,PSYC 172,A00,189144,Gorman; Michael R.,0,6,30,30
1683662652120,PSYC 179,A00,189146,Lacefield; Katharine I,0,87,120,120
1683662653146,PSYC 181,A00,189147,Anagnostaras; Stephan,0,44,90,90
1683662654174,PSYC 190R,A00,189148,Barner; David A.,0,23,80,80
1683662655201,PSYC 191,A00,189275,Rickard; Timothy C.,0,10,25,25
1683662656229,PSYC 193,A00,189276,Chapman; Eddie Nathaniel,0,1,0,4
1683662657254,PSYC 193L,A01,189281,Lowe; Angela Beth,10,0,20,10
1683662657254,PSYC 193L,B01,189285,Staff,28,0,35,7
1683662658278,RELI 149,A00,187137,Rahimi; Babak,7,0,40,33
1683662659302,SE 9,A01,187315,Staff,0,2,18,18
1683662660329,SE 101B,A00,187409,Staff,24,0,30,6
1683662661353,SE 110B,A00,187444,Staff,10,0,40,30
1683662662380,SE 130B,A00,187449,Staff,31,0,40,9
1683662663404,SE 150A,A00,187516,Staff,9,0,20,11
1683662664428,SE 154,A00,187528,Staff,29,0,50,21
1683662665453,SIO 3,A01,258171,Staff,35,0,40,5
1683662666477,SIO 10,A00,187144,Cook; Geoffrey W,0,7,75,75
1683662667503,SIO 45,A00,187152,Cook; Geoffrey W,0,5,100,100
1683662668527,SIO 109R,A00,194486,Staff,0,4,20,20
1683662670582,SIO 187,A01,187233,Kacev; David,12,0,40,28
1683662671611,SOCI 1,A01,258656,Thorpe; Charles Robert,28,0,30,2
1683662671611,SOCI 1,A02,258658,Thorpe; Charles Robert,30,0,30,0
1683662671611,SOCI 1,A03,258661,Thorpe; Charles Robert,25,0,25,0
1683662671611,SOCI 1,A04,258666,Thorpe; Charles Robert,22,0,25,3
1683662671611,SOCI 1,A05,258897,Thorpe; Charles Robert,22,0,25,3
1683662671611,SOCI 1,A06,258898,Thorpe; Charles Robert,25,0,25,0
1683662672638,SOCI 30,A01,258903,Pardo Guerra; Juan Pablo,14,0,30,16
1683662673665,SOCI 102,A00,258904,Staff,9,0,25,16
1683662674693,SOCI 106,A00,258905,Staff,19,0,25,6
1683662675721,SOCI 111,A00,258907,Ribas Norris; Janet Vanesa,26,0,30,4
1683662676748,SOCI 121R,A00,258908,Pardo Guerra; Juan Pablo,8,0,30,22
1683662677775,SOCI 126,A01,203330,Staff,14,0,20,6
1683662678799,SOCI 131,A00,258909,Thorpe; Charles Robert,30,0,60,30
1683662679825,SOCI 135,A00,258910,Payne; Christine Anna,0,11,30,30
1683662680849,SOCI 157,A00,258911,Staff,12,0,30,18
1683662681875,SOCI 184,A00,258912,Staff,25,0,30,5
1683662682899,SOCI 188D,A00,258913,Staff,22,0,30,8
1683662683926,SYN 2,001,187529,Staff,9,0,16,7
1683662683926,SYN 2,002,201452,Staff,0,20,16,16
1683662683926,SYN 2,003,201469,Staff,1,0,16,15
1683662684951,SYN 100,A01,187531,Staff,0,9,20,20
1683662684951,SYN 100,B01,201491,Staff,0,10,20,20
1683662685976,TDAC 1,A00,189286,Walsh; Kim C.,3,0,20,17
1683662685976,TDAC 1,B00,189287,Harting; Carla Kelso,10,0,20,10
1683662687000,TDAC 101,A00,189300,Walsh; Kim C.,16,0,20,4
1683662687000,TDAC 101,B00,189301,Harting; Carla Kelso,18,0,20,2
1683662688024,TDAC 102,A00,189304,Basso; Beatrice,14,0,20,6
1683662689052,TDAC 108,A00,189305,Staff,18,0,20,2
1683662690077,TDDE 131,A00,189310,Staff,19,0,20,1
1683662690077,TDDE 131,B00,189314,Staff,19,0,20,1
1683662690077,TDDE 131,C00,189315,Staff,48,0,50,2
1683662690077,TDDE 131,D00,189316,Staff,14,0,15,1
1683662690077,TDDE 131,E00,204841,Staff,20,0,20,0
1683662691105,TDGE 10,A00,189289,Staff,27,0,50,23
1683662691105,TDGE 10,B00,189290,Havis; Allan,0,1,50,50
1683662692129,TDGE 11,A00,189291,Fulton; Julia,0,4,50,50
1683662692129,TDGE 11,B00,189292,Staff,20,0,25,5
1683662692129,TDGE 11,C00,260270,Staff,0,0,0,0
1683662693153,TDGE 25,A00,189294,Staff,2,0,20,18
1683662694179,TDGE 124,A00,189318,Fulton; Julia,0,8,50,50
1683662695202,TDGE 125,A00,189319,Staff,13,0,25,12
1683662695202,TDGE 125,B00,189320,Staff,23,0,25,2
1683662696225,TDGE 127,A00,189322,Havis; Allan,1,0,50,49
1683662697249,TDHT 101,A00,189323,Staff,18,0,25,7
1683662697249,TDHT 101,B00,189324,Staff,25,0,25,0
1683662698271,TDHT 102,A00,189325,Staff,49,0,50,1
1683662699296,TDMV 1,A00,189295,Arcidiacono; Kristin,20,0,30,10
1683662699296,TDMV 1,B00,189296,Caligagan; Maria T.,24,0,30,6
1683662700320,TDMV 2,A00,189297,Sammartano; Tonnie,27,0,30,3
1683662700320,TDMV 2,B00,189299,Arcidiacono; Kristin,23,0,30,7
1683662701347,TDMV 3,A00,204998,Rincon; Alicia,22,0,30,8
1683662702374,TDMV 120,A00,189458,Sammartano; Tonnie,28,0,30,2
1683662703401,TDMV 138,A00,189541,Jun; Grace Shin Hae,20,0,40,20
1683662704429,TDMV 142,A00,189717,Caligagan; Tony,25,0,30,5
1683662704429,TDMV 142,B00,189718,Caligagan; Maria T.,25,0,30,5
1683662705456,TMC 2,A01,187533,Staff,25,0,25,0
1683662705456,TMC 2,A02,187534,Staff,25,0,25,0
1683662706536,USP 1,A01,187536,Kwak; Nancy,0,16,25,25
1683662707564,USP 5,A01,187538,Staff,9,0,25,16
1683662708586,USP 101,A00,199253,Staff,0,4,0,0
1683662709615,USP 124,A00,187562,Boomhower; Matthew Charles,0,0,30,30
1683662710638,USP 138,A00,187582,Staff,20,0,25,5
1683662711665,USP 152,A01,187597,Staff,3,0,25,22
1683662712692,USP 153,A00,187598,Staff,19,0,25,6
1683662713718,USP 168,A00,187607,Kwak; Nancy,2,0,5,3
1683662714746,USP 173,A00,187619,Staff,4,0,25,21
1683662715770,USP 181,A00,187638,Staff,0,4,25,25
1683662716799,VIS 103,A00,187650,Cruz; Edwin Teddy,17,0,75,58
1683662717832,VIS 110D,A00,187669,Staff,13,0,22,9
1683662718857,VIS 127C,A00,187720,Shen; Kuiyi,68,0,146,78
1683662719879,VIS 149,A00,187731,Yoldas; Pinar,1,14,22,21
1683662720906,VIS 151,A01,188091,Staff,22,0,34,12
1683662720906,VIS 151,A02,188092,Staff,11,0,34,23
1683662721930,VIS 160B,A00,188093,Stalbaum; Brett,0,1,10,10
1683662723979,WCWP 10B,A00,201720,Staff,10,0,15,5
1683662723979,WCWP 10B,B00,201722,Staff,9,0,15,6
1683662725002,WCWP 100,A00,201725,Gagnon; Jeffrey C,0,0,2,2
1683662725002,WCWP 100,B00,201727,Staff,0,4,15,15
1683662728090,ANBI 133,A00,258401,Wilder; Linnea Lorene,34,0,40,6
1683662729112,ANBI 140,A00,258395,Hrvoj Mihic; Branka,18,0,25,7
1683662730140,ANSC 120,A00,258402,Bialecki; Jon Anthony,26,0,40,14
1683662731162,ANSC 144,A00,258400,Staff,12,0,40,28
1683662733212,ANSC 166,A00,258396,Parish; Steven Martin,156,0,175,19
1683662734237,ANSC 180,A00,193533,Staff,8,0,20,12
1683662735261,ANSC 188,A00,258397,Jassal; Aftab,34,0,40,6
1683662736289,ANTH 3,A01,258316,Staff,23,0,30,7
1683662737316,ANTH 5,A00,258394,Semendeferi; Ekaterini,16,0,20,4
1683662738341,ANTH 21,A01,258331,Staff,4,0,40,36
1683662739365,ANTH 103,A00,258398,Varma; Saiba,15,0,25,10
1683662740393,AWP 10,001,202034,Staff,0,0,0,0
1683662740393,AWP 10,002,202035,Staff,0,0,0,0
1683662740393,AWP 10,003,202036,Staff,0,0,0,0
1683662740393,AWP 10,004,202037,Staff,0,0,0,0
1683662740393,AWP 10,005,202038,Staff,0,0,0,0
1683662740393,AWP 10,006,202039,Staff,0,0,0,0
1683662740393,AWP 10,007,202040,Staff,0,0,0,0
1683662740393,AWP 10,008,202041,Staff,0,0,0,0
1683662740393,AWP 10,009,202042,Staff,0,0,0,0
1683662740393,AWP 10,010,202043,Staff,0,0,0,0
1683662740393,AWP 10,011,202044,Staff,0,0,0,0
1683662740393,AWP 10,012,202045,Staff,0,0,0,0
1683662740393,AWP 10,013,202046,Staff,0,0,0,0
1683662740393,AWP 10,014,202047,Staff,0,0,0,0
1683662740393,AWP 10,015,202048,Staff,0,0,0,0
1683662740393,AWP 10,016,202049,Staff,0,0,0,0
1683662740393,AWP 10,017,202050,Staff,0,0,0,0
1683662740393,AWP 10,018,202051,Staff,0,0,0,0
1683662740393,AWP 10,019,202052,Staff,0,0,0,0
1683662740393,AWP 10,020,202053,Staff,0,0,0,0
1683662740393,AWP 10,021,202054,Staff,0,0,0,0
1683662740393,AWP 10,022,202055,Staff,0,0,0,0
1683662740393,AWP 10,023,202056,Staff,0,0,0,0
1683662740393,AWP 10,024,202057,Staff,0,0,0,0
1683662740393,AWP 10,025,202058,Staff,0,0,0,0
1683662740393,AWP 10,026,202059,Staff,0,0,0,0
1683662741417,AWP 102,001,202032,Staff,0,0,0,0
1683662741417,AWP 102,002,202033,Staff,0,0,0,0
1683662742440,BENG 100,A01,254234,Taylor Amos; Alyssa C,31,0,40,9
1683662743464,BENG 196,001,270013,Engler; Adam J.,9999,0,9999,0
1683662744494,BICD 100R,A01,202018,Smith; Laurie,0,7,32,32
1683662744494,BICD 100R,A02,202019,Smith; Laurie,0,3,32,32
1683662744494,BICD 100R,A03,202020,Smith; Laurie,0,1,32,32
1683662744494,BICD 100R,A04,202021,Smith; Laurie,6,0,32,26
1683662744494,BICD 100R,A05,202022,Smith; Laurie,11,0,32,21
1683662745518,BICD 136,A01,193242,Gustafson-Brown; Cindy,0,2,32,32
1683662745518,BICD 136,A02,193244,Gustafson-Brown; Cindy,13,0,32,19
1683662746543,BIEB 102,A01,193249,Butler; Shannon Rhey,1,2,32,31
1683662746543,BIEB 102,A02,193251,Butler; Shannon Rhey,0,0,32,32
1683662746543,BIEB 102,A03,193253,Butler; Shannon Rhey,0,0,32,32
1683662746543,BIEB 102,A04,193255,Butler; Shannon Rhey,14,0,32,18
1683662746543,BIEB 102,A05,193265,Butler; Shannon Rhey,25,0,32,7
1683662746543,BIEB 102,A06,193269,Butler; Shannon Rhey,14,0,32,18
1683662748590,BIEB 150,A01,193274,Staff,0,0,32,32
1683662748590,BIEB 150,A02,193285,Staff,24,0,32,8
1683662749613,BIEB 194,A00,193286,Kurle; Carolyn M.,20,0,32,12
1683662750640,BILD 1,A01,192291,Staff,15,0,32,17
1683662750640,BILD 1,A02,192292,Staff,30,0,32,2
1683662750640,BILD 1,B01,192520,Reuther; Keefe,0,1,0,0
1683662750640,BILD 1,B02,192532,Reuther; Keefe,0,1,0,0
1683662751665,BILD 3,A01,192556,Butler; Shannon Rhey,0,0,32,32
1683662751665,BILD 3,A02,192581,Butler; Shannon Rhey,0,0,32,32
1683662751665,BILD 3,A03,192611,Butler; Shannon Rhey,21,0,32,11
1683662751665,BILD 3,A04,192612,Butler; Shannon Rhey,24,0,32,8
1683662751665,BILD 3,A05,192613,Butler; Shannon Rhey,26,0,32,6
1683662751665,BILD 3,A06,192679,Butler; Shannon Rhey,27,0,32,5
1683662751665,BILD 3,A07,192682,Butler; Shannon Rhey,20,0,32,12
1683662752694,BILD 4,A01,192836,Reuther; Keefe,1,0,24,23
1683662752694,BILD 4,A02,193044,Reuther; Keefe,4,0,24,20
1683662753719,BILD 10,A01,193142,Gustafson-Brown; Cindy,29,0,32,3
1683662753719,BILD 10,A02,193149,Gustafson-Brown; Cindy,31,0,32,1
1683662754744,BIMM 100,A01,193301,Staff,0,6,32,32
1683662754744,BIMM 100,A02,193312,Staff,0,7,32,32
1683662754744,BIMM 100,A03,193323,Staff,0,9,32,32
1683662755774,BIMM 101,A01,193329,McDonnell; Lisa Marie,0,4,24,24
1683662755774,BIMM 101,A02,193339,McDonnell; Lisa Marie,1,4,24,23
1683662755774,BIMM 101,B01,193354,McDonnell; Lisa Marie,0,4,24,24
1683662755774,BIMM 101,B02,193357,McDonnell; Lisa Marie,0,3,24,24
1683662756798,BIMM 110,A01,193377,Tat; John,0,11,32,32
1683662756798,BIMM 110,A02,193378,Tat; John,0,10,32,32
1683662757823,BIMM 120,A01,206116,Staff,0,0,32,32
1683662757823,BIMM 120,A02,206117,Staff,6,0,32,26
1683662757823,BIMM 120,A03,206121,Staff,21,0,32,11
1683662758850,BIPN 100,A01,193393,Park; Ji Young,0,15,32,32
1683662758850,BIPN 100,A02,193402,Park; Ji Young,0,14,32,32
1683662758850,BIPN 100,A03,193413,Park; Ji Young,0,14,32,32
1683662758850,BIPN 100,A04,193414,Park; Ji Young,0,13,32,32
1683662759881,BIPN 102,A01,193429,Staff,0,0,32,32
1683662759881,BIPN 102,A02,193438,Staff,18,0,32,14
1683662760908,BIPN 106,A01,193450,Reyes Gonzalez; Catalina,0,2,40,40
1683662761955,BIPN 134,A01,193465,Cooke; James Edward,0,0,32,32
1683662761955,BIPN 134,A02,193474,Cooke; James Edward,25,0,32,7
1683662761955,BIPN 134,A03,193485,Cooke; James Edward,29,0,32,3
1683662761955,BIPN 134,A04,193486,Cooke; James Edward,20,0,32,12
1683662761955,BIPN 134,A05,193491,Cooke; James Edward,31,0,32,1
1683662761955,BIPN 134,A06,193501,Cooke; James Edward,30,0,32,2
1683662761955,BIPN 134,A07,193510,Cooke; James Edward,29,0,32,3
1683662764008,BISP 194,A00,222522,Staff,14,0,32,18
1683662765036,CAT 124,A01,202407,Staff,19,0,25,6
1683662766063,CAT 125,A00,202408,Marchisotto; Jennifer Anne,2,0,20,18
1683662767089,CAT 125R,A00,202409,Smith; Lauryn Alissa,0,11,20,20
1683662767089,CAT 125R,B00,202410,Morales; Celeste Georgianna,0,11,20,20
1683662767089,CAT 125R,C00,202411,Irwin; Matthew Joseph,0,12,20,20
1683662768113,CENG 15,A01,204712,Yang; Kesong,0,1,0,0
1683662769140,CENG 114,A00,202070,Jahed Motlagh; Zeinab,5,0,20,15
1683662770166,CGS 105,A00,185477,Wesling; Megan E.,24,0,40,16
1683662771197,CGS 106,A00,185494,Staff,11,0,22,11
1683662772220,CGS 108,A00,185495,Staff,14,0,20,6
1683662773244,CGS 114,A00,185496,Staff,13,0,18,5
1683662774270,CGS 119,A00,185501,Staff,15,0,20,5
1683662775295,CGS 120,A00,185511,Staff,12,0,20,8
1683662776324,CHEM 4,A01,184675,Bussey; Thomas J,97,0,100,3
1683662777350,CHEM 6A,A01,184677,Staff,32,0,60,28
1683662778379,CHEM 6B,A01,184679,Staff,63,0,100,37
1683662779407,CHEM 6C,A01,184681,Bussey; Thomas J,0,0,50,50
1683662779407,CHEM 6C,A02,184682,Bussey; Thomas J,32,0,50,18
1683662780434,CHEM 40A,A01,184684,Albizati; Kim F.,34,0,100,66
1683662781457,CHEM 40B,A01,184686,Albizati; Kim F.,0,22,100,100
1683662782481,CHEM 41B,A01,184690,Staff,51,0,100,49
1683662783506,COGS 3,A01,184715,Boyle; Mary E. T.,0,27,40,40
1683662784535,COGS 14B,A01,185172,Staff,0,14,38,38
1683662785562,COGS 18,A01,184736,Staff,14,0,80,66
1683662786589,COGS 100,A01,184932,Staff,0,7,73,73
1683662787613,COGS 101A,A01,184935,Staff,0,40,30,30
1683662788641,COGS 101B,A01,184944,Staff,0,2,30,30
1683662789665,COGS 101C,A01,184946,Staff,0,10,30,30
1683662790693,COGS 102A,A01,184951,Johnson; Christine M.,2,0,40,38
1683662791721,COGS 107B,A01,184953,Mooshagian; Eric Frederick,0,51,40,40
1683662792746,COGS 118B,A01,184959,Gupta; Anjum,0,49,40,40
1683662793770,COGS 153,A00,184961,Staff,0,16,30,30
1683662794794,COGS 177,A00,184962,Staff,0,21,30,30
1683662795823,COGS 187A,A01,184969,Boyle; Mary E. T.,0,19,40,40
1683662796848,COMM 10,A01,185174,Staff,0,5,25,25
1683662796848,COMM 10,A02,185189,Staff,0,2,25,25
1683662796848,COMM 10,A03,269821,Staff,0,1,0,0
1683662797879,COMM 100B,A01,185475,Staff,0,1,0,2
1683662797879,COMM 100B,A02,185476,Staff,12,0,25,13
1683662798904,COMM 100C,A01,185314,Staff,1,0,25,24
1683662798904,COMM 100C,A02,185327,Staff,18,0,25,7
1683662799930,COMM 110M,A00,185349,Staff,0,0,40,40
1683662800955,COMM 113T,A00,185352,Staff,25,0,40,15
1683662801979,COMM 114I,A00,185353,Staff,31,0,40,9
1683662803005,COMM 131,A00,185354,Staff,17,0,30,13
1683662804033,CSE 8A,A50,185358,Cao; Yingjun,0,46,10,10
1683662805057,CSE 8B,A01,185362,Staff,0,48,50,50
1683662806080,CSE 11,A01,185416,Cao; Yingjun,0,91,10,10
1683662807106,CSE 20,A01,185445,Briones; Jor-el Thomas Caparas,4,0,25,21
1683662808132,CSE 21,A01,185447,Staff,9,0,50,41
1683662809155,CSE 101,A01,185451,Staff,0,13,50,50
1683662809155,CSE 101,B01,185453,Jones; Miles E,0,14,50,50
1683662811264,CSE 141,A01,185458,Eldon; John,16,0,100,84
1683662812289,CSE 141L,A01,185461,Eldon; John,8,0,100,92
1683662813312,CSE 142,A01,185463,Staff,34,0,60,26
1683662813312,CSE 142,B01,201355,Staff,0,7,60,60
1683662814340,CSE 142L,A01,185470,Staff,34,0,60,26
1683662814340,CSE 142L,B01,201417,Staff,0,6,60,60
1683662815364,CSE 190,A00,201433,Staff,32,0,49,17
1683662816390,DOC 1,A01,259136,Strom; Megan C.,7,0,15,8
1683662816390,DOC 1,A02,259137,Strom; Megan C.,14,0,15,1
1683662816390,DOC 1,A03,259138,Strom; Megan C.,14,0,15,1
1683662816390,DOC 1,A04,259139,Strom; Megan C.,14,0,15,1
1683662817432,DOC 100D,A00,259140,Pass; Natalye Joann,14,0,25,11
1683662818459,DSGN 1,A01,184749,Rill; Bryan,0,26,30,30
1683662819487,DSGN 100,A01,185168,Staff,0,2,25,25
1683662820515,ECE 5,A01,185626,Morris; Karcher William,0,11,0,0
1683662821543,ECE 101,A01,185628,Staff,14,0,70,56
1683662822567,ECE 107,A01,185635,Baghdadchi; Saharnaz,0,0,20,20
1683662822567,ECE 107,A02,185638,Baghdadchi; Saharnaz,2,0,20,18
1683662823594,ECE 148,A01,185647,Silberman; Jack,0,0,16,16
1683662824619,ECON 1,A01,185537,Crane; Meredith Helen,54,0,70,16
1683662825645,ECON 3,A01,185549,Crane; Meredith Helen,29,0,70,41
1683662826673,ECON 4,A01,203354,Anderson; John Charles,0,5,10,10
1683662827697,ECON 100A,A01,185574,Staff,0,5,40,40
1683662828721,ECON 100B,A01,185576,Staff,0,12,50,50
1683662829748,ECON 100C,A01,185589,Newhouse; Herbert S,30,0,70,40
1683662830772,ECON 105,A00,185608,Vespa; Emanuel Ignacio,19,0,35,16
1683662831799,ECON 109,A01,185610,Shishkin; Denis,9,0,35,26
1683662832830,ECON 110A,A01,185612,Staff,9,0,40,31
1683662833855,ECON 120A,A01,185615,Staff,20,0,40,20
1683662834881,ECON 120C,A01,185617,Sun; Yixiao,0,20,70,70
1683662835905,ECON 144,A00,203346,Squires; Dale E,2,0,35,33
1683662836929,ECON 171,A01,203349,Newhouse; Herbert S,0,1,35,35
1683662837953,ECON 173A,A01,185621,Toda; Alexis Akira,20,0,35,15
1683662838978,EDS 25,A01,202413,Staff,0,1,0,0
1683662838978,EDS 25,A02,202414,Staff,0,1,0,0
1683662838978,EDS 25,A03,202415,Staff,0,0,0,0
1683662838978,EDS 25,A04,202416,Staff,0,1,0,0
1683662838978,EDS 25,A05,202439,Staff,0,0,0,0
1683662838978,EDS 25,A06,202440,Staff,0,0,0,0
1683662838978,EDS 25,B01,202631,Staff,0,0,0,0
1683662838978,EDS 25,B02,202632,Staff,0,0,0,0
1683662838978,EDS 25,B03,202639,Staff,0,0,0,0
1683662838978,EDS 25,B04,202640,Staff,0,0,0,0
1683662838978,EDS 25,B05,202643,Staff,0,0,0,0
1683662838978,EDS 25,B06,202644,Staff,0,0,0,0
1683662840009,EDS 38,A01,202659,Black; Alison Michelle,24,0,25,1
1683662841036,EDS 115,A00,202652,Staff,18,0,30,12
1683662842063,EDS 125,A00,202649,Staff,13,0,30,17
1683662843087,EDS 126,A01,203332,Staff,30,0,30,0
1683662844110,EDS 139,A00,202838,Staff,16,0,25,9
1683662845133,EDS 146,A01,202655,Staff,14,0,25,11
1683662846158,ENG 15,A00,185667,Staff,0,1,0,0
1683662846158,ENG 15,B00,185672,Staff,0,0,0,0
1683662846158,ENG 15,C00,185675,Staff,0,0,0,0
1683662846158,ENG 15,D00,185682,Staff,0,0,0,0
1683662846158,ENG 15,E00,185684,Staff,0,0,0,0
1683662847184,ETHN 103,A00,185710,Staff,0,8,35,35
1683662848212,ETHN 103A,A00,199228,Man; Simeon S,0,0,9,9
1683662849239,ETHN 109,A00,185711,Staff,16,0,35,19
1683662850266,ETHN 142,A00,185726,Staff,0,4,30,30
1683662851293,ETHN 163J,A00,199229,Man; Simeon S,5,0,8,3
1683662852316,ETHN 168,A00,185727,Staff,7,0,10,3
1683662853340,ETHN 182,A00,185728,Staff,0,0,35,35
1683662854363,ETHN 183,A00,185737,Staff,9,0,18,9
1683662855390,GLBH 111,A01,209361,Burgos; Jose L.,0,0,0,0
1683662857441,HIEU 104,A00,185792,Staff,14,0,20,6
1683662858464,HIEU 115,A00,185800,Staff,0,0,20,20
1683662859491,HIEU 128,A00,185801,Staff,0,9,20,20
1683662860515,HIEU 147,A00,185802,Staff,15,0,20,5
1683662861542,HIEU 154,A00,185823,Staff,11,0,20,9
1683662862570,HILA 102,A00,185826,Staff,14,0,20,6
1683662863594,HILD 2C,A01,185778,Staff,0,13,20,20
1683662864618,HILD 7B,A01,185780,Kwak; Nancy,0,17,32,32
1683662864618,HILD 7B,A02,185781,Kwak; Nancy,0,18,32,32
1683662865642,HILD 30,A01,185791,Staff,12,0,20,8
1683662866666,HISC 119,A00,185830,Golan; Tal,0,9,20,20
1683662867689,HITO 156GS,A00,185831,Patterson; Patrick H.,0,0,0,23
1683662868717,HIUS 103,A00,185832,Man; Simeon S,0,4,20,20
1683662869741,HIUS 117,A00,185836,Kwak; Nancy,2,0,20,18
1683662870768,HIUS 125,A00,185840,Man; Simeon S,0,2,23,23
1683662871795,HIUS 149,A00,185845,Staff,1,0,20,19
1683662872824,HUM 3,A01,185882,Zavodny; Tatiana Sophia,0,8,50,50
1683662872824,HUM 3,B01,185899,Caldwell; Michael Alan,0,18,50,50
1683662873853,HUM 3GS,A00,185900,Patterson; Patrick H.,0,0,0,23
1683662874878,HUM 4,A01,185938,Zroka; Amy Liane,29,0,50,21
1683662874878,HUM 4,B01,185956,Watkins; Eric,0,4,50,50
1683662874878,HUM 4,B02,202209,Watkins; Eric,0,5,50,50
1683662874878,HUM 4,B03,202210,Watkins; Eric,0,5,50,50
1683662875901,HUM 5,A01,185958,West; Geoffrey Scott,0,0,50,50
1683662875901,HUM 5,A02,202215,West; Geoffrey Scott,0,0,50,50
1683662876924,INTL 190,A00,185959,Gagnon; Jeffrey C,0,0,0,9
1683662876924,INTL 190,B00,185960,Lettieri; Michael Joseph,0,0,0,2
1683662877951,JAPN 180,A00,254509,Staff,5,0,30,25
1683662878975,LATI 10,A01,202853,Kennemore; Amy Michelle,4,0,35,31
1683662878975,LATI 10,A02,202854,Kennemore; Amy Michelle,2,0,35,33
1683662878975,LATI 10,A03,270054,Kennemore; Amy Michelle,30,0,30,0
1683662879999,LATI 180,A00,202855,Kennemore; Amy Michelle,11,0,20,9
1683662881026,LAWS 101,A00,201767,Golan; Tal,0,7,40,40
1683662882051,LIFR 1C,A00,185961,Staff,6,0,20,14
1683662883079,LIFR 1CX,A00,185962,Staff,7,0,20,13
1683662884103,LIFR 1D,A00,185963,Staff,7,0,20,13
1683662885127,LIFR 1DX,A00,185964,Staff,7,0,20,13
1683662886153,LIGN 101,A01,186039,Staff,43,0,50,7
1683662887176,LIGN 165,A00,186040,Staff,15,0,50,35
1683662888200,LTCS 108,A00,186041,Staff,5,0,10,5
1683662889224,LTCS 119,A00,186042,Staff,15,0,20,5
1683662890247,LTCS 130,A00,186043,Wesling; Megan E.,15,0,25,10
1683662892293,LTEA 138,A00,186119,Staff,14,0,40,26
1683662893318,LTEN 124,A00,186148,Staff,5,0,25,20
1683662894342,LTEN 178,A00,186149,Staff,7,0,15,8
1683662895366,LTEN 181,A00,186150,Blanco; John D,34,0,40,6
1683662896390,LTWL 120,A00,186160,Staff,20,0,25,5
1683662897415,LTWL 165,A00,186161,Staff,22,0,25,3
1683662898439,LTWR 100,A00,186162,Staff,0,5,15,15
1683662899467,LTWR 102,A00,186163,Doller; Ben,5,0,15,10
1683662900491,MAE 8,A01,186412,Staff,0,0,0,0
1683662901517,MAE 30B,A00,186445,Bahadori; Mohammad Yousef,82,0,100,18
1683662902540,MAE 40,A00,186592,Bewley; Thomas R,10,0,50,40
1683662903563,MAE 101B,A00,186593,Bahadori; Mohammad Yousef,80,0,100,20
1683662904587,MAE 105,A00,186594,Bandaru; Prabhakar,10,0,50,40
1683662905615,MAE 107,A00,186599,Pham; Hieu Tan,0,7,120,120
1683662906642,MAE 148,A01,186660,Silberman; Jack,3,0,16,13
1683662907669,MATH 10A,A01,188095,Staff,0,6,35,35
1683662908694,MATH 10B,A01,188097,Bowers; Adam R.,0,12,30,30
1683662908694,MATH 10B,A02,188099,Bowers; Adam R.,0,11,30,30
1683662908694,MATH 10B,B01,188104,Bowers; Adam R.,0,10,30,30
1683662908694,MATH 10B,B02,188106,Bowers; Adam R.,1,9,30,29
1683662909720,MATH 10C,A01,188111,Staff,0,18,30,30
1683662909720,MATH 10C,A02,188127,Staff,0,19,30,30
1683662909720,MATH 10C,A03,188131,Staff,0,19,30,30
1683662909720,MATH 10C,B01,188218,Staff,17,0,30,13
1683662909720,MATH 10C,B02,188244,Staff,13,0,30,17
1683662909720,MATH 10C,B03,188277,Staff,14,0,30,16
1683662910745,MATH 18,A01,188344,Bach; Quang Tran,18,0,30,12
1683662910745,MATH 18,A02,188345,Bach; Quang Tran,11,0,30,19
1683662910745,MATH 18,B01,188353,Bach; Quang Tran,11,0,30,19
1683662910745,MATH 18,B02,188354,Bach; Quang Tran,19,0,30,11
1683662911769,MATH 20A,A01,188374,Staff,11,0,35,24
1683662912799,MATH 20B,A01,188382,Ohm; Ko Woon,7,0,30,23
1683662912799,MATH 20B,A02,188383,Ohm; Ko Woon,22,0,30,8
1683662912799,MATH 20B,B01,188385,Ohm; Ko Woon,7,0,30,23
1683662912799,MATH 20B,B02,188392,Ohm; Ko Woon,22,0,30,8
1683662913882,MATH 20C,A01,188394,Harel; Guershon,10,0,30,20
1683662913882,MATH 20C,A02,188395,Harel; Guershon,13,0,30,17
1683662913882,MATH 20C,B01,188404,Harel; Guershon,5,0,30,25
1683662913882,MATH 20C,B02,188405,Harel; Guershon,18,0,30,12
1683662914914,MATH 20D,A01,188414,Hammock; Frances H,0,1,30,30
1683662914914,MATH 20D,A02,188415,Hammock; Frances H,0,1,30,30
1683662914914,MATH 20D,B01,188447,Hammock; Frances H,0,1,30,30
1683662914914,MATH 20D,B02,188486,Hammock; Frances H,3,0,30,27
1683662915942,MATH 20E,A01,188649,Staff,21,0,30,9
1683662915942,MATH 20E,A02,188650,Staff,21,0,30,9
1683662915942,MATH 20E,A03,188673,Staff,0,0,30,30
1683662916966,MATH 102,A01,188675,Staff,0,36,35,35
1683662917996,MATH 103B,A01,188681,Staff,3,0,35,32
1683662917996,MATH 103B,B01,188692,Staff,5,0,35,30
1683662919023,MATH 109,A01,188695,Salehi Golsefidy; Alireza,24,0,35,11
1683662919023,MATH 109,A02,188696,Salehi Golsefidy; Alireza,25,0,35,10
1683662920057,MATH 120A,A01,188698,Eggers; John Dietrich,7,0,35,28
1683662921082,MATH 142B,A01,188736,Ioana; Adrian,1,1,30,29
1683662921082,MATH 142B,A02,188741,Ioana; Adrian,0,1,30,30
1683662921082,MATH 142B,A03,188743,Ioana; Adrian,0,1,30,30
1683662922108,MATH 168A,A01,188790,Staff,0,10,35,35
1683662923131,MATH 170A,A01,188803,Nie; Jiawang,0,2,35,35
1683662923131,MATH 170A,A02,188811,Nie; Jiawang,0,0,35,35
1683662923131,MATH 170A,A03,188814,Nie; Jiawang,0,0,35,35
1683662923131,MATH 170A,A04,188815,Nie; Jiawang,9,0,35,26
1683662924158,MATH 193B,A01,188817,Staff,0,0,35,35
1683662924158,MATH 193B,A02,188818,Staff,5,0,35,30
1683662925185,MGT 4,A01,202857,Anderson; John Charles,61,0,80,19
1683662926211,MGT 12,A00,202858,Lindenberger; Wade Douglas,40,0,90,50
1683662927235,MGT 18,A00,202859,Staff,74,0,90,16
1683662928265,MGT 18GS,A00,202860,McKay; Michael J,13,0,28,15
1683662929289,MGT 45,A00,202861,Pecore; Joseph P.,11,0,90,79
1683662930316,MGT 100,A00,202863,Yavorsky; Daniel Ryan,28,0,90,62
1683662931341,MGT 103,A00,202864,Ehrich; Kristine R,0,18,90,90
1683662932367,MGT 112,A00,202865,Ehrich; Kristine R,14,0,90,76
1683662933393,MGT 121A,A00,202868,Staff,90,20,90,0
1683662934417,MGT 131B,A00,202869,Anderson; John Charles,59,0,90,31
1683662935441,MGT 136,A00,202871,Lindenberger; Wade Douglas,83,0,90,7
1683662936469,MGT 164,A00,202873,Staff,0,67,90,91
1683662937496,MGT 164GS,A00,202874,McKay; Mary A,13,0,28,15
1683662938523,MGT 180,A00,202875,Staff,0,51,90,91
1683662939548,MMW 11R,A01,205019,Herbst; Matthew,1,0,30,29
1683662939548,MMW 11R,A02,205026,Herbst; Matthew,29,0,30,1
1683662940577,MMW 15,A01,193512,Chang; Edmond Yi-Teh,0,8,28,28
1683662940577,MMW 15,A02,193513,Chang; Edmond Yi-Teh,0,5,28,28
1683662940577,MMW 15,A03,193514,Chang; Edmond Yi-Teh,0,5,28,28
1683662940577,MMW 15,A04,193515,Chang; Edmond Yi-Teh,0,5,28,28
1683662940577,MMW 15,A05,193516,Chang; Edmond Yi-Teh,0,5,28,28
1683662940577,MMW 15,A06,193517,Chang; Edmond Yi-Teh,0,6,28,28
1683662940577,MMW 15,B01,193519,Chang; Edmond Yi-Teh,0,5,28,28
1683662940577,MMW 15,B02,193520,Chang; Edmond Yi-Teh,0,5,28,28
1683662940577,MMW 15,B03,193521,Chang; Edmond Yi-Teh,0,5,28,28
1683662940577,MMW 15,B04,193522,Chang; Edmond Yi-Teh,0,5,28,28
1683662940577,MMW 15,B05,193523,Chang; Edmond Yi-Teh,0,5,28,28
1683662940577,MMW 15,B06,193524,Chang; Edmond Yi-Teh,0,5,28,28
1683662941603,MMW 122,A01,193526,Rahimi; Babak,0,16,28,28
1683662941603,MMW 122,A02,193527,Rahimi; Babak,0,15,28,28
1683662941603,MMW 122,A03,193528,Rahimi; Babak,0,0,0,0
1683662941603,MMW 122,A04,193529,Rahimi; Babak,0,0,0,0
1683662942627,MUS 1A,A01,186663,Staff,1,20,35,34
1683662943653,MUS 4,A01,186715,Staff,0,12,35,35
1683662944681,MUS 5R,A01,186796,Dubnov; Shlomo,0,17,35,35
1683662945708,MUS 6,A01,186798,Staff,0,5,25,25
1683662946731,MUS 7,A01,186830,Staff,11,0,35,24
1683662947758,MUS 8,A01,186930,Staff,0,26,35,35
1683662948782,MUS 15,A01,186932,Staff,0,16,35,35
1683662948782,MUS 15,B01,186934,Staff,1,17,35,34
1683662949807,MUS 80,A00,186935,Staff,0,0,20,20
1683662949807,MUS 80,B00,186936,Staff,24,0,25,1
1683662950831,NANO 11,A00,204702,Lipomi; Darren John,0,0,0,0
1683662951859,NANO 15,A01,204709,Yang; Kesong,0,1,0,0
1683662952885,NANO 114,A00,202069,Jahed Motlagh; Zeinab,3,0,10,7
1683662953909,PHIL 1,A00,186955,Grush; Rick Scott,31,0,40,9
1683662954936,PHIL 10,A01,186973,Grush; Rick Scott,27,0,35,8
1683662954936,PHIL 10,A02,186974,Grush; Rick Scott,33,0,35,2
1683662955963,PHIL 13,A01,186976,Staff,3,0,35,32
1683662955963,PHIL 13,A02,186977,Staff,16,0,35,19
1683662956988,PHIL 14,A01,186979,Staff,31,0,35,4
1683662956988,PHIL 14,A02,186986,Staff,32,0,35,3
1683662958012,PHIL 28,A01,186988,Staff,16,0,30,14
1683662958012,PHIL 28,A02,186989,Staff,1,0,30,29
1683662958012,PHIL 28,A03,186990,Staff,10,0,30,20
1683662958012,PHIL 28,A04,186991,Staff,26,0,30,4
1683662959035,PHIL 120,A00,186997,Staff,23,0,40,17
1683662960061,PHIL 137,A00,187003,Staff,7,0,40,33
1683662961089,PHIL 150,A00,187015,Staff,47,0,70,23
1683662962110,PHIL 167,A00,187021,Lamey; Andy M.,34,0,40,6
1683662963134,PHIL 174,A01,202226,Staff,17,0,20,3
1683662963134,PHIL 174,A02,202235,Staff,20,0,20,0
1683662964158,PHIL 191A,A00,258918,Staff,0,0,1,1
1683662965184,PHYS 1A,A00,187028,Staff,26,0,60,34
1683662966208,PHYS 1AL,001,187036,Staff,3,0,30,27
1683662966208,PHYS 1AL,002,187049,Staff,18,0,30,12
1683662967232,PHYS 1B,A00,187058,Staff,22,0,60,38
1683662968255,PHYS 1BL,001,187064,Staff,0,1,30,30
1683662968255,PHYS 1BL,002,187070,Staff,4,0,30,26
1683662969279,PHYS 1C,A00,187082,Staff,29,0,120,91
1683662970304,PHYS 1CL,001,187088,Staff,0,9,30,30
1683662970304,PHYS 1CL,002,187089,Staff,0,1,30,30
1683662970304,PHYS 1CL,009,262693,Staff,9,0,30,21
1683662971328,PHYS 2B,A01,187097,Staff,55,0,115,60
1683662972351,PHYS 2C,A01,187099,Staff,63,0,115,52
1683662973376,PHYS 2CL,A01,187101,Staff,5,0,28,23
1683662973376,PHYS 2CL,A02,187102,Staff,15,0,28,13
1683662974400,PHYS 2D,A01,187123,Shotwell; Brian,95,0,115,20
1683662975427,PHYS 4B,A01,187133,Grinstein; Benjamin,35,0,50,15
1683662976453,POLI 10,A00,188819,Staff,0,4,50,50
1683662977476,POLI 11,A00,188827,Staff,43,0,50,7
1683662978500,POLI 13R,A00,188828,Staff,0,1,20,20
1683662979527,POLI 27,A01,188830,Elgin; Samuel Zincke,0,2,70,70
1683662980555,POLI 30,A00,188832,Desposato; Scott,30,0,50,20
1683662981579,POLI 102F,A00,188834,Staff,0,0,40,40
1683662982606,POLI 104A,A00,188852,Staff,13,0,30,17
1683662983629,POLI 104I,A00,188853,Staff,0,7,20,20
1683662984656,POLI 110B,A00,188854,Wiens; David,6,0,20,14
1683662985683,POLI 112A,A00,188855,Wiens; David,3,0,30,27
1683662986706,POLI 117R,A00,188856,Forman; Fonna,0,12,20,20
1683662987730,POLI 118,A00,188857,Ingham; Sean,8,0,20,12
1683662988758,POLI 120G,A00,188858,Staff,8,0,30,22
1683662989782,POLI 131CR,A00,188863,Hoston; Germaine,21,0,50,29
1683662990807,POLI 133,A00,188864,Nellis; Gareth Hb,44,0,50,6
1683662991834,POLI 134D,A00,188865,Desposato; Scott,27,0,30,3
1683662992860,POLI 142A,A00,188871,Gartzke; Erik,21,0,50,29
1683662993884,POLI 142K,A00,188874,Staff,38,0,50,12
1683662994908,POLI 143,A00,188940,Gartzke; Erik,16,0,30,14
1683662995932,POLI 153,A00,188943,Staff,2,0,20,18
1683662996959,POLI 160AA,A00,188944,Staff,11,0,40,29
1683662997982,POLI 170A,A00,188945,Staff,11,0,30,19
1683663000032,PSYC 1,A00,188952,Staff,36,0,90,54
1683663001058,PSYC 2,B00,188953,Staff,19,0,35,16
1683663002082,PSYC 6,A00,188970,Staff,47,0,60,13
1683663003104,PSYC 7,A00,188973,Staff,35,0,45,10
1683663004130,PSYC 60,A01,188980,Rickard; Timothy C.,42,0,60,18
1683663005153,PSYC 70,A01,189001,Steiner; Eric Tomas,22,0,45,23
1683663006180,PSYC 100,A00,189005,Lacefield; Katharine I,0,99,120,120
1683663007206,PSYC 102,A00,189008,Staff,8,0,30,22
1683663008230,PSYC 106,B00,189026,Gorman; Michael R.,27,0,60,33
1683663009259,PSYC 114,B01,189033,Winkielman; Piotr,0,31,30,30
1683663010284,PSYC 131,A00,189036,Anagnostaras; Stephan,0,43,60,60
1683663011307,PSYC 136,A00,189041,Lowe; Angela Beth,0,7,25,25
1683663012340,PSYC 137,A00,189057,Winkielman; Piotr,0,37,25,25
1683663013367,PSYC 144,A00,189107,Wixted; John T,0,11,50,50
1683663015414,PSYC 162,A00,189142,Staff,0,9,85,85
1683663016438,PSYC 172,A00,189144,Gorman; Michael R.,0,6,30,30
1683663018542,PSYC 179,A00,189146,Lacefield; Katharine I,0,87,120,120
1683663019566,PSYC 181,A00,189147,Anagnostaras; Stephan,0,44,90,90
1683663020590,PSYC 190R,A00,189148,Barner; David A.,0,23,80,80
1683663021617,PSYC 191,A00,189275,Rickard; Timothy C.,0,10,25,25
1683663022641,PSYC 193,A00,189276,Chapman; Eddie Nathaniel,0,1,0,4
1683663023670,PSYC 193L,A01,189281,Lowe; Angela Beth,10,0,20,10
1683663023670,PSYC 193L,B01,189285,Staff,28,0,35,7
1683663024695,RELI 149,A00,187137,Rahimi; Babak,7,0,40,33
1683663025721,SE 9,A01,187315,Staff,0,2,18,18
1683663026744,SE 101B,A00,187409,Staff,24,0,30,6
1683663027772,SE 110B,A00,187444,Staff,10,0,40,30
1683663028799,SE 130B,A00,187449,Staff,31,0,40,9
1683663029826,SE 150A,A00,187516,Staff,9,0,20,11
1683663030853,SE 154,A00,187528,Staff,29,0,50,21
1683663031886,SIO 3,A01,258171,Staff,35,0,40,5
1683663032913,SIO 10,A00,187144,Cook; Geoffrey W,0,7,75,75
1683663033936,SIO 45,A00,187152,Cook; Geoffrey W,0,5,100,100
1683663034958,SIO 109R,A00,194486,Staff,0,4,20,20
1683663037011,SIO 187,A01,187233,Kacev; David,12,0,40,28
1683663038035,SOCI 1,A01,258656,Thorpe; Charles Robert,28,0,30,2
1683663038035,SOCI 1,A02,258658,Thorpe; Charles Robert,30,0,30,0
1683663038035,SOCI 1,A03,258661,Thorpe; Charles Robert,25,0,25,0
1683663038035,SOCI 1,A04,258666,Thorpe; Charles Robert,22,0,25,3
1683663038035,SOCI 1,A05,258897,Thorpe; Charles Robert,22,0,25,3
1683663038035,SOCI 1,A06,258898,Thorpe; Charles Robert,25,0,25,0
1683663039059,SOCI 30,A01,258903,Pardo Guerra; Juan Pablo,14,0,30,16
1683663040083,SOCI 102,A00,258904,Staff,9,0,25,16
1683663041106,SOCI 106,A00,258905,Staff,19,0,25,6
1683663042132,SOCI 111,A00,258907,Ribas Norris; Janet Vanesa,26,0,30,4
1683663043158,SOCI 121R,A00,258908,Pardo Guerra; Juan Pablo,8,0,30,22
1683663044182,SOCI 126,A01,203330,Staff,14,0,20,6
1683663045207,SOCI 131,A00,258909,Thorpe; Charles Robert,30,0,60,30
1683663046233,SOCI 135,A00,258910,Payne; Christine Anna,0,11,30,30
1683663047256,SOCI 157,A00,258911,Staff,12,0,30,18
1683663048284,SOCI 184,A00,258912,Staff,25,0,30,5
1683663049307,SOCI 188D,A00,258913,Staff,22,0,30,8
1683663050332,SYN 2,001,187529,Staff,9,0,16,7
1683663050332,SYN 2,002,201452,Staff,0,20,16,16
1683663050332,SYN 2,003,201469,Staff,1,0,16,15
1683663051356,SYN 100,A01,187531,Staff,0,9,20,20
1683663051356,SYN 100,B01,201491,Staff,0,10,20,20
1683663052380,TDAC 1,A00,189286,Walsh; Kim C.,3,0,20,17
1683663052380,TDAC 1,B00,189287,Harting; Carla Kelso,10,0,20,10
1683663053405,TDAC 101,A00,189300,Walsh; Kim C.,16,0,20,4
1683663053405,TDAC 101,B00,189301,Harting; Carla Kelso,18,0,20,2
1683663054433,TDAC 102,A00,189304,Basso; Beatrice,14,0,20,6
1683663055461,TDAC 108,A00,189305,Staff,18,0,20,2
1683663056485,TDDE 131,A00,189310,Staff,19,0,20,1
1683663056485,TDDE 131,B00,189314,Staff,19,0,20,1
1683663056485,TDDE 131,C00,189315,Staff,48,0,50,2
1683663056485,TDDE 131,D00,189316,Staff,14,0,15,1
1683663056485,TDDE 131,E00,204841,Staff,20,0,20,0
1683663057509,TDGE 10,A00,189289,Staff,27,0,50,23
1683663057509,TDGE 10,B00,189290,Havis; Allan,0,1,50,50
1683663058534,TDGE 11,A00,189291,Fulton; Julia,0,4,50,50
1683663058534,TDGE 11,B00,189292,Staff,20,0,25,5
1683663058534,TDGE 11,C00,260270,Staff,0,0,0,0
1683663059562,TDGE 25,A00,189294,Staff,2,0,20,18
1683663060587,TDGE 124,A00,189318,Fulton; Julia,0,8,50,50
1683663061612,TDGE 125,A00,189319,Staff,13,0,25,12
1683663061612,TDGE 125,B00,189320,Staff,23,0,25,2
1683663062636,TDGE 127,A00,189322,Havis; Allan,1,0,50,49
1683663063665,TDHT 101,A00,189323,Staff,18,0,25,7
1683663063665,TDHT 101,B00,189324,Staff,25,0,25,0
1683663064691,TDHT 102,A00,189325,Staff,49,0,50,1
1683663065717,TDMV 1,A00,189295,Arcidiacono; Kristin,20,0,30,10
1683663065717,TDMV 1,B00,189296,Caligagan; Maria T.,24,0,30,6
1683663066741,TDMV 2,A00,189297,Sammartano; Tonnie,27,0,30,3
1683663066741,TDMV 2,B00,189299,Arcidiacono; Kristin,23,0,30,7
1683663067768,TDMV 3,A00,204998,Rincon; Alicia,22,0,30,8
1683663068792,TDMV 120,A00,189458,Sammartano; Tonnie,28,0,30,2
1683663069816,TDMV 138,A00,189541,Jun; Grace Shin Hae,20,0,40,20
1683663070843,TDMV 142,A00,189717,Caligagan; Tony,25,0,30,5
1683663070843,TDMV 142,B00,189718,Caligagan; Maria T.,25,0,30,5
1683663071869,TMC 2,A01,187533,Staff,25,0,25,0
1683663071869,TMC 2,A02,187534,Staff,25,0,25,0
1683663072894,USP 1,A01,187536,Kwak; Nancy,0,16,25,25
1683663073918,USP 5,A01,187538,Staff,9,0,25,16
1683663074945,USP 101,A00,199253,Staff,0,4,0,0
1683663075971,USP 124,A00,187562,Boomhower; Matthew Charles,0,0,30,30
1683663076998,USP 138,A00,187582,Staff,20,0,25,5
1683663078023,USP 152,A01,187597,Staff,3,0,25,22
1683663079047,USP 153,A00,187598,Staff,19,0,25,6
1683663080071,USP 168,A00,187607,Kwak; Nancy,2,0,5,3
1683663081095,USP 173,A00,187619,Staff,4,0,25,21
1683663082119,USP 181,A00,187638,Staff,0,4,25,25
1683663083144,VIS 103,A00,187650,Cruz; Edwin Teddy,17,0,75,58
1683663084168,VIS 110D,A00,187669,Staff,13,0,22,9
1683663085192,VIS 127C,A00,187720,Shen; Kuiyi,68,0,146,78
1683663086215,VIS 149,A00,187731,Yoldas; Pinar,1,14,22,21
1683663087242,VIS 151,A01,188091,Staff,22,0,34,12
1683663087242,VIS 151,A02,188092,Staff,11,0,34,23
1683663088266,VIS 160B,A00,188093,Stalbaum; Brett,0,1,10,10
1683663090317,WCWP 10B,A00,201720,Staff,10,0,15,5
1683663090317,WCWP 10B,B00,201722,Staff,9,0,15,6
1683663091344,WCWP 100,A00,201725,Gagnon; Jeffrey C,0,0,2,2
1683663091344,WCWP 100,B00,201727,Staff,0,4,15,15
1683663094434,ANBI 133,A00,258401,Wilder; Linnea Lorene,34,0,40,6
1683663095460,ANBI 140,A00,258395,Hrvoj Mihic; Branka,18,0,25,7
1683663096487,ANSC 120,A00,258402,Bialecki; Jon Anthony,26,0,40,14
1683663097511,ANSC 144,A00,258400,Staff,12,0,40,28
1683663099559,ANSC 166,A00,258396,Parish; Steven Martin,156,0,175,19
1683663100582,ANSC 180,A00,193533,Staff,8,0,20,12
1683663101605,ANSC 188,A00,258397,Jassal; Aftab,34,0,40,6
1683663102631,ANTH 3,A01,258316,Staff,23,0,30,7
1683663103658,ANTH 5,A00,258394,Semendeferi; Ekaterini,16,0,20,4
1683663104681,ANTH 21,A01,258331,Staff,4,0,40,36
1683663105708,ANTH 103,A00,258398,Varma; Saiba,15,0,25,10
1683663106743,AWP 10,001,202034,Staff,0,0,0,0
1683663106743,AWP 10,002,202035,Staff,0,0,0,0
1683663106743,AWP 10,003,202036,Staff,0,0,0,0
1683663106743,AWP 10,004,202037,Staff,0,0,0,0
1683663106743,AWP 10,005,202038,Staff,0,0,0,0
1683663106743,AWP 10,006,202039,Staff,0,0,0,0
1683663106743,AWP 10,007,202040,Staff,0,0,0,0
1683663106743,AWP 10,008,202041,Staff,0,0,0,0
1683663106743,AWP 10,009,202042,Staff,0,0,0,0
1683663106743,AWP 10,010,202043,Staff,0,0,0,0
1683663106743,AWP 10,011,202044,Staff,0,0,0,0
1683663106743,AWP 10,012,202045,Staff,0,0,0,0
1683663106743,AWP 10,013,202046,Staff,0,0,0,0
1683663106743,AWP 10,014,202047,Staff,0,0,0,0
1683663106743,AWP 10,015,202048,Staff,0,0,0,0
1683663106743,AWP 10,016,202049,Staff,0,0,0,0
1683663106743,AWP 10,017,202050,Staff,0,0,0,0
1683663106743,AWP 10,018,202051,Staff,0,0,0,0
1683663106743,AWP 10,019,202052,Staff,0,0,0,0
1683663106743,AWP 10,020,202053,Staff,0,0,0,0
1683663106743,AWP 10,021,202054,Staff,0,0,0,0
1683663106743,AWP 10,022,202055,Staff,0,0,0,0
1683663106743,AWP 10,023,202056,Staff,0,0,0,0
1683663106743,AWP 10,024,202057,Staff,0,0,0,0
1683663106743,AWP 10,025,202058,Staff,0,0,0,0
1683663106743,AWP 10,026,202059,Staff,0,0,0,0
1683663107767,AWP 102,001,202032,Staff,0,0,0,0
1683663107767,AWP 102,002,202033,Staff,0,0,0,0
1683663108791,BENG 100,A01,254234,Taylor Amos; Alyssa C,31,0,40,9
1683663109814,BENG 196,001,270013,Engler; Adam J.,9999,0,9999,0
1683663110838,BICD 100R,A01,202018,Smith; Laurie,0,7,32,32
1683663110838,BICD 100R,A02,202019,Smith; Laurie,0,3,32,32
1683663110838,BICD 100R,A03,202020,Smith; Laurie,0,1,32,32
1683663110838,BICD 100R,A04,202021,Smith; Laurie,6,0,32,26
1683663110838,BICD 100R,A05,202022,Smith; Laurie,11,0,32,21
1683663111862,BICD 136,A01,193242,Gustafson-Brown; Cindy,0,2,32,32
1683663111862,BICD 136,A02,193244,Gustafson-Brown; Cindy,13,0,32,19
1683663112885,BIEB 102,A01,193249,Butler; Shannon Rhey,1,2,32,31
1683663112885,BIEB 102,A02,193251,Butler; Shannon Rhey,0,0,32,32
1683663112885,BIEB 102,A03,193253,Butler; Shannon Rhey,0,0,32,32
1683663112885,BIEB 102,A04,193255,Butler; Shannon Rhey,14,0,32,18
1683663112885,BIEB 102,A05,193265,Butler; Shannon Rhey,25,0,32,7
1683663112885,BIEB 102,A06,193269,Butler; Shannon Rhey,14,0,32,18
1683663114934,BIEB 150,A01,193274,Staff,0,0,32,32
1683663114934,BIEB 150,A02,193285,Staff,24,0,32,8
1683663115960,BIEB 194,A00,193286,Kurle; Carolyn M.,20,0,32,12
1683663116989,BILD 1,A01,192291,Staff,15,0,32,17
1683663116989,BILD 1,A02,192292,Staff,30,0,32,2
1683663116989,BILD 1,B01,192520,Reuther; Keefe,0,1,0,0
1683663116989,BILD 1,B02,192532,Reuther; Keefe,0,1,0,0
1683663118018,BILD 3,A01,192556,Butler; Shannon Rhey,0,0,32,32
1683663118018,BILD 3,A02,192581,Butler; Shannon Rhey,0,0,32,32
1683663118018,BILD 3,A03,192611,Butler; Shannon Rhey,21,0,32,11
1683663118018,BILD 3,A04,192612,Butler; Shannon Rhey,24,0,32,8
1683663118018,BILD 3,A05,192613,Butler; Shannon Rhey,26,0,32,6
1683663118018,BILD 3,A06,192679,Butler; Shannon Rhey,27,0,32,5
1683663118018,BILD 3,A07,192682,Butler; Shannon Rhey,20,0,32,12
1683663119047,BILD 4,A01,192836,Reuther; Keefe,1,0,24,23
1683663119047,BILD 4,A02,193044,Reuther; Keefe,4,0,24,20
1683663120070,BILD 10,A01,193142,Gustafson-Brown; Cindy,29,0,32,3
1683663120070,BILD 10,A02,193149,Gustafson-Brown; Cindy,31,0,32,1
1683663121169,BIMM 100,A01,193301,Staff,0,6,32,32
1683663121169,BIMM 100,A02,193312,Staff,0,7,32,32
1683663121169,BIMM 100,A03,193323,Staff,0,9,32,32
1683663122194,BIMM 101,A01,193329,McDonnell; Lisa Marie,0,4,24,24
1683663122194,BIMM 101,A02,193339,McDonnell; Lisa Marie,1,4,24,23
1683663122194,BIMM 101,B01,193354,McDonnell; Lisa Marie,0,4,24,24
1683663122194,BIMM 101,B02,193357,McDonnell; Lisa Marie,0,3,24,24
1683663123222,BIMM 110,A01,193377,Tat; John,0,11,32,32
1683663123222,BIMM 110,A02,193378,Tat; John,0,10,32,32
1683663124245,BIMM 120,A01,206116,Staff,0,0,32,32
1683663124245,BIMM 120,A02,206117,Staff,6,0,32,26
1683663124245,BIMM 120,A03,206121,Staff,21,0,32,11
1683663125270,BIPN 100,A01,193393,Park; Ji Young,0,15,32,32
1683663125270,BIPN 100,A02,193402,Park; Ji Young,0,14,32,32
1683663125270,BIPN 100,A03,193413,Park; Ji Young,0,14,32,32
1683663125270,BIPN 100,A04,193414,Park; Ji Young,0,13,32,32
1683663126294,BIPN 102,A01,193429,Staff,0,0,32,32
1683663126294,BIPN 102,A02,193438,Staff,18,0,32,14
1683663127320,BIPN 106,A01,193450,Reyes Gonzalez; Catalina,0,2,40,40
1683663128345,BIPN 134,A01,193465,Cooke; James Edward,0,0,32,32
1683663128345,BIPN 134,A02,193474,Cooke; James Edward,25,0,32,7
1683663128345,BIPN 134,A03,193485,Cooke; James Edward,29,0,32,3
1683663128345,BIPN 134,A04,193486,Cooke; James Edward,20,0,32,12
1683663128345,BIPN 134,A05,193491,Cooke; James Edward,31,0,32,1
1683663128345,BIPN 134,A06,193501,Cooke; James Edward,30,0,32,2
1683663128345,BIPN 134,A07,193510,Cooke; James Edward,29,0,32,3
1683663130395,BISP 194,A00,222522,Staff,14,0,32,18
1683663131418,CAT 124,A01,202407,Staff,19,0,25,6
1683663132446,CAT 125,A00,202408,Marchisotto; Jennifer Anne,2,0,20,18
1683663133477,CAT 125R,A00,202409,Smith; Lauryn Alissa,0,11,20,20
1683663133477,CAT 125R,B00,202410,Morales; Celeste Georgianna,0,11,20,20
1683663133477,CAT 125R,C00,202411,Irwin; Matthew Joseph,0,12,20,20
1683663134502,CENG 15,A01,204712,Yang; Kesong,0,1,0,0
1683663135529,CENG 114,A00,202070,Jahed Motlagh; Zeinab,5,0,20,15
1683663136557,CGS 105,A00,185477,Wesling; Megan E.,24,0,40,16
1683663137584,CGS 106,A00,185494,Staff,11,0,22,11
1683663138608,CGS 108,A00,185495,Staff,14,0,20,6
1683663139631,CGS 114,A00,185496,Staff,13,0,18,5
1683663140658,CGS 119,A00,185501,Staff,15,0,20,5
1683663141681,CGS 120,A00,185511,Staff,12,0,20,8
1683663142706,CHEM 4,A01,184675,Bussey; Thomas J,97,0,100,3
1683663143729,CHEM 6A,A01,184677,Staff,32,0,60,28
1683663144762,CHEM 6B,A01,184679,Staff,63,0,100,37
1683663145789,CHEM 6C,A01,184681,Bussey; Thomas J,0,0,50,50
1683663145789,CHEM 6C,A02,184682,Bussey; Thomas J,32,0,50,18
1683663146814,CHEM 40A,A01,184684,Albizati; Kim F.,34,0,100,66
1683663147838,CHEM 40B,A01,184686,Albizati; Kim F.,0,22,100,100
1683663148865,CHEM 41B,A01,184690,Staff,51,0,100,49
1683663149893,COGS 3,A01,184715,Boyle; Mary E. T.,0,27,40,40
1683663150918,COGS 14B,A01,185172,Staff,0,14,38,38
1683663151947,COGS 18,A01,184736,Staff,14,0,80,66
1683663152974,COGS 100,A01,184932,Staff,0,7,73,73
1683663153998,COGS 101A,A01,184935,Staff,0,40,30,30
1683663155023,COGS 101B,A01,184944,Staff,0,2,30,30
1683663156050,COGS 101C,A01,184946,Staff,0,10,30,30
1683663157083,COGS 102A,A01,184951,Johnson; Christine M.,2,0,40,38
1683663158110,COGS 107B,A01,184953,Mooshagian; Eric Frederick,0,51,40,40
1683663159135,COGS 118B,A01,184959,Gupta; Anjum,0,49,40,40
1683663160160,COGS 153,A00,184961,Staff,0,16,30,30
1683663161185,COGS 177,A00,184962,Staff,0,21,30,30
1683663162209,COGS 187A,A01,184969,Boyle; Mary E. T.,0,19,40,40
1683663163232,COMM 10,A01,185174,Staff,0,5,25,25
1683663163232,COMM 10,A02,185189,Staff,0,2,25,25
1683663163232,COMM 10,A03,269821,Staff,0,1,0,0
1683663164255,COMM 100B,A01,185475,Staff,0,1,0,2
1683663164255,COMM 100B,A02,185476,Staff,12,0,25,13
1683663165280,COMM 100C,A01,185314,Staff,1,0,25,24
1683663165280,COMM 100C,A02,185327,Staff,18,0,25,7
1683663166302,COMM 110M,A00,185349,Staff,0,0,40,40
1683663167329,COMM 113T,A00,185352,Staff,25,0,40,15
1683663168357,COMM 114I,A00,185353,Staff,31,0,40,9
1683663169385,COMM 131,A00,185354,Staff,17,0,30,13
1683663170408,CSE 8A,A50,185358,Cao; Yingjun,0,46,10,10
1683663171435,CSE 8B,A01,185362,Staff,0,48,50,50
1683663172463,CSE 11,A01,185416,Cao; Yingjun,0,91,10,10
1683663173486,CSE 20,A01,185445,Briones; Jor-el Thomas Caparas,4,0,25,21
1683663174511,CSE 21,A01,185447,Staff,9,0,50,41
1683663175535,CSE 101,A01,185451,Staff,0,13,50,50
1683663175535,CSE 101,B01,185453,Jones; Miles E,0,14,50,50
1683663177600,CSE 141,A01,185458,Eldon; John,16,0,100,84
1683663178627,CSE 141L,A01,185461,Eldon; John,8,0,100,92
1683663179652,CSE 142,A01,185463,Staff,34,0,60,26
1683663179652,CSE 142,B01,201355,Staff,0,7,60,60
1683663180678,CSE 142L,A01,185470,Staff,34,0,60,26
1683663180678,CSE 142L,B01,201417,Staff,0,6,60,60
1683663181714,CSE 190,A00,201433,Staff,32,0,49,17
1683663182743,DOC 1,A01,259136,Strom; Megan C.,7,0,15,8
1683663182743,DOC 1,A02,259137,Strom; Megan C.,14,0,15,1
1683663182743,DOC 1,A03,259138,Strom; Megan C.,14,0,15,1
1683663182743,DOC 1,A04,259139,Strom; Megan C.,14,0,15,1
1683663183768,DOC 100D,A00,259140,Pass; Natalye Joann,14,0,25,11
1683663184795,DSGN 1,A01,184749,Rill; Bryan,0,26,30,30
1683663185820,DSGN 100,A01,185168,Staff,0,2,25,25
1683663186844,ECE 5,A01,185626,Morris; Karcher William,0,11,0,0
1683663187871,ECE 101,A01,185628,Staff,14,0,70,56
1683663188894,ECE 107,A01,185635,Baghdadchi; Saharnaz,0,0,20,20
1683663188894,ECE 107,A02,185638,Baghdadchi; Saharnaz,2,0,20,18
1683663189918,ECE 148,A01,185647,Silberman; Jack,0,0,16,16
1683663190943,ECON 1,A01,185537,Crane; Meredith Helen,54,0,70,16
1683663191970,ECON 3,A01,185549,Crane; Meredith Helen,29,0,70,41
1683663192995,ECON 4,A01,203354,Anderson; John Charles,0,5,10,10
1683663194019,ECON 100A,A01,185574,Staff,0,5,40,40
1683663195043,ECON 100B,A01,185576,Staff,0,12,50,50
1683663196067,ECON 100C,A01,185589,Newhouse; Herbert S,30,0,70,40
1683663197091,ECON 105,A00,185608,Vespa; Emanuel Ignacio,19,0,35,16
1683663198115,ECON 109,A01,185610,Shishkin; Denis,9,0,35,26
1683663199139,ECON 110A,A01,185612,Staff,9,0,40,31
1683663200165,ECON 120A,A01,185615,Staff,20,0,40,20
1683663201189,ECON 120C,A01,185617,Sun; Yixiao,0,20,70,70
1683663202214,ECON 144,A00,203346,Squires; Dale E,2,0,35,33
1683663203238,ECON 171,A01,203349,Newhouse; Herbert S,0,1,35,35
1683663204261,ECON 173A,A01,185621,Toda; Alexis Akira,20,0,35,15
1683663205291,EDS 25,A01,202413,Staff,0,1,0,0
1683663205291,EDS 25,A02,202414,Staff,0,1,0,0
1683663205291,EDS 25,A03,202415,Staff,0,0,0,0
1683663205291,EDS 25,A04,202416,Staff,0,1,0,0
1683663205291,EDS 25,A05,202439,Staff,0,0,0,0
1683663205291,EDS 25,A06,202440,Staff,0,0,0,0
1683663205291,EDS 25,B01,202631,Staff,0,0,0,0
1683663205291,EDS 25,B02,202632,Staff,0,0,0,0
1683663205291,EDS 25,B03,202639,Staff,0,0,0,0
1683663205291,EDS 25,B04,202640,Staff,0,0,0,0
1683663205291,EDS 25,B05,202643,Staff,0,0,0,0
1683663205291,EDS 25,B06,202644,Staff,0,0,0,0
1683663206318,EDS 38,A01,202659,Black; Alison Michelle,24,0,25,1
1683663207343,EDS 115,A00,202652,Staff,18,0,30,12
1683663208367,EDS 125,A00,202649,Staff,13,0,30,17
1683663209394,EDS 126,A01,203332,Staff,30,0,30,0
1683663210418,EDS 139,A00,202838,Staff,16,0,25,9
1683663211442,EDS 146,A01,202655,Staff,14,0,25,11
1683663212471,ENG 15,A00,185667,Staff,0,1,0,0
1683663212471,ENG 15,B00,185672,Staff,0,0,0,0
1683663212471,ENG 15,C00,185675,Staff,0,0,0,0
1683663212471,ENG 15,D00,185682,Staff,0,0,0,0
1683663212471,ENG 15,E00,185684,Staff,0,0,0,0
1683663213495,ETHN 103,A00,185710,Staff,0,8,35,35
1683663214523,ETHN 103A,A00,199228,Man; Simeon S,0,0,9,9
1683663215544,ETHN 109,A00,185711,Staff,16,0,35,19
1683663216568,ETHN 142,A00,185726,Staff,0,4,30,30
1683663217596,ETHN 163J,A00,199229,Man; Simeon S,5,0,8,3
1683663218621,ETHN 168,A00,185727,Staff,7,0,10,3
1683663219647,ETHN 182,A00,185728,Staff,0,0,35,35
1683663220673,ETHN 183,A00,185737,Staff,9,0,18,9
1683663221701,GLBH 111,A01,209361,Burgos; Jose L.,0,0,0,0
1683663223747,HIEU 104,A00,185792,Staff,14,0,20,6
1683663224826,HIEU 115,A00,185800,Staff,0,0,20,20
1683663225849,HIEU 128,A00,185801,Staff,0,9,20,20
1683663226872,HIEU 147,A00,185802,Staff,15,0,20,5
1683663227897,HIEU 154,A00,185823,Staff,11,0,20,9
1683663228920,HILA 102,A00,185826,Staff,14,0,20,6
1683663229943,HILD 2C,A01,185778,Staff,0,13,20,20
1683663230967,HILD 7B,A01,185780,Kwak; Nancy,0,17,32,32
1683663230967,HILD 7B,A02,185781,Kwak; Nancy,0,18,32,32
1683663231993,HILD 30,A01,185791,Staff,12,0,20,8
1683663233015,HISC 119,A00,185830,Golan; Tal,0,9,20,20
1683663234040,HITO 156GS,A00,185831,Patterson; Patrick H.,0,0,0,23
1683663235064,HIUS 103,A00,185832,Man; Simeon S,0,4,20,20
1683663236089,HIUS 117,A00,185836,Kwak; Nancy,2,0,20,18
1683663237113,HIUS 125,A00,185840,Man; Simeon S,0,2,23,23
1683663238139,HIUS 149,A00,185845,Staff,1,0,20,19
1683663239168,HUM 3,A01,185882,Zavodny; Tatiana Sophia,0,8,50,50
1683663239168,HUM 3,B01,185899,Caldwell; Michael Alan,0,18,50,50
1683663240196,HUM 3GS,A00,185900,Patterson; Patrick H.,0,0,0,23
1683663241226,HUM 4,A01,185938,Zroka; Amy Liane,29,0,50,21
1683663241226,HUM 4,B01,185956,Watkins; Eric,0,4,50,50
1683663241226,HUM 4,B02,202209,Watkins; Eric,0,5,50,50
1683663241226,HUM 4,B03,202210,Watkins; Eric,0,5,50,50
1683663242258,HUM 5,A01,185958,West; Geoffrey Scott,0,0,50,50
1683663242258,HUM 5,A02,202215,West; Geoffrey Scott,0,0,50,50
1683663243284,INTL 190,A00,185959,Gagnon; Jeffrey C,0,0,0,9
1683663243284,INTL 190,B00,185960,Lettieri; Michael Joseph,0,0,0,2
1683663244309,JAPN 180,A00,254509,Staff,5,0,30,25
1683663245332,LATI 10,A01,202853,Kennemore; Amy Michelle,4,0,35,31
1683663245332,LATI 10,A02,202854,Kennemore; Amy Michelle,2,0,35,33
1683663245332,LATI 10,A03,270054,Kennemore; Amy Michelle,30,0,30,0
1683663246360,LATI 180,A00,202855,Kennemore; Amy Michelle,11,0,20,9
1683663247385,LAWS 101,A00,201767,Golan; Tal,0,7,40,40
1683663248410,LIFR 1C,A00,185961,Staff,6,0,20,14
1683663249435,LIFR 1CX,A00,185962,Staff,7,0,20,13
1683663250461,LIFR 1D,A00,185963,Staff,7,0,20,13
1683663251489,LIFR 1DX,A00,185964,Staff,7,0,20,13
1683663252513,LIGN 101,A01,186039,Staff,43,0,50,7
1683663253537,LIGN 165,A00,186040,Staff,15,0,50,35
1683663254564,LTCS 108,A00,186041,Staff,5,0,10,5
1683663255587,LTCS 119,A00,186042,Staff,15,0,20,5
1683663256615,LTCS 130,A00,186043,Wesling; Megan E.,15,0,25,10
1683663258661,LTEA 138,A00,186119,Staff,14,0,40,26
1683663259685,LTEN 124,A00,186148,Staff,5,0,25,20
1683663260713,LTEN 178,A00,186149,Staff,7,0,15,8
1683663261737,LTEN 181,A00,186150,Blanco; John D,34,0,40,6
1683663262768,LTWL 120,A00,186160,Staff,20,0,25,5
1683663263796,LTWL 165,A00,186161,Staff,22,0,25,3
1683663264822,LTWR 100,A00,186162,Staff,0,5,15,15
1683663265849,LTWR 102,A00,186163,Doller; Ben,5,0,15,10
1683663266887,MAE 8,A01,186412,Staff,0,0,0,0
1683663267911,MAE 30B,A00,186445,Bahadori; Mohammad Yousef,82,0,100,18
1683663268938,MAE 40,A00,186592,Bewley; Thomas R,10,0,50,40
1683663269964,MAE 101B,A00,186593,Bahadori; Mohammad Yousef,80,0,100,20
1683663270988,MAE 105,A00,186594,Bandaru; Prabhakar,10,0,50,40
1683663272012,MAE 107,A00,186599,Pham; Hieu Tan,0,7,120,120
1683663273038,MAE 148,A01,186660,Silberman; Jack,3,0,16,13
1683663274064,MATH 10A,A01,188095,Staff,0,6,35,35
1683663275089,MATH 10B,A01,188097,Bowers; Adam R.,0,12,30,30
1683663275089,MATH 10B,A02,188099,Bowers; Adam R.,0,11,30,30
1683663275089,MATH 10B,B01,188104,Bowers; Adam R.,0,10,30,30
1683663275089,MATH 10B,B02,188106,Bowers; Adam R.,1,9,30,29
1683663276116,MATH 10C,A01,188111,Staff,0,18,30,30
1683663276116,MATH 10C,A02,188127,Staff,0,19,30,30
1683663276116,MATH 10C,A03,188131,Staff,0,19,30,30
1683663276116,MATH 10C,B01,188218,Staff,17,0,30,13
1683663276116,MATH 10C,B02,188244,Staff,13,0,30,17
1683663276116,MATH 10C,B03,188277,Staff,14,0,30,16
1683663277143,MATH 18,A01,188344,Bach; Quang Tran,18,0,30,12
1683663277143,MATH 18,A02,188345,Bach; Quang Tran,11,0,30,19
1683663277143,MATH 18,B01,188353,Bach; Quang Tran,11,0,30,19
1683663277143,MATH 18,B02,188354,Bach; Quang Tran,19,0,30,11
1683663278169,MATH 20A,A01,188374,Staff,11,0,35,24
1683663279194,MATH 20B,A01,188382,Ohm; Ko Woon,7,0,30,23
1683663279194,MATH 20B,A02,188383,Ohm; Ko Woon,22,0,30,8
1683663279194,MATH 20B,B01,188385,Ohm; Ko Woon,7,0,30,23
1683663279194,MATH 20B,B02,188392,Ohm; Ko Woon,22,0,30,8
1683663280219,MATH 20C,A01,188394,Harel; Guershon,10,0,30,20
1683663280219,MATH 20C,A02,188395,Harel; Guershon,13,0,30,17
1683663280219,MATH 20C,B01,188404,Harel; Guershon,5,0,30,25
1683663280219,MATH 20C,B02,188405,Harel; Guershon,18,0,30,12
1683663281244,MATH 20D,A01,188414,Hammock; Frances H,0,1,30,30
1683663281244,MATH 20D,A02,188415,Hammock; Frances H,0,1,30,30
1683663281244,MATH 20D,B01,188447,Hammock; Frances H,0,1,30,30
1683663281244,MATH 20D,B02,188486,Hammock; Frances H,3,0,30,27
1683663282271,MATH 20E,A01,188649,Staff,21,0,30,9
1683663282271,MATH 20E,A02,188650,Staff,21,0,30,9
1683663282271,MATH 20E,A03,188673,Staff,0,0,30,30
1683663283295,MATH 102,A01,188675,Staff,0,36,35,35
1683663284319,MATH 103B,A01,188681,Staff,3,0,35,32
1683663284319,MATH 103B,B01,188692,Staff,5,0,35,30
1683663285343,MATH 109,A01,188695,Salehi Golsefidy; Alireza,24,0,35,11
1683663285343,MATH 109,A02,188696,Salehi Golsefidy; Alireza,25,0,35,10
1683663286366,MATH 120A,A01,188698,Eggers; John Dietrich,7,0,35,28
1683663287394,MATH 142B,A01,188736,Ioana; Adrian,1,1,30,29
1683663287394,MATH 142B,A02,188741,Ioana; Adrian,0,1,30,30
1683663287394,MATH 142B,A03,188743,Ioana; Adrian,0,1,30,30
1683663288421,MATH 168A,A01,188790,Staff,0,10,35,35
1683663289446,MATH 170A,A01,188803,Nie; Jiawang,0,2,35,35
1683663289446,MATH 170A,A02,188811,Nie; Jiawang,0,0,35,35
1683663289446,MATH 170A,A03,188814,Nie; Jiawang,0,0,35,35
1683663289446,MATH 170A,A04,188815,Nie; Jiawang,9,0,35,26
1683663290473,MATH 193B,A01,188817,Staff,0,0,35,35
1683663290473,MATH 193B,A02,188818,Staff,5,0,35,30
1683663291497,MGT 4,A01,202857,Anderson; John Charles,61,0,80,19
1683663292525,MGT 12,A00,202858,Lindenberger; Wade Douglas,40,0,90,50
1683663293549,MGT 18,A00,202859,Staff,74,0,90,16
1683663294572,MGT 18GS,A00,202860,McKay; Michael J,13,0,28,15
1683663295594,MGT 45,A00,202861,Pecore; Joseph P.,11,0,90,79
1683663296620,MGT 100,A00,202863,Yavorsky; Daniel Ryan,28,0,90,62
1683663297647,MGT 103,A00,202864,Ehrich; Kristine R,0,18,90,90
1683663298671,MGT 112,A00,202865,Ehrich; Kristine R,14,0,90,76
1683663299695,MGT 121A,A00,202868,Staff,90,20,90,0
1683663300722,MGT 131B,A00,202869,Anderson; John Charles,59,0,90,31
1683663301748,MGT 136,A00,202871,Lindenberger; Wade Douglas,83,0,90,7
1683663302771,MGT 164,A00,202873,Staff,0,67,90,91
1683663303796,MGT 164GS,A00,202874,McKay; Mary A,13,0,28,15
1683663304820,MGT 180,A00,202875,Staff,0,51,90,91
1683663305847,MMW 11R,A01,205019,Herbst; Matthew,1,0,30,29
1683663305847,MMW 11R,A02,205026,Herbst; Matthew,29,0,30,1
1683663306871,MMW 15,A01,193512,Chang; Edmond Yi-Teh,0,8,28,28
1683663306871,MMW 15,A02,193513,Chang; Edmond Yi-Teh,0,5,28,28
1683663306871,MMW 15,A03,193514,Chang; Edmond Yi-Teh,0,5,28,28
1683663306871,MMW 15,A04,193515,Chang; Edmond Yi-Teh,0,5,28,28
1683663306871,MMW 15,A05,193516,Chang; Edmond Yi-Teh,0,5,28,28
1683663306871,MMW 15,A06,193517,Chang; Edmond Yi-Teh,0,6,28,28
1683663306871,MMW 15,B01,193519,Chang; Edmond Yi-Teh,0,5,28,28
1683663306871,MMW 15,B02,193520,Chang; Edmond Yi-Teh,0,5,28,28
1683663306871,MMW 15,B03,193521,Chang; Edmond Yi-Teh,0,5,28,28
1683663306871,MMW 15,B04,193522,Chang; Edmond Yi-Teh,0,5,28,28
1683663306871,MMW 15,B05,193523,Chang; Edmond Yi-Teh,0,5,28,28
1683663306871,MMW 15,B06,193524,Chang; Edmond Yi-Teh,0,5,28,28
1683663307898,MMW 122,A01,193526,Rahimi; Babak,0,16,28,28
1683663307898,MMW 122,A02,193527,Rahimi; Babak,0,15,28,28
1683663307898,MMW 122,A03,193528,Rahimi; Babak,0,0,0,0
1683663307898,MMW 122,A04,193529,Rahimi; Babak,0,0,0,0
1683663308921,MUS 1A,A01,186663,Staff,1,20,35,34
1683663309944,MUS 4,A01,186715,Staff,0,12,35,35
1683663310969,MUS 5R,A01,186796,Dubnov; Shlomo,0,17,35,35
1683663311997,MUS 6,A01,186798,Staff,0,5,25,25
1683663313021,MUS 7,A01,186830,Staff,11,0,35,24
1683663314049,MUS 8,A01,186930,Staff,0,26,35,35
1683663315076,MUS 15,A01,186932,Staff,0,16,35,35
1683663315076,MUS 15,B01,186934,Staff,1,17,35,34
1683663316106,MUS 80,A00,186935,Staff,0,0,20,20
1683663316106,MUS 80,B00,186936,Staff,24,0,25,1
1683663317128,NANO 11,A00,204702,Lipomi; Darren John,0,0,0,0
1683663318155,NANO 15,A01,204709,Yang; Kesong,0,1,0,0
1683663319179,NANO 114,A00,202069,Jahed Motlagh; Zeinab,3,0,10,7
1683663320202,PHIL 1,A00,186955,Grush; Rick Scott,31,0,40,9
1683663321229,PHIL 10,A01,186973,Grush; Rick Scott,27,0,35,8
1683663321229,PHIL 10,A02,186974,Grush; Rick Scott,33,0,35,2
1683663322253,PHIL 13,A01,186976,Staff,3,0,35,32
1683663322253,PHIL 13,A02,186977,Staff,16,0,35,19
1683663323280,PHIL 14,A01,186979,Staff,31,0,35,4
1683663323280,PHIL 14,A02,186986,Staff,32,0,35,3
1683663324304,PHIL 28,A01,186988,Staff,16,0,30,14
1683663324304,PHIL 28,A02,186989,Staff,1,0,30,29
1683663324304,PHIL 28,A03,186990,Staff,10,0,30,20
1683663324304,PHIL 28,A04,186991,Staff,26,0,30,4
1683663325332,PHIL 120,A00,186997,Staff,23,0,40,17
1683663326356,PHIL 137,A00,187003,Staff,7,0,40,33
1683663327382,PHIL 150,A00,187015,Staff,47,0,70,23
1683663328461,PHIL 167,A00,187021,Lamey; Andy M.,34,0,40,6
1683663329485,PHIL 174,A01,202226,Staff,17,0,20,3
1683663329485,PHIL 174,A02,202235,Staff,20,0,20,0
1683663330511,PHIL 191A,A00,258918,Staff,0,0,1,1
1683663331538,PHYS 1A,A00,187028,Staff,26,0,60,34
1683663332563,PHYS 1AL,001,187036,Staff,3,0,30,27
1683663332563,PHYS 1AL,002,187049,Staff,18,0,30,12
1683663333587,PHYS 1B,A00,187058,Staff,22,0,60,38
1683663334611,PHYS 1BL,001,187064,Staff,0,1,30,30
1683663334611,PHYS 1BL,002,187070,Staff,4,0,30,26
1683663335635,PHYS 1C,A00,187082,Staff,29,0,120,91
1683663336659,PHYS 1CL,001,187088,Staff,0,9,30,30
1683663336659,PHYS 1CL,002,187089,Staff,0,1,30,30
1683663336659,PHYS 1CL,009,262693,Staff,9,0,30,21
1683663337685,PHYS 2B,A01,187097,Staff,55,0,115,60
1683663338709,PHYS 2C,A01,187099,Staff,63,0,115,52
1683663339732,PHYS 2CL,A01,187101,Staff,5,0,28,23
1683663339732,PHYS 2CL,A02,187102,Staff,15,0,28,13
1683663340760,PHYS 2D,A01,187123,Shotwell; Brian,95,0,115,20
1683663341784,PHYS 4B,A01,187133,Grinstein; Benjamin,35,0,50,15
1683663342809,POLI 10,A00,188819,Staff,0,4,50,50
1683663343834,POLI 11,A00,188827,Staff,43,0,50,7
1683663344860,POLI 13R,A00,188828,Staff,0,1,20,20
1683663345885,POLI 27,A01,188830,Elgin; Samuel Zincke,0,2,70,70
1683663346911,POLI 30,A00,188832,Desposato; Scott,30,0,50,20
1683663347936,POLI 102F,A00,188834,Staff,0,0,40,40
1683663348961,POLI 104A,A00,188852,Staff,13,0,30,17
1683663349985,POLI 104I,A00,188853,Staff,0,7,20,20
1683663351014,POLI 110B,A00,188854,Wiens; David,6,0,20,14
1683663352039,POLI 112A,A00,188855,Wiens; David,3,0,30,27
1683663353067,POLI 117R,A00,188856,Forman; Fonna,0,12,20,20
1683663354094,POLI 118,A00,188857,Ingham; Sean,8,0,20,12
1683663355118,POLI 120G,A00,188858,Staff,8,0,30,22
1683663356145,POLI 131CR,A00,188863,Hoston; Germaine,21,0,50,29
1683663357170,POLI 133,A00,188864,Nellis; Gareth Hb,44,0,50,6
1683663358194,POLI 134D,A00,188865,Desposato; Scott,27,0,30,3
1683663359219,POLI 142A,A00,188871,Gartzke; Erik,21,0,50,29
1683663360241,POLI 142K,A00,188874,Staff,38,0,50,12
1683663361268,POLI 143,A00,188940,Gartzke; Erik,16,0,30,14
1683663362296,POLI 153,A00,188943,Staff,2,0,20,18
1683663363325,POLI 160AA,A00,188944,Staff,11,0,40,29
1683663364352,POLI 170A,A00,188945,Staff,11,0,30,19
1683663366405,PSYC 1,A00,188952,Staff,36,0,90,54
1683663367427,PSYC 2,B00,188953,Staff,19,0,35,16
1683663368450,PSYC 6,A00,188970,Staff,47,0,60,13
1683663369474,PSYC 7,A00,188973,Staff,35,0,45,10
1683663370502,PSYC 60,A01,188980,Rickard; Timothy C.,42,0,60,18
1683663371528,PSYC 70,A01,189001,Steiner; Eric Tomas,22,0,45,23
1683663372556,PSYC 100,A00,189005,Lacefield; Katharine I,0,99,120,120
1683663373580,PSYC 102,A00,189008,Staff,8,0,30,22
1683663374604,PSYC 106,B00,189026,Gorman; Michael R.,27,0,60,33
1683663375631,PSYC 114,B01,189033,Winkielman; Piotr,0,31,30,30
1683663376655,PSYC 131,A00,189036,Anagnostaras; Stephan,0,43,60,60
1683663377678,PSYC 136,A00,189041,Lowe; Angela Beth,0,7,25,25
1683663378707,PSYC 137,A00,189057,Winkielman; Piotr,0,37,25,25
1683663379740,PSYC 144,A00,189107,Wixted; John T,0,11,50,50
1683663381790,PSYC 162,A00,189142,Staff,0,9,85,85
1683663382814,PSYC 172,A00,189144,Gorman; Michael R.,0,6,30,30
1683663384864,PSYC 179,A00,189146,Lacefield; Katharine I,0,87,120,120
1683663385888,PSYC 181,A00,189147,Anagnostaras; Stephan,0,44,90,90
1683663386911,PSYC 190R,A00,189148,Barner; David A.,0,23,80,80
1683663387938,PSYC 191,A00,189275,Rickard; Timothy C.,0,10,25,25
1683663388962,PSYC 193,A00,189276,Chapman; Eddie Nathaniel,0,1,0,4
1683663389990,PSYC 193L,A01,189281,Lowe; Angela Beth,10,0,20,10
1683663389990,PSYC 193L,B01,189285,Staff,28,0,35,7
1683663391016,RELI 149,A00,187137,Rahimi; Babak,7,0,40,33
1683663392040,SE 9,A01,187315,Staff,0,2,18,18
1683663393065,SE 101B,A00,187409,Staff,24,0,30,6
1683663394089,SE 110B,A00,187444,Staff,10,0,40,30
1683663395115,SE 130B,A00,187449,Staff,31,0,40,9
1683663396138,SE 150A,A00,187516,Staff,9,0,20,11
1683663397169,SE 154,A00,187528,Staff,29,0,50,21
1683663398195,SIO 3,A01,258171,Staff,35,0,40,5
1683663399219,SIO 10,A00,187144,Cook; Geoffrey W,0,7,75,75
1683663400246,SIO 45,A00,187152,Cook; Geoffrey W,0,5,100,100
1683663401272,SIO 109R,A00,194486,Staff,0,4,20,20
1683663403320,SIO 187,A01,187233,Kacev; David,12,0,40,28
1683663404345,SOCI 1,A01,258656,Thorpe; Charles Robert,28,0,30,2
1683663404345,SOCI 1,A02,258658,Thorpe; Charles Robert,30,0,30,0
1683663404345,SOCI 1,A03,258661,Thorpe; Charles Robert,25,0,25,0
1683663404345,SOCI 1,A04,258666,Thorpe; Charles Robert,22,0,25,3
1683663404345,SOCI 1,A05,258897,Thorpe; Charles Robert,22,0,25,3
1683663404345,SOCI 1,A06,258898,Thorpe; Charles Robert,25,0,25,0
1683663405370,SOCI 30,A01,258903,Pardo Guerra; Juan Pablo,14,0,30,16
1683663406397,SOCI 102,A00,258904,Staff,9,0,25,16
1683663407420,SOCI 106,A00,258905,Staff,19,0,25,6
1683663408446,SOCI 111,A00,258907,Ribas Norris; Janet Vanesa,26,0,30,4
1683663409469,SOCI 121R,A00,258908,Pardo Guerra; Juan Pablo,8,0,30,22
1683663410495,SOCI 126,A01,203330,Staff,14,0,20,6
1683663411521,SOCI 131,A00,258909,Thorpe; Charles Robert,30,0,60,30
1683663412549,SOCI 135,A00,258910,Payne; Christine Anna,0,11,30,30
1683663413575,SOCI 157,A00,258911,Staff,12,0,30,18
1683663414602,SOCI 184,A00,258912,Staff,25,0,30,5
1683663415624,SOCI 188D,A00,258913,Staff,22,0,30,8
1683663416648,SYN 2,001,187529,Staff,9,0,16,7
1683663416648,SYN 2,002,201452,Staff,0,20,16,16
1683663416648,SYN 2,003,201469,Staff,1,0,16,15
1683663417674,SYN 100,A01,187531,Staff,0,9,20,20
1683663417674,SYN 100,B01,201491,Staff,0,10,20,20
1683663418701,TDAC 1,A00,189286,Walsh; Kim C.,3,0,20,17
1683663418701,TDAC 1,B00,189287,Harting; Carla Kelso,10,0,20,10
1683663419724,TDAC 101,A00,189300,Walsh; Kim C.,16,0,20,4
1683663419724,TDAC 101,B00,189301,Harting; Carla Kelso,18,0,20,2
1683663420747,TDAC 102,A00,189304,Basso; Beatrice,14,0,20,6
1683663421770,TDAC 108,A00,189305,Staff,18,0,20,2
1683663422798,TDDE 131,A00,189310,Staff,19,0,20,1
1683663422798,TDDE 131,B00,189314,Staff,19,0,20,1
1683663422798,TDDE 131,C00,189315,Staff,48,0,50,2
1683663422798,TDDE 131,D00,189316,Staff,14,0,15,1
1683663422798,TDDE 131,E00,204841,Staff,20,0,20,0
1683663423825,TDGE 10,A00,189289,Staff,27,0,50,23
1683663423825,TDGE 10,B00,189290,Havis; Allan,0,1,50,50
1683663424849,TDGE 11,A00,189291,Fulton; Julia,0,4,50,50
1683663424849,TDGE 11,B00,189292,Staff,20,0,25,5
1683663424849,TDGE 11,C00,260270,Staff,0,0,0,0
1683663425876,TDGE 25,A00,189294,Staff,2,0,20,18
1683663426900,TDGE 124,A00,189318,Fulton; Julia,0,8,50,50
1683663427924,TDGE 125,A00,189319,Staff,13,0,25,12
1683663427924,TDGE 125,B00,189320,Staff,23,0,25,2
1683663428947,TDGE 127,A00,189322,Havis; Allan,1,0,50,49
1683663429973,TDHT 101,A00,189323,Staff,18,0,25,7
1683663429973,TDHT 101,B00,189324,Staff,25,0,25,0
1683663430997,TDHT 102,A00,189325,Staff,49,0,50,1
1683663432084,TDMV 1,A00,189295,Arcidiacono; Kristin,20,0,30,10
1683663432084,TDMV 1,B00,189296,Caligagan; Maria T.,24,0,30,6
1683663433110,TDMV 2,A00,189297,Sammartano; Tonnie,27,0,30,3
1683663433110,TDMV 2,B00,189299,Arcidiacono; Kristin,23,0,30,7
1683663434137,TDMV 3,A00,204998,Rincon; Alicia,22,0,30,8
1683663435164,TDMV 120,A00,189458,Sammartano; Tonnie,28,0,30,2
1683663436190,TDMV 138,A00,189541,Jun; Grace Shin Hae,20,0,40,20
1683663437213,TDMV 142,A00,189717,Caligagan; Tony,25,0,30,5
1683663437213,TDMV 142,B00,189718,Caligagan; Maria T.,25,0,30,5
1683663438238,TMC 2,A01,187533,Staff,25,0,25,0
1683663438238,TMC 2,A02,187534,Staff,25,0,25,0
1683663439261,USP 1,A01,187536,Kwak; Nancy,0,16,25,25
1683663440284,USP 5,A01,187538,Staff,9,0,25,16
1683663441310,USP 101,A00,199253,Staff,0,4,0,0
1683663442334,USP 124,A00,187562,Boomhower; Matthew Charles,0,0,30,30
1683663443361,USP 138,A00,187582,Staff,20,0,25,5
1683663444385,USP 152,A01,187597,Staff,3,0,25,22
1683663445410,USP 153,A00,187598,Staff,19,0,25,6
1683663446433,USP 168,A00,187607,Kwak; Nancy,2,0,5,3
1683663447457,USP 173,A00,187619,Staff,4,0,25,21
1683663448483,USP 181,A00,187638,Staff,0,4,25,25
1683663449513,VIS 103,A00,187650,Cruz; Edwin Teddy,17,0,75,58
1683663450537,VIS 110D,A00,187669,Staff,13,0,22,9
1683663451560,VIS 127C,A00,187720,Shen; Kuiyi,68,0,146,78
1683663452584,VIS 149,A00,187731,Yoldas; Pinar,1,14,22,21
1683663453620,VIS 151,A01,188091,Staff,22,0,34,12
1683663453620,VIS 151,A02,188092,Staff,11,0,34,23
1683663454646,VIS 160B,A00,188093,Stalbaum; Brett,0,1,10,10
1683663456697,WCWP 10B,A00,201720,Staff,10,0,15,5
1683663456697,WCWP 10B,B00,201722,Staff,9,0,15,6
1683663457723,WCWP 100,A00,201725,Gagnon; Jeffrey C,0,0,2,2
1683663457723,WCWP 100,B00,201727,Staff,0,4,15,15
1683663460849,ANBI 133,A00,258401,Wilder; Linnea Lorene,34,0,40,6
1683663461876,ANBI 140,A00,258395,Hrvoj Mihic; Branka,18,0,25,7
1683663462899,ANSC 120,A00,258402,Bialecki; Jon Anthony,26,0,40,14
1683663463924,ANSC 144,A00,258400,Staff,12,0,40,28
1683663465976,ANSC 166,A00,258396,Parish; Steven Martin,156,0,175,19
1683663466999,ANSC 180,A00,193533,Staff,8,0,20,12
1683663468027,ANSC 188,A00,258397,Jassal; Aftab,34,0,40,6
1683663469051,ANTH 3,A01,258316,Staff,23,0,30,7
1683663470075,ANTH 5,A00,258394,Semendeferi; Ekaterini,16,0,20,4
1683663471104,ANTH 21,A01,258331,Staff,4,0,40,36
1683663472128,ANTH 103,A00,258398,Varma; Saiba,15,0,25,10
1683663473157,AWP 10,001,202034,Staff,0,0,0,0
1683663473157,AWP 10,002,202035,Staff,0,0,0,0
1683663473157,AWP 10,003,202036,Staff,0,0,0,0
1683663473157,AWP 10,004,202037,Staff,0,0,0,0
1683663473157,AWP 10,005,202038,Staff,0,0,0,0
1683663473157,AWP 10,006,202039,Staff,0,0,0,0
1683663473157,AWP 10,007,202040,Staff,0,0,0,0
1683663473157,AWP 10,008,202041,Staff,0,0,0,0
1683663473157,AWP 10,009,202042,Staff,0,0,0,0
1683663473157,AWP 10,010,202043,Staff,0,0,0,0
1683663473157,AWP 10,011,202044,Staff,0,0,0,0
1683663473157,AWP 10,012,202045,Staff,0,0,0,0
1683663473157,AWP 10,013,202046,Staff,0,0,0,0
1683663473157,AWP 10,014,202047,Staff,0,0,0,0
1683663473157,AWP 10,015,202048,Staff,0,0,0,0
1683663473157,AWP 10,016,202049,Staff,0,0,0,0
1683663473157,AWP 10,017,202050,Staff,0,0,0,0
1683663473157,AWP 10,018,202051,Staff,0,0,0,0
1683663473157,AWP 10,019,202052,Staff,0,0,0,0
1683663473157,AWP 10,020,202053,Staff,0,0,0,0
1683663473157,AWP 10,021,202054,Staff,0,0,0,0
1683663473157,AWP 10,022,202055,Staff,0,0,0,0
1683663473157,AWP 10,023,202056,Staff,0,0,0,0
1683663473157,AWP 10,024,202057,Staff,0,0,0,0
1683663473157,AWP 10,025,202058,Staff,0,0,0,0
1683663473157,AWP 10,026,202059,Staff,0,0,0,0
1683663474181,AWP 102,001,202032,Staff,0,0,0,0
1683663474181,AWP 102,002,202033,Staff,0,0,0,0
1683663475207,BENG 100,A01,254234,Taylor Amos; Alyssa C,31,0,40,9
1683663476231,BENG 196,001,270013,Engler; Adam J.,9999,0,9999,0
1683663477260,BICD 100R,A01,202018,Smith; Laurie,0,7,32,32
1683663477260,BICD 100R,A02,202019,Smith; Laurie,0,3,32,32
1683663477260,BICD 100R,A03,202020,Smith; Laurie,0,1,32,32
1683663477260,BICD 100R,A04,202021,Smith; Laurie,6,0,32,26
1683663477260,BICD 100R,A05,202022,Smith; Laurie,11,0,32,21
1683663478285,BICD 136,A01,193242,Gustafson-Brown; Cindy,0,2,32,32
1683663478285,BICD 136,A02,193244,Gustafson-Brown; Cindy,13,0,32,19
1683663479309,BIEB 102,A01,193249,Butler; Shannon Rhey,1,2,32,31
1683663479309,BIEB 102,A02,193251,Butler; Shannon Rhey,0,0,32,32
1683663479309,BIEB 102,A03,193253,Butler; Shannon Rhey,0,0,32,32
1683663479309,BIEB 102,A04,193255,Butler; Shannon Rhey,14,0,32,18
1683663479309,BIEB 102,A05,193265,Butler; Shannon Rhey,25,0,32,7
1683663479309,BIEB 102,A06,193269,Butler; Shannon Rhey,14,0,32,18
1683663481359,BIEB 150,A01,193274,Staff,0,0,32,32
1683663481359,BIEB 150,A02,193285,Staff,24,0,32,8
1683663482388,BIEB 194,A00,193286,Kurle; Carolyn M.,20,0,32,12
1683663483418,BILD 1,A01,192291,Staff,15,0,32,17
1683663483418,BILD 1,A02,192292,Staff,30,0,32,2
1683663483418,BILD 1,B01,192520,Reuther; Keefe,0,1,0,0
1683663483418,BILD 1,B02,192532,Reuther; Keefe,0,1,0,0
1683663484442,BILD 3,A01,192556,Butler; Shannon Rhey,0,0,32,32
1683663484442,BILD 3,A02,192581,Butler; Shannon Rhey,0,0,32,32
1683663484442,BILD 3,A03,192611,Butler; Shannon Rhey,21,0,32,11
1683663484442,BILD 3,A04,192612,Butler; Shannon Rhey,24,0,32,8
1683663484442,BILD 3,A05,192613,Butler; Shannon Rhey,26,0,32,6
1683663484442,BILD 3,A06,192679,Butler; Shannon Rhey,27,0,32,5
1683663484442,BILD 3,A07,192682,Butler; Shannon Rhey,20,0,32,12
1683663485465,BILD 4,A01,192836,Reuther; Keefe,1,0,24,23
1683663485465,BILD 4,A02,193044,Reuther; Keefe,4,0,24,20
1683663486488,BILD 10,A01,193142,Gustafson-Brown; Cindy,29,0,32,3
1683663486488,BILD 10,A02,193149,Gustafson-Brown; Cindy,31,0,32,1
1683663487516,BIMM 100,A01,193301,Staff,0,6,32,32
1683663487516,BIMM 100,A02,193312,Staff,0,7,32,32
1683663487516,BIMM 100,A03,193323,Staff,0,9,32,32
1683663488541,BIMM 101,A01,193329,McDonnell; Lisa Marie,0,4,24,24
1683663488541,BIMM 101,A02,193339,McDonnell; Lisa Marie,1,4,24,23
1683663488541,BIMM 101,B01,193354,McDonnell; Lisa Marie,0,4,24,24
1683663488541,BIMM 101,B02,193357,McDonnell; Lisa Marie,0,3,24,24
1683663489566,BIMM 110,A01,193377,Tat; John,0,11,32,32
1683663489566,BIMM 110,A02,193378,Tat; John,0,10,32,32
1683663490590,BIMM 120,A01,206116,Staff,0,0,32,32
1683663490590,BIMM 120,A02,206117,Staff,6,0,32,26
1683663490590,BIMM 120,A03,206121,Staff,21,0,32,11
1683663491615,BIPN 100,A01,193393,Park; Ji Young,0,15,32,32
1683663491615,BIPN 100,A02,193402,Park; Ji Young,0,14,32,32
1683663491615,BIPN 100,A03,193413,Park; Ji Young,0,14,32,32
1683663491615,BIPN 100,A04,193414,Park; Ji Young,0,13,32,32
1683663492639,BIPN 102,A01,193429,Staff,0,0,32,32
1683663492639,BIPN 102,A02,193438,Staff,18,0,32,14
1683663493664,BIPN 106,A01,193450,Reyes Gonzalez; Catalina,0,2,40,40
1683663494693,BIPN 134,A01,193465,Cooke; James Edward,0,0,32,32
1683663494693,BIPN 134,A02,193474,Cooke; James Edward,25,0,32,7
1683663494693,BIPN 134,A03,193485,Cooke; James Edward,29,0,32,3
1683663494693,BIPN 134,A04,193486,Cooke; James Edward,20,0,32,12
1683663494693,BIPN 134,A05,193491,Cooke; James Edward,31,0,32,1
1683663494693,BIPN 134,A06,193501,Cooke; James Edward,30,0,32,2
1683663494693,BIPN 134,A07,193510,Cooke; James Edward,29,0,32,3
1683663496747,BISP 194,A00,222522,Staff,14,0,32,18
1683663497774,CAT 124,A01,202407,Staff,19,0,25,6
1683663498802,CAT 125,A00,202408,Marchisotto; Jennifer Anne,2,0,20,18
1683663499826,CAT 125R,A00,202409,Smith; Lauryn Alissa,0,11,20,20
1683663499826,CAT 125R,B00,202410,Morales; Celeste Georgianna,0,11,20,20
1683663499826,CAT 125R,C00,202411,Irwin; Matthew Joseph,0,12,20,20
1683663500853,CENG 15,A01,204712,Yang; Kesong,0,1,0,0
1683663501880,CENG 114,A00,202070,Jahed Motlagh; Zeinab,5,0,20,15
1683663502907,CGS 105,A00,185477,Wesling; Megan E.,24,0,40,16
1683663503932,CGS 106,A00,185494,Staff,11,0,22,11
1683663504957,CGS 108,A00,185495,Staff,14,0,20,6
1683663505983,CGS 114,A00,185496,Staff,13,0,18,5
1683663507009,CGS 119,A00,185501,Staff,15,0,20,5
1683663508033,CGS 120,A00,185511,Staff,12,0,20,8
1683663509057,CHEM 4,A01,184675,Bussey; Thomas J,97,0,100,3
1683663510083,CHEM 6A,A01,184677,Staff,32,0,60,28
1683663511107,CHEM 6B,A01,184679,Staff,63,0,100,37
1683663512135,CHEM 6C,A01,184681,Bussey; Thomas J,0,0,50,50
1683663512135,CHEM 6C,A02,184682,Bussey; Thomas J,32,0,50,18
1683663513159,CHEM 40A,A01,184684,Albizati; Kim F.,34,0,100,66
1683663514184,CHEM 40B,A01,184686,Albizati; Kim F.,0,22,100,100
1683663515209,CHEM 41B,A01,184690,Staff,51,0,100,49
1683663516236,COGS 3,A01,184715,Boyle; Mary E. T.,0,27,40,40
1683663517260,COGS 14B,A01,185172,Staff,0,14,38,38
1683663518285,COGS 18,A01,184736,Staff,14,0,80,66
1683663519310,COGS 100,A01,184932,Staff,0,7,73,73
1683663520334,COGS 101A,A01,184935,Staff,0,40,30,30
1683663521358,COGS 101B,A01,184944,Staff,0,2,30,30
1683663522385,COGS 101C,A01,184946,Staff,0,10,30,30
1683663523412,COGS 102A,A01,184951,Johnson; Christine M.,2,0,40,38
1683663524443,COGS 107B,A01,184953,Mooshagian; Eric Frederick,0,51,40,40
1683663525466,COGS 118B,A01,184959,Gupta; Anjum,0,49,40,40
1683663526490,COGS 153,A00,184961,Staff,0,16,30,30
1683663527514,COGS 177,A00,184962,Staff,0,21,30,30
1683663528543,COGS 187A,A01,184969,Boyle; Mary E. T.,0,19,40,40
1683663529566,COMM 10,A01,185174,Staff,0,5,25,25
1683663529566,COMM 10,A02,185189,Staff,0,2,25,25
1683663529566,COMM 10,A03,269821,Staff,0,1,0,0
1683663530593,COMM 100B,A01,185475,Staff,0,1,0,2
1683663530593,COMM 100B,A02,185476,Staff,12,0,25,13
1683663531619,COMM 100C,A01,185314,Staff,1,0,25,24
1683663531619,COMM 100C,A02,185327,Staff,18,0,25,7
1683663532643,COMM 110M,A00,185349,Staff,0,0,40,40
1683663533669,COMM 113T,A00,185352,Staff,25,0,40,15
1683663534693,COMM 114I,A00,185353,Staff,31,0,40,9
1683663535775,COMM 131,A00,185354,Staff,17,0,30,13
1683663536804,CSE 8A,A50,185358,Cao; Yingjun,0,46,10,10
1683663537830,CSE 8B,A01,185362,Staff,0,48,50,50
1683663538855,CSE 11,A01,185416,Cao; Yingjun,0,91,10,10
1683663539881,CSE 20,A01,185445,Briones; Jor-el Thomas Caparas,4,0,25,21
1683663540906,CSE 21,A01,185447,Staff,9,0,50,41
1683663541933,CSE 101,A01,185451,Staff,0,13,50,50
1683663541933,CSE 101,B01,185453,Jones; Miles E,0,14,50,50
1683663543986,CSE 141,A01,185458,Eldon; John,16,0,100,84
1683663545014,CSE 141L,A01,185461,Eldon; John,8,0,100,92
1683663546042,CSE 142,A01,185463,Staff,34,0,60,26
1683663546042,CSE 142,B01,201355,Staff,0,7,60,60
1683663547066,CSE 142L,A01,185470,Staff,34,0,60,26
1683663547066,CSE 142L,B01,201417,Staff,0,6,60,60
1683663548093,CSE 190,A00,201433,Staff,32,0,49,17
1683663549120,DOC 1,A01,259136,Strom; Megan C.,7,0,15,8
1683663549120,DOC 1,A02,259137,Strom; Megan C.,14,0,15,1
1683663549120,DOC 1,A03,259138,Strom; Megan C.,14,0,15,1
1683663549120,DOC 1,A04,259139,Strom; Megan C.,14,0,15,1
1683663550146,DOC 100D,A00,259140,Pass; Natalye Joann,14,0,25,11
1683663551173,DSGN 1,A01,184749,Rill; Bryan,0,26,30,30
1683663552198,DSGN 100,A01,185168,Staff,0,2,25,25
1683663553220,ECE 5,A01,185626,Morris; Karcher William,0,11,0,0
1683663554247,ECE 101,A01,185628,Staff,14,0,70,56
1683663555270,ECE 107,A01,185635,Baghdadchi; Saharnaz,0,0,20,20
1683663555270,ECE 107,A02,185638,Baghdadchi; Saharnaz,2,0,20,18
1683663556292,ECE 148,A01,185647,Silberman; Jack,0,0,16,16
1683663557319,ECON 1,A01,185537,Crane; Meredith Helen,54,0,70,16
1683663558347,ECON 3,A01,185549,Crane; Meredith Helen,29,0,70,41
1683663559373,ECON 4,A01,203354,Anderson; John Charles,0,5,10,10
1683663560399,ECON 100A,A01,185574,Staff,0,5,40,40
1683663561423,ECON 100B,A01,185576,Staff,0,12,50,50
1683663562449,ECON 100C,A01,185589,Newhouse; Herbert S,30,0,70,40
1683663563473,ECON 105,A00,185608,Vespa; Emanuel Ignacio,19,0,35,16
1683663564497,ECON 109,A01,185610,Shishkin; Denis,9,0,35,26
1683663565524,ECON 110A,A01,185612,Staff,9,0,40,31
1683663566549,ECON 120A,A01,185615,Staff,20,0,40,20
1683663567573,ECON 120C,A01,185617,Sun; Yixiao,0,20,70,70
1683663568597,ECON 144,A00,203346,Squires; Dale E,2,0,35,33
1683663569620,ECON 171,A01,203349,Newhouse; Herbert S,0,1,35,35
1683663570649,ECON 173A,A01,185621,Toda; Alexis Akira,20,0,35,15
1683663571673,EDS 25,A01,202413,Staff,0,1,0,0
1683663571673,EDS 25,A02,202414,Staff,0,1,0,0
1683663571673,EDS 25,A03,202415,Staff,0,0,0,0
1683663571673,EDS 25,A04,202416,Staff,0,1,0,0
1683663571673,EDS 25,A05,202439,Staff,0,0,0,0
1683663571673,EDS 25,A06,202440,Staff,0,0,0,0
1683663571673,EDS 25,B01,202631,Staff,0,0,0,0
1683663571673,EDS 25,B02,202632,Staff,0,0,0,0
1683663571673,EDS 25,B03,202639,Staff,0,0,0,0
1683663571673,EDS 25,B04,202640,Staff,0,0,0,0
1683663571673,EDS 25,B05,202643,Staff,0,0,0,0
1683663571673,EDS 25,B06,202644,Staff,0,0,0,0
1683663572696,EDS 38,A01,202659,Black; Alison Michelle,24,0,25,1
1683663573723,EDS 115,A00,202652,Staff,18,0,30,12
1683663574750,EDS 125,A00,202649,Staff,13,0,30,17
1683663575773,EDS 126,A01,203332,Staff,30,0,30,0
1683663576799,EDS 139,A00,202838,Staff,16,0,25,9
1683663577826,EDS 146,A01,202655,Staff,14,0,25,11
1683663578854,ENG 15,A00,185667,Staff,0,1,0,0
1683663578854,ENG 15,B00,185672,Staff,0,0,0,0
1683663578854,ENG 15,C00,185675,Staff,0,0,0,0
1683663578854,ENG 15,D00,185682,Staff,0,0,0,0
1683663578854,ENG 15,E00,185684,Staff,0,0,0,0
1683663579878,ETHN 103,A00,185710,Staff,0,8,35,35
1683663580902,ETHN 103A,A00,199228,Man; Simeon S,0,0,9,9
1683663581924,ETHN 109,A00,185711,Staff,15,0,35,20
1683663582950,ETHN 142,A00,185726,Staff,0,4,30,30
1683663583973,ETHN 163J,A00,199229,Man; Simeon S,5,0,8,3
1683663584997,ETHN 168,A00,185727,Staff,7,0,10,3
1683663586022,ETHN 182,A00,185728,Staff,0,0,35,35
1683663587045,ETHN 183,A00,185737,Staff,9,0,18,9
1683663588074,GLBH 111,A01,209361,Burgos; Jose L.,0,0,0,0
1683663590129,HIEU 104,A00,185792,Staff,14,0,20,6
1683663591156,HIEU 115,A00,185800,Staff,0,0,20,20
1683663592178,HIEU 128,A00,185801,Staff,0,9,20,20
1683663593201,HIEU 147,A00,185802,Staff,15,0,20,5
1683663594227,HIEU 154,A00,185823,Staff,11,0,20,9
1683663595249,HILA 102,A00,185826,Staff,14,0,20,6
1683663596275,HILD 2C,A01,185778,Staff,0,13,20,20
1683663597301,HILD 7B,A01,185780,Kwak; Nancy,0,17,32,32
1683663597301,HILD 7B,A02,185781,Kwak; Nancy,0,18,32,32
1683663598327,HILD 30,A01,185791,Staff,12,0,20,8
1683663599349,HISC 119,A00,185830,Golan; Tal,0,9,20,20
1683663600379,HITO 156GS,A00,185831,Patterson; Patrick H.,0,0,0,23
1683663601403,HIUS 103,A00,185832,Man; Simeon S,0,4,20,20
1683663602429,HIUS 117,A00,185836,Kwak; Nancy,2,0,20,18
1683663603456,HIUS 125,A00,185840,Man; Simeon S,0,2,23,23
1683663604478,HIUS 149,A00,185845,Staff,1,0,20,19
1683663605501,HUM 3,A01,185882,Zavodny; Tatiana Sophia,0,8,50,50
1683663605501,HUM 3,B01,185899,Caldwell; Michael Alan,0,18,50,50
1683663606526,HUM 3GS,A00,185900,Patterson; Patrick H.,0,0,0,23
1683663607551,HUM 4,A01,185938,Zroka; Amy Liane,29,0,50,21
1683663607551,HUM 4,B01,185956,Watkins; Eric,0,4,50,50
1683663607551,HUM 4,B02,202209,Watkins; Eric,0,5,50,50
1683663607551,HUM 4,B03,202210,Watkins; Eric,0,5,50,50
1683663608578,HUM 5,A01,185958,West; Geoffrey Scott,0,0,50,50
1683663608578,HUM 5,A02,202215,West; Geoffrey Scott,0,0,50,50
1683663609601,INTL 190,A00,185959,Gagnon; Jeffrey C,0,0,0,9
1683663609601,INTL 190,B00,185960,Lettieri; Michael Joseph,0,0,0,2
1683663610630,JAPN 180,A00,254509,Staff,5,0,30,25
1683663611654,LATI 10,A01,202853,Kennemore; Amy Michelle,4,0,35,31
1683663611654,LATI 10,A02,202854,Kennemore; Amy Michelle,2,0,35,33
1683663611654,LATI 10,A03,270054,Kennemore; Amy Michelle,30,0,30,0
1683663612677,LATI 180,A00,202855,Kennemore; Amy Michelle,11,0,20,9
1683663613701,LAWS 101,A00,201767,Golan; Tal,0,7,40,40
1683663614725,LIFR 1C,A00,185961,Staff,6,0,20,14
1683663615750,LIFR 1CX,A00,185962,Staff,7,0,20,13
1683663616777,LIFR 1D,A00,185963,Staff,7,0,20,13
1683663617804,LIFR 1DX,A00,185964,Staff,7,0,20,13
1683663618831,LIGN 101,A01,186039,Staff,43,0,50,7
1683663619858,LIGN 165,A00,186040,Staff,15,0,50,35
1683663620884,LTCS 108,A00,186041,Staff,5,0,10,5
1683663621908,LTCS 119,A00,186042,Staff,15,0,20,5
1683663622931,LTCS 130,A00,186043,Wesling; Megan E.,15,0,25,10
1683663624980,LTEA 138,A00,186119,Staff,14,0,40,26
1683663626007,LTEN 124,A00,186148,Staff,5,0,25,20
1683663627031,LTEN 178,A00,186149,Staff,7,0,15,8
1683663628055,LTEN 181,A00,186150,Blanco; John D,34,0,40,6
1683663629081,LTWL 120,A00,186160,Staff,20,0,25,5
1683663630105,LTWL 165,A00,186161,Staff,22,0,25,3
1683663631131,LTWR 100,A00,186162,Staff,0,5,15,15
1683663632158,LTWR 102,A00,186163,Doller; Ben,5,0,15,10
1683663633182,MAE 8,A01,186412,Staff,0,0,0,0
1683663634210,MAE 30B,A00,186445,Bahadori; Mohammad Yousef,82,0,100,18
1683663635237,MAE 40,A00,186592,Bewley; Thomas R,10,0,50,40
1683663636261,MAE 101B,A00,186593,Bahadori; Mohammad Yousef,80,0,100,20
1683663637285,MAE 105,A00,186594,Bandaru; Prabhakar,10,0,50,40
1683663638309,MAE 107,A00,186599,Pham; Hieu Tan,0,7,120,120
1683663639411,MAE 148,A01,186660,Silberman; Jack,3,0,16,13
1683663640435,MATH 10A,A01,188095,Staff,0,6,35,35
1683663641461,MATH 10B,A01,188097,Bowers; Adam R.,0,12,30,30
1683663641461,MATH 10B,A02,188099,Bowers; Adam R.,0,11,30,30
1683663641461,MATH 10B,B01,188104,Bowers; Adam R.,0,10,30,30
1683663641461,MATH 10B,B02,188106,Bowers; Adam R.,1,9,30,29
1683663642491,MATH 10C,A01,188111,Staff,0,18,30,30
1683663642491,MATH 10C,A02,188127,Staff,0,19,30,30
1683663642491,MATH 10C,A03,188131,Staff,0,19,30,30
1683663642491,MATH 10C,B01,188218,Staff,17,0,30,13
1683663642491,MATH 10C,B02,188244,Staff,13,0,30,17
1683663642491,MATH 10C,B03,188277,Staff,14,0,30,16
1683663643518,MATH 18,A01,188344,Bach; Quang Tran,18,0,30,12
1683663643518,MATH 18,A02,188345,Bach; Quang Tran,11,0,30,19
1683663643518,MATH 18,B01,188353,Bach; Quang Tran,11,0,30,19
1683663643518,MATH 18,B02,188354,Bach; Quang Tran,19,0,30,11
1683663644541,MATH 20A,A01,188374,Staff,11,0,35,24
1683663645569,MATH 20B,A01,188382,Ohm; Ko Woon,7,0,30,23
1683663645569,MATH 20B,A02,188383,Ohm; Ko Woon,22,0,30,8
1683663645569,MATH 20B,B01,188385,Ohm; Ko Woon,7,0,30,23
1683663645569,MATH 20B,B02,188392,Ohm; Ko Woon,22,0,30,8
1683663646597,MATH 20C,A01,188394,Harel; Guershon,10,0,30,20
1683663646597,MATH 20C,A02,188395,Harel; Guershon,13,0,30,17
1683663646597,MATH 20C,B01,188404,Harel; Guershon,5,0,30,25
1683663646597,MATH 20C,B02,188405,Harel; Guershon,18,0,30,12
1683663647622,MATH 20D,A01,188414,Hammock; Frances H,0,1,30,30
1683663647622,MATH 20D,A02,188415,Hammock; Frances H,0,1,30,30
1683663647622,MATH 20D,B01,188447,Hammock; Frances H,0,1,30,30
1683663647622,MATH 20D,B02,188486,Hammock; Frances H,3,0,30,27
1683663648649,MATH 20E,A01,188649,Staff,21,0,30,9
1683663648649,MATH 20E,A02,188650,Staff,21,0,30,9
1683663648649,MATH 20E,A03,188673,Staff,0,0,30,30
1683663649673,MATH 102,A01,188675,Staff,0,36,35,35
1683663650701,MATH 103B,A01,188681,Staff,3,0,35,32
1683663650701,MATH 103B,B01,188692,Staff,5,0,35,30
1683663651725,MATH 109,A01,188695,Salehi Golsefidy; Alireza,24,0,35,11
1683663651725,MATH 109,A02,188696,Salehi Golsefidy; Alireza,25,0,35,10
1683663652750,MATH 120A,A01,188698,Eggers; John Dietrich,7,0,35,28
1683663653781,MATH 142B,A01,188736,Ioana; Adrian,1,1,30,29
1683663653781,MATH 142B,A02,188741,Ioana; Adrian,0,1,30,30
1683663653781,MATH 142B,A03,188743,Ioana; Adrian,0,1,30,30
1683663654814,MATH 168A,A01,188790,Staff,0,10,35,35
1683663655843,MATH 170A,A01,188803,Nie; Jiawang,0,2,35,35
1683663655843,MATH 170A,A02,188811,Nie; Jiawang,0,0,35,35
1683663655843,MATH 170A,A03,188814,Nie; Jiawang,0,0,35,35
1683663655843,MATH 170A,A04,188815,Nie; Jiawang,9,0,35,26
1683663656870,MATH 193B,A01,188817,Staff,0,0,35,35
1683663656870,MATH 193B,A02,188818,Staff,5,0,35,30
1683663657897,MGT 4,A01,202857,Anderson; John Charles,61,0,80,19
1683663658923,MGT 12,A00,202858,Lindenberger; Wade Douglas,40,0,90,50
1683663659947,MGT 18,A00,202859,Staff,74,0,90,16
1683663660971,MGT 18GS,A00,202860,McKay; Michael J,13,0,28,15
1683663661998,MGT 45,A00,202861,Pecore; Joseph P.,11,0,90,79
1683663663022,MGT 100,A00,202863,Yavorsky; Daniel Ryan,28,0,90,62
1683663664044,MGT 103,A00,202864,Ehrich; Kristine R,0,18,90,90
1683663665069,MGT 112,A00,202865,Ehrich; Kristine R,14,0,90,76
1683663666096,MGT 121A,A00,202868,Staff,90,20,90,0
1683663667122,MGT 131B,A00,202869,Anderson; John Charles,59,0,90,31
1683663668149,MGT 136,A00,202871,Lindenberger; Wade Douglas,83,0,90,7
1683663669179,MGT 164,A00,202873,Staff,0,67,90,91
1683663670208,MGT 164GS,A00,202874,McKay; Mary A,13,0,28,15
1683663671234,MGT 180,A00,202875,Staff,0,51,90,91
1683663672260,MMW 11R,A01,205019,Herbst; Matthew,1,0,30,29
1683663672260,MMW 11R,A02,205026,Herbst; Matthew,29,0,30,1
1683663673288,MMW 15,A01,193512,Chang; Edmond Yi-Teh,0,8,28,28
1683663673288,MMW 15,A02,193513,Chang; Edmond Yi-Teh,0,5,28,28
1683663673288,MMW 15,A03,193514,Chang; Edmond Yi-Teh,0,5,28,28
1683663673288,MMW 15,A04,193515,Chang; Edmond Yi-Teh,0,5,28,28
1683663673288,MMW 15,A05,193516,Chang; Edmond Yi-Teh,0,5,28,28
1683663673288,MMW 15,A06,193517,Chang; Edmond Yi-Teh,0,6,28,28
1683663673288,MMW 15,B01,193519,Chang; Edmond Yi-Teh,0,5,28,28
1683663673288,MMW 15,B02,193520,Chang; Edmond Yi-Teh,0,5,28,28
1683663673288,MMW 15,B03,193521,Chang; Edmond Yi-Teh,0,5,28,28
1683663673288,MMW 15,B04,193522,Chang; Edmond Yi-Teh,0,5,28,28
1683663673288,MMW 15,B05,193523,Chang; Edmond Yi-Teh,0,5,28,28
1683663673288,MMW 15,B06,193524,Chang; Edmond Yi-Teh,0,5,28,28
1683663674312,MMW 122,A01,193526,Rahimi; Babak,0,16,28,28
1683663674312,MMW 122,A02,193527,Rahimi; Babak,0,15,28,28
1683663674312,MMW 122,A03,193528,Rahimi; Babak,0,0,0,0
1683663674312,MMW 122,A04,193529,Rahimi; Babak,0,0,0,0
1683663675339,MUS 1A,A01,186663,Staff,1,20,35,34
1683663676363,MUS 4,A01,186715,Staff,0,12,35,35
1683663677390,MUS 5R,A01,186796,Dubnov; Shlomo,0,17,35,35
1683663678413,MUS 6,A01,186798,Staff,0,5,25,25
1683663679436,MUS 7,A01,186830,Staff,11,0,35,24
1683663680463,MUS 8,A01,186930,Staff,0,26,35,35
1683663681489,MUS 15,A01,186932,Staff,0,16,35,35
1683663681489,MUS 15,B01,186934,Staff,1,17,35,34
1683663682513,MUS 80,A00,186935,Staff,0,0,20,20
1683663682513,MUS 80,B00,186936,Staff,24,0,25,1
1683663683537,NANO 11,A00,204702,Lipomi; Darren John,0,0,0,0
1683663684561,NANO 15,A01,204709,Yang; Kesong,0,1,0,0
1683663685583,NANO 114,A00,202069,Jahed Motlagh; Zeinab,3,0,10,7
1683663686607,PHIL 1,A00,186955,Grush; Rick Scott,31,0,40,9
1683663687631,PHIL 10,A01,186973,Grush; Rick Scott,27,0,35,8
1683663687631,PHIL 10,A02,186974,Grush; Rick Scott,33,0,35,2
1683663688655,PHIL 13,A01,186976,Staff,3,0,35,32
1683663688655,PHIL 13,A02,186977,Staff,16,0,35,19
1683663689682,PHIL 14,A01,186979,Staff,31,0,35,4
1683663689682,PHIL 14,A02,186986,Staff,32,0,35,3
1683663690708,PHIL 28,A01,186988,Staff,16,0,30,14
1683663690708,PHIL 28,A02,186989,Staff,1,0,30,29
1683663690708,PHIL 28,A03,186990,Staff,10,0,30,20
1683663690708,PHIL 28,A04,186991,Staff,26,0,30,4
1683663691731,PHIL 120,A00,186997,Staff,23,0,40,17
1683663692756,PHIL 137,A00,187003,Staff,7,0,40,33
1683663693782,PHIL 150,A00,187015,Staff,47,0,70,23
1683663694806,PHIL 167,A00,187021,Lamey; Andy M.,34,0,40,6
1683663695833,PHIL 174,A01,202226,Staff,17,0,20,3
1683663695833,PHIL 174,A02,202235,Staff,20,0,20,0
1683663696858,PHIL 191A,A00,258918,Staff,0,0,1,1
1683663697885,PHYS 1A,A00,187028,Staff,26,0,60,34
1683663698912,PHYS 1AL,001,187036,Staff,3,0,30,27
1683663698912,PHYS 1AL,002,187049,Staff,18,0,30,12
1683663699936,PHYS 1B,A00,187058,Staff,22,0,60,38
1683663700959,PHYS 1BL,001,187064,Staff,0,1,30,30
1683663700959,PHYS 1BL,002,187070,Staff,4,0,30,26
1683663701986,PHYS 1C,A00,187082,Staff,29,0,120,91
1683663703010,PHYS 1CL,001,187088,Staff,0,9,30,30
1683663703010,PHYS 1CL,002,187089,Staff,0,1,30,30
1683663703010,PHYS 1CL,009,262693,Staff,9,0,30,21
1683663704034,PHYS 2B,A01,187097,Staff,55,0,115,60
1683663705061,PHYS 2C,A01,187099,Staff,63,0,115,52
1683663706089,PHYS 2CL,A01,187101,Staff,5,0,28,23
1683663706089,PHYS 2CL,A02,187102,Staff,15,0,28,13
1683663707114,PHYS 2D,A01,187123,Shotwell; Brian,95,0,115,20
1683663708142,PHYS 4B,A01,187133,Grinstein; Benjamin,35,0,50,15
1683663709164,POLI 10,A00,188819,Staff,0,4,50,50
1683663710187,POLI 11,A00,188827,Staff,43,0,50,7
1683663711210,POLI 13R,A00,188828,Staff,0,1,20,20
1683663712234,POLI 27,A01,188830,Elgin; Samuel Zincke,0,2,70,70
1683663713257,POLI 30,A00,188832,Desposato; Scott,30,0,50,20
1683663714285,POLI 102F,A00,188834,Staff,0,0,40,40
1683663715312,POLI 104A,A00,188852,Staff,13,0,30,17
1683663716335,POLI 104I,A00,188853,Staff,0,7,20,20
1683663717361,POLI 110B,A00,188854,Wiens; David,6,0,20,14
1683663718388,POLI 112A,A00,188855,Wiens; David,3,0,30,27
1683663719412,POLI 117R,A00,188856,Forman; Fonna,0,12,20,20
1683663720435,POLI 118,A00,188857,Ingham; Sean,8,0,20,12
1683663721461,POLI 120G,A00,188858,Staff,8,0,30,22
1683663722485,POLI 131CR,A00,188863,Hoston; Germaine,21,0,50,29
1683663723512,POLI 133,A00,188864,Nellis; Gareth Hb,44,0,50,6
1683663724536,POLI 134D,A00,188865,Desposato; Scott,27,0,30,3
1683663725560,POLI 142A,A00,188871,Gartzke; Erik,21,0,50,29
1683663726589,POLI 142K,A00,188874,Staff,38,0,50,12
1683663727612,POLI 143,A00,188940,Gartzke; Erik,16,0,30,14
1683663728635,POLI 153,A00,188943,Staff,2,0,20,18
1683663729662,POLI 160AA,A00,188944,Staff,11,0,40,29
1683663730689,POLI 170A,A00,188945,Staff,11,0,30,19
1683663732743,PSYC 1,A00,188952,Staff,36,0,90,54
1683663733767,PSYC 2,B00,188953,Staff,19,0,35,16
1683663734794,PSYC 6,A00,188970,Staff,47,0,60,13
1683663735820,PSYC 7,A00,188973,Staff,35,0,45,10
1683663736845,PSYC 60,A01,188980,Rickard; Timothy C.,42,0,60,18
1683663737873,PSYC 70,A01,189001,Steiner; Eric Tomas,22,0,45,23
1683663738901,PSYC 100,A00,189005,Lacefield; Katharine I,0,99,120,120
1683663739924,PSYC 102,A00,189008,Staff,8,0,30,22
1683663740947,PSYC 106,B00,189026,Gorman; Michael R.,27,0,60,33
1683663741975,PSYC 114,B01,189033,Winkielman; Piotr,0,31,30,30
1683663743058,PSYC 131,A00,189036,Anagnostaras; Stephan,0,43,60,60
1683663744082,PSYC 136,A00,189041,Lowe; Angela Beth,0,7,25,25
1683663745108,PSYC 137,A00,189057,Winkielman; Piotr,0,37,25,25
1683663746135,PSYC 144,A00,189107,Wixted; John T,0,11,50,50
1683663748184,PSYC 162,A00,189142,Staff,0,9,85,85
1683663749212,PSYC 172,A00,189144,Gorman; Michael R.,0,6,30,30
1683663751259,PSYC 179,A00,189146,Lacefield; Katharine I,0,87,120,120
1683663752283,PSYC 181,A00,189147,Anagnostaras; Stephan,0,44,90,90
1683663753310,PSYC 190R,A00,189148,Barner; David A.,0,23,80,80
1683663754333,PSYC 191,A00,189275,Rickard; Timothy C.,0,10,25,25
1683663755359,PSYC 193,A00,189276,Chapman; Eddie Nathaniel,0,1,0,4
1683663756384,PSYC 193L,A01,189281,Lowe; Angela Beth,10,0,20,10
1683663756384,PSYC 193L,B01,189285,Staff,28,0,35,7
1683663757407,RELI 149,A00,187137,Rahimi; Babak,7,0,40,33
1683663758431,SE 9,A01,187315,Staff,0,2,18,18
1683663759458,SE 101B,A00,187409,Staff,24,0,30,6
1683663760480,SE 110B,A00,187444,Staff,10,0,40,30
1683663761505,SE 130B,A00,187449,Staff,31,0,40,9
1683663762531,SE 150A,A00,187516,Staff,9,0,20,11
1683663763555,SE 154,A00,187528,Staff,29,0,50,21
1683663764579,SIO 3,A01,258171,Staff,35,0,40,5
1683663765605,SIO 10,A00,187144,Cook; Geoffrey W,0,7,75,75
1683663766628,SIO 45,A00,187152,Cook; Geoffrey W,0,5,100,100
1683663767652,SIO 109R,A00,194486,Staff,0,4,20,20
1683663769700,SIO 187,A01,187233,Kacev; David,12,0,40,28
1683663770729,SOCI 1,A01,258656,Thorpe; Charles Robert,28,0,30,2
1683663770729,SOCI 1,A02,258658,Thorpe; Charles Robert,30,0,30,0
1683663770729,SOCI 1,A03,258661,Thorpe; Charles Robert,25,0,25,0
1683663770729,SOCI 1,A04,258666,Thorpe; Charles Robert,22,0,25,3
1683663770729,SOCI 1,A05,258897,Thorpe; Charles Robert,22,0,25,3
1683663770729,SOCI 1,A06,258898,Thorpe; Charles Robert,25,0,25,0
1683663771757,SOCI 30,A01,258903,Pardo Guerra; Juan Pablo,14,0,30,16
1683663772782,SOCI 102,A00,258904,Staff,9,0,25,16
1683663773810,SOCI 106,A00,258905,Staff,19,0,25,6
1683663774833,SOCI 111,A00,258907,Ribas Norris; Janet Vanesa,26,0,30,4
1683663775857,SOCI 121R,A00,258908,Pardo Guerra; Juan Pablo,8,0,30,22
1683663776882,SOCI 126,A01,203330,Staff,14,0,20,6
1683663777904,SOCI 131,A00,258909,Thorpe; Charles Robert,30,0,60,30
1683663778932,SOCI 135,A00,258910,Payne; Christine Anna,0,11,30,30
1683663779955,SOCI 157,A00,258911,Staff,12,0,30,18
1683663780978,SOCI 184,A00,258912,Staff,25,0,30,5
1683663782001,SOCI 188D,A00,258913,Staff,22,0,30,8
1683663783038,SYN 2,001,187529,Staff,9,0,16,7
1683663783038,SYN 2,002,201452,Staff,0,20,16,16
1683663783038,SYN 2,003,201469,Staff,1,0,16,15
1683663784067,SYN 100,A01,187531,Staff,0,9,20,20
1683663784067,SYN 100,B01,201491,Staff,0,10,20,20
1683663785090,TDAC 1,A00,189286,Walsh; Kim C.,3,0,20,17
1683663785090,TDAC 1,B00,189287,Harting; Carla Kelso,10,0,20,10
1683663786118,TDAC 101,A00,189300,Walsh; Kim C.,16,0,20,4
1683663786118,TDAC 101,B00,189301,Harting; Carla Kelso,18,0,20,2
1683663787145,TDAC 102,A00,189304,Basso; Beatrice,14,0,20,6
1683663788171,TDAC 108,A00,189305,Staff,18,0,20,2
1683663789201,TDDE 131,A00,189310,Staff,19,0,20,1
1683663789201,TDDE 131,B00,189314,Staff,19,0,20,1
1683663789201,TDDE 131,C00,189315,Staff,48,0,50,2
1683663789201,TDDE 131,D00,189316,Staff,14,0,15,1
1683663789201,TDDE 131,E00,204841,Staff,20,0,20,0
1683663790228,TDGE 10,A00,189289,Staff,27,0,50,23
1683663790228,TDGE 10,B00,189290,Havis; Allan,0,1,50,50
1683663791253,TDGE 11,A00,189291,Fulton; Julia,0,4,50,50
1683663791253,TDGE 11,B00,189292,Staff,20,0,25,5
1683663791253,TDGE 11,C00,260270,Staff,0,0,0,0
1683663792279,TDGE 25,A00,189294,Staff,2,0,20,18
1683663793301,TDGE 124,A00,189318,Fulton; Julia,0,8,50,50
1683663794324,TDGE 125,A00,189319,Staff,13,0,25,12
1683663794324,TDGE 125,B00,189320,Staff,23,0,25,2
1683663795352,TDGE 127,A00,189322,Havis; Allan,1,0,50,49
1683663796376,TDHT 101,A00,189323,Staff,18,0,25,7
1683663796376,TDHT 101,B00,189324,Staff,25,0,25,0
1683663797399,TDHT 102,A00,189325,Staff,49,0,50,1
1683663798428,TDMV 1,A00,189295,Arcidiacono; Kristin,20,0,30,10
1683663798428,TDMV 1,B00,189296,Caligagan; Maria T.,24,0,30,6
1683663799452,TDMV 2,A00,189297,Sammartano; Tonnie,27,0,30,3
1683663799452,TDMV 2,B00,189299,Arcidiacono; Kristin,23,0,30,7
1683663800479,TDMV 3,A00,204998,Rincon; Alicia,22,0,30,8
1683663801504,TDMV 120,A00,189458,Sammartano; Tonnie,28,0,30,2
1683663802528,TDMV 138,A00,189541,Jun; Grace Shin Hae,20,0,40,20
1683663803553,TDMV 142,A00,189717,Caligagan; Tony,25,0,30,5
1683663803553,TDMV 142,B00,189718,Caligagan; Maria T.,25,0,30,5
1683663804577,TMC 2,A01,187533,Staff,25,0,25,0
1683663804577,TMC 2,A02,187534,Staff,25,0,25,0
1683663805601,USP 1,A01,187536,Kwak; Nancy,0,16,25,25
1683663806627,USP 5,A01,187538,Staff,9,0,25,16
1683663807655,USP 101,A00,199253,Staff,0,4,0,0
1683663808683,USP 124,A00,187562,Boomhower; Matthew Charles,0,0,30,30
1683663809706,USP 138,A00,187582,Staff,20,0,25,5
1683663810731,USP 152,A01,187597,Staff,3,0,25,22
1683663811757,USP 153,A00,187598,Staff,19,0,25,6
1683663812781,USP 168,A00,187607,Kwak; Nancy,2,0,5,3
1683663813805,USP 173,A00,187619,Staff,4,0,25,21
1683663814830,USP 181,A00,187638,Staff,0,4,25,25
1683663815856,VIS 103,A00,187650,Cruz; Edwin Teddy,17,0,75,58
1683663816883,VIS 110D,A00,187669,Staff,13,0,22,9
1683663817909,VIS 127C,A00,187720,Shen; Kuiyi,68,0,146,78
1683663818933,VIS 149,A00,187731,Yoldas; Pinar,1,14,22,21
1683663819959,VIS 151,A01,188091,Staff,22,0,34,12
1683663819959,VIS 151,A02,188092,Staff,11,0,34,23
1683663820985,VIS 160B,A00,188093,Stalbaum; Brett,0,1,10,10
1683663823033,WCWP 10B,A00,201720,Staff,10,0,15,5
1683663823033,WCWP 10B,B00,201722,Staff,9,0,15,6
1683663824060,WCWP 100,A00,201725,Gagnon; Jeffrey C,0,0,2,2
1683663824060,WCWP 100,B00,201727,Staff,0,4,15,15
1683663827146,ANBI 133,A00,258401,Wilder; Linnea Lorene,34,0,40,6
1683663828170,ANBI 140,A00,258395,Hrvoj Mihic; Branka,18,0,25,7
1683663829193,ANSC 120,A00,258402,Bialecki; Jon Anthony,26,0,40,14
1683663830221,ANSC 144,A00,258400,Staff,12,0,40,28
1683663832277,ANSC 166,A00,258396,Parish; Steven Martin,156,0,175,19
1683663833301,ANSC 180,A00,193533,Staff,8,0,20,12
1683663834328,ANSC 188,A00,258397,Jassal; Aftab,34,0,40,6
1683663835350,ANTH 3,A01,258316,Staff,23,0,30,7
1683663836375,ANTH 5,A00,258394,Semendeferi; Ekaterini,16,0,20,4
1683663837400,ANTH 21,A01,258331,Staff,4,0,40,36
1683663838427,ANTH 103,A00,258398,Varma; Saiba,15,0,25,10
1683663839460,AWP 10,001,202034,Staff,0,0,0,0
1683663839460,AWP 10,002,202035,Staff,0,0,0,0
1683663839460,AWP 10,003,202036,Staff,0,0,0,0
1683663839460,AWP 10,004,202037,Staff,0,0,0,0
1683663839460,AWP 10,005,202038,Staff,0,0,0,0
1683663839460,AWP 10,006,202039,Staff,0,0,0,0
1683663839460,AWP 10,007,202040,Staff,0,0,0,0
1683663839460,AWP 10,008,202041,Staff,0,0,0,0
1683663839460,AWP 10,009,202042,Staff,0,0,0,0
1683663839460,AWP 10,010,202043,Staff,0,0,0,0
1683663839460,AWP 10,011,202044,Staff,0,0,0,0
1683663839460,AWP 10,012,202045,Staff,0,0,0,0
1683663839460,AWP 10,013,202046,Staff,0,0,0,0
1683663839460,AWP 10,014,202047,Staff,0,0,0,0
1683663839460,AWP 10,015,202048,Staff,0,0,0,0
1683663839460,AWP 10,016,202049,Staff,0,0,0,0
1683663839460,AWP 10,017,202050,Staff,0,0,0,0
1683663839460,AWP 10,018,202051,Staff,0,0,0,0
1683663839460,AWP 10,019,202052,Staff,0,0,0,0
1683663839460,AWP 10,020,202053,Staff,0,0,0,0
1683663839460,AWP 10,021,202054,Staff,0,0,0,0
1683663839460,AWP 10,022,202055,Staff,0,0,0,0
1683663839460,AWP 10,023,202056,Staff,0,0,0,0
1683663839460,AWP 10,024,202057,Staff,0,0,0,0
1683663839460,AWP 10,025,202058,Staff,0,0,0,0
1683663839460,AWP 10,026,202059,Staff,0,0,0,0
1683663840486,AWP 102,001,202032,Staff,0,0,0,0
1683663840486,AWP 102,002,202033,Staff,0,0,0,0
1683663841534,BENG 100,A01,254234,Taylor Amos; Alyssa C,31,0,40,9
1683663842561,BENG 196,001,270013,Engler; Adam J.,9999,0,9999,0
1683663843589,BICD 100R,A01,202018,Smith; Laurie,0,7,32,32
1683663843589,BICD 100R,A02,202019,Smith; Laurie,0,3,32,32
1683663843589,BICD 100R,A03,202020,Smith; Laurie,0,1,32,32
1683663843589,BICD 100R,A04,202021,Smith; Laurie,6,0,32,26
1683663843589,BICD 100R,A05,202022,Smith; Laurie,11,0,32,21
1683663844614,BICD 136,A01,193242,Gustafson-Brown; Cindy,0,2,32,32
1683663844614,BICD 136,A02,193244,Gustafson-Brown; Cindy,13,0,32,19
1683663845643,BIEB 102,A01,193249,Butler; Shannon Rhey,1,2,32,31
1683663845643,BIEB 102,A02,193251,Butler; Shannon Rhey,0,0,32,32
1683663845643,BIEB 102,A03,193253,Butler; Shannon Rhey,0,0,32,32
1683663845643,BIEB 102,A04,193255,Butler; Shannon Rhey,14,0,32,18
1683663845643,BIEB 102,A05,193265,Butler; Shannon Rhey,25,0,32,7
1683663845643,BIEB 102,A06,193269,Butler; Shannon Rhey,14,0,32,18
1683663847755,BIEB 150,A01,193274,Staff,0,0,32,32
1683663847755,BIEB 150,A02,193285,Staff,24,0,32,8
1683663848778,BIEB 194,A00,193286,Kurle; Carolyn M.,20,0,32,12
1683663849803,BILD 1,A01,192291,Staff,15,0,32,17
1683663849803,BILD 1,A02,192292,Staff,30,0,32,2
1683663849803,BILD 1,B01,192520,Reuther; Keefe,0,1,0,0
1683663849803,BILD 1,B02,192532,Reuther; Keefe,0,1,0,0
1683663850829,BILD 3,A01,192556,Butler; Shannon Rhey,0,0,32,32
1683663850829,BILD 3,A02,192581,Butler; Shannon Rhey,0,0,32,32
1683663850829,BILD 3,A03,192611,Butler; Shannon Rhey,21,0,32,11
1683663850829,BILD 3,A04,192612,Butler; Shannon Rhey,24,0,32,8
1683663850829,BILD 3,A05,192613,Butler; Shannon Rhey,26,0,32,6
1683663850829,BILD 3,A06,192679,Butler; Shannon Rhey,27,0,32,5
1683663850829,BILD 3,A07,192682,Butler; Shannon Rhey,20,0,32,12
1683663851858,BILD 4,A01,192836,Reuther; Keefe,1,0,24,23
1683663851858,BILD 4,A02,193044,Reuther; Keefe,4,0,24,20
1683663852886,BILD 10,A01,193142,Gustafson-Brown; Cindy,29,0,32,3
1683663852886,BILD 10,A02,193149,Gustafson-Brown; Cindy,31,0,32,1
1683663853911,BIMM 100,A01,193301,Staff,0,6,32,32
1683663853911,BIMM 100,A02,193312,Staff,0,7,32,32
1683663853911,BIMM 100,A03,193323,Staff,0,9,32,32
1683663854937,BIMM 101,A01,193329,McDonnell; Lisa Marie,0,4,24,24
1683663854937,BIMM 101,A02,193339,McDonnell; Lisa Marie,1,4,24,23
1683663854937,BIMM 101,B01,193354,McDonnell; Lisa Marie,0,4,24,24
1683663854937,BIMM 101,B02,193357,McDonnell; Lisa Marie,0,3,24,24
1683663855961,BIMM 110,A01,193377,Tat; John,0,11,32,32
1683663855961,BIMM 110,A02,193378,Tat; John,0,10,32,32
1683663856989,BIMM 120,A01,206116,Staff,0,0,32,32
1683663856989,BIMM 120,A02,206117,Staff,6,0,32,26
1683663856989,BIMM 120,A03,206121,Staff,21,0,32,11
1683663858015,BIPN 100,A01,193393,Park; Ji Young,0,15,32,32
1683663858015,BIPN 100,A02,193402,Park; Ji Young,0,14,32,32
1683663858015,BIPN 100,A03,193413,Park; Ji Young,0,14,32,32
1683663858015,BIPN 100,A04,193414,Park; Ji Young,0,13,32,32
1683663859040,BIPN 102,A01,193429,Staff,0,0,32,32
1683663859040,BIPN 102,A02,193438,Staff,18,0,32,14
1683663860064,BIPN 106,A01,193450,Reyes Gonzalez; Catalina,0,2,40,40
1683663861088,BIPN 134,A01,193465,Cooke; James Edward,0,0,32,32
1683663861088,BIPN 134,A02,193474,Cooke; James Edward,25,0,32,7
1683663861088,BIPN 134,A03,193485,Cooke; James Edward,29,0,32,3
1683663861088,BIPN 134,A04,193486,Cooke; James Edward,20,0,32,12
1683663861088,BIPN 134,A05,193491,Cooke; James Edward,31,0,32,1
1683663861088,BIPN 134,A06,193501,Cooke; James Edward,30,0,32,2
1683663861088,BIPN 134,A07,193510,Cooke; James Edward,29,0,32,3
1683663863137,BISP 194,A00,222522,Staff,14,0,32,18
1683663864161,CAT 124,A01,202407,Staff,19,0,25,6
1683663865186,CAT 125,A00,202408,Marchisotto; Jennifer Anne,2,0,20,18
1683663866216,CAT 125R,A00,202409,Smith; Lauryn Alissa,0,11,20,20
1683663866216,CAT 125R,B00,202410,Morales; Celeste Georgianna,0,11,20,20
1683663866216,CAT 125R,C00,202411,Irwin; Matthew Joseph,0,12,20,20
1683663867240,CENG 15,A01,204712,Yang; Kesong,0,1,0,0
1683663868263,CENG 114,A00,202070,Jahed Motlagh; Zeinab,5,0,20,15
1683663869288,CGS 105,A00,185477,Wesling; Megan E.,24,0,40,16
1683663870312,CGS 106,A00,185494,Staff,11,0,22,11
1683663871337,CGS 108,A00,185495,Staff,14,0,20,6
1683663872360,CGS 114,A00,185496,Staff,13,0,18,5
1683663873389,CGS 119,A00,185501,Staff,15,0,20,5
1683663874411,CGS 120,A00,185511,Staff,12,0,20,8
1683663875441,CHEM 4,A01,184675,Bussey; Thomas J,97,0,100,3
1683663876485,CHEM 6A,A01,184677,Staff,32,0,60,28
1683663877511,CHEM 6B,A01,184679,Staff,63,0,100,37
1683663878541,CHEM 6C,A01,184681,Bussey; Thomas J,0,0,50,50
1683663878541,CHEM 6C,A02,184682,Bussey; Thomas J,32,0,50,18
1683663879569,CHEM 40A,A01,184684,Albizati; Kim F.,34,0,100,66
1683663880592,CHEM 40B,A01,184686,Albizati; Kim F.,0,22,100,100
1683663881619,CHEM 41B,A01,184690,Staff,51,0,100,49
1683663882646,COGS 3,A01,184715,Boyle; Mary E. T.,0,27,40,40
1683663883670,COGS 14B,A01,185172,Staff,0,14,38,38
1683663884701,COGS 18,A01,184736,Staff,14,0,80,66
1683663885726,COGS 100,A01,184932,Staff,0,7,73,73
1683663886750,COGS 101A,A01,184935,Staff,0,40,30,30
1683663887778,COGS 101B,A01,184944,Staff,0,2,30,30
1683663888803,COGS 101C,A01,184946,Staff,0,10,30,30
1683663889829,COGS 102A,A01,184951,Johnson; Christine M.,2,0,40,38
1683663890857,COGS 107B,A01,184953,Mooshagian; Eric Frederick,0,51,40,40
1683663891883,COGS 118B,A01,184959,Gupta; Anjum,0,49,40,40
1683663892912,COGS 153,A00,184961,Staff,0,16,30,30
1683663893937,COGS 177,A00,184962,Staff,0,21,30,30
1683663894966,COGS 187A,A01,184969,Boyle; Mary E. T.,0,19,40,40
1683663895993,COMM 10,A01,185174,Staff,0,5,25,25
1683663895993,COMM 10,A02,185189,Staff,0,2,25,25
1683663895993,COMM 10,A03,269821,Staff,0,1,0,0
1683663897017,COMM 100B,A01,185475,Staff,0,1,0,2
1683663897017,COMM 100B,A02,185476,Staff,12,0,25,13
1683663898041,COMM 100C,A01,185314,Staff,1,0,25,24
1683663898041,COMM 100C,A02,185327,Staff,18,0,25,7
1683663899063,COMM 110M,A00,185349,Staff,0,0,40,40
1683663900087,COMM 113T,A00,185352,Staff,25,0,40,15
1683663901113,COMM 114I,A00,185353,Staff,31,0,40,9
1683663902141,COMM 131,A00,185354,Staff,17,0,30,13
1683663903170,CSE 8A,A50,185358,Cao; Yingjun,0,46,10,10
1683663904201,CSE 8B,A01,185362,Staff,0,48,50,50
1683663905227,CSE 11,A01,185416,Cao; Yingjun,0,91,10,10
1683663906253,CSE 20,A01,185445,Briones; Jor-el Thomas Caparas,4,0,25,21
1683663907277,CSE 21,A01,185447,Staff,9,0,50,41
1683663908305,CSE 101,A01,185451,Staff,0,13,50,50
1683663908305,CSE 101,B01,185453,Jones; Miles E,0,14,50,50
1683663910356,CSE 141,A01,185458,Eldon; John,16,0,100,84
1683663911379,CSE 141L,A01,185461,Eldon; John,8,0,100,92
1683663912407,CSE 142,A01,185463,Staff,34,0,60,26
1683663912407,CSE 142,B01,201355,Staff,0,7,60,60
1683663913435,CSE 142L,A01,185470,Staff,34,0,60,26
1683663913435,CSE 142L,B01,201417,Staff,0,6,60,60
1683663914460,CSE 190,A00,201433,Staff,32,0,49,17
1683663915488,DOC 1,A01,259136,Strom; Megan C.,7,0,15,8
1683663915488,DOC 1,A02,259137,Strom; Megan C.,14,0,15,1
1683663915488,DOC 1,A03,259138,Strom; Megan C.,14,0,15,1
1683663915488,DOC 1,A04,259139,Strom; Megan C.,14,0,15,1
1683663916512,DOC 100D,A00,259140,Pass; Natalye Joann,14,0,25,11
1683663917537,DSGN 1,A01,184749,Rill; Bryan,0,26,30,30
1683663918677,DSGN 100,A01,185168,Staff,0,2,25,25
1683663919705,ECE 5,A01,185626,Morris; Karcher William,0,11,0,0
1683663920728,ECE 101,A01,185628,Staff,14,0,70,56
1683663921752,ECE 107,A01,185635,Baghdadchi; Saharnaz,0,0,20,20
1683663921752,ECE 107,A02,185638,Baghdadchi; Saharnaz,2,0,20,18
1683663922775,ECE 148,A01,185647,Silberman; Jack,0,0,16,16
1683663923803,ECON 1,A01,185537,Crane; Meredith Helen,54,0,70,16
1683663924827,ECON 3,A01,185549,Crane; Meredith Helen,29,0,70,41
1683663925851,ECON 4,A01,203354,Anderson; John Charles,0,5,10,10
1683663926875,ECON 100A,A01,185574,Staff,0,5,40,40
1683663927900,ECON 100B,A01,185576,Staff,0,12,50,50
1683663928927,ECON 100C,A01,185589,Newhouse; Herbert S,30,0,70,40
1683663929950,ECON 105,A00,185608,Vespa; Emanuel Ignacio,19,0,35,16
1683663930977,ECON 109,A01,185610,Shishkin; Denis,9,0,35,26
1683663932000,ECON 110A,A01,185612,Staff,9,0,40,31
1683663933026,ECON 120A,A01,185615,Staff,20,0,40,20
1683663934056,ECON 120C,A01,185617,Sun; Yixiao,0,20,70,70
1683663935082,ECON 144,A00,203346,Squires; Dale E,2,0,35,33
1683663936105,ECON 171,A01,203349,Newhouse; Herbert S,0,1,35,35
1683663937128,ECON 173A,A01,185621,Toda; Alexis Akira,20,0,35,15
1683663938154,EDS 25,A01,202413,Staff,0,1,0,0
1683663938154,EDS 25,A02,202414,Staff,0,1,0,0
1683663938154,EDS 25,A03,202415,Staff,0,0,0,0
1683663938154,EDS 25,A04,202416,Staff,0,1,0,0
1683663938154,EDS 25,A05,202439,Staff,0,0,0,0
1683663938154,EDS 25,A06,202440,Staff,0,0,0,0
1683663938154,EDS 25,B01,202631,Staff,0,0,0,0
1683663938154,EDS 25,B02,202632,Staff,0,0,0,0
1683663938154,EDS 25,B03,202639,Staff,0,0,0,0
1683663938154,EDS 25,B04,202640,Staff,0,0,0,0
1683663938154,EDS 25,B05,202643,Staff,0,0,0,0
1683663938154,EDS 25,B06,202644,Staff,0,0,0,0
1683663939179,EDS 38,A01,202659,Black; Alison Michelle,24,0,25,1
1683663940205,EDS 115,A00,202652,Staff,18,0,30,12
1683663941237,EDS 125,A00,202649,Staff,13,0,30,17
1683663942263,EDS 126,A01,203332,Staff,30,0,30,0
1683663943287,EDS 139,A00,202838,Staff,16,0,25,9
1683663944310,EDS 146,A01,202655,Staff,14,0,25,11
1683663945336,ENG 15,A00,185667,Staff,0,1,0,0
1683663945336,ENG 15,B00,185672,Staff,0,0,0,0
1683663945336,ENG 15,C00,185675,Staff,0,0,0,0
1683663945336,ENG 15,D00,185682,Staff,0,0,0,0
1683663945336,ENG 15,E00,185684,Staff,0,0,0,0
1683663946360,ETHN 103,A00,185710,Staff,0,8,35,35
1683663947393,ETHN 103A,A00,199228,Man; Simeon S,0,0,9,9
1683663948423,ETHN 109,A00,185711,Staff,15,0,35,20
1683663949450,ETHN 142,A00,185726,Staff,0,4,30,30
1683663950529,ETHN 163J,A00,199229,Man; Simeon S,5,0,8,3
1683663951553,ETHN 168,A00,185727,Staff,7,0,10,3
1683663952579,ETHN 182,A00,185728,Staff,0,0,35,35
1683663953605,ETHN 183,A00,185737,Staff,9,0,18,9
1683663954629,GLBH 111,A01,209361,Burgos; Jose L.,0,0,0,0
1683663956687,HIEU 104,A00,185792,Staff,14,0,20,6
1683663957712,HIEU 115,A00,185800,Staff,0,0,20,20
1683663968762,HIEU 128,A00,185801,Staff,0,9,20,20
1683663969786,HIEU 147,A00,185802,Staff,15,0,20,5
1683663970813,HIEU 154,A00,185823,Staff,11,0,20,9
1683663971840,HILA 102,A00,185826,Staff,14,0,20,6
1683663972864,HILD 2C,A01,185778,Staff,0,13,20,20
1683663973888,HILD 7B,A01,185780,Kwak; Nancy,0,17,32,32
1683663973888,HILD 7B,A02,185781,Kwak; Nancy,0,18,32,32
1683663974914,HILD 30,A01,185791,Staff,12,0,20,8
1683663975939,HISC 119,A00,185830,Golan; Tal,0,9,20,20
1683663976964,HITO 156GS,A00,185831,Patterson; Patrick H.,0,0,0,23
1683663977991,HIUS 103,A00,185832,Man; Simeon S,0,4,20,20
1683663979015,HIUS 117,A00,185836,Kwak; Nancy,2,0,20,18
1683663980039,HIUS 125,A00,185840,Man; Simeon S,0,2,23,23
1683663981066,HIUS 149,A00,185845,Staff,1,0,20,19
1683663982094,HUM 3,A01,185882,Zavodny; Tatiana Sophia,0,8,50,50
1683663982094,HUM 3,B01,185899,Caldwell; Michael Alan,0,18,50,50
1683663983120,HUM 3GS,A00,185900,Patterson; Patrick H.,0,0,0,23
1683663984147,HUM 4,A01,185938,Zroka; Amy Liane,29,0,50,21
1683663984147,HUM 4,B01,185956,Watkins; Eric,0,4,50,50
1683663984147,HUM 4,B02,202209,Watkins; Eric,0,5,50,50
1683663984147,HUM 4,B03,202210,Watkins; Eric,0,5,50,50
1683663985171,HUM 5,A01,185958,West; Geoffrey Scott,0,0,50,50
1683663985171,HUM 5,A02,202215,West; Geoffrey Scott,0,0,50,50
1683663986199,INTL 190,A00,185959,Gagnon; Jeffrey C,0,0,0,9
1683663986199,INTL 190,B00,185960,Lettieri; Michael Joseph,0,0,0,2
1683663987224,JAPN 180,A00,254509,Staff,5,0,30,25
1683663988247,LATI 10,A01,202853,Kennemore; Amy Michelle,4,0,35,31
1683663988247,LATI 10,A02,202854,Kennemore; Amy Michelle,2,0,35,33
1683663988247,LATI 10,A03,270054,Kennemore; Amy Michelle,30,0,30,0
1683663989272,LATI 180,A00,202855,Kennemore; Amy Michelle,11,0,20,9
1683663990296,LAWS 101,A00,201767,Golan; Tal,0,7,40,40
1683663991323,LIFR 1C,A00,185961,Staff,6,0,20,14
1683663992349,LIFR 1CX,A00,185962,Staff,7,0,20,13
1683663993375,LIFR 1D,A00,185963,Staff,7,0,20,13
1683663994399,LIFR 1DX,A00,185964,Staff,7,0,20,13
1683663995421,LIGN 101,A01,186039,Staff,43,0,50,7
1683663996448,LIGN 165,A00,186040,Staff,15,0,50,35
1683663997470,LTCS 108,A00,186041,Staff,5,0,10,5
1683663998497,LTCS 119,A00,186042,Staff,15,0,20,5
1683663999520,LTCS 130,A00,186043,Wesling; Megan E.,15,0,25,10
1683664001568,LTEA 138,A00,186119,Staff,14,0,40,26
1683664002594,LTEN 124,A00,186148,Staff,5,0,25,20
1683664003620,LTEN 178,A00,186149,Staff,7,0,15,8
1683664004645,LTEN 181,A00,186150,Blanco; John D,34,0,40,6
1683664005672,LTWL 120,A00,186160,Staff,20,0,25,5
1683664006697,LTWL 165,A00,186161,Staff,22,0,25,3
1683664007721,LTWR 100,A00,186162,Staff,0,5,15,15
1683664008745,LTWR 102,A00,186163,Doller; Ben,5,0,15,10
1683664009771,MAE 8,A01,186412,Staff,0,0,0,0
1683664010798,MAE 30B,A00,186445,Bahadori; Mohammad Yousef,82,0,100,18
1683664011821,MAE 40,A00,186592,Bewley; Thomas R,10,0,50,40
1683664012845,MAE 101B,A00,186593,Bahadori; Mohammad Yousef,80,0,100,20
1683664013871,MAE 105,A00,186594,Bandaru; Prabhakar,10,0,50,40
1683664014896,MAE 107,A00,186599,Pham; Hieu Tan,0,7,120,120
1683664015923,MAE 148,A01,186660,Silberman; Jack,3,0,16,13
1683664016947,MATH 10A,A01,188095,Staff,0,6,35,35
1683664017983,MATH 10B,A01,188097,Bowers; Adam R.,0,12,30,30
1683664017983,MATH 10B,A02,188099,Bowers; Adam R.,0,11,30,30
1683664017983,MATH 10B,B01,188104,Bowers; Adam R.,0,10,30,30
1683664017983,MATH 10B,B02,188106,Bowers; Adam R.,1,9,30,29
1683664019008,MATH 10C,A01,188111,Staff,0,18,30,30
1683664019008,MATH 10C,A02,188127,Staff,0,19,30,30
1683664019008,MATH 10C,A03,188131,Staff,0,19,30,30
1683664019008,MATH 10C,B01,188218,Staff,17,0,30,13
1683664019008,MATH 10C,B02,188244,Staff,13,0,30,17
1683664019008,MATH 10C,B03,188277,Staff,14,0,30,16
1683664020034,MATH 18,A01,188344,Bach; Quang Tran,18,0,30,12
1683664020034,MATH 18,A02,188345,Bach; Quang Tran,11,0,30,19
1683664020034,MATH 18,B01,188353,Bach; Quang Tran,11,0,30,19
1683664020034,MATH 18,B02,188354,Bach; Quang Tran,19,0,30,11
1683664021061,MATH 20A,A01,188374,Staff,11,0,35,24
1683664022084,MATH 20B,A01,188382,Ohm; Ko Woon,7,0,30,23
1683664022084,MATH 20B,A02,188383,Ohm; Ko Woon,22,0,30,8
1683664022084,MATH 20B,B01,188385,Ohm; Ko Woon,7,0,30,23
1683664022084,MATH 20B,B02,188392,Ohm; Ko Woon,22,0,30,8
1683664023111,MATH 20C,A01,188394,Harel; Guershon,10,0,30,20
1683664023111,MATH 20C,A02,188395,Harel; Guershon,13,0,30,17
1683664023111,MATH 20C,B01,188404,Harel; Guershon,5,0,30,25
1683664023111,MATH 20C,B02,188405,Harel; Guershon,18,0,30,12
1683664024139,MATH 20D,A01,188414,Hammock; Frances H,0,1,30,30
1683664024139,MATH 20D,A02,188415,Hammock; Frances H,0,1,30,30
1683664024139,MATH 20D,B01,188447,Hammock; Frances H,0,1,30,30
1683664024139,MATH 20D,B02,188486,Hammock; Frances H,3,0,30,27
1683664025164,MATH 20E,A01,188649,Staff,21,0,30,9
1683664025164,MATH 20E,A02,188650,Staff,21,0,30,9
1683664025164,MATH 20E,A03,188673,Staff,0,0,30,30
1683664026191,MATH 102,A01,188675,Staff,0,36,35,35
1683664027216,MATH 103B,A01,188681,Staff,3,0,35,32
1683664027216,MATH 103B,B01,188692,Staff,5,0,35,30
1683664028240,MATH 109,A01,188695,Salehi Golsefidy; Alireza,24,0,35,11
1683664028240,MATH 109,A02,188696,Salehi Golsefidy; Alireza,25,0,35,10
1683664029269,MATH 120A,A01,188698,Eggers; John Dietrich,7,0,35,28
1683664030293,MATH 142B,A01,188736,Ioana; Adrian,1,1,30,29
1683664030293,MATH 142B,A02,188741,Ioana; Adrian,0,1,30,30
1683664030293,MATH 142B,A03,188743,Ioana; Adrian,0,1,30,30
1683664031320,MATH 168A,A01,188790,Staff,0,10,35,35
1683664032349,MATH 170A,A01,188803,Nie; Jiawang,0,2,35,35
1683664032349,MATH 170A,A02,188811,Nie; Jiawang,0,0,35,35
1683664032349,MATH 170A,A03,188814,Nie; Jiawang,0,0,35,35
1683664032349,MATH 170A,A04,188815,Nie; Jiawang,9,0,35,26
1683664033372,MATH 193B,A01,188817,Staff,0,0,35,35
1683664033372,MATH 193B,A02,188818,Staff,5,0,35,30
1683664034396,MGT 4,A01,202857,Anderson; John Charles,61,0,80,19
1683664035423,MGT 12,A00,202858,Lindenberger; Wade Douglas,40,0,90,50
1683664036446,MGT 18,A00,202859,Staff,74,0,90,16
1683664037470,MGT 18GS,A00,202860,McKay; Michael J,13,0,28,15
1683664038495,MGT 45,A00,202861,Pecore; Joseph P.,11,0,90,79
1683664039522,MGT 100,A00,202863,Yavorsky; Daniel Ryan,28,0,90,62
1683664040550,MGT 103,A00,202864,Ehrich; Kristine R,0,18,90,90
1683664041574,MGT 112,A00,202865,Ehrich; Kristine R,14,0,90,76
1683664042603,MGT 121A,A00,202868,Staff,90,20,90,0
1683664043632,MGT 131B,A00,202869,Anderson; John Charles,59,0,90,31
1683664044657,MGT 136,A00,202871,Lindenberger; Wade Douglas,83,0,90,7
1683664045682,MGT 164,A00,202873,Staff,0,67,90,91
1683664046706,MGT 164GS,A00,202874,McKay; Mary A,13,0,28,15
1683664047729,MGT 180,A00,202875,Staff,0,51,90,91
1683664048755,MMW 11R,A01,205019,Herbst; Matthew,1,0,30,29
1683664048755,MMW 11R,A02,205026,Herbst; Matthew,29,0,30,1
1683664049784,MMW 15,A01,193512,Chang; Edmond Yi-Teh,0,8,28,28
1683664049784,MMW 15,A02,193513,Chang; Edmond Yi-Teh,0,5,28,28
1683664049784,MMW 15,A03,193514,Chang; Edmond Yi-Teh,0,5,28,28
1683664049784,MMW 15,A04,193515,Chang; Edmond Yi-Teh,0,5,28,28
1683664049784,MMW 15,A05,193516,Chang; Edmond Yi-Teh,0,5,28,28
1683664049784,MMW 15,A06,193517,Chang; Edmond Yi-Teh,0,6,28,28
1683664049784,MMW 15,B01,193519,Chang; Edmond Yi-Teh,0,5,28,28
1683664049784,MMW 15,B02,193520,Chang; Edmond Yi-Teh,0,5,28,28
1683664049784,MMW 15,B03,193521,Chang; Edmond Yi-Teh,0,5,28,28
1683664049784,MMW 15,B04,193522,Chang; Edmond Yi-Teh,0,5,28,28
1683664049784,MMW 15,B05,193523,Chang; Edmond Yi-Teh,0,5,28,28
1683664049784,MMW 15,B06,193524,Chang; Edmond Yi-Teh,0,5,28,28
1683664050810,MMW 122,A01,193526,Rahimi; Babak,0,16,28,28
1683664050810,MMW 122,A02,193527,Rahimi; Babak,0,15,28,28
1683664050810,MMW 122,A03,193528,Rahimi; Babak,0,0,0,0
1683664050810,MMW 122,A04,193529,Rahimi; Babak,0,0,0,0
1683664051834,MUS 1A,A01,186663,Staff,1,20,35,34
1683664052859,MUS 4,A01,186715,Staff,0,12,35,35
1683664053881,MUS 5R,A01,186796,Dubnov; Shlomo,0,17,35,35
1683664054905,MUS 6,A01,186798,Staff,0,5,25,25
1683664055929,MUS 7,A01,186830,Staff,11,0,35,24
1683664056956,MUS 8,A01,186930,Staff,0,26,35,35
1683664057987,MUS 15,A01,186932,Staff,0,16,35,35
1683664057987,MUS 15,B01,186934,Staff,1,17,35,34
1683664059011,MUS 80,A00,186935,Staff,0,0,20,20
1683664059011,MUS 80,B00,186936,Staff,24,0,25,1
1683664060040,NANO 11,A00,204702,Lipomi; Darren John,0,0,0,0
1683664061067,NANO 15,A01,204709,Yang; Kesong,0,1,0,0
1683664062092,NANO 114,A00,202069,Jahed Motlagh; Zeinab,3,0,10,7
1683664063118,PHIL 1,A00,186955,Grush; Rick Scott,31,0,40,9
1683664064201,PHIL 10,A01,186973,Grush; Rick Scott,27,0,35,8
1683664064201,PHIL 10,A02,186974,Grush; Rick Scott,33,0,35,2
1683664065227,PHIL 13,A01,186976,Staff,3,0,35,32
1683664065227,PHIL 13,A02,186977,Staff,16,0,35,19
1683664066253,PHIL 14,A01,186979,Staff,31,0,35,4
1683664066253,PHIL 14,A02,186986,Staff,32,0,35,3
1683664067279,PHIL 28,A01,186988,Staff,16,0,30,14
1683664067279,PHIL 28,A02,186989,Staff,1,0,30,29
1683664067279,PHIL 28,A03,186990,Staff,10,0,30,20
1683664067279,PHIL 28,A04,186991,Staff,26,0,30,4
1683664068306,PHIL 120,A00,186997,Staff,23,0,40,17
1683664069333,PHIL 137,A00,187003,Staff,7,0,40,33
1683664070360,PHIL 150,A00,187015,Staff,47,0,70,23
1683664071384,PHIL 167,A00,187021,Lamey; Andy M.,34,0,40,6
1683664072407,PHIL 174,A01,202226,Staff,17,0,20,3
1683664072407,PHIL 174,A02,202235,Staff,20,0,20,0
1683664073430,PHIL 191A,A00,258918,Staff,0,0,1,1
1683664074456,PHYS 1A,A00,187028,Staff,26,0,60,34
1683664075481,PHYS 1AL,001,187036,Staff,3,0,30,27
1683664075481,PHYS 1AL,002,187049,Staff,18,0,30,12
1683664076506,PHYS 1B,A00,187058,Staff,22,0,60,38
1683664077531,PHYS 1BL,001,187064,Staff,0,1,30,30
1683664077531,PHYS 1BL,002,187070,Staff,4,0,30,26
1683664078558,PHYS 1C,A00,187082,Staff,29,0,120,91
1683664079584,PHYS 1CL,001,187088,Staff,0,9,30,30
1683664079584,PHYS 1CL,002,187089,Staff,0,1,30,30
1683664079584,PHYS 1CL,009,262693,Staff,9,0,30,21
1683664080612,PHYS 2B,A01,187097,Staff,55,0,115,60
1683664081636,PHYS 2C,A01,187099,Staff,63,0,115,52
1683664082661,PHYS 2CL,A01,187101,Staff,5,0,28,23
1683664082661,PHYS 2CL,A02,187102,Staff,15,0,28,13
1683664083686,PHYS 2D,A01,187123,Shotwell; Brian,95,0,115,20
1683664084713,PHYS 4B,A01,187133,Grinstein; Benjamin,35,0,50,15
1683664085738,POLI 10,A00,188819,Staff,0,4,50,50
1683664086761,POLI 11,A00,188827,Staff,43,0,50,7
1683664087784,POLI 13R,A00,188828,Staff,0,1,20,20
1683664088809,POLI 27,A01,188830,Elgin; Samuel Zincke,0,2,70,70
1683664089833,POLI 30,A00,188832,Desposato; Scott,30,0,50,20
1683664090862,POLI 102F,A00,188834,Staff,0,0,40,40
1683664091885,POLI 104A,A00,188852,Staff,13,0,30,17
1683664092913,POLI 104I,A00,188853,Staff,0,7,20,20
1683664093938,POLI 110B,A00,188854,Wiens; David,6,0,20,14
1683664094965,POLI 112A,A00,188855,Wiens; David,3,0,30,27
1683664095989,POLI 117R,A00,188856,Forman; Fonna,0,12,20,20
1683664097015,POLI 118,A00,188857,Ingham; Sean,8,0,20,12
1683664098042,POLI 120G,A00,188858,Staff,8,0,30,22
1683664099066,POLI 131CR,A00,188863,Hoston; Germaine,21,0,50,29
1683664100090,POLI 133,A00,188864,Nellis; Gareth Hb,44,0,50,6
1683664101117,POLI 134D,A00,188865,Desposato; Scott,27,0,30,3
1683664102142,POLI 142A,A00,188871,Gartzke; Erik,21,0,50,29
1683664103170,POLI 142K,A00,188874,Staff,38,0,50,12
1683664104194,POLI 143,A00,188940,Gartzke; Erik,16,0,30,14
1683664105216,POLI 153,A00,188943,Staff,2,0,20,18
1683664106240,POLI 160AA,A00,188944,Staff,11,0,40,29
1683664107267,POLI 170A,A00,188945,Staff,11,0,30,19
1683664109315,PSYC 1,A00,188952,Staff,36,0,90,54
1683664110341,PSYC 2,B00,188953,Staff,19,0,35,16
1683664111365,PSYC 6,A00,188970,Staff,47,0,60,13
1683664112389,PSYC 7,A00,188973,Staff,35,0,45,10
1683664113414,PSYC 60,A01,188980,Rickard; Timothy C.,42,0,60,18
1683664114437,PSYC 70,A01,189001,Steiner; Eric Tomas,22,0,45,23
1683664115466,PSYC 100,A00,189005,Lacefield; Katharine I,0,99,120,120
1683664116489,PSYC 102,A00,189008,Staff,8,0,30,22
1683664117512,PSYC 106,B00,189026,Gorman; Michael R.,27,0,60,33
1683664118549,PSYC 114,B01,189033,Winkielman; Piotr,0,31,30,30
1683664119575,PSYC 131,A00,189036,Anagnostaras; Stephan,0,43,60,60
1683664120604,PSYC 136,A00,189041,Lowe; Angela Beth,0,7,25,25
1683664121630,PSYC 137,A00,189057,Winkielman; Piotr,0,37,25,25
1683664122654,PSYC 144,A00,189107,Wixted; John T,0,11,50,50
1683664124707,PSYC 162,A00,189142,Staff,0,9,85,85
1683664125730,PSYC 172,A00,189144,Gorman; Michael R.,0,6,30,30
1683664127780,PSYC 179,A00,189146,Lacefield; Katharine I,0,87,120,120
1683664128807,PSYC 181,A00,189147,Anagnostaras; Stephan,0,44,90,90
1683664129833,PSYC 190R,A00,189148,Barner; David A.,0,23,80,80
1683664130860,PSYC 191,A00,189275,Rickard; Timothy C.,0,10,25,25
1683664131882,PSYC 193,A00,189276,Chapman; Eddie Nathaniel,0,1,0,4
1683664132911,PSYC 193L,A01,189281,Lowe; Angela Beth,10,0,20,10
1683664132911,PSYC 193L,B01,189285,Staff,28,0,35,7
1683664133935,RELI 149,A00,187137,Rahimi; Babak,7,0,40,33
1683664134960,SE 9,A01,187315,Staff,0,2,18,18
1683664135983,SE 101B,A00,187409,Staff,24,0,30,6
1683664137008,SE 110B,A00,187444,Staff,10,0,40,30
1683664138032,SE 130B,A00,187449,Staff,31,0,40,9
1683664139060,SE 150A,A00,187516,Staff,8,0,20,12
1683664140090,SE 154,A00,187528,Staff,29,0,50,21
1683664141113,SIO 3,A01,258171,Staff,35,0,40,5
1683664142140,SIO 10,A00,187144,Cook; Geoffrey W,0,7,75,75
1683664143170,SIO 45,A00,187152,Cook; Geoffrey W,0,5,100,100
1683664144195,SIO 109R,A00,194486,Staff,0,4,20,20
1683664146249,SIO 187,A01,187233,Kacev; David,12,0,40,28
1683664147277,SOCI 1,A01,258656,Thorpe; Charles Robert,28,0,30,2
1683664147277,SOCI 1,A02,258658,Thorpe; Charles Robert,30,0,30,0
1683664147277,SOCI 1,A03,258661,Thorpe; Charles Robert,25,0,25,0
1683664147277,SOCI 1,A04,258666,Thorpe; Charles Robert,22,0,25,3
1683664147277,SOCI 1,A05,258897,Thorpe; Charles Robert,22,0,25,3
1683664147277,SOCI 1,A06,258898,Thorpe; Charles Robert,25,0,25,0
1683664148305,SOCI 30,A01,258903,Pardo Guerra; Juan Pablo,14,0,30,16
1683664149328,SOCI 102,A00,258904,Staff,9,0,25,16
1683664150355,SOCI 106,A00,258905,Staff,19,0,25,6
1683664151381,SOCI 111,A00,258907,Ribas Norris; Janet Vanesa,26,0,30,4
1683664152404,SOCI 121R,A00,258908,Pardo Guerra; Juan Pablo,8,0,30,22
1683664153428,SOCI 126,A01,203330,Staff,14,0,20,6
1683664154454,SOCI 131,A00,258909,Thorpe; Charles Robert,30,0,60,30
1683664155481,SOCI 135,A00,258910,Payne; Christine Anna,0,11,30,30
1683664156508,SOCI 157,A00,258911,Staff,12,0,30,18
1683664157531,SOCI 184,A00,258912,Staff,25,0,30,5
1683664158557,SOCI 188D,A00,258913,Staff,22,0,30,8
1683664159581,SYN 2,001,187529,Staff,9,0,16,7
1683664159581,SYN 2,002,201452,Staff,0,20,16,16
1683664159581,SYN 2,003,201469,Staff,1,0,16,15
1683664160605,SYN 100,A01,187531,Staff,0,9,20,20
1683664160605,SYN 100,B01,201491,Staff,0,10,20,20
1683664161629,TDAC 1,A00,189286,Walsh; Kim C.,3,0,20,17
1683664161629,TDAC 1,B00,189287,Harting; Carla Kelso,10,0,20,10
1683664162655,TDAC 101,A00,189300,Walsh; Kim C.,16,0,20,4
1683664162655,TDAC 101,B00,189301,Harting; Carla Kelso,18,0,20,2
1683664163680,TDAC 102,A00,189304,Basso; Beatrice,14,0,20,6
1683664164703,TDAC 108,A00,189305,Staff,18,0,20,2
1683664165732,TDDE 131,A00,189310,Staff,19,0,20,1
1683664165732,TDDE 131,B00,189314,Staff,19,0,20,1
1683664165732,TDDE 131,C00,189315,Staff,48,0,50,2
1683664165732,TDDE 131,D00,189316,Staff,14,0,15,1
1683664165732,TDDE 131,E00,204841,Staff,20,0,20,0
1683664166756,TDGE 10,A00,189289,Staff,27,0,50,23
1683664166756,TDGE 10,B00,189290,Havis; Allan,0,1,50,50
1683664167857,TDGE 11,A00,189291,Fulton; Julia,0,4,50,50
1683664167857,TDGE 11,B00,189292,Staff,20,0,25,5
1683664167857,TDGE 11,C00,260270,Staff,0,0,0,0
1683664168884,TDGE 25,A00,189294,Staff,2,0,20,18
1683664169911,TDGE 124,A00,189318,Fulton; Julia,0,8,50,50
1683664170941,TDGE 125,A00,189319,Staff,13,0,25,12
1683664170941,TDGE 125,B00,189320,Staff,23,0,25,2
1683664171966,TDGE 127,A00,189322,Havis; Allan,1,0,50,49
1683664172989,TDHT 101,A00,189323,Staff,18,0,25,7
1683664172989,TDHT 101,B00,189324,Staff,25,0,25,0
1683664174013,TDHT 102,A00,189325,Staff,49,0,50,1
1683664175041,TDMV 1,A00,189295,Arcidiacono; Kristin,20,0,30,10
1683664175041,TDMV 1,B00,189296,Caligagan; Maria T.,24,0,30,6
1683664176067,TDMV 2,A00,189297,Sammartano; Tonnie,27,0,30,3
1683664176067,TDMV 2,B00,189299,Arcidiacono; Kristin,23,0,30,7
1683664177091,TDMV 3,A00,204998,Rincon; Alicia,22,0,30,8
1683664178119,TDMV 120,A00,189458,Sammartano; Tonnie,28,0,30,2
1683664179146,TDMV 138,A00,189541,Jun; Grace Shin Hae,20,0,40,20
1683664180170,TDMV 142,A00,189717,Caligagan; Tony,25,0,30,5
1683664180170,TDMV 142,B00,189718,Caligagan; Maria T.,25,0,30,5
1683664181195,TMC 2,A01,187533,Staff,25,0,25,0
1683664181195,TMC 2,A02,187534,Staff,25,0,25,0
1683664182218,USP 1,A01,187536,Kwak; Nancy,0,16,25,25
1683664183242,USP 5,A01,187538,Staff,9,0,25,16
1683664184269,USP 101,A00,199253,Staff,0,4,0,0
1683664185293,USP 124,A00,187562,Boomhower; Matthew Charles,0,0,30,30
1683664186321,USP 138,A00,187582,Staff,20,0,25,5
1683664187349,USP 152,A01,187597,Staff,3,0,25,22
1683664188377,USP 153,A00,187598,Staff,19,0,25,6
1683664189401,USP 168,A00,187607,Kwak; Nancy,2,0,5,3
1683664190429,USP 173,A00,187619,Staff,4,0,25,21
1683664191453,USP 181,A00,187638,Staff,0,4,25,25
1683664192478,VIS 103,A00,187650,Cruz; Edwin Teddy,17,0,75,58
1683664193503,VIS 110D,A00,187669,Staff,13,0,22,9
1683664194526,VIS 127C,A00,187720,Shen; Kuiyi,68,0,146,78
1683664195550,VIS 149,A00,187731,Yoldas; Pinar,1,14,22,21
1683664196575,VIS 151,A01,188091,Staff,22,0,34,12
1683664196575,VIS 151,A02,188092,Staff,11,0,34,23
1683664197599,VIS 160B,A00,188093,Stalbaum; Brett,0,1,10,10
1683664199648,WCWP 10B,A00,201720,Staff,10,0,15,5
1683664199648,WCWP 10B,B00,201722,Staff,9,0,15,6
1683664200672,WCWP 100,A00,201725,Gagnon; Jeffrey C,0,0,2,2
1683664200672,WCWP 100,B00,201727,Staff,0,4,15,15
1683664203762,ANBI 133,A00,258401,Wilder; Linnea Lorene,34,0,40,6
1683664204791,ANBI 140,A00,258395,Hrvoj Mihic; Branka,18,0,25,7
1683664205815,ANSC 120,A00,258402,Bialecki; Jon Anthony,26,0,40,14
1683664206843,ANSC 144,A00,258400,Staff,12,0,40,28
1683664208905,ANSC 166,A00,258396,Parish; Steven Martin,156,0,175,19
1683664209932,ANSC 180,A00,193533,Staff,8,0,20,12
1683664210956,ANSC 188,A00,258397,Jassal; Aftab,34,0,40,6
1683664211982,ANTH 3,A01,258316,Staff,23,0,30,7
1683664213009,ANTH 5,A00,258394,Semendeferi; Ekaterini,16,0,20,4
1683664214033,ANTH 21,A01,258331,Staff,4,0,40,36
1683664215056,ANTH 103,A00,258398,Varma; Saiba,15,0,25,10
1683664216082,AWP 10,001,202034,Staff,0,0,0,0
1683664216082,AWP 10,002,202035,Staff,0,0,0,0
1683664216082,AWP 10,003,202036,Staff,0,0,0,0
1683664216082,AWP 10,004,202037,Staff,0,0,0,0
1683664216082,AWP 10,005,202038,Staff,0,0,0,0
1683664216082,AWP 10,006,202039,Staff,0,0,0,0
1683664216082,AWP 10,007,202040,Staff,0,0,0,0
1683664216082,AWP 10,008,202041,Staff,0,0,0,0
1683664216082,AWP 10,009,202042,Staff,0,0,0,0
1683664216082,AWP 10,010,202043,Staff,0,0,0,0
1683664216082,AWP 10,011,202044,Staff,0,0,0,0
1683664216082,AWP 10,012,202045,Staff,0,0,0,0
1683664216082,AWP 10,013,202046,Staff,0,0,0,0
1683664216082,AWP 10,014,202047,Staff,0,0,0,0
1683664216082,AWP 10,015,202048,Staff,0,0,0,0
1683664216082,AWP 10,016,202049,Staff,0,0,0,0
1683664216082,AWP 10,017,202050,Staff,0,0,0,0
1683664216082,AWP 10,018,202051,Staff,0,0,0,0
1683664216082,AWP 10,019,202052,Staff,0,0,0,0
1683664216082,AWP 10,020,202053,Staff,0,0,0,0
1683664216082,AWP 10,021,202054,Staff,0,0,0,0
1683664216082,AWP 10,022,202055,Staff,0,0,0,0
1683664216082,AWP 10,023,202056,Staff,0,0,0,0
1683664216082,AWP 10,024,202057,Staff,0,0,0,0
1683664216082,AWP 10,025,202058,Staff,0,0,0,0
1683664216082,AWP 10,026,202059,Staff,0,0,0,0
1683664217106,AWP 102,001,202032,Staff,0,0,0,0
1683664217106,AWP 102,002,202033,Staff,0,0,0,0
1683664218132,BENG 100,A01,254234,Taylor Amos; Alyssa C,31,0,40,9
1683664219156,BENG 196,001,270013,Engler; Adam J.,9999,0,9999,0
1683664220181,BICD 100R,A01,202018,Smith; Laurie,0,7,32,32
1683664220181,BICD 100R,A02,202019,Smith; Laurie,0,3,32,32
1683664220181,BICD 100R,A03,202020,Smith; Laurie,0,1,32,32
1683664220181,BICD 100R,A04,202021,Smith; Laurie,6,0,32,26
1683664220181,BICD 100R,A05,202022,Smith; Laurie,11,0,32,21
1683664221206,BICD 136,A01,193242,Gustafson-Brown; Cindy,0,2,32,32
1683664221206,BICD 136,A02,193244,Gustafson-Brown; Cindy,13,0,32,19
1683664222234,BIEB 102,A01,193249,Butler; Shannon Rhey,1,2,32,31
1683664222234,BIEB 102,A02,193251,Butler; Shannon Rhey,0,0,32,32
1683664222234,BIEB 102,A03,193253,Butler; Shannon Rhey,0,0,32,32
1683664222234,BIEB 102,A04,193255,Butler; Shannon Rhey,14,0,32,18
1683664222234,BIEB 102,A05,193265,Butler; Shannon Rhey,25,0,32,7
1683664222234,BIEB 102,A06,193269,Butler; Shannon Rhey,14,0,32,18
1683664224283,BIEB 150,A01,193274,Staff,0,0,32,32
1683664224283,BIEB 150,A02,193285,Staff,24,0,32,8
1683664225309,BIEB 194,A00,193286,Kurle; Carolyn M.,20,0,32,12
1683664226337,BILD 1,A01,192291,Staff,15,0,32,17
1683664226337,BILD 1,A02,192292,Staff,30,0,32,2
1683664226337,BILD 1,B01,192520,Reuther; Keefe,0,1,0,0
1683664226337,BILD 1,B02,192532,Reuther; Keefe,0,1,0,0
1683664227365,BILD 3,A01,192556,Butler; Shannon Rhey,0,0,32,32
1683664227365,BILD 3,A02,192581,Butler; Shannon Rhey,0,0,32,32
1683664227365,BILD 3,A03,192611,Butler; Shannon Rhey,21,0,32,11
1683664227365,BILD 3,A04,192612,Butler; Shannon Rhey,24,0,32,8
1683664227365,BILD 3,A05,192613,Butler; Shannon Rhey,26,0,32,6
1683664227365,BILD 3,A06,192679,Butler; Shannon Rhey,27,0,32,5
1683664227365,BILD 3,A07,192682,Butler; Shannon Rhey,20,0,32,12
1683664228391,BILD 4,A01,192836,Reuther; Keefe,1,0,24,23
1683664228391,BILD 4,A02,193044,Reuther; Keefe,4,0,24,20
1683664229416,BILD 10,A01,193142,Gustafson-Brown; Cindy,29,0,32,3
1683664229416,BILD 10,A02,193149,Gustafson-Brown; Cindy,31,0,32,1
1683664230440,BIMM 100,A01,193301,Staff,0,6,32,32
1683664230440,BIMM 100,A02,193312,Staff,0,7,32,32
1683664230440,BIMM 100,A03,193323,Staff,0,9,32,32
1683664231469,BIMM 101,A01,193329,McDonnell; Lisa Marie,0,4,24,24
1683664231469,BIMM 101,A02,193339,McDonnell; Lisa Marie,1,4,24,23
1683664231469,BIMM 101,B01,193354,McDonnell; Lisa Marie,0,4,24,24
1683664231469,BIMM 101,B02,193357,McDonnell; Lisa Marie,0,3,24,24
1683664232494,BIMM 110,A01,193377,Tat; John,0,11,32,32
1683664232494,BIMM 110,A02,193378,Tat; John,0,10,32,32
1683664233522,BIMM 120,A01,206116,Staff,0,0,32,32
1683664233522,BIMM 120,A02,206117,Staff,6,0,32,26
1683664233522,BIMM 120,A03,206121,Staff,21,0,32,11
1683664234547,BIPN 100,A01,193393,Park; Ji Young,0,15,32,32
1683664234547,BIPN 100,A02,193402,Park; Ji Young,0,14,32,32
1683664234547,BIPN 100,A03,193413,Park; Ji Young,0,14,32,32
1683664234547,BIPN 100,A04,193414,Park; Ji Young,0,13,32,32
1683664235574,BIPN 102,A01,193429,Staff,0,0,32,32
1683664235574,BIPN 102,A02,193438,Staff,18,0,32,14
1683664236599,BIPN 106,A01,193450,Reyes Gonzalez; Catalina,0,2,40,40
1683664237624,BIPN 134,A01,193465,Cooke; James Edward,0,0,32,32
1683664237624,BIPN 134,A02,193474,Cooke; James Edward,25,0,32,7
1683664237624,BIPN 134,A03,193485,Cooke; James Edward,29,0,32,3
1683664237624,BIPN 134,A04,193486,Cooke; James Edward,20,0,32,12
1683664237624,BIPN 134,A05,193491,Cooke; James Edward,31,0,32,1
1683664237624,BIPN 134,A06,193501,Cooke; James Edward,30,0,32,2
1683664237624,BIPN 134,A07,193510,Cooke; James Edward,29,0,32,3
1683664239671,BISP 194,A00,222522,Staff,14,0,32,18
1683664240695,CAT 124,A01,202407,Staff,19,0,25,6
1683664241720,CAT 125,A00,202408,Marchisotto; Jennifer Anne,2,0,20,18
1683664242744,CAT 125R,A00,202409,Smith; Lauryn Alissa,0,11,20,20
1683664242744,CAT 125R,B00,202410,Morales; Celeste Georgianna,0,11,20,20
1683664242744,CAT 125R,C00,202411,Irwin; Matthew Joseph,0,12,20,20
1683664243770,CENG 15,A01,204712,Yang; Kesong,0,1,0,0
1683664244795,CENG 114,A00,202070,Jahed Motlagh; Zeinab,5,0,20,15
1683664245819,CGS 105,A00,185477,Wesling; Megan E.,24,0,40,16
1683664246842,CGS 106,A00,185494,Staff,11,0,22,11
1683664247865,CGS 108,A00,185495,Staff,14,0,20,6
1683664248889,CGS 114,A00,185496,Staff,13,0,18,5
1683664249915,CGS 119,A00,185501,Staff,15,0,20,5
1683664250938,CGS 120,A00,185511,Staff,12,0,20,8
1683664251966,CHEM 4,A01,184675,Bussey; Thomas J,97,0,100,3
1683664252989,CHEM 6A,A01,184677,Staff,32,0,60,28
1683664254016,CHEM 6B,A01,184679,Staff,63,0,100,37
1683664255043,CHEM 6C,A01,184681,Bussey; Thomas J,0,0,50,50
1683664255043,CHEM 6C,A02,184682,Bussey; Thomas J,32,0,50,18
1683664256068,CHEM 40A,A01,184684,Albizati; Kim F.,34,0,100,66
1683664257095,CHEM 40B,A01,184686,Albizati; Kim F.,0,22,100,100
1683664258121,CHEM 41B,A01,184690,Staff,51,0,100,49
1683664259154,COGS 3,A01,184715,Boyle; Mary E. T.,0,27,40,40
1683664260182,COGS 14B,A01,185172,Staff,0,14,38,38
1683664261207,COGS 18,A01,184736,Staff,14,0,80,66
1683664262231,COGS 100,A01,184932,Staff,0,7,73,73
1683664263257,COGS 101A,A01,184935,Staff,0,40,30,30
1683664264281,COGS 101B,A01,184944,Staff,0,2,30,30
1683664265307,COGS 101C,A01,184946,Staff,0,10,30,30
1683664266332,COGS 102A,A01,184951,Johnson; Christine M.,2,0,40,38
1683664267357,COGS 107B,A01,184953,Mooshagian; Eric Frederick,0,51,40,40
1683664268385,COGS 118B,A01,184959,Gupta; Anjum,0,50,40,40
1683664269412,COGS 153,A00,184961,Staff,0,16,30,30
1683664270437,COGS 177,A00,184962,Staff,0,21,30,30
1683664271518,COGS 187A,A01,184969,Boyle; Mary E. T.,0,19,40,40
1683664272546,COMM 10,A01,185174,Staff,0,5,25,25
1683664272546,COMM 10,A02,185189,Staff,0,2,25,25
1683664272546,COMM 10,A03,269821,Staff,0,1,0,0
1683664273574,COMM 100B,A01,185475,Staff,0,1,0,2
1683664273574,COMM 100B,A02,185476,Staff,12,0,25,13
1683664274597,COMM 100C,A01,185314,Staff,1,0,25,24
1683664274597,COMM 100C,A02,185327,Staff,18,0,25,7
1683664275624,COMM 110M,A00,185349,Staff,0,0,40,40
1683664276651,COMM 113T,A00,185352,Staff,25,0,40,15
1683664277676,COMM 114I,A00,185353,Staff,31,0,40,9
1683664278700,COMM 131,A00,185354,Staff,17,0,30,13
1683664279728,CSE 8A,A50,185358,Cao; Yingjun,0,46,10,10
1683664280757,CSE 8B,A01,185362,Staff,0,48,50,50
1683664281784,CSE 11,A01,185416,Cao; Yingjun,0,91,10,10
1683664282812,CSE 20,A01,185445,Briones; Jor-el Thomas Caparas,4,0,25,21
1683664283839,CSE 21,A01,185447,Staff,9,0,50,41
1683664284866,CSE 101,A01,185451,Staff,0,13,50,50
1683664284866,CSE 101,B01,185453,Jones; Miles E,0,14,50,50
1683664286920,CSE 141,A01,185458,Eldon; John,16,0,100,84
1683664287948,CSE 141L,A01,185461,Eldon; John,8,0,100,92
1683664288973,CSE 142,A01,185463,Staff,34,0,60,26
1683664288973,CSE 142,B01,201355,Staff,0,7,60,60
1683664289996,CSE 142L,A01,185470,Staff,34,0,60,26
1683664289996,CSE 142L,B01,201417,Staff,0,6,60,60
1683664291020,CSE 190,A00,201433,Staff,32,0,49,17
1683664292050,DOC 1,A01,259136,Strom; Megan C.,7,0,15,8
1683664292050,DOC 1,A02,259137,Strom; Megan C.,14,0,15,1
1683664292050,DOC 1,A03,259138,Strom; Megan C.,14,0,15,1
1683664292050,DOC 1,A04,259139,Strom; Megan C.,14,0,15,1
1683664293073,DOC 100D,A00,259140,Pass; Natalye Joann,14,0,25,11
1683664294098,DSGN 1,A01,184749,Rill; Bryan,0,26,30,30
1683664295126,DSGN 100,A01,185168,Staff,0,2,25,25
1683664296154,ECE 5,A01,185626,Morris; Karcher William,0,11,0,0
1683664297177,ECE 101,A01,185628,Staff,14,0,70,56
1683664298209,ECE 107,A01,185635,Baghdadchi; Saharnaz,0,0,20,20
1683664298209,ECE 107,A02,185638,Baghdadchi; Saharnaz,2,0,20,18
1683664299235,ECE 148,A01,185647,Silberman; Jack,0,0,16,16
1683664300258,ECON 1,A01,185537,Crane; Meredith Helen,54,0,70,16
1683664301288,ECON 3,A01,185549,Crane; Meredith Helen,29,0,70,41
1683664302313,ECON 4,A01,203354,Anderson; John Charles,0,5,10,10
1683664303337,ECON 100A,A01,185574,Staff,0,5,40,40
1683664304361,ECON 100B,A01,185576,Staff,0,12,50,50
1683664305385,ECON 100C,A01,185589,Newhouse; Herbert S,30,0,70,40
1683664306412,ECON 105,A00,185608,Vespa; Emanuel Ignacio,19,0,35,16
1683664307437,ECON 109,A01,185610,Shishkin; Denis,9,0,35,26
1683664308464,ECON 110A,A01,185612,Staff,9,0,40,31
1683664309490,ECON 120A,A01,185615,Staff,20,0,40,20
1683664310513,ECON 120C,A01,185617,Sun; Yixiao,0,20,70,70
1683664311540,ECON 144,A00,203346,Squires; Dale E,2,0,35,33
1683664312566,ECON 171,A01,203349,Newhouse; Herbert S,0,1,35,35
1683664313589,ECON 173A,A01,185621,Toda; Alexis Akira,20,0,35,15
1683664314614,EDS 25,A01,202413,Staff,0,1,0,0
1683664314614,EDS 25,A02,202414,Staff,0,1,0,0
1683664314614,EDS 25,A03,202415,Staff,0,0,0,0
1683664314614,EDS 25,A04,202416,Staff,0,1,0,0
1683664314614,EDS 25,A05,202439,Staff,0,0,0,0
1683664314614,EDS 25,A06,202440,Staff,0,0,0,0
1683664314614,EDS 25,B01,202631,Staff,0,0,0,0
1683664314614,EDS 25,B02,202632,Staff,0,0,0,0
1683664314614,EDS 25,B03,202639,Staff,0,0,0,0
1683664314614,EDS 25,B04,202640,Staff,0,0,0,0
1683664314614,EDS 25,B05,202643,Staff,0,0,0,0
1683664314614,EDS 25,B06,202644,Staff,0,0,0,0
1683664315639,EDS 38,A01,202659,Black; Alison Michelle,24,0,25,1
1683664316662,EDS 115,A00,202652,Staff,18,0,30,12
1683664317689,EDS 125,A00,202649,Staff,13,0,30,17
1683664318713,EDS 126,A01,203332,Staff,30,0,30,0
1683664319739,EDS 139,A00,202838,Staff,16,0,25,9
1683664320765,EDS 146,A01,202655,Staff,14,0,25,11
1683664321793,ENG 15,A00,185667,Staff,0,1,0,0
1683664321793,ENG 15,B00,185672,Staff,0,0,0,0
1683664321793,ENG 15,C00,185675,Staff,0,0,0,0
1683664321793,ENG 15,D00,185682,Staff,0,0,0,0
1683664321793,ENG 15,E00,185684,Staff,0,0,0,0
1683664322816,ETHN 103,A00,185710,Staff,0,8,35,35
1683664323842,ETHN 103A,A00,199228,Man; Simeon S,0,0,9,9
1683664324867,ETHN 109,A00,185711,Staff,15,0,35,20
1683664325892,ETHN 142,A00,185726,Staff,0,4,30,30
1683664326918,ETHN 163J,A00,199229,Man; Simeon S,5,0,8,3
1683664327943,ETHN 168,A00,185727,Staff,7,0,10,3
1683664328966,ETHN 182,A00,185728,Staff,0,0,35,35
1683664329993,ETHN 183,A00,185737,Staff,9,0,18,9
1683664331019,GLBH 111,A01,209361,Burgos; Jose L.,0,0,0,0
1683664333072,HIEU 104,A00,185792,Staff,14,0,20,6
1683664334099,HIEU 115,A00,185800,Staff,0,0,20,20
1683664335126,HIEU 128,A00,185801,Staff,0,9,20,20
1683664336149,HIEU 147,A00,185802,Staff,15,0,20,5
1683664337172,HIEU 154,A00,185823,Staff,11,0,20,9
1683664338200,HILA 102,A00,185826,Staff,14,0,20,6
1683664339225,HILD 2C,A01,185778,Staff,0,13,20,20
1683664340250,HILD 7B,A01,185780,Kwak; Nancy,0,17,32,32
1683664340250,HILD 7B,A02,185781,Kwak; Nancy,0,18,32,32
1683664341275,HILD 30,A01,185791,Staff,12,0,20,8
1683664342302,HISC 119,A00,185830,Golan; Tal,0,9,20,20
1683664343336,HITO 156GS,A00,185831,Patterson; Patrick H.,0,0,0,23
1683664344364,HIUS 103,A00,185832,Man; Simeon S,0,4,20,20
1683664345386,HIUS 117,A00,185836,Kwak; Nancy,2,0,20,18
1683664346414,HIUS 125,A00,185840,Man; Simeon S,0,2,23,23
1683664347438,HIUS 149,A00,185845,Staff,1,0,20,19
1683664348462,HUM 3,A01,185882,Zavodny; Tatiana Sophia,0,8,50,50
1683664348462,HUM 3,B01,185899,Caldwell; Michael Alan,0,18,50,50
1683664349488,HUM 3GS,A00,185900,Patterson; Patrick H.,0,0,0,23
1683664350513,HUM 4,A01,185938,Zroka; Amy Liane,29,0,50,21
1683664350513,HUM 4,B01,185956,Watkins; Eric,0,5,50,50
1683664350513,HUM 4,B02,202209,Watkins; Eric,0,5,50,50
1683664350513,HUM 4,B03,202210,Watkins; Eric,0,5,50,50
1683664351541,HUM 5,A01,185958,West; Geoffrey Scott,0,0,50,50
1683664351541,HUM 5,A02,202215,West; Geoffrey Scott,0,0,50,50
1683664352564,INTL 190,A00,185959,Gagnon; Jeffrey C,0,0,0,9
1683664352564,INTL 190,B00,185960,Lettieri; Michael Joseph,0,0,0,2
1683664353588,JAPN 180,A00,254509,Staff,5,0,30,25
1683664354616,LATI 10,A01,202853,Kennemore; Amy Michelle,4,0,35,31
1683664354616,LATI 10,A02,202854,Kennemore; Amy Michelle,2,0,35,33
1683664354616,LATI 10,A03,270054,Kennemore; Amy Michelle,30,0,30,0
1683664355640,LATI 180,A00,202855,Kennemore; Amy Michelle,11,0,20,9
1683664356664,LAWS 101,A00,201767,Golan; Tal,0,7,40,40
1683664357688,LIFR 1C,A00,185961,Staff,6,0,20,14
1683664358715,LIFR 1CX,A00,185962,Staff,7,0,20,13
1683664359747,LIFR 1D,A00,185963,Staff,7,0,20,13
1683664360771,LIFR 1DX,A00,185964,Staff,7,0,20,13
1683664361796,LIGN 101,A01,186039,Staff,43,0,50,7
1683664362821,LIGN 165,A00,186040,Staff,15,0,50,35
1683664363847,LTCS 108,A00,186041,Staff,5,0,10,5
1683664364871,LTCS 119,A00,186042,Staff,15,0,20,5
1683664365896,LTCS 130,A00,186043,Wesling; Megan E.,15,0,25,10
1683664367947,LTEA 138,A00,186119,Staff,14,0,40,26
1683664368971,LTEN 124,A00,186148,Staff,5,0,25,20
1683664369995,LTEN 178,A00,186149,Staff,7,0,15,8
1683664371019,LTEN 181,A00,186150,Blanco; John D,34,0,40,6
1683664372046,LTWL 120,A00,186160,Staff,20,0,25,5
1683664373070,LTWL 165,A00,186161,Staff,22,0,25,3
1683664374097,LTWR 100,A00,186162,Staff,0,5,15,15
1683664375180,LTWR 102,A00,186163,Doller; Ben,5,0,15,10
1683664376208,MAE 8,A01,186412,Staff,0,0,0,0
1683664377232,MAE 30B,A00,186445,Bahadori; Mohammad Yousef,82,0,100,18
1683664378259,MAE 40,A00,186592,Bewley; Thomas R,10,0,50,40
1683664379285,MAE 101B,A00,186593,Bahadori; Mohammad Yousef,80,0,100,20
1683664380309,MAE 105,A00,186594,Bandaru; Prabhakar,10,0,50,40
1683664381332,MAE 107,A00,186599,Pham; Hieu Tan,0,7,120,120
1683664382363,MAE 148,A01,186660,Silberman; Jack,3,0,16,13
1683664383389,MATH 10A,A01,188095,Staff,0,6,35,35
1683664384413,MATH 10B,A01,188097,Bowers; Adam R.,0,12,30,30
1683664384413,MATH 10B,A02,188099,Bowers; Adam R.,0,11,30,30
1683664384413,MATH 10B,B01,188104,Bowers; Adam R.,0,10,30,30
1683664384413,MATH 10B,B02,188106,Bowers; Adam R.,1,9,30,29
1683664385442,MATH 10C,A01,188111,Staff,0,18,30,30
1683664385442,MATH 10C,A02,188127,Staff,0,19,30,30
1683664385442,MATH 10C,A03,188131,Staff,0,19,30,30
1683664385442,MATH 10C,B01,188218,Staff,17,0,30,13
1683664385442,MATH 10C,B02,188244,Staff,13,0,30,17
1683664385442,MATH 10C,B03,188277,Staff,14,0,30,16
1683664386466,MATH 18,A01,188344,Bach; Quang Tran,18,0,30,12
1683664386466,MATH 18,A02,188345,Bach; Quang Tran,11,0,30,19
1683664386466,MATH 18,B01,188353,Bach; Quang Tran,11,0,30,19
1683664386466,MATH 18,B02,188354,Bach; Quang Tran,19,0,30,11
1683664387490,MATH 20A,A01,188374,Staff,11,0,35,24
1683664388514,MATH 20B,A01,188382,Ohm; Ko Woon,7,0,30,23
1683664388514,MATH 20B,A02,188383,Ohm; Ko Woon,22,0,30,8
1683664388514,MATH 20B,B01,188385,Ohm; Ko Woon,7,0,30,23
1683664388514,MATH 20B,B02,188392,Ohm; Ko Woon,22,0,30,8
1683664389538,MATH 20C,A01,188394,Harel; Guershon,10,0,30,20
1683664389538,MATH 20C,A02,188395,Harel; Guershon,13,0,30,17
1683664389538,MATH 20C,B01,188404,Harel; Guershon,5,0,30,25
1683664389538,MATH 20C,B02,188405,Harel; Guershon,18,0,30,12
1683664390567,MATH 20D,A01,188414,Hammock; Frances H,0,1,30,30
1683664390567,MATH 20D,A02,188415,Hammock; Frances H,0,1,30,30
1683664390567,MATH 20D,B01,188447,Hammock; Frances H,0,1,30,30
1683664390567,MATH 20D,B02,188486,Hammock; Frances H,3,0,30,27
1683664391591,MATH 20E,A01,188649,Staff,21,0,30,9
1683664391591,MATH 20E,A02,188650,Staff,21,0,30,9
1683664391591,MATH 20E,A03,188673,Staff,0,0,30,30
1683664392615,MATH 102,A01,188675,Staff,0,36,35,35
1683664393643,MATH 103B,A01,188681,Staff,3,0,35,32
1683664393643,MATH 103B,B01,188692,Staff,5,0,35,30
1683664394667,MATH 109,A01,188695,Salehi Golsefidy; Alireza,24,0,35,11
1683664394667,MATH 109,A02,188696,Salehi Golsefidy; Alireza,25,0,35,10
1683664395695,MATH 120A,A01,188698,Eggers; John Dietrich,7,0,35,28
1683664396718,MATH 142B,A01,188736,Ioana; Adrian,1,1,30,29
1683664396718,MATH 142B,A02,188741,Ioana; Adrian,0,1,30,30
1683664396718,MATH 142B,A03,188743,Ioana; Adrian,0,1,30,30
1683664397745,MATH 168A,A01,188790,Staff,0,10,35,35
1683664398773,MATH 170A,A01,188803,Nie; Jiawang,0,2,35,35
1683664398773,MATH 170A,A02,188811,Nie; Jiawang,0,0,35,35
1683664398773,MATH 170A,A03,188814,Nie; Jiawang,0,0,35,35
1683664398773,MATH 170A,A04,188815,Nie; Jiawang,9,0,35,26
1683664399798,MATH 193B,A01,188817,Staff,0,0,35,35
1683664399798,MATH 193B,A02,188818,Staff,5,0,35,30
1683664400827,MGT 4,A01,202857,Anderson; John Charles,61,0,80,19
1683664401854,MGT 12,A00,202858,Lindenberger; Wade Douglas,40,0,90,50
1683664402877,MGT 18,A00,202859,Staff,74,0,90,16
1683664403901,MGT 18GS,A00,202860,McKay; Michael J,13,0,28,15
1683664404925,MGT 45,A00,202861,Pecore; Joseph P.,11,0,90,79
1683664405952,MGT 100,A00,202863,Yavorsky; Daniel Ryan,28,0,90,62
1683664406976,MGT 103,A00,202864,Ehrich; Kristine R,0,18,90,90
1683664407999,MGT 112,A00,202865,Ehrich; Kristine R,14,0,90,76
1683664409027,MGT 121A,A00,202868,Staff,90,20,90,0
1683664410055,MGT 131B,A00,202869,Anderson; John Charles,59,0,90,31
1683664411081,MGT 136,A00,202871,Lindenberger; Wade Douglas,83,0,90,7
1683664412106,MGT 164,A00,202873,Staff,0,67,90,91
1683664413133,MGT 164GS,A00,202874,McKay; Mary A,13,0,28,15
1683664414157,MGT 180,A00,202875,Staff,0,51,90,91
1683664415185,MMW 11R,A01,205019,Herbst; Matthew,1,0,30,29
1683664415185,MMW 11R,A02,205026,Herbst; Matthew,29,0,30,1
1683664416213,MMW 15,A01,193512,Chang; Edmond Yi-Teh,0,8,28,28
1683664416213,MMW 15,A02,193513,Chang; Edmond Yi-Teh,0,5,28,28
1683664416213,MMW 15,A03,193514,Chang; Edmond Yi-Teh,0,5,28,28
1683664416213,MMW 15,A04,193515,Chang; Edmond Yi-Teh,0,5,28,28
1683664416213,MMW 15,A05,193516,Chang; Edmond Yi-Teh,0,5,28,28
1683664416213,MMW 15,A06,193517,Chang; Edmond Yi-Teh,0,6,28,28
1683664416213,MMW 15,B01,193519,Chang; Edmond Yi-Teh,0,5,28,28
1683664416213,MMW 15,B02,193520,Chang; Edmond Yi-Teh,0,5,28,28
1683664416213,MMW 15,B03,193521,Chang; Edmond Yi-Teh,0,5,28,28
1683664416213,MMW 15,B04,193522,Chang; Edmond Yi-Teh,0,5,28,28
1683664416213,MMW 15,B05,193523,Chang; Edmond Yi-Teh,0,5,28,28
1683664416213,MMW 15,B06,193524,Chang; Edmond Yi-Teh,0,5,28,28
1683664417241,MMW 122,A01,193526,Rahimi; Babak,0,16,28,28
1683664417241,MMW 122,A02,193527,Rahimi; Babak,0,15,28,28
1683664417241,MMW 122,A03,193528,Rahimi; Babak,0,0,0,0
1683664417241,MMW 122,A04,193529,Rahimi; Babak,0,0,0,0
1683664418269,MUS 1A,A01,186663,Staff,1,20,35,34
1683664419293,MUS 4,A01,186715,Staff,0,12,35,35
1683664420320,MUS 5R,A01,186796,Dubnov; Shlomo,0,17,35,35
1683664421345,MUS 6,A01,186798,Staff,0,5,25,25
1683664422372,MUS 7,A01,186830,Staff,11,0,35,24
1683664423398,MUS 8,A01,186930,Staff,0,26,35,35
1683664424422,MUS 15,A01,186932,Staff,0,16,35,35
1683664424422,MUS 15,B01,186934,Staff,1,17,35,34
1683664425445,MUS 80,A00,186935,Staff,0,0,20,20
1683664425445,MUS 80,B00,186936,Staff,24,0,25,1
1683664426469,NANO 11,A00,204702,Lipomi; Darren John,0,0,0,0
1683664427492,NANO 15,A01,204709,Yang; Kesong,0,1,0,0
1683664428520,NANO 114,A00,202069,Jahed Motlagh; Zeinab,3,0,10,7
1683664429546,PHIL 1,A00,186955,Grush; Rick Scott,31,0,40,9
1683664430569,PHIL 10,A01,186973,Grush; Rick Scott,27,0,35,8
1683664430569,PHIL 10,A02,186974,Grush; Rick Scott,33,0,35,2
1683664431593,PHIL 13,A01,186976,Staff,3,0,35,32
1683664431593,PHIL 13,A02,186977,Staff,16,0,35,19
1683664432620,PHIL 14,A01,186979,Staff,31,0,35,4
1683664432620,PHIL 14,A02,186986,Staff,32,0,35,3
1683664433647,PHIL 28,A01,186988,Staff,16,0,30,14
1683664433647,PHIL 28,A02,186989,Staff,1,0,30,29
1683664433647,PHIL 28,A03,186990,Staff,10,0,30,20
1683664433647,PHIL 28,A04,186991,Staff,26,0,30,4
1683664434671,PHIL 120,A00,186997,Staff,23,0,40,17
1683664435703,PHIL 137,A00,187003,Staff,7,0,40,33
1683664436730,PHIL 150,A00,187015,Staff,47,0,70,23
1683664437754,PHIL 167,A00,187021,Lamey; Andy M.,34,0,40,6
1683664438778,PHIL 174,A01,202226,Staff,17,0,20,3
1683664438778,PHIL 174,A02,202235,Staff,20,0,20,0
1683664439804,PHIL 191A,A00,258918,Staff,0,0,1,1
1683664440827,PHYS 1A,A00,187028,Staff,26,0,60,34
1683664441853,PHYS 1AL,001,187036,Staff,3,0,30,27
1683664441853,PHYS 1AL,002,187049,Staff,18,0,30,12
1683664442877,PHYS 1B,A00,187058,Staff,22,0,60,38
1683664443905,PHYS 1BL,001,187064,Staff,0,1,30,30
1683664443905,PHYS 1BL,002,187070,Staff,4,0,30,26
1683664444929,PHYS 1C,A00,187082,Staff,29,0,120,91
1683664445957,PHYS 1CL,001,187088,Staff,0,9,30,30
1683664445957,PHYS 1CL,002,187089,Staff,0,1,30,30
1683664445957,PHYS 1CL,009,262693,Staff,9,0,30,21
1683664446981,PHYS 2B,A01,187097,Staff,55,0,115,60
1683664448006,PHYS 2C,A01,187099,Staff,63,0,115,52
1683664449035,PHYS 2CL,A01,187101,Staff,5,0,28,23
1683664449035,PHYS 2CL,A02,187102,Staff,15,0,28,13
1683664450059,PHYS 2D,A01,187123,Shotwell; Brian,95,0,115,20
1683664451088,PHYS 4B,A01,187133,Grinstein; Benjamin,35,0,50,15
1683664452113,POLI 10,A00,188819,Staff,0,4,50,50
1683664453137,POLI 11,A00,188827,Staff,43,0,50,7
1683664454161,POLI 13R,A00,188828,Staff,0,1,20,20
1683664455185,POLI 27,A01,188830,Elgin; Samuel Zincke,0,2,70,70
1683664456211,POLI 30,A00,188832,Desposato; Scott,30,0,50,20
1683664457248,POLI 102F,A00,188834,Staff,0,0,40,40
1683664458275,POLI 104A,A00,188852,Staff,13,0,30,17
1683664459299,POLI 104I,A00,188853,Staff,0,7,20,20
1683664460324,POLI 110B,A00,188854,Wiens; David,6,0,20,14
1683664461349,POLI 112A,A00,188855,Wiens; David,3,0,30,27
1683664462377,POLI 117R,A00,188856,Forman; Fonna,0,12,20,20
1683664463402,POLI 118,A00,188857,Ingham; Sean,8,0,20,12
1683664464425,POLI 120G,A00,188858,Staff,8,0,30,22
1683664465459,POLI 131CR,A00,188863,Hoston; Germaine,21,0,50,29
1683664466487,POLI 133,A00,188864,Nellis; Gareth Hb,44,0,50,6
1683664467513,POLI 134D,A00,188865,Desposato; Scott,27,0,30,3
1683664468538,POLI 142A,A00,188871,Gartzke; Erik,21,0,50,29
1683664469562,POLI 142K,A00,188874,Staff,38,0,50,12
1683664470586,POLI 143,A00,188940,Gartzke; Erik,16,0,30,14
1683664471613,POLI 153,A00,188943,Staff,2,0,20,18
1683664472639,POLI 160AA,A00,188944,Staff,11,0,40,29
1683664473663,POLI 170A,A00,188945,Staff,11,0,30,19
1683664475718,PSYC 1,A00,188952,Staff,36,0,90,54
1683664476743,PSYC 2,B00,188953,Staff,19,0,35,16
1683664477767,PSYC 6,A00,188970,Staff,47,0,60,13
1683664478851,PSYC 7,A00,188973,Staff,35,0,45,10
1683664479877,PSYC 60,A01,188980,Rickard; Timothy C.,42,0,60,18
1683664480901,PSYC 70,A01,189001,Steiner; Eric Tomas,22,0,45,23
1683664481925,PSYC 100,A00,189005,Lacefield; Katharine I,0,99,120,120
1683664482949,PSYC 102,A00,189008,Staff,8,0,30,22
1683664483976,PSYC 106,B00,189026,Gorman; Michael R.,27,0,60,33
1683664485000,PSYC 114,B01,189033,Winkielman; Piotr,0,31,30,30
1683664486028,PSYC 131,A00,189036,Anagnostaras; Stephan,0,43,60,60
1683664487054,PSYC 136,A00,189041,Lowe; Angela Beth,0,7,25,25
1683664488078,PSYC 137,A00,189057,Winkielman; Piotr,0,37,25,25
1683664489102,PSYC 144,A00,189107,Wixted; John T,0,11,50,50
1683664491154,PSYC 162,A00,189142,Staff,0,9,85,85
1683664492179,PSYC 172,A00,189144,Gorman; Michael R.,0,6,30,30
1683664494231,PSYC 179,A00,189146,Lacefield; Katharine I,0,87,120,120
1683664495257,PSYC 181,A00,189147,Anagnostaras; Stephan,0,44,90,90
1683664496282,PSYC 190R,A00,189148,Barner; David A.,0,23,80,80
1683664497305,PSYC 191,A00,189275,Rickard; Timothy C.,0,10,25,25
1683664498327,PSYC 193,A00,189276,Chapman; Eddie Nathaniel,0,1,0,4
1683664499355,PSYC 193L,A01,189281,Lowe; Angela Beth,10,0,20,10
1683664499355,PSYC 193L,B01,189285,Staff,28,0,35,7
1683664500381,RELI 149,A00,187137,Rahimi; Babak,7,0,40,33
1683664501403,SE 9,A01,187315,Staff,0,2,18,18
1683664502430,SE 101B,A00,187409,Staff,24,0,30,6
1683664503454,SE 110B,A00,187444,Staff,10,0,40,30
1683664504482,SE 130B,A00,187449,Staff,31,0,40,9
1683664505507,SE 150A,A00,187516,Staff,8,0,20,12
1683664506534,SE 154,A00,187528,Staff,29,0,50,21
1683664507558,SIO 3,A01,258171,Staff,35,0,40,5
1683664508581,SIO 10,A00,187144,Cook; Geoffrey W,0,7,75,75
1683664509608,SIO 45,A00,187152,Cook; Geoffrey W,0,5,100,100
1683664510631,SIO 109R,A00,194486,Staff,0,4,20,20
1683664512678,SIO 187,A01,187233,Kacev; David,12,0,40,28
1683664513703,SOCI 1,A01,258656,Thorpe; Charles Robert,28,0,30,2
1683664513703,SOCI 1,A02,258658,Thorpe; Charles Robert,30,0,30,0
1683664513703,SOCI 1,A03,258661,Thorpe; Charles Robert,25,0,25,0
1683664513703,SOCI 1,A04,258666,Thorpe; Charles Robert,22,0,25,3
1683664513703,SOCI 1,A05,258897,Thorpe; Charles Robert,22,0,25,3
1683664513703,SOCI 1,A06,258898,Thorpe; Charles Robert,25,0,25,0
1683664514731,SOCI 30,A01,258903,Pardo Guerra; Juan Pablo,14,0,30,16
1683664515766,SOCI 102,A00,258904,Staff,9,0,25,16
1683664516790,SOCI 106,A00,258905,Staff,19,0,25,6
1683664517813,SOCI 111,A00,258907,Ribas Norris; Janet Vanesa,26,0,30,4
1683664518837,SOCI 121R,A00,258908,Pardo Guerra; Juan Pablo,8,0,30,22
1683664519859,SOCI 126,A01,203330,Staff,14,0,20,6
1683664520883,SOCI 131,A00,258909,Thorpe; Charles Robert,30,0,60,30
1683664521907,SOCI 135,A00,258910,Payne; Christine Anna,0,11,30,30
1683664522932,SOCI 157,A00,258911,Staff,12,0,30,18
1683664523957,SOCI 184,A00,258912,Staff,25,0,30,5
1683664524983,SOCI 188D,A00,258913,Staff,22,0,30,8
1683664526011,SYN 2,001,187529,Staff,9,0,16,7
1683664526011,SYN 2,002,201452,Staff,0,20,16,16
1683664526011,SYN 2,003,201469,Staff,1,0,16,15
1683664527037,SYN 100,A01,187531,Staff,0,9,20,20
1683664527037,SYN 100,B01,201491,Staff,0,10,20,20
1683664528060,TDAC 1,A00,189286,Walsh; Kim C.,3,0,20,17
1683664528060,TDAC 1,B00,189287,Harting; Carla Kelso,10,0,20,10
1683664529089,TDAC 101,A00,189300,Walsh; Kim C.,16,0,20,4
1683664529089,TDAC 101,B00,189301,Harting; Carla Kelso,18,0,20,2
1683664530118,TDAC 102,A00,189304,Basso; Beatrice,14,0,20,6
1683664531141,TDAC 108,A00,189305,Staff,18,0,20,2
1683664532167,TDDE 131,A00,189310,Staff,19,0,20,1
1683664532167,TDDE 131,B00,189314,Staff,19,0,20,1
1683664532167,TDDE 131,C00,189315,Staff,48,0,50,2
1683664532167,TDDE 131,D00,189316,Staff,14,0,15,1
1683664532167,TDDE 131,E00,204841,Staff,20,0,20,0
1683664533191,TDGE 10,A00,189289,Staff,27,0,50,23
1683664533191,TDGE 10,B00,189290,Havis; Allan,0,1,50,50
1683664534215,TDGE 11,A00,189291,Fulton; Julia,0,4,50,50
1683664534215,TDGE 11,B00,189292,Staff,20,0,25,5
1683664534215,TDGE 11,C00,260270,Staff,0,0,0,0
1683664535239,TDGE 25,A00,189294,Staff,2,0,20,18
1683664536263,TDGE 124,A00,189318,Fulton; Julia,0,8,50,50
1683664537289,TDGE 125,A00,189319,Staff,13,0,25,12
1683664537289,TDGE 125,B00,189320,Staff,23,0,25,2
1683664538316,TDGE 127,A00,189322,Havis; Allan,1,0,50,49
1683664539342,TDHT 101,A00,189323,Staff,18,0,25,7
1683664539342,TDHT 101,B00,189324,Staff,25,0,25,0
1683664540369,TDHT 102,A00,189325,Staff,49,0,50,1
1683664541393,TDMV 1,A00,189295,Arcidiacono; Kristin,20,0,30,10
1683664541393,TDMV 1,B00,189296,Caligagan; Maria T.,24,0,30,6
1683664542418,TDMV 2,A00,189297,Sammartano; Tonnie,27,0,30,3
1683664542418,TDMV 2,B00,189299,Arcidiacono; Kristin,23,0,30,7
1683664543440,TDMV 3,A00,204998,Rincon; Alicia,22,0,30,8
1683664544464,TDMV 120,A00,189458,Sammartano; Tonnie,28,0,30,2
1683664545487,TDMV 138,A00,189541,Jun; Grace Shin Hae,20,0,40,20
1683664546515,TDMV 142,A00,189717,Caligagan; Tony,25,0,30,5
1683664546515,TDMV 142,B00,189718,Caligagan; Maria T.,25,0,30,5
1683664547537,TMC 2,A01,187533,Staff,25,0,25,0
1683664547537,TMC 2,A02,187534,Staff,25,0,25,0
1683664548561,USP 1,A01,187536,Kwak; Nancy,0,16,25,25
1683664549589,USP 5,A01,187538,Staff,9,0,25,16
1683664550615,USP 101,A00,199253,Staff,0,4,0,0
1683664551642,USP 124,A00,187562,Boomhower; Matthew Charles,0,0,30,30
1683664552666,USP 138,A00,187582,Staff,20,0,25,5
1683664553706,USP 152,A01,187597,Staff,3,0,25,22
1683664554731,USP 153,A00,187598,Staff,19,0,25,6
1683664555756,USP 168,A00,187607,Kwak; Nancy,2,0,5,3
1683664556779,USP 173,A00,187619,Staff,4,0,25,21
1683664557807,USP 181,A00,187638,Staff,0,4,25,25
1683664558831,VIS 103,A00,187650,Cruz; Edwin Teddy,17,0,75,58
1683664559855,VIS 110D,A00,187669,Staff,13,0,22,9
1683664560884,VIS 127C,A00,187720,Shen; Kuiyi,68,0,146,78
1683664561911,VIS 149,A00,187731,Yoldas; Pinar,1,14,22,21
1683664562945,VIS 151,A01,188091,Staff,22,0,34,12
1683664562945,VIS 151,A02,188092,Staff,11,0,34,23
1683664563970,VIS 160B,A00,188093,Stalbaum; Brett,0,1,10,10
1683664566018,WCWP 10B,A00,201720,Staff,10,0,15,5
1683664566018,WCWP 10B,B00,201722,Staff,9,0,15,6
1683664567042,WCWP 100,A00,201725,Gagnon; Jeffrey C,0,0,2,2
1683664567042,WCWP 100,B00,201727,Staff,0,4,15,15
1683664570134,ANBI 133,A00,258401,Wilder; Linnea Lorene,34,0,40,6
1683664571158,ANBI 140,A00,258395,Hrvoj Mihic; Branka,18,0,25,7
1683664572182,ANSC 120,A00,258402,Bialecki; Jon Anthony,26,0,40,14
1683664573214,ANSC 144,A00,258400,Staff,12,0,40,28
1683664575268,ANSC 166,A00,258396,Parish; Steven Martin,156,0,175,19
1683664576294,ANSC 180,A00,193533,Staff,8,0,20,12
1683664577319,ANSC 188,A00,258397,Jassal; Aftab,34,0,40,6
1683664578348,ANTH 3,A01,258316,Staff,23,0,30,7
1683664579375,ANTH 5,A00,258394,Semendeferi; Ekaterini,16,0,20,4
1683664580398,ANTH 21,A01,258331,Staff,4,0,40,36
1683664581422,ANTH 103,A00,258398,Varma; Saiba,15,0,25,10
1683664582505,AWP 10,001,202034,Staff,0,0,0,0
1683664582505,AWP 10,002,202035,Staff,0,0,0,0
1683664582505,AWP 10,003,202036,Staff,0,0,0,0
1683664582505,AWP 10,004,202037,Staff,0,0,0,0
1683664582505,AWP 10,005,202038,Staff,0,0,0,0
1683664582505,AWP 10,006,202039,Staff,0,0,0,0
1683664582505,AWP 10,007,202040,Staff,0,0,0,0
1683664582505,AWP 10,008,202041,Staff,0,0,0,0
1683664582505,AWP 10,009,202042,Staff,0,0,0,0
1683664582505,AWP 10,010,202043,Staff,0,0,0,0
1683664582505,AWP 10,011,202044,Staff,0,0,0,0
1683664582505,AWP 10,012,202045,Staff,0,0,0,0
1683664582505,AWP 10,013,202046,Staff,0,0,0,0
1683664582505,AWP 10,014,202047,Staff,0,0,0,0
1683664582505,AWP 10,015,202048,Staff,0,0,0,0
1683664582505,AWP 10,016,202049,Staff,0,0,0,0
1683664582505,AWP 10,017,202050,Staff,0,0,0,0
1683664582505,AWP 10,018,202051,Staff,0,0,0,0
1683664582505,AWP 10,019,202052,Staff,0,0,0,0
1683664582505,AWP 10,020,202053,Staff,0,0,0,0
1683664582505,AWP 10,021,202054,Staff,0,0,0,0
1683664582505,AWP 10,022,202055,Staff,0,0,0,0
1683664582505,AWP 10,023,202056,Staff,0,0,0,0
1683664582505,AWP 10,024,202057,Staff,0,0,0,0
1683664582505,AWP 10,025,202058,Staff,0,0,0,0
1683664582505,AWP 10,026,202059,Staff,0,0,0,0
1683664583531,AWP 102,001,202032,Staff,0,0,0,0
1683664583531,AWP 102,002,202033,Staff,0,0,0,0
1683664584558,BENG 100,A01,254234,Taylor Amos; Alyssa C,31,0,40,9
1683664585583,BENG 196,001,270013,Engler; Adam J.,9999,0,9999,0
1683664586613,BICD 100R,A01,202018,Smith; Laurie,0,7,32,32
1683664586613,BICD 100R,A02,202019,Smith; Laurie,0,3,32,32
1683664586613,BICD 100R,A03,202020,Smith; Laurie,0,1,32,32
1683664586613,BICD 100R,A04,202021,Smith; Laurie,6,0,32,26
1683664586613,BICD 100R,A05,202022,Smith; Laurie,11,0,32,21
1683664587639,BICD 136,A01,193242,Gustafson-Brown; Cindy,0,2,32,32
1683664587639,BICD 136,A02,193244,Gustafson-Brown; Cindy,13,0,32,19
1683664588664,BIEB 102,A01,193249,Butler; Shannon Rhey,1,2,32,31
1683664588664,BIEB 102,A02,193251,Butler; Shannon Rhey,0,0,32,32
1683664588664,BIEB 102,A03,193253,Butler; Shannon Rhey,0,0,32,32
1683664588664,BIEB 102,A04,193255,Butler; Shannon Rhey,14,0,32,18
1683664588664,BIEB 102,A05,193265,Butler; Shannon Rhey,25,0,32,7
1683664588664,BIEB 102,A06,193269,Butler; Shannon Rhey,14,0,32,18
1683664590712,BIEB 150,A01,193274,Staff,0,0,32,32
1683664590712,BIEB 150,A02,193285,Staff,24,0,32,8
1683664591738,BIEB 194,A00,193286,Kurle; Carolyn M.,20,0,32,12
1683664592762,BILD 1,A01,192291,Staff,15,0,32,17
1683664592762,BILD 1,A02,192292,Staff,30,0,32,2
1683664592762,BILD 1,B01,192520,Reuther; Keefe,0,1,0,0
1683664592762,BILD 1,B02,192532,Reuther; Keefe,0,1,0,0
1683664593787,BILD 3,A01,192556,Butler; Shannon Rhey,0,0,32,32
1683664593787,BILD 3,A02,192581,Butler; Shannon Rhey,0,0,32,32
1683664593787,BILD 3,A03,192611,Butler; Shannon Rhey,21,0,32,11
1683664593787,BILD 3,A04,192612,Butler; Shannon Rhey,24,0,32,8
1683664593787,BILD 3,A05,192613,Butler; Shannon Rhey,26,0,32,6
1683664593787,BILD 3,A06,192679,Butler; Shannon Rhey,27,0,32,5
1683664593787,BILD 3,A07,192682,Butler; Shannon Rhey,20,0,32,12
1683664594813,BILD 4,A01,192836,Reuther; Keefe,1,0,24,23
1683664594813,BILD 4,A02,193044,Reuther; Keefe,4,0,24,20
1683664595847,BILD 10,A01,193142,Gustafson-Brown; Cindy,29,0,32,3
1683664595847,BILD 10,A02,193149,Gustafson-Brown; Cindy,31,0,32,1
1683664596871,BIMM 100,A01,193301,Staff,0,6,32,32
1683664596871,BIMM 100,A02,193312,Staff,0,7,32,32
1683664596871,BIMM 100,A03,193323,Staff,0,9,32,32
1683664597903,BIMM 101,A01,193329,McDonnell; Lisa Marie,0,4,24,24
1683664597903,BIMM 101,A02,193339,McDonnell; Lisa Marie,1,4,24,23
1683664597903,BIMM 101,B01,193354,McDonnell; Lisa Marie,0,4,24,24
1683664597903,BIMM 101,B02,193357,McDonnell; Lisa Marie,0,3,24,24
1683664598926,BIMM 110,A01,193377,Tat; John,0,11,32,32
1683664598926,BIMM 110,A02,193378,Tat; John,0,10,32,32
1683664599949,BIMM 120,A01,206116,Staff,0,0,32,32
1683664599949,BIMM 120,A02,206117,Staff,6,0,32,26
1683664599949,BIMM 120,A03,206121,Staff,21,0,32,11
1683664600974,BIPN 100,A01,193393,Park; Ji Young,0,15,32,32
1683664600974,BIPN 100,A02,193402,Park; Ji Young,0,14,32,32
1683664600974,BIPN 100,A03,193413,Park; Ji Young,0,14,32,32
1683664600974,BIPN 100,A04,193414,Park; Ji Young,0,13,32,32
1683664602002,BIPN 102,A01,193429,Staff,0,0,32,32
1683664602002,BIPN 102,A02,193438,Staff,18,0,32,14
1683664603029,BIPN 106,A01,193450,Reyes Gonzalez; Catalina,0,2,40,40
1683664604055,BIPN 134,A01,193465,Cooke; James Edward,0,0,32,32
1683664604055,BIPN 134,A02,193474,Cooke; James Edward,25,0,32,7
1683664604055,BIPN 134,A03,193485,Cooke; James Edward,29,0,32,3
1683664604055,BIPN 134,A04,193486,Cooke; James Edward,20,0,32,12
1683664604055,BIPN 134,A05,193491,Cooke; James Edward,31,0,32,1
1683664604055,BIPN 134,A06,193501,Cooke; James Edward,30,0,32,2
1683664604055,BIPN 134,A07,193510,Cooke; James Edward,29,0,32,3
1683664606108,BISP 194,A00,222522,Staff,14,0,32,18
1683664607132,CAT 124,A01,202407,Staff,19,0,25,6
1683664608155,CAT 125,A00,202408,Marchisotto; Jennifer Anne,2,0,20,18
1683664609181,CAT 125R,A00,202409,Smith; Lauryn Alissa,0,11,20,20
1683664609181,CAT 125R,B00,202410,Morales; Celeste Georgianna,0,11,20,20
1683664609181,CAT 125R,C00,202411,Irwin; Matthew Joseph,0,12,20,20
1683664610205,CENG 15,A01,204712,Yang; Kesong,0,1,0,0
1683664611231,CENG 114,A00,202070,Jahed Motlagh; Zeinab,5,0,20,15
1683664612254,CGS 105,A00,185477,Wesling; Megan E.,24,0,40,16
1683664613276,CGS 106,A00,185494,Staff,11,0,22,11
1683664614300,CGS 108,A00,185495,Staff,14,0,20,6
1683664615327,CGS 114,A00,185496,Staff,13,0,18,5
1683664616354,CGS 119,A00,185501,Staff,15,0,20,5
1683664617380,CGS 120,A00,185511,Staff,12,0,20,8
1683664618402,CHEM 4,A01,184675,Bussey; Thomas J,97,0,100,3
1683664619426,CHEM 6A,A01,184677,Staff,32,0,60,28
1683664620454,CHEM 6B,A01,184679,Staff,63,0,100,37
1683664621481,CHEM 6C,A01,184681,Bussey; Thomas J,0,0,50,50
1683664621481,CHEM 6C,A02,184682,Bussey; Thomas J,32,0,50,18
1683664622509,CHEM 40A,A01,184684,Albizati; Kim F.,34,0,100,66
1683664623537,CHEM 40B,A01,184686,Albizati; Kim F.,0,22,100,100
1683664624561,CHEM 41B,A01,184690,Staff,51,0,100,49
1683664625587,COGS 3,A01,184715,Boyle; Mary E. T.,0,27,40,40
1683664626614,COGS 14B,A01,185172,Staff,0,14,38,38
1683664627638,COGS 18,A01,184736,Staff,14,0,80,66
1683664628666,COGS 100,A01,184932,Staff,0,7,73,73
1683664629693,COGS 101A,A01,184935,Staff,0,40,30,30
1683664630715,COGS 101B,A01,184944,Staff,0,2,30,30
1683664631739,COGS 101C,A01,184946,Staff,0,10,30,30
1683664632763,COGS 102A,A01,184951,Johnson; Christine M.,2,0,40,38
1683664633792,COGS 107B,A01,184953,Mooshagian; Eric Frederick,0,51,40,40
1683664634816,COGS 118B,A01,184959,Gupta; Anjum,0,50,40,40
1683664635855,COGS 153,A00,184961,Staff,0,16,30,30
1683664636882,COGS 177,A00,184962,Staff,0,21,30,30
1683664637909,COGS 187A,A01,184969,Boyle; Mary E. T.,0,19,40,40
1683664638933,COMM 10,A01,185174,Staff,0,5,25,25
1683664638933,COMM 10,A02,185189,Staff,0,2,25,25
1683664638933,COMM 10,A03,269821,Staff,0,1,0,0
1683664639961,COMM 100B,A01,185475,Staff,0,1,0,2
1683664639961,COMM 100B,A02,185476,Staff,12,0,25,13
1683664640985,COMM 100C,A01,185314,Staff,1,0,25,24
1683664640985,COMM 100C,A02,185327,Staff,18,0,25,7
1683664642013,COMM 110M,A00,185349,Staff,0,0,40,40
1683664643035,COMM 113T,A00,185352,Staff,25,0,40,15
1683664644060,COMM 114I,A00,185353,Staff,31,0,40,9
1683664645083,COMM 131,A00,185354,Staff,17,0,30,13
1683664646108,CSE 8A,A50,185358,Cao; Yingjun,0,46,10,10
1683664647132,CSE 8B,A01,185362,Staff,0,48,50,50
1683664648154,CSE 11,A01,185416,Cao; Yingjun,0,91,10,10
1683664649178,CSE 20,A01,185445,Briones; Jor-el Thomas Caparas,4,0,25,21
1683664650202,CSE 21,A01,185447,Staff,9,0,50,41
1683664651230,CSE 101,A01,185451,Staff,0,13,50,50
1683664651230,CSE 101,B01,185453,Jones; Miles E,0,14,50,50
1683664653281,CSE 141,A01,185458,Eldon; John,16,0,100,84
1683664654318,CSE 141L,A01,185461,Eldon; John,8,0,100,92
1683664655341,CSE 142,A01,185463,Staff,34,0,60,26
1683664655341,CSE 142,B01,201355,Staff,0,7,60,60
1683664656366,CSE 142L,A01,185470,Staff,34,0,60,26
1683664656366,CSE 142L,B01,201417,Staff,0,6,60,60
1683664657390,CSE 190,A00,201433,Staff,32,0,49,17
1683664658414,DOC 1,A01,259136,Strom; Megan C.,7,0,15,8
1683664658414,DOC 1,A02,259137,Strom; Megan C.,14,0,15,1
1683664658414,DOC 1,A03,259138,Strom; Megan C.,14,0,15,1
1683664658414,DOC 1,A04,259139,Strom; Megan C.,14,0,15,1
1683664659438,DOC 100D,A00,259140,Pass; Natalye Joann,14,0,25,11
1683664660465,DSGN 1,A01,184749,Rill; Bryan,0,26,30,30
1683664661489,DSGN 100,A01,185168,Staff,0,2,25,25
1683664662517,ECE 5,A01,185626,Morris; Karcher William,0,12,0,0
1683664663541,ECE 101,A01,185628,Staff,14,0,70,56
1683664664568,ECE 107,A01,185635,Baghdadchi; Saharnaz,0,0,20,20
1683664664568,ECE 107,A02,185638,Baghdadchi; Saharnaz,2,0,20,18
1683664665592,ECE 148,A01,185647,Silberman; Jack,0,0,16,16
1683664666616,ECON 1,A01,185537,Crane; Meredith Helen,54,0,70,16
1683664667644,ECON 3,A01,185549,Crane; Meredith Helen,29,0,70,41
1683664668669,ECON 4,A01,203354,Anderson; John Charles,0,5,10,10
1683664669698,ECON 100A,A01,185574,Staff,0,5,40,40
1683664670722,ECON 100B,A01,185576,Staff,0,12,50,50
1683664671747,ECON 100C,A01,185589,Newhouse; Herbert S,30,0,70,40
1683664672774,ECON 105,A00,185608,Vespa; Emanuel Ignacio,19,0,35,16
1683664673801,ECON 109,A01,185610,Shishkin; Denis,9,0,35,26
1683664674824,ECON 110A,A01,185612,Staff,9,0,40,31
1683664675851,ECON 120A,A01,185615,Staff,20,0,40,20
1683664676875,ECON 120C,A01,185617,Sun; Yixiao,0,20,70,70
1683664677903,ECON 144,A00,203346,Squires; Dale E,2,0,35,33
1683664678927,ECON 171,A01,203349,Newhouse; Herbert S,0,1,35,35
1683664679954,ECON 173A,A01,185621,Toda; Alexis Akira,20,0,35,15
1683664680983,EDS 25,A01,202413,Staff,0,1,0,0
1683664680983,EDS 25,A02,202414,Staff,0,1,0,0
1683664680983,EDS 25,A03,202415,Staff,0,0,0,0
1683664680983,EDS 25,A04,202416,Staff,0,1,0,0
1683664680983,EDS 25,A05,202439,Staff,0,0,0,0
1683664680983,EDS 25,A06,202440,Staff,0,0,0,0
1683664680983,EDS 25,B01,202631,Staff,0,0,0,0
1683664680983,EDS 25,B02,202632,Staff,0,0,0,0
1683664680983,EDS 25,B03,202639,Staff,0,0,0,0
1683664680983,EDS 25,B04,202640,Staff,0,0,0,0
1683664680983,EDS 25,B05,202643,Staff,0,0,0,0
1683664680983,EDS 25,B06,202644,Staff,0,0,0,0
1683664682009,EDS 38,A01,202659,Black; Alison Michelle,24,0,25,1
1683664683037,EDS 115,A00,202652,Staff,18,0,30,12
1683664684064,EDS 125,A00,202649,Staff,13,0,30,17
1683664685088,EDS 126,A01,203332,Staff,30,0,30,0
1683664686186,EDS 139,A00,202838,Staff,16,0,25,9
1683664687211,EDS 146,A01,202655,Staff,14,0,25,11
1683664688241,ENG 15,A00,185667,Staff,0,1,0,0
1683664688241,ENG 15,B00,185672,Staff,0,0,0,0
1683664688241,ENG 15,C00,185675,Staff,0,0,0,0
1683664688241,ENG 15,D00,185682,Staff,0,0,0,0
1683664688241,ENG 15,E00,185684,Staff,0,0,0,0
1683664689279,ETHN 103,A00,185710,Staff,0,8,35,35
1683664690306,ETHN 103A,A00,199228,Man; Simeon S,0,0,9,9
1683664691330,ETHN 109,A00,185711,Staff,15,0,35,20
1683664692356,ETHN 142,A00,185726,Staff,0,4,30,30
1683664693383,ETHN 163J,A00,199229,Man; Simeon S,5,0,8,3
1683664694411,ETHN 168,A00,185727,Staff,7,0,10,3
1683664695434,ETHN 182,A00,185728,Staff,0,0,35,35
1683664696463,ETHN 183,A00,185737,Staff,9,0,18,9
1683664697489,GLBH 111,A01,209361,Burgos; Jose L.,0,0,0,0
1683664699539,HIEU 104,A00,185792,Staff,14,0,20,6
1683664700566,HIEU 115,A00,185800,Staff,0,0,20,20
1683664701590,HIEU 128,A00,185801,Staff,0,9,20,20
1683664702617,HIEU 147,A00,185802,Staff,15,0,20,5
1683664703643,HIEU 154,A00,185823,Staff,11,0,20,9
1683664704669,HILA 102,A00,185826,Staff,14,0,20,6
1683664705697,HILD 2C,A01,185778,Staff,0,13,20,20
1683664706725,HILD 7B,A01,185780,Kwak; Nancy,0,17,32,32
1683664706725,HILD 7B,A02,185781,Kwak; Nancy,0,18,32,32
1683664707749,HILD 30,A01,185791,Staff,12,0,20,8
1683664708777,HISC 119,A00,185830,Golan; Tal,0,9,20,20
1683664709804,HITO 156GS,A00,185831,Patterson; Patrick H.,0,0,0,23
1683664710827,HIUS 103,A00,185832,Man; Simeon S,0,4,20,20
1683664711853,HIUS 117,A00,185836,Kwak; Nancy,2,0,20,18
1683664712877,HIUS 125,A00,185840,Man; Simeon S,0,2,23,23
1683664713903,HIUS 149,A00,185845,Staff,1,0,20,19
1683664714932,HUM 3,A01,185882,Zavodny; Tatiana Sophia,0,8,50,50
1683664714932,HUM 3,B01,185899,Caldwell; Michael Alan,0,18,50,50
1683664715956,HUM 3GS,A00,185900,Patterson; Patrick H.,0,0,0,23
1683664716985,HUM 4,A01,185938,Zroka; Amy Liane,29,0,50,21
1683664716985,HUM 4,B01,185956,Watkins; Eric,0,5,50,50
1683664716985,HUM 4,B02,202209,Watkins; Eric,0,5,50,50
1683664716985,HUM 4,B03,202210,Watkins; Eric,0,5,50,50
1683664718009,HUM 5,A01,185958,West; Geoffrey Scott,0,0,50,50
1683664718009,HUM 5,A02,202215,West; Geoffrey Scott,0,0,50,50
1683664719034,INTL 190,A00,185959,Gagnon; Jeffrey C,0,0,0,9
1683664719034,INTL 190,B00,185960,Lettieri; Michael Joseph,0,0,0,2
1683664720059,JAPN 180,A00,254509,Staff,5,0,30,25
1683664721087,LATI 10,A01,202853,Kennemore; Amy Michelle,4,0,35,31
1683664721087,LATI 10,A02,202854,Kennemore; Amy Michelle,2,0,35,33
1683664721087,LATI 10,A03,270054,Kennemore; Amy Michelle,30,0,30,0
1683664722114,LATI 180,A00,202855,Kennemore; Amy Michelle,11,0,20,9
1683664723138,LAWS 101,A00,201767,Golan; Tal,0,7,40,40
1683664724164,LIFR 1C,A00,185961,Staff,6,0,20,14
1683664725191,LIFR 1CX,A00,185962,Staff,7,0,20,13
1683664726213,LIFR 1D,A00,185963,Staff,7,0,20,13
1683664727240,LIFR 1DX,A00,185964,Staff,7,0,20,13
1683664728263,LIGN 101,A01,186039,Staff,43,0,50,7
1683664729285,LIGN 165,A00,186040,Staff,15,0,50,35
1683664730311,LTCS 108,A00,186041,Staff,5,0,10,5
1683664731335,LTCS 119,A00,186042,Staff,15,0,20,5
1683664732359,LTCS 130,A00,186043,Wesling; Megan E.,15,0,25,10
1683664734409,LTEA 138,A00,186119,Staff,14,0,40,26
1683664735434,LTEN 124,A00,186148,Staff,5,0,25,20
1683664736461,LTEN 178,A00,186149,Staff,7,0,15,8
1683664737485,LTEN 181,A00,186150,Blanco; John D,34,0,40,6
1683664738508,LTWL 120,A00,186160,Staff,20,0,25,5
1683664739533,LTWL 165,A00,186161,Staff,22,0,25,3
1683664740563,LTWR 100,A00,186162,Staff,0,5,15,15
1683664741590,LTWR 102,A00,186163,Doller; Ben,5,0,15,10
1683664742616,MAE 8,A01,186412,Staff,0,0,0,0
1683664743646,MAE 30B,A00,186445,Bahadori; Mohammad Yousef,82,0,100,18
1683664744670,MAE 40,A00,186592,Bewley; Thomas R,10,0,50,40
1683664745697,MAE 101B,A00,186593,Bahadori; Mohammad Yousef,80,0,100,20
1683664746721,MAE 105,A00,186594,Bandaru; Prabhakar,10,0,50,40
1683664747744,MAE 107,A00,186599,Pham; Hieu Tan,0,7,120,120
1683664748774,MAE 148,A01,186660,Silberman; Jack,3,0,16,13
1683664749799,MATH 10A,A01,188095,Staff,0,6,35,35
1683664750829,MATH 10B,A01,188097,Bowers; Adam R.,0,12,30,30
1683664750829,MATH 10B,A02,188099,Bowers; Adam R.,0,11,30,30
1683664750829,MATH 10B,B01,188104,Bowers; Adam R.,0,10,30,30
1683664750829,MATH 10B,B02,188106,Bowers; Adam R.,1,9,30,29
1683664751860,MATH 10C,A01,188111,Staff,0,18,30,30
1683664751860,MATH 10C,A02,188127,Staff,0,19,30,30
1683664751860,MATH 10C,A03,188131,Staff,0,19,30,30
1683664751860,MATH 10C,B01,188218,Staff,17,0,30,13
1683664751860,MATH 10C,B02,188244,Staff,13,0,30,17
1683664751860,MATH 10C,B03,188277,Staff,14,0,30,16
1683664752885,MATH 18,A01,188344,Bach; Quang Tran,18,0,30,12
1683664752885,MATH 18,A02,188345,Bach; Quang Tran,11,0,30,19
1683664752885,MATH 18,B01,188353,Bach; Quang Tran,11,0,30,19
1683664752885,MATH 18,B02,188354,Bach; Quang Tran,19,0,30,11
1683664753918,MATH 20A,A01,188374,Staff,11,0,35,24
1683664754947,MATH 20B,A01,188382,Ohm; Ko Woon,7,0,30,23
1683664754947,MATH 20B,A02,188383,Ohm; Ko Woon,22,0,30,8
1683664754947,MATH 20B,B01,188385,Ohm; Ko Woon,7,0,30,23
1683664754947,MATH 20B,B02,188392,Ohm; Ko Woon,22,0,30,8
1683664755972,MATH 20C,A01,188394,Harel; Guershon,10,0,30,20
1683664755972,MATH 20C,A02,188395,Harel; Guershon,13,0,30,17
1683664755972,MATH 20C,B01,188404,Harel; Guershon,5,0,30,25
1683664755972,MATH 20C,B02,188405,Harel; Guershon,18,0,30,12
1683664756997,MATH 20D,A01,188414,Hammock; Frances H,0,1,30,30
1683664756997,MATH 20D,A02,188415,Hammock; Frances H,0,1,30,30
1683664756997,MATH 20D,B01,188447,Hammock; Frances H,0,1,30,30
1683664756997,MATH 20D,B02,188486,Hammock; Frances H,3,0,30,27
1683664758021,MATH 20E,A01,188649,Staff,21,0,30,9
1683664758021,MATH 20E,A02,188650,Staff,21,0,30,9
1683664758021,MATH 20E,A03,188673,Staff,0,0,30,30
1683664759047,MATH 102,A01,188675,Staff,0,36,35,35
1683664760073,MATH 103B,A01,188681,Staff,3,0,35,32
1683664760073,MATH 103B,B01,188692,Staff,5,0,35,30
1683664761099,MATH 109,A01,188695,Salehi Golsefidy; Alireza,24,0,35,11
1683664761099,MATH 109,A02,188696,Salehi Golsefidy; Alireza,25,0,35,10
1683664762125,MATH 120A,A01,188698,Eggers; John Dietrich,7,0,35,28
1683664763149,MATH 142B,A01,188736,Ioana; Adrian,1,1,30,29
1683664763149,MATH 142B,A02,188741,Ioana; Adrian,0,1,30,30
1683664763149,MATH 142B,A03,188743,Ioana; Adrian,0,1,30,30
1683664764176,MATH 168A,A01,188790,Staff,0,10,35,35
1683664765201,MATH 170A,A01,188803,Nie; Jiawang,0,2,35,35
1683664765201,MATH 170A,A02,188811,Nie; Jiawang,0,0,35,35
1683664765201,MATH 170A,A03,188814,Nie; Jiawang,0,0,35,35
1683664765201,MATH 170A,A04,188815,Nie; Jiawang,9,0,35,26
1683664766229,MATH 193B,A01,188817,Staff,0,0,35,35
1683664766229,MATH 193B,A02,188818,Staff,5,0,35,30
1683664767256,MGT 4,A01,202857,Anderson; John Charles,61,0,80,19
1683664768279,MGT 12,A00,202858,Lindenberger; Wade Douglas,40,0,90,50
1683664769303,MGT 18,A00,202859,Staff,74,0,90,16
1683664770330,MGT 18GS,A00,202860,McKay; Michael J,13,0,28,15
1683664771357,MGT 45,A00,202861,Pecore; Joseph P.,11,0,90,79
1683664772386,MGT 100,A00,202863,Yavorsky; Daniel Ryan,28,0,90,62
1683664773416,MGT 103,A00,202864,Ehrich; Kristine R,0,18,90,90
1683664774440,MGT 112,A00,202865,Ehrich; Kristine R,14,0,90,76
1683664775464,MGT 121A,A00,202868,Staff,90,20,90,0
1683664776490,MGT 131B,A00,202869,Anderson; John Charles,59,0,90,31
1683664777515,MGT 136,A00,202871,Lindenberger; Wade Douglas,83,0,90,7
1683664778539,MGT 164,A00,202873,Staff,0,67,90,91
1683664779568,MGT 164GS,A00,202874,McKay; Mary A,13,0,28,15
1683664780592,MGT 180,A00,202875,Staff,0,51,90,91
1683664781619,MMW 11R,A01,205019,Herbst; Matthew,1,0,30,29
1683664781619,MMW 11R,A02,205026,Herbst; Matthew,29,0,30,1
1683664782644,MMW 15,A01,193512,Chang; Edmond Yi-Teh,0,8,28,28
1683664782644,MMW 15,A02,193513,Chang; Edmond Yi-Teh,0,5,28,28
1683664782644,MMW 15,A03,193514,Chang; Edmond Yi-Teh,0,5,28,28
1683664782644,MMW 15,A04,193515,Chang; Edmond Yi-Teh,0,5,28,28
1683664782644,MMW 15,A05,193516,Chang; Edmond Yi-Teh,0,5,28,28
1683664782644,MMW 15,A06,193517,Chang; Edmond Yi-Teh,0,6,28,28
1683664782644,MMW 15,B01,193519,Chang; Edmond Yi-Teh,0,5,28,28
1683664782644,MMW 15,B02,193520,Chang; Edmond Yi-Teh,0,5,28,28
1683664782644,MMW 15,B03,193521,Chang; Edmond Yi-Teh,0,5,28,28
1683664782644,MMW 15,B04,193522,Chang; Edmond Yi-Teh,0,5,28,28
1683664782644,MMW 15,B05,193523,Chang; Edmond Yi-Teh,0,5,28,28
1683664782644,MMW 15,B06,193524,Chang; Edmond Yi-Teh,0,5,28,28
1683664783672,MMW 122,A01,193526,Rahimi; Babak,0,16,28,28
1683664783672,MMW 122,A02,193527,Rahimi; Babak,0,15,28,28
1683664783672,MMW 122,A03,193528,Rahimi; Babak,0,0,0,0
1683664783672,MMW 122,A04,193529,Rahimi; Babak,0,0,0,0
1683664784697,MUS 1A,A01,186663,Staff,1,20,35,34
1683664785724,MUS 4,A01,186715,Staff,0,12,35,35
1683664786751,MUS 5R,A01,186796,Dubnov; Shlomo,0,17,35,35
1683664787781,MUS 6,A01,186798,Staff,0,5,25,25
1683664788816,MUS 7,A01,186830,Staff,11,0,35,24
1683664789894,MUS 8,A01,186930,Staff,0,26,35,35
1683664790921,MUS 15,A01,186932,Staff,0,16,35,35
1683664790921,MUS 15,B01,186934,Staff,1,17,35,34
1683664791949,MUS 80,A00,186935,Staff,0,0,20,20
1683664791949,MUS 80,B00,186936,Staff,24,0,25,1
1683664792974,NANO 11,A00,204702,Lipomi; Darren John,0,0,0,0
1683664793997,NANO 15,A01,204709,Yang; Kesong,0,1,0,0
1683664795022,NANO 114,A00,202069,Jahed Motlagh; Zeinab,3,0,10,7
1683664796050,PHIL 1,A00,186955,Grush; Rick Scott,31,0,40,9
1683664797078,PHIL 10,A01,186973,Grush; Rick Scott,27,0,35,8
1683664797078,PHIL 10,A02,186974,Grush; Rick Scott,33,0,35,2
1683664798102,PHIL 13,A01,186976,Staff,3,0,35,32
1683664798102,PHIL 13,A02,186977,Staff,16,0,35,19
1683664799128,PHIL 14,A01,186979,Staff,31,0,35,4
1683664799128,PHIL 14,A02,186986,Staff,32,0,35,3
1683664800155,PHIL 28,A01,186988,Staff,16,0,30,14
1683664800155,PHIL 28,A02,186989,Staff,1,0,30,29
1683664800155,PHIL 28,A03,186990,Staff,10,0,30,20
1683664800155,PHIL 28,A04,186991,Staff,26,0,30,4
1683664801181,PHIL 120,A00,186997,Staff,23,0,40,17
1683664802210,PHIL 137,A00,187003,Staff,7,0,40,33
1683664803238,PHIL 150,A00,187015,Staff,47,0,70,23
1683664804265,PHIL 167,A00,187021,Lamey; Andy M.,34,0,40,6
1683664805294,PHIL 174,A01,202226,Staff,17,0,20,3
1683664805294,PHIL 174,A02,202235,Staff,20,0,20,0
1683664806318,PHIL 191A,A00,258918,Staff,0,0,1,1
1683664807347,PHYS 1A,A00,187028,Staff,26,0,60,34
1683664808376,PHYS 1AL,001,187036,Staff,3,0,30,27
1683664808376,PHYS 1AL,002,187049,Staff,18,0,30,12
1683664809400,PHYS 1B,A00,187058,Staff,22,0,60,38
1683664810429,PHYS 1BL,001,187064,Staff,0,1,30,30
1683664810429,PHYS 1BL,002,187070,Staff,4,0,30,26
1683664811455,PHYS 1C,A00,187082,Staff,29,0,120,91
1683664812484,PHYS 1CL,001,187088,Staff,0,9,30,30
1683664812484,PHYS 1CL,002,187089,Staff,0,1,30,30
1683664812484,PHYS 1CL,009,262693,Staff,9,0,30,21
1683664813509,PHYS 2B,A01,187097,Staff,55,0,115,60
1683664814537,PHYS 2C,A01,187099,Staff,63,0,115,52
1683664815567,PHYS 2CL,A01,187101,Staff,5,0,28,23
1683664815567,PHYS 2CL,A02,187102,Staff,15,0,28,13
1683664816592,PHYS 2D,A01,187123,Shotwell; Brian,95,0,115,20
1683664817619,PHYS 4B,A01,187133,Grinstein; Benjamin,35,0,50,15
1683664818646,POLI 10,A00,188819,Staff,0,4,50,50
1683664819672,POLI 11,A00,188827,Staff,43,0,50,7
1683664820697,POLI 13R,A00,188828,Staff,0,1,20,20
1683664821725,POLI 27,A01,188830,Elgin; Samuel Zincke,0,2,70,70
1683664822749,POLI 30,A00,188832,Desposato; Scott,30,0,50,20
1683664823776,POLI 102F,A00,188834,Staff,0,0,40,40
1683664824802,POLI 104A,A00,188852,Staff,13,0,30,17
1683664825828,POLI 104I,A00,188853,Staff,0,7,20,20
1683664826852,POLI 110B,A00,188854,Wiens; David,6,0,20,14
1683664827876,POLI 112A,A00,188855,Wiens; David,3,0,30,27
1683664828902,POLI 117R,A00,188856,Forman; Fonna,0,12,20,20
1683664829929,POLI 118,A00,188857,Ingham; Sean,8,0,20,12
1683664830954,POLI 120G,A00,188858,Staff,8,0,30,22
1683664831981,POLI 131CR,A00,188863,Hoston; Germaine,21,0,50,29
1683664833005,POLI 133,A00,188864,Nellis; Gareth Hb,44,0,50,6
1683664834030,POLI 134D,A00,188865,Desposato; Scott,27,0,30,3
1683664835057,POLI 142A,A00,188871,Gartzke; Erik,21,0,50,29
1683664836081,POLI 142K,A00,188874,Staff,38,0,50,12
1683664837105,POLI 143,A00,188940,Gartzke; Erik,16,0,30,14
1683664838128,POLI 153,A00,188943,Staff,2,0,20,18
1683664839151,POLI 160AA,A00,188944,Staff,11,0,40,29
1683664840175,POLI 170A,A00,188945,Staff,11,0,30,19
1683664842269,PSYC 1,A00,188952,Staff,36,0,90,54
1683664843293,PSYC 2,B00,188953,Staff,19,0,35,16
1683664844319,PSYC 6,A00,188970,Staff,47,0,60,13
1683664845346,PSYC 7,A00,188973,Staff,35,0,45,10
1683664846373,PSYC 60,A01,188980,Rickard; Timothy C.,42,0,60,18
1683664847401,PSYC 70,A01,189001,Steiner; Eric Tomas,22,0,45,23
1683664848424,PSYC 100,A00,189005,Lacefield; Katharine I,0,99,120,120
1683664849453,PSYC 102,A00,189008,Staff,8,0,30,22
1683664850477,PSYC 106,B00,189026,Gorman; Michael R.,27,0,60,33
1683664851503,PSYC 114,B01,189033,Winkielman; Piotr,0,31,30,30
1683664852526,PSYC 131,A00,189036,Anagnostaras; Stephan,0,43,60,60
1683664853550,PSYC 136,A00,189041,Lowe; Angela Beth,0,7,25,25
1683664854574,PSYC 137,A00,189057,Winkielman; Piotr,0,37,25,25
1683664855598,PSYC 144,A00,189107,Wixted; John T,0,11,50,50
1683664857654,PSYC 162,A00,189142,Staff,0,9,85,85
1683664858683,PSYC 172,A00,189144,Gorman; Michael R.,0,6,30,30
1683664860732,PSYC 179,A00,189146,Lacefield; Katharine I,0,87,120,120
1683664861757,PSYC 181,A00,189147,Anagnostaras; Stephan,0,44,90,90
1683664862781,PSYC 190R,A00,189148,Barner; David A.,0,23,80,80
1683664863813,PSYC 191,A00,189275,Rickard; Timothy C.,0,10,25,25
1683664864836,PSYC 193,A00,189276,Chapman; Eddie Nathaniel,0,1,0,4
1683664865859,PSYC 193L,A01,189281,Lowe; Angela Beth,10,0,20,10
1683664865859,PSYC 193L,B01,189285,Staff,28,0,35,7
1683664866885,RELI 149,A00,187137,Rahimi; Babak,7,0,40,33
1683664867909,SE 9,A01,187315,Staff,0,2,18,18
1683664868936,SE 101B,A00,187409,Staff,24,0,30,6
1683664869967,SE 110B,A00,187444,Staff,10,0,40,30
1683664870994,SE 130B,A00,187449,Staff,31,0,40,9
1683664872018,SE 150A,A00,187516,Staff,8,0,20,12
1683664873042,SE 154,A00,187528,Staff,29,0,50,21
1683664874066,SIO 3,A01,258171,Staff,35,0,40,5
1683664875093,SIO 10,A00,187144,Cook; Geoffrey W,0,7,75,75
1683664876117,SIO 45,A00,187152,Cook; Geoffrey W,0,5,100,100
1683664877144,SIO 109R,A00,194486,Staff,0,4,20,20
1683664879195,SIO 187,A01,187233,Kacev; David,12,0,40,28
1683664880224,SOCI 1,A01,258656,Thorpe; Charles Robert,28,0,30,2
1683664880224,SOCI 1,A02,258658,Thorpe; Charles Robert,30,0,30,0
1683664880224,SOCI 1,A03,258661,Thorpe; Charles Robert,25,0,25,0
1683664880224,SOCI 1,A04,258666,Thorpe; Charles Robert,22,0,25,3
1683664880224,SOCI 1,A05,258897,Thorpe; Charles Robert,22,0,25,3
1683664880224,SOCI 1,A06,258898,Thorpe; Charles Robert,25,0,25,0
1683664881250,SOCI 30,A01,258903,Pardo Guerra; Juan Pablo,14,0,30,16
1683664882276,SOCI 102,A00,258904,Staff,9,0,25,16
1683664883303,SOCI 106,A00,258905,Staff,19,0,25,6
1683664884327,SOCI 111,A00,258907,Ribas Norris; Janet Vanesa,26,0,30,4
1683664885354,SOCI 121R,A00,258908,Pardo Guerra; Juan Pablo,8,0,30,22
1683664886379,SOCI 126,A01,203330,Staff,14,0,20,6
1683664887405,SOCI 131,A00,258909,Thorpe; Charles Robert,30,0,60,30
1683664888431,SOCI 135,A00,258910,Payne; Christine Anna,0,11,30,30
1683664889457,SOCI 157,A00,258911,Staff,12,0,30,18
1683664890484,SOCI 184,A00,258912,Staff,25,0,30,5
1683664891510,SOCI 188D,A00,258913,Staff,22,0,30,8
1683664892534,SYN 2,001,187529,Staff,9,0,16,7
1683664892534,SYN 2,002,201452,Staff,0,20,16,16
1683664892534,SYN 2,003,201469,Staff,1,0,16,15
1683664893613,SYN 100,A01,187531,Staff,0,9,20,20
1683664893613,SYN 100,B01,201491,Staff,0,10,20,20
1683664894638,TDAC 1,A00,189286,Walsh; Kim C.,3,0,20,17
1683664894638,TDAC 1,B00,189287,Harting; Carla Kelso,10,0,20,10
1683664895661,TDAC 101,A00,189300,Walsh; Kim C.,16,0,20,4
1683664895661,TDAC 101,B00,189301,Harting; Carla Kelso,18,0,20,2
1683664896686,TDAC 102,A00,189304,Basso; Beatrice,14,0,20,6
1683664897710,TDAC 108,A00,189305,Staff,18,0,20,2
1683664898736,TDDE 131,A00,189310,Staff,19,0,20,1
1683664898736,TDDE 131,B00,189314,Staff,19,0,20,1
1683664898736,TDDE 131,C00,189315,Staff,48,0,50,2
1683664898736,TDDE 131,D00,189316,Staff,14,0,15,1
1683664898736,TDDE 131,E00,204841,Staff,20,0,20,0
1683664899760,TDGE 10,A00,189289,Staff,27,0,50,23
1683664899760,TDGE 10,B00,189290,Havis; Allan,0,1,50,50
1683664900788,TDGE 11,A00,189291,Fulton; Julia,0,4,50,50
1683664900788,TDGE 11,B00,189292,Staff,20,0,25,5
1683664900788,TDGE 11,C00,260270,Staff,0,0,0,0
1683664901814,TDGE 25,A00,189294,Staff,2,0,20,18
1683664902838,TDGE 124,A00,189318,Fulton; Julia,0,8,50,50
1683664903866,TDGE 125,A00,189319,Staff,13,0,25,12
1683664903866,TDGE 125,B00,189320,Staff,23,0,25,2
1683664904893,TDGE 127,A00,189322,Havis; Allan,1,0,50,49
1683664905923,TDHT 101,A00,189323,Staff,18,0,25,7
1683664905923,TDHT 101,B00,189324,Staff,25,0,25,0
1683664906947,TDHT 102,A00,189325,Staff,49,0,50,1
1683664907975,TDMV 1,A00,189295,Arcidiacono; Kristin,20,0,30,10
1683664907975,TDMV 1,B00,189296,Caligagan; Maria T.,24,0,30,6
1683664909000,TDMV 2,A00,189297,Sammartano; Tonnie,27,0,30,3
1683664909000,TDMV 2,B00,189299,Arcidiacono; Kristin,23,0,30,7
1683664910023,TDMV 3,A00,204998,Rincon; Alicia,22,0,30,8
1683664911051,TDMV 120,A00,189458,Sammartano; Tonnie,28,0,30,2
1683664912075,TDMV 138,A00,189541,Jun; Grace Shin Hae,20,0,40,20
1683664913099,TDMV 142,A00,189717,Caligagan; Tony,25,0,30,5
1683664913099,TDMV 142,B00,189718,Caligagan; Maria T.,25,0,30,5
1683664914123,TMC 2,A01,187533,Staff,25,0,25,0
1683664914123,TMC 2,A02,187534,Staff,25,0,25,0
1683664915149,USP 1,A01,187536,Kwak; Nancy,0,16,25,25
1683664916173,USP 5,A01,187538,Staff,9,0,25,16
1683664917198,USP 101,A00,199253,Staff,0,4,0,0
1683664918221,USP 124,A00,187562,Boomhower; Matthew Charles,0,0,30,30
1683664919244,USP 138,A00,187582,Staff,20,0,25,5
1683664920269,USP 152,A01,187597,Staff,3,0,25,22
1683664921293,USP 153,A00,187598,Staff,19,0,25,6
1683664922317,USP 168,A00,187607,Kwak; Nancy,2,0,5,3
1683664923342,USP 173,A00,187619,Staff,4,0,25,21
1683664924367,USP 181,A00,187638,Staff,0,4,25,25
1683664925395,VIS 103,A00,187650,Cruz; Edwin Teddy,17,0,75,58
1683664926422,VIS 110D,A00,187669,Staff,13,0,22,9
1683664927446,VIS 127C,A00,187720,Shen; Kuiyi,68,0,146,78
1683664928474,VIS 149,A00,187731,Yoldas; Pinar,1,14,22,21
1683664929501,VIS 151,A01,188091,Staff,22,0,34,12
1683664929501,VIS 151,A02,188092,Staff,11,0,34,23
1683664930529,VIS 160B,A00,188093,Stalbaum; Brett,0,1,10,10
1683664932585,WCWP 10B,A00,201720,Staff,10,0,15,5
1683664932585,WCWP 10B,B00,201722,Staff,9,0,15,6
1683664933613,WCWP 100,A00,201725,Gagnon; Jeffrey C,0,0,2,2
1683664933613,WCWP 100,B00,201727,Staff,0,4,15,15
1683664936709,ANBI 133,A00,258401,Wilder; Linnea Lorene,34,0,40,6
1683664937735,ANBI 140,A00,258395,Hrvoj Mihic; Branka,18,0,25,7
1683664938767,ANSC 120,A00,258402,Bialecki; Jon Anthony,26,0,40,14
1683664939791,ANSC 144,A00,258400,Staff,12,0,40,28
1683664941837,ANSC 166,A00,258396,Parish; Steven Martin,156,0,175,19
1683664942861,ANSC 180,A00,193533,Staff,8,0,20,12
1683664943888,ANSC 188,A00,258397,Jassal; Aftab,34,0,40,6
1683664944914,ANTH 3,A01,258316,Staff,23,0,30,7
1683664945939,ANTH 5,A00,258394,Semendeferi; Ekaterini,16,0,20,4
1683664946967,ANTH 21,A01,258331,Staff,4,0,40,36
1683664947994,ANTH 103,A00,258398,Varma; Saiba,15,0,25,10
1683664949023,AWP 10,001,202034,Staff,0,0,0,0
1683664949023,AWP 10,002,202035,Staff,0,0,0,0
1683664949023,AWP 10,003,202036,Staff,0,0,0,0
1683664949023,AWP 10,004,202037,Staff,0,0,0,0
1683664949023,AWP 10,005,202038,Staff,0,0,0,0
1683664949023,AWP 10,006,202039,Staff,0,0,0,0
1683664949023,AWP 10,007,202040,Staff,0,0,0,0
1683664949023,AWP 10,008,202041,Staff,0,0,0,0
1683664949023,AWP 10,009,202042,Staff,0,0,0,0
1683664949023,AWP 10,010,202043,Staff,0,0,0,0
1683664949023,AWP 10,011,202044,Staff,0,0,0,0
1683664949023,AWP 10,012,202045,Staff,0,0,0,0
1683664949023,AWP 10,013,202046,Staff,0,0,0,0
1683664949023,AWP 10,014,202047,Staff,0,0,0,0
1683664949023,AWP 10,015,202048,Staff,0,0,0,0
1683664949023,AWP 10,016,202049,Staff,0,0,0,0
1683664949023,AWP 10,017,202050,Staff,0,0,0,0
1683664949023,AWP 10,018,202051,Staff,0,0,0,0
1683664949023,AWP 10,019,202052,Staff,0,0,0,0
1683664949023,AWP 10,020,202053,Staff,0,0,0,0
1683664949023,AWP 10,021,202054,Staff,0,0,0,0
1683664949023,AWP 10,022,202055,Staff,0,0,0,0
1683664949023,AWP 10,023,202056,Staff,0,0,0,0
1683664949023,AWP 10,024,202057,Staff,0,0,0,0
1683664949023,AWP 10,025,202058,Staff,0,0,0,0
1683664949023,AWP 10,026,202059,Staff,0,0,0,0
1683664950047,AWP 102,001,202032,Staff,0,0,0,0
1683664950047,AWP 102,002,202033,Staff,0,0,0,0
1683664951073,BENG 100,A01,254234,Taylor Amos; Alyssa C,31,0,40,9
1683664952099,BENG 196,001,270013,Engler; Adam J.,9999,0,9999,0
1683664953124,BICD 100R,A01,202018,Smith; Laurie,0,7,32,32
1683664953124,BICD 100R,A02,202019,Smith; Laurie,0,3,32,32
1683664953124,BICD 100R,A03,202020,Smith; Laurie,0,1,32,32
1683664953124,BICD 100R,A04,202021,Smith; Laurie,6,0,32,26
1683664953124,BICD 100R,A05,202022,Smith; Laurie,11,0,32,21
1683664954150,BICD 136,A01,193242,Gustafson-Brown; Cindy,0,2,32,32
1683664954150,BICD 136,A02,193244,Gustafson-Brown; Cindy,13,0,32,19
1683664955175,BIEB 102,A01,193249,Butler; Shannon Rhey,1,2,32,31
1683664955175,BIEB 102,A02,193251,Butler; Shannon Rhey,0,0,32,32
1683664955175,BIEB 102,A03,193253,Butler; Shannon Rhey,0,0,32,32
1683664955175,BIEB 102,A04,193255,Butler; Shannon Rhey,14,0,32,18
1683664955175,BIEB 102,A05,193265,Butler; Shannon Rhey,25,0,32,7
1683664955175,BIEB 102,A06,193269,Butler; Shannon Rhey,14,0,32,18
1683664957228,BIEB 150,A01,193274,Staff,0,0,32,32
1683664957228,BIEB 150,A02,193285,Staff,24,0,32,8
1683664958252,BIEB 194,A00,193286,Kurle; Carolyn M.,20,0,32,12
1683664959276,BILD 1,A01,192291,Staff,15,0,32,17
1683664959276,BILD 1,A02,192292,Staff,30,0,32,2
1683664959276,BILD 1,B01,192520,Reuther; Keefe,0,1,0,0
1683664959276,BILD 1,B02,192532,Reuther; Keefe,0,1,0,0
1683664960298,BILD 3,A01,192556,Butler; Shannon Rhey,0,0,32,32
1683664960298,BILD 3,A02,192581,Butler; Shannon Rhey,0,0,32,32
1683664960298,BILD 3,A03,192611,Butler; Shannon Rhey,20,0,32,12
1683664960298,BILD 3,A04,192612,Butler; Shannon Rhey,24,0,32,8
1683664960298,BILD 3,A05,192613,Butler; Shannon Rhey,26,0,32,6
1683664960298,BILD 3,A06,192679,Butler; Shannon Rhey,27,0,32,5
1683664960298,BILD 3,A07,192682,Butler; Shannon Rhey,20,0,32,12
1683664961325,BILD 4,A01,192836,Reuther; Keefe,1,0,24,23
1683664961325,BILD 4,A02,193044,Reuther; Keefe,4,0,24,20
1683664962353,BILD 10,A01,193142,Gustafson-Brown; Cindy,29,0,32,3
1683664962353,BILD 10,A02,193149,Gustafson-Brown; Cindy,31,0,32,1
1683664963381,BIMM 100,A01,193301,Staff,0,6,32,32
1683664963381,BIMM 100,A02,193312,Staff,0,7,32,32
1683664963381,BIMM 100,A03,193323,Staff,0,9,32,32
1683664964411,BIMM 101,A01,193329,McDonnell; Lisa Marie,0,4,24,24
1683664964411,BIMM 101,A02,193339,McDonnell; Lisa Marie,1,4,24,23
1683664964411,BIMM 101,B01,193354,McDonnell; Lisa Marie,0,4,24,24
1683664964411,BIMM 101,B02,193357,McDonnell; Lisa Marie,0,3,24,24
1683664965436,BIMM 110,A01,193377,Tat; John,0,11,32,32
1683664965436,BIMM 110,A02,193378,Tat; John,0,10,32,32
1683664966461,BIMM 120,A01,206116,Staff,0,0,32,32
1683664966461,BIMM 120,A02,206117,Staff,6,0,32,26
1683664966461,BIMM 120,A03,206121,Staff,21,0,32,11
1683664967486,BIPN 100,A01,193393,Park; Ji Young,0,15,32,32
1683664967486,BIPN 100,A02,193402,Park; Ji Young,0,14,32,32
1683664967486,BIPN 100,A03,193413,Park; Ji Young,0,14,32,32
1683664967486,BIPN 100,A04,193414,Park; Ji Young,0,13,32,32
1683664968515,BIPN 102,A01,193429,Staff,0,0,32,32
1683664968515,BIPN 102,A02,193438,Staff,18,0,32,14
1683664969539,BIPN 106,A01,193450,Reyes Gonzalez; Catalina,0,2,40,40
1683664970564,BIPN 134,A01,193465,Cooke; James Edward,0,0,32,32
1683664970564,BIPN 134,A02,193474,Cooke; James Edward,25,0,32,7
1683664970564,BIPN 134,A03,193485,Cooke; James Edward,29,0,32,3
1683664970564,BIPN 134,A04,193486,Cooke; James Edward,20,0,32,12
1683664970564,BIPN 134,A05,193491,Cooke; James Edward,31,0,32,1
1683664970564,BIPN 134,A06,193501,Cooke; James Edward,30,0,32,2
1683664970564,BIPN 134,A07,193510,Cooke; James Edward,29,0,32,3
1683664972617,BISP 194,A00,222522,Staff,14,0,32,18
1683664973641,CAT 124,A01,202407,Staff,19,0,25,6
1683664974669,CAT 125,A00,202408,Marchisotto; Jennifer Anne,2,0,20,18
1683664975694,CAT 125R,A00,202409,Smith; Lauryn Alissa,0,11,20,20
1683664975694,CAT 125R,B00,202410,Morales; Celeste Georgianna,0,11,20,20
1683664975694,CAT 125R,C00,202411,Irwin; Matthew Joseph,0,12,20,20
1683664976722,CENG 15,A01,204712,Yang; Kesong,0,1,0,0
1683664977752,CENG 114,A00,202070,Jahed Motlagh; Zeinab,5,0,20,15
1683664978778,CGS 105,A00,185477,Wesling; Megan E.,24,0,40,16
1683664979807,CGS 106,A00,185494,Staff,11,0,22,11
1683664980833,CGS 108,A00,185495,Staff,14,0,20,6
1683664981857,CGS 114,A00,185496,Staff,13,0,18,5
1683664982881,CGS 119,A00,185501,Staff,15,0,20,5
1683664983905,CGS 120,A00,185511,Staff,12,0,20,8
1683664984934,CHEM 4,A01,184675,Bussey; Thomas J,97,0,100,3
1683664985958,CHEM 6A,A01,184677,Staff,32,0,60,28
1683664986983,CHEM 6B,A01,184679,Staff,63,0,100,37
1683664988012,CHEM 6C,A01,184681,Bussey; Thomas J,0,0,50,50
1683664988012,CHEM 6C,A02,184682,Bussey; Thomas J,32,0,50,18
1683664989040,CHEM 40A,A01,184684,Albizati; Kim F.,34,0,100,66
1683664990064,CHEM 40B,A01,184686,Albizati; Kim F.,0,22,100,100
1683664991091,CHEM 41B,A01,184690,Staff,51,0,100,49
1683664992119,COGS 3,A01,184715,Boyle; Mary E. T.,0,27,40,40
1683664993146,COGS 14B,A01,185172,Staff,0,14,38,38
1683664994170,COGS 18,A01,184736,Staff,14,0,80,66
1683664995195,COGS 100,A01,184932,Staff,0,7,73,73
1683664996221,COGS 101A,A01,184935,Staff,0,40,30,30
1683664997306,COGS 101B,A01,184944,Staff,0,2,30,30
1683664998334,COGS 101C,A01,184946,Staff,0,10,30,30
1683664999359,COGS 102A,A01,184951,Johnson; Christine M.,2,0,40,38
1683665000391,COGS 107B,A01,184953,Mooshagian; Eric Frederick,0,51,40,40
1683665001415,COGS 118B,A01,184959,Gupta; Anjum,0,50,40,40
1683665002440,COGS 153,A00,184961,Staff,0,16,30,30
1683665003467,COGS 177,A00,184962,Staff,0,21,30,30
1683665004495,COGS 187A,A01,184969,Boyle; Mary E. T.,0,19,40,40
1683665005518,COMM 10,A01,185174,Staff,0,5,25,25
1683665005518,COMM 10,A02,185189,Staff,0,2,25,25
1683665005518,COMM 10,A03,269821,Staff,0,1,0,0
1683665006541,COMM 100B,A01,185475,Staff,0,1,0,2
1683665006541,COMM 100B,A02,185476,Staff,12,0,25,13
1683665007568,COMM 100C,A01,185314,Staff,1,0,25,24
1683665007568,COMM 100C,A02,185327,Staff,18,0,25,7
1683665008592,COMM 110M,A00,185349,Staff,0,0,40,40
1683665009619,COMM 113T,A00,185352,Staff,25,0,40,15
1683665010646,COMM 114I,A00,185353,Staff,31,0,40,9
1683665011673,COMM 131,A00,185354,Staff,17,0,30,13
1683665012700,CSE 8A,A50,185358,Cao; Yingjun,0,46,10,10
1683665013725,CSE 8B,A01,185362,Staff,0,48,50,50
1683665014748,CSE 11,A01,185416,Cao; Yingjun,0,91,10,10
1683665015773,CSE 20,A01,185445,Briones; Jor-el Thomas Caparas,4,0,25,21
1683665016797,CSE 21,A01,185447,Staff,9,0,50,41
1683665017823,CSE 101,A01,185451,Staff,0,13,50,50
1683665017823,CSE 101,B01,185453,Jones; Miles E,0,14,50,50
1683665019871,CSE 141,A01,185458,Eldon; John,16,0,100,84
1683665020896,CSE 141L,A01,185461,Eldon; John,8,0,100,92
1683665021924,CSE 142,A01,185463,Staff,34,0,60,26
1683665021924,CSE 142,B01,201355,Staff,0,7,60,60
1683665022958,CSE 142L,A01,185470,Staff,34,0,60,26
1683665022958,CSE 142L,B01,201417,Staff,0,6,60,60
1683665023987,CSE 190,A00,201433,Staff,32,0,49,17
1683665025015,DOC 1,A01,259136,Strom; Megan C.,7,0,15,8
1683665025015,DOC 1,A02,259137,Strom; Megan C.,14,0,15,1
1683665025015,DOC 1,A03,259138,Strom; Megan C.,14,0,15,1
1683665025015,DOC 1,A04,259139,Strom; Megan C.,14,0,15,1
1683665026039,DOC 100D,A00,259140,Pass; Natalye Joann,14,0,25,11
1683665027070,DSGN 1,A01,184749,Rill; Bryan,0,26,30,30
1683665028098,DSGN 100,A01,185168,Staff,0,2,25,25
1683665029122,ECE 5,A01,185626,Morris; Karcher William,0,12,0,0
1683665030146,ECE 101,A01,185628,Staff,14,0,70,56
1683665031170,ECE 107,A01,185635,Baghdadchi; Saharnaz,0,0,20,20
1683665031170,ECE 107,A02,185638,Baghdadchi; Saharnaz,1,0,20,19
1683665032196,ECE 148,A01,185647,Silberman; Jack,0,0,16,16
1683665033220,ECON 1,A01,185537,Crane; Meredith Helen,54,0,70,16
1683665034244,ECON 3,A01,185549,Crane; Meredith Helen,29,0,70,41
1683665035267,ECON 4,A01,203354,Anderson; John Charles,0,5,10,10
1683665036291,ECON 100A,A01,185574,Staff,0,5,40,40
1683665037315,ECON 100B,A01,185576,Staff,0,12,50,50
1683665038338,ECON 100C,A01,185589,Newhouse; Herbert S,30,0,70,40
1683665039362,ECON 105,A00,185608,Vespa; Emanuel Ignacio,19,0,35,16
1683665040390,ECON 109,A01,185610,Shishkin; Denis,9,0,35,26
1683665041414,ECON 110A,A01,185612,Staff,9,0,40,31
1683665042440,ECON 120A,A01,185615,Staff,19,0,40,21
1683665043465,ECON 120C,A01,185617,Sun; Yixiao,0,20,70,70
1683665044492,ECON 144,A00,203346,Squires; Dale E,2,0,35,33
1683665045519,ECON 171,A01,203349,Newhouse; Herbert S,0,1,35,35
1683665046546,ECON 173A,A01,185621,Toda; Alexis Akira,20,0,35,15
1683665047577,EDS 25,A01,202413,Staff,0,1,0,0
1683665047577,EDS 25,A02,202414,Staff,0,1,0,0
1683665047577,EDS 25,A03,202415,Staff,0,0,0,0
1683665047577,EDS 25,A04,202416,Staff,0,1,0,0
1683665047577,EDS 25,A05,202439,Staff,0,0,0,0
1683665047577,EDS 25,A06,202440,Staff,0,0,0,0
1683665047577,EDS 25,B01,202631,Staff,0,0,0,0
1683665047577,EDS 25,B02,202632,Staff,0,0,0,0
1683665047577,EDS 25,B03,202639,Staff,0,0,0,0
1683665047577,EDS 25,B04,202640,Staff,0,0,0,0
1683665047577,EDS 25,B05,202643,Staff,0,0,0,0
1683665047577,EDS 25,B06,202644,Staff,0,0,0,0
1683665048604,EDS 38,A01,202659,Black; Alison Michelle,24,0,25,1
1683665049627,EDS 115,A00,202652,Staff,18,0,30,12
1683665050656,EDS 125,A00,202649,Staff,13,0,30,17
1683665051680,EDS 126,A01,203332,Staff,30,0,30,0
1683665052704,EDS 139,A00,202838,Staff,16,0,25,9
1683665053728,EDS 146,A01,202655,Staff,14,0,25,11
1683665054756,ENG 15,A00,185667,Staff,0,1,0,0
1683665054756,ENG 15,B00,185672,Staff,0,0,0,0
1683665054756,ENG 15,C00,185675,Staff,0,0,0,0
1683665054756,ENG 15,D00,185682,Staff,0,0,0,0
1683665054756,ENG 15,E00,185684,Staff,0,0,0,0
1683665055782,ETHN 103,A00,185710,Staff,0,8,35,35
1683665056810,ETHN 103A,A00,199228,Man; Simeon S,0,0,9,9
1683665057837,ETHN 109,A00,185711,Staff,15,0,35,20
1683665058861,ETHN 142,A00,185726,Staff,0,4,30,30
1683665059885,ETHN 163J,A00,199229,Man; Simeon S,5,0,8,3
1683665060909,ETHN 168,A00,185727,Staff,7,0,10,3
1683665061932,ETHN 182,A00,185728,Staff,0,0,35,35
1683665062958,ETHN 183,A00,185737,Staff,9,0,18,9
1683665063982,GLBH 111,A01,209361,Burgos; Jose L.,0,0,0,0
1683665066035,HIEU 104,A00,185792,Staff,14,0,20,6
1683665067059,HIEU 115,A00,185800,Staff,0,0,20,20
1683665068083,HIEU 128,A00,185801,Staff,0,9,20,20
1683665069107,HIEU 147,A00,185802,Staff,15,0,20,5
1683665070130,HIEU 154,A00,185823,Staff,11,0,20,9
1683665071156,HILA 102,A00,185826,Staff,14,0,20,6
1683665072179,HILD 2C,A01,185778,Staff,0,13,20,20
1683665073207,HILD 7B,A01,185780,Kwak; Nancy,0,17,32,32
1683665073207,HILD 7B,A02,185781,Kwak; Nancy,0,18,32,32
1683665074234,HILD 30,A01,185791,Staff,12,0,20,8
1683665075257,HISC 119,A00,185830,Golan; Tal,0,9,20,20
1683665076281,HITO 156GS,A00,185831,Patterson; Patrick H.,0,0,0,23
1683665077306,HIUS 103,A00,185832,Man; Simeon S,0,4,20,20
1683665078329,HIUS 117,A00,185836,Kwak; Nancy,2,0,20,18
1683665079356,HIUS 125,A00,185840,Man; Simeon S,0,2,23,23
1683665080380,HIUS 149,A00,185845,Staff,1,0,20,19
1683665081403,HUM 3,A01,185882,Zavodny; Tatiana Sophia,0,8,50,50
1683665081403,HUM 3,B01,185899,Caldwell; Michael Alan,0,18,50,50
1683665082427,HUM 3GS,A00,185900,Patterson; Patrick H.,0,0,0,23
1683665083455,HUM 4,A01,185938,Zroka; Amy Liane,29,0,50,21
1683665083455,HUM 4,B01,185956,Watkins; Eric,0,5,50,50
1683665083455,HUM 4,B02,202209,Watkins; Eric,0,5,50,50
1683665083455,HUM 4,B03,202210,Watkins; Eric,0,5,50,50
1683665084479,HUM 5,A01,185958,West; Geoffrey Scott,0,0,50,50
1683665084479,HUM 5,A02,202215,West; Geoffrey Scott,0,0,50,50
1683665085503,INTL 190,A00,185959,Gagnon; Jeffrey C,0,0,0,9
1683665085503,INTL 190,B00,185960,Lettieri; Michael Joseph,0,0,0,2
1683665086527,JAPN 180,A00,254509,Staff,5,0,30,25
1683665087552,LATI 10,A01,202853,Kennemore; Amy Michelle,4,0,35,31
1683665087552,LATI 10,A02,202854,Kennemore; Amy Michelle,2,0,35,33
1683665087552,LATI 10,A03,270054,Kennemore; Amy Michelle,30,0,30,0
1683665088579,LATI 180,A00,202855,Kennemore; Amy Michelle,11,0,20,9
1683665089604,LAWS 101,A00,201767,Golan; Tal,0,7,40,40
1683665090627,LIFR 1C,A00,185961,Staff,6,0,20,14
1683665091651,LIFR 1CX,A00,185962,Staff,7,0,20,13
1683665092676,LIFR 1D,A00,185963,Staff,7,0,20,13
1683665093699,LIFR 1DX,A00,185964,Staff,7,0,20,13
1683665094724,LIGN 101,A01,186039,Staff,43,0,50,7
1683665095748,LIGN 165,A00,186040,Staff,15,0,50,35
1683665096771,LTCS 108,A00,186041,Staff,5,0,10,5
1683665097798,LTCS 119,A00,186042,Staff,15,0,20,5
1683665098823,LTCS 130,A00,186043,Wesling; Megan E.,15,0,25,10
1683665100929,LTEA 138,A00,186119,Staff,14,0,40,26
1683665101956,LTEN 124,A00,186148,Staff,5,0,25,20
1683665102981,LTEN 178,A00,186149,Staff,7,0,15,8
1683665104007,LTEN 181,A00,186150,Blanco; John D,34,0,40,6
1683665105031,LTWL 120,A00,186160,Staff,20,0,25,5
1683665106056,LTWL 165,A00,186161,Staff,22,0,25,3
1683665107079,LTWR 100,A00,186162,Staff,0,5,15,15
1683665108108,LTWR 102,A00,186163,Doller; Ben,5,0,15,10
1683665109133,MAE 8,A01,186412,Staff,0,0,0,0
1683665110156,MAE 30B,A00,186445,Bahadori; Mohammad Yousef,82,0,100,18
1683665111185,MAE 40,A00,186592,Bewley; Thomas R,10,0,50,40
1683665112213,MAE 101B,A00,186593,Bahadori; Mohammad Yousef,80,0,100,20
1683665113236,MAE 105,A00,186594,Bandaru; Prabhakar,10,0,50,40
1683665114264,MAE 107,A00,186599,Pham; Hieu Tan,0,7,120,120
1683665115291,MAE 148,A01,186660,Silberman; Jack,3,0,16,13
1683665116315,MATH 10A,A01,188095,Staff,0,6,35,35
1683665117344,MATH 10B,A01,188097,Bowers; Adam R.,0,12,30,30
1683665117344,MATH 10B,A02,188099,Bowers; Adam R.,0,11,30,30
1683665117344,MATH 10B,B01,188104,Bowers; Adam R.,0,10,30,30
1683665117344,MATH 10B,B02,188106,Bowers; Adam R.,1,9,30,29
1683665118369,MATH 10C,A01,188111,Staff,0,18,30,30
1683665118369,MATH 10C,A02,188127,Staff,0,19,30,30
1683665118369,MATH 10C,A03,188131,Staff,0,19,30,30
1683665118369,MATH 10C,B01,188218,Staff,17,0,30,13
1683665118369,MATH 10C,B02,188244,Staff,13,0,30,17
1683665118369,MATH 10C,B03,188277,Staff,14,0,30,16
1683665119397,MATH 18,A01,188344,Bach; Quang Tran,18,0,30,12
1683665119397,MATH 18,A02,188345,Bach; Quang Tran,11,0,30,19
1683665119397,MATH 18,B01,188353,Bach; Quang Tran,11,0,30,19
1683665119397,MATH 18,B02,188354,Bach; Quang Tran,19,0,30,11
1683665120424,MATH 20A,A01,188374,Staff,11,0,35,24
1683665121452,MATH 20B,A01,188382,Ohm; Ko Woon,7,0,30,23
1683665121452,MATH 20B,A02,188383,Ohm; Ko Woon,22,0,30,8
1683665121452,MATH 20B,B01,188385,Ohm; Ko Woon,7,0,30,23
1683665121452,MATH 20B,B02,188392,Ohm; Ko Woon,22,0,30,8
1683665122481,MATH 20C,A01,188394,Harel; Guershon,10,0,30,20
1683665122481,MATH 20C,A02,188395,Harel; Guershon,13,0,30,17
1683665122481,MATH 20C,B01,188404,Harel; Guershon,5,0,30,25
1683665122481,MATH 20C,B02,188405,Harel; Guershon,18,0,30,12
1683665123505,MATH 20D,A01,188414,Hammock; Frances H,0,1,30,30
1683665123505,MATH 20D,A02,188415,Hammock; Frances H,0,1,30,30
1683665123505,MATH 20D,B01,188447,Hammock; Frances H,0,1,30,30
1683665123505,MATH 20D,B02,188486,Hammock; Frances H,3,0,30,27
1683665124530,MATH 20E,A01,188649,Staff,21,0,30,9
1683665124530,MATH 20E,A02,188650,Staff,21,0,30,9
1683665124530,MATH 20E,A03,188673,Staff,0,0,30,30
1683665125557,MATH 102,A01,188675,Staff,0,36,35,35
1683665126581,MATH 103B,A01,188681,Staff,3,0,35,32
1683665126581,MATH 103B,B01,188692,Staff,5,0,35,30
1683665127604,MATH 109,A01,188695,Salehi Golsefidy; Alireza,24,0,35,11
1683665127604,MATH 109,A02,188696,Salehi Golsefidy; Alireza,25,0,35,10
1683665128635,MATH 120A,A01,188698,Eggers; John Dietrich,7,0,35,28
1683665129663,MATH 142B,A01,188736,Ioana; Adrian,1,1,30,29
1683665129663,MATH 142B,A02,188741,Ioana; Adrian,0,1,30,30
1683665129663,MATH 142B,A03,188743,Ioana; Adrian,0,1,30,30
1683665130688,MATH 168A,A01,188790,Staff,0,10,35,35
1683665131714,MATH 170A,A01,188803,Nie; Jiawang,0,2,35,35
1683665131714,MATH 170A,A02,188811,Nie; Jiawang,0,0,35,35
1683665131714,MATH 170A,A03,188814,Nie; Jiawang,0,0,35,35
1683665131714,MATH 170A,A04,188815,Nie; Jiawang,9,0,35,26
1683665132738,MATH 193B,A01,188817,Staff,0,0,35,35
1683665132738,MATH 193B,A02,188818,Staff,5,0,35,30
1683665133765,MGT 4,A01,202857,Anderson; John Charles,61,0,80,19
1683665134791,MGT 12,A00,202858,Lindenberger; Wade Douglas,40,0,90,50
1683665135816,MGT 18,A00,202859,Staff,74,0,90,16
1683665136839,MGT 18GS,A00,202860,McKay; Michael J,13,0,28,15
1683665137864,MGT 45,A00,202861,Pecore; Joseph P.,11,0,90,79
1683665138889,MGT 100,A00,202863,Yavorsky; Daniel Ryan,28,0,90,62
1683665139913,MGT 103,A00,202864,Ehrich; Kristine R,0,18,90,90
1683665140937,MGT 112,A00,202865,Ehrich; Kristine R,14,0,90,76
1683665141966,MGT 121A,A00,202868,Staff,90,20,90,0
1683665142990,MGT 131B,A00,202869,Anderson; John Charles,59,0,90,31
1683665144032,MGT 136,A00,202871,Lindenberger; Wade Douglas,83,0,90,7
1683665145057,MGT 164,A00,202873,Staff,0,67,90,91
1683665146083,MGT 164GS,A00,202874,McKay; Mary A,13,0,28,15
1683665147106,MGT 180,A00,202875,Staff,0,51,90,91
1683665148130,MMW 11R,A01,205019,Herbst; Matthew,1,0,30,29
1683665148130,MMW 11R,A02,205026,Herbst; Matthew,29,0,30,1
1683665149153,MMW 15,A01,193512,Chang; Edmond Yi-Teh,0,8,28,28
1683665149153,MMW 15,A02,193513,Chang; Edmond Yi-Teh,0,5,28,28
1683665149153,MMW 15,A03,193514,Chang; Edmond Yi-Teh,0,5,28,28
1683665149153,MMW 15,A04,193515,Chang; Edmond Yi-Teh,0,5,28,28
1683665149153,MMW 15,A05,193516,Chang; Edmond Yi-Teh,0,5,28,28
1683665149153,MMW 15,A06,193517,Chang; Edmond Yi-Teh,0,6,28,28
1683665149153,MMW 15,B01,193519,Chang; Edmond Yi-Teh,0,5,28,28
1683665149153,MMW 15,B02,193520,Chang; Edmond Yi-Teh,0,5,28,28
1683665149153,MMW 15,B03,193521,Chang; Edmond Yi-Teh,0,5,28,28
1683665149153,MMW 15,B04,193522,Chang; Edmond Yi-Teh,0,5,28,28
1683665149153,MMW 15,B05,193523,Chang; Edmond Yi-Teh,0,5,28,28
1683665149153,MMW 15,B06,193524,Chang; Edmond Yi-Teh,0,5,28,28
1683665150178,MMW 122,A01,193526,Rahimi; Babak,0,16,28,28
1683665150178,MMW 122,A02,193527,Rahimi; Babak,0,15,28,28
1683665150178,MMW 122,A03,193528,Rahimi; Babak,0,0,0,0
1683665150178,MMW 122,A04,193529,Rahimi; Babak,0,0,0,0
1683665151202,MUS 1A,A01,186663,Staff,1,20,35,34
1683665152225,MUS 4,A01,186715,Staff,0,12,35,35
1683665153250,MUS 5R,A01,186796,Dubnov; Shlomo,0,17,35,35
1683665154274,MUS 6,A01,186798,Staff,0,5,25,25
1683665155298,MUS 7,A01,186830,Staff,11,0,35,24
1683665156322,MUS 8,A01,186930,Staff,0,26,35,35
1683665157348,MUS 15,A01,186932,Staff,0,16,35,35
1683665157348,MUS 15,B01,186934,Staff,1,17,35,34
1683665158374,MUS 80,A00,186935,Staff,0,0,20,20
1683665158374,MUS 80,B00,186936,Staff,24,0,25,1
1683665159398,NANO 11,A00,204702,Lipomi; Darren John,0,0,0,0
1683665160423,NANO 15,A01,204709,Yang; Kesong,0,1,0,0
1683665161449,NANO 114,A00,202069,Jahed Motlagh; Zeinab,3,0,10,7
1683665162476,PHIL 1,A00,186955,Grush; Rick Scott,31,0,40,9
1683665163501,PHIL 10,A01,186973,Grush; Rick Scott,27,0,35,8
1683665163501,PHIL 10,A02,186974,Grush; Rick Scott,33,0,35,2
1683665164530,PHIL 13,A01,186976,Staff,3,0,35,32
1683665164530,PHIL 13,A02,186977,Staff,16,0,35,19
1683665165554,PHIL 14,A01,186979,Staff,31,0,35,4
1683665165554,PHIL 14,A02,186986,Staff,32,0,35,3
1683665166579,PHIL 28,A01,186988,Staff,16,0,30,14
1683665166579,PHIL 28,A02,186989,Staff,1,0,30,29
1683665166579,PHIL 28,A03,186990,Staff,10,0,30,20
1683665166579,PHIL 28,A04,186991,Staff,26,0,30,4
1683665167605,PHIL 120,A00,186997,Staff,23,0,40,17
1683665168632,PHIL 137,A00,187003,Staff,7,0,40,33
1683665169656,PHIL 150,A00,187015,Staff,47,0,70,23
1683665170682,PHIL 167,A00,187021,Lamey; Andy M.,34,0,40,6
1683665171705,PHIL 174,A01,202226,Staff,17,0,20,3
1683665171705,PHIL 174,A02,202235,Staff,20,0,20,0
1683665172731,PHIL 191A,A00,258918,Staff,0,0,1,1
1683665173755,PHYS 1A,A00,187028,Staff,26,0,60,34
1683665174779,PHYS 1AL,001,187036,Staff,3,0,30,27
1683665174779,PHYS 1AL,002,187049,Staff,18,0,30,12
1683665175809,PHYS 1B,A00,187058,Staff,22,0,60,38
1683665176836,PHYS 1BL,001,187064,Staff,0,1,30,30
1683665176836,PHYS 1BL,002,187070,Staff,4,0,30,26
1683665177858,PHYS 1C,A00,187082,Staff,29,0,120,91
1683665178885,PHYS 1CL,001,187088,Staff,0,9,30,30
1683665178885,PHYS 1CL,002,187089,Staff,0,1,30,30
1683665178885,PHYS 1CL,009,262693,Staff,9,0,30,21
1683665179909,PHYS 2B,A01,187097,Staff,55,0,115,60
1683665180933,PHYS 2C,A01,187099,Staff,63,0,115,52
1683665181962,PHYS 2CL,A01,187101,Staff,5,0,28,23
1683665181962,PHYS 2CL,A02,187102,Staff,15,0,28,13
1683665182987,PHYS 2D,A01,187123,Shotwell; Brian,95,0,115,20
1683665184016,PHYS 4B,A01,187133,Grinstein; Benjamin,35,0,50,15
1683665185042,POLI 10,A00,188819,Staff,0,4,50,50
1683665186069,POLI 11,A00,188827,Staff,43,0,50,7
1683665187096,POLI 13R,A00,188828,Staff,0,1,20,20
1683665188119,POLI 27,A01,188830,Elgin; Samuel Zincke,0,2,70,70
1683665189145,POLI 30,A00,188832,Desposato; Scott,30,0,50,20
1683665190170,POLI 102F,A00,188834,Staff,0,0,40,40
1683665191195,POLI 104A,A00,188852,Staff,13,0,30,17
1683665192219,POLI 104I,A00,188853,Staff,0,7,20,20
1683665193246,POLI 110B,A00,188854,Wiens; David,6,0,20,14
1683665194272,POLI 112A,A00,188855,Wiens; David,3,0,30,27
1683665195299,POLI 117R,A00,188856,Forman; Fonna,0,12,20,20
1683665196326,POLI 118,A00,188857,Ingham; Sean,8,0,20,12
1683665197350,POLI 120G,A00,188858,Staff,8,0,30,22
1683665198377,POLI 131CR,A00,188863,Hoston; Germaine,21,0,50,29
1683665199403,POLI 133,A00,188864,Nellis; Gareth Hb,44,0,50,6
1683665200428,POLI 134D,A00,188865,Desposato; Scott,27,0,30,3
1683665201452,POLI 142A,A00,188871,Gartzke; Erik,21,0,50,29
1683665202479,POLI 142K,A00,188874,Staff,38,0,50,12
1683665203507,POLI 143,A00,188940,Gartzke; Erik,16,0,30,14
1683665204602,POLI 153,A00,188943,Staff,2,0,20,18
1683665205628,POLI 160AA,A00,188944,Staff,11,0,40,29
1683665206654,POLI 170A,A00,188945,Staff,11,0,30,19
1683665208702,PSYC 1,A00,188952,Staff,36,0,90,54
1683665209729,PSYC 2,B00,188953,Staff,19,0,35,16
1683665210758,PSYC 6,A00,188970,Staff,47,0,60,13
1683665211785,PSYC 7,A00,188973,Staff,35,0,45,10
1683665212813,PSYC 60,A01,188980,Rickard; Timothy C.,42,0,60,18
1683665213838,PSYC 70,A01,189001,Steiner; Eric Tomas,22,0,45,23
1683665214861,PSYC 100,A00,189005,Lacefield; Katharine I,0,99,120,120
1683665215888,PSYC 102,A00,189008,Staff,8,0,30,22
1683665216916,PSYC 106,B00,189026,Gorman; Michael R.,27,0,60,33
1683665217941,PSYC 114,B01,189033,Winkielman; Piotr,0,31,30,30
1683665218968,PSYC 131,A00,189036,Anagnostaras; Stephan,0,43,60,60
1683665219991,PSYC 136,A00,189041,Lowe; Angela Beth,0,7,25,25
1683665221017,PSYC 137,A00,189057,Winkielman; Piotr,0,37,25,25
1683665222043,PSYC 144,A00,189107,Wixted; John T,0,11,50,50
1683665224092,PSYC 162,A00,189142,Staff,0,9,85,85
1683665225114,PSYC 172,A00,189144,Gorman; Michael R.,0,6,30,30
1683665227163,PSYC 179,A00,189146,Lacefield; Katharine I,0,87,120,120
1683665228192,PSYC 181,A00,189147,Anagnostaras; Stephan,0,44,90,90
1683665229216,PSYC 190R,A00,189148,Barner; David A.,0,23,80,80
1683665230243,PSYC 191,A00,189275,Rickard; Timothy C.,0,10,25,25
1683665231265,PSYC 193,A00,189276,Chapman; Eddie Nathaniel,0,1,0,4
1683665232296,PSYC 193L,A01,189281,Lowe; Angela Beth,10,0,20,10
1683665232296,PSYC 193L,B01,189285,Staff,28,0,35,7
1683665233323,RELI 149,A00,187137,Rahimi; Babak,7,0,40,33
1683665234347,SE 9,A01,187315,Staff,0,2,18,18
1683665235371,SE 101B,A00,187409,Staff,24,0,30,6
1683665236398,SE 110B,A00,187444,Staff,10,0,40,30
1683665237425,SE 130B,A00,187449,Staff,31,0,40,9
1683665238449,SE 150A,A00,187516,Staff,8,0,20,12
1683665239477,SE 154,A00,187528,Staff,29,0,50,21
1683665240504,SIO 3,A01,258171,Staff,35,0,40,5
1683665241529,SIO 10,A00,187144,Cook; Geoffrey W,0,7,75,75
1683665242552,SIO 45,A00,187152,Cook; Geoffrey W,0,5,100,100
1683665243577,SIO 109R,A00,194486,Staff,0,4,20,20
1683665245629,SIO 187,A01,187233,Kacev; David,12,0,40,28
1683665246654,SOCI 1,A01,258656,Thorpe; Charles Robert,28,0,30,2
1683665246654,SOCI 1,A02,258658,Thorpe; Charles Robert,30,0,30,0
1683665246654,SOCI 1,A03,258661,Thorpe; Charles Robert,25,0,25,0
1683665246654,SOCI 1,A04,258666,Thorpe; Charles Robert,22,0,25,3
1683665246654,SOCI 1,A05,258897,Thorpe; Charles Robert,22,0,25,3
1683665246654,SOCI 1,A06,258898,Thorpe; Charles Robert,25,0,25,0
1683665247678,SOCI 30,A01,258903,Pardo Guerra; Juan Pablo,14,0,30,16
1683665248703,SOCI 102,A00,258904,Staff,9,0,25,16
1683665249731,SOCI 106,A00,258905,Staff,19,0,25,6
1683665250758,SOCI 111,A00,258907,Ribas Norris; Janet Vanesa,26,0,30,4
1683665251785,SOCI 121R,A00,258908,Pardo Guerra; Juan Pablo,8,0,30,22
1683665252810,SOCI 126,A01,203330,Staff,14,0,20,6
1683665253832,SOCI 131,A00,258909,Thorpe; Charles Robert,30,0,60,30
1683665254855,SOCI 135,A00,258910,Payne; Christine Anna,0,11,30,30
1683665255879,SOCI 157,A00,258911,Staff,12,0,30,18
1683665256903,SOCI 184,A00,258912,Staff,25,0,30,5
1683665257926,SOCI 188D,A00,258913,Staff,22,0,30,8
1683665258950,SYN 2,001,187529,Staff,9,0,16,7
1683665258950,SYN 2,002,201452,Staff,0,20,16,16
1683665258950,SYN 2,003,201469,Staff,1,0,16,15
1683665259978,SYN 100,A01,187531,Staff,0,9,20,20
1683665259978,SYN 100,B01,201491,Staff,0,10,20,20
1683665261003,TDAC 1,A00,189286,Walsh; Kim C.,3,0,20,17
1683665261003,TDAC 1,B00,189287,Harting; Carla Kelso,10,0,20,10
1683665262030,TDAC 101,A00,189300,Walsh; Kim C.,16,0,20,4
1683665262030,TDAC 101,B00,189301,Harting; Carla Kelso,18,0,20,2
1683665263055,TDAC 102,A00,189304,Basso; Beatrice,14,0,20,6
1683665264079,TDAC 108,A00,189305,Staff,18,0,20,2
1683665265104,TDDE 131,A00,189310,Staff,19,0,20,1
1683665265104,TDDE 131,B00,189314,Staff,19,0,20,1
1683665265104,TDDE 131,C00,189315,Staff,48,0,50,2
1683665265104,TDDE 131,D00,189316,Staff,14,0,15,1
1683665265104,TDDE 131,E00,204841,Staff,20,0,20,0
1683665266127,TDGE 10,A00,189289,Staff,27,0,50,23
1683665266127,TDGE 10,B00,189290,Havis; Allan,0,1,50,50
1683665267152,TDGE 11,A00,189291,Fulton; Julia,0,4,50,50
1683665267152,TDGE 11,B00,189292,Staff,20,0,25,5
1683665267152,TDGE 11,C00,260270,Staff,0,0,0,0
1683665268176,TDGE 25,A00,189294,Staff,2,0,20,18
1683665269198,TDGE 124,A00,189318,Fulton; Julia,0,8,50,50
1683665270223,TDGE 125,A00,189319,Staff,13,0,25,12
1683665270223,TDGE 125,B00,189320,Staff,23,0,25,2
1683665271246,TDGE 127,A00,189322,Havis; Allan,1,0,50,49
1683665272271,TDHT 101,A00,189323,Staff,18,0,25,7
1683665272271,TDHT 101,B00,189324,Staff,25,0,25,0
1683665273295,TDHT 102,A00,189325,Staff,49,0,50,1
1683665274319,TDMV 1,A00,189295,Arcidiacono; Kristin,20,0,30,10
1683665274319,TDMV 1,B00,189296,Caligagan; Maria T.,24,0,30,6
1683665275347,TDMV 2,A00,189297,Sammartano; Tonnie,27,0,30,3
1683665275347,TDMV 2,B00,189299,Arcidiacono; Kristin,23,0,30,7
1683665276373,TDMV 3,A00,204998,Rincon; Alicia,22,0,30,8
1683665277396,TDMV 120,A00,189458,Sammartano; Tonnie,28,0,30,2
1683665278423,TDMV 138,A00,189541,Jun; Grace Shin Hae,20,0,40,20
1683665279450,TDMV 142,A00,189717,Caligagan; Tony,25,0,30,5
1683665279450,TDMV 142,B00,189718,Caligagan; Maria T.,25,0,30,5
1683665280473,TMC 2,A01,187533,Staff,25,0,25,0
1683665280473,TMC 2,A02,187534,Staff,25,0,25,0
1683665281497,USP 1,A01,187536,Kwak; Nancy,0,16,25,25
1683665282523,USP 5,A01,187538,Staff,9,0,25,16
1683665283547,USP 101,A00,199253,Staff,0,4,0,0
1683665284572,USP 124,A00,187562,Boomhower; Matthew Charles,0,0,30,30
1683665285597,USP 138,A00,187582,Staff,20,0,25,5
1683665286624,USP 152,A01,187597,Staff,3,0,25,22
1683665287649,USP 153,A00,187598,Staff,19,0,25,6
1683665288677,USP 168,A00,187607,Kwak; Nancy,2,0,5,3
1683665289701,USP 173,A00,187619,Staff,4,0,25,21
1683665290729,USP 181,A00,187638,Staff,0,4,25,25
1683665291753,VIS 103,A00,187650,Cruz; Edwin Teddy,17,0,75,58
1683665292777,VIS 110D,A00,187669,Staff,13,0,22,9
1683665293802,VIS 127C,A00,187720,Shen; Kuiyi,68,0,146,78
1683665294829,VIS 149,A00,187731,Yoldas; Pinar,1,14,22,21
1683665295857,VIS 151,A01,188091,Staff,22,0,34,12
1683665295857,VIS 151,A02,188092,Staff,11,0,34,23
1683665296881,VIS 160B,A00,188093,Stalbaum; Brett,0,1,10,10
1683665298930,WCWP 10B,A00,201720,Staff,10,0,15,5
1683665298930,WCWP 10B,B00,201722,Staff,9,0,15,6
1683665299956,WCWP 100,A00,201725,Gagnon; Jeffrey C,0,0,2,2
1683665299956,WCWP 100,B00,201727,Staff,0,4,15,15
1683665303049,ANBI 133,A00,258401,Wilder; Linnea Lorene,34,0,40,6
1683665304073,ANBI 140,A00,258395,Hrvoj Mihic; Branka,18,0,25,7
1683665305097,ANSC 120,A00,258402,Bialecki; Jon Anthony,26,0,40,14
1683665306122,ANSC 144,A00,258400,Staff,12,0,40,28
1683665308230,ANSC 166,A00,258396,Parish; Steven Martin,156,0,175,19
1683665309260,ANSC 180,A00,193533,Staff,8,0,20,12
1683665310287,ANSC 188,A00,258397,Jassal; Aftab,34,0,40,6
1683665311312,ANTH 3,A01,258316,Staff,23,0,30,7
1683665312339,ANTH 5,A00,258394,Semendeferi; Ekaterini,16,0,20,4
1683665313367,ANTH 21,A01,258331,Staff,4,0,40,36
1683665314392,ANTH 103,A00,258398,Varma; Saiba,15,0,25,10
1683665315425,AWP 10,001,202034,Staff,0,0,0,0
1683665315425,AWP 10,002,202035,Staff,0,0,0,0
1683665315425,AWP 10,003,202036,Staff,0,0,0,0
1683665315425,AWP 10,004,202037,Staff,0,0,0,0
1683665315425,AWP 10,005,202038,Staff,0,0,0,0
1683665315425,AWP 10,006,202039,Staff,0,0,0,0
1683665315425,AWP 10,007,202040,Staff,0,0,0,0
1683665315425,AWP 10,008,202041,Staff,0,0,0,0
1683665315425,AWP 10,009,202042,Staff,0,0,0,0
1683665315425,AWP 10,010,202043,Staff,0,0,0,0
1683665315425,AWP 10,011,202044,Staff,0,0,0,0
1683665315425,AWP 10,012,202045,Staff,0,0,0,0
1683665315425,AWP 10,013,202046,Staff,0,0,0,0
1683665315425,AWP 10,014,202047,Staff,0,0,0,0
1683665315425,AWP 10,015,202048,Staff,0,0,0,0
1683665315425,AWP 10,016,202049,Staff,0,0,0,0
1683665315425,AWP 10,017,202050,Staff,0,0,0,0
1683665315425,AWP 10,018,202051,Staff,0,0,0,0
1683665315425,AWP 10,019,202052,Staff,0,0,0,0
1683665315425,AWP 10,020,202053,Staff,0,0,0,0
1683665315425,AWP 10,021,202054,Staff,0,0,0,0
1683665315425,AWP 10,022,202055,Staff,0,0,0,0
1683665315425,AWP 10,023,202056,Staff,0,0,0,0
1683665315425,AWP 10,024,202057,Staff,0,0,0,0
1683665315425,AWP 10,025,202058,Staff,0,0,0,0
1683665315425,AWP 10,026,202059,Staff,0,0,0,0
1683665316448,AWP 102,001,202032,Staff,0,0,0,0
1683665316448,AWP 102,002,202033,Staff,0,0,0,0
1683665317473,BENG 100,A01,254234,Taylor Amos; Alyssa C,31,0,40,9
1683665318497,BENG 196,001,270013,Engler; Adam J.,9999,0,9999,0
1683665319522,BICD 100R,A01,202018,Smith; Laurie,0,7,32,32
1683665319522,BICD 100R,A02,202019,Smith; Laurie,0,3,32,32
1683665319522,BICD 100R,A03,202020,Smith; Laurie,0,1,32,32
1683665319522,BICD 100R,A04,202021,Smith; Laurie,6,0,32,26
1683665319522,BICD 100R,A05,202022,Smith; Laurie,11,0,32,21
1683665320552,BICD 136,A01,193242,Gustafson-Brown; Cindy,0,2,32,32
1683665320552,BICD 136,A02,193244,Gustafson-Brown; Cindy,13,0,32,19
1683665321580,BIEB 102,A01,193249,Butler; Shannon Rhey,1,2,32,31
1683665321580,BIEB 102,A02,193251,Butler; Shannon Rhey,0,0,32,32
1683665321580,BIEB 102,A03,193253,Butler; Shannon Rhey,0,0,32,32
1683665321580,BIEB 102,A04,193255,Butler; Shannon Rhey,14,0,32,18
1683665321580,BIEB 102,A05,193265,Butler; Shannon Rhey,25,0,32,7
1683665321580,BIEB 102,A06,193269,Butler; Shannon Rhey,14,0,32,18
1683665323636,BIEB 150,A01,193274,Staff,0,0,32,32
1683665323636,BIEB 150,A02,193285,Staff,24,0,32,8
1683665324658,BIEB 194,A00,193286,Kurle; Carolyn M.,20,0,32,12
1683665325687,BILD 1,A01,192291,Staff,15,0,32,17
1683665325687,BILD 1,A02,192292,Staff,30,0,32,2
1683665325687,BILD 1,B01,192520,Reuther; Keefe,0,1,0,0
1683665325687,BILD 1,B02,192532,Reuther; Keefe,0,1,0,0
1683665326713,BILD 3,A01,192556,Butler; Shannon Rhey,0,0,32,32
1683665326713,BILD 3,A02,192581,Butler; Shannon Rhey,0,0,32,32
1683665326713,BILD 3,A03,192611,Butler; Shannon Rhey,20,0,32,12
1683665326713,BILD 3,A04,192612,Butler; Shannon Rhey,24,0,32,8
1683665326713,BILD 3,A05,192613,Butler; Shannon Rhey,26,0,32,6
1683665326713,BILD 3,A06,192679,Butler; Shannon Rhey,27,0,32,5
1683665326713,BILD 3,A07,192682,Butler; Shannon Rhey,20,0,32,12
1683665327737,BILD 4,A01,192836,Reuther; Keefe,1,0,24,23
1683665327737,BILD 4,A02,193044,Reuther; Keefe,4,0,24,20
1683665328760,BILD 10,A01,193142,Gustafson-Brown; Cindy,29,0,32,3
1683665328760,BILD 10,A02,193149,Gustafson-Brown; Cindy,31,0,32,1
1683665329787,BIMM 100,A01,193301,Staff,0,6,32,32
1683665329787,BIMM 100,A02,193312,Staff,0,7,32,32
1683665329787,BIMM 100,A03,193323,Staff,0,9,32,32
1683665330812,BIMM 101,A01,193329,McDonnell; Lisa Marie,0,4,24,24
1683665330812,BIMM 101,A02,193339,McDonnell; Lisa Marie,1,4,24,23
1683665330812,BIMM 101,B01,193354,McDonnell; Lisa Marie,0,4,24,24
1683665330812,BIMM 101,B02,193357,McDonnell; Lisa Marie,0,3,24,24
1683665331835,BIMM 110,A01,193377,Tat; John,0,11,32,32
1683665331835,BIMM 110,A02,193378,Tat; John,0,10,32,32
1683665332859,BIMM 120,A01,206116,Staff,0,0,32,32
1683665332859,BIMM 120,A02,206117,Staff,6,0,32,26
1683665332859,BIMM 120,A03,206121,Staff,21,0,32,11
1683665333883,BIPN 100,A01,193393,Park; Ji Young,0,15,32,32
1683665333883,BIPN 100,A02,193402,Park; Ji Young,0,14,32,32
1683665333883,BIPN 100,A03,193413,Park; Ji Young,0,14,32,32
1683665333883,BIPN 100,A04,193414,Park; Ji Young,0,13,32,32
1683665334911,BIPN 102,A01,193429,Staff,0,0,32,32
1683665334911,BIPN 102,A02,193438,Staff,18,0,32,14
1683665335935,BIPN 106,A01,193450,Reyes Gonzalez; Catalina,0,2,40,40
1683665336959,BIPN 134,A01,193465,Cooke; James Edward,0,0,32,32
1683665336959,BIPN 134,A02,193474,Cooke; James Edward,25,0,32,7
1683665336959,BIPN 134,A03,193485,Cooke; James Edward,29,0,32,3
1683665336959,BIPN 134,A04,193486,Cooke; James Edward,20,0,32,12
1683665336959,BIPN 134,A05,193491,Cooke; James Edward,31,0,32,1
1683665336959,BIPN 134,A06,193501,Cooke; James Edward,30,0,32,2
1683665336959,BIPN 134,A07,193510,Cooke; James Edward,29,0,32,3
1683665339009,BISP 194,A00,222522,Staff,14,0,32,18
1683665340038,CAT 124,A01,202407,Staff,19,0,25,6
1683665341066,CAT 125,A00,202408,Marchisotto; Jennifer Anne,2,0,20,18
1683665342094,CAT 125R,A00,202409,Smith; Lauryn Alissa,0,11,20,20
1683665342094,CAT 125R,B00,202410,Morales; Celeste Georgianna,0,11,20,20
1683665342094,CAT 125R,C00,202411,Irwin; Matthew Joseph,0,12,20,20
1683665343119,CENG 15,A01,204712,Yang; Kesong,0,1,0,0
1683665344145,CENG 114,A00,202070,Jahed Motlagh; Zeinab,5,0,20,15
1683665345170,CGS 105,A00,185477,Wesling; Megan E.,24,0,40,16
1683665346193,CGS 106,A00,185494,Staff,11,0,22,11
1683665347219,CGS 108,A00,185495,Staff,14,0,20,6
1683665348242,CGS 114,A00,185496,Staff,13,0,18,5
1683665349267,CGS 119,A00,185501,Staff,15,0,20,5
1683665350291,CGS 120,A00,185511,Staff,12,0,20,8
1683665351319,CHEM 4,A01,184675,Bussey; Thomas J,97,0,100,3
1683665352342,CHEM 6A,A01,184677,Staff,32,0,60,28
1683665353365,CHEM 6B,A01,184679,Staff,63,0,100,37
1683665354391,CHEM 6C,A01,184681,Bussey; Thomas J,0,0,50,50
1683665354391,CHEM 6C,A02,184682,Bussey; Thomas J,32,0,50,18
1683665355418,CHEM 40A,A01,184684,Albizati; Kim F.,34,0,100,66
1683665356446,CHEM 40B,A01,184686,Albizati; Kim F.,0,22,100,100
1683665357471,CHEM 41B,A01,184690,Staff,51,0,100,49
1683665358499,COGS 3,A01,184715,Boyle; Mary E. T.,0,27,40,40
1683665359531,COGS 14B,A01,185172,Staff,0,14,38,38
1683665360559,COGS 18,A01,184736,Staff,14,0,80,66
1683665361583,COGS 100,A01,184932,Staff,0,7,73,73
1683665362610,COGS 101A,A01,184935,Staff,0,40,30,30
1683665363663,COGS 101B,A01,184944,Staff,0,2,30,30
1683665364690,COGS 101C,A01,184946,Staff,0,10,30,30
1683665365722,COGS 102A,A01,184951,Johnson; Christine M.,2,0,40,38
1683665366751,COGS 107B,A01,184953,Mooshagian; Eric Frederick,0,51,40,40
1683665367776,COGS 118B,A01,184959,Gupta; Anjum,0,50,40,40
1683665368804,COGS 153,A00,184961,Staff,0,16,30,30
1683665369828,COGS 177,A00,184962,Staff,0,21,30,30
1683665370853,COGS 187A,A01,184969,Boyle; Mary E. T.,0,19,40,40
1683665371881,COMM 10,A01,185174,Staff,0,5,25,25
1683665371881,COMM 10,A02,185189,Staff,0,2,25,25
1683665371881,COMM 10,A03,269821,Staff,0,1,0,0
1683665372906,COMM 100B,A01,185475,Staff,0,1,0,2
1683665372906,COMM 100B,A02,185476,Staff,12,0,25,13
1683665373929,COMM 100C,A01,185314,Staff,1,0,25,24
1683665373929,COMM 100C,A02,185327,Staff,18,0,25,7
1683665374956,COMM 110M,A00,185349,Staff,0,0,40,40
1683665375983,COMM 113T,A00,185352,Staff,25,0,40,15
1683665377007,COMM 114I,A00,185353,Staff,31,0,40,9
1683665378034,COMM 131,A00,185354,Staff,17,0,30,13
1683665379060,CSE 8A,A50,185358,Cao; Yingjun,0,46,10,10
1683665380083,CSE 8B,A01,185362,Staff,0,48,50,50
1683665381106,CSE 11,A01,185416,Cao; Yingjun,0,91,10,10
1683665382130,CSE 20,A01,185445,Briones; Jor-el Thomas Caparas,4,0,25,21
1683665383154,CSE 21,A01,185447,Staff,9,0,50,41
1683665384181,CSE 101,A01,185451,Staff,0,13,50,50
1683665384181,CSE 101,B01,185453,Jones; Miles E,0,14,50,50
1683665386233,CSE 141,A01,185458,Eldon; John,16,0,100,84
1683665387261,CSE 141L,A01,185461,Eldon; John,8,0,100,92
1683665388289,CSE 142,A01,185463,Staff,34,0,60,26
1683665388289,CSE 142,B01,201355,Staff,0,7,60,60
1683665389317,CSE 142L,A01,185470,Staff,34,0,60,26
1683665389317,CSE 142L,B01,201417,Staff,0,6,60,60
1683665390344,CSE 190,A00,201433,Staff,32,0,49,17
1683665391370,DOC 1,A01,259136,Strom; Megan C.,7,0,15,8
1683665391370,DOC 1,A02,259137,Strom; Megan C.,14,0,15,1
1683665391370,DOC 1,A03,259138,Strom; Megan C.,14,0,15,1
1683665391370,DOC 1,A04,259139,Strom; Megan C.,14,0,15,1
1683665392393,DOC 100D,A00,259140,Pass; Natalye Joann,14,0,25,11
1683665393419,DSGN 1,A01,184749,Rill; Bryan,0,26,30,30
1683665394443,DSGN 100,A01,185168,Staff,0,2,25,25
1683665395469,ECE 5,A01,185626,Morris; Karcher William,0,12,0,0
1683665396493,ECE 101,A01,185628,Staff,14,0,70,56
1683665397517,ECE 107,A01,185635,Baghdadchi; Saharnaz,0,0,20,20
1683665397517,ECE 107,A02,185638,Baghdadchi; Saharnaz,1,0,20,19
1683665398544,ECE 148,A01,185647,Silberman; Jack,0,0,16,16
1683665399576,ECON 1,A01,185537,Crane; Meredith Helen,54,0,70,16
1683665400603,ECON 3,A01,185549,Crane; Meredith Helen,29,0,70,41
1683665401626,ECON 4,A01,203354,Anderson; John Charles,0,5,10,10
1683665402653,ECON 100A,A01,185574,Staff,0,5,40,40
1683665403677,ECON 100B,A01,185576,Staff,0,12,50,50
1683665404710,ECON 100C,A01,185589,Newhouse; Herbert S,30,0,70,40
1683665405737,ECON 105,A00,185608,Vespa; Emanuel Ignacio,19,0,35,16
1683665406761,ECON 109,A01,185610,Shishkin; Denis,9,0,35,26
1683665407784,ECON 110A,A01,185612,Staff,9,0,40,31
1683665408807,ECON 120A,A01,185615,Staff,19,0,40,21
1683665409835,ECON 120C,A01,185617,Sun; Yixiao,0,20,70,70
1683665410862,ECON 144,A00,203346,Squires; Dale E,2,0,35,33
1683665411944,ECON 171,A01,203349,Newhouse; Herbert S,0,1,35,35
1683665412971,ECON 173A,A01,185621,Toda; Alexis Akira,20,0,35,15
1683665414005,EDS 25,A01,202413,Staff,0,1,0,0
1683665414005,EDS 25,A02,202414,Staff,0,1,0,0
1683665414005,EDS 25,A03,202415,Staff,0,0,0,0
1683665414005,EDS 25,A04,202416,Staff,0,1,0,0
1683665414005,EDS 25,A05,202439,Staff,0,0,0,0
1683665414005,EDS 25,A06,202440,Staff,0,0,0,0
1683665414005,EDS 25,B01,202631,Staff,0,0,0,0
1683665414005,EDS 25,B02,202632,Staff,0,0,0,0
1683665414005,EDS 25,B03,202639,Staff,0,0,0,0
1683665414005,EDS 25,B04,202640,Staff,0,0,0,0
1683665414005,EDS 25,B05,202643,Staff,0,0,0,0
1683665414005,EDS 25,B06,202644,Staff,0,0,0,0
1683665415033,EDS 38,A01,202659,Black; Alison Michelle,24,0,25,1
1683665416061,EDS 115,A00,202652,Staff,18,0,30,12
1683665417088,EDS 125,A00,202649,Staff,13,0,30,17
1683665418111,EDS 126,A01,203332,Staff,30,0,30,0
1683665419139,EDS 139,A00,202838,Staff,16,0,25,9
1683665420161,EDS 146,A01,202655,Staff,14,0,25,11
1683665421188,ENG 15,A00,185667,Staff,0,1,0,0
1683665421188,ENG 15,B00,185672,Staff,0,0,0,0
1683665421188,ENG 15,C00,185675,Staff,0,0,0,0
1683665421188,ENG 15,D00,185682,Staff,0,0,0,0
1683665421188,ENG 15,E00,185684,Staff,0,0,0,0
1683665422211,ETHN 103,A00,185710,Staff,0,8,35,35
1683665423235,ETHN 103A,A00,199228,Man; Simeon S,0,0,9,9
1683665424264,ETHN 109,A00,185711,Staff,15,0,35,20
1683665425287,ETHN 142,A00,185726,Staff,0,4,30,30
1683665426315,ETHN 163J,A00,199229,Man; Simeon S,5,0,8,3
1683665427338,ETHN 168,A00,185727,Staff,7,0,10,3
1683665428364,ETHN 182,A00,185728,Staff,0,0,35,35
1683665429389,ETHN 183,A00,185737,Staff,9,0,18,9
1683665430413,GLBH 111,A01,209361,Burgos; Jose L.,0,0,0,0
1683665432464,HIEU 104,A00,185792,Staff,14,0,20,6
1683665433489,HIEU 115,A00,185800,Staff,0,0,20,20
1683665434515,HIEU 128,A00,185801,Staff,0,9,20,20
1683665435539,HIEU 147,A00,185802,Staff,15,0,20,5
1683665436567,HIEU 154,A00,185823,Staff,11,0,20,9
1683665437593,HILA 102,A00,185826,Staff,14,0,20,6
1683665438620,HILD 2C,A01,185778,Staff,0,13,20,20
1683665439644,HILD 7B,A01,185780,Kwak; Nancy,0,17,32,32
1683665439644,HILD 7B,A02,185781,Kwak; Nancy,0,18,32,32
1683665440674,HILD 30,A01,185791,Staff,12,0,20,8
1683665441698,HISC 119,A00,185830,Golan; Tal,0,9,20,20
1683665442722,HITO 156GS,A00,185831,Patterson; Patrick H.,0,0,0,23
1683665443746,HIUS 103,A00,185832,Man; Simeon S,0,4,20,20
1683665444773,HIUS 117,A00,185836,Kwak; Nancy,2,0,20,18
1683665445800,HIUS 125,A00,185840,Man; Simeon S,0,2,23,23
1683665446824,HIUS 149,A00,185845,Staff,1,0,20,19
1683665447849,HUM 3,A01,185882,Zavodny; Tatiana Sophia,0,8,50,50
1683665447849,HUM 3,B01,185899,Caldwell; Michael Alan,0,18,50,50
1683665448873,HUM 3GS,A00,185900,Patterson; Patrick H.,0,0,0,23
1683665449903,HUM 4,A01,185938,Zroka; Amy Liane,29,0,50,21
1683665449903,HUM 4,B01,185956,Watkins; Eric,0,5,50,50
1683665449903,HUM 4,B02,202209,Watkins; Eric,0,5,50,50
1683665449903,HUM 4,B03,202210,Watkins; Eric,0,5,50,50
1683665450928,HUM 5,A01,185958,West; Geoffrey Scott,0,0,50,50
1683665450928,HUM 5,A02,202215,West; Geoffrey Scott,0,0,50,50
1683665451951,INTL 190,A00,185959,Gagnon; Jeffrey C,0,0,0,9
1683665451951,INTL 190,B00,185960,Lettieri; Michael Joseph,0,0,0,2
1683665452975,JAPN 180,A00,254509,Staff,5,0,30,25
1683665453998,LATI 10,A01,202853,Kennemore; Amy Michelle,4,0,35,31
1683665453998,LATI 10,A02,202854,Kennemore; Amy Michelle,2,0,35,33
1683665453998,LATI 10,A03,270054,Kennemore; Amy Michelle,30,0,30,0
1683665455023,LATI 180,A00,202855,Kennemore; Amy Michelle,11,0,20,9
1683665456047,LAWS 101,A00,201767,Golan; Tal,0,7,40,40
1683665457075,LIFR 1C,A00,185961,Staff,6,0,20,14
1683665458102,LIFR 1CX,A00,185962,Staff,7,0,20,13
1683665459155,LIFR 1D,A00,185963,Staff,7,0,20,13
1683665460182,LIFR 1DX,A00,185964,Staff,7,0,20,13
1683665461209,LIGN 101,A01,186039,Staff,43,0,50,7
1683665462236,LIGN 165,A00,186040,Staff,15,0,50,35
1683665463264,LTCS 108,A00,186041,Staff,5,0,10,5
1683665464286,LTCS 119,A00,186042,Staff,15,0,20,5
1683665465310,LTCS 130,A00,186043,Wesling; Megan E.,15,0,25,10
1683665467361,LTEA 138,A00,186119,Staff,14,0,40,26
1683665468385,LTEN 124,A00,186148,Staff,5,0,25,20
1683665469412,LTEN 178,A00,186149,Staff,7,0,15,8
1683665470434,LTEN 181,A00,186150,Blanco; John D,34,0,40,6
1683665471497,LTWL 120,A00,186160,Staff,20,0,25,5
1683665472522,LTWL 165,A00,186161,Staff,22,0,25,3
1683665473545,LTWR 100,A00,186162,Staff,0,5,15,15
1683665474568,LTWR 102,A00,186163,Doller; Ben,5,0,15,10
1683665475594,MAE 8,A01,186412,Staff,0,0,0,0
1683665476622,MAE 30B,A00,186445,Bahadori; Mohammad Yousef,82,0,100,18
1683665477648,MAE 40,A00,186592,Bewley; Thomas R,10,0,50,40
1683665478672,MAE 101B,A00,186593,Bahadori; Mohammad Yousef,80,0,100,20
1683665479699,MAE 105,A00,186594,Bandaru; Prabhakar,10,0,50,40
1683665480726,MAE 107,A00,186599,Pham; Hieu Tan,0,7,120,120
1683665481752,MAE 148,A01,186660,Silberman; Jack,3,0,16,13
1683665482778,MATH 10A,A01,188095,Staff,0,6,35,35
1683665483808,MATH 10B,A01,188097,Bowers; Adam R.,0,12,30,30
1683665483808,MATH 10B,A02,188099,Bowers; Adam R.,0,11,30,30
1683665483808,MATH 10B,B01,188104,Bowers; Adam R.,0,10,30,30
1683665483808,MATH 10B,B02,188106,Bowers; Adam R.,1,9,30,29
1683665484836,MATH 10C,A01,188111,Staff,0,18,30,30
1683665484836,MATH 10C,A02,188127,Staff,0,19,30,30
1683665484836,MATH 10C,A03,188131,Staff,0,19,30,30
1683665484836,MATH 10C,B01,188218,Staff,17,0,30,13
1683665484836,MATH 10C,B02,188244,Staff,13,0,30,17
1683665484836,MATH 10C,B03,188277,Staff,14,0,30,16
1683665485865,MATH 18,A01,188344,Bach; Quang Tran,18,0,30,12
1683665485865,MATH 18,A02,188345,Bach; Quang Tran,11,0,30,19
1683665485865,MATH 18,B01,188353,Bach; Quang Tran,11,0,30,19
1683665485865,MATH 18,B02,188354,Bach; Quang Tran,19,0,30,11
1683665486891,MATH 20A,A01,188374,Staff,11,0,35,24
1683665487919,MATH 20B,A01,188382,Ohm; Ko Woon,7,0,30,23
1683665487919,MATH 20B,A02,188383,Ohm; Ko Woon,22,0,30,8
1683665487919,MATH 20B,B01,188385,Ohm; Ko Woon,7,0,30,23
1683665487919,MATH 20B,B02,188392,Ohm; Ko Woon,22,0,30,8
1683665488945,MATH 20C,A01,188394,Harel; Guershon,10,0,30,20
1683665488945,MATH 20C,A02,188395,Harel; Guershon,13,0,30,17
1683665488945,MATH 20C,B01,188404,Harel; Guershon,5,0,30,25
1683665488945,MATH 20C,B02,188405,Harel; Guershon,18,0,30,12
1683665489973,MATH 20D,A01,188414,Hammock; Frances H,0,1,30,30
1683665489973,MATH 20D,A02,188415,Hammock; Frances H,0,1,30,30
1683665489973,MATH 20D,B01,188447,Hammock; Frances H,0,1,30,30
1683665489973,MATH 20D,B02,188486,Hammock; Frances H,3,0,30,27
1683665490996,MATH 20E,A01,188649,Staff,21,0,30,9
1683665490996,MATH 20E,A02,188650,Staff,21,0,30,9
1683665490996,MATH 20E,A03,188673,Staff,0,0,30,30
1683665492019,MATH 102,A01,188675,Staff,0,36,35,35
1683665493049,MATH 103B,A01,188681,Staff,3,0,35,32
1683665493049,MATH 103B,B01,188692,Staff,5,0,35,30
1683665494072,MATH 109,A01,188695,Salehi Golsefidy; Alireza,24,0,35,11
1683665494072,MATH 109,A02,188696,Salehi Golsefidy; Alireza,25,0,35,10
1683665495102,MATH 120A,A01,188698,Eggers; John Dietrich,7,0,35,28
1683665496127,MATH 142B,A01,188736,Ioana; Adrian,1,1,30,29
1683665496127,MATH 142B,A02,188741,Ioana; Adrian,0,1,30,30
1683665496127,MATH 142B,A03,188743,Ioana; Adrian,0,1,30,30
1683665497150,MATH 168A,A01,188790,Staff,0,10,35,35
1683665498177,MATH 170A,A01,188803,Nie; Jiawang,0,2,35,35
1683665498177,MATH 170A,A02,188811,Nie; Jiawang,0,0,35,35
1683665498177,MATH 170A,A03,188814,Nie; Jiawang,0,0,35,35
1683665498177,MATH 170A,A04,188815,Nie; Jiawang,9,0,35,26
1683665499201,MATH 193B,A01,188817,Staff,0,0,35,35
1683665499201,MATH 193B,A02,188818,Staff,5,0,35,30
1683665500228,MGT 4,A01,202857,Anderson; John Charles,61,0,80,19
1683665501251,MGT 12,A00,202858,Lindenberger; Wade Douglas,40,0,90,50
1683665502275,MGT 18,A00,202859,Staff,74,0,90,16
1683665503298,MGT 18GS,A00,202860,McKay; Michael J,13,0,28,15
1683665504321,MGT 45,A00,202861,Pecore; Joseph P.,11,0,90,79
1683665505345,MGT 100,A00,202863,Yavorsky; Daniel Ryan,28,0,90,62
1683665506371,MGT 103,A00,202864,Ehrich; Kristine R,0,18,90,90
1683665507398,MGT 112,A00,202865,Ehrich; Kristine R,14,0,90,76
1683665508425,MGT 121A,A00,202868,Staff,90,20,90,0
1683665509453,MGT 131B,A00,202869,Anderson; John Charles,59,0,90,31
1683665510477,MGT 136,A00,202871,Lindenberger; Wade Douglas,83,0,90,7
1683665511505,MGT 164,A00,202873,Staff,0,67,90,91
1683665512531,MGT 164GS,A00,202874,McKay; Mary A,13,0,28,15
1683665513555,MGT 180,A00,202875,Staff,0,51,90,91
1683665514580,MMW 11R,A01,205019,Herbst; Matthew,1,0,30,29
1683665514580,MMW 11R,A02,205026,Herbst; Matthew,29,0,30,1
1683665515686,MMW 15,A01,193512,Chang; Edmond Yi-Teh,0,8,28,28
1683665515686,MMW 15,A02,193513,Chang; Edmond Yi-Teh,0,5,28,28
1683665515686,MMW 15,A03,193514,Chang; Edmond Yi-Teh,0,5,28,28
1683665515686,MMW 15,A04,193515,Chang; Edmond Yi-Teh,0,5,28,28
1683665515686,MMW 15,A05,193516,Chang; Edmond Yi-Teh,0,5,28,28
1683665515686,MMW 15,A06,193517,Chang; Edmond Yi-Teh,0,6,28,28
1683665515686,MMW 15,B01,193519,Chang; Edmond Yi-Teh,0,5,28,28
1683665515686,MMW 15,B02,193520,Chang; Edmond Yi-Teh,0,5,28,28
1683665515686,MMW 15,B03,193521,Chang; Edmond Yi-Teh,0,5,28,28
1683665515686,MMW 15,B04,193522,Chang; Edmond Yi-Teh,0,5,28,28
1683665515686,MMW 15,B05,193523,Chang; Edmond Yi-Teh,0,5,28,28
1683665515686,MMW 15,B06,193524,Chang; Edmond Yi-Teh,0,5,28,28
1683665516710,MMW 122,A01,193526,Rahimi; Babak,0,16,28,28
1683665516710,MMW 122,A02,193527,Rahimi; Babak,0,15,28,28
1683665516710,MMW 122,A03,193528,Rahimi; Babak,0,0,0,0
1683665516710,MMW 122,A04,193529,Rahimi; Babak,0,0,0,0
1683665517737,MUS 1A,A01,186663,Staff,1,20,35,34
1683665518761,MUS 4,A01,186715,Staff,0,12,35,35
1683665519786,MUS 5R,A01,186796,Dubnov; Shlomo,0,17,35,35
1683665520810,MUS 6,A01,186798,Staff,0,5,25,25
1683665521838,MUS 7,A01,186830,Staff,11,0,35,24
1683665522863,MUS 8,A01,186930,Staff,0,26,35,35
1683665523887,MUS 15,A01,186932,Staff,0,16,35,35
1683665523887,MUS 15,B01,186934,Staff,1,17,35,34
1683665524914,MUS 80,A00,186935,Staff,0,0,20,20
1683665524914,MUS 80,B00,186936,Staff,24,0,25,1
1683665525943,NANO 11,A00,204702,Lipomi; Darren John,0,0,0,0
1683665526966,NANO 15,A01,204709,Yang; Kesong,0,1,0,0
1683665527993,NANO 114,A00,202069,Jahed Motlagh; Zeinab,3,0,10,7
1683665529018,PHIL 1,A00,186955,Grush; Rick Scott,31,0,40,9
1683665530047,PHIL 10,A01,186973,Grush; Rick Scott,27,0,35,8
1683665530047,PHIL 10,A02,186974,Grush; Rick Scott,33,0,35,2
1683665531071,PHIL 13,A01,186976,Staff,3,0,35,32
1683665531071,PHIL 13,A02,186977,Staff,16,0,35,19
1683665532098,PHIL 14,A01,186979,Staff,31,0,35,4
1683665532098,PHIL 14,A02,186986,Staff,32,0,35,3
1683665533122,PHIL 28,A01,186988,Staff,16,0,30,14
1683665533122,PHIL 28,A02,186989,Staff,1,0,30,29
1683665533122,PHIL 28,A03,186990,Staff,10,0,30,20
1683665533122,PHIL 28,A04,186991,Staff,26,0,30,4
1683665534148,PHIL 120,A00,186997,Staff,23,0,40,17
1683665535171,PHIL 137,A00,187003,Staff,7,0,40,33
1683665536195,PHIL 150,A00,187015,Staff,47,0,70,23
1683665537224,PHIL 167,A00,187021,Lamey; Andy M.,34,0,40,6
1683665538247,PHIL 174,A01,202226,Staff,17,0,20,3
1683665538247,PHIL 174,A02,202235,Staff,20,0,20,0
1683665539271,PHIL 191A,A00,258918,Staff,0,0,1,1
1683665540299,PHYS 1A,A00,187028,Staff,26,0,60,34
1683665541324,PHYS 1AL,001,187036,Staff,3,0,30,27
1683665541324,PHYS 1AL,002,187049,Staff,18,0,30,12
1683665542354,PHYS 1B,A00,187058,Staff,22,0,60,38
1683665543378,PHYS 1BL,001,187064,Staff,0,1,30,30
1683665543378,PHYS 1BL,002,187070,Staff,4,0,30,26
1683665544407,PHYS 1C,A00,187082,Staff,29,0,120,91
1683665545432,PHYS 1CL,001,187088,Staff,0,9,30,30
1683665545432,PHYS 1CL,002,187089,Staff,0,1,30,30
1683665545432,PHYS 1CL,009,262693,Staff,9,0,30,21
1683665546456,PHYS 2B,A01,187097,Staff,55,0,115,60
1683665547481,PHYS 2C,A01,187099,Staff,63,0,115,52
1683665548507,PHYS 2CL,A01,187101,Staff,5,0,28,23
1683665548507,PHYS 2CL,A02,187102,Staff,15,0,28,13
1683665549536,PHYS 2D,A01,187123,Shotwell; Brian,95,0,115,20
1683665550558,PHYS 4B,A01,187133,Grinstein; Benjamin,35,0,50,15
1683665551583,POLI 10,A00,188819,Staff,0,4,50,50
1683665552608,POLI 11,A00,188827,Staff,43,0,50,7
1683665553635,POLI 13R,A00,188828,Staff,0,1,20,20
1683665554678,POLI 27,A01,188830,Elgin; Samuel Zincke,0,2,70,70
1683665555706,POLI 30,A00,188832,Desposato; Scott,30,0,50,20
1683665556733,POLI 102F,A00,188834,Staff,0,0,40,40
1683665557759,POLI 104A,A00,188852,Staff,13,0,30,17
1683665558783,POLI 104I,A00,188853,Staff,0,7,20,20
1683665559814,POLI 110B,A00,188854,Wiens; David,6,0,20,14
1683665560839,POLI 112A,A00,188855,Wiens; David,3,0,30,27
1683665561863,POLI 117R,A00,188856,Forman; Fonna,0,12,20,20
1683665562891,POLI 118,A00,188857,Ingham; Sean,8,0,20,12
1683665563916,POLI 120G,A00,188858,Staff,8,0,30,22
1683665564940,POLI 131CR,A00,188863,Hoston; Germaine,21,0,50,29
1683665565965,POLI 133,A00,188864,Nellis; Gareth Hb,44,0,50,6
1683665566993,POLI 134D,A00,188865,Desposato; Scott,27,0,30,3
1683665568022,POLI 142A,A00,188871,Gartzke; Erik,21,0,50,29
1683665569044,POLI 142K,A00,188874,Staff,38,0,50,12
1683665570070,POLI 143,A00,188940,Gartzke; Erik,16,0,30,14
1683665571098,POLI 153,A00,188943,Staff,2,0,20,18
1683665572123,POLI 160AA,A00,188944,Staff,11,0,40,29
1683665573147,POLI 170A,A00,188945,Staff,11,0,30,19
1683665575199,PSYC 1,A00,188952,Staff,36,0,90,54
1683665576223,PSYC 2,B00,188953,Staff,19,0,35,16
1683665577251,PSYC 6,A00,188970,Staff,47,0,60,13
1683665578273,PSYC 7,A00,188973,Staff,35,0,45,10
1683665579297,PSYC 60,A01,188980,Rickard; Timothy C.,42,0,60,18
1683665580321,PSYC 70,A01,189001,Steiner; Eric Tomas,22,0,45,23
1683665581345,PSYC 100,A00,189005,Lacefield; Katharine I,0,99,120,120
1683665582384,PSYC 102,A00,189008,Staff,8,0,30,22
1683665583412,PSYC 106,B00,189026,Gorman; Michael R.,27,0,60,33
1683665584443,PSYC 114,B01,189033,Winkielman; Piotr,0,31,30,30
1683665585470,PSYC 131,A00,189036,Anagnostaras; Stephan,0,43,60,60
1683665586499,PSYC 136,A00,189041,Lowe; Angela Beth,0,7,25,25
1683665587524,PSYC 137,A00,189057,Winkielman; Piotr,0,37,25,25
1683665588548,PSYC 144,A00,189107,Wixted; John T,0,11,50,50
1683665590597,PSYC 162,A00,189142,Staff,0,9,85,85
1683665591620,PSYC 172,A00,189144,Gorman; Michael R.,0,6,30,30
1683665593671,PSYC 179,A00,189146,Lacefield; Katharine I,0,87,120,120
1683665594697,PSYC 181,A00,189147,Anagnostaras; Stephan,0,44,90,90
1683665595726,PSYC 190R,A00,189148,Barner; David A.,0,23,80,80
1683665596750,PSYC 191,A00,189275,Rickard; Timothy C.,0,10,25,25
1683665597776,PSYC 193,A00,189276,Chapman; Eddie Nathaniel,0,1,0,4
1683665598800,PSYC 193L,A01,189281,Lowe; Angela Beth,10,0,20,10
1683665598800,PSYC 193L,B01,189285,Staff,28,0,35,7
1683665599827,RELI 149,A00,187137,Rahimi; Babak,7,0,40,33
1683665600852,SE 9,A01,187315,Staff,0,2,18,18
1683665601877,SE 101B,A00,187409,Staff,24,0,30,6
1683665602901,SE 110B,A00,187444,Staff,10,0,40,30
1683665603925,SE 130B,A00,187449,Staff,31,0,40,9
1683665604951,SE 150A,A00,187516,Staff,8,0,20,12
1683665605977,SE 154,A00,187528,Staff,29,0,50,21
1683665607001,SIO 3,A01,258171,Staff,35,0,40,5
1683665608027,SIO 10,A00,187144,Cook; Geoffrey W,0,7,75,75
1683665609053,SIO 45,A00,187152,Cook; Geoffrey W,0,5,100,100
1683665610075,SIO 109R,A00,194486,Staff,0,4,20,20
1683665612126,SIO 187,A01,187233,Kacev; David,12,0,40,28
1683665613154,SOCI 1,A01,258656,Thorpe; Charles Robert,28,0,30,2
1683665613154,SOCI 1,A02,258658,Thorpe; Charles Robert,30,0,30,0
1683665613154,SOCI 1,A03,258661,Thorpe; Charles Robert,25,0,25,0
1683665613154,SOCI 1,A04,258666,Thorpe; Charles Robert,22,0,25,3
1683665613154,SOCI 1,A05,258897,Thorpe; Charles Robert,22,0,25,3
1683665613154,SOCI 1,A06,258898,Thorpe; Charles Robert,25,0,25,0
1683665614185,SOCI 30,A01,258903,Pardo Guerra; Juan Pablo,14,0,30,16
1683665615208,SOCI 102,A00,258904,Staff,9,0,25,16
1683665616233,SOCI 106,A00,258905,Staff,19,0,25,6
1683665617256,SOCI 111,A00,258907,Ribas Norris; Janet Vanesa,26,0,30,4
1683665618283,SOCI 121R,A00,258908,Pardo Guerra; Juan Pablo,8,0,30,22
1683665619364,SOCI 126,A01,203330,Staff,14,0,20,6
1683665620387,SOCI 131,A00,258909,Thorpe; Charles Robert,30,0,60,30
1683665621411,SOCI 135,A00,258910,Payne; Christine Anna,0,11,30,30
1683665622435,SOCI 157,A00,258911,Staff,12,0,30,18
1683665623459,SOCI 184,A00,258912,Staff,25,0,30,5
1683665624485,SOCI 188D,A00,258913,Staff,22,0,30,8
1683665625507,SYN 2,001,187529,Staff,9,0,16,7
1683665625507,SYN 2,002,201452,Staff,0,20,16,16
1683665625507,SYN 2,003,201469,Staff,1,0,16,15
1683665626531,SYN 100,A01,187531,Staff,0,9,20,20
1683665626531,SYN 100,B01,201491,Staff,0,10,20,20
1683665627559,TDAC 1,A00,189286,Walsh; Kim C.,3,0,20,17
1683665627559,TDAC 1,B00,189287,Harting; Carla Kelso,10,0,20,10
1683665628583,TDAC 101,A00,189300,Walsh; Kim C.,16,0,20,4
1683665628583,TDAC 101,B00,189301,Harting; Carla Kelso,18,0,20,2
1683665629607,TDAC 102,A00,189304,Basso; Beatrice,14,0,20,6
1683665630635,TDAC 108,A00,189305,Staff,18,0,20,2
1683665631665,TDDE 131,A00,189310,Staff,19,0,20,1
1683665631665,TDDE 131,B00,189314,Staff,19,0,20,1
1683665631665,TDDE 131,C00,189315,Staff,48,0,50,2
1683665631665,TDDE 131,D00,189316,Staff,14,0,15,1
1683665631665,TDDE 131,E00,204841,Staff,20,0,20,0
1683665632693,TDGE 10,A00,189289,Staff,27,0,50,23
1683665632693,TDGE 10,B00,189290,Havis; Allan,0,1,50,50
1683665633717,TDGE 11,A00,189291,Fulton; Julia,0,4,50,50
1683665633717,TDGE 11,B00,189292,Staff,20,0,25,5
1683665633717,TDGE 11,C00,260270,Staff,0,0,0,0
1683665634748,TDGE 25,A00,189294,Staff,2,0,20,18
1683665635775,TDGE 124,A00,189318,Fulton; Julia,0,8,50,50
1683665636805,TDGE 125,A00,189319,Staff,13,0,25,12
1683665636805,TDGE 125,B00,189320,Staff,23,0,25,2
1683665637830,TDGE 127,A00,189322,Havis; Allan,1,0,50,49
1683665638854,TDHT 101,A00,189323,Staff,18,0,25,7
1683665638854,TDHT 101,B00,189324,Staff,25,0,25,0
1683665639879,TDHT 102,A00,189325,Staff,49,0,50,1
1683665640902,TDMV 1,A00,189295,Arcidiacono; Kristin,20,0,30,10
1683665640902,TDMV 1,B00,189296,Caligagan; Maria T.,24,0,30,6
1683665641929,TDMV 2,A00,189297,Sammartano; Tonnie,27,0,30,3
1683665641929,TDMV 2,B00,189299,Arcidiacono; Kristin,23,0,30,7
1683665642956,TDMV 3,A00,204998,Rincon; Alicia,22,0,30,8
1683665643982,TDMV 120,A00,189458,Sammartano; Tonnie,28,0,30,2
1683665645004,TDMV 138,A00,189541,Jun; Grace Shin Hae,20,0,40,20
1683665646028,TDMV 142,A00,189717,Caligagan; Tony,25,0,30,5
1683665646028,TDMV 142,B00,189718,Caligagan; Maria T.,25,0,30,5
1683665647054,TMC 2,A01,187533,Staff,25,0,25,0
1683665647054,TMC 2,A02,187534,Staff,25,0,25,0
1683665648079,USP 1,A01,187536,Kwak; Nancy,0,16,25,25
1683665649103,USP 5,A01,187538,Staff,9,0,25,16
1683665650131,USP 101,A00,199253,Staff,0,4,0,0
1683665651155,USP 124,A00,187562,Boomhower; Matthew Charles,0,0,30,30
1683665652186,USP 138,A00,187582,Staff,20,0,25,5
1683665653210,USP 152,A01,187597,Staff,3,0,25,22
1683665654233,USP 153,A00,187598,Staff,19,0,25,6
1683665655257,USP 168,A00,187607,Kwak; Nancy,2,0,5,3
1683665656285,USP 173,A00,187619,Staff,4,0,25,21
1683665657314,USP 181,A00,187638,Staff,0,4,25,25
1683665658341,VIS 103,A00,187650,Cruz; Edwin Teddy,17,0,75,58
1683665659365,VIS 110D,A00,187669,Staff,13,0,22,9
1683665660390,VIS 127C,A00,187720,Shen; Kuiyi,68,0,146,78
1683665661417,VIS 149,A00,187731,Yoldas; Pinar,1,14,22,21
1683665662443,VIS 151,A01,188091,Staff,22,0,34,12
1683665662443,VIS 151,A02,188092,Staff,11,0,34,23
1683665663467,VIS 160B,A00,188093,Stalbaum; Brett,0,1,10,10
1683665665516,WCWP 10B,A00,201720,Staff,10,0,15,5
1683665665516,WCWP 10B,B00,201722,Staff,9,0,15,6
1683665666540,WCWP 100,A00,201725,Gagnon; Jeffrey C,0,0,2,2
1683665666540,WCWP 100,B00,201727,Staff,0,4,15,15
1683665669633,ANBI 133,A00,258401,Wilder; Linnea Lorene,34,0,40,6
1683665670657,ANBI 140,A00,258395,Hrvoj Mihic; Branka,18,0,25,7
1683665671682,ANSC 120,A00,258402,Bialecki; Jon Anthony,26,0,40,14
1683665672707,ANSC 144,A00,258400,Staff,12,0,40,28
1683665674760,ANSC 166,A00,258396,Parish; Steven Martin,156,0,175,19
1683665675785,ANSC 180,A00,193533,Staff,8,0,20,12
1683665676812,ANSC 188,A00,258397,Jassal; Aftab,34,0,40,6
1683665677845,ANTH 3,A01,258316,Staff,23,0,30,7
1683665678871,ANTH 5,A00,258394,Semendeferi; Ekaterini,16,0,20,4
1683665679898,ANTH 21,A01,258331,Staff,4,0,40,36
1683665680925,ANTH 103,A00,258398,Varma; Saiba,15,0,25,10
1683665681952,AWP 10,001,202034,Staff,0,0,0,0
1683665681952,AWP 10,002,202035,Staff,0,0,0,0
1683665681952,AWP 10,003,202036,Staff,0,0,0,0
1683665681952,AWP 10,004,202037,Staff,0,0,0,0
1683665681952,AWP 10,005,202038,Staff,0,0,0,0
1683665681952,AWP 10,006,202039,Staff,0,0,0,0
1683665681952,AWP 10,007,202040,Staff,0,0,0,0
1683665681952,AWP 10,008,202041,Staff,0,0,0,0
1683665681952,AWP 10,009,202042,Staff,0,0,0,0
1683665681952,AWP 10,010,202043,Staff,0,0,0,0
1683665681952,AWP 10,011,202044,Staff,0,0,0,0
1683665681952,AWP 10,012,202045,Staff,0,0,0,0
1683665681952,AWP 10,013,202046,Staff,0,0,0,0
1683665681952,AWP 10,014,202047,Staff,0,0,0,0
1683665681952,AWP 10,015,202048,Staff,0,0,0,0
1683665681952,AWP 10,016,202049,Staff,0,0,0,0
1683665681952,AWP 10,017,202050,Staff,0,0,0,0
1683665681952,AWP 10,018,202051,Staff,0,0,0,0
1683665681952,AWP 10,019,202052,Staff,0,0,0,0
1683665681952,AWP 10,020,202053,Staff,0,0,0,0
1683665681952,AWP 10,021,202054,Staff,0,0,0,0
1683665681952,AWP 10,022,202055,Staff,0,0,0,0
1683665681952,AWP 10,023,202056,Staff,0,0,0,0
1683665681952,AWP 10,024,202057,Staff,0,0,0,0
1683665681952,AWP 10,025,202058,Staff,0,0,0,0
1683665681952,AWP 10,026,202059,Staff,0,0,0,0
1683665682975,AWP 102,001,202032,Staff,0,0,0,0
1683665682975,AWP 102,002,202033,Staff,0,0,0,0
1683665684001,BENG 100,A01,254234,Taylor Amos; Alyssa C,31,0,40,9
1683665685025,BENG 196,001,270013,Engler; Adam J.,9999,0,9999,0
1683665686050,BICD 100R,A01,202018,Smith; Laurie,0,7,32,32
1683665686050,BICD 100R,A02,202019,Smith; Laurie,0,3,32,32
1683665686050,BICD 100R,A03,202020,Smith; Laurie,0,1,32,32
1683665686050,BICD 100R,A04,202021,Smith; Laurie,6,0,32,26
1683665686050,BICD 100R,A05,202022,Smith; Laurie,11,0,32,21
1683665687074,BICD 136,A01,193242,Gustafson-Brown; Cindy,0,2,32,32
1683665687074,BICD 136,A02,193244,Gustafson-Brown; Cindy,13,0,32,19
1683665688099,BIEB 102,A01,193249,Butler; Shannon Rhey,1,2,32,31
1683665688099,BIEB 102,A02,193251,Butler; Shannon Rhey,0,0,32,32
1683665688099,BIEB 102,A03,193253,Butler; Shannon Rhey,0,0,32,32
1683665688099,BIEB 102,A04,193255,Butler; Shannon Rhey,14,0,32,18
1683665688099,BIEB 102,A05,193265,Butler; Shannon Rhey,25,0,32,7
1683665688099,BIEB 102,A06,193269,Butler; Shannon Rhey,14,0,32,18
1683665690150,BIEB 150,A01,193274,Staff,0,0,32,32
1683665690150,BIEB 150,A02,193285,Staff,24,0,32,8
1683665691174,BIEB 194,A00,193286,Kurle; Carolyn M.,20,0,32,12
1683665692202,BILD 1,A01,192291,Staff,15,0,32,17
1683665692202,BILD 1,A02,192292,Staff,30,0,32,2
1683665692202,BILD 1,B01,192520,Reuther; Keefe,0,1,0,0
1683665692202,BILD 1,B02,192532,Reuther; Keefe,0,1,0,0
1683665693230,BILD 3,A01,192556,Butler; Shannon Rhey,0,0,32,32
1683665693230,BILD 3,A02,192581,Butler; Shannon Rhey,0,0,32,32
1683665693230,BILD 3,A03,192611,Butler; Shannon Rhey,20,0,32,12
1683665693230,BILD 3,A04,192612,Butler; Shannon Rhey,24,0,32,8
1683665693230,BILD 3,A05,192613,Butler; Shannon Rhey,26,0,32,6
1683665693230,BILD 3,A06,192679,Butler; Shannon Rhey,27,0,32,5
1683665693230,BILD 3,A07,192682,Butler; Shannon Rhey,20,0,32,12
1683665694254,BILD 4,A01,192836,Reuther; Keefe,1,0,24,23
1683665694254,BILD 4,A02,193044,Reuther; Keefe,4,0,24,20
1683665695281,BILD 10,A01,193142,Gustafson-Brown; Cindy,29,0,32,3
1683665695281,BILD 10,A02,193149,Gustafson-Brown; Cindy,31,0,32,1
1683665696307,BIMM 100,A01,193301,Staff,0,6,32,32
1683665696307,BIMM 100,A02,193312,Staff,0,7,32,32
1683665696307,BIMM 100,A03,193323,Staff,0,9,32,32
1683665697336,BIMM 101,A01,193329,McDonnell; Lisa Marie,0,4,24,24
1683665697336,BIMM 101,A02,193339,McDonnell; Lisa Marie,1,4,24,23
1683665697336,BIMM 101,B01,193354,McDonnell; Lisa Marie,0,4,24,24
1683665697336,BIMM 101,B02,193357,McDonnell; Lisa Marie,0,3,24,24
1683665698362,BIMM 110,A01,193377,Tat; John,0,11,32,32
1683665698362,BIMM 110,A02,193378,Tat; John,0,10,32,32
1683665699389,BIMM 120,A01,206116,Staff,0,0,32,32
1683665699389,BIMM 120,A02,206117,Staff,6,0,32,26
1683665699389,BIMM 120,A03,206121,Staff,21,0,32,11
1683665700414,BIPN 100,A01,193393,Park; Ji Young,0,15,32,32
1683665700414,BIPN 100,A02,193402,Park; Ji Young,0,14,32,32
1683665700414,BIPN 100,A03,193413,Park; Ji Young,0,14,32,32
1683665700414,BIPN 100,A04,193414,Park; Ji Young,0,13,32,32
1683665701437,BIPN 102,A01,193429,Staff,0,0,32,32
1683665701437,BIPN 102,A02,193438,Staff,18,0,32,14
1683665702463,BIPN 106,A01,193450,Reyes Gonzalez; Catalina,0,2,40,40
1683665703492,BIPN 134,A01,193465,Cooke; James Edward,0,0,32,32
1683665703492,BIPN 134,A02,193474,Cooke; James Edward,25,0,32,7
1683665703492,BIPN 134,A03,193485,Cooke; James Edward,29,0,32,3
1683665703492,BIPN 134,A04,193486,Cooke; James Edward,20,0,32,12
1683665703492,BIPN 134,A05,193491,Cooke; James Edward,31,0,32,1
1683665703492,BIPN 134,A06,193501,Cooke; James Edward,30,0,32,2
1683665703492,BIPN 134,A07,193510,Cooke; James Edward,29,0,32,3
1683665705542,BISP 194,A00,222522,Staff,14,0,32,18
1683665706565,CAT 124,A01,202407,Staff,19,0,25,6
1683665707591,CAT 125,A00,202408,Marchisotto; Jennifer Anne,2,0,20,18
1683665708619,CAT 125R,A00,202409,Smith; Lauryn Alissa,0,11,20,20
1683665708619,CAT 125R,B00,202410,Morales; Celeste Georgianna,0,11,20,20
1683665708619,CAT 125R,C00,202411,Irwin; Matthew Joseph,0,12,20,20
1683665709646,CENG 15,A01,204712,Yang; Kesong,0,1,0,0
1683665710670,CENG 114,A00,202070,Jahed Motlagh; Zeinab,5,0,20,15
1683665711697,CGS 105,A00,185477,Wesling; Megan E.,24,0,40,16
1683665712724,CGS 106,A00,185494,Staff,11,0,22,11
1683665713749,CGS 108,A00,185495,Staff,14,0,20,6
1683665714775,CGS 114,A00,185496,Staff,13,0,18,5
1683665715800,CGS 119,A00,185501,Staff,15,0,20,5
1683665716826,CGS 120,A00,185511,Staff,12,0,20,8
1683665717851,CHEM 4,A01,184675,Bussey; Thomas J,97,0,100,3
1683665718878,CHEM 6A,A01,184677,Staff,32,0,60,28
1683665719904,CHEM 6B,A01,184679,Staff,63,0,100,37
1683665720930,CHEM 6C,A01,184681,Bussey; Thomas J,0,0,50,50
1683665720930,CHEM 6C,A02,184682,Bussey; Thomas J,32,0,50,18
1683665721957,CHEM 40A,A01,184684,Albizati; Kim F.,34,0,100,66
1683665723044,CHEM 40B,A01,184686,Albizati; Kim F.,0,22,100,100
1683665724069,CHEM 41B,A01,184690,Staff,51,0,100,49
1683665725094,COGS 3,A01,184715,Boyle; Mary E. T.,0,27,40,40
1683665726119,COGS 14B,A01,185172,Staff,0,14,38,38
1683665727143,COGS 18,A01,184736,Staff,14,0,80,66
1683665728169,COGS 100,A01,184932,Staff,0,7,73,73
1683665729196,COGS 101A,A01,184935,Staff,0,40,30,30
1683665730219,COGS 101B,A01,184944,Staff,0,2,30,30
1683665731242,COGS 101C,A01,184946,Staff,0,10,30,30
1683665732273,COGS 102A,A01,184951,Johnson; Christine M.,2,0,40,38
1683665733296,COGS 107B,A01,184953,Mooshagian; Eric Frederick,0,51,40,40
1683665734320,COGS 118B,A01,184959,Gupta; Anjum,0,50,40,40
1683665735343,COGS 153,A00,184961,Staff,0,16,30,30
1683665736367,COGS 177,A00,184962,Staff,0,21,30,30
1683665737390,COGS 187A,A01,184969,Boyle; Mary E. T.,0,19,40,40
1683665738419,COMM 10,A01,185174,Staff,0,5,25,25
1683665738419,COMM 10,A02,185189,Staff,0,2,25,25
1683665738419,COMM 10,A03,269821,Staff,0,1,0,0
1683665739443,COMM 100B,A01,185475,Staff,0,1,0,2
1683665739443,COMM 100B,A02,185476,Staff,12,0,25,13
1683665740466,COMM 100C,A01,185314,Staff,1,0,25,24
1683665740466,COMM 100C,A02,185327,Staff,18,0,25,7
1683665741491,COMM 110M,A00,185349,Staff,0,0,40,40
1683665742514,COMM 113T,A00,185352,Staff,25,0,40,15
1683665743540,COMM 114I,A00,185353,Staff,31,0,40,9
1683665744567,COMM 131,A00,185354,Staff,17,0,30,13
1683665745592,CSE 8A,A50,185358,Cao; Yingjun,0,46,10,10
1683665746618,CSE 8B,A01,185362,Staff,0,48,50,50
1683665747643,CSE 11,A01,185416,Cao; Yingjun,0,91,10,10
1683665748667,CSE 20,A01,185445,Briones; Jor-el Thomas Caparas,4,0,25,21
1683665749691,CSE 21,A01,185447,Staff,9,0,50,41
1683665750714,CSE 101,A01,185451,Staff,0,13,50,50
1683665750714,CSE 101,B01,185453,Jones; Miles E,0,14,50,50
1683665752761,CSE 141,A01,185458,Eldon; John,16,0,100,84
1683665753786,CSE 141L,A01,185461,Eldon; John,8,0,100,92
1683665754811,CSE 142,A01,185463,Staff,34,0,60,26
1683665754811,CSE 142,B01,201355,Staff,0,7,60,60
1683665755838,CSE 142L,A01,185470,Staff,34,0,60,26
1683665755838,CSE 142L,B01,201417,Staff,0,6,60,60
1683665756862,CSE 190,A00,201433,Staff,32,0,49,17
1683665757887,DOC 1,A01,259136,Strom; Megan C.,7,0,15,8
1683665757887,DOC 1,A02,259137,Strom; Megan C.,14,0,15,1
1683665757887,DOC 1,A03,259138,Strom; Megan C.,14,0,15,1
1683665757887,DOC 1,A04,259139,Strom; Megan C.,14,0,15,1
1683665758911,DOC 100D,A00,259140,Pass; Natalye Joann,14,0,25,11
1683665759937,DSGN 1,A01,184749,Rill; Bryan,0,26,30,30
1683665760963,DSGN 100,A01,185168,Staff,0,2,25,25
1683665761987,ECE 5,A01,185626,Morris; Karcher William,0,12,0,0
1683665763011,ECE 101,A01,185628,Staff,14,0,70,56
1683665764036,ECE 107,A01,185635,Baghdadchi; Saharnaz,0,0,20,20
1683665764036,ECE 107,A02,185638,Baghdadchi; Saharnaz,1,0,20,19
1683665765060,ECE 148,A01,185647,Silberman; Jack,0,0,16,16
1683665766084,ECON 1,A01,185537,Crane; Meredith Helen,54,0,70,16
1683665767109,ECON 3,A01,185549,Crane; Meredith Helen,29,0,70,41
1683665768137,ECON 4,A01,203354,Anderson; John Charles,0,5,10,10
1683665769160,ECON 100A,A01,185574,Staff,0,5,40,40
1683665770184,ECON 100B,A01,185576,Staff,0,12,50,50
1683665771211,ECON 100C,A01,185589,Newhouse; Herbert S,30,0,70,40
1683665772235,ECON 105,A00,185608,Vespa; Emanuel Ignacio,19,0,35,16
1683665773262,ECON 109,A01,185610,Shishkin; Denis,9,0,35,26
1683665774288,ECON 110A,A01,185612,Staff,9,0,40,31
1683665775313,ECON 120A,A01,185615,Staff,19,0,40,21
1683665776336,ECON 120C,A01,185617,Sun; Yixiao,0,20,70,70
1683665777360,ECON 144,A00,203346,Squires; Dale E,2,0,35,33
1683665778384,ECON 171,A01,203349,Newhouse; Herbert S,0,1,35,35
1683665779407,ECON 173A,A01,185621,Toda; Alexis Akira,20,0,35,15
1683665780433,EDS 25,A01,202413,Staff,0,1,0,0
1683665780433,EDS 25,A02,202414,Staff,0,1,0,0
1683665780433,EDS 25,A03,202415,Staff,0,0,0,0
1683665780433,EDS 25,A04,202416,Staff,0,1,0,0
1683665780433,EDS 25,A05,202439,Staff,0,0,0,0
1683665780433,EDS 25,A06,202440,Staff,0,0,0,0
1683665780433,EDS 25,B01,202631,Staff,0,0,0,0
1683665780433,EDS 25,B02,202632,Staff,0,0,0,0
1683665780433,EDS 25,B03,202639,Staff,0,0,0,0
1683665780433,EDS 25,B04,202640,Staff,0,0,0,0
1683665780433,EDS 25,B05,202643,Staff,0,0,0,0
1683665780433,EDS 25,B06,202644,Staff,0,0,0,0
1683665781457,EDS 38,A01,202659,Black; Alison Michelle,24,0,25,1
1683665782480,EDS 115,A00,202652,Staff,18,0,30,12
1683665783505,EDS 125,A00,202649,Staff,13,0,30,17
1683665784532,EDS 126,A01,203332,Staff,30,0,30,0
1683665785557,EDS 139,A00,202838,Staff,16,0,25,9
1683665786581,EDS 146,A01,202655,Staff,14,0,25,11
1683665787609,ENG 15,A00,185667,Staff,0,1,0,0
1683665787609,ENG 15,B00,185672,Staff,0,0,0,0
1683665787609,ENG 15,C00,185675,Staff,0,0,0,0
1683665787609,ENG 15,D00,185682,Staff,0,0,0,0
1683665787609,ENG 15,E00,185684,Staff,0,0,0,0
1683665788634,ETHN 103,A00,185710,Staff,0,8,35,35
1683665789660,ETHN 103A,A00,199228,Man; Simeon S,0,0,9,9
1683665790684,ETHN 109,A00,185711,Staff,15,0,35,20
1683665791711,ETHN 142,A00,185726,Staff,0,4,30,30
1683665792737,ETHN 163J,A00,199229,Man; Simeon S,5,0,8,3
1683665793761,ETHN 168,A00,185727,Staff,7,0,10,3
1683665794786,ETHN 182,A00,185728,Staff,0,0,35,35
1683665795809,ETHN 183,A00,185737,Staff,9,0,18,9
1683665796834,GLBH 111,A01,209361,Burgos; Jose L.,0,0,0,0
1683665798883,HIEU 104,A00,185792,Staff,14,0,20,6
1683665799908,HIEU 115,A00,185800,Staff,0,0,20,20
1683665800933,HIEU 128,A00,185801,Staff,0,9,20,20
1683665801955,HIEU 147,A00,185802,Staff,15,0,20,5
1683665802982,HIEU 154,A00,185823,Staff,11,0,20,9
1683665804005,HILA 102,A00,185826,Staff,14,0,20,6
1683665805029,HILD 2C,A01,185778,Staff,0,13,20,20
1683665806055,HILD 7B,A01,185780,Kwak; Nancy,0,17,32,32
1683665806055,HILD 7B,A02,185781,Kwak; Nancy,0,18,32,32
1683665807082,HILD 30,A01,185791,Staff,12,0,20,8
1683665808109,HISC 119,A00,185830,Golan; Tal,0,9,20,20
1683665809141,HITO 156GS,A00,185831,Patterson; Patrick H.,0,0,0,23
1683665810167,HIUS 103,A00,185832,Man; Simeon S,0,4,20,20
1683665811190,HIUS 117,A00,185836,Kwak; Nancy,2,0,20,18
1683665812213,HIUS 125,A00,185840,Man; Simeon S,0,2,23,23
1683665813236,HIUS 149,A00,185845,Staff,1,0,20,19
1683665814265,HUM 3,A01,185882,Zavodny; Tatiana Sophia,0,8,50,50
1683665814265,HUM 3,B01,185899,Caldwell; Michael Alan,0,18,50,50
1683665815289,HUM 3GS,A00,185900,Patterson; Patrick H.,0,0,0,23
1683665816318,HUM 4,A01,185938,Zroka; Amy Liane,29,0,50,21
1683665816318,HUM 4,B01,185956,Watkins; Eric,0,5,50,50
1683665816318,HUM 4,B02,202209,Watkins; Eric,0,5,50,50
1683665816318,HUM 4,B03,202210,Watkins; Eric,0,5,50,50
1683665817346,HUM 5,A01,185958,West; Geoffrey Scott,0,0,50,50
1683665817346,HUM 5,A02,202215,West; Geoffrey Scott,0,0,50,50
1683665818369,INTL 190,A00,185959,Gagnon; Jeffrey C,0,0,0,9
1683665818369,INTL 190,B00,185960,Lettieri; Michael Joseph,0,0,0,2
1683665819393,JAPN 180,A00,254509,Staff,5,0,30,25
1683665820421,LATI 10,A01,202853,Kennemore; Amy Michelle,4,0,35,31
1683665820421,LATI 10,A02,202854,Kennemore; Amy Michelle,2,0,35,33
1683665820421,LATI 10,A03,270054,Kennemore; Amy Michelle,30,0,30,0
1683665821443,LATI 180,A00,202855,Kennemore; Amy Michelle,11,0,20,9
1683665822466,LAWS 101,A00,201767,Golan; Tal,0,7,40,40
1683665823491,LIFR 1C,A00,185961,Staff,6,0,20,14
1683665824513,LIFR 1CX,A00,185962,Staff,7,0,20,13
1683665825538,LIFR 1D,A00,185963,Staff,7,0,20,13
1683665826621,LIFR 1DX,A00,185964,Staff,7,0,20,13
1683665827647,LIGN 101,A01,186039,Staff,43,0,50,7
1683665828675,LIGN 165,A00,186040,Staff,15,0,50,35
1683665829701,LTCS 108,A00,186041,Staff,5,0,10,5
1683665830725,LTCS 119,A00,186042,Staff,15,0,20,5
1683665831753,LTCS 130,A00,186043,Wesling; Megan E.,15,0,25,10
1683665833808,LTEA 138,A00,186119,Staff,14,0,40,26
1683665834833,LTEN 124,A00,186148,Staff,5,0,25,20
1683665835860,LTEN 178,A00,186149,Staff,7,0,15,8
1683665836888,LTEN 181,A00,186150,Blanco; John D,34,0,40,6
1683665837912,LTWL 120,A00,186160,Staff,20,0,25,5
1683665838936,LTWL 165,A00,186161,Staff,22,0,25,3
1683665839963,LTWR 100,A00,186162,Staff,0,5,15,15
1683665840989,LTWR 102,A00,186163,Doller; Ben,5,0,15,10
1683665842016,MAE 8,A01,186412,Staff,0,0,0,0
1683665843043,MAE 30B,A00,186445,Bahadori; Mohammad Yousef,82,0,100,18
1683665844067,MAE 40,A00,186592,Bewley; Thomas R,10,0,50,40
1683665845089,MAE 101B,A00,186593,Bahadori; Mohammad Yousef,80,0,100,20
1683665846116,MAE 105,A00,186594,Bandaru; Prabhakar,10,0,50,40
1683665847143,MAE 107,A00,186599,Pham; Hieu Tan,0,7,120,120
1683665848165,MAE 148,A01,186660,Silberman; Jack,3,0,16,13
1683665849189,MATH 10A,A01,188095,Staff,0,6,35,35
1683665850218,MATH 10B,A01,188097,Bowers; Adam R.,0,12,30,30
1683665850218,MATH 10B,A02,188099,Bowers; Adam R.,0,11,30,30
1683665850218,MATH 10B,B01,188104,Bowers; Adam R.,0,10,30,30
1683665850218,MATH 10B,B02,188106,Bowers; Adam R.,1,9,30,29
1683665851241,MATH 10C,A01,188111,Staff,0,18,30,30
1683665851241,MATH 10C,A02,188127,Staff,0,19,30,30
1683665851241,MATH 10C,A03,188131,Staff,0,19,30,30
1683665851241,MATH 10C,B01,188218,Staff,17,0,30,13
1683665851241,MATH 10C,B02,188244,Staff,13,0,30,17
1683665851241,MATH 10C,B03,188277,Staff,14,0,30,16
1683665852270,MATH 18,A01,188344,Bach; Quang Tran,18,0,30,12
1683665852270,MATH 18,A02,188345,Bach; Quang Tran,11,0,30,19
1683665852270,MATH 18,B01,188353,Bach; Quang Tran,11,0,30,19
1683665852270,MATH 18,B02,188354,Bach; Quang Tran,19,0,30,11
1683665853293,MATH 20A,A01,188374,Staff,11,0,35,24
1683665854321,MATH 20B,A01,188382,Ohm; Ko Woon,7,0,30,23
1683665854321,MATH 20B,A02,188383,Ohm; Ko Woon,22,0,30,8
1683665854321,MATH 20B,B01,188385,Ohm; Ko Woon,7,0,30,23
1683665854321,MATH 20B,B02,188392,Ohm; Ko Woon,22,0,30,8
1683665855348,MATH 20C,A01,188394,Harel; Guershon,10,0,30,20
1683665855348,MATH 20C,A02,188395,Harel; Guershon,13,0,30,17
1683665855348,MATH 20C,B01,188404,Harel; Guershon,5,0,30,25
1683665855348,MATH 20C,B02,188405,Harel; Guershon,18,0,30,12
1683665856373,MATH 20D,A01,188414,Hammock; Frances H,0,1,30,30
1683665856373,MATH 20D,A02,188415,Hammock; Frances H,0,1,30,30
1683665856373,MATH 20D,B01,188447,Hammock; Frances H,0,1,30,30
1683665856373,MATH 20D,B02,188486,Hammock; Frances H,3,0,30,27
1683665857397,MATH 20E,A01,188649,Staff,21,0,30,9
1683665857397,MATH 20E,A02,188650,Staff,21,0,30,9
1683665857397,MATH 20E,A03,188673,Staff,0,0,30,30
1683665858420,MATH 102,A01,188675,Staff,0,36,35,35
1683665859447,MATH 103B,A01,188681,Staff,3,0,35,32
1683665859447,MATH 103B,B01,188692,Staff,5,0,35,30
1683665860471,MATH 109,A01,188695,Salehi Golsefidy; Alireza,24,0,35,11
1683665860471,MATH 109,A02,188696,Salehi Golsefidy; Alireza,25,0,35,10
1683665861495,MATH 120A,A01,188698,Eggers; John Dietrich,7,0,35,28
1683665862523,MATH 142B,A01,188736,Ioana; Adrian,1,1,30,29
1683665862523,MATH 142B,A02,188741,Ioana; Adrian,0,1,30,30
1683665862523,MATH 142B,A03,188743,Ioana; Adrian,0,1,30,30
1683665863547,MATH 168A,A01,188790,Staff,0,10,35,35
1683665864575,MATH 170A,A01,188803,Nie; Jiawang,0,2,35,35
1683665864575,MATH 170A,A02,188811,Nie; Jiawang,0,0,35,35
1683665864575,MATH 170A,A03,188814,Nie; Jiawang,0,0,35,35
1683665864575,MATH 170A,A04,188815,Nie; Jiawang,9,0,35,26
1683665865599,MATH 193B,A01,188817,Staff,0,0,35,35
1683665865599,MATH 193B,A02,188818,Staff,5,0,35,30
1683665866623,MGT 4,A01,202857,Anderson; John Charles,61,0,80,19
1683665867646,MGT 12,A00,202858,Lindenberger; Wade Douglas,40,0,90,50
1683665868673,MGT 18,A00,202859,Staff,74,0,90,16
1683665869699,MGT 18GS,A00,202860,McKay; Michael J,13,0,28,15
1683665870723,MGT 45,A00,202861,Pecore; Joseph P.,11,0,90,79
1683665871748,MGT 100,A00,202863,Yavorsky; Daniel Ryan,28,0,90,62
1683665872776,MGT 103,A00,202864,Ehrich; Kristine R,0,18,90,90
1683665873802,MGT 112,A00,202865,Ehrich; Kristine R,14,0,90,76
1683665874830,MGT 121A,A00,202868,Staff,90,20,90,0
1683665875854,MGT 131B,A00,202869,Anderson; John Charles,59,0,90,31
1683665876879,MGT 136,A00,202871,Lindenberger; Wade Douglas,83,0,90,7
1683665877902,MGT 164,A00,202873,Staff,0,67,90,91
1683665878929,MGT 164GS,A00,202874,McKay; Mary A,13,0,28,15
1683665879956,MGT 180,A00,202875,Staff,0,51,90,91
1683665880979,MMW 11R,A01,205019,Herbst; Matthew,1,0,30,29
1683665880979,MMW 11R,A02,205026,Herbst; Matthew,29,0,30,1
1683665882010,MMW 15,A01,193512,Chang; Edmond Yi-Teh,0,8,28,28
1683665882010,MMW 15,A02,193513,Chang; Edmond Yi-Teh,0,5,28,28
1683665882010,MMW 15,A03,193514,Chang; Edmond Yi-Teh,0,5,28,28
1683665882010,MMW 15,A04,193515,Chang; Edmond Yi-Teh,0,5,28,28
1683665882010,MMW 15,A05,193516,Chang; Edmond Yi-Teh,0,5,28,28
1683665882010,MMW 15,A06,193517,Chang; Edmond Yi-Teh,0,6,28,28
1683665882010,MMW 15,B01,193519,Chang; Edmond Yi-Teh,0,5,28,28
1683665882010,MMW 15,B02,193520,Chang; Edmond Yi-Teh,0,5,28,28
1683665882010,MMW 15,B03,193521,Chang; Edmond Yi-Teh,0,5,28,28
1683665882010,MMW 15,B04,193522,Chang; Edmond Yi-Teh,0,5,28,28
1683665882010,MMW 15,B05,193523,Chang; Edmond Yi-Teh,0,5,28,28
1683665882010,MMW 15,B06,193524,Chang; Edmond Yi-Teh,0,5,28,28
1683665883036,MMW 122,A01,193526,Rahimi; Babak,0,16,28,28
1683665883036,MMW 122,A02,193527,Rahimi; Babak,0,15,28,28
1683665883036,MMW 122,A03,193528,Rahimi; Babak,0,0,0,0
1683665883036,MMW 122,A04,193529,Rahimi; Babak,0,0,0,0
1683665884060,MUS 1A,A01,186663,Staff,1,20,35,34
1683665885088,MUS 4,A01,186715,Staff,0,12,35,35
1683665886111,MUS 5R,A01,186796,Dubnov; Shlomo,0,17,35,35
1683665887141,MUS 6,A01,186798,Staff,0,5,25,25
1683665888166,MUS 7,A01,186830,Staff,11,0,35,24
1683665889189,MUS 8,A01,186930,Staff,0,26,35,35
1683665890215,MUS 15,A01,186932,Staff,0,16,35,35
1683665890215,MUS 15,B01,186934,Staff,1,17,35,34
1683665891239,MUS 80,A00,186935,Staff,0,0,20,20
1683665891239,MUS 80,B00,186936,Staff,24,0,25,1
1683665892262,NANO 11,A00,204702,Lipomi; Darren John,0,0,0,0
1683665893285,NANO 15,A01,204709,Yang; Kesong,0,1,0,0
1683665894309,NANO 114,A00,202069,Jahed Motlagh; Zeinab,3,0,10,7
1683665895336,PHIL 1,A00,186955,Grush; Rick Scott,31,0,40,9
1683665896364,PHIL 10,A01,186973,Grush; Rick Scott,27,0,35,8
1683665896364,PHIL 10,A02,186974,Grush; Rick Scott,33,0,35,2
1683665897391,PHIL 13,A01,186976,Staff,3,0,35,32
1683665897391,PHIL 13,A02,186977,Staff,16,0,35,19
1683665898417,PHIL 14,A01,186979,Staff,31,0,35,4
1683665898417,PHIL 14,A02,186986,Staff,32,0,35,3
1683665899443,PHIL 28,A01,186988,Staff,16,0,30,14
1683665899443,PHIL 28,A02,186989,Staff,1,0,30,29
1683665899443,PHIL 28,A03,186990,Staff,10,0,30,20
1683665899443,PHIL 28,A04,186991,Staff,26,0,30,4
1683665900466,PHIL 120,A00,186997,Staff,23,0,40,17
1683665901494,PHIL 137,A00,187003,Staff,7,0,40,33
1683665902520,PHIL 150,A00,187015,Staff,47,0,70,23
1683665903543,PHIL 167,A00,187021,Lamey; Andy M.,34,0,40,6
1683665904571,PHIL 174,A01,202226,Staff,17,0,20,3
1683665904571,PHIL 174,A02,202235,Staff,20,0,20,0
1683665905595,PHIL 191A,A00,258918,Staff,0,0,1,1
1683665906622,PHYS 1A,A00,187028,Staff,26,0,60,34
1683665907652,PHYS 1AL,001,187036,Staff,3,0,30,27
1683665907652,PHYS 1AL,002,187049,Staff,18,0,30,12
1683665908683,PHYS 1B,A00,187058,Staff,22,0,60,38
1683665909708,PHYS 1BL,001,187064,Staff,0,1,30,30
1683665909708,PHYS 1BL,002,187070,Staff,4,0,30,26
1683665910734,PHYS 1C,A00,187082,Staff,29,0,120,91
1683665911758,PHYS 1CL,001,187088,Staff,0,9,30,30
1683665911758,PHYS 1CL,002,187089,Staff,0,1,30,30
1683665911758,PHYS 1CL,009,262693,Staff,9,0,30,21
1683665912785,PHYS 2B,A01,187097,Staff,55,0,115,60
1683665913812,PHYS 2C,A01,187099,Staff,63,0,115,52
1683665914837,PHYS 2CL,A01,187101,Staff,5,0,28,23
1683665914837,PHYS 2CL,A02,187102,Staff,15,0,28,13
1683665915860,PHYS 2D,A01,187123,Shotwell; Brian,95,0,115,20
1683665916888,PHYS 4B,A01,187133,Grinstein; Benjamin,35,0,50,15
1683665917916,POLI 10,A00,188819,Staff,0,4,50,50
1683665918943,POLI 11,A00,188827,Staff,43,0,50,7
1683665919968,POLI 13R,A00,188828,Staff,0,1,20,20
1683665920996,POLI 27,A01,188830,Elgin; Samuel Zincke,0,2,70,70
1683665922020,POLI 30,A00,188832,Desposato; Scott,30,0,50,20
1683665923043,POLI 102F,A00,188834,Staff,0,0,40,40
1683665924071,POLI 104A,A00,188852,Staff,13,0,30,17
1683665925098,POLI 104I,A00,188853,Staff,0,7,20,20
1683665926121,POLI 110B,A00,188854,Wiens; David,6,0,20,14
1683665927145,POLI 112A,A00,188855,Wiens; David,3,0,30,27
1683665928169,POLI 117R,A00,188856,Forman; Fonna,0,12,20,20
1683665929193,POLI 118,A00,188857,Ingham; Sean,8,0,20,12
1683665930295,POLI 120G,A00,188858,Staff,8,0,30,22
1683665931324,POLI 131CR,A00,188863,Hoston; Germaine,21,0,50,29
1683665932348,POLI 133,A00,188864,Nellis; Gareth Hb,44,0,50,6
1683665933376,POLI 134D,A00,188865,Desposato; Scott,27,0,30,3
1683665934399,POLI 142A,A00,188871,Gartzke; Erik,21,0,50,29
1683665935424,POLI 142K,A00,188874,Staff,38,0,50,12
1683665936449,POLI 143,A00,188940,Gartzke; Erik,16,0,30,14
1683665937474,POLI 153,A00,188943,Staff,2,0,20,18
1683665938499,POLI 160AA,A00,188944,Staff,11,0,40,29
1683665939522,POLI 170A,A00,188945,Staff,11,0,30,19
1683665941572,PSYC 1,A00,188952,Staff,36,0,90,54
1683665942597,PSYC 2,B00,188953,Staff,19,0,35,16
1683665943622,PSYC 6,A00,188970,Staff,47,0,60,13
1683665944647,PSYC 7,A00,188973,Staff,35,0,45,10
1683665945671,PSYC 60,A01,188980,Rickard; Timothy C.,42,0,60,18
1683665946715,PSYC 70,A01,189001,Steiner; Eric Tomas,22,0,45,23
1683665947739,PSYC 100,A00,189005,Lacefield; Katharine I,0,99,120,120
1683665948763,PSYC 102,A00,189008,Staff,8,0,30,22
1683665949792,PSYC 106,B00,189026,Gorman; Michael R.,27,0,60,33
1683665950817,PSYC 114,B01,189033,Winkielman; Piotr,0,31,30,30
1683665951842,PSYC 131,A00,189036,Anagnostaras; Stephan,0,43,60,60
1683665952867,PSYC 136,A00,189041,Lowe; Angela Beth,0,7,25,25
1683665953902,PSYC 137,A00,189057,Winkielman; Piotr,0,37,25,25
1683665954926,PSYC 144,A00,189107,Wixted; John T,0,11,50,50
1683665956979,PSYC 162,A00,189142,Staff,0,9,85,85
1683665958003,PSYC 172,A00,189144,Gorman; Michael R.,0,6,30,30
1683665960056,PSYC 179,A00,189146,Lacefield; Katharine I,0,87,120,120
1683665961083,PSYC 181,A00,189147,Anagnostaras; Stephan,0,44,90,90
1683665962111,PSYC 190R,A00,189148,Barner; David A.,0,23,80,80
1683665963134,PSYC 191,A00,189275,Rickard; Timothy C.,0,10,25,25
1683665964157,PSYC 193,A00,189276,Chapman; Eddie Nathaniel,0,1,0,4
1683665965182,PSYC 193L,A01,189281,Lowe; Angela Beth,10,0,20,10
1683665965182,PSYC 193L,B01,189285,Staff,28,0,35,7
1683665966208,RELI 149,A00,187137,Rahimi; Babak,7,0,40,33
1683665967233,SE 9,A01,187315,Staff,0,2,18,18
1683665968257,SE 101B,A00,187409,Staff,24,0,30,6
1683665969281,SE 110B,A00,187444,Staff,10,0,40,30
1683665970305,SE 130B,A00,187449,Staff,31,0,40,9
1683665971329,SE 150A,A00,187516,Staff,8,0,20,12
1683665972357,SE 154,A00,187528,Staff,29,0,50,21
1683665973381,SIO 3,A01,258171,Staff,35,0,40,5
1683665974405,SIO 10,A00,187144,Cook; Geoffrey W,0,7,75,75
1683665975433,SIO 45,A00,187152,Cook; Geoffrey W,0,5,100,100
1683665976458,SIO 109R,A00,194486,Staff,0,4,20,20
1683665978512,SIO 187,A01,187233,Kacev; David,12,0,40,28
1683665979540,SOCI 1,A01,258656,Thorpe; Charles Robert,28,0,30,2
1683665979540,SOCI 1,A02,258658,Thorpe; Charles Robert,30,0,30,0
1683665979540,SOCI 1,A03,258661,Thorpe; Charles Robert,25,0,25,0
1683665979540,SOCI 1,A04,258666,Thorpe; Charles Robert,22,0,25,3
1683665979540,SOCI 1,A05,258897,Thorpe; Charles Robert,22,0,25,3
1683665979540,SOCI 1,A06,258898,Thorpe; Charles Robert,25,0,25,0
1683665980564,SOCI 30,A01,258903,Pardo Guerra; Juan Pablo,14,0,30,16
1683665981589,SOCI 102,A00,258904,Staff,9,0,25,16
1683665982613,SOCI 106,A00,258905,Staff,19,0,25,6
1683665983636,SOCI 111,A00,258907,Ribas Norris; Janet Vanesa,26,0,30,4
1683665984665,SOCI 121R,A00,258908,Pardo Guerra; Juan Pablo,8,0,30,22
1683665985690,SOCI 126,A01,203330,Staff,14,0,20,6
1683665986714,SOCI 131,A00,258909,Thorpe; Charles Robert,30,0,60,30
1683665987739,SOCI 135,A00,258910,Payne; Christine Anna,0,11,30,30
1683665988765,SOCI 157,A00,258911,Staff,12,0,30,18
1683665989789,SOCI 184,A00,258912,Staff,25,0,30,5
1683665990813,SOCI 188D,A00,258913,Staff,22,0,30,8
1683665991840,SYN 2,001,187529,Staff,9,0,16,7
1683665991840,SYN 2,002,201452,Staff,0,20,16,16
1683665991840,SYN 2,003,201469,Staff,1,0,16,15
1683665992866,SYN 100,A01,187531,Staff,0,9,20,20
1683665992866,SYN 100,B01,201491,Staff,0,10,20,20
1683665993893,TDAC 1,A00,189286,Walsh; Kim C.,3,0,20,17
1683665993893,TDAC 1,B00,189287,Harting; Carla Kelso,10,0,20,10
1683665994917,TDAC 101,A00,189300,Walsh; Kim C.,16,0,20,4
1683665994917,TDAC 101,B00,189301,Harting; Carla Kelso,18,0,20,2
1683665995943,TDAC 102,A00,189304,Basso; Beatrice,14,0,20,6
1683665996970,TDAC 108,A00,189305,Staff,18,0,20,2
1683665997995,TDDE 131,A00,189310,Staff,19,0,20,1
1683665997995,TDDE 131,B00,189314,Staff,19,0,20,1
1683665997995,TDDE 131,C00,189315,Staff,48,0,50,2
1683665997995,TDDE 131,D00,189316,Staff,14,0,15,1
1683665997995,TDDE 131,E00,204841,Staff,20,0,20,0
1683665999022,TDGE 10,A00,189289,Staff,27,0,50,23
1683665999022,TDGE 10,B00,189290,Havis; Allan,0,1,50,50
1683666000047,TDGE 11,A00,189291,Fulton; Julia,0,4,50,50
1683666000047,TDGE 11,B00,189292,Staff,20,0,25,5
1683666000047,TDGE 11,C00,260270,Staff,0,0,0,0
1683666001073,TDGE 25,A00,189294,Staff,2,0,20,18
1683666002096,TDGE 124,A00,189318,Fulton; Julia,0,8,50,50
1683666003122,TDGE 125,A00,189319,Staff,13,0,25,12
1683666003122,TDGE 125,B00,189320,Staff,23,0,25,2
1683666004148,TDGE 127,A00,189322,Havis; Allan,1,0,50,49
1683666005171,TDHT 101,A00,189323,Staff,18,0,25,7
1683666005171,TDHT 101,B00,189324,Staff,25,0,25,0
1683666006197,TDHT 102,A00,189325,Staff,49,0,50,1
1683666007221,TDMV 1,A00,189295,Arcidiacono; Kristin,20,0,30,10
1683666007221,TDMV 1,B00,189296,Caligagan; Maria T.,24,0,30,6
1683666008252,TDMV 2,A00,189297,Sammartano; Tonnie,27,0,30,3
1683666008252,TDMV 2,B00,189299,Arcidiacono; Kristin,23,0,30,7
1683666009282,TDMV 3,A00,204998,Rincon; Alicia,22,0,30,8
1683666010311,TDMV 120,A00,189458,Sammartano; Tonnie,28,0,30,2
1683666011340,TDMV 138,A00,189541,Jun; Grace Shin Hae,20,0,40,20
1683666012368,TDMV 142,A00,189717,Caligagan; Tony,25,0,30,5
1683666012368,TDMV 142,B00,189718,Caligagan; Maria T.,25,0,30,5
1683666013390,TMC 2,A01,187533,Staff,25,0,25,0
1683666013390,TMC 2,A02,187534,Staff,25,0,25,0
1683666014416,USP 1,A01,187536,Kwak; Nancy,0,16,25,25
1683666015438,USP 5,A01,187538,Staff,9,0,25,16
1683666016464,USP 101,A00,199253,Staff,0,4,0,0
1683666017493,USP 124,A00,187562,Boomhower; Matthew Charles,0,0,30,30
1683666018518,USP 138,A00,187582,Staff,20,0,25,5
1683666019541,USP 152,A01,187597,Staff,3,0,25,22
1683666020566,USP 153,A00,187598,Staff,19,0,25,6
1683666021588,USP 168,A00,187607,Kwak; Nancy,2,0,5,3
1683666022610,USP 173,A00,187619,Staff,4,0,25,21
1683666023634,USP 181,A00,187638,Staff,0,4,25,25
1683666024659,VIS 103,A00,187650,Cruz; Edwin Teddy,17,0,75,58
1683666025687,VIS 110D,A00,187669,Staff,13,0,22,9
1683666026711,VIS 127C,A00,187720,Shen; Kuiyi,68,0,146,78
1683666027737,VIS 149,A00,187731,Yoldas; Pinar,1,14,22,21
1683666028760,VIS 151,A01,188091,Staff,22,0,34,12
1683666028760,VIS 151,A02,188092,Staff,11,0,34,23
1683666029782,VIS 160B,A00,188093,Stalbaum; Brett,0,1,10,10
1683666031831,WCWP 10B,A00,201720,Staff,10,0,15,5
1683666031831,WCWP 10B,B00,201722,Staff,9,0,15,6
1683666032855,WCWP 100,A00,201725,Gagnon; Jeffrey C,0,0,2,2
1683666032855,WCWP 100,B00,201727,Staff,0,4,15,15
1683666036038,ANBI 133,A00,258401,Wilder; Linnea Lorene,34,0,40,6
1683666037065,ANBI 140,A00,258395,Hrvoj Mihic; Branka,18,0,25,7
1683666038088,ANSC 120,A00,258402,Bialecki; Jon Anthony,26,0,40,14
1683666039114,ANSC 144,A00,258400,Staff,12,0,40,28
1683666041160,ANSC 166,A00,258396,Parish; Steven Martin,156,0,175,19
1683666042183,ANSC 180,A00,193533,Staff,8,0,20,12
1683666043209,ANSC 188,A00,258397,Jassal; Aftab,34,0,40,6
1683666044231,ANTH 3,A01,258316,Staff,23,0,30,7
1683666045257,ANTH 5,A00,258394,Semendeferi; Ekaterini,16,0,20,4
1683666046282,ANTH 21,A01,258331,Staff,4,0,40,36
1683666047307,ANTH 103,A00,258398,Varma; Saiba,15,0,25,10
1683666048338,AWP 10,001,202034,Staff,0,0,0,0
1683666048338,AWP 10,002,202035,Staff,0,0,0,0
1683666048338,AWP 10,003,202036,Staff,0,0,0,0
1683666048338,AWP 10,004,202037,Staff,0,0,0,0
1683666048338,AWP 10,005,202038,Staff,0,0,0,0
1683666048338,AWP 10,006,202039,Staff,0,0,0,0
1683666048338,AWP 10,007,202040,Staff,0,0,0,0
1683666048338,AWP 10,008,202041,Staff,0,0,0,0
1683666048338,AWP 10,009,202042,Staff,0,0,0,0
1683666048338,AWP 10,010,202043,Staff,0,0,0,0
1683666048338,AWP 10,011,202044,Staff,0,0,0,0
1683666048338,AWP 10,012,202045,Staff,0,0,0,0
1683666048338,AWP 10,013,202046,Staff,0,0,0,0
1683666048338,AWP 10,014,202047,Staff,0,0,0,0
1683666048338,AWP 10,015,202048,Staff,0,0,0,0
1683666048338,AWP 10,016,202049,Staff,0,0,0,0
1683666048338,AWP 10,017,202050,Staff,0,0,0,0
1683666048338,AWP 10,018,202051,Staff,0,0,0,0
1683666048338,AWP 10,019,202052,Staff,0,0,0,0
1683666048338,AWP 10,020,202053,Staff,0,0,0,0
1683666048338,AWP 10,021,202054,Staff,0,0,0,0
1683666048338,AWP 10,022,202055,Staff,0,0,0,0
1683666048338,AWP 10,023,202056,Staff,0,0,0,0
1683666048338,AWP 10,024,202057,Staff,0,0,0,0
1683666048338,AWP 10,025,202058,Staff,0,0,0,0
1683666048338,AWP 10,026,202059,Staff,0,0,0,0
1683666049361,AWP 102,001,202032,Staff,0,0,0,0
1683666049361,AWP 102,002,202033,Staff,0,0,0,0
1683666050385,BENG 100,A01,254234,Taylor Amos; Alyssa C,31,0,40,9
1683666051411,BENG 196,001,270013,Engler; Adam J.,9999,0,9999,0
1683666052438,BICD 100R,A01,202018,Smith; Laurie,0,7,32,32
1683666052438,BICD 100R,A02,202019,Smith; Laurie,0,3,32,32
1683666052438,BICD 100R,A03,202020,Smith; Laurie,0,1,32,32
1683666052438,BICD 100R,A04,202021,Smith; Laurie,6,0,32,26
1683666052438,BICD 100R,A05,202022,Smith; Laurie,11,0,32,21
1683666053462,BICD 136,A01,193242,Gustafson-Brown; Cindy,0,2,32,32
1683666053462,BICD 136,A02,193244,Gustafson-Brown; Cindy,13,0,32,19
1683666054485,BIEB 102,A01,193249,Butler; Shannon Rhey,1,2,32,31
1683666054485,BIEB 102,A02,193251,Butler; Shannon Rhey,0,0,32,32
1683666054485,BIEB 102,A03,193253,Butler; Shannon Rhey,0,0,32,32
1683666054485,BIEB 102,A04,193255,Butler; Shannon Rhey,14,0,32,18
1683666054485,BIEB 102,A05,193265,Butler; Shannon Rhey,25,0,32,7
1683666054485,BIEB 102,A06,193269,Butler; Shannon Rhey,14,0,32,18
1683666056534,BIEB 150,A01,193274,Staff,0,0,32,32
1683666056534,BIEB 150,A02,193285,Staff,24,0,32,8
1683666057561,BIEB 194,A00,193286,Kurle; Carolyn M.,20,0,32,12
1683666058589,BILD 1,A01,192291,Staff,15,0,32,17
1683666058589,BILD 1,A02,192292,Staff,30,0,32,2
1683666058589,BILD 1,B01,192520,Reuther; Keefe,0,1,0,0
1683666058589,BILD 1,B02,192532,Reuther; Keefe,0,1,0,0
1683666059613,BILD 3,A01,192556,Butler; Shannon Rhey,0,0,32,32
1683666059613,BILD 3,A02,192581,Butler; Shannon Rhey,0,0,32,32
1683666059613,BILD 3,A03,192611,Butler; Shannon Rhey,20,0,32,12
1683666059613,BILD 3,A04,192612,Butler; Shannon Rhey,24,0,32,8
1683666059613,BILD 3,A05,192613,Butler; Shannon Rhey,26,0,32,6
1683666059613,BILD 3,A06,192679,Butler; Shannon Rhey,27,0,32,5
1683666059613,BILD 3,A07,192682,Butler; Shannon Rhey,20,0,32,12
1683666060636,BILD 4,A01,192836,Reuther; Keefe,1,0,24,23
1683666060636,BILD 4,A02,193044,Reuther; Keefe,4,0,24,20
1683666061665,BILD 10,A01,193142,Gustafson-Brown; Cindy,29,0,32,3
1683666061665,BILD 10,A02,193149,Gustafson-Brown; Cindy,31,0,32,1
1683666062693,BIMM 100,A01,193301,Staff,0,6,32,32
1683666062693,BIMM 100,A02,193312,Staff,0,7,32,32
1683666062693,BIMM 100,A03,193323,Staff,0,9,32,32
1683666063715,BIMM 101,A01,193329,McDonnell; Lisa Marie,0,4,24,24
1683666063715,BIMM 101,A02,193339,McDonnell; Lisa Marie,1,4,24,23
1683666063715,BIMM 101,B01,193354,McDonnell; Lisa Marie,0,4,24,24
1683666063715,BIMM 101,B02,193357,McDonnell; Lisa Marie,0,3,24,24
1683666064739,BIMM 110,A01,193377,Tat; John,0,11,32,32
1683666064739,BIMM 110,A02,193378,Tat; John,0,10,32,32
1683666065766,BIMM 120,A01,206116,Staff,0,0,32,32
1683666065766,BIMM 120,A02,206117,Staff,6,0,32,26
1683666065766,BIMM 120,A03,206121,Staff,21,0,32,11
1683666066790,BIPN 100,A01,193393,Park; Ji Young,0,15,32,32
1683666066790,BIPN 100,A02,193402,Park; Ji Young,0,14,32,32
1683666066790,BIPN 100,A03,193413,Park; Ji Young,0,14,32,32
1683666066790,BIPN 100,A04,193414,Park; Ji Young,0,13,32,32
1683666067814,BIPN 102,A01,193429,Staff,0,0,32,32
1683666067814,BIPN 102,A02,193438,Staff,18,0,32,14
1683666068839,BIPN 106,A01,193450,Reyes Gonzalez; Catalina,0,2,40,40
1683666069864,BIPN 134,A01,193465,Cooke; James Edward,0,0,32,32
1683666069864,BIPN 134,A02,193474,Cooke; James Edward,25,0,32,7
1683666069864,BIPN 134,A03,193485,Cooke; James Edward,29,0,32,3
1683666069864,BIPN 134,A04,193486,Cooke; James Edward,20,0,32,12
1683666069864,BIPN 134,A05,193491,Cooke; James Edward,31,0,32,1
1683666069864,BIPN 134,A06,193501,Cooke; James Edward,30,0,32,2
1683666069864,BIPN 134,A07,193510,Cooke; James Edward,29,0,32,3
1683666071912,BISP 194,A00,222522,Staff,14,0,32,18
1683666072937,CAT 124,A01,202407,Staff,19,0,25,6
1683666073963,CAT 125,A00,202408,Marchisotto; Jennifer Anne,2,0,20,18
1683666074992,CAT 125R,A00,202409,Smith; Lauryn Alissa,0,11,20,20
1683666074992,CAT 125R,B00,202410,Morales; Celeste Georgianna,0,11,20,20
1683666074992,CAT 125R,C00,202411,Irwin; Matthew Joseph,0,12,20,20
1683666076016,CENG 15,A01,204712,Yang; Kesong,0,1,0,0
1683666077045,CENG 114,A00,202070,Jahed Motlagh; Zeinab,5,0,20,15
1683666078071,CGS 105,A00,185477,Wesling; Megan E.,24,0,40,16
1683666079099,CGS 106,A00,185494,Staff,11,0,22,11
1683666080122,CGS 108,A00,185495,Staff,14,0,20,6
1683666081145,CGS 114,A00,185496,Staff,13,0,18,5
1683666082170,CGS 119,A00,185501,Staff,15,0,20,5
1683666083194,CGS 120,A00,185511,Staff,12,0,20,8
1683666084222,CHEM 4,A01,184675,Bussey; Thomas J,97,0,100,3
1683666085249,CHEM 6A,A01,184677,Staff,32,0,60,28
1683666086274,CHEM 6B,A01,184679,Staff,63,0,100,37
1683666087299,CHEM 6C,A01,184681,Bussey; Thomas J,0,0,50,50
1683666087299,CHEM 6C,A02,184682,Bussey; Thomas J,32,0,50,18
1683666088325,CHEM 40A,A01,184684,Albizati; Kim F.,34,0,100,66
1683666089348,CHEM 40B,A01,184686,Albizati; Kim F.,0,22,100,100
1683666090375,CHEM 41B,A01,184690,Staff,51,0,100,49
1683666091399,COGS 3,A01,184715,Boyle; Mary E. T.,0,27,40,40
1683666092426,COGS 14B,A01,185172,Staff,0,14,38,38
1683666093451,COGS 18,A01,184736,Staff,14,0,80,66
1683666094478,COGS 100,A01,184932,Staff,0,8,73,73
1683666095502,COGS 101A,A01,184935,Staff,0,40,30,30
1683666096527,COGS 101B,A01,184944,Staff,0,2,30,30
1683666097550,COGS 101C,A01,184946,Staff,0,10,30,30
1683666098575,COGS 102A,A01,184951,Johnson; Christine M.,2,0,40,38
1683666099599,COGS 107B,A01,184953,Mooshagian; Eric Frederick,0,51,40,40
1683666100627,COGS 118B,A01,184959,Gupta; Anjum,0,50,40,40
1683666101654,COGS 153,A00,184961,Staff,0,16,30,30
1683666102680,COGS 177,A00,184962,Staff,0,21,30,30
1683666103703,COGS 187A,A01,184969,Boyle; Mary E. T.,0,19,40,40
1683666104730,COMM 10,A01,185174,Staff,0,5,25,25
1683666104730,COMM 10,A02,185189,Staff,0,2,25,25
1683666104730,COMM 10,A03,269821,Staff,0,1,0,0
1683666105751,COMM 100B,A01,185475,Staff,0,1,0,2
1683666105751,COMM 100B,A02,185476,Staff,12,0,25,13
1683666106777,COMM 100C,A01,185314,Staff,1,0,25,24
1683666106777,COMM 100C,A02,185327,Staff,18,0,25,7
1683666107802,COMM 110M,A00,185349,Staff,0,0,40,40
1683666108827,COMM 113T,A00,185352,Staff,25,0,40,15
1683666109850,COMM 114I,A00,185353,Staff,31,0,40,9
1683666110877,COMM 131,A00,185354,Staff,17,0,30,13
1683666111904,CSE 8A,A50,185358,Cao; Yingjun,0,46,10,10
1683666112932,CSE 8B,A01,185362,Staff,0,48,50,50
1683666113957,CSE 11,A01,185416,Cao; Yingjun,0,91,10,10
1683666114984,CSE 20,A01,185445,Briones; Jor-el Thomas Caparas,4,0,25,21
1683666116009,CSE 21,A01,185447,Staff,9,0,50,41
1683666117034,CSE 101,A01,185451,Staff,0,13,50,50
1683666117034,CSE 101,B01,185453,Jones; Miles E,0,14,50,50
1683666119086,CSE 141,A01,185458,Eldon; John,16,0,100,84
1683666120109,CSE 141L,A01,185461,Eldon; John,8,0,100,92
1683666121137,CSE 142,A01,185463,Staff,34,0,60,26
1683666121137,CSE 142,B01,201355,Staff,0,7,60,60
1683666122162,CSE 142L,A01,185470,Staff,34,0,60,26
1683666122162,CSE 142L,B01,201417,Staff,0,6,60,60
1683666123189,CSE 190,A00,201433,Staff,32,0,49,17
1683666124214,DOC 1,A01,259136,Strom; Megan C.,7,0,15,8
1683666124214,DOC 1,A02,259137,Strom; Megan C.,14,0,15,1
1683666124214,DOC 1,A03,259138,Strom; Megan C.,14,0,15,1
1683666124214,DOC 1,A04,259139,Strom; Megan C.,14,0,15,1
1683666125238,DOC 100D,A00,259140,Pass; Natalye Joann,14,0,25,11
1683666126264,DSGN 1,A01,184749,Rill; Bryan,0,26,30,30
1683666127286,DSGN 100,A01,185168,Staff,0,2,25,25
1683666128311,ECE 5,A01,185626,Morris; Karcher William,0,12,0,0
1683666129334,ECE 101,A01,185628,Staff,14,0,70,56
1683666130359,ECE 107,A01,185635,Baghdadchi; Saharnaz,0,0,20,20
1683666130359,ECE 107,A02,185638,Baghdadchi; Saharnaz,1,0,20,19
1683666131386,ECE 148,A01,185647,Silberman; Jack,0,0,16,16
1683666132409,ECON 1,A01,185537,Crane; Meredith Helen,54,0,70,16
1683666133432,ECON 3,A01,185549,Crane; Meredith Helen,29,0,70,41
1683666134456,ECON 4,A01,203354,Anderson; John Charles,0,5,10,10
1683666135480,ECON 100A,A01,185574,Staff,0,5,40,40
1683666136506,ECON 100B,A01,185576,Staff,0,12,50,50
1683666137587,ECON 100C,A01,185589,Newhouse; Herbert S,30,0,70,40
1683666138611,ECON 105,A00,185608,Vespa; Emanuel Ignacio,19,0,35,16
1683666139642,ECON 109,A01,185610,Shishkin; Denis,9,0,35,26
1683666140665,ECON 110A,A01,185612,Staff,9,0,40,31
1683666141690,ECON 120A,A01,185615,Staff,19,0,40,21
1683666142714,ECON 120C,A01,185617,Sun; Yixiao,0,20,70,70
1683666143738,ECON 144,A00,203346,Squires; Dale E,2,0,35,33
1683666144765,ECON 171,A01,203349,Newhouse; Herbert S,0,1,35,35
1683666145792,ECON 173A,A01,185621,Toda; Alexis Akira,20,0,35,15
1683666146821,EDS 25,A01,202413,Staff,0,1,0,0
1683666146821,EDS 25,A02,202414,Staff,0,1,0,0
1683666146821,EDS 25,A03,202415,Staff,0,0,0,0
1683666146821,EDS 25,A04,202416,Staff,0,1,0,0
1683666146821,EDS 25,A05,202439,Staff,0,0,0,0
1683666146821,EDS 25,A06,202440,Staff,0,0,0,0
1683666146821,EDS 25,B01,202631,Staff,0,0,0,0
1683666146821,EDS 25,B02,202632,Staff,0,0,0,0
1683666146821,EDS 25,B03,202639,Staff,0,0,0,0
1683666146821,EDS 25,B04,202640,Staff,0,0,0,0
1683666146821,EDS 25,B05,202643,Staff,0,0,0,0
1683666146821,EDS 25,B06,202644,Staff,0,0,0,0
1683666147845,EDS 38,A01,202659,Black; Alison Michelle,24,0,25,1
1683666148869,EDS 115,A00,202652,Staff,18,0,30,12
1683666149896,EDS 125,A00,202649,Staff,13,0,30,17
1683666150920,EDS 126,A01,203332,Staff,30,0,30,0
1683666151946,EDS 139,A00,202838,Staff,16,0,25,9
1683666152972,EDS 146,A01,202655,Staff,14,0,25,11
1683666153997,ENG 15,A00,185667,Staff,0,1,0,0
1683666153997,ENG 15,B00,185672,Staff,0,0,0,0
1683666153997,ENG 15,C00,185675,Staff,0,0,0,0
1683666153997,ENG 15,D00,185682,Staff,0,0,0,0
1683666153997,ENG 15,E00,185684,Staff,0,0,0,0
1683666155024,ETHN 103,A00,185710,Staff,0,8,35,35
1683666156049,ETHN 103A,A00,199228,Man; Simeon S,0,0,9,9
1683666157075,ETHN 109,A00,185711,Staff,15,0,35,20
1683666158100,ETHN 142,A00,185726,Staff,0,4,30,30
1683666159126,ETHN 163J,A00,199229,Man; Simeon S,5,0,8,3
1683666160149,ETHN 168,A00,185727,Staff,7,0,10,3
1683666161173,ETHN 182,A00,185728,Staff,0,0,35,35
1683666162200,ETHN 183,A00,185737,Staff,9,0,18,9
1683666163224,GLBH 111,A01,209361,Burgos; Jose L.,0,0,0,0
1683666165277,HIEU 104,A00,185792,Staff,14,0,20,6
1683666166304,HIEU 115,A00,185800,Staff,0,0,20,20
1683666167328,HIEU 128,A00,185801,Staff,0,9,20,20
1683666168354,HIEU 147,A00,185802,Staff,15,0,20,5
1683666169377,HIEU 154,A00,185823,Staff,11,0,20,9
1683666170401,HILA 102,A00,185826,Staff,14,0,20,6
1683666171425,HILD 2C,A01,185778,Staff,0,13,20,20
1683666172450,HILD 7B,A01,185780,Kwak; Nancy,0,17,32,32
1683666172450,HILD 7B,A02,185781,Kwak; Nancy,0,18,32,32
1683666173477,HILD 30,A01,185791,Staff,12,0,20,8
1683666174502,HISC 119,A00,185830,Golan; Tal,0,9,20,20
1683666175529,HITO 156GS,A00,185831,Patterson; Patrick H.,0,0,0,23
1683666176553,HIUS 103,A00,185832,Man; Simeon S,0,4,20,20
1683666177576,HIUS 117,A00,185836,Kwak; Nancy,2,0,20,18
1683666178601,HIUS 125,A00,185840,Man; Simeon S,0,2,23,23
1683666179622,HIUS 149,A00,185845,Staff,1,0,20,19
1683666180645,HUM 3,A01,185882,Zavodny; Tatiana Sophia,0,8,50,50
1683666180645,HUM 3,B01,185899,Caldwell; Michael Alan,0,18,50,50
1683666181668,HUM 3GS,A00,185900,Patterson; Patrick H.,0,0,0,23
1683666182694,HUM 4,A01,185938,Zroka; Amy Liane,29,0,50,21
1683666182694,HUM 4,B01,185956,Watkins; Eric,0,5,50,50
1683666182694,HUM 4,B02,202209,Watkins; Eric,0,5,50,50
1683666182694,HUM 4,B03,202210,Watkins; Eric,0,5,50,50
1683666183722,HUM 5,A01,185958,West; Geoffrey Scott,0,0,50,50
1683666183722,HUM 5,A02,202215,West; Geoffrey Scott,0,0,50,50
1683666184749,INTL 190,A00,185959,Gagnon; Jeffrey C,0,0,0,9
1683666184749,INTL 190,B00,185960,Lettieri; Michael Joseph,0,0,0,2
1683666185775,JAPN 180,A00,254509,Staff,5,0,30,25
1683666186800,LATI 10,A01,202853,Kennemore; Amy Michelle,4,0,35,31
1683666186800,LATI 10,A02,202854,Kennemore; Amy Michelle,2,0,35,33
1683666186800,LATI 10,A03,270054,Kennemore; Amy Michelle,30,0,30,0
1683666187824,LATI 180,A00,202855,Kennemore; Amy Michelle,11,0,20,9
1683666188849,LAWS 101,A00,201767,Golan; Tal,0,7,40,40
1683666189876,LIFR 1C,A00,185961,Staff,6,0,20,14
1683666190899,LIFR 1CX,A00,185962,Staff,7,0,20,13
1683666191923,LIFR 1D,A00,185963,Staff,7,0,20,13
1683666192947,LIFR 1DX,A00,185964,Staff,7,0,20,13
1683666193972,LIGN 101,A01,186039,Staff,43,0,50,7
1683666194999,LIGN 165,A00,186040,Staff,15,0,50,35
1683666196026,LTCS 108,A00,186041,Staff,5,0,10,5
1683666197051,LTCS 119,A00,186042,Staff,15,0,20,5
1683666198075,LTCS 130,A00,186043,Wesling; Megan E.,15,0,25,10
1683666200124,LTEA 138,A00,186119,Staff,14,0,40,26
1683666201148,LTEN 124,A00,186148,Staff,5,0,25,20
1683666202177,LTEN 178,A00,186149,Staff,7,0,15,8
1683666203204,LTEN 181,A00,186150,Blanco; John D,34,0,40,6
1683666204230,LTWL 120,A00,186160,Staff,20,0,25,5
1683666205256,LTWL 165,A00,186161,Staff,22,0,25,3
1683666206284,LTWR 100,A00,186162,Staff,0,5,15,15
1683666207308,LTWR 102,A00,186163,Doller; Ben,5,0,15,10
1683666208333,MAE 8,A01,186412,Staff,0,0,0,0
1683666209361,MAE 30B,A00,186445,Bahadori; Mohammad Yousef,82,0,100,18
1683666210385,MAE 40,A00,186592,Bewley; Thomas R,10,0,50,40
1683666211413,MAE 101B,A00,186593,Bahadori; Mohammad Yousef,80,0,100,20
1683666212439,MAE 105,A00,186594,Bandaru; Prabhakar,10,0,50,40
1683666213466,MAE 107,A00,186599,Pham; Hieu Tan,0,7,120,120
1683666214490,MAE 148,A01,186660,Silberman; Jack,3,0,16,13
1683666215513,MATH 10A,A01,188095,Staff,0,6,35,35
1683666216538,MATH 10B,A01,188097,Bowers; Adam R.,0,12,30,30
1683666216538,MATH 10B,A02,188099,Bowers; Adam R.,0,11,30,30
1683666216538,MATH 10B,B01,188104,Bowers; Adam R.,0,10,30,30
1683666216538,MATH 10B,B02,188106,Bowers; Adam R.,1,9,30,29
1683666217567,MATH 10C,A01,188111,Staff,0,18,30,30
1683666217567,MATH 10C,A02,188127,Staff,0,19,30,30
1683666217567,MATH 10C,A03,188131,Staff,0,19,30,30
1683666217567,MATH 10C,B01,188218,Staff,17,0,30,13
1683666217567,MATH 10C,B02,188244,Staff,13,0,30,17
1683666217567,MATH 10C,B03,188277,Staff,14,0,30,16
1683666218593,MATH 18,A01,188344,Bach; Quang Tran,18,0,30,12
1683666218593,MATH 18,A02,188345,Bach; Quang Tran,11,0,30,19
1683666218593,MATH 18,B01,188353,Bach; Quang Tran,11,0,30,19
1683666218593,MATH 18,B02,188354,Bach; Quang Tran,19,0,30,11
1683666219621,MATH 20A,A01,188374,Staff,11,0,35,24
1683666220647,MATH 20B,A01,188382,Ohm; Ko Woon,7,0,30,23
1683666220647,MATH 20B,A02,188383,Ohm; Ko Woon,22,0,30,8
1683666220647,MATH 20B,B01,188385,Ohm; Ko Woon,7,0,30,23
1683666220647,MATH 20B,B02,188392,Ohm; Ko Woon,22,0,30,8
1683666221671,MATH 20C,A01,188394,Harel; Guershon,10,0,30,20
1683666221671,MATH 20C,A02,188395,Harel; Guershon,13,0,30,17
1683666221671,MATH 20C,B01,188404,Harel; Guershon,5,0,30,25
1683666221671,MATH 20C,B02,188405,Harel; Guershon,18,0,30,12
1683666222697,MATH 20D,A01,188414,Hammock; Frances H,0,1,30,30
1683666222697,MATH 20D,A02,188415,Hammock; Frances H,0,1,30,30
1683666222697,MATH 20D,B01,188447,Hammock; Frances H,0,1,30,30
1683666222697,MATH 20D,B02,188486,Hammock; Frances H,3,0,30,27
1683666223727,MATH 20E,A01,188649,Staff,21,0,30,9
1683666223727,MATH 20E,A02,188650,Staff,21,0,30,9
1683666223727,MATH 20E,A03,188673,Staff,0,0,30,30
1683666224755,MATH 102,A01,188675,Staff,0,36,35,35
1683666225782,MATH 103B,A01,188681,Staff,3,0,35,32
1683666225782,MATH 103B,B01,188692,Staff,5,0,35,30
1683666226806,MATH 109,A01,188695,Salehi Golsefidy; Alireza,24,0,35,11
1683666226806,MATH 109,A02,188696,Salehi Golsefidy; Alireza,25,0,35,10
1683666227831,MATH 120A,A01,188698,Eggers; John Dietrich,7,0,35,28
1683666228857,MATH 142B,A01,188736,Ioana; Adrian,1,1,30,29
1683666228857,MATH 142B,A02,188741,Ioana; Adrian,0,1,30,30
1683666228857,MATH 142B,A03,188743,Ioana; Adrian,0,1,30,30
1683666229882,MATH 168A,A01,188790,Staff,0,10,35,35
1683666230906,MATH 170A,A01,188803,Nie; Jiawang,0,2,35,35
1683666230906,MATH 170A,A02,188811,Nie; Jiawang,0,0,35,35
1683666230906,MATH 170A,A03,188814,Nie; Jiawang,0,0,35,35
1683666230906,MATH 170A,A04,188815,Nie; Jiawang,9,0,35,26
1683666231931,MATH 193B,A01,188817,Staff,0,0,35,35
1683666231931,MATH 193B,A02,188818,Staff,5,0,35,30
1683666232955,MGT 4,A01,202857,Anderson; John Charles,61,0,80,19
1683666233979,MGT 12,A00,202858,Lindenberger; Wade Douglas,40,0,90,50
1683666235006,MGT 18,A00,202859,Staff,74,0,90,16
1683666236033,MGT 18GS,A00,202860,McKay; Michael J,13,0,28,15
1683666237056,MGT 45,A00,202861,Pecore; Joseph P.,11,0,90,79
1683666238083,MGT 100,A00,202863,Yavorsky; Daniel Ryan,28,0,90,62
1683666239109,MGT 103,A00,202864,Ehrich; Kristine R,0,18,90,90
1683666240133,MGT 112,A00,202865,Ehrich; Kristine R,14,0,90,76
1683666241217,MGT 121A,A00,202868,Staff,90,20,90,0
1683666242245,MGT 131B,A00,202869,Anderson; John Charles,59,0,90,31
1683666243269,MGT 136,A00,202871,Lindenberger; Wade Douglas,83,0,90,7
1683666244296,MGT 164,A00,202873,Staff,0,67,90,91
1683666245322,MGT 164GS,A00,202874,McKay; Mary A,13,0,28,15
1683666246346,MGT 180,A00,202875,Staff,0,51,90,91
1683666247369,MMW 11R,A01,205019,Herbst; Matthew,1,0,30,29
1683666247369,MMW 11R,A02,205026,Herbst; Matthew,29,0,30,1
1683666248394,MMW 15,A01,193512,Chang; Edmond Yi-Teh,0,8,28,28
1683666248394,MMW 15,A02,193513,Chang; Edmond Yi-Teh,0,5,28,28
1683666248394,MMW 15,A03,193514,Chang; Edmond Yi-Teh,0,5,28,28
1683666248394,MMW 15,A04,193515,Chang; Edmond Yi-Teh,0,5,28,28
1683666248394,MMW 15,A05,193516,Chang; Edmond Yi-Teh,0,5,28,28
1683666248394,MMW 15,A06,193517,Chang; Edmond Yi-Teh,0,6,28,28
1683666248394,MMW 15,B01,193519,Chang; Edmond Yi-Teh,0,5,28,28
1683666248394,MMW 15,B02,193520,Chang; Edmond Yi-Teh,0,5,28,28
1683666248394,MMW 15,B03,193521,Chang; Edmond Yi-Teh,0,5,28,28
1683666248394,MMW 15,B04,193522,Chang; Edmond Yi-Teh,0,5,28,28
1683666248394,MMW 15,B05,193523,Chang; Edmond Yi-Teh,0,5,28,28
1683666248394,MMW 15,B06,193524,Chang; Edmond Yi-Teh,0,5,28,28
1683666249421,MMW 122,A01,193526,Rahimi; Babak,0,16,28,28
1683666249421,MMW 122,A02,193527,Rahimi; Babak,0,15,28,28
1683666249421,MMW 122,A03,193528,Rahimi; Babak,0,0,0,0
1683666249421,MMW 122,A04,193529,Rahimi; Babak,0,0,0,0
1683666250448,MUS 1A,A01,186663,Staff,1,20,35,34
1683666251477,MUS 4,A01,186715,Staff,0,12,35,35
1683666252502,MUS 5R,A01,186796,Dubnov; Shlomo,0,17,35,35
1683666253533,MUS 6,A01,186798,Staff,0,5,25,25
1683666254562,MUS 7,A01,186830,Staff,11,0,35,24
1683666255587,MUS 8,A01,186930,Staff,0,26,35,35
1683666256617,MUS 15,A01,186932,Staff,0,16,35,35
1683666256617,MUS 15,B01,186934,Staff,1,17,35,34
1683666257645,MUS 80,A00,186935,Staff,0,0,20,20
1683666257645,MUS 80,B00,186936,Staff,24,0,25,1
1683666258675,NANO 11,A00,204702,Lipomi; Darren John,0,0,0,0
1683666259705,NANO 15,A01,204709,Yang; Kesong,0,1,0,0
1683666260732,NANO 114,A00,202069,Jahed Motlagh; Zeinab,3,0,10,7
1683666261759,PHIL 1,A00,186955,Grush; Rick Scott,31,0,40,9
1683666262783,PHIL 10,A01,186973,Grush; Rick Scott,27,0,35,8
1683666262783,PHIL 10,A02,186974,Grush; Rick Scott,33,0,35,2
1683666263807,PHIL 13,A01,186976,Staff,3,0,35,32
1683666263807,PHIL 13,A02,186977,Staff,16,0,35,19
1683666264834,PHIL 14,A01,186979,Staff,31,0,35,4
1683666264834,PHIL 14,A02,186986,Staff,32,0,35,3
1683666265857,PHIL 28,A01,186988,Staff,16,0,30,14
1683666265857,PHIL 28,A02,186989,Staff,1,0,30,29
1683666265857,PHIL 28,A03,186990,Staff,10,0,30,20
1683666265857,PHIL 28,A04,186991,Staff,26,0,30,4
1683666266880,PHIL 120,A00,186997,Staff,23,0,40,17
1683666267907,PHIL 137,A00,187003,Staff,7,0,40,33
1683666268932,PHIL 150,A00,187015,Staff,47,0,70,23
1683666269955,PHIL 167,A00,187021,Lamey; Andy M.,34,0,40,6
1683666270978,PHIL 174,A01,202226,Staff,17,0,20,3
1683666270978,PHIL 174,A02,202235,Staff,20,0,20,0
1683666272017,PHIL 191A,A00,258918,Staff,0,0,1,1
1683666273044,PHYS 1A,A00,187028,Staff,26,0,60,34
1683666274071,PHYS 1AL,001,187036,Staff,3,0,30,27
1683666274071,PHYS 1AL,002,187049,Staff,18,0,30,12
1683666275098,PHYS 1B,A00,187058,Staff,22,0,60,38
1683666276123,PHYS 1BL,001,187064,Staff,0,1,30,30
1683666276123,PHYS 1BL,002,187070,Staff,4,0,30,26
1683666277149,PHYS 1C,A00,187082,Staff,29,0,120,91
1683666278174,PHYS 1CL,001,187088,Staff,0,9,30,30
1683666278174,PHYS 1CL,002,187089,Staff,0,1,30,30
1683666278174,PHYS 1CL,009,262693,Staff,9,0,30,21
1683666279198,PHYS 2B,A01,187097,Staff,55,0,115,60
1683666280230,PHYS 2C,A01,187099,Staff,63,0,115,52
1683666281254,PHYS 2CL,A01,187101,Staff,5,0,28,23
1683666281254,PHYS 2CL,A02,187102,Staff,15,0,28,13
1683666282279,PHYS 2D,A01,187123,Shotwell; Brian,95,0,115,20
1683666283302,PHYS 4B,A01,187133,Grinstein; Benjamin,35,0,50,15
1683666284326,POLI 10,A00,188819,Staff,0,4,50,50
1683666285349,POLI 11,A00,188827,Staff,43,0,50,7
1683666286375,POLI 13R,A00,188828,Staff,0,1,20,20
1683666287402,POLI 27,A01,188830,Elgin; Samuel Zincke,0,2,70,70
1683666288425,POLI 30,A00,188832,Desposato; Scott,30,0,50,20
1683666289449,POLI 102F,A00,188834,Staff,0,0,40,40
1683666290475,POLI 104A,A00,188852,Staff,13,0,30,17
1683666291499,POLI 104I,A00,188853,Staff,0,7,20,20
1683666292523,POLI 110B,A00,188854,Wiens; David,6,0,20,14
1683666293547,POLI 112A,A00,188855,Wiens; David,3,0,30,27
1683666294571,POLI 117R,A00,188856,Forman; Fonna,0,12,20,20
1683666295595,POLI 118,A00,188857,Ingham; Sean,8,0,20,12
1683666296623,POLI 120G,A00,188858,Staff,8,0,30,22
1683666297650,POLI 131CR,A00,188863,Hoston; Germaine,21,0,50,29
1683666298673,POLI 133,A00,188864,Nellis; Gareth Hb,44,0,50,6
1683666299696,POLI 134D,A00,188865,Desposato; Scott,27,0,30,3
1683666300731,POLI 142A,A00,188871,Gartzke; Erik,21,0,50,29
1683666301756,POLI 142K,A00,188874,Staff,38,0,50,12
1683666302784,POLI 143,A00,188940,Gartzke; Erik,16,0,30,14
1683666303809,POLI 153,A00,188943,Staff,2,0,20,18
1683666304838,POLI 160AA,A00,188944,Staff,11,0,40,29
1683666305865,POLI 170A,A00,188945,Staff,11,0,30,19
1683666307917,PSYC 1,A00,188952,Staff,36,0,90,54
1683666308941,PSYC 2,B00,188953,Staff,19,0,35,16
1683666309964,PSYC 6,A00,188970,Staff,47,0,60,13
1683666310992,PSYC 7,A00,188973,Staff,35,0,45,10
1683666312015,PSYC 60,A01,188980,Rickard; Timothy C.,42,0,60,18
1683666313039,PSYC 70,A01,189001,Steiner; Eric Tomas,22,0,45,23
1683666314065,PSYC 100,A00,189005,Lacefield; Katharine I,0,99,120,120
1683666315093,PSYC 102,A00,189008,Staff,8,0,30,22
1683666316117,PSYC 106,B00,189026,Gorman; Michael R.,27,0,60,33
1683666317141,PSYC 114,B01,189033,Winkielman; Piotr,0,31,30,30
1683666318170,PSYC 131,A00,189036,Anagnostaras; Stephan,0,43,60,60
1683666319200,PSYC 136,A00,189041,Lowe; Angela Beth,0,7,25,25
1683666320224,PSYC 137,A00,189057,Winkielman; Piotr,0,37,25,25
1683666321248,PSYC 144,A00,189107,Wixted; John T,0,11,50,50
1683666323301,PSYC 162,A00,189142,Staff,0,9,85,85
1683666324324,PSYC 172,A00,189144,Gorman; Michael R.,0,6,30,30
1683666326377,PSYC 179,A00,189146,Lacefield; Katharine I,0,87,120,120
1683666327401,PSYC 181,A00,189147,Anagnostaras; Stephan,0,44,90,90
1683666328427,PSYC 190R,A00,189148,Barner; David A.,0,23,80,80
1683666329451,PSYC 191,A00,189275,Rickard; Timothy C.,0,10,25,25
1683666330480,PSYC 193,A00,189276,Chapman; Eddie Nathaniel,0,1,0,4
1683666331504,PSYC 193L,A01,189281,Lowe; Angela Beth,10,0,20,10
1683666331504,PSYC 193L,B01,189285,Staff,28,0,35,7
1683666332527,RELI 149,A00,187137,Rahimi; Babak,7,0,40,33
1683666333551,SE 9,A01,187315,Staff,0,2,18,18
1683666334574,SE 101B,A00,187409,Staff,24,0,30,6
1683666335599,SE 110B,A00,187444,Staff,10,0,40,30
1683666336621,SE 130B,A00,187449,Staff,31,0,40,9
1683666337645,SE 150A,A00,187516,Staff,8,0,20,12
1683666338669,SE 154,A00,187528,Staff,29,0,50,21
1683666339696,SIO 3,A01,258171,Staff,35,0,40,5
1683666340721,SIO 10,A00,187144,Cook; Geoffrey W,0,7,75,75
1683666341748,SIO 45,A00,187152,Cook; Geoffrey W,0,5,100,100
1683666342774,SIO 109R,A00,194486,Staff,0,4,20,20
1683666344881,SIO 187,A01,187233,Kacev; David,12,0,40,28
1683666345909,SOCI 1,A01,258656,Thorpe; Charles Robert,28,0,30,2
1683666345909,SOCI 1,A02,258658,Thorpe; Charles Robert,30,0,30,0
1683666345909,SOCI 1,A03,258661,Thorpe; Charles Robert,25,0,25,0
1683666345909,SOCI 1,A04,258666,Thorpe; Charles Robert,22,0,25,3
1683666345909,SOCI 1,A05,258897,Thorpe; Charles Robert,22,0,25,3
1683666345909,SOCI 1,A06,258898,Thorpe; Charles Robert,25,0,25,0
1683666346942,SOCI 30,A01,258903,Pardo Guerra; Juan Pablo,14,0,30,16
1683666347973,SOCI 102,A00,258904,Staff,9,0,25,16
1683666348995,SOCI 106,A00,258905,Staff,19,0,25,6
1683666350022,SOCI 111,A00,258907,Ribas Norris; Janet Vanesa,26,0,30,4
1683666351046,SOCI 121R,A00,258908,Pardo Guerra; Juan Pablo,8,0,30,22
1683666352075,SOCI 126,A01,203330,Staff,14,0,20,6
1683666353102,SOCI 131,A00,258909,Thorpe; Charles Robert,30,0,60,30
1683666354126,SOCI 135,A00,258910,Payne; Christine Anna,0,11,30,30
1683666355152,SOCI 157,A00,258911,Staff,12,0,30,18
1683666356176,SOCI 184,A00,258912,Staff,25,0,30,5
1683666357200,SOCI 188D,A00,258913,Staff,22,0,30,8
1683666358223,SYN 2,001,187529,Staff,9,0,16,7
1683666358223,SYN 2,002,201452,Staff,0,20,16,16
1683666358223,SYN 2,003,201469,Staff,1,0,16,15
1683666359250,SYN 100,A01,187531,Staff,0,9,20,20
1683666359250,SYN 100,B01,201491,Staff,0,10,20,20
1683666360274,TDAC 1,A00,189286,Walsh; Kim C.,3,0,20,17
1683666360274,TDAC 1,B00,189287,Harting; Carla Kelso,10,0,20,10
1683666361301,TDAC 101,A00,189300,Walsh; Kim C.,16,0,20,4
1683666361301,TDAC 101,B00,189301,Harting; Carla Kelso,18,0,20,2
1683666362324,TDAC 102,A00,189304,Basso; Beatrice,14,0,20,6
1683666363350,TDAC 108,A00,189305,Staff,18,0,20,2
1683666364377,TDDE 131,A00,189310,Staff,19,0,20,1
1683666364377,TDDE 131,B00,189314,Staff,19,0,20,1
1683666364377,TDDE 131,C00,189315,Staff,48,0,50,2
1683666364377,TDDE 131,D00,189316,Staff,14,0,15,1
1683666364377,TDDE 131,E00,204841,Staff,20,0,20,0
1683666365403,TDGE 10,A00,189289,Staff,27,0,50,23
1683666365403,TDGE 10,B00,189290,Havis; Allan,0,1,50,50
1683666366426,TDGE 11,A00,189291,Fulton; Julia,0,4,50,50
1683666366426,TDGE 11,B00,189292,Staff,20,0,25,5
1683666366426,TDGE 11,C00,260270,Staff,0,0,0,0
1683666367453,TDGE 25,A00,189294,Staff,2,0,20,18
1683666368479,TDGE 124,A00,189318,Fulton; Julia,0,8,50,50
1683666369503,TDGE 125,A00,189319,Staff,13,0,25,12
1683666369503,TDGE 125,B00,189320,Staff,23,0,25,2
1683666370528,TDGE 127,A00,189322,Havis; Allan,1,0,50,49
1683666371555,TDHT 101,A00,189323,Staff,18,0,25,7
1683666371555,TDHT 101,B00,189324,Staff,25,0,25,0
1683666372580,TDHT 102,A00,189325,Staff,49,0,50,1
1683666373608,TDMV 1,A00,189295,Arcidiacono; Kristin,20,0,30,10
1683666373608,TDMV 1,B00,189296,Caligagan; Maria T.,24,0,30,6
1683666374635,TDMV 2,A00,189297,Sammartano; Tonnie,27,0,30,3
1683666374635,TDMV 2,B00,189299,Arcidiacono; Kristin,23,0,30,7
1683666375661,TDMV 3,A00,204998,Rincon; Alicia,22,0,30,8
1683666376688,TDMV 120,A00,189458,Sammartano; Tonnie,28,0,30,2
1683666377710,TDMV 138,A00,189541,Jun; Grace Shin Hae,20,0,40,20
1683666378737,TDMV 142,A00,189717,Caligagan; Tony,25,0,30,5
1683666378737,TDMV 142,B00,189718,Caligagan; Maria T.,25,0,30,5
1683666379762,TMC 2,A01,187533,Staff,25,0,25,0
1683666379762,TMC 2,A02,187534,Staff,25,0,25,0
1683666380790,USP 1,A01,187536,Kwak; Nancy,0,16,25,25
1683666381814,USP 5,A01,187538,Staff,9,0,25,16
1683666382837,USP 101,A00,199253,Staff,0,4,0,0
1683666383865,USP 124,A00,187562,Boomhower; Matthew Charles,0,0,30,30
1683666384888,USP 138,A00,187582,Staff,20,0,25,5
1683666385912,USP 152,A01,187597,Staff,3,0,25,22
1683666386939,USP 153,A00,187598,Staff,19,0,25,6
1683666387965,USP 168,A00,187607,Kwak; Nancy,2,0,5,3
1683666388989,USP 173,A00,187619,Staff,4,0,25,21
1683666390013,USP 181,A00,187638,Staff,0,4,25,25
1683666391040,VIS 103,A00,187650,Cruz; Edwin Teddy,17,0,75,58
1683666392063,VIS 110D,A00,187669,Staff,13,0,22,9
1683666393089,VIS 127C,A00,187720,Shen; Kuiyi,68,0,146,78
1683666394115,VIS 149,A00,187731,Yoldas; Pinar,1,14,22,21
1683666395140,VIS 151,A01,188091,Staff,22,0,34,12
1683666395140,VIS 151,A02,188092,Staff,11,0,34,23
1683666396164,VIS 160B,A00,188093,Stalbaum; Brett,0,1,10,10
1683666398213,WCWP 10B,A00,201720,Staff,10,0,15,5
1683666398213,WCWP 10B,B00,201722,Staff,9,0,15,6
1683666399240,WCWP 100,A00,201725,Gagnon; Jeffrey C,0,0,2,2
1683666399240,WCWP 100,B00,201727,Staff,0,4,15,15
1683666402370,ANBI 133,A00,258401,Wilder; Linnea Lorene,34,0,40,6
1683666403396,ANBI 140,A00,258395,Hrvoj Mihic; Branka,18,0,25,7
1683666404421,ANSC 120,A00,258402,Bialecki; Jon Anthony,26,0,40,14
1683666405448,ANSC 144,A00,258400,Staff,12,0,40,28
1683666407498,ANSC 166,A00,258396,Parish; Steven Martin,156,0,175,19
1683666408525,ANSC 180,A00,193533,Staff,8,0,20,12
1683666409551,ANSC 188,A00,258397,Jassal; Aftab,34,0,40,6
1683666410579,ANTH 3,A01,258316,Staff,23,0,30,7
1683666411602,ANTH 5,A00,258394,Semendeferi; Ekaterini,16,0,20,4
1683666412626,ANTH 21,A01,258331,Staff,4,0,40,36
1683666413661,ANTH 103,A00,258398,Varma; Saiba,15,0,25,10
1683666414686,AWP 10,001,202034,Staff,0,0,0,0
1683666414686,AWP 10,002,202035,Staff,0,0,0,0
1683666414686,AWP 10,003,202036,Staff,0,0,0,0
1683666414686,AWP 10,004,202037,Staff,0,0,0,0
1683666414686,AWP 10,005,202038,Staff,0,0,0,0
1683666414686,AWP 10,006,202039,Staff,0,0,0,0
1683666414686,AWP 10,007,202040,Staff,0,0,0,0
1683666414686,AWP 10,008,202041,Staff,0,0,0,0
1683666414686,AWP 10,009,202042,Staff,0,0,0,0
1683666414686,AWP 10,010,202043,Staff,0,0,0,0
1683666414686,AWP 10,011,202044,Staff,0,0,0,0
1683666414686,AWP 10,012,202045,Staff,0,0,0,0
1683666414686,AWP 10,013,202046,Staff,0,0,0,0
1683666414686,AWP 10,014,202047,Staff,0,0,0,0
1683666414686,AWP 10,015,202048,Staff,0,0,0,0
1683666414686,AWP 10,016,202049,Staff,0,0,0,0
1683666414686,AWP 10,017,202050,Staff,0,0,0,0
1683666414686,AWP 10,018,202051,Staff,0,0,0,0
1683666414686,AWP 10,019,202052,Staff,0,0,0,0
1683666414686,AWP 10,020,202053,Staff,0,0,0,0
1683666414686,AWP 10,021,202054,Staff,0,0,0,0
1683666414686,AWP 10,022,202055,Staff,0,0,0,0
1683666414686,AWP 10,023,202056,Staff,0,0,0,0
1683666414686,AWP 10,024,202057,Staff,0,0,0,0
1683666414686,AWP 10,025,202058,Staff,0,0,0,0
1683666414686,AWP 10,026,202059,Staff,0,0,0,0
1683666415710,AWP 102,001,202032,Staff,0,0,0,0
1683666415710,AWP 102,002,202033,Staff,0,0,0,0
1683666416735,BENG 100,A01,254234,Taylor Amos; Alyssa C,31,0,40,9
1683666417763,BENG 196,001,270013,Engler; Adam J.,9999,0,9999,0
1683666418787,BICD 100R,A01,202018,Smith; Laurie,0,7,32,32
1683666418787,BICD 100R,A02,202019,Smith; Laurie,0,3,32,32
1683666418787,BICD 100R,A03,202020,Smith; Laurie,0,1,32,32
1683666418787,BICD 100R,A04,202021,Smith; Laurie,6,0,32,26
1683666418787,BICD 100R,A05,202022,Smith; Laurie,11,0,32,21
1683666419812,BICD 136,A01,193242,Gustafson-Brown; Cindy,0,2,32,32
1683666419812,BICD 136,A02,193244,Gustafson-Brown; Cindy,13,0,32,19
1683666420841,BIEB 102,A01,193249,Butler; Shannon Rhey,1,2,32,31
1683666420841,BIEB 102,A02,193251,Butler; Shannon Rhey,0,0,32,32
1683666420841,BIEB 102,A03,193253,Butler; Shannon Rhey,0,0,32,32
1683666420841,BIEB 102,A04,193255,Butler; Shannon Rhey,14,0,32,18
1683666420841,BIEB 102,A05,193265,Butler; Shannon Rhey,25,0,32,7
1683666420841,BIEB 102,A06,193269,Butler; Shannon Rhey,14,0,32,18
1683666422897,BIEB 150,A01,193274,Staff,0,0,32,32
1683666422897,BIEB 150,A02,193285,Staff,24,0,32,8
1683666423922,BIEB 194,A00,193286,Kurle; Carolyn M.,20,0,32,12
1683666424952,BILD 1,A01,192291,Staff,15,0,32,17
1683666424952,BILD 1,A02,192292,Staff,30,0,32,2
1683666424952,BILD 1,B01,192520,Reuther; Keefe,0,1,0,0
1683666424952,BILD 1,B02,192532,Reuther; Keefe,0,1,0,0
1683666425978,BILD 3,A01,192556,Butler; Shannon Rhey,0,0,32,32
1683666425978,BILD 3,A02,192581,Butler; Shannon Rhey,0,0,32,32
1683666425978,BILD 3,A03,192611,Butler; Shannon Rhey,20,0,32,12
1683666425978,BILD 3,A04,192612,Butler; Shannon Rhey,24,0,32,8
1683666425978,BILD 3,A05,192613,Butler; Shannon Rhey,26,0,32,6
1683666425978,BILD 3,A06,192679,Butler; Shannon Rhey,27,0,32,5
1683666425978,BILD 3,A07,192682,Butler; Shannon Rhey,20,0,32,12
1683666427006,BILD 4,A01,192836,Reuther; Keefe,1,0,24,23
1683666427006,BILD 4,A02,193044,Reuther; Keefe,4,0,24,20
1683666428591,BILD 10,A01,193142,Gustafson-Brown; Cindy,29,0,32,3
1683666428591,BILD 10,A02,193149,Gustafson-Brown; Cindy,31,0,32,1
1683666429615,BIMM 100,A01,193301,Staff,0,6,32,32
1683666429615,BIMM 100,A02,193312,Staff,0,7,32,32
1683666429615,BIMM 100,A03,193323,Staff,0,9,32,32
1683666430640,BIMM 101,A01,193329,McDonnell; Lisa Marie,0,4,24,24
1683666430640,BIMM 101,A02,193339,McDonnell; Lisa Marie,1,4,24,23
1683666430640,BIMM 101,B01,193354,McDonnell; Lisa Marie,0,4,24,24
1683666430640,BIMM 101,B02,193357,McDonnell; Lisa Marie,0,3,24,24
1683666431669,BIMM 110,A01,193377,Tat; John,0,11,32,32
1683666431669,BIMM 110,A02,193378,Tat; John,0,10,32,32
1683666432694,BIMM 120,A01,206116,Staff,0,0,32,32
1683666432694,BIMM 120,A02,206117,Staff,6,0,32,26
1683666432694,BIMM 120,A03,206121,Staff,21,0,32,11
1683666433724,BIPN 100,A01,193393,Park; Ji Young,0,15,32,32
1683666433724,BIPN 100,A02,193402,Park; Ji Young,0,14,32,32
1683666433724,BIPN 100,A03,193413,Park; Ji Young,0,14,32,32
1683666433724,BIPN 100,A04,193414,Park; Ji Young,0,13,32,32
1683666434749,BIPN 102,A01,193429,Staff,0,0,32,32
1683666434749,BIPN 102,A02,193438,Staff,18,0,32,14
1683666435777,BIPN 106,A01,193450,Reyes Gonzalez; Catalina,0,2,40,40
1683666436803,BIPN 134,A01,193465,Cooke; James Edward,0,0,32,32
1683666436803,BIPN 134,A02,193474,Cooke; James Edward,25,0,32,7
1683666436803,BIPN 134,A03,193485,Cooke; James Edward,29,0,32,3
1683666436803,BIPN 134,A04,193486,Cooke; James Edward,20,0,32,12
1683666436803,BIPN 134,A05,193491,Cooke; James Edward,31,0,32,1
1683666436803,BIPN 134,A06,193501,Cooke; James Edward,30,0,32,2
1683666436803,BIPN 134,A07,193510,Cooke; James Edward,29,0,32,3
1683666438863,BISP 194,A00,222522,Staff,14,0,32,18
1683666439887,CAT 124,A01,202407,Staff,19,0,25,6
1683666440915,CAT 125,A00,202408,Marchisotto; Jennifer Anne,2,0,20,18
1683666441940,CAT 125R,A00,202409,Smith; Lauryn Alissa,0,11,20,20
1683666441940,CAT 125R,B00,202410,Morales; Celeste Georgianna,0,11,20,20
1683666441940,CAT 125R,C00,202411,Irwin; Matthew Joseph,0,12,20,20
1683666442966,CENG 15,A01,204712,Yang; Kesong,0,1,0,0
1683666443990,CENG 114,A00,202070,Jahed Motlagh; Zeinab,5,0,20,15
1683666445014,CGS 105,A00,185477,Wesling; Megan E.,24,0,40,16
1683666446040,CGS 106,A00,185494,Staff,11,0,22,11
1683666447066,CGS 108,A00,185495,Staff,14,0,20,6
1683666448090,CGS 114,A00,185496,Staff,13,0,18,5
1683666449193,CGS 119,A00,185501,Staff,15,0,20,5
1683666450219,CGS 120,A00,185511,Staff,12,0,20,8
1683666451246,CHEM 4,A01,184675,Bussey; Thomas J,97,0,100,3
1683666452271,CHEM 6A,A01,184677,Staff,32,0,60,28
1683666453294,CHEM 6B,A01,184679,Staff,63,0,100,37
1683666454320,CHEM 6C,A01,184681,Bussey; Thomas J,0,0,50,50
1683666454320,CHEM 6C,A02,184682,Bussey; Thomas J,32,0,50,18
1683666455343,CHEM 40A,A01,184684,Albizati; Kim F.,34,0,100,66
1683666456371,CHEM 40B,A01,184686,Albizati; Kim F.,0,22,100,100
1683666457397,CHEM 41B,A01,184690,Staff,51,0,100,49
1683666458426,COGS 3,A01,184715,Boyle; Mary E. T.,0,27,40,40
1683666459451,COGS 14B,A01,185172,Staff,0,14,38,38
1683666460478,COGS 18,A01,184736,Staff,14,0,80,66
1683666461503,COGS 100,A01,184932,Staff,0,8,73,73
1683666462531,COGS 101A,A01,184935,Staff,0,40,30,30
1683666463557,COGS 101B,A01,184944,Staff,0,2,30,30
1683666464582,COGS 101C,A01,184946,Staff,0,10,30,30
1683666465607,COGS 102A,A01,184951,Johnson; Christine M.,2,0,40,38
1683666466635,COGS 107B,A01,184953,Mooshagian; Eric Frederick,0,51,40,40
1683666467663,COGS 118B,A01,184959,Gupta; Anjum,0,50,40,40
1683666468686,COGS 153,A00,184961,Staff,0,16,30,30
1683666469713,COGS 177,A00,184962,Staff,0,21,30,30
1683666470739,COGS 187A,A01,184969,Boyle; Mary E. T.,0,19,40,40
1683666471762,COMM 10,A01,185174,Staff,0,5,25,25
1683666471762,COMM 10,A02,185189,Staff,0,2,25,25
1683666471762,COMM 10,A03,269821,Staff,0,1,0,0
1683666472790,COMM 100B,A01,185475,Staff,0,1,0,2
1683666472790,COMM 100B,A02,185476,Staff,12,0,25,13
1683666473817,COMM 100C,A01,185314,Staff,1,0,25,24
1683666473817,COMM 100C,A02,185327,Staff,18,0,25,7
1683666474845,COMM 110M,A00,185349,Staff,0,0,40,40
1683666475870,COMM 113T,A00,185352,Staff,25,0,40,15
1683666476894,COMM 114I,A00,185353,Staff,31,0,40,9
1683666477921,COMM 131,A00,185354,Staff,17,0,30,13
1683666478945,CSE 8A,A50,185358,Cao; Yingjun,0,46,10,10
1683666479973,CSE 8B,A01,185362,Staff,0,48,50,50
1683666481001,CSE 11,A01,185416,Cao; Yingjun,0,91,10,10
1683666482028,CSE 20,A01,185445,Briones; Jor-el Thomas Caparas,4,0,25,21
1683666483055,CSE 21,A01,185447,Staff,9,0,50,41
1683666484079,CSE 101,A01,185451,Staff,0,13,50,50
1683666484079,CSE 101,B01,185453,Jones; Miles E,0,14,50,50
1683666486130,CSE 141,A01,185458,Eldon; John,16,0,100,84
1683666487157,CSE 141L,A01,185461,Eldon; John,8,0,100,92
1683666488184,CSE 142,A01,185463,Staff,34,0,60,26
1683666488184,CSE 142,B01,201355,Staff,0,7,60,60
1683666489208,CSE 142L,A01,185470,Staff,34,0,60,26
1683666489208,CSE 142L,B01,201417,Staff,0,6,60,60
1683666490234,CSE 190,A00,201433,Staff,32,0,49,17
1683666491259,DOC 1,A01,259136,Strom; Megan C.,7,0,15,8
1683666491259,DOC 1,A02,259137,Strom; Megan C.,14,0,15,1
1683666491259,DOC 1,A03,259138,Strom; Megan C.,14,0,15,1
1683666491259,DOC 1,A04,259139,Strom; Megan C.,14,0,15,1
1683666492289,DOC 100D,A00,259140,Pass; Natalye Joann,14,0,25,11
1683666493311,DSGN 1,A01,184749,Rill; Bryan,0,26,30,30
1683666494337,DSGN 100,A01,185168,Staff,0,2,25,25
1683666495361,ECE 5,A01,185626,Morris; Karcher William,0,12,0,0
1683666496389,ECE 101,A01,185628,Staff,14,0,70,56
1683666497414,ECE 107,A01,185635,Baghdadchi; Saharnaz,0,0,20,20
1683666497414,ECE 107,A02,185638,Baghdadchi; Saharnaz,1,0,20,19
1683666498440,ECE 148,A01,185647,Silberman; Jack,0,0,16,16
1683666499465,ECON 1,A01,185537,Crane; Meredith Helen,54,0,70,16
1683666500493,ECON 3,A01,185549,Crane; Meredith Helen,29,0,70,41
1683666501521,ECON 4,A01,203354,Anderson; John Charles,0,5,10,10
1683666502546,ECON 100A,A01,185574,Staff,0,5,40,40
1683666503570,ECON 100B,A01,185576,Staff,0,12,50,50
1683666504595,ECON 100C,A01,185589,Newhouse; Herbert S,30,0,70,40
1683666505621,ECON 105,A00,185608,Vespa; Emanuel Ignacio,19,0,35,16
1683666506649,ECON 109,A01,185610,Shishkin; Denis,9,0,35,26
1683666507673,ECON 110A,A01,185612,Staff,9,0,40,31
1683666508700,ECON 120A,A01,185615,Staff,19,0,40,21
1683666509724,ECON 120C,A01,185617,Sun; Yixiao,0,20,70,70
1683666510748,ECON 144,A00,203346,Squires; Dale E,2,0,35,33
1683666511773,ECON 171,A01,203349,Newhouse; Herbert S,0,1,35,35
1683666512796,ECON 173A,A01,185621,Toda; Alexis Akira,20,0,35,15
1683666513821,EDS 25,A01,202413,Staff,0,1,0,0
1683666513821,EDS 25,A02,202414,Staff,0,1,0,0
1683666513821,EDS 25,A03,202415,Staff,0,0,0,0
1683666513821,EDS 25,A04,202416,Staff,0,1,0,0
1683666513821,EDS 25,A05,202439,Staff,0,0,0,0
1683666513821,EDS 25,A06,202440,Staff,0,0,0,0
1683666513821,EDS 25,B01,202631,Staff,0,0,0,0
1683666513821,EDS 25,B02,202632,Staff,0,0,0,0
1683666513821,EDS 25,B03,202639,Staff,0,0,0,0
1683666513821,EDS 25,B04,202640,Staff,0,0,0,0
1683666513821,EDS 25,B05,202643,Staff,0,0,0,0
1683666513821,EDS 25,B06,202644,Staff,0,0,0,0
1683666514849,EDS 38,A01,202659,Black; Alison Michelle,24,0,25,1
1683666515873,EDS 115,A00,202652,Staff,18,0,30,12
1683666516896,EDS 125,A00,202649,Staff,13,0,30,17
1683666517924,EDS 126,A01,203332,Staff,30,0,30,0
1683666518948,EDS 139,A00,202838,Staff,16,0,25,9
1683666519974,EDS 146,A01,202655,Staff,14,0,25,11
1683666520998,ENG 15,A00,185667,Staff,0,1,0,0
1683666520998,ENG 15,B00,185672,Staff,0,0,0,0
1683666520998,ENG 15,C00,185675,Staff,0,0,0,0
1683666520998,ENG 15,D00,185682,Staff,0,0,0,0
1683666520998,ENG 15,E00,185684,Staff,0,0,0,0
1683666522024,ETHN 103,A00,185710,Staff,0,8,35,35
1683666523048,ETHN 103A,A00,199228,Man; Simeon S,0,0,9,9
1683666524075,ETHN 109,A00,185711,Staff,15,0,35,20
1683666525100,ETHN 142,A00,185726,Staff,0,4,30,30
1683666526123,ETHN 163J,A00,199229,Man; Simeon S,5,0,8,3
1683666527149,ETHN 168,A00,185727,Staff,7,0,10,3
1683666528178,ETHN 182,A00,185728,Staff,0,0,35,35
1683666529201,ETHN 183,A00,185737,Staff,9,0,18,9
1683666530226,GLBH 111,A01,209361,Burgos; Jose L.,0,0,0,0
1683666532277,HIEU 104,A00,185792,Staff,14,0,20,6
1683666533303,HIEU 115,A00,185800,Staff,0,0,20,20
1683666534327,HIEU 128,A00,185801,Staff,0,9,20,20
1683666535350,HIEU 147,A00,185802,Staff,15,0,20,5
1683666536373,HIEU 154,A00,185823,Staff,11,0,20,9
1683666537408,HILA 102,A00,185826,Staff,14,0,20,6
1683666538434,HILD 2C,A01,185778,Staff,0,13,20,20
1683666539461,HILD 7B,A01,185780,Kwak; Nancy,0,17,32,32
1683666539461,HILD 7B,A02,185781,Kwak; Nancy,0,18,32,32
1683666540485,HILD 30,A01,185791,Staff,12,0,20,8
1683666541509,HISC 119,A00,185830,Golan; Tal,0,9,20,20
1683666542539,HITO 156GS,A00,185831,Patterson; Patrick H.,0,0,0,23
1683666543565,HIUS 103,A00,185832,Man; Simeon S,0,4,20,20
1683666544589,HIUS 117,A00,185836,Kwak; Nancy,2,0,20,18
1683666545615,HIUS 125,A00,185840,Man; Simeon S,0,2,23,23
1683666546639,HIUS 149,A00,185845,Staff,1,0,20,19
1683666547663,HUM 3,A01,185882,Zavodny; Tatiana Sophia,0,8,50,50
1683666547663,HUM 3,B01,185899,Caldwell; Michael Alan,0,18,50,50
1683666548690,HUM 3GS,A00,185900,Patterson; Patrick H.,0,0,0,23
1683666549716,HUM 4,A01,185938,Zroka; Amy Liane,29,0,50,21
1683666549716,HUM 4,B01,185956,Watkins; Eric,0,5,50,50
1683666549716,HUM 4,B02,202209,Watkins; Eric,0,5,50,50
1683666549716,HUM 4,B03,202210,Watkins; Eric,0,5,50,50
1683666550740,HUM 5,A01,185958,West; Geoffrey Scott,0,0,50,50
1683666550740,HUM 5,A02,202215,West; Geoffrey Scott,0,0,50,50
1683666551766,INTL 190,A00,185959,Gagnon; Jeffrey C,0,0,0,9
1683666551766,INTL 190,B00,185960,Lettieri; Michael Joseph,0,0,0,2
1683666552861,JAPN 180,A00,254509,Staff,5,0,30,25
1683666553891,LATI 10,A01,202853,Kennemore; Amy Michelle,4,0,35,31
1683666553891,LATI 10,A02,202854,Kennemore; Amy Michelle,2,0,35,33
1683666553891,LATI 10,A03,270054,Kennemore; Amy Michelle,30,0,30,0
1683666554917,LATI 180,A00,202855,Kennemore; Amy Michelle,11,0,20,9
1683666555941,LAWS 101,A00,201767,Golan; Tal,0,7,40,40
1683666556965,LIFR 1C,A00,185961,Staff,6,0,20,14
1683666557991,LIFR 1CX,A00,185962,Staff,7,0,20,13
1683666559017,LIFR 1D,A00,185963,Staff,7,0,20,13
1683666560041,LIFR 1DX,A00,185964,Staff,7,0,20,13
1683666561068,LIGN 101,A01,186039,Staff,43,0,50,7
1683666562098,LIGN 165,A00,186040,Staff,15,0,50,35
1683666563123,LTCS 108,A00,186041,Staff,5,0,10,5
1683666564147,LTCS 119,A00,186042,Staff,15,0,20,5
1683666565173,LTCS 130,A00,186043,Wesling; Megan E.,15,0,25,10
1683666567226,LTEA 138,A00,186119,Staff,14,0,40,26
1683666568247,LTEN 124,A00,186148,Staff,5,0,25,20
1683666569271,LTEN 178,A00,186149,Staff,7,0,15,8
1683666570302,LTEN 181,A00,186150,Blanco; John D,34,0,40,6
1683666571329,LTWL 120,A00,186160,Staff,20,0,25,5
1683666572355,LTWL 165,A00,186161,Staff,22,0,25,3
1683666573381,LTWR 100,A00,186162,Staff,0,5,15,15
1683666574404,LTWR 102,A00,186163,Doller; Ben,5,0,15,10
1683666575435,MAE 8,A01,186412,Staff,0,0,0,0
1683666576457,MAE 30B,A00,186445,Bahadori; Mohammad Yousef,82,0,100,18
1683666577480,MAE 40,A00,186592,Bewley; Thomas R,10,0,50,40
1683666578507,MAE 101B,A00,186593,Bahadori; Mohammad Yousef,80,0,100,20
1683666579533,MAE 105,A00,186594,Bandaru; Prabhakar,10,0,50,40
1683666580556,MAE 107,A00,186599,Pham; Hieu Tan,0,7,120,120
1683666581583,MAE 148,A01,186660,Silberman; Jack,3,0,16,13
1683666582610,MATH 10A,A01,188095,Staff,0,6,35,35
1683666583636,MATH 10B,A01,188097,Bowers; Adam R.,0,12,30,30
1683666583636,MATH 10B,A02,188099,Bowers; Adam R.,0,11,30,30
1683666583636,MATH 10B,B01,188104,Bowers; Adam R.,0,10,30,30
1683666583636,MATH 10B,B02,188106,Bowers; Adam R.,1,9,30,29
1683666584660,MATH 10C,A01,188111,Staff,0,18,30,30
1683666584660,MATH 10C,A02,188127,Staff,0,19,30,30
1683666584660,MATH 10C,A03,188131,Staff,0,19,30,30
1683666584660,MATH 10C,B01,188218,Staff,17,0,30,13
1683666584660,MATH 10C,B02,188244,Staff,13,0,30,17
1683666584660,MATH 10C,B03,188277,Staff,14,0,30,16
1683666585690,MATH 18,A01,188344,Bach; Quang Tran,18,0,30,12
1683666585690,MATH 18,A02,188345,Bach; Quang Tran,11,0,30,19
1683666585690,MATH 18,B01,188353,Bach; Quang Tran,11,0,30,19
1683666585690,MATH 18,B02,188354,Bach; Quang Tran,19,0,30,11
1683666586717,MATH 20A,A01,188374,Staff,11,0,35,24
1683666587742,MATH 20B,A01,188382,Ohm; Ko Woon,7,0,30,23
1683666587742,MATH 20B,A02,188383,Ohm; Ko Woon,22,0,30,8
1683666587742,MATH 20B,B01,188385,Ohm; Ko Woon,7,0,30,23
1683666587742,MATH 20B,B02,188392,Ohm; Ko Woon,22,0,30,8
1683666588767,MATH 20C,A01,188394,Harel; Guershon,10,0,30,20
1683666588767,MATH 20C,A02,188395,Harel; Guershon,13,0,30,17
1683666588767,MATH 20C,B01,188404,Harel; Guershon,5,0,30,25
1683666588767,MATH 20C,B02,188405,Harel; Guershon,18,0,30,12
1683666589798,MATH 20D,A01,188414,Hammock; Frances H,0,1,30,30
1683666589798,MATH 20D,A02,188415,Hammock; Frances H,0,1,30,30
1683666589798,MATH 20D,B01,188447,Hammock; Frances H,0,1,30,30
1683666589798,MATH 20D,B02,188486,Hammock; Frances H,3,0,30,27
1683666590823,MATH 20E,A01,188649,Staff,21,0,30,9
1683666590823,MATH 20E,A02,188650,Staff,21,0,30,9
1683666590823,MATH 20E,A03,188673,Staff,0,0,30,30
1683666591847,MATH 102,A01,188675,Staff,0,36,35,35
1683666592875,MATH 103B,A01,188681,Staff,3,0,35,32
1683666592875,MATH 103B,B01,188692,Staff,5,0,35,30
1683666593898,MATH 109,A01,188695,Salehi Golsefidy; Alireza,24,0,35,11
1683666593898,MATH 109,A02,188696,Salehi Golsefidy; Alireza,25,0,35,10
1683666594926,MATH 120A,A01,188698,Eggers; John Dietrich,7,0,35,28
1683666595952,MATH 142B,A01,188736,Ioana; Adrian,1,1,30,29
1683666595952,MATH 142B,A02,188741,Ioana; Adrian,0,1,30,30
1683666595952,MATH 142B,A03,188743,Ioana; Adrian,0,1,30,30
1683666596979,MATH 168A,A01,188790,Staff,0,10,35,35
1683666598004,MATH 170A,A01,188803,Nie; Jiawang,0,2,35,35
1683666598004,MATH 170A,A02,188811,Nie; Jiawang,0,0,35,35
1683666598004,MATH 170A,A03,188814,Nie; Jiawang,0,0,35,35
1683666598004,MATH 170A,A04,188815,Nie; Jiawang,8,0,35,27
1683666599029,MATH 193B,A01,188817,Staff,0,0,35,35
1683666599029,MATH 193B,A02,188818,Staff,6,0,35,29
1683666600052,MGT 4,A01,202857,Anderson; John Charles,61,0,80,19
1683666601077,MGT 12,A00,202858,Lindenberger; Wade Douglas,40,0,90,50
1683666602104,MGT 18,A00,202859,Staff,74,0,90,16
1683666603130,MGT 18GS,A00,202860,McKay; Michael J,13,0,28,15
1683666604154,MGT 45,A00,202861,Pecore; Joseph P.,11,0,90,79
1683666605181,MGT 100,A00,202863,Yavorsky; Daniel Ryan,28,0,90,62
1683666606204,MGT 103,A00,202864,Ehrich; Kristine R,0,18,90,90
1683666607227,MGT 112,A00,202865,Ehrich; Kristine R,14,0,90,76
1683666608256,MGT 121A,A00,202868,Staff,90,20,90,0
1683666609281,MGT 131B,A00,202869,Anderson; John Charles,59,0,90,31
1683666610305,MGT 136,A00,202871,Lindenberger; Wade Douglas,83,0,90,7
1683666611329,MGT 164,A00,202873,Staff,0,67,90,91
1683666612355,MGT 164GS,A00,202874,McKay; Mary A,13,0,28,15
1683666613379,MGT 180,A00,202875,Staff,0,51,90,91
1683666614406,MMW 11R,A01,205019,Herbst; Matthew,1,0,30,29
1683666614406,MMW 11R,A02,205026,Herbst; Matthew,29,0,30,1
1683666615439,MMW 15,A01,193512,Chang; Edmond Yi-Teh,0,8,28,28
1683666615439,MMW 15,A02,193513,Chang; Edmond Yi-Teh,0,5,28,28
1683666615439,MMW 15,A03,193514,Chang; Edmond Yi-Teh,0,5,28,28
1683666615439,MMW 15,A04,193515,Chang; Edmond Yi-Teh,0,5,28,28
1683666615439,MMW 15,A05,193516,Chang; Edmond Yi-Teh,0,5,28,28
1683666615439,MMW 15,A06,193517,Chang; Edmond Yi-Teh,0,6,28,28
1683666615439,MMW 15,B01,193519,Chang; Edmond Yi-Teh,0,5,28,28
1683666615439,MMW 15,B02,193520,Chang; Edmond Yi-Teh,0,5,28,28
1683666615439,MMW 15,B03,193521,Chang; Edmond Yi-Teh,0,5,28,28
1683666615439,MMW 15,B04,193522,Chang; Edmond Yi-Teh,0,5,28,28
1683666615439,MMW 15,B05,193523,Chang; Edmond Yi-Teh,0,5,28,28
1683666615439,MMW 15,B06,193524,Chang; Edmond Yi-Teh,0,5,28,28
1683666616470,MMW 122,A01,193526,Rahimi; Babak,0,16,28,28
1683666616470,MMW 122,A02,193527,Rahimi; Babak,0,15,28,28
1683666616470,MMW 122,A03,193528,Rahimi; Babak,0,0,0,0
1683666616470,MMW 122,A04,193529,Rahimi; Babak,0,0,0,0
1683666617494,MUS 1A,A01,186663,Staff,1,20,35,34
1683666618518,MUS 4,A01,186715,Staff,0,12,35,35
1683666619545,MUS 5R,A01,186796,Dubnov; Shlomo,0,17,35,35
1683666620572,MUS 6,A01,186798,Staff,0,5,25,25
1683666621599,MUS 7,A01,186830,Staff,11,0,35,24
1683666622626,MUS 8,A01,186930,Staff,0,26,35,35
1683666623652,MUS 15,A01,186932,Staff,0,16,35,35
1683666623652,MUS 15,B01,186934,Staff,1,17,35,34
1683666624677,MUS 80,A00,186935,Staff,0,0,20,20
1683666624677,MUS 80,B00,186936,Staff,24,0,25,1
1683666625702,NANO 11,A00,204702,Lipomi; Darren John,0,0,0,0
1683666626728,NANO 15,A01,204709,Yang; Kesong,0,1,0,0
1683666627752,NANO 114,A00,202069,Jahed Motlagh; Zeinab,3,0,10,7
1683666628780,PHIL 1,A00,186955,Grush; Rick Scott,31,0,40,9
1683666629816,PHIL 10,A01,186973,Grush; Rick Scott,27,0,35,8
1683666629816,PHIL 10,A02,186974,Grush; Rick Scott,33,0,35,2
1683666630839,PHIL 13,A01,186976,Staff,3,0,35,32
1683666630839,PHIL 13,A02,186977,Staff,16,0,35,19
1683666631865,PHIL 14,A01,186979,Staff,31,0,35,4
1683666631865,PHIL 14,A02,186986,Staff,32,0,35,3
1683666632890,PHIL 28,A01,186988,Staff,16,0,30,14
1683666632890,PHIL 28,A02,186989,Staff,1,0,30,29
1683666632890,PHIL 28,A03,186990,Staff,10,0,30,20
1683666632890,PHIL 28,A04,186991,Staff,26,0,30,4
1683666633917,PHIL 120,A00,186997,Staff,23,0,40,17
1683666634943,PHIL 137,A00,187003,Staff,7,0,40,33
1683666635970,PHIL 150,A00,187015,Staff,47,0,70,23
1683666636997,PHIL 167,A00,187021,Lamey; Andy M.,34,0,40,6
1683666638023,PHIL 174,A01,202226,Staff,17,0,20,3
1683666638023,PHIL 174,A02,202235,Staff,20,0,20,0
1683666639051,PHIL 191A,A00,258918,Staff,0,0,1,1
1683666640076,PHYS 1A,A00,187028,Staff,26,0,60,34
1683666641100,PHYS 1AL,001,187036,Staff,3,0,30,27
1683666641100,PHYS 1AL,002,187049,Staff,18,0,30,12
1683666642124,PHYS 1B,A00,187058,Staff,22,0,60,38
1683666643148,PHYS 1BL,001,187064,Staff,0,1,30,30
1683666643148,PHYS 1BL,002,187070,Staff,4,0,30,26
1683666644176,PHYS 1C,A00,187082,Staff,29,0,120,91
1683666645200,PHYS 1CL,001,187088,Staff,0,9,30,30
1683666645200,PHYS 1CL,002,187089,Staff,0,1,30,30
1683666645200,PHYS 1CL,009,262693,Staff,9,0,30,21
1683666646227,PHYS 2B,A01,187097,Staff,55,0,115,60
1683666647254,PHYS 2C,A01,187099,Staff,63,0,115,52
1683666648279,PHYS 2CL,A01,187101,Staff,5,0,28,23
1683666648279,PHYS 2CL,A02,187102,Staff,15,0,28,13
1683666649304,PHYS 2D,A01,187123,Shotwell; Brian,95,0,115,20
1683666650331,PHYS 4B,A01,187133,Grinstein; Benjamin,35,0,50,15
1683666651355,POLI 10,A00,188819,Staff,0,4,50,50
1683666652377,POLI 11,A00,188827,Staff,43,0,50,7
1683666653404,POLI 13R,A00,188828,Staff,0,1,20,20
1683666654429,POLI 27,A01,188830,Elgin; Samuel Zincke,0,2,70,70
1683666655457,POLI 30,A00,188832,Desposato; Scott,30,0,50,20
1683666656537,POLI 102F,A00,188834,Staff,0,0,40,40
1683666657561,POLI 104A,A00,188852,Staff,13,0,30,17
1683666658587,POLI 104I,A00,188853,Staff,0,7,20,20
1683666659619,POLI 110B,A00,188854,Wiens; David,6,0,20,14
1683666660642,POLI 112A,A00,188855,Wiens; David,3,0,30,27
1683666661670,POLI 117R,A00,188856,Forman; Fonna,0,12,20,20
1683666662693,POLI 118,A00,188857,Ingham; Sean,8,0,20,12
1683666663717,POLI 120G,A00,188858,Staff,8,0,30,22
1683666664740,POLI 131CR,A00,188863,Hoston; Germaine,21,0,50,29
1683666665769,POLI 133,A00,188864,Nellis; Gareth Hb,44,0,50,6
1683666666795,POLI 134D,A00,188865,Desposato; Scott,27,0,30,3
1683666667828,POLI 142A,A00,188871,Gartzke; Erik,21,0,50,29
1683666668851,POLI 142K,A00,188874,Staff,38,0,50,12
1683666669881,POLI 143,A00,188940,Gartzke; Erik,16,0,30,14
1683666670908,POLI 153,A00,188943,Staff,2,0,20,18
1683666671934,POLI 160AA,A00,188944,Staff,11,0,40,29
1683666672958,POLI 170A,A00,188945,Staff,11,0,30,19
1683666675008,PSYC 1,A00,188952,Staff,36,0,90,54
1683666676032,PSYC 2,B00,188953,Staff,19,0,35,16
1683666677057,PSYC 6,A00,188970,Staff,47,0,60,13
1683666678084,PSYC 7,A00,188973,Staff,35,0,45,10
1683666679110,PSYC 60,A01,188980,Rickard; Timothy C.,42,0,60,18
1683666680137,PSYC 70,A01,189001,Steiner; Eric Tomas,22,0,45,23
1683666681162,PSYC 100,A00,189005,Lacefield; Katharine I,0,99,120,120
1683666682186,PSYC 102,A00,189008,Staff,8,0,30,22
1683666683214,PSYC 106,B00,189026,Gorman; Michael R.,27,0,60,33
1683666684238,PSYC 114,B01,189033,Winkielman; Piotr,0,31,30,30
1683666685261,PSYC 131,A00,189036,Anagnostaras; Stephan,0,43,60,60
1683666686285,PSYC 136,A00,189041,Lowe; Angela Beth,0,7,25,25
1683666687316,PSYC 137,A00,189057,Winkielman; Piotr,0,37,25,25
1683666688339,PSYC 144,A00,189107,Wixted; John T,0,11,50,50
1683666690386,PSYC 162,A00,189142,Staff,0,9,85,85
1683666691410,PSYC 172,A00,189144,Gorman; Michael R.,0,6,30,30
1683666693466,PSYC 179,A00,189146,Lacefield; Katharine I,0,87,120,120
1683666694492,PSYC 181,A00,189147,Anagnostaras; Stephan,0,44,90,90
1683666695518,PSYC 190R,A00,189148,Barner; David A.,0,23,80,80
1683666696544,PSYC 191,A00,189275,Rickard; Timothy C.,0,10,25,25
1683666697572,PSYC 193,A00,189276,Chapman; Eddie Nathaniel,0,1,0,4
1683666698595,PSYC 193L,A01,189281,Lowe; Angela Beth,10,0,20,10
1683666698595,PSYC 193L,B01,189285,Staff,28,0,35,7
1683666699623,RELI 149,A00,187137,Rahimi; Babak,7,0,40,33
1683666700647,SE 9,A01,187315,Staff,0,2,18,18
1683666701670,SE 101B,A00,187409,Staff,24,0,30,6
1683666702695,SE 110B,A00,187444,Staff,10,0,40,30
1683666703719,SE 130B,A00,187449,Staff,31,0,40,9
1683666704744,SE 150A,A00,187516,Staff,8,0,20,12
1683666705771,SE 154,A00,187528,Staff,29,0,50,21
1683666706795,SIO 3,A01,258171,Staff,35,0,40,5
1683666707819,SIO 10,A00,187144,Cook; Geoffrey W,0,7,75,75
1683666708843,SIO 45,A00,187152,Cook; Geoffrey W,0,5,100,100
1683666709868,SIO 109R,A00,194486,Staff,0,4,20,20
1683666711923,SIO 187,A01,187233,Kacev; David,12,0,40,28
1683666712952,SOCI 1,A01,258656,Thorpe; Charles Robert,28,0,30,2
1683666712952,SOCI 1,A02,258658,Thorpe; Charles Robert,30,0,30,0
1683666712952,SOCI 1,A03,258661,Thorpe; Charles Robert,25,0,25,0
1683666712952,SOCI 1,A04,258666,Thorpe; Charles Robert,22,0,25,3
1683666712952,SOCI 1,A05,258897,Thorpe; Charles Robert,22,0,25,3
1683666712952,SOCI 1,A06,258898,Thorpe; Charles Robert,25,0,25,0
1683666713980,SOCI 30,A01,258903,Pardo Guerra; Juan Pablo,14,0,30,16
1683666715005,SOCI 102,A00,258904,Staff,9,0,25,16
1683666716034,SOCI 106,A00,258905,Staff,19,0,25,6
1683666717058,SOCI 111,A00,258907,Ribas Norris; Janet Vanesa,26,0,30,4
1683666718085,SOCI 121R,A00,258908,Pardo Guerra; Juan Pablo,8,0,30,22
1683666719111,SOCI 126,A01,203330,Staff,14,0,20,6
1683666720134,SOCI 131,A00,258909,Thorpe; Charles Robert,30,0,60,30
1683666721157,SOCI 135,A00,258910,Payne; Christine Anna,0,11,30,30
1683666722181,SOCI 157,A00,258911,Staff,12,0,30,18
1683666723286,SOCI 184,A00,258912,Staff,25,0,30,5
1683666724309,SOCI 188D,A00,258913,Staff,22,0,30,8
1683666725348,SYN 2,001,187529,Staff,9,0,16,7
1683666725348,SYN 2,002,201452,Staff,0,20,16,16
1683666725348,SYN 2,003,201469,Staff,1,0,16,15
1683666726372,SYN 100,A01,187531,Staff,0,9,20,20
1683666726372,SYN 100,B01,201491,Staff,0,10,20,20
1683666727396,TDAC 1,A00,189286,Walsh; Kim C.,3,0,20,17
1683666727396,TDAC 1,B00,189287,Harting; Carla Kelso,10,0,20,10
1683666728424,TDAC 101,A00,189300,Walsh; Kim C.,16,0,20,4
1683666728424,TDAC 101,B00,189301,Harting; Carla Kelso,18,0,20,2
1683666729451,TDAC 102,A00,189304,Basso; Beatrice,14,0,20,6
1683666730477,TDAC 108,A00,189305,Staff,18,0,20,2
1683666731506,TDDE 131,A00,189310,Staff,19,0,20,1
1683666731506,TDDE 131,B00,189314,Staff,19,0,20,1
1683666731506,TDDE 131,C00,189315,Staff,48,0,50,2
1683666731506,TDDE 131,D00,189316,Staff,14,0,15,1
1683666731506,TDDE 131,E00,204841,Staff,20,0,20,0
1683666732529,TDGE 10,A00,189289,Staff,27,0,50,23
1683666732529,TDGE 10,B00,189290,Havis; Allan,0,1,50,50
1683666733558,TDGE 11,A00,189291,Fulton; Julia,0,4,50,50
1683666733558,TDGE 11,B00,189292,Staff,20,0,25,5
1683666733558,TDGE 11,C00,260270,Staff,0,0,0,0
1683666734584,TDGE 25,A00,189294,Staff,2,0,20,18
1683666735611,TDGE 124,A00,189318,Fulton; Julia,0,8,50,50
1683666736634,TDGE 125,A00,189319,Staff,13,0,25,12
1683666736634,TDGE 125,B00,189320,Staff,23,0,25,2
1683666737658,TDGE 127,A00,189322,Havis; Allan,1,0,50,49
1683666738685,TDHT 101,A00,189323,Staff,18,0,25,7
1683666738685,TDHT 101,B00,189324,Staff,25,0,25,0
1683666739709,TDHT 102,A00,189325,Staff,49,0,50,1
1683666740733,TDMV 1,A00,189295,Arcidiacono; Kristin,20,0,30,10
1683666740733,TDMV 1,B00,189296,Caligagan; Maria T.,24,0,30,6
1683666741757,TDMV 2,A00,189297,Sammartano; Tonnie,27,0,30,3
1683666741757,TDMV 2,B00,189299,Arcidiacono; Kristin,23,0,30,7
1683666742781,TDMV 3,A00,204998,Rincon; Alicia,22,0,30,8
1683666743809,TDMV 120,A00,189458,Sammartano; Tonnie,28,0,30,2
1683666744832,TDMV 138,A00,189541,Jun; Grace Shin Hae,20,0,40,20
1683666745856,TDMV 142,A00,189717,Caligagan; Tony,25,0,30,5
1683666745856,TDMV 142,B00,189718,Caligagan; Maria T.,25,0,30,5
1683666746882,TMC 2,A01,187533,Staff,25,0,25,0
1683666746882,TMC 2,A02,187534,Staff,25,0,25,0
1683666747909,USP 1,A01,187536,Kwak; Nancy,0,16,25,25
1683666748942,USP 5,A01,187538,Staff,9,0,25,16
1683666749966,USP 101,A00,199253,Staff,0,4,0,0
1683666750993,USP 124,A00,187562,Boomhower; Matthew Charles,0,0,30,30
1683666752018,USP 138,A00,187582,Staff,20,0,25,5
1683666753042,USP 152,A01,187597,Staff,3,0,25,22
1683666754065,USP 153,A00,187598,Staff,19,0,25,6
1683666755092,USP 168,A00,187607,Kwak; Nancy,2,0,5,3
1683666756117,USP 173,A00,187619,Staff,4,0,25,21
1683666757145,USP 181,A00,187638,Staff,0,4,25,25
1683666758168,VIS 103,A00,187650,Cruz; Edwin Teddy,17,0,75,58
1683666759195,VIS 110D,A00,187669,Staff,13,0,22,9
1683666760274,VIS 127C,A00,187720,Shen; Kuiyi,68,0,146,78
1683666761303,VIS 149,A00,187731,Yoldas; Pinar,1,14,22,21
1683666762330,VIS 151,A01,188091,Staff,22,0,34,12
1683666762330,VIS 151,A02,188092,Staff,11,0,34,23
1683666763357,VIS 160B,A00,188093,Stalbaum; Brett,0,1,10,10
1683666765407,WCWP 10B,A00,201720,Staff,10,0,15,5
1683666765407,WCWP 10B,B00,201722,Staff,9,0,15,6
1683666766431,WCWP 100,A00,201725,Gagnon; Jeffrey C,0,0,2,2
1683666766431,WCWP 100,B00,201727,Staff,0,4,15,15
1683666769521,ANBI 133,A00,258401,Wilder; Linnea Lorene,34,0,40,6
1683666770545,ANBI 140,A00,258395,Hrvoj Mihic; Branka,18,0,25,7
1683666771573,ANSC 120,A00,258402,Bialecki; Jon Anthony,26,0,40,14
1683666772599,ANSC 144,A00,258400,Staff,12,0,40,28
1683666774649,ANSC 166,A00,258396,Parish; Steven Martin,156,0,175,19
1683666775674,ANSC 180,A00,193533,Staff,8,0,20,12
1683666776696,ANSC 188,A00,258397,Jassal; Aftab,34,0,40,6
1683666777723,ANTH 3,A01,258316,Staff,23,0,30,7
1683666778747,ANTH 5,A00,258394,Semendeferi; Ekaterini,16,0,20,4
1683666779774,ANTH 21,A01,258331,Staff,4,0,40,36
1683666780797,ANTH 103,A00,258398,Varma; Saiba,15,0,25,10
1683666781829,AWP 10,001,202034,Staff,0,0,0,0
1683666781829,AWP 10,002,202035,Staff,0,0,0,0
1683666781829,AWP 10,003,202036,Staff,0,0,0,0
1683666781829,AWP 10,004,202037,Staff,0,0,0,0
1683666781829,AWP 10,005,202038,Staff,0,0,0,0
1683666781829,AWP 10,006,202039,Staff,0,0,0,0
1683666781829,AWP 10,007,202040,Staff,0,0,0,0
1683666781829,AWP 10,008,202041,Staff,0,0,0,0
1683666781829,AWP 10,009,202042,Staff,0,0,0,0
1683666781829,AWP 10,010,202043,Staff,0,0,0,0
1683666781829,AWP 10,011,202044,Staff,0,0,0,0
1683666781829,AWP 10,012,202045,Staff,0,0,0,0
1683666781829,AWP 10,013,202046,Staff,0,0,0,0
1683666781829,AWP 10,014,202047,Staff,0,0,0,0
1683666781829,AWP 10,015,202048,Staff,0,0,0,0
1683666781829,AWP 10,016,202049,Staff,0,0,0,0
1683666781829,AWP 10,017,202050,Staff,0,0,0,0
1683666781829,AWP 10,018,202051,Staff,0,0,0,0
1683666781829,AWP 10,019,202052,Staff,0,0,0,0
1683666781829,AWP 10,020,202053,Staff,0,0,0,0
1683666781829,AWP 10,021,202054,Staff,0,0,0,0
1683666781829,AWP 10,022,202055,Staff,0,0,0,0
1683666781829,AWP 10,023,202056,Staff,0,0,0,0
1683666781829,AWP 10,024,202057,Staff,0,0,0,0
1683666781829,AWP 10,025,202058,Staff,0,0,0,0
1683666781829,AWP 10,026,202059,Staff,0,0,0,0
1683666782854,AWP 102,001,202032,Staff,0,0,0,0
1683666782854,AWP 102,002,202033,Staff,0,0,0,0
1683666783877,BENG 100,A01,254234,Taylor Amos; Alyssa C,31,0,40,9
1683666784901,BENG 196,001,270013,Engler; Adam J.,9999,0,9999,0
1683666785930,BICD 100R,A01,202018,Smith; Laurie,0,7,32,32
1683666785930,BICD 100R,A02,202019,Smith; Laurie,0,3,32,32
1683666785930,BICD 100R,A03,202020,Smith; Laurie,0,1,32,32
1683666785930,BICD 100R,A04,202021,Smith; Laurie,6,0,32,26
1683666785930,BICD 100R,A05,202022,Smith; Laurie,11,0,32,21
1683666786954,BICD 136,A01,193242,Gustafson-Brown; Cindy,0,2,32,32
1683666786954,BICD 136,A02,193244,Gustafson-Brown; Cindy,13,0,32,19
1683666787986,BIEB 102,A01,193249,Butler; Shannon Rhey,1,2,32,31
1683666787986,BIEB 102,A02,193251,Butler; Shannon Rhey,0,0,32,32
1683666787986,BIEB 102,A03,193253,Butler; Shannon Rhey,0,0,32,32
1683666787986,BIEB 102,A04,193255,Butler; Shannon Rhey,14,0,32,18
1683666787986,BIEB 102,A05,193265,Butler; Shannon Rhey,25,0,32,7
1683666787986,BIEB 102,A06,193269,Butler; Shannon Rhey,14,0,32,18
1683666790038,BIEB 150,A01,193274,Staff,0,0,32,32
1683666790038,BIEB 150,A02,193285,Staff,24,0,32,8
1683666791065,BIEB 194,A00,193286,Kurle; Carolyn M.,20,0,32,12
1683666792089,BILD 1,A01,192291,Staff,15,0,32,17
1683666792089,BILD 1,A02,192292,Staff,30,0,32,2
1683666792089,BILD 1,B01,192520,Reuther; Keefe,0,1,0,0
1683666792089,BILD 1,B02,192532,Reuther; Keefe,0,1,0,0
1683666793119,BILD 3,A01,192556,Butler; Shannon Rhey,0,0,32,32
1683666793119,BILD 3,A02,192581,Butler; Shannon Rhey,0,0,32,32
1683666793119,BILD 3,A03,192611,Butler; Shannon Rhey,20,0,32,12
1683666793119,BILD 3,A04,192612,Butler; Shannon Rhey,24,0,32,8
1683666793119,BILD 3,A05,192613,Butler; Shannon Rhey,26,0,32,6
1683666793119,BILD 3,A06,192679,Butler; Shannon Rhey,27,0,32,5
1683666793119,BILD 3,A07,192682,Butler; Shannon Rhey,20,0,32,12
1683666794145,BILD 4,A01,192836,Reuther; Keefe,1,0,24,23
1683666794145,BILD 4,A02,193044,Reuther; Keefe,4,0,24,20
1683666795173,BILD 10,A01,193142,Gustafson-Brown; Cindy,29,0,32,3
1683666795173,BILD 10,A02,193149,Gustafson-Brown; Cindy,31,0,32,1
1683666796198,BIMM 100,A01,193301,Staff,0,6,32,32
1683666796198,BIMM 100,A02,193312,Staff,0,7,32,32
1683666796198,BIMM 100,A03,193323,Staff,0,9,32,32
1683666797223,BIMM 101,A01,193329,McDonnell; Lisa Marie,0,4,24,24
1683666797223,BIMM 101,A02,193339,McDonnell; Lisa Marie,1,4,24,23
1683666797223,BIMM 101,B01,193354,McDonnell; Lisa Marie,0,4,24,24
1683666797223,BIMM 101,B02,193357,McDonnell; Lisa Marie,0,3,24,24
1683666798250,BIMM 110,A01,193377,Tat; John,0,11,32,32
1683666798250,BIMM 110,A02,193378,Tat; John,0,10,32,32
1683666799273,BIMM 120,A01,206116,Staff,0,0,32,32
1683666799273,BIMM 120,A02,206117,Staff,6,0,32,26
1683666799273,BIMM 120,A03,206121,Staff,21,0,32,11
1683666800303,BIPN 100,A01,193393,Park; Ji Young,0,15,32,32
1683666800303,BIPN 100,A02,193402,Park; Ji Young,0,14,32,32
1683666800303,BIPN 100,A03,193413,Park; Ji Young,0,14,32,32
1683666800303,BIPN 100,A04,193414,Park; Ji Young,0,13,32,32
1683666801327,BIPN 102,A01,193429,Staff,0,0,32,32
1683666801327,BIPN 102,A02,193438,Staff,18,0,32,14
1683666802356,BIPN 106,A01,193450,Reyes Gonzalez; Catalina,0,2,40,40
1683666803385,BIPN 134,A01,193465,Cooke; James Edward,0,0,32,32
1683666803385,BIPN 134,A02,193474,Cooke; James Edward,25,0,32,7
1683666803385,BIPN 134,A03,193485,Cooke; James Edward,29,0,32,3
1683666803385,BIPN 134,A04,193486,Cooke; James Edward,20,0,32,12
1683666803385,BIPN 134,A05,193491,Cooke; James Edward,31,0,32,1
1683666803385,BIPN 134,A06,193501,Cooke; James Edward,30,0,32,2
1683666803385,BIPN 134,A07,193510,Cooke; James Edward,29,0,32,3
1683666805437,BISP 194,A00,222522,Staff,14,0,32,18
1683666806462,CAT 124,A01,202407,Staff,19,0,25,6
1683666807486,CAT 125,A00,202408,Marchisotto; Jennifer Anne,2,0,20,18
1683666808515,CAT 125R,A00,202409,Smith; Lauryn Alissa,0,11,20,20
1683666808515,CAT 125R,B00,202410,Morales; Celeste Georgianna,0,11,20,20
1683666808515,CAT 125R,C00,202411,Irwin; Matthew Joseph,0,12,20,20
1683666809542,CENG 15,A01,204712,Yang; Kesong,0,1,0,0
1683666810568,CENG 114,A00,202070,Jahed Motlagh; Zeinab,5,0,20,15
1683666811595,CGS 105,A00,185477,Wesling; Megan E.,24,0,40,16
1683666812618,CGS 106,A00,185494,Staff,11,0,22,11
1683666813640,CGS 108,A00,185495,Staff,14,0,20,6
1683666814664,CGS 114,A00,185496,Staff,13,0,18,5
1683666815691,CGS 119,A00,185501,Staff,15,0,20,5
1683666816715,CGS 120,A00,185511,Staff,12,0,20,8
1683666817745,CHEM 4,A01,184675,Bussey; Thomas J,97,0,100,3
1683666818769,CHEM 6A,A01,184677,Staff,32,0,60,28
1683666819799,CHEM 6B,A01,184679,Staff,63,0,100,37
1683666820828,CHEM 6C,A01,184681,Bussey; Thomas J,0,0,50,50
1683666820828,CHEM 6C,A02,184682,Bussey; Thomas J,32,0,50,18
1683666821852,CHEM 40A,A01,184684,Albizati; Kim F.,34,0,100,66
1683666822879,CHEM 40B,A01,184686,Albizati; Kim F.,0,22,100,100
1683666823903,CHEM 41B,A01,184690,Staff,51,0,100,49
1683666824930,COGS 3,A01,184715,Boyle; Mary E. T.,0,27,40,40
1683666825954,COGS 14B,A01,185172,Staff,0,14,38,38
1683666826978,COGS 18,A01,184736,Staff,14,0,80,66
1683666828001,COGS 100,A01,184932,Staff,0,8,73,73
1683666829024,COGS 101A,A01,184935,Staff,0,40,30,30
1683666830054,COGS 101B,A01,184944,Staff,0,2,30,30
1683666831079,COGS 101C,A01,184946,Staff,0,10,30,30
1683666832101,COGS 102A,A01,184951,Johnson; Christine M.,2,0,40,38
1683666833124,COGS 107B,A01,184953,Mooshagian; Eric Frederick,0,51,40,40
1683666834154,COGS 118B,A01,184959,Gupta; Anjum,0,50,40,40
1683666835178,COGS 153,A00,184961,Staff,0,16,30,30
1683666836202,COGS 177,A00,184962,Staff,0,21,30,30
1683666837231,COGS 187A,A01,184969,Boyle; Mary E. T.,0,19,40,40
1683666838254,COMM 10,A01,185174,Staff,0,5,25,25
1683666838254,COMM 10,A02,185189,Staff,0,2,25,25
1683666838254,COMM 10,A03,269821,Staff,0,1,0,0
1683666839277,COMM 100B,A01,185475,Staff,0,1,0,2
1683666839277,COMM 100B,A02,185476,Staff,12,0,25,13
1683666840303,COMM 100C,A01,185314,Staff,1,0,25,24
1683666840303,COMM 100C,A02,185327,Staff,18,0,25,7
1683666841330,COMM 110M,A00,185349,Staff,0,0,40,40
1683666842353,COMM 113T,A00,185352,Staff,25,0,40,15
1683666843378,COMM 114I,A00,185353,Staff,31,0,40,9
1683666844403,COMM 131,A00,185354,Staff,17,0,30,13
1683666845427,CSE 8A,A50,185358,Cao; Yingjun,0,46,10,10
1683666846451,CSE 8B,A01,185362,Staff,0,48,50,50
1683666847476,CSE 11,A01,185416,Cao; Yingjun,0,91,10,10
1683666848501,CSE 20,A01,185445,Briones; Jor-el Thomas Caparas,4,0,25,21
1683666849529,CSE 21,A01,185447,Staff,9,0,50,41
1683666850552,CSE 101,A01,185451,Staff,0,13,50,50
1683666850552,CSE 101,B01,185453,Jones; Miles E,0,14,50,50
1683666852604,CSE 141,A01,185458,Eldon; John,16,0,100,84
1683666853630,CSE 141L,A01,185461,Eldon; John,8,0,100,92
1683666854657,CSE 142,A01,185463,Staff,34,0,60,26
1683666854657,CSE 142,B01,201355,Staff,0,7,60,60
1683666855684,CSE 142L,A01,185470,Staff,34,0,60,26
1683666855684,CSE 142L,B01,201417,Staff,0,6,60,60
1683666856707,CSE 190,A00,201433,Staff,32,0,49,17
1683666857732,DOC 1,A01,259136,Strom; Megan C.,7,0,15,8
1683666857732,DOC 1,A02,259137,Strom; Megan C.,14,0,15,1
1683666857732,DOC 1,A03,259138,Strom; Megan C.,14,0,15,1
1683666857732,DOC 1,A04,259139,Strom; Megan C.,14,0,15,1
1683666858756,DOC 100D,A00,259140,Pass; Natalye Joann,14,0,25,11
1683666859784,DSGN 1,A01,184749,Rill; Bryan,0,26,30,30
1683666860808,DSGN 100,A01,185168,Staff,0,2,25,25
1683666861834,ECE 5,A01,185626,Morris; Karcher William,0,12,0,0
1683666862860,ECE 101,A01,185628,Staff,14,0,70,56
1683666863942,ECE 107,A01,185635,Baghdadchi; Saharnaz,0,0,20,20
1683666863942,ECE 107,A02,185638,Baghdadchi; Saharnaz,1,0,20,19
1683666864965,ECE 148,A01,185647,Silberman; Jack,0,0,16,16
1683666865988,ECON 1,A01,185537,Crane; Meredith Helen,54,0,70,16
1683666867012,ECON 3,A01,185549,Crane; Meredith Helen,29,0,70,41
1683666868040,ECON 4,A01,203354,Anderson; John Charles,0,5,10,10
1683666869066,ECON 100A,A01,185574,Staff,0,5,40,40
1683666870091,ECON 100B,A01,185576,Staff,0,12,50,50
1683666871118,ECON 100C,A01,185589,Newhouse; Herbert S,30,0,70,40
1683666872143,ECON 105,A00,185608,Vespa; Emanuel Ignacio,19,0,35,16
1683666873167,ECON 109,A01,185610,Shishkin; Denis,9,0,35,26
1683666874196,ECON 110A,A01,185612,Staff,9,0,40,31
1683666875223,ECON 120A,A01,185615,Staff,19,0,40,21
1683666876247,ECON 120C,A01,185617,Sun; Yixiao,0,20,70,70
1683666877271,ECON 144,A00,203346,Squires; Dale E,2,0,35,33
1683666878298,ECON 171,A01,203349,Newhouse; Herbert S,0,1,35,35
1683666879322,ECON 173A,A01,185621,Toda; Alexis Akira,20,0,35,15
1683666880347,EDS 25,A01,202413,Staff,0,1,0,0
1683666880347,EDS 25,A02,202414,Staff,0,1,0,0
1683666880347,EDS 25,A03,202415,Staff,0,0,0,0
1683666880347,EDS 25,A04,202416,Staff,0,1,0,0
1683666880347,EDS 25,A05,202439,Staff,0,0,0,0
1683666880347,EDS 25,A06,202440,Staff,0,0,0,0
1683666880347,EDS 25,B01,202631,Staff,0,0,0,0
1683666880347,EDS 25,B02,202632,Staff,0,0,0,0
1683666880347,EDS 25,B03,202639,Staff,0,0,0,0
1683666880347,EDS 25,B04,202640,Staff,0,0,0,0
1683666880347,EDS 25,B05,202643,Staff,0,0,0,0
1683666880347,EDS 25,B06,202644,Staff,0,0,0,0
1683666881375,EDS 38,A01,202659,Black; Alison Michelle,24,0,25,1
1683666882401,EDS 115,A00,202652,Staff,18,0,30,12
1683666883423,EDS 125,A00,202649,Staff,13,0,30,17
1683666884447,EDS 126,A01,203332,Staff,30,0,30,0
1683666885470,EDS 139,A00,202838,Staff,16,0,25,9
1683666886497,EDS 146,A01,202655,Staff,14,0,25,11
1683666887525,ENG 15,A00,185667,Staff,0,1,0,0
1683666887525,ENG 15,B00,185672,Staff,0,0,0,0
1683666887525,ENG 15,C00,185675,Staff,0,0,0,0
1683666887525,ENG 15,D00,185682,Staff,0,0,0,0
1683666887525,ENG 15,E00,185684,Staff,0,0,0,0
1683666888553,ETHN 103,A00,185710,Staff,0,8,35,35
1683666889580,ETHN 103A,A00,199228,Man; Simeon S,0,0,9,9
1683666890604,ETHN 109,A00,185711,Staff,14,0,35,21
1683666891630,ETHN 142,A00,185726,Staff,0,4,30,30
1683666892656,ETHN 163J,A00,199229,Man; Simeon S,5,0,8,3
1683666893680,ETHN 168,A00,185727,Staff,7,0,10,3
1683666894707,ETHN 182,A00,185728,Staff,0,0,35,35
1683666895732,ETHN 183,A00,185737,Staff,9,0,18,9
1683666896758,GLBH 111,A01,209361,Burgos; Jose L.,0,0,0,0
1683666898808,HIEU 104,A00,185792,Staff,14,0,20,6
1683666899832,HIEU 115,A00,185800,Staff,0,0,20,20
1683666900861,HIEU 128,A00,185801,Staff,0,9,20,20
1683666901884,HIEU 147,A00,185802,Staff,15,0,20,5
1683666902909,HIEU 154,A00,185823,Staff,11,0,20,9
1683666903933,HILA 102,A00,185826,Staff,14,0,20,6
1683666904957,HILD 2C,A01,185778,Staff,0,13,20,20
1683666905982,HILD 7B,A01,185780,Kwak; Nancy,0,17,32,32
1683666905982,HILD 7B,A02,185781,Kwak; Nancy,0,18,32,32
1683666907005,HILD 30,A01,185791,Staff,12,0,20,8
1683666908030,HISC 119,A00,185830,Golan; Tal,0,9,20,20
1683666909053,HITO 156GS,A00,185831,Patterson; Patrick H.,0,0,0,23
1683666910078,HIUS 103,A00,185832,Man; Simeon S,0,4,20,20
1683666911104,HIUS 117,A00,185836,Kwak; Nancy,2,0,20,18
1683666912128,HIUS 125,A00,185840,Man; Simeon S,0,2,23,23
1683666913152,HIUS 149,A00,185845,Staff,1,0,20,19
1683666914176,HUM 3,A01,185882,Zavodny; Tatiana Sophia,0,8,50,50
1683666914176,HUM 3,B01,185899,Caldwell; Michael Alan,0,18,50,50
1683666915205,HUM 3GS,A00,185900,Patterson; Patrick H.,0,0,0,23
1683666916229,HUM 4,A01,185938,Zroka; Amy Liane,29,0,50,21
1683666916229,HUM 4,B01,185956,Watkins; Eric,0,5,50,50
1683666916229,HUM 4,B02,202209,Watkins; Eric,0,5,50,50
1683666916229,HUM 4,B03,202210,Watkins; Eric,0,5,50,50
1683666917253,HUM 5,A01,185958,West; Geoffrey Scott,0,0,50,50
1683666917253,HUM 5,A02,202215,West; Geoffrey Scott,0,0,50,50
1683666918278,INTL 190,A00,185959,Gagnon; Jeffrey C,0,0,0,9
1683666918278,INTL 190,B00,185960,Lettieri; Michael Joseph,0,0,0,2
1683666919300,JAPN 180,A00,254509,Staff,5,0,30,25
1683666920328,LATI 10,A01,202853,Kennemore; Amy Michelle,4,0,35,31
1683666920328,LATI 10,A02,202854,Kennemore; Amy Michelle,2,0,35,33
1683666920328,LATI 10,A03,270054,Kennemore; Amy Michelle,30,0,30,0
1683666921352,LATI 180,A00,202855,Kennemore; Amy Michelle,11,0,20,9
1683666922379,LAWS 101,A00,201767,Golan; Tal,0,7,40,40
1683666923405,LIFR 1C,A00,185961,Staff,6,0,20,14
1683666924429,LIFR 1CX,A00,185962,Staff,7,0,20,13
1683666925453,LIFR 1D,A00,185963,Staff,7,0,20,13
1683666926477,LIFR 1DX,A00,185964,Staff,7,0,20,13
1683666927503,LIGN 101,A01,186039,Staff,43,0,50,7
1683666928529,LIGN 165,A00,186040,Staff,15,0,50,35
1683666929553,LTCS 108,A00,186041,Staff,5,0,10,5
1683666930577,LTCS 119,A00,186042,Staff,15,0,20,5
1683666931602,LTCS 130,A00,186043,Wesling; Megan E.,15,0,25,10
1683666933654,LTEA 138,A00,186119,Staff,14,0,40,26
1683666934677,LTEN 124,A00,186148,Staff,5,0,25,20
1683666935701,LTEN 178,A00,186149,Staff,7,0,15,8
1683666936726,LTEN 181,A00,186150,Blanco; John D,34,0,40,6
1683666937752,LTWL 120,A00,186160,Staff,20,0,25,5
1683666938780,LTWL 165,A00,186161,Staff,22,0,25,3
1683666939805,LTWR 100,A00,186162,Staff,0,5,15,15
1683666940827,LTWR 102,A00,186163,Doller; Ben,5,0,15,10
1683666941850,MAE 8,A01,186412,Staff,0,0,0,0
1683666942874,MAE 30B,A00,186445,Bahadori; Mohammad Yousef,82,0,100,18
1683666943899,MAE 40,A00,186592,Bewley; Thomas R,10,0,50,40
1683666944927,MAE 101B,A00,186593,Bahadori; Mohammad Yousef,80,0,100,20
1683666945955,MAE 105,A00,186594,Bandaru; Prabhakar,10,0,50,40
1683666946978,MAE 107,A00,186599,Pham; Hieu Tan,0,7,120,120
1683666948002,MAE 148,A01,186660,Silberman; Jack,3,0,16,13
1683666949029,MATH 10A,A01,188095,Staff,0,6,35,35
1683666950060,MATH 10B,A01,188097,Bowers; Adam R.,0,12,30,30
1683666950060,MATH 10B,A02,188099,Bowers; Adam R.,0,11,30,30
1683666950060,MATH 10B,B01,188104,Bowers; Adam R.,0,10,30,30
1683666950060,MATH 10B,B02,188106,Bowers; Adam R.,1,9,30,29
1683666951088,MATH 10C,A01,188111,Staff,0,18,30,30
1683666951088,MATH 10C,A02,188127,Staff,0,19,30,30
1683666951088,MATH 10C,A03,188131,Staff,0,19,30,30
1683666951088,MATH 10C,B01,188218,Staff,17,0,30,13
1683666951088,MATH 10C,B02,188244,Staff,13,0,30,17
1683666951088,MATH 10C,B03,188277,Staff,14,0,30,16
1683666952116,MATH 18,A01,188344,Bach; Quang Tran,18,0,30,12
1683666952116,MATH 18,A02,188345,Bach; Quang Tran,11,0,30,19
1683666952116,MATH 18,B01,188353,Bach; Quang Tran,11,0,30,19
1683666952116,MATH 18,B02,188354,Bach; Quang Tran,19,0,30,11
1683666953142,MATH 20A,A01,188374,Staff,11,0,35,24
1683666954167,MATH 20B,A01,188382,Ohm; Ko Woon,7,0,30,23
1683666954167,MATH 20B,A02,188383,Ohm; Ko Woon,22,0,30,8
1683666954167,MATH 20B,B01,188385,Ohm; Ko Woon,7,0,30,23
1683666954167,MATH 20B,B02,188392,Ohm; Ko Woon,22,0,30,8
1683666955192,MATH 20C,A01,188394,Harel; Guershon,10,0,30,20
1683666955192,MATH 20C,A02,188395,Harel; Guershon,13,0,30,17
1683666955192,MATH 20C,B01,188404,Harel; Guershon,5,0,30,25
1683666955192,MATH 20C,B02,188405,Harel; Guershon,18,0,30,12
1683666956221,MATH 20D,A01,188414,Hammock; Frances H,0,1,30,30
1683666956221,MATH 20D,A02,188415,Hammock; Frances H,0,1,30,30
1683666956221,MATH 20D,B01,188447,Hammock; Frances H,0,1,30,30
1683666956221,MATH 20D,B02,188486,Hammock; Frances H,3,0,30,27
1683666957257,MATH 20E,A01,188649,Staff,21,0,30,9
1683666957257,MATH 20E,A02,188650,Staff,21,0,30,9
1683666957257,MATH 20E,A03,188673,Staff,0,0,30,30
1683666958283,MATH 102,A01,188675,Staff,0,36,35,35
1683666959311,MATH 103B,A01,188681,Staff,3,0,35,32
1683666959311,MATH 103B,B01,188692,Staff,5,0,35,30
1683666960339,MATH 109,A01,188695,Salehi Golsefidy; Alireza,24,0,35,11
1683666960339,MATH 109,A02,188696,Salehi Golsefidy; Alireza,25,0,35,10
1683666961367,MATH 120A,A01,188698,Eggers; John Dietrich,7,0,35,28
1683666962398,MATH 142B,A01,188736,Ioana; Adrian,1,1,30,29
1683666962398,MATH 142B,A02,188741,Ioana; Adrian,0,1,30,30
1683666962398,MATH 142B,A03,188743,Ioana; Adrian,0,1,30,30
1683666963425,MATH 168A,A01,188790,Staff,0,10,35,35
1683666964453,MATH 170A,A01,188803,Nie; Jiawang,0,2,35,35
1683666964453,MATH 170A,A02,188811,Nie; Jiawang,0,0,35,35
1683666964453,MATH 170A,A03,188814,Nie; Jiawang,0,0,35,35
1683666964453,MATH 170A,A04,188815,Nie; Jiawang,8,0,35,27
1683666965480,MATH 193B,A01,188817,Staff,0,0,35,35
1683666965480,MATH 193B,A02,188818,Staff,6,0,35,29
1683666966504,MGT 4,A01,202857,Anderson; John Charles,60,0,80,20
1683666967602,MGT 12,A00,202858,Lindenberger; Wade Douglas,40,0,90,50
1683666968631,MGT 18,A00,202859,Staff,74,0,90,16
1683666969655,MGT 18GS,A00,202860,McKay; Michael J,13,0,28,15
1683666970682,MGT 45,A00,202861,Pecore; Joseph P.,11,0,90,79
1683666971708,MGT 100,A00,202863,Yavorsky; Daniel Ryan,28,0,90,62
1683666972734,MGT 103,A00,202864,Ehrich; Kristine R,0,18,90,90
1683666973762,MGT 112,A00,202865,Ehrich; Kristine R,15,0,90,75
1683666974785,MGT 121A,A00,202868,Staff,90,20,90,0
1683666975812,MGT 131B,A00,202869,Anderson; John Charles,59,0,90,31
1683666976840,MGT 136,A00,202871,Lindenberger; Wade Douglas,83,0,90,7
1683666977866,MGT 164,A00,202873,Staff,0,67,90,91
1683666978891,MGT 164GS,A00,202874,McKay; Mary A,13,0,28,15
1683666979918,MGT 180,A00,202875,Staff,0,51,90,91
1683666980943,MMW 11R,A01,205019,Herbst; Matthew,1,0,30,29
1683666980943,MMW 11R,A02,205026,Herbst; Matthew,29,0,30,1
1683666981970,MMW 15,A01,193512,Chang; Edmond Yi-Teh,0,8,28,28
1683666981970,MMW 15,A02,193513,Chang; Edmond Yi-Teh,0,5,28,28
1683666981970,MMW 15,A03,193514,Chang; Edmond Yi-Teh,0,5,28,28
1683666981970,MMW 15,A04,193515,Chang; Edmond Yi-Teh,0,5,28,28
1683666981970,MMW 15,A05,193516,Chang; Edmond Yi-Teh,0,5,28,28
1683666981970,MMW 15,A06,193517,Chang; Edmond Yi-Teh,0,6,28,28
1683666981970,MMW 15,B01,193519,Chang; Edmond Yi-Teh,0,5,28,28
1683666981970,MMW 15,B02,193520,Chang; Edmond Yi-Teh,0,5,28,28
1683666981970,MMW 15,B03,193521,Chang; Edmond Yi-Teh,0,5,28,28
1683666981970,MMW 15,B04,193522,Chang; Edmond Yi-Teh,0,5,28,28
1683666981970,MMW 15,B05,193523,Chang; Edmond Yi-Teh,0,5,28,28
1683666981970,MMW 15,B06,193524,Chang; Edmond Yi-Teh,0,5,28,28
1683666982995,MMW 122,A01,193526,Rahimi; Babak,0,16,28,28
1683666982995,MMW 122,A02,193527,Rahimi; Babak,0,15,28,28
1683666982995,MMW 122,A03,193528,Rahimi; Babak,0,0,0,0
1683666982995,MMW 122,A04,193529,Rahimi; Babak,0,0,0,0
1683666984019,MUS 1A,A01,186663,Staff,1,19,35,34
1683666985046,MUS 4,A01,186715,Staff,0,12,35,35
1683666986074,MUS 5R,A01,186796,Dubnov; Shlomo,0,17,35,35
1683666987097,MUS 6,A01,186798,Staff,0,5,25,25
1683666988119,MUS 7,A01,186830,Staff,11,0,35,24
1683666989142,MUS 8,A01,186930,Staff,0,26,35,35
1683666990170,MUS 15,A01,186932,Staff,0,15,35,35
1683666990170,MUS 15,B01,186934,Staff,1,17,35,34
1683666991193,MUS 80,A00,186935,Staff,0,0,20,20
1683666991193,MUS 80,B00,186936,Staff,24,0,25,1
1683666992217,NANO 11,A00,204702,Lipomi; Darren John,0,0,0,0
1683666993245,NANO 15,A01,204709,Yang; Kesong,0,1,0,0
1683666994269,NANO 114,A00,202069,Jahed Motlagh; Zeinab,3,0,10,7
1683666995292,PHIL 1,A00,186955,Grush; Rick Scott,31,0,40,9
1683666996316,PHIL 10,A01,186973,Grush; Rick Scott,27,0,35,8
1683666996316,PHIL 10,A02,186974,Grush; Rick Scott,33,0,35,2
1683666997340,PHIL 13,A01,186976,Staff,3,0,35,32
1683666997340,PHIL 13,A02,186977,Staff,16,0,35,19
1683666998363,PHIL 14,A01,186979,Staff,31,0,35,4
1683666998363,PHIL 14,A02,186986,Staff,32,0,35,3
1683666999391,PHIL 28,A01,186988,Staff,16,0,30,14
1683666999391,PHIL 28,A02,186989,Staff,1,0,30,29
1683666999391,PHIL 28,A03,186990,Staff,10,0,30,20
1683666999391,PHIL 28,A04,186991,Staff,26,0,30,4
1683667000416,PHIL 120,A00,186997,Staff,23,0,40,17
1683667001440,PHIL 137,A00,187003,Staff,7,0,40,33
1683667002464,PHIL 150,A00,187015,Staff,47,0,70,23
1683667003491,PHIL 167,A00,187021,Lamey; Andy M.,34,0,40,6
1683667004519,PHIL 174,A01,202226,Staff,17,0,20,3
1683667004519,PHIL 174,A02,202235,Staff,20,0,20,0
1683667005543,PHIL 191A,A00,258918,Staff,0,0,1,1
1683667006567,PHYS 1A,A00,187028,Staff,26,0,60,34
1683667007591,PHYS 1AL,001,187036,Staff,3,0,30,27
1683667007591,PHYS 1AL,002,187049,Staff,18,0,30,12
1683667008615,PHYS 1B,A00,187058,Staff,22,0,60,38
1683667009641,PHYS 1BL,001,187064,Staff,0,1,30,30
1683667009641,PHYS 1BL,002,187070,Staff,4,0,30,26
1683667010668,PHYS 1C,A00,187082,Staff,29,0,120,91
1683667011695,PHYS 1CL,001,187088,Staff,0,9,30,30
1683667011695,PHYS 1CL,002,187089,Staff,0,1,30,30
1683667011695,PHYS 1CL,009,262693,Staff,9,0,30,21
1683667012722,PHYS 2B,A01,187097,Staff,55,0,115,60
1683667013747,PHYS 2C,A01,187099,Staff,63,0,115,52
1683667014772,PHYS 2CL,A01,187101,Staff,5,0,28,23
1683667014772,PHYS 2CL,A02,187102,Staff,15,0,28,13
1683667015797,PHYS 2D,A01,187123,Shotwell; Brian,95,0,115,20
1683667016824,PHYS 4B,A01,187133,Grinstein; Benjamin,35,0,50,15
1683667017847,POLI 10,A00,188819,Staff,0,4,50,50
1683667018874,POLI 11,A00,188827,Staff,43,0,50,7
1683667019901,POLI 13R,A00,188828,Staff,0,1,20,20
1683667020925,POLI 27,A01,188830,Elgin; Samuel Zincke,0,2,70,70
1683667021954,POLI 30,A00,188832,Desposato; Scott,30,0,50,20
1683667022983,POLI 102F,A00,188834,Staff,0,0,40,40
1683667024006,POLI 104A,A00,188852,Staff,13,0,30,17
1683667025034,POLI 104I,A00,188853,Staff,0,7,20,20
1683667026061,POLI 110B,A00,188854,Wiens; David,6,0,20,14
1683667027086,POLI 112A,A00,188855,Wiens; David,3,0,30,27
1683667028112,POLI 117R,A00,188856,Forman; Fonna,0,12,20,20
1683667029135,POLI 118,A00,188857,Ingham; Sean,8,0,20,12
1683667030162,POLI 120G,A00,188858,Staff,8,0,30,22
1683667031185,POLI 131CR,A00,188863,Hoston; Germaine,21,0,50,29
1683667032209,POLI 133,A00,188864,Nellis; Gareth Hb,44,0,50,6
1683667033232,POLI 134D,A00,188865,Desposato; Scott,27,0,30,3
1683667034261,POLI 142A,A00,188871,Gartzke; Erik,21,0,50,29
1683667035285,POLI 142K,A00,188874,Staff,38,0,50,12
1683667036311,POLI 143,A00,188940,Gartzke; Erik,16,0,30,14
1683667037333,POLI 153,A00,188943,Staff,2,0,20,18
1683667038359,POLI 160AA,A00,188944,Staff,11,0,40,29
1683667039385,POLI 170A,A00,188945,Staff,11,0,30,19
1683667041435,PSYC 1,A00,188952,Staff,36,0,90,54
1683667042457,PSYC 2,B00,188953,Staff,19,0,35,16
1683667043481,PSYC 6,A00,188970,Staff,47,0,60,13
1683667044507,PSYC 7,A00,188973,Staff,35,0,45,10
1683667045531,PSYC 60,A01,188980,Rickard; Timothy C.,42,0,60,18
1683667046555,PSYC 70,A01,189001,Steiner; Eric Tomas,22,0,45,23
1683667047584,PSYC 100,A00,189005,Lacefield; Katharine I,0,99,120,120
1683667048606,PSYC 102,A00,189008,Staff,8,0,30,22
1683667049631,PSYC 106,B00,189026,Gorman; Michael R.,27,0,60,33
1683667050655,PSYC 114,B01,189033,Winkielman; Piotr,0,31,30,30
1683667051683,PSYC 131,A00,189036,Anagnostaras; Stephan,0,43,60,60
1683667052706,PSYC 136,A00,189041,Lowe; Angela Beth,0,7,25,25
1683667053732,PSYC 137,A00,189057,Winkielman; Piotr,1,37,25,24
1683667054756,PSYC 144,A00,189107,Wixted; John T,0,11,50,50
1683667056807,PSYC 162,A00,189142,Staff,0,9,85,85
1683667057838,PSYC 172,A00,189144,Gorman; Michael R.,0,6,30,30
1683667059886,PSYC 179,A00,189146,Lacefield; Katharine I,0,87,120,120
1683667060912,PSYC 181,A00,189147,Anagnostaras; Stephan,0,44,90,90
1683667061936,PSYC 190R,A00,189148,Barner; David A.,0,23,80,80
1683667062963,PSYC 191,A00,189275,Rickard; Timothy C.,0,10,25,25
1683667063987,PSYC 193,A00,189276,Chapman; Eddie Nathaniel,0,1,0,4
1683667065011,PSYC 193L,A01,189281,Lowe; Angela Beth,10,0,20,10
1683667065011,PSYC 193L,B01,189285,Staff,28,0,35,7
1683667066035,RELI 149,A00,187137,Rahimi; Babak,7,0,40,33
1683667067069,SE 9,A01,187315,Staff,0,2,18,18
1683667068093,SE 101B,A00,187409,Staff,24,0,30,6
1683667069120,SE 110B,A00,187444,Staff,10,0,40,30
1683667070147,SE 130B,A00,187449,Staff,31,0,40,9
1683667071233,SE 150A,A00,187516,Staff,8,0,20,12
1683667072269,SE 154,A00,187528,Staff,29,0,50,21
1683667073299,SIO 3,A01,258171,Staff,35,0,40,5
1683667074324,SIO 10,A00,187144,Cook; Geoffrey W,0,7,75,75
1683667075350,SIO 45,A00,187152,Cook; Geoffrey W,0,5,100,100
1683667076376,SIO 109R,A00,194486,Staff,0,4,20,20
1683667078426,SIO 187,A01,187233,Kacev; David,12,0,40,28
1683667079450,SOCI 1,A01,258656,Thorpe; Charles Robert,28,0,30,2
1683667079450,SOCI 1,A02,258658,Thorpe; Charles Robert,30,0,30,0
1683667079450,SOCI 1,A03,258661,Thorpe; Charles Robert,25,0,25,0
1683667079450,SOCI 1,A04,258666,Thorpe; Charles Robert,22,0,25,3
1683667079450,SOCI 1,A05,258897,Thorpe; Charles Robert,22,0,25,3
1683667079450,SOCI 1,A06,258898,Thorpe; Charles Robert,25,0,25,0
1683667080474,SOCI 30,A01,258903,Pardo Guerra; Juan Pablo,14,0,30,16
1683667081502,SOCI 102,A00,258904,Staff,9,0,25,16
1683667082528,SOCI 106,A00,258905,Staff,19,0,25,6
1683667083554,SOCI 111,A00,258907,Ribas Norris; Janet Vanesa,26,0,30,4
1683667084581,SOCI 121R,A00,258908,Pardo Guerra; Juan Pablo,8,0,30,22
1683667085609,SOCI 126,A01,203330,Staff,14,0,20,6
1683667086633,SOCI 131,A00,258909,Thorpe; Charles Robert,30,0,60,30
1683667087660,SOCI 135,A00,258910,Payne; Christine Anna,0,11,30,30
1683667088685,SOCI 157,A00,258911,Staff,12,0,30,18
1683667089713,SOCI 184,A00,258912,Staff,25,0,30,5
1683667090736,SOCI 188D,A00,258913,Staff,22,0,30,8
1683667091763,SYN 2,001,187529,Staff,9,0,16,7
1683667091763,SYN 2,002,201452,Staff,0,20,16,16
1683667091763,SYN 2,003,201469,Staff,1,0,16,15
1683667092788,SYN 100,A01,187531,Staff,0,9,20,20
1683667092788,SYN 100,B01,201491,Staff,0,10,20,20
1683667093813,TDAC 1,A00,189286,Walsh; Kim C.,3,0,20,17
1683667093813,TDAC 1,B00,189287,Harting; Carla Kelso,10,0,20,10
1683667094837,TDAC 101,A00,189300,Walsh; Kim C.,16,0,20,4
1683667094837,TDAC 101,B00,189301,Harting; Carla Kelso,18,0,20,2
1683667095862,TDAC 102,A00,189304,Basso; Beatrice,14,0,20,6
1683667096887,TDAC 108,A00,189305,Staff,18,0,20,2
1683667097912,TDDE 131,A00,189310,Staff,19,0,20,1
1683667097912,TDDE 131,B00,189314,Staff,19,0,20,1
1683667097912,TDDE 131,C00,189315,Staff,48,0,50,2
1683667097912,TDDE 131,D00,189316,Staff,14,0,15,1
1683667097912,TDDE 131,E00,204841,Staff,20,0,20,0
1683667098938,TDGE 10,A00,189289,Staff,27,0,50,23
1683667098938,TDGE 10,B00,189290,Havis; Allan,0,1,50,50
1683667099962,TDGE 11,A00,189291,Fulton; Julia,0,4,50,50
1683667099962,TDGE 11,B00,189292,Staff,20,0,25,5
1683667099962,TDGE 11,C00,260270,Staff,0,0,0,0
1683667100985,TDGE 25,A00,189294,Staff,2,0,20,18
1683667102009,TDGE 124,A00,189318,Fulton; Julia,0,8,50,50
1683667103037,TDGE 125,A00,189319,Staff,13,0,25,12
1683667103037,TDGE 125,B00,189320,Staff,23,0,25,2
1683667104064,TDGE 127,A00,189322,Havis; Allan,1,0,50,49
1683667105088,TDHT 101,A00,189323,Staff,18,0,25,7
1683667105088,TDHT 101,B00,189324,Staff,25,0,25,0
1683667106113,TDHT 102,A00,189325,Staff,49,0,50,1
1683667107141,TDMV 1,A00,189295,Arcidiacono; Kristin,20,0,30,10
1683667107141,TDMV 1,B00,189296,Caligagan; Maria T.,24,0,30,6
1683667108166,TDMV 2,A00,189297,Sammartano; Tonnie,27,0,30,3
1683667108166,TDMV 2,B00,189299,Arcidiacono; Kristin,23,0,30,7
1683667109190,TDMV 3,A00,204998,Rincon; Alicia,22,0,30,8
1683667110224,TDMV 120,A00,189458,Sammartano; Tonnie,28,0,30,2
1683667111249,TDMV 138,A00,189541,Jun; Grace Shin Hae,20,0,40,20
1683667112275,TDMV 142,A00,189717,Caligagan; Tony,25,0,30,5
1683667112275,TDMV 142,B00,189718,Caligagan; Maria T.,25,0,30,5
1683667113303,TMC 2,A01,187533,Staff,25,0,25,0
1683667113303,TMC 2,A02,187534,Staff,25,0,25,0
1683667114326,USP 1,A01,187536,Kwak; Nancy,0,16,25,25
1683667115349,USP 5,A01,187538,Staff,9,0,25,16
1683667116372,USP 101,A00,199253,Staff,0,4,0,0
1683667117398,USP 124,A00,187562,Boomhower; Matthew Charles,0,0,30,30
1683667118420,USP 138,A00,187582,Staff,20,0,25,5
1683667119445,USP 152,A01,187597,Staff,3,0,25,22
1683667120469,USP 153,A00,187598,Staff,19,0,25,6
1683667121496,USP 168,A00,187607,Kwak; Nancy,2,0,5,3
1683667122524,USP 173,A00,187619,Staff,4,0,25,21
1683667123551,USP 181,A00,187638,Staff,0,4,25,25
1683667124578,VIS 103,A00,187650,Cruz; Edwin Teddy,17,0,75,58
1683667125605,VIS 110D,A00,187669,Staff,13,0,22,9
1683667126630,VIS 127C,A00,187720,Shen; Kuiyi,68,0,146,78
1683667127656,VIS 149,A00,187731,Yoldas; Pinar,1,14,22,21
1683667128680,VIS 151,A01,188091,Staff,22,0,34,12
1683667128680,VIS 151,A02,188092,Staff,11,0,34,23
1683667129704,VIS 160B,A00,188093,Stalbaum; Brett,0,1,10,10
1683667131764,WCWP 10B,A00,201720,Staff,10,0,15,5
1683667131764,WCWP 10B,B00,201722,Staff,9,0,15,6
1683667132792,WCWP 100,A00,201725,Gagnon; Jeffrey C,0,0,2,2
1683667132792,WCWP 100,B00,201727,Staff,0,4,15,15
1683667135887,ANBI 133,A00,258401,Wilder; Linnea Lorene,34,0,40,6
1683667136915,ANBI 140,A00,258395,Hrvoj Mihic; Branka,18,0,25,7
1683667137939,ANSC 120,A00,258402,Bialecki; Jon Anthony,26,0,40,14
1683667138966,ANSC 144,A00,258400,Staff,12,0,40,28
1683667141017,ANSC 166,A00,258396,Parish; Steven Martin,156,0,175,19
1683667142050,ANSC 180,A00,193533,Staff,8,0,20,12
1683667143077,ANSC 188,A00,258397,Jassal; Aftab,34,0,40,6
1683667144108,ANTH 3,A01,258316,Staff,23,0,30,7
1683667145133,ANTH 5,A00,258394,Semendeferi; Ekaterini,16,0,20,4
1683667146162,ANTH 21,A01,258331,Staff,4,0,40,36
1683667147186,ANTH 103,A00,258398,Varma; Saiba,15,0,25,10
1683667148221,AWP 10,001,202034,Staff,0,0,0,0
1683667148221,AWP 10,002,202035,Staff,0,0,0,0
1683667148221,AWP 10,003,202036,Staff,0,0,0,0
1683667148221,AWP 10,004,202037,Staff,0,0,0,0
1683667148221,AWP 10,005,202038,Staff,0,0,0,0
1683667148221,AWP 10,006,202039,Staff,0,0,0,0
1683667148221,AWP 10,007,202040,Staff,0,0,0,0
1683667148221,AWP 10,008,202041,Staff,0,0,0,0
1683667148221,AWP 10,009,202042,Staff,0,0,0,0
1683667148221,AWP 10,010,202043,Staff,0,0,0,0
1683667148221,AWP 10,011,202044,Staff,0,0,0,0
1683667148221,AWP 10,012,202045,Staff,0,0,0,0
1683667148221,AWP 10,013,202046,Staff,0,0,0,0
1683667148221,AWP 10,014,202047,Staff,0,0,0,0
1683667148221,AWP 10,015,202048,Staff,0,0,0,0
1683667148221,AWP 10,016,202049,Staff,0,0,0,0
1683667148221,AWP 10,017,202050,Staff,0,0,0,0
1683667148221,AWP 10,018,202051,Staff,0,0,0,0
1683667148221,AWP 10,019,202052,Staff,0,0,0,0
1683667148221,AWP 10,020,202053,Staff,0,0,0,0
1683667148221,AWP 10,021,202054,Staff,0,0,0,0
1683667148221,AWP 10,022,202055,Staff,0,0,0,0
1683667148221,AWP 10,023,202056,Staff,0,0,0,0
1683667148221,AWP 10,024,202057,Staff,0,0,0,0
1683667148221,AWP 10,025,202058,Staff,0,0,0,0
1683667148221,AWP 10,026,202059,Staff,0,0,0,0
1683667149247,AWP 102,001,202032,Staff,0,0,0,0
1683667149247,AWP 102,002,202033,Staff,0,0,0,0
1683667150273,BENG 100,A01,254234,Taylor Amos; Alyssa C,31,0,40,9
1683667151298,BENG 196,001,270013,Engler; Adam J.,9999,0,9999,0
1683667152327,BICD 100R,A01,202018,Smith; Laurie,0,7,32,32
1683667152327,BICD 100R,A02,202019,Smith; Laurie,0,3,32,32
1683667152327,BICD 100R,A03,202020,Smith; Laurie,0,1,32,32
1683667152327,BICD 100R,A04,202021,Smith; Laurie,6,0,32,26
1683667152327,BICD 100R,A05,202022,Smith; Laurie,11,0,32,21
1683667153351,BICD 136,A01,193242,Gustafson-Brown; Cindy,0,2,32,32
1683667153351,BICD 136,A02,193244,Gustafson-Brown; Cindy,13,0,32,19
1683667154388,BIEB 102,A01,193249,Butler; Shannon Rhey,1,2,32,31
1683667154388,BIEB 102,A02,193251,Butler; Shannon Rhey,0,0,32,32
1683667154388,BIEB 102,A03,193253,Butler; Shannon Rhey,0,0,32,32
1683667154388,BIEB 102,A04,193255,Butler; Shannon Rhey,14,0,32,18
1683667154388,BIEB 102,A05,193265,Butler; Shannon Rhey,25,0,32,7
1683667154388,BIEB 102,A06,193269,Butler; Shannon Rhey,14,0,32,18
1683667156441,BIEB 150,A01,193274,Staff,0,0,32,32
1683667156441,BIEB 150,A02,193285,Staff,24,0,32,8
1683667157467,BIEB 194,A00,193286,Kurle; Carolyn M.,20,0,32,12
1683667158492,BILD 1,A01,192291,Staff,15,0,32,17
1683667158492,BILD 1,A02,192292,Staff,30,0,32,2
1683667158492,BILD 1,B01,192520,Reuther; Keefe,0,1,0,0
1683667158492,BILD 1,B02,192532,Reuther; Keefe,0,1,0,0
1683667159517,BILD 3,A01,192556,Butler; Shannon Rhey,0,0,32,32
1683667159517,BILD 3,A02,192581,Butler; Shannon Rhey,0,0,32,32
1683667159517,BILD 3,A03,192611,Butler; Shannon Rhey,20,0,32,12
1683667159517,BILD 3,A04,192612,Butler; Shannon Rhey,24,0,32,8
1683667159517,BILD 3,A05,192613,Butler; Shannon Rhey,26,0,32,6
1683667159517,BILD 3,A06,192679,Butler; Shannon Rhey,27,0,32,5
1683667159517,BILD 3,A07,192682,Butler; Shannon Rhey,20,0,32,12
1683667160542,BILD 4,A01,192836,Reuther; Keefe,1,0,24,23
1683667160542,BILD 4,A02,193044,Reuther; Keefe,4,0,24,20
1683667161570,BILD 10,A01,193142,Gustafson-Brown; Cindy,29,0,32,3
1683667161570,BILD 10,A02,193149,Gustafson-Brown; Cindy,31,0,32,1
1683667162596,BIMM 100,A01,193301,Staff,0,6,32,32
1683667162596,BIMM 100,A02,193312,Staff,0,7,32,32
1683667162596,BIMM 100,A03,193323,Staff,0,9,32,32
1683667163623,BIMM 101,A01,193329,McDonnell; Lisa Marie,1,4,24,23
1683667163623,BIMM 101,A02,193339,McDonnell; Lisa Marie,1,4,24,23
1683667163623,BIMM 101,B01,193354,McDonnell; Lisa Marie,0,4,24,24
1683667163623,BIMM 101,B02,193357,McDonnell; Lisa Marie,0,3,24,24
1683667164657,BIMM 110,A01,193377,Tat; John,0,11,32,32
1683667164657,BIMM 110,A02,193378,Tat; John,0,10,32,32
1683667165681,BIMM 120,A01,206116,Staff,0,0,32,32
1683667165681,BIMM 120,A02,206117,Staff,6,0,32,26
1683667165681,BIMM 120,A03,206121,Staff,21,0,32,11
1683667166708,BIPN 100,A01,193393,Park; Ji Young,0,15,32,32
1683667166708,BIPN 100,A02,193402,Park; Ji Young,0,14,32,32
1683667166708,BIPN 100,A03,193413,Park; Ji Young,0,14,32,32
1683667166708,BIPN 100,A04,193414,Park; Ji Young,0,13,32,32
1683667167731,BIPN 102,A01,193429,Staff,0,0,32,32
1683667167731,BIPN 102,A02,193438,Staff,18,0,32,14
1683667168758,BIPN 106,A01,193450,Reyes Gonzalez; Catalina,0,2,40,40
1683667169782,BIPN 134,A01,193465,Cooke; James Edward,0,0,32,32
1683667169782,BIPN 134,A02,193474,Cooke; James Edward,25,0,32,7
1683667169782,BIPN 134,A03,193485,Cooke; James Edward,29,0,32,3
1683667169782,BIPN 134,A04,193486,Cooke; James Edward,20,0,32,12
1683667169782,BIPN 134,A05,193491,Cooke; James Edward,31,0,32,1
1683667169782,BIPN 134,A06,193501,Cooke; James Edward,30,0,32,2
1683667169782,BIPN 134,A07,193510,Cooke; James Edward,29,0,32,3
1683667171832,BISP 194,A00,222522,Staff,14,0,32,18
1683667172856,CAT 124,A01,202407,Staff,19,0,25,6
1683667173883,CAT 125,A00,202408,Marchisotto; Jennifer Anne,2,0,20,18
1683667174962,CAT 125R,A00,202409,Smith; Lauryn Alissa,0,11,20,20
1683667174962,CAT 125R,B00,202410,Morales; Celeste Georgianna,0,11,20,20
1683667174962,CAT 125R,C00,202411,Irwin; Matthew Joseph,0,12,20,20
1683667175989,CENG 15,A01,204712,Yang; Kesong,0,1,0,0
1683667177013,CENG 114,A00,202070,Jahed Motlagh; Zeinab,5,0,20,15
1683667178039,CGS 105,A00,185477,Wesling; Megan E.,24,0,40,16
1683667179067,CGS 106,A00,185494,Staff,11,0,22,11
1683667180091,CGS 108,A00,185495,Staff,14,0,20,6
1683667181114,CGS 114,A00,185496,Staff,13,0,18,5
1683667182137,CGS 119,A00,185501,Staff,15,0,20,5
1683667183160,CGS 120,A00,185511,Staff,12,0,20,8
1683667184184,CHEM 4,A01,184675,Bussey; Thomas J,97,0,100,3
1683667185208,CHEM 6A,A01,184677,Staff,32,0,60,28
1683667186231,CHEM 6B,A01,184679,Staff,63,0,100,37
1683667187255,CHEM 6C,A01,184681,Bussey; Thomas J,0,0,50,50
1683667187255,CHEM 6C,A02,184682,Bussey; Thomas J,32,0,50,18
1683667188279,CHEM 40A,A01,184684,Albizati; Kim F.,34,0,100,66
1683667189306,CHEM 40B,A01,184686,Albizati; Kim F.,0,22,100,100
1683667190337,CHEM 41B,A01,184690,Staff,51,0,100,49
1683667191363,COGS 3,A01,184715,Boyle; Mary E. T.,0,27,40,40
1683667192387,COGS 14B,A01,185172,Staff,0,14,38,38
1683667193414,COGS 18,A01,184736,Staff,14,0,80,66
1683667194437,COGS 100,A01,184932,Staff,0,8,73,73
1683667195461,COGS 101A,A01,184935,Staff,0,40,30,30
1683667196491,COGS 101B,A01,184944,Staff,0,2,30,30
1683667197518,COGS 101C,A01,184946,Staff,0,10,30,30
1683667198546,COGS 102A,A01,184951,Johnson; Christine M.,2,0,40,38
1683667199574,COGS 107B,A01,184953,Mooshagian; Eric Frederick,0,51,40,40
1683667200602,COGS 118B,A01,184959,Gupta; Anjum,0,50,40,40
1683667201625,COGS 153,A00,184961,Staff,0,16,30,30
1683667202649,COGS 177,A00,184962,Staff,0,21,30,30
1683667203673,COGS 187A,A01,184969,Boyle; Mary E. T.,0,19,40,40
1683667204701,COMM 10,A01,185174,Staff,0,5,25,25
1683667204701,COMM 10,A02,185189,Staff,0,2,25,25
1683667204701,COMM 10,A03,269821,Staff,0,1,0,0
1683667205725,COMM 100B,A01,185475,Staff,0,1,0,2
1683667205725,COMM 100B,A02,185476,Staff,12,0,25,13
1683667206752,COMM 100C,A01,185314,Staff,1,0,25,24
1683667206752,COMM 100C,A02,185327,Staff,18,0,25,7
1683667207774,COMM 110M,A00,185349,Staff,0,0,40,40
1683667208798,COMM 113T,A00,185352,Staff,25,0,40,15
1683667209821,COMM 114I,A00,185353,Staff,31,0,40,9
1683667210845,COMM 131,A00,185354,Staff,17,0,30,13
1683667211869,CSE 8A,A50,185358,Cao; Yingjun,0,46,10,10
1683667212895,CSE 8B,A01,185362,Staff,0,48,50,50
1683667213923,CSE 11,A01,185416,Cao; Yingjun,0,91,10,10
1683667214949,CSE 20,A01,185445,Briones; Jor-el Thomas Caparas,4,0,25,21
1683667215974,CSE 21,A01,185447,Staff,9,0,50,41
1683667217002,CSE 101,A01,185451,Staff,0,13,50,50
1683667217002,CSE 101,B01,185453,Jones; Miles E,0,14,50,50
1683667219055,CSE 141,A01,185458,Eldon; John,16,0,100,84
1683667220081,CSE 141L,A01,185461,Eldon; John,8,0,100,92
1683667221108,CSE 142,A01,185463,Staff,34,0,60,26
1683667221108,CSE 142,B01,201355,Staff,0,7,60,60
1683667222135,CSE 142L,A01,185470,Staff,34,0,60,26
1683667222135,CSE 142L,B01,201417,Staff,0,6,60,60
1683667223159,CSE 190,A00,201433,Staff,32,0,49,17
1683667224183,DOC 1,A01,259136,Strom; Megan C.,7,0,15,8
1683667224183,DOC 1,A02,259137,Strom; Megan C.,14,0,15,1
1683667224183,DOC 1,A03,259138,Strom; Megan C.,14,0,15,1
1683667224183,DOC 1,A04,259139,Strom; Megan C.,14,0,15,1
1683667225206,DOC 100D,A00,259140,Pass; Natalye Joann,14,0,25,11
1683667226235,DSGN 1,A01,184749,Rill; Bryan,0,26,30,30
1683667227261,DSGN 100,A01,185168,Staff,0,2,25,25
1683667228288,ECE 5,A01,185626,Morris; Karcher William,0,12,0,0
1683667229311,ECE 101,A01,185628,Staff,14,0,70,56
1683667230334,ECE 107,A01,185635,Baghdadchi; Saharnaz,0,0,20,20
1683667230334,ECE 107,A02,185638,Baghdadchi; Saharnaz,1,0,20,19
1683667231360,ECE 148,A01,185647,Silberman; Jack,0,0,16,16
1683667232387,ECON 1,A01,185537,Crane; Meredith Helen,54,0,70,16
1683667233414,ECON 3,A01,185549,Crane; Meredith Helen,29,0,70,41
1683667234441,ECON 4,A01,203354,Anderson; John Charles,0,5,10,10
1683667235465,ECON 100A,A01,185574,Staff,0,5,40,40
1683667236491,ECON 100B,A01,185576,Staff,0,12,50,50
1683667237515,ECON 100C,A01,185589,Newhouse; Herbert S,30,0,70,40
1683667238544,ECON 105,A00,185608,Vespa; Emanuel Ignacio,19,0,35,16
1683667239570,ECON 109,A01,185610,Shishkin; Denis,9,0,35,26
1683667240594,ECON 110A,A01,185612,Staff,9,0,40,31
1683667241618,ECON 120A,A01,185615,Staff,19,0,40,21
1683667242642,ECON 120C,A01,185617,Sun; Yixiao,0,20,70,70
1683667243668,ECON 144,A00,203346,Squires; Dale E,2,0,35,33
1683667244691,ECON 171,A01,203349,Newhouse; Herbert S,0,1,35,35
1683667245715,ECON 173A,A01,185621,Toda; Alexis Akira,20,0,35,15
1683667246743,EDS 25,A01,202413,Staff,0,1,0,0
1683667246743,EDS 25,A02,202414,Staff,0,1,0,0
1683667246743,EDS 25,A03,202415,Staff,0,0,0,0
1683667246743,EDS 25,A04,202416,Staff,0,1,0,0
1683667246743,EDS 25,A05,202439,Staff,0,0,0,0
1683667246743,EDS 25,A06,202440,Staff,0,0,0,0
1683667246743,EDS 25,B01,202631,Staff,0,0,0,0
1683667246743,EDS 25,B02,202632,Staff,0,0,0,0
1683667246743,EDS 25,B03,202639,Staff,0,0,0,0
1683667246743,EDS 25,B04,202640,Staff,0,0,0,0
1683667246743,EDS 25,B05,202643,Staff,0,0,0,0
1683667246743,EDS 25,B06,202644,Staff,0,0,0,0
1683667247764,EDS 38,A01,202659,Black; Alison Michelle,24,0,25,1
1683667248791,EDS 115,A00,202652,Staff,18,0,30,12
1683667249818,EDS 125,A00,202649,Staff,13,0,30,17
1683667250847,EDS 126,A01,203332,Staff,30,0,30,0
1683667251872,EDS 139,A00,202838,Staff,16,0,25,9
1683667252898,EDS 146,A01,202655,Staff,14,0,25,11
1683667253927,ENG 15,A00,185667,Staff,0,1,0,0
1683667253927,ENG 15,B00,185672,Staff,0,0,0,0
1683667253927,ENG 15,C00,185675,Staff,0,0,0,0
1683667253927,ENG 15,D00,185682,Staff,0,0,0,0
1683667253927,ENG 15,E00,185684,Staff,0,0,0,0
1683667254951,ETHN 103,A00,185710,Staff,0,8,35,35
1683667255979,ETHN 103A,A00,199228,Man; Simeon S,0,0,9,9
1683667257006,ETHN 109,A00,185711,Staff,14,0,35,21
1683667258034,ETHN 142,A00,185726,Staff,0,4,30,30
1683667259058,ETHN 163J,A00,199229,Man; Simeon S,5,0,8,3
1683667260084,ETHN 168,A00,185727,Staff,7,0,10,3
1683667261110,ETHN 182,A00,185728,Staff,0,0,35,35
1683667262136,ETHN 183,A00,185737,Staff,9,0,18,9
1683667263161,GLBH 111,A01,209361,Burgos; Jose L.,0,0,0,0
1683667265209,HIEU 104,A00,185792,Staff,14,0,20,6
1683667266237,HIEU 115,A00,185800,Staff,0,0,20,20
1683667267259,HIEU 128,A00,185801,Staff,0,9,20,20
1683667268286,HIEU 147,A00,185802,Staff,15,0,20,5
1683667269309,HIEU 154,A00,185823,Staff,11,0,20,9
1683667270334,HILA 102,A00,185826,Staff,14,0,20,6
1683667271355,HILD 2C,A01,185778,Staff,0,13,20,20
1683667272382,HILD 7B,A01,185780,Kwak; Nancy,0,17,32,32
1683667272382,HILD 7B,A02,185781,Kwak; Nancy,0,18,32,32
1683667273406,HILD 30,A01,185791,Staff,12,0,20,8
1683667274434,HISC 119,A00,185830,Golan; Tal,0,9,20,20
1683667275458,HITO 156GS,A00,185831,Patterson; Patrick H.,0,0,0,23
1683667276482,HIUS 103,A00,185832,Man; Simeon S,0,4,20,20
1683667277507,HIUS 117,A00,185836,Kwak; Nancy,2,0,20,18
1683667278587,HIUS 125,A00,185840,Man; Simeon S,0,2,23,23
1683667279612,HIUS 149,A00,185845,Staff,1,0,20,19
1683667280636,HUM 3,A01,185882,Zavodny; Tatiana Sophia,0,8,50,50
1683667280636,HUM 3,B01,185899,Caldwell; Michael Alan,0,18,50,50
1683667281659,HUM 3GS,A00,185900,Patterson; Patrick H.,0,0,0,23
1683667282691,HUM 4,A01,185938,Zroka; Amy Liane,29,0,50,21
1683667282691,HUM 4,B01,185956,Watkins; Eric,0,5,50,50
1683667282691,HUM 4,B02,202209,Watkins; Eric,0,5,50,50
1683667282691,HUM 4,B03,202210,Watkins; Eric,0,5,50,50
1683667283721,HUM 5,A01,185958,West; Geoffrey Scott,0,0,50,50
1683667283721,HUM 5,A02,202215,West; Geoffrey Scott,0,0,50,50
1683667284746,INTL 190,A00,185959,Gagnon; Jeffrey C,0,0,0,9
1683667284746,INTL 190,B00,185960,Lettieri; Michael Joseph,0,0,0,2
1683667285772,JAPN 180,A00,254509,Staff,5,0,30,25
1683667286796,LATI 10,A01,202853,Kennemore; Amy Michelle,4,0,35,31
1683667286796,LATI 10,A02,202854,Kennemore; Amy Michelle,2,0,35,33
1683667286796,LATI 10,A03,270054,Kennemore; Amy Michelle,30,0,30,0
1683667287822,LATI 180,A00,202855,Kennemore; Amy Michelle,11,0,20,9
1683667288849,LAWS 101,A00,201767,Golan; Tal,0,7,40,40
1683667289874,LIFR 1C,A00,185961,Staff,6,0,20,14
1683667290898,LIFR 1CX,A00,185962,Staff,7,0,20,13
1683667291921,LIFR 1D,A00,185963,Staff,7,0,20,13
1683667292948,LIFR 1DX,A00,185964,Staff,7,0,20,13
1683667293977,LIGN 101,A01,186039,Staff,43,0,50,7
1683667295003,LIGN 165,A00,186040,Staff,15,0,50,35
1683667296027,LTCS 108,A00,186041,Staff,5,0,10,5
1683667297052,LTCS 119,A00,186042,Staff,15,0,20,5
1683667298076,LTCS 130,A00,186043,Wesling; Megan E.,15,0,25,10
1683667300128,LTEA 138,A00,186119,Staff,14,0,40,26
1683667301151,LTEN 124,A00,186148,Staff,5,0,25,20
1683667302175,LTEN 178,A00,186149,Staff,7,0,15,8
1683667303202,LTEN 181,A00,186150,Blanco; John D,34,0,40,6
1683667304227,LTWL 120,A00,186160,Staff,20,0,25,5
1683667305251,LTWL 165,A00,186161,Staff,22,0,25,3
1683667306275,LTWR 100,A00,186162,Staff,0,5,15,15
1683667307300,LTWR 102,A00,186163,Doller; Ben,5,0,15,10
1683667308326,MAE 8,A01,186412,Staff,0,0,0,0
1683667309353,MAE 30B,A00,186445,Bahadori; Mohammad Yousef,82,0,100,18
1683667310377,MAE 40,A00,186592,Bewley; Thomas R,10,0,50,40
1683667311404,MAE 101B,A00,186593,Bahadori; Mohammad Yousef,80,0,100,20
1683667312435,MAE 105,A00,186594,Bandaru; Prabhakar,10,0,50,40
1683667313461,MAE 107,A00,186599,Pham; Hieu Tan,0,7,120,120
1683667314485,MAE 148,A01,186660,Silberman; Jack,3,0,16,13
1683667315510,MATH 10A,A01,188095,Staff,0,6,35,35
1683667316535,MATH 10B,A01,188097,Bowers; Adam R.,0,12,30,30
1683667316535,MATH 10B,A02,188099,Bowers; Adam R.,0,11,30,30
1683667316535,MATH 10B,B01,188104,Bowers; Adam R.,0,10,30,30
1683667316535,MATH 10B,B02,188106,Bowers; Adam R.,1,9,30,29
1683667317561,MATH 10C,A01,188111,Staff,0,19,30,30
1683667317561,MATH 10C,A02,188127,Staff,0,19,30,30
1683667317561,MATH 10C,A03,188131,Staff,0,19,30,30
1683667317561,MATH 10C,B01,188218,Staff,17,0,30,13
1683667317561,MATH 10C,B02,188244,Staff,13,0,30,17
1683667317561,MATH 10C,B03,188277,Staff,14,0,30,16
1683667318586,MATH 18,A01,188344,Bach; Quang Tran,18,0,30,12
1683667318586,MATH 18,A02,188345,Bach; Quang Tran,11,0,30,19
1683667318586,MATH 18,B01,188353,Bach; Quang Tran,11,0,30,19
1683667318586,MATH 18,B02,188354,Bach; Quang Tran,19,0,30,11
1683667319614,MATH 20A,A01,188374,Staff,11,0,35,24
1683667320642,MATH 20B,A01,188382,Ohm; Ko Woon,7,0,30,23
1683667320642,MATH 20B,A02,188383,Ohm; Ko Woon,22,0,30,8
1683667320642,MATH 20B,B01,188385,Ohm; Ko Woon,7,0,30,23
1683667320642,MATH 20B,B02,188392,Ohm; Ko Woon,22,0,30,8
1683667321665,MATH 20C,A01,188394,Harel; Guershon,10,0,30,20
1683667321665,MATH 20C,A02,188395,Harel; Guershon,13,0,30,17
1683667321665,MATH 20C,B01,188404,Harel; Guershon,5,0,30,25
1683667321665,MATH 20C,B02,188405,Harel; Guershon,18,0,30,12
1683667322695,MATH 20D,A01,188414,Hammock; Frances H,0,1,30,30
1683667322695,MATH 20D,A02,188415,Hammock; Frances H,0,1,30,30
1683667322695,MATH 20D,B01,188447,Hammock; Frances H,0,1,30,30
1683667322695,MATH 20D,B02,188486,Hammock; Frances H,3,0,30,27
1683667323721,MATH 20E,A01,188649,Staff,21,0,30,9
1683667323721,MATH 20E,A02,188650,Staff,21,0,30,9
1683667323721,MATH 20E,A03,188673,Staff,0,0,30,30
1683667324746,MATH 102,A01,188675,Staff,0,36,35,35
1683667325769,MATH 103B,A01,188681,Staff,3,0,35,32
1683667325769,MATH 103B,B01,188692,Staff,5,0,35,30
1683667326794,MATH 109,A01,188695,Salehi Golsefidy; Alireza,24,0,35,11
1683667326794,MATH 109,A02,188696,Salehi Golsefidy; Alireza,25,0,35,10
1683667327824,MATH 120A,A01,188698,Eggers; John Dietrich,7,0,35,28
1683667328847,MATH 142B,A01,188736,Ioana; Adrian,1,1,30,29
1683667328847,MATH 142B,A02,188741,Ioana; Adrian,0,1,30,30
1683667328847,MATH 142B,A03,188743,Ioana; Adrian,0,1,30,30
1683667329873,MATH 168A,A01,188790,Staff,0,10,35,35
1683667330902,MATH 170A,A01,188803,Nie; Jiawang,0,2,35,35
1683667330902,MATH 170A,A02,188811,Nie; Jiawang,0,0,35,35
1683667330902,MATH 170A,A03,188814,Nie; Jiawang,0,0,35,35
1683667330902,MATH 170A,A04,188815,Nie; Jiawang,8,0,35,27
1683667331931,MATH 193B,A01,188817,Staff,0,0,35,35
1683667331931,MATH 193B,A02,188818,Staff,6,0,35,29
1683667332955,MGT 4,A01,202857,Anderson; John Charles,60,0,80,20
1683667333980,MGT 12,A00,202858,Lindenberger; Wade Douglas,40,0,90,50
1683667335007,MGT 18,A00,202859,Staff,74,0,90,16
1683667336031,MGT 18GS,A00,202860,McKay; Michael J,13,0,28,15
1683667337059,MGT 45,A00,202861,Pecore; Joseph P.,11,0,90,79
1683667338084,MGT 100,A00,202863,Yavorsky; Daniel Ryan,28,0,90,62
1683667339164,MGT 103,A00,202864,Ehrich; Kristine R,0,18,90,90
1683667340187,MGT 112,A00,202865,Ehrich; Kristine R,15,0,90,75
1683667341216,MGT 121A,A00,202868,Staff,90,20,90,0
1683667342241,MGT 131B,A00,202869,Anderson; John Charles,59,0,90,31
1683667343265,MGT 136,A00,202871,Lindenberger; Wade Douglas,83,0,90,7
1683667344289,MGT 164,A00,202873,Staff,0,67,90,91
1683667345313,MGT 164GS,A00,202874,McKay; Mary A,13,0,28,15
1683667346337,MGT 180,A00,202875,Staff,0,51,90,91
1683667347364,MMW 11R,A01,205019,Herbst; Matthew,1,0,30,29
1683667347364,MMW 11R,A02,205026,Herbst; Matthew,29,0,30,1
1683667348391,MMW 15,A01,193512,Chang; Edmond Yi-Teh,0,8,28,28
1683667348391,MMW 15,A02,193513,Chang; Edmond Yi-Teh,0,5,28,28
1683667348391,MMW 15,A03,193514,Chang; Edmond Yi-Teh,0,5,28,28
1683667348391,MMW 15,A04,193515,Chang; Edmond Yi-Teh,0,5,28,28
1683667348391,MMW 15,A05,193516,Chang; Edmond Yi-Teh,0,5,28,28
1683667348391,MMW 15,A06,193517,Chang; Edmond Yi-Teh,0,6,28,28
1683667348391,MMW 15,B01,193519,Chang; Edmond Yi-Teh,0,5,28,28
1683667348391,MMW 15,B02,193520,Chang; Edmond Yi-Teh,0,5,28,28
1683667348391,MMW 15,B03,193521,Chang; Edmond Yi-Teh,0,5,28,28
1683667348391,MMW 15,B04,193522,Chang; Edmond Yi-Teh,0,5,28,28
1683667348391,MMW 15,B05,193523,Chang; Edmond Yi-Teh,0,5,28,28
1683667348391,MMW 15,B06,193524,Chang; Edmond Yi-Teh,0,5,28,28
1683667349416,MMW 122,A01,193526,Rahimi; Babak,0,16,28,28
1683667349416,MMW 122,A02,193527,Rahimi; Babak,0,15,28,28
1683667349416,MMW 122,A03,193528,Rahimi; Babak,0,0,0,0
1683667349416,MMW 122,A04,193529,Rahimi; Babak,0,0,0,0
1683667350441,MUS 1A,A01,186663,Staff,1,19,35,34
1683667351465,MUS 4,A01,186715,Staff,0,12,35,35
1683667352489,MUS 5R,A01,186796,Dubnov; Shlomo,0,17,35,35
1683667353513,MUS 6,A01,186798,Staff,0,5,25,25
1683667354537,MUS 7,A01,186830,Staff,11,0,35,24
1683667355562,MUS 8,A01,186930,Staff,0,26,35,35
1683667356587,MUS 15,A01,186932,Staff,0,15,35,35
1683667356587,MUS 15,B01,186934,Staff,1,17,35,34
1683667357611,MUS 80,A00,186935,Staff,0,0,20,20
1683667357611,MUS 80,B00,186936,Staff,24,0,25,1
1683667358636,NANO 11,A00,204702,Lipomi; Darren John,0,0,0,0
1683667359665,NANO 15,A01,204709,Yang; Kesong,0,1,0,0
1683667360689,NANO 114,A00,202069,Jahed Motlagh; Zeinab,3,0,10,7
1683667361716,PHIL 1,A00,186955,Grush; Rick Scott,31,0,40,9
1683667362739,PHIL 10,A01,186973,Grush; Rick Scott,27,0,35,8
1683667362739,PHIL 10,A02,186974,Grush; Rick Scott,33,0,35,2
1683667363766,PHIL 13,A01,186976,Staff,3,0,35,32
1683667363766,PHIL 13,A02,186977,Staff,16,0,35,19
1683667364792,PHIL 14,A01,186979,Staff,31,0,35,4
1683667364792,PHIL 14,A02,186986,Staff,32,0,35,3
1683667365815,PHIL 28,A01,186988,Staff,16,0,30,14
1683667365815,PHIL 28,A02,186989,Staff,1,0,30,29
1683667365815,PHIL 28,A03,186990,Staff,10,0,30,20
1683667365815,PHIL 28,A04,186991,Staff,26,0,30,4
1683667366839,PHIL 120,A00,186997,Staff,23,0,40,17
1683667367862,PHIL 137,A00,187003,Staff,7,0,40,33
1683667368887,PHIL 150,A00,187015,Staff,47,0,70,23
1683667369913,PHIL 167,A00,187021,Lamey; Andy M.,34,0,40,6
1683667370940,PHIL 174,A01,202226,Staff,17,0,20,3
1683667370940,PHIL 174,A02,202235,Staff,20,0,20,0
1683667371964,PHIL 191A,A00,258918,Staff,0,0,1,1
1683667372987,PHYS 1A,A00,187028,Staff,26,0,60,34
1683667374015,PHYS 1AL,001,187036,Staff,3,0,30,27
1683667374015,PHYS 1AL,002,187049,Staff,18,0,30,12
1683667375039,PHYS 1B,A00,187058,Staff,22,0,60,38
1683667376067,PHYS 1BL,001,187064,Staff,0,1,30,30
1683667376067,PHYS 1BL,002,187070,Staff,4,0,30,26
1683667377093,PHYS 1C,A00,187082,Staff,29,0,120,91
1683667378125,PHYS 1CL,001,187088,Staff,0,9,30,30
1683667378125,PHYS 1CL,002,187089,Staff,0,1,30,30
1683667378125,PHYS 1CL,009,262693,Staff,9,0,30,21
1683667379182,PHYS 2B,A01,187097,Staff,55,0,115,60
1683667380209,PHYS 2C,A01,187099,Staff,63,0,115,52
1683667381234,PHYS 2CL,A01,187101,Staff,5,0,28,23
1683667381234,PHYS 2CL,A02,187102,Staff,15,0,28,13
1683667382320,PHYS 2D,A01,187123,Shotwell; Brian,95,0,115,20
1683667383347,PHYS 4B,A01,187133,Grinstein; Benjamin,35,0,50,15
1683667384369,POLI 10,A00,188819,Staff,0,4,50,50
1683667385394,POLI 11,A00,188827,Staff,43,0,50,7
1683667386417,POLI 13R,A00,188828,Staff,0,1,20,20
1683667387441,POLI 27,A01,188830,Elgin; Samuel Zincke,0,2,70,70
1683667388468,POLI 30,A00,188832,Desposato; Scott,30,0,50,20
1683667389493,POLI 102F,A00,188834,Staff,0,0,40,40
1683667390519,POLI 104A,A00,188852,Staff,13,0,30,17
1683667391547,POLI 104I,A00,188853,Staff,0,7,20,20
1683667392570,POLI 110B,A00,188854,Wiens; David,6,0,20,14
1683667393597,POLI 112A,A00,188855,Wiens; David,3,0,30,27
1683667394620,POLI 117R,A00,188856,Forman; Fonna,0,12,20,20
1683667395648,POLI 118,A00,188857,Ingham; Sean,8,0,20,12
1683667396673,POLI 120G,A00,188858,Staff,8,0,30,22
1683667397697,POLI 131CR,A00,188863,Hoston; Germaine,21,0,50,29
1683667398725,POLI 133,A00,188864,Nellis; Gareth Hb,44,0,50,6
1683667399753,POLI 134D,A00,188865,Desposato; Scott,27,0,30,3
1683667400778,POLI 142A,A00,188871,Gartzke; Erik,21,0,50,29
1683667401802,POLI 142K,A00,188874,Staff,38,0,50,12
1683667402826,POLI 143,A00,188940,Gartzke; Erik,16,0,30,14
1683667403854,POLI 153,A00,188943,Staff,2,0,20,18
1683667404879,POLI 160AA,A00,188944,Staff,11,0,40,29
1683667405908,POLI 170A,A00,188945,Staff,11,0,30,19
1683667407979,PSYC 1,A00,188952,Staff,36,0,90,54
1683667409003,PSYC 2,B00,188953,Staff,19,0,35,16
1683667410027,PSYC 6,A00,188970,Staff,47,0,60,13
1683667411051,PSYC 7,A00,188973,Staff,35,0,45,10
1683667412076,PSYC 60,A01,188980,Rickard; Timothy C.,42,0,60,18
1683667413104,PSYC 70,A01,189001,Steiner; Eric Tomas,22,0,45,23
1683667414130,PSYC 100,A00,189005,Lacefield; Katharine I,0,99,120,120
1683667415154,PSYC 102,A00,189008,Staff,8,0,30,22
1683667416180,PSYC 106,B00,189026,Gorman; Michael R.,27,0,60,33
1683667417203,PSYC 114,B01,189033,Winkielman; Piotr,0,31,30,30
1683667418231,PSYC 131,A00,189036,Anagnostaras; Stephan,0,43,60,60
1683667419261,PSYC 136,A00,189041,Lowe; Angela Beth,0,7,25,25
1683667420324,PSYC 137,A00,189057,Winkielman; Piotr,1,37,25,24
1683667421352,PSYC 144,A00,189107,Wixted; John T,0,11,50,50
1683667423402,PSYC 162,A00,189142,Staff,0,9,85,85
1683667424429,PSYC 172,A00,189144,Gorman; Michael R.,0,6,30,30
1683667426475,PSYC 179,A00,189146,Lacefield; Katharine I,0,87,120,120
1683667427500,PSYC 181,A00,189147,Anagnostaras; Stephan,0,44,90,90
1683667428527,PSYC 190R,A00,189148,Barner; David A.,0,23,80,80
1683667429551,PSYC 191,A00,189275,Rickard; Timothy C.,0,10,25,25
1683667430579,PSYC 193,A00,189276,Chapman; Eddie Nathaniel,0,1,0,4
1683667431607,PSYC 193L,A01,189281,Lowe; Angela Beth,10,0,20,10
1683667431607,PSYC 193L,B01,189285,Staff,28,0,35,7
1683667432632,RELI 149,A00,187137,Rahimi; Babak,7,0,40,33
1683667433660,SE 9,A01,187315,Staff,0,2,18,18
1683667434685,SE 101B,A00,187409,Staff,24,0,30,6
1683667435708,SE 110B,A00,187444,Staff,10,0,40,30
1683667436731,SE 130B,A00,187449,Staff,31,0,40,9
1683667437761,SE 150A,A00,187516,Staff,8,0,20,12
1683667438788,SE 154,A00,187528,Staff,29,0,50,21
1683667439812,SIO 3,A01,258171,Staff,35,0,40,5
1683667440837,SIO 10,A00,187144,Cook; Geoffrey W,0,7,75,75
1683667441859,SIO 45,A00,187152,Cook; Geoffrey W,0,5,100,100
1683667442891,SIO 109R,A00,194486,Staff,0,4,20,20
1683667444944,SIO 187,A01,187233,Kacev; David,12,0,40,28
1683667445973,SOCI 1,A01,258656,Thorpe; Charles Robert,28,0,30,2
1683667445973,SOCI 1,A02,258658,Thorpe; Charles Robert,30,0,30,0
1683667445973,SOCI 1,A03,258661,Thorpe; Charles Robert,25,0,25,0
1683667445973,SOCI 1,A04,258666,Thorpe; Charles Robert,22,0,25,3
1683667445973,SOCI 1,A05,258897,Thorpe; Charles Robert,22,0,25,3
1683667445973,SOCI 1,A06,258898,Thorpe; Charles Robert,25,0,25,0
1683667446999,SOCI 30,A01,258903,Pardo Guerra; Juan Pablo,14,0,30,16
1683667448026,SOCI 102,A00,258904,Staff,9,0,25,16
1683667449050,SOCI 106,A00,258905,Staff,19,0,25,6
1683667450073,SOCI 111,A00,258907,Ribas Norris; Janet Vanesa,26,0,30,4
1683667451103,SOCI 121R,A00,258908,Pardo Guerra; Juan Pablo,8,0,30,22
1683667452125,SOCI 126,A01,203330,Staff,14,0,20,6
1683667453151,SOCI 131,A00,258909,Thorpe; Charles Robert,30,0,60,30
1683667454175,SOCI 135,A00,258910,Payne; Christine Anna,0,11,30,30
1683667455201,SOCI 157,A00,258911,Staff,12,0,30,18
1683667456226,SOCI 184,A00,258912,Staff,25,0,30,5
1683667457250,SOCI 188D,A00,258913,Staff,22,0,30,8
1683667458277,SYN 2,001,187529,Staff,9,0,16,7
1683667458277,SYN 2,002,201452,Staff,0,20,16,16
1683667458277,SYN 2,003,201469,Staff,1,0,16,15
1683667459301,SYN 100,A01,187531,Staff,0,9,20,20
1683667459301,SYN 100,B01,201491,Staff,0,10,20,20
1683667460326,TDAC 1,A00,189286,Walsh; Kim C.,3,0,20,17
1683667460326,TDAC 1,B00,189287,Harting; Carla Kelso,10,0,20,10
1683667461349,TDAC 101,A00,189300,Walsh; Kim C.,16,0,20,4
1683667461349,TDAC 101,B00,189301,Harting; Carla Kelso,18,0,20,2
1683667462381,TDAC 102,A00,189304,Basso; Beatrice,14,0,20,6
1683667463408,TDAC 108,A00,189305,Staff,18,0,20,2
1683667464435,TDDE 131,A00,189310,Staff,19,0,20,1
1683667464435,TDDE 131,B00,189314,Staff,19,0,20,1
1683667464435,TDDE 131,C00,189315,Staff,48,0,50,2
1683667464435,TDDE 131,D00,189316,Staff,14,0,15,1
1683667464435,TDDE 131,E00,204841,Staff,20,0,20,0
1683667465459,TDGE 10,A00,189289,Staff,27,0,50,23
1683667465459,TDGE 10,B00,189290,Havis; Allan,0,1,50,50
1683667466485,TDGE 11,A00,189291,Fulton; Julia,0,4,50,50
1683667466485,TDGE 11,B00,189292,Staff,20,0,25,5
1683667466485,TDGE 11,C00,260270,Staff,0,0,0,0
1683667467511,TDGE 25,A00,189294,Staff,2,0,20,18
1683667468535,TDGE 124,A00,189318,Fulton; Julia,0,8,50,50
1683667469560,TDGE 125,A00,189319,Staff,13,0,25,12
1683667469560,TDGE 125,B00,189320,Staff,23,0,25,2
1683667470586,TDGE 127,A00,189322,Havis; Allan,1,0,50,49
1683667471611,TDHT 101,A00,189323,Staff,18,0,25,7
1683667471611,TDHT 101,B00,189324,Staff,25,0,25,0
1683667472637,TDHT 102,A00,189325,Staff,49,0,50,1
1683667473666,TDMV 1,A00,189295,Arcidiacono; Kristin,20,0,30,10
1683667473666,TDMV 1,B00,189296,Caligagan; Maria T.,24,0,30,6
1683667474691,TDMV 2,A00,189297,Sammartano; Tonnie,27,0,30,3
1683667474691,TDMV 2,B00,189299,Arcidiacono; Kristin,23,0,30,7
1683667475717,TDMV 3,A00,204998,Rincon; Alicia,22,0,30,8
1683667476740,TDMV 120,A00,189458,Sammartano; Tonnie,28,0,30,2
1683667477764,TDMV 138,A00,189541,Jun; Grace Shin Hae,20,0,40,20
1683667478792,TDMV 142,A00,189717,Caligagan; Tony,25,0,30,5
1683667478792,TDMV 142,B00,189718,Caligagan; Maria T.,25,0,30,5
1683667479821,TMC 2,A01,187533,Staff,25,0,25,0
1683667479821,TMC 2,A02,187534,Staff,25,0,25,0
1683667480848,USP 1,A01,187536,Kwak; Nancy,0,16,25,25
1683667481875,USP 5,A01,187538,Staff,9,0,25,16
1683667482902,USP 101,A00,199253,Staff,0,4,0,0
1683667483927,USP 124,A00,187562,Boomhower; Matthew Charles,0,0,30,30
1683667484950,USP 138,A00,187582,Staff,20,0,25,5
1683667486032,USP 152,A01,187597,Staff,3,0,25,22
1683667487057,USP 153,A00,187598,Staff,19,0,25,6
1683667488085,USP 168,A00,187607,Kwak; Nancy,2,0,5,3
1683667489110,USP 173,A00,187619,Staff,4,0,25,21
1683667490134,USP 181,A00,187638,Staff,0,4,25,25
1683667491158,VIS 103,A00,187650,Cruz; Edwin Teddy,17,0,75,58
1683667492181,VIS 110D,A00,187669,Staff,13,0,22,9
1683667493208,VIS 127C,A00,187720,Shen; Kuiyi,68,0,146,78
1683667494235,VIS 149,A00,187731,Yoldas; Pinar,1,14,22,21
1683667495261,VIS 151,A01,188091,Staff,22,0,34,12
1683667495261,VIS 151,A02,188092,Staff,11,0,34,23
1683667496286,VIS 160B,A00,188093,Stalbaum; Brett,0,1,10,10
1683667498335,WCWP 10B,A00,201720,Staff,10,0,15,5
1683667498335,WCWP 10B,B00,201722,Staff,9,0,15,6
1683667499359,WCWP 100,A00,201725,Gagnon; Jeffrey C,0,0,2,2
1683667499359,WCWP 100,B00,201727,Staff,0,4,15,15
1683667502491,ANBI 133,A00,258401,Wilder; Linnea Lorene,34,0,40,6
1683667503519,ANBI 140,A00,258395,Hrvoj Mihic; Branka,18,0,25,7
1683667504544,ANSC 120,A00,258402,Bialecki; Jon Anthony,26,0,40,14
1683667505571,ANSC 144,A00,258400,Staff,12,0,40,28
1683667507623,ANSC 166,A00,258396,Parish; Steven Martin,156,0,175,19
1683667508648,ANSC 180,A00,193533,Staff,8,0,20,12
1683667509672,ANSC 188,A00,258397,Jassal; Aftab,34,0,40,6
1683667510696,ANTH 3,A01,258316,Staff,23,0,30,7
1683667511721,ANTH 5,A00,258394,Semendeferi; Ekaterini,16,0,20,4
1683667512745,ANTH 21,A01,258331,Staff,4,0,40,36
1683667513774,ANTH 103,A00,258398,Varma; Saiba,15,0,25,10
1683667514800,AWP 10,001,202034,Staff,0,0,0,0
1683667514800,AWP 10,002,202035,Staff,0,0,0,0
1683667514800,AWP 10,003,202036,Staff,0,0,0,0
1683667514800,AWP 10,004,202037,Staff,0,0,0,0
1683667514800,AWP 10,005,202038,Staff,0,0,0,0
1683667514800,AWP 10,006,202039,Staff,0,0,0,0
1683667514800,AWP 10,007,202040,Staff,0,0,0,0
1683667514800,AWP 10,008,202041,Staff,0,0,0,0
1683667514800,AWP 10,009,202042,Staff,0,0,0,0
1683667514800,AWP 10,010,202043,Staff,0,0,0,0
1683667514800,AWP 10,011,202044,Staff,0,0,0,0
1683667514800,AWP 10,012,202045,Staff,0,0,0,0
1683667514800,AWP 10,013,202046,Staff,0,0,0,0
1683667514800,AWP 10,014,202047,Staff,0,0,0,0
1683667514800,AWP 10,015,202048,Staff,0,0,0,0
1683667514800,AWP 10,016,202049,Staff,0,0,0,0
1683667514800,AWP 10,017,202050,Staff,0,0,0,0
1683667514800,AWP 10,018,202051,Staff,0,0,0,0
1683667514800,AWP 10,019,202052,Staff,0,0,0,0
1683667514800,AWP 10,020,202053,Staff,0,0,0,0
1683667514800,AWP 10,021,202054,Staff,0,0,0,0
1683667514800,AWP 10,022,202055,Staff,0,0,0,0
1683667514800,AWP 10,023,202056,Staff,0,0,0,0
1683667514800,AWP 10,024,202057,Staff,0,0,0,0
1683667514800,AWP 10,025,202058,Staff,0,0,0,0
1683667514800,AWP 10,026,202059,Staff,0,0,0,0
1683667515824,AWP 102,001,202032,Staff,0,0,0,0
1683667515824,AWP 102,002,202033,Staff,0,0,0,0
1683667516854,BENG 100,A01,254234,Taylor Amos; Alyssa C,31,0,40,9
1683667517878,BENG 196,001,270013,Engler; Adam J.,9999,0,9999,0
1683667518902,BICD 100R,A01,202018,Smith; Laurie,0,7,32,32
1683667518902,BICD 100R,A02,202019,Smith; Laurie,0,3,32,32
1683667518902,BICD 100R,A03,202020,Smith; Laurie,0,1,32,32
1683667518902,BICD 100R,A04,202021,Smith; Laurie,6,0,32,26
1683667518902,BICD 100R,A05,202022,Smith; Laurie,11,0,32,21
1683667519930,BICD 136,A01,193242,Gustafson-Brown; Cindy,0,2,32,32
1683667519930,BICD 136,A02,193244,Gustafson-Brown; Cindy,13,0,32,19
1683667520956,BIEB 102,A01,193249,Butler; Shannon Rhey,1,2,32,31
1683667520956,BIEB 102,A02,193251,Butler; Shannon Rhey,0,0,32,32
1683667520956,BIEB 102,A03,193253,Butler; Shannon Rhey,0,0,32,32
1683667520956,BIEB 102,A04,193255,Butler; Shannon Rhey,14,0,32,18
1683667520956,BIEB 102,A05,193265,Butler; Shannon Rhey,25,0,32,7
1683667520956,BIEB 102,A06,193269,Butler; Shannon Rhey,14,0,32,18
1683667523006,BIEB 150,A01,193274,Staff,0,0,32,32
1683667523006,BIEB 150,A02,193285,Staff,24,0,32,8
1683667524033,BIEB 194,A00,193286,Kurle; Carolyn M.,20,0,32,12
1683667525058,BILD 1,A01,192291,Staff,15,0,32,17
1683667525058,BILD 1,A02,192292,Staff,30,0,32,2
1683667525058,BILD 1,B01,192520,Reuther; Keefe,0,1,0,0
1683667525058,BILD 1,B02,192532,Reuther; Keefe,0,1,0,0
1683667526086,BILD 3,A01,192556,Butler; Shannon Rhey,0,0,32,32
1683667526086,BILD 3,A02,192581,Butler; Shannon Rhey,0,0,32,32
1683667526086,BILD 3,A03,192611,Butler; Shannon Rhey,20,0,32,12
1683667526086,BILD 3,A04,192612,Butler; Shannon Rhey,24,0,32,8
1683667526086,BILD 3,A05,192613,Butler; Shannon Rhey,26,0,32,6
1683667526086,BILD 3,A06,192679,Butler; Shannon Rhey,27,0,32,5
1683667526086,BILD 3,A07,192682,Butler; Shannon Rhey,20,0,32,12
1683667527114,BILD 4,A01,192836,Reuther; Keefe,1,0,24,23
1683667527114,BILD 4,A02,193044,Reuther; Keefe,4,0,24,20
1683667528137,BILD 10,A01,193142,Gustafson-Brown; Cindy,29,0,32,3
1683667528137,BILD 10,A02,193149,Gustafson-Brown; Cindy,31,0,32,1
1683667529161,BIMM 100,A01,193301,Staff,0,6,32,32
1683667529161,BIMM 100,A02,193312,Staff,0,7,32,32
1683667529161,BIMM 100,A03,193323,Staff,0,9,32,32
1683667530190,BIMM 101,A01,193329,McDonnell; Lisa Marie,1,4,24,23
1683667530190,BIMM 101,A02,193339,McDonnell; Lisa Marie,1,4,24,23
1683667530190,BIMM 101,B01,193354,McDonnell; Lisa Marie,0,4,24,24
1683667530190,BIMM 101,B02,193357,McDonnell; Lisa Marie,0,3,24,24
1683667531214,BIMM 110,A01,193377,Tat; John,0,11,32,32
1683667531214,BIMM 110,A02,193378,Tat; John,0,10,32,32
1683667532242,BIMM 120,A01,206116,Staff,0,0,32,32
1683667532242,BIMM 120,A02,206117,Staff,6,0,32,26
1683667532242,BIMM 120,A03,206121,Staff,21,0,32,11
1683667533266,BIPN 100,A01,193393,Park; Ji Young,0,15,32,32
1683667533266,BIPN 100,A02,193402,Park; Ji Young,0,14,32,32
1683667533266,BIPN 100,A03,193413,Park; Ji Young,0,14,32,32
1683667533266,BIPN 100,A04,193414,Park; Ji Young,0,13,32,32
1683667534290,BIPN 102,A01,193429,Staff,0,0,32,32
1683667534290,BIPN 102,A02,193438,Staff,18,0,32,14
1683667535315,BIPN 106,A01,193450,Reyes Gonzalez; Catalina,0,2,40,40
1683667536344,BIPN 134,A01,193465,Cooke; James Edward,0,0,32,32
1683667536344,BIPN 134,A02,193474,Cooke; James Edward,25,0,32,7
1683667536344,BIPN 134,A03,193485,Cooke; James Edward,29,0,32,3
1683667536344,BIPN 134,A04,193486,Cooke; James Edward,20,0,32,12
1683667536344,BIPN 134,A05,193491,Cooke; James Edward,31,0,32,1
1683667536344,BIPN 134,A06,193501,Cooke; James Edward,30,0,32,2
1683667536344,BIPN 134,A07,193510,Cooke; James Edward,29,0,32,3
1683667538394,BISP 194,A00,222522,Staff,14,0,32,18
1683667539423,CAT 124,A01,202407,Staff,19,0,25,6
1683667540450,CAT 125,A00,202408,Marchisotto; Jennifer Anne,2,0,20,18
1683667541475,CAT 125R,A00,202409,Smith; Lauryn Alissa,0,11,20,20
1683667541475,CAT 125R,B00,202410,Morales; Celeste Georgianna,0,11,20,20
1683667541475,CAT 125R,C00,202411,Irwin; Matthew Joseph,0,12,20,20
1683667542502,CENG 15,A01,204712,Yang; Kesong,0,1,0,0
1683667543530,CENG 114,A00,202070,Jahed Motlagh; Zeinab,5,0,20,15
1683667544555,CGS 105,A00,185477,Wesling; Megan E.,24,0,40,16
1683667545583,CGS 106,A00,185494,Staff,11,0,22,11
1683667546604,CGS 108,A00,185495,Staff,14,0,20,6
1683667547629,CGS 114,A00,185496,Staff,13,0,18,5
1683667548653,CGS 119,A00,185501,Staff,15,0,20,5
1683667549680,CGS 120,A00,185511,Staff,12,0,20,8
1683667550705,CHEM 4,A01,184675,Bussey; Thomas J,97,0,100,3
1683667551734,CHEM 6A,A01,184677,Staff,32,0,60,28
1683667552759,CHEM 6B,A01,184679,Staff,63,0,100,37
1683667553784,CHEM 6C,A01,184681,Bussey; Thomas J,0,0,50,50
1683667553784,CHEM 6C,A02,184682,Bussey; Thomas J,32,0,50,18
1683667554808,CHEM 40A,A01,184684,Albizati; Kim F.,34,0,100,66
1683667555834,CHEM 40B,A01,184686,Albizati; Kim F.,0,22,100,100
1683667556858,CHEM 41B,A01,184690,Staff,51,0,100,49
1683667557883,COGS 3,A01,184715,Boyle; Mary E. T.,0,27,40,40
1683667558913,COGS 14B,A01,185172,Staff,0,14,38,38
1683667559941,COGS 18,A01,184736,Staff,14,0,80,66
1683667560969,COGS 100,A01,184932,Staff,0,8,73,73
1683667561996,COGS 101A,A01,184935,Staff,0,40,30,30
1683667563024,COGS 101B,A01,184944,Staff,0,2,30,30
1683667564049,COGS 101C,A01,184946,Staff,0,10,30,30
1683667565078,COGS 102A,A01,184951,Johnson; Christine M.,2,0,40,38
1683667566104,COGS 107B,A01,184953,Mooshagian; Eric Frederick,0,51,40,40
1683667567130,COGS 118B,A01,184959,Gupta; Anjum,0,50,40,40
1683667568153,COGS 153,A00,184961,Staff,0,16,30,30
1683667569183,COGS 177,A00,184962,Staff,0,21,30,30
1683667570212,COGS 187A,A01,184969,Boyle; Mary E. T.,0,19,40,40
1683667571239,COMM 10,A01,185174,Staff,0,5,25,25
1683667571239,COMM 10,A02,185189,Staff,0,2,25,25
1683667571239,COMM 10,A03,269821,Staff,0,1,0,0
1683667572266,COMM 100B,A01,185475,Staff,0,1,0,2
1683667572266,COMM 100B,A02,185476,Staff,12,0,25,13
1683667573293,COMM 100C,A01,185314,Staff,1,0,25,24
1683667573293,COMM 100C,A02,185327,Staff,18,0,25,7
1683667574317,COMM 110M,A00,185349,Staff,0,0,40,40
1683667575341,COMM 113T,A00,185352,Staff,25,0,40,15
1683667576368,COMM 114I,A00,185353,Staff,31,0,40,9
1683667577395,COMM 131,A00,185354,Staff,17,0,30,13
1683667578420,CSE 8A,A50,185358,Cao; Yingjun,0,46,10,10
1683667579448,CSE 8B,A01,185362,Staff,0,48,50,50
1683667580472,CSE 11,A01,185416,Cao; Yingjun,0,91,10,10
1683667581496,CSE 20,A01,185445,Briones; Jor-el Thomas Caparas,4,0,25,21
1683667582526,CSE 21,A01,185447,Staff,9,0,50,41
1683667583553,CSE 101,A01,185451,Staff,0,13,50,50
1683667583553,CSE 101,B01,185453,Jones; Miles E,0,14,50,50
1683667585603,CSE 141,A01,185458,Eldon; John,16,0,100,84
1683667586630,CSE 141L,A01,185461,Eldon; John,8,0,100,92
1683667587659,CSE 142,A01,185463,Staff,34,0,60,26
1683667587659,CSE 142,B01,201355,Staff,0,7,60,60
1683667588685,CSE 142L,A01,185470,Staff,34,0,60,26
1683667588685,CSE 142L,B01,201417,Staff,0,6,60,60
1683667589777,CSE 190,A00,201433,Staff,32,0,49,17
1683667590801,DOC 1,A01,259136,Strom; Megan C.,7,0,15,8
1683667590801,DOC 1,A02,259137,Strom; Megan C.,14,0,15,1
1683667590801,DOC 1,A03,259138,Strom; Megan C.,14,0,15,1
1683667590801,DOC 1,A04,259139,Strom; Megan C.,14,0,15,1
1683667591825,DOC 100D,A00,259140,Pass; Natalye Joann,14,0,25,11
1683667592852,DSGN 1,A01,184749,Rill; Bryan,0,26,30,30
1683667593885,DSGN 100,A01,185168,Staff,0,2,25,25
1683667594913,ECE 5,A01,185626,Morris; Karcher William,0,12,0,0
1683667595940,ECE 101,A01,185628,Staff,14,0,70,56
1683667596965,ECE 107,A01,185635,Baghdadchi; Saharnaz,0,0,20,20
1683667596965,ECE 107,A02,185638,Baghdadchi; Saharnaz,1,0,20,19
1683667597988,ECE 148,A01,185647,Silberman; Jack,0,0,16,16
1683667599014,ECON 1,A01,185537,Crane; Meredith Helen,54,0,70,16
1683667600038,ECON 3,A01,185549,Crane; Meredith Helen,29,0,70,41
1683667601066,ECON 4,A01,203354,Anderson; John Charles,0,5,10,10
1683667602093,ECON 100A,A01,185574,Staff,0,5,40,40
1683667603121,ECON 100B,A01,185576,Staff,0,12,50,50
1683667604149,ECON 100C,A01,185589,Newhouse; Herbert S,30,0,70,40
1683667605174,ECON 105,A00,185608,Vespa; Emanuel Ignacio,19,0,35,16
1683667606198,ECON 109,A01,185610,Shishkin; Denis,9,0,35,26
1683667607225,ECON 110A,A01,185612,Staff,9,0,40,31
1683667608250,ECON 120A,A01,185615,Staff,19,0,40,21
1683667609275,ECON 120C,A01,185617,Sun; Yixiao,0,20,70,70
1683667610303,ECON 144,A00,203346,Squires; Dale E,2,0,35,33
1683667611328,ECON 171,A01,203349,Newhouse; Herbert S,0,1,35,35
1683667612358,ECON 173A,A01,185621,Toda; Alexis Akira,20,0,35,15
1683667613386,EDS 25,A01,202413,Staff,0,1,0,0
1683667613386,EDS 25,A02,202414,Staff,0,1,0,0
1683667613386,EDS 25,A03,202415,Staff,0,0,0,0
1683667613386,EDS 25,A04,202416,Staff,0,1,0,0
1683667613386,EDS 25,A05,202439,Staff,0,0,0,0
1683667613386,EDS 25,A06,202440,Staff,0,0,0,0
1683667613386,EDS 25,B01,202631,Staff,0,0,0,0
1683667613386,EDS 25,B02,202632,Staff,0,0,0,0
1683667613386,EDS 25,B03,202639,Staff,0,0,0,0
1683667613386,EDS 25,B04,202640,Staff,0,0,0,0
1683667613386,EDS 25,B05,202643,Staff,0,0,0,0
1683667613386,EDS 25,B06,202644,Staff,0,0,0,0
1683667614411,EDS 38,A01,202659,Black; Alison Michelle,24,0,25,1
1683667615435,EDS 115,A00,202652,Staff,18,0,30,12
1683667616459,EDS 125,A00,202649,Staff,13,0,30,17
1683667617485,EDS 126,A01,203332,Staff,30,0,30,0
1683667618510,EDS 139,A00,202838,Staff,16,0,25,9
1683667619536,EDS 146,A01,202655,Staff,14,0,25,11
1683667620560,ENG 15,A00,185667,Staff,0,1,0,0
1683667620560,ENG 15,B00,185672,Staff,0,0,0,0
1683667620560,ENG 15,C00,185675,Staff,0,0,0,0
1683667620560,ENG 15,D00,185682,Staff,0,0,0,0
1683667620560,ENG 15,E00,185684,Staff,0,0,0,0
1683667621593,ETHN 103,A00,185710,Staff,0,8,35,35
1683667622618,ETHN 103A,A00,199228,Man; Simeon S,0,0,9,9
1683667623645,ETHN 109,A00,185711,Staff,15,0,35,20
1683667624669,ETHN 142,A00,185726,Staff,0,4,30,30
1683667625695,ETHN 163J,A00,199229,Man; Simeon S,5,0,8,3
1683667626723,ETHN 168,A00,185727,Staff,7,0,10,3
1683667627750,ETHN 182,A00,185728,Staff,0,0,35,35
1683667628775,ETHN 183,A00,185737,Staff,9,0,18,9
1683667629800,GLBH 111,A01,209361,Burgos; Jose L.,0,0,0,0
1683667631849,HIEU 104,A00,185792,Staff,14,0,20,6
1683667632874,HIEU 115,A00,185800,Staff,0,0,20,20
1683667633903,HIEU 128,A00,185801,Staff,0,9,20,20
1683667634927,HIEU 147,A00,185802,Staff,15,0,20,5
1683667635951,HIEU 154,A00,185823,Staff,11,0,20,9
1683667636975,HILA 102,A00,185826,Staff,14,0,20,6
1683667638003,HILD 2C,A01,185778,Staff,0,13,20,20
1683667639030,HILD 7B,A01,185780,Kwak; Nancy,0,17,32,32
1683667639030,HILD 7B,A02,185781,Kwak; Nancy,0,18,32,32
1683667640058,HILD 30,A01,185791,Staff,12,0,20,8
1683667641082,HISC 119,A00,185830,Golan; Tal,0,9,20,20
1683667642105,HITO 156GS,A00,185831,Patterson; Patrick H.,0,0,0,23
1683667643133,HIUS 103,A00,185832,Man; Simeon S,0,4,20,20
1683667644160,HIUS 117,A00,185836,Kwak; Nancy,2,0,20,18
1683667645184,HIUS 125,A00,185840,Man; Simeon S,0,2,23,23
1683667646208,HIUS 149,A00,185845,Staff,1,0,20,19
1683667647237,HUM 3,A01,185882,Zavodny; Tatiana Sophia,0,8,50,50
1683667647237,HUM 3,B01,185899,Caldwell; Michael Alan,0,18,50,50
1683667648259,HUM 3GS,A00,185900,Patterson; Patrick H.,0,0,0,23
1683667649284,HUM 4,A01,185938,Zroka; Amy Liane,29,0,50,21
1683667649284,HUM 4,B01,185956,Watkins; Eric,0,5,50,50
1683667649284,HUM 4,B02,202209,Watkins; Eric,0,5,50,50
1683667649284,HUM 4,B03,202210,Watkins; Eric,0,5,50,50
1683667650309,HUM 5,A01,185958,West; Geoffrey Scott,0,0,50,50
1683667650309,HUM 5,A02,202215,West; Geoffrey Scott,0,0,50,50
1683667651334,INTL 190,A00,185959,Gagnon; Jeffrey C,0,0,0,9
1683667651334,INTL 190,B00,185960,Lettieri; Michael Joseph,0,0,0,2
1683667652359,JAPN 180,A00,254509,Staff,5,0,30,25
1683667653383,LATI 10,A01,202853,Kennemore; Amy Michelle,4,0,35,31
1683667653383,LATI 10,A02,202854,Kennemore; Amy Michelle,2,0,35,33
1683667653383,LATI 10,A03,270054,Kennemore; Amy Michelle,30,0,30,0
1683667654406,LATI 180,A00,202855,Kennemore; Amy Michelle,11,0,20,9
1683667655433,LAWS 101,A00,201767,Golan; Tal,0,7,40,40
1683667656457,LIFR 1C,A00,185961,Staff,6,0,20,14
1683667657481,LIFR 1CX,A00,185962,Staff,7,0,20,13
1683667658508,LIFR 1D,A00,185963,Staff,7,0,20,13
1683667659532,LIFR 1DX,A00,185964,Staff,7,0,20,13
1683667660556,LIGN 101,A01,186039,Staff,43,0,50,7
1683667661583,LIGN 165,A00,186040,Staff,15,0,50,35
1683667662613,LTCS 108,A00,186041,Staff,5,0,10,5
1683667663636,LTCS 119,A00,186042,Staff,15,0,20,5
1683667664661,LTCS 130,A00,186043,Wesling; Megan E.,15,0,25,10
1683667666710,LTEA 138,A00,186119,Staff,14,0,40,26
1683667667734,LTEN 124,A00,186148,Staff,5,0,25,20
1683667668758,LTEN 178,A00,186149,Staff,7,0,15,8
1683667669786,LTEN 181,A00,186150,Blanco; John D,34,0,40,6
1683667670810,LTWL 120,A00,186160,Staff,19,0,25,6
1683667671836,LTWL 165,A00,186161,Staff,22,0,25,3
1683667672860,LTWR 100,A00,186162,Staff,0,5,15,15
1683667673884,LTWR 102,A00,186163,Doller; Ben,5,0,15,10
1683667674908,MAE 8,A01,186412,Staff,0,0,0,0
1683667675932,MAE 30B,A00,186445,Bahadori; Mohammad Yousef,82,0,100,18
1683667676959,MAE 40,A00,186592,Bewley; Thomas R,10,0,50,40
1683667677986,MAE 101B,A00,186593,Bahadori; Mohammad Yousef,80,0,100,20
1683667679011,MAE 105,A00,186594,Bandaru; Prabhakar,10,0,50,40
1683667680037,MAE 107,A00,186599,Pham; Hieu Tan,0,7,120,120
1683667681061,MAE 148,A01,186660,Silberman; Jack,3,0,16,13
1683667682086,MATH 10A,A01,188095,Staff,0,6,35,35
1683667683110,MATH 10B,A01,188097,Bowers; Adam R.,0,12,30,30
1683667683110,MATH 10B,A02,188099,Bowers; Adam R.,0,11,30,30
1683667683110,MATH 10B,B01,188104,Bowers; Adam R.,0,10,30,30
1683667683110,MATH 10B,B02,188106,Bowers; Adam R.,1,9,30,29
1683667684135,MATH 10C,A01,188111,Staff,0,19,30,30
1683667684135,MATH 10C,A02,188127,Staff,0,19,30,30
1683667684135,MATH 10C,A03,188131,Staff,0,19,30,30
1683667684135,MATH 10C,B01,188218,Staff,17,0,30,13
1683667684135,MATH 10C,B02,188244,Staff,13,0,30,17
1683667684135,MATH 10C,B03,188277,Staff,14,0,30,16
1683667685161,MATH 18,A01,188344,Bach; Quang Tran,18,0,30,12
1683667685161,MATH 18,A02,188345,Bach; Quang Tran,11,0,30,19
1683667685161,MATH 18,B01,188353,Bach; Quang Tran,11,0,30,19
1683667685161,MATH 18,B02,188354,Bach; Quang Tran,19,0,30,11
1683667686189,MATH 20A,A01,188374,Staff,11,0,35,24
1683667687213,MATH 20B,A01,188382,Ohm; Ko Woon,7,0,30,23
1683667687213,MATH 20B,A02,188383,Ohm; Ko Woon,22,0,30,8
1683667687213,MATH 20B,B01,188385,Ohm; Ko Woon,7,0,30,23
1683667687213,MATH 20B,B02,188392,Ohm; Ko Woon,22,0,30,8
1683667688237,MATH 20C,A01,188394,Harel; Guershon,10,0,30,20
1683667688237,MATH 20C,A02,188395,Harel; Guershon,13,0,30,17
1683667688237,MATH 20C,B01,188404,Harel; Guershon,5,0,30,25
1683667688237,MATH 20C,B02,188405,Harel; Guershon,18,0,30,12
1683667689261,MATH 20D,A01,188414,Hammock; Frances H,0,1,30,30
1683667689261,MATH 20D,A02,188415,Hammock; Frances H,0,1,30,30
1683667689261,MATH 20D,B01,188447,Hammock; Frances H,0,1,30,30
1683667689261,MATH 20D,B02,188486,Hammock; Frances H,3,0,30,27
1683667690288,MATH 20E,A01,188649,Staff,21,0,30,9
1683667690288,MATH 20E,A02,188650,Staff,21,0,30,9
1683667690288,MATH 20E,A03,188673,Staff,0,0,30,30
1683667691315,MATH 102,A01,188675,Staff,0,36,35,35
1683667692341,MATH 103B,A01,188681,Staff,3,0,35,32
1683667692341,MATH 103B,B01,188692,Staff,5,0,35,30
1683667693422,MATH 109,A01,188695,Salehi Golsefidy; Alireza,24,0,35,11
1683667693422,MATH 109,A02,188696,Salehi Golsefidy; Alireza,25,0,35,10
1683667694450,MATH 120A,A01,188698,Eggers; John Dietrich,7,0,35,28
1683667695478,MATH 142B,A01,188736,Ioana; Adrian,1,1,30,29
1683667695478,MATH 142B,A02,188741,Ioana; Adrian,0,1,30,30
1683667695478,MATH 142B,A03,188743,Ioana; Adrian,0,1,30,30
1683667696505,MATH 168A,A01,188790,Staff,0,10,35,35
1683667697534,MATH 170A,A01,188803,Nie; Jiawang,0,2,35,35
1683667697534,MATH 170A,A02,188811,Nie; Jiawang,0,0,35,35
1683667697534,MATH 170A,A03,188814,Nie; Jiawang,0,0,35,35
1683667697534,MATH 170A,A04,188815,Nie; Jiawang,8,0,35,27
1683667698562,MATH 193B,A01,188817,Staff,0,0,35,35
1683667698562,MATH 193B,A02,188818,Staff,6,0,35,29
1683667699586,MGT 4,A01,202857,Anderson; John Charles,60,0,80,20
1683667700614,MGT 12,A00,202858,Lindenberger; Wade Douglas,40,0,90,50
1683667701636,MGT 18,A00,202859,Staff,74,0,90,16
1683667702662,MGT 18GS,A00,202860,McKay; Michael J,13,0,28,15
1683667703689,MGT 45,A00,202861,Pecore; Joseph P.,11,0,90,79
1683667704713,MGT 100,A00,202863,Yavorsky; Daniel Ryan,28,0,90,62
1683667705740,MGT 103,A00,202864,Ehrich; Kristine R,0,18,90,90
1683667706766,MGT 112,A00,202865,Ehrich; Kristine R,15,0,90,75
1683667707789,MGT 121A,A00,202868,Staff,90,20,90,0
1683667708815,MGT 131B,A00,202869,Anderson; John Charles,59,0,90,31
1683667709841,MGT 136,A00,202871,Lindenberger; Wade Douglas,83,0,90,7
1683667710865,MGT 164,A00,202873,Staff,0,67,90,91
1683667711892,MGT 164GS,A00,202874,McKay; Mary A,13,0,28,15
1683667712920,MGT 180,A00,202875,Staff,0,51,90,91
1683667713942,MMW 11R,A01,205019,Herbst; Matthew,1,0,30,29
1683667713942,MMW 11R,A02,205026,Herbst; Matthew,29,0,30,1
1683667714966,MMW 15,A01,193512,Chang; Edmond Yi-Teh,0,8,28,28
1683667714966,MMW 15,A02,193513,Chang; Edmond Yi-Teh,0,5,28,28
1683667714966,MMW 15,A03,193514,Chang; Edmond Yi-Teh,0,5,28,28
1683667714966,MMW 15,A04,193515,Chang; Edmond Yi-Teh,0,5,28,28
1683667714966,MMW 15,A05,193516,Chang; Edmond Yi-Teh,0,5,28,28
1683667714966,MMW 15,A06,193517,Chang; Edmond Yi-Teh,0,6,28,28
1683667714966,MMW 15,B01,193519,Chang; Edmond Yi-Teh,0,5,28,28
1683667714966,MMW 15,B02,193520,Chang; Edmond Yi-Teh,0,5,28,28
1683667714966,MMW 15,B03,193521,Chang; Edmond Yi-Teh,0,5,28,28
1683667714966,MMW 15,B04,193522,Chang; Edmond Yi-Teh,0,5,28,28
1683667714966,MMW 15,B05,193523,Chang; Edmond Yi-Teh,0,5,28,28
1683667714966,MMW 15,B06,193524,Chang; Edmond Yi-Teh,0,5,28,28
1683667715993,MMW 122,A01,193526,Rahimi; Babak,0,16,28,28
1683667715993,MMW 122,A02,193527,Rahimi; Babak,0,15,28,28
1683667715993,MMW 122,A03,193528,Rahimi; Babak,0,0,0,0
1683667715993,MMW 122,A04,193529,Rahimi; Babak,0,0,0,0
1683667717019,MUS 1A,A01,186663,Staff,1,19,35,34
1683667718044,MUS 4,A01,186715,Staff,0,12,35,35
1683667719071,MUS 5R,A01,186796,Dubnov; Shlomo,0,17,35,35
1683667720094,MUS 6,A01,186798,Staff,0,5,25,25
1683667721118,MUS 7,A01,186830,Staff,11,0,35,24
1683667722147,MUS 8,A01,186930,Staff,0,26,35,35
1683667723174,MUS 15,A01,186932,Staff,0,15,35,35
1683667723174,MUS 15,B01,186934,Staff,1,17,35,34
1683667724204,MUS 80,A00,186935,Staff,0,0,20,20
1683667724204,MUS 80,B00,186936,Staff,24,0,25,1
1683667725227,NANO 11,A00,204702,Lipomi; Darren John,0,0,0,0
1683667726253,NANO 15,A01,204709,Yang; Kesong,0,1,0,0
1683667727277,NANO 114,A00,202069,Jahed Motlagh; Zeinab,3,0,10,7
1683667728304,PHIL 1,A00,186955,Grush; Rick Scott,31,0,40,9
1683667729331,PHIL 10,A01,186973,Grush; Rick Scott,27,0,35,8
1683667729331,PHIL 10,A02,186974,Grush; Rick Scott,33,0,35,2
1683667730357,PHIL 13,A01,186976,Staff,3,0,35,32
1683667730357,PHIL 13,A02,186977,Staff,16,0,35,19
1683667731382,PHIL 14,A01,186979,Staff,31,0,35,4
1683667731382,PHIL 14,A02,186986,Staff,32,0,35,3
1683667732405,PHIL 28,A01,186988,Staff,16,0,30,14
1683667732405,PHIL 28,A02,186989,Staff,1,0,30,29
1683667732405,PHIL 28,A03,186990,Staff,10,0,30,20
1683667732405,PHIL 28,A04,186991,Staff,26,0,30,4
1683667733432,PHIL 120,A00,186997,Staff,23,0,40,17
1683667734456,PHIL 137,A00,187003,Staff,7,0,40,33
1683667735483,PHIL 150,A00,187015,Staff,47,0,70,23
1683667736506,PHIL 167,A00,187021,Lamey; Andy M.,34,0,40,6
1683667737531,PHIL 174,A01,202226,Staff,17,0,20,3
1683667737531,PHIL 174,A02,202235,Staff,20,0,20,0
1683667738565,PHIL 191A,A00,258918,Staff,0,0,1,1
1683667739590,PHYS 1A,A00,187028,Staff,26,0,60,34
1683667740614,PHYS 1AL,001,187036,Staff,3,0,30,27
1683667740614,PHYS 1AL,002,187049,Staff,18,0,30,12
1683667741637,PHYS 1B,A00,187058,Staff,22,0,60,38
1683667742665,PHYS 1BL,001,187064,Staff,0,1,30,30
1683667742665,PHYS 1BL,002,187070,Staff,4,0,30,26
1683667743693,PHYS 1C,A00,187082,Staff,29,0,120,91
1683667744721,PHYS 1CL,001,187088,Staff,0,9,30,30
1683667744721,PHYS 1CL,002,187089,Staff,0,1,30,30
1683667744721,PHYS 1CL,009,262693,Staff,9,0,30,21
1683667745745,PHYS 2B,A01,187097,Staff,55,0,115,60
1683667746769,PHYS 2C,A01,187099,Staff,63,0,115,52
1683667747792,PHYS 2CL,A01,187101,Staff,5,0,28,23
1683667747792,PHYS 2CL,A02,187102,Staff,15,0,28,13
1683667748816,PHYS 2D,A01,187123,Shotwell; Brian,95,0,115,20
1683667749841,PHYS 4B,A01,187133,Grinstein; Benjamin,35,0,50,15
1683667750865,POLI 10,A00,188819,Staff,0,4,50,50
1683667751892,POLI 11,A00,188827,Staff,43,0,50,7
1683667752919,POLI 13R,A00,188828,Staff,0,1,20,20
1683667753945,POLI 27,A01,188830,Elgin; Samuel Zincke,0,2,70,70
1683667754971,POLI 30,A00,188832,Desposato; Scott,30,0,50,20
1683667755998,POLI 102F,A00,188834,Staff,0,0,40,40
1683667757025,POLI 104A,A00,188852,Staff,13,0,30,17
1683667758049,POLI 104I,A00,188853,Staff,0,7,20,20
1683667759073,POLI 110B,A00,188854,Wiens; David,6,0,20,14
1683667760097,POLI 112A,A00,188855,Wiens; David,3,0,30,27
1683667761122,POLI 117R,A00,188856,Forman; Fonna,0,12,20,20
1683667762149,POLI 118,A00,188857,Ingham; Sean,8,0,20,12
1683667763174,POLI 120G,A00,188858,Staff,8,0,30,22
1683667764197,POLI 131CR,A00,188863,Hoston; Germaine,21,0,50,29
1683667765221,POLI 133,A00,188864,Nellis; Gareth Hb,44,0,50,6
1683667766247,POLI 134D,A00,188865,Desposato; Scott,27,0,30,3
1683667767271,POLI 142A,A00,188871,Gartzke; Erik,21,0,50,29
1683667768296,POLI 142K,A00,188874,Staff,38,0,50,12
1683667769319,POLI 143,A00,188940,Gartzke; Erik,16,0,30,14
1683667770343,POLI 153,A00,188943,Staff,2,0,20,18
1683667771369,POLI 160AA,A00,188944,Staff,11,0,40,29
1683667772393,POLI 170A,A00,188945,Staff,11,0,30,19
1683667774442,PSYC 1,A00,188952,Staff,36,0,90,54
1683667775469,PSYC 2,B00,188953,Staff,19,0,35,16
1683667776494,PSYC 6,A00,188970,Staff,47,0,60,13
1683667777518,PSYC 7,A00,188973,Staff,35,0,45,10
1683667778544,PSYC 60,A01,188980,Rickard; Timothy C.,42,0,60,18
1683667779568,PSYC 70,A01,189001,Steiner; Eric Tomas,22,0,45,23
1683667780593,PSYC 100,A00,189005,Lacefield; Katharine I,0,99,120,120
1683667781617,PSYC 102,A00,189008,Staff,8,0,30,22
1683667782642,PSYC 106,B00,189026,Gorman; Michael R.,27,0,60,33
1683667783668,PSYC 114,B01,189033,Winkielman; Piotr,0,31,30,30
1683667784694,PSYC 131,A00,189036,Anagnostaras; Stephan,0,43,60,60
1683667785719,PSYC 136,A00,189041,Lowe; Angela Beth,0,7,25,25
1683667786743,PSYC 137,A00,189057,Winkielman; Piotr,1,37,25,24
1683667787769,PSYC 144,A00,189107,Wixted; John T,0,11,50,50
1683667789819,PSYC 162,A00,189142,Staff,0,9,85,85
1683667790842,PSYC 172,A00,189144,Gorman; Michael R.,0,6,30,30
1683667792895,PSYC 179,A00,189146,Lacefield; Katharine I,0,87,120,120
1683667793921,PSYC 181,A00,189147,Anagnostaras; Stephan,0,44,90,90
1683667794948,PSYC 190R,A00,189148,Barner; David A.,0,23,80,80
1683667795976,PSYC 191,A00,189275,Rickard; Timothy C.,0,10,25,25
1683667797057,PSYC 193,A00,189276,Chapman; Eddie Nathaniel,0,1,0,4
1683667798080,PSYC 193L,A01,189281,Lowe; Angela Beth,10,0,20,10
1683667798080,PSYC 193L,B01,189285,Staff,28,0,35,7
1683667799104,RELI 149,A00,187137,Rahimi; Babak,7,0,40,33
1683667800129,SE 9,A01,187315,Staff,0,2,18,18
1683667801157,SE 101B,A00,187409,Staff,24,0,30,6
1683667802184,SE 110B,A00,187444,Staff,10,0,40,30
1683667803209,SE 130B,A00,187449,Staff,31,0,40,9
1683667804235,SE 150A,A00,187516,Staff,8,0,20,12
1683667805260,SE 154,A00,187528,Staff,29,0,50,21
1683667806283,SIO 3,A01,258171,Staff,35,0,40,5
1683667807306,SIO 10,A00,187144,Cook; Geoffrey W,0,7,75,75
1683667808333,SIO 45,A00,187152,Cook; Geoffrey W,0,5,100,100
1683667809359,SIO 109R,A00,194486,Staff,0,4,20,20
1683667811410,SIO 187,A01,187233,Kacev; David,12,0,40,28
1683667812433,SOCI 1,A01,258656,Thorpe; Charles Robert,28,0,30,2
1683667812433,SOCI 1,A02,258658,Thorpe; Charles Robert,30,0,30,0
1683667812433,SOCI 1,A03,258661,Thorpe; Charles Robert,25,0,25,0
1683667812433,SOCI 1,A04,258666,Thorpe; Charles Robert,22,0,25,3
1683667812433,SOCI 1,A05,258897,Thorpe; Charles Robert,22,0,25,3
1683667812433,SOCI 1,A06,258898,Thorpe; Charles Robert,25,0,25,0
1683667813459,SOCI 30,A01,258903,Pardo Guerra; Juan Pablo,14,0,30,16
1683667814485,SOCI 102,A00,258904,Staff,9,0,25,16
1683667815512,SOCI 106,A00,258905,Staff,19,0,25,6
1683667816536,SOCI 111,A00,258907,Ribas Norris; Janet Vanesa,26,0,30,4
1683667817562,SOCI 121R,A00,258908,Pardo Guerra; Juan Pablo,8,0,30,22
1683667818587,SOCI 126,A01,203330,Staff,14,0,20,6
1683667819615,SOCI 131,A00,258909,Thorpe; Charles Robert,30,0,60,30
1683667820641,SOCI 135,A00,258910,Payne; Christine Anna,0,11,30,30
1683667821668,SOCI 157,A00,258911,Staff,12,0,30,18
1683667822692,SOCI 184,A00,258912,Staff,25,0,30,5
1683667823717,SOCI 188D,A00,258913,Staff,22,0,30,8
1683667824743,SYN 2,001,187529,Staff,9,0,16,7
1683667824743,SYN 2,002,201452,Staff,0,20,16,16
1683667824743,SYN 2,003,201469,Staff,1,0,16,15
1683667825772,SYN 100,A01,187531,Staff,0,9,20,20
1683667825772,SYN 100,B01,201491,Staff,0,10,20,20
1683667826798,TDAC 1,A00,189286,Walsh; Kim C.,3,0,20,17
1683667826798,TDAC 1,B00,189287,Harting; Carla Kelso,10,0,20,10
1683667827826,TDAC 101,A00,189300,Walsh; Kim C.,16,0,20,4
1683667827826,TDAC 101,B00,189301,Harting; Carla Kelso,18,0,20,2
1683667828855,TDAC 102,A00,189304,Basso; Beatrice,14,0,20,6
1683667829880,TDAC 108,A00,189305,Staff,18,0,20,2
1683667830909,TDDE 131,A00,189310,Staff,19,0,20,1
1683667830909,TDDE 131,B00,189314,Staff,19,0,20,1
1683667830909,TDDE 131,C00,189315,Staff,48,0,50,2
1683667830909,TDDE 131,D00,189316,Staff,14,0,15,1
1683667830909,TDDE 131,E00,204841,Staff,20,0,20,0
1683667831936,TDGE 10,A00,189289,Staff,27,0,50,23
1683667831936,TDGE 10,B00,189290,Havis; Allan,0,1,50,50
1683667832961,TDGE 11,A00,189291,Fulton; Julia,0,4,50,50
1683667832961,TDGE 11,B00,189292,Staff,20,0,25,5
1683667832961,TDGE 11,C00,260270,Staff,0,0,0,0
1683667833986,TDGE 25,A00,189294,Staff,2,0,20,18
1683667835009,TDGE 124,A00,189318,Fulton; Julia,0,8,50,50
1683667836037,TDGE 125,A00,189319,Staff,13,0,25,12
1683667836037,TDGE 125,B00,189320,Staff,23,0,25,2
1683667837061,TDGE 127,A00,189322,Havis; Allan,1,0,50,49
1683667838085,TDHT 101,A00,189323,Staff,18,0,25,7
1683667838085,TDHT 101,B00,189324,Staff,25,0,25,0
1683667839109,TDHT 102,A00,189325,Staff,49,0,50,1
1683667840136,TDMV 1,A00,189295,Arcidiacono; Kristin,20,0,30,10
1683667840136,TDMV 1,B00,189296,Caligagan; Maria T.,24,0,30,6
1683667841163,TDMV 2,A00,189297,Sammartano; Tonnie,27,0,30,3
1683667841163,TDMV 2,B00,189299,Arcidiacono; Kristin,23,0,30,7
1683667842187,TDMV 3,A00,204998,Rincon; Alicia,22,0,30,8
1683667843209,TDMV 120,A00,189458,Sammartano; Tonnie,28,0,30,2
1683667844232,TDMV 138,A00,189541,Jun; Grace Shin Hae,20,0,40,20
1683667845259,TDMV 142,A00,189717,Caligagan; Tony,25,0,30,5
1683667845259,TDMV 142,B00,189718,Caligagan; Maria T.,25,0,30,5
1683667846282,TMC 2,A01,187533,Staff,25,0,25,0
1683667846282,TMC 2,A02,187534,Staff,25,0,25,0
1683667847310,USP 1,A01,187536,Kwak; Nancy,0,16,25,25
1683667848333,USP 5,A01,187538,Staff,9,0,25,16
1683667849359,USP 101,A00,199253,Staff,0,4,0,0
1683667850387,USP 124,A00,187562,Boomhower; Matthew Charles,0,0,30,30
1683667851412,USP 138,A00,187582,Staff,20,0,25,5
1683667852437,USP 152,A01,187597,Staff,3,0,25,22
1683667853463,USP 153,A00,187598,Staff,19,0,25,6
1683667854488,USP 168,A00,187607,Kwak; Nancy,2,0,5,3
1683667855514,USP 173,A00,187619,Staff,4,0,25,21
1683667856538,USP 181,A00,187638,Staff,0,4,25,25
1683667857565,VIS 103,A00,187650,Cruz; Edwin Teddy,17,0,75,58
1683667858591,VIS 110D,A00,187669,Staff,13,0,22,9
1683667859617,VIS 127C,A00,187720,Shen; Kuiyi,68,0,146,78
1683667860640,VIS 149,A00,187731,Yoldas; Pinar,1,14,22,21
1683667861666,VIS 151,A01,188091,Staff,22,0,34,12
1683667861666,VIS 151,A02,188092,Staff,11,0,34,23
1683667862690,VIS 160B,A00,188093,Stalbaum; Brett,0,1,10,10
1683667864739,WCWP 10B,A00,201720,Staff,10,0,15,5
1683667864739,WCWP 10B,B00,201722,Staff,9,0,15,6
1683667865763,WCWP 100,A00,201725,Gagnon; Jeffrey C,0,0,2,2
1683667865763,WCWP 100,B00,201727,Staff,0,4,15,15
1683667868896,ANBI 133,A00,258401,Wilder; Linnea Lorene,34,0,40,6
1683667869923,ANBI 140,A00,258395,Hrvoj Mihic; Branka,18,0,25,7
1683667870949,ANSC 120,A00,258402,Bialecki; Jon Anthony,26,0,40,14
1683667871973,ANSC 144,A00,258400,Staff,12,0,40,28
1683667874029,ANSC 166,A00,258396,Parish; Steven Martin,156,0,175,19
1683667875053,ANSC 180,A00,193533,Staff,8,0,20,12
1683667876076,ANSC 188,A00,258397,Jassal; Aftab,34,0,40,6
1683667877101,ANTH 3,A01,258316,Staff,23,0,30,7
1683667878127,ANTH 5,A00,258394,Semendeferi; Ekaterini,16,0,20,4
1683667879149,ANTH 21,A01,258331,Staff,4,0,40,36
1683667880177,ANTH 103,A00,258398,Varma; Saiba,15,0,25,10
1683667881203,AWP 10,001,202034,Staff,0,0,0,0
1683667881203,AWP 10,002,202035,Staff,0,0,0,0
1683667881203,AWP 10,003,202036,Staff,0,0,0,0
1683667881203,AWP 10,004,202037,Staff,0,0,0,0
1683667881203,AWP 10,005,202038,Staff,0,0,0,0
1683667881203,AWP 10,006,202039,Staff,0,0,0,0
1683667881203,AWP 10,007,202040,Staff,0,0,0,0
1683667881203,AWP 10,008,202041,Staff,0,0,0,0
1683667881203,AWP 10,009,202042,Staff,0,0,0,0
1683667881203,AWP 10,010,202043,Staff,0,0,0,0
1683667881203,AWP 10,011,202044,Staff,0,0,0,0
1683667881203,AWP 10,012,202045,Staff,0,0,0,0
1683667881203,AWP 10,013,202046,Staff,0,0,0,0
1683667881203,AWP 10,014,202047,Staff,0,0,0,0
1683667881203,AWP 10,015,202048,Staff,0,0,0,0
1683667881203,AWP 10,016,202049,Staff,0,0,0,0
1683667881203,AWP 10,017,202050,Staff,0,0,0,0
1683667881203,AWP 10,018,202051,Staff,0,0,0,0
1683667881203,AWP 10,019,202052,Staff,0,0,0,0
1683667881203,AWP 10,020,202053,Staff,0,0,0,0
1683667881203,AWP 10,021,202054,Staff,0,0,0,0
1683667881203,AWP 10,022,202055,Staff,0,0,0,0
1683667881203,AWP 10,023,202056,Staff,0,0,0,0
1683667881203,AWP 10,024,202057,Staff,0,0,0,0
1683667881203,AWP 10,025,202058,Staff,0,0,0,0
1683667881203,AWP 10,026,202059,Staff,0,0,0,0
1683667882226,AWP 102,001,202032,Staff,0,0,0,0
1683667882226,AWP 102,002,202033,Staff,0,0,0,0
1683667883254,BENG 100,A01,254234,Taylor Amos; Alyssa C,31,0,40,9
1683667884280,BENG 196,001,270013,Engler; Adam J.,9999,0,9999,0
1683667885308,BICD 100R,A01,202018,Smith; Laurie,0,7,32,32
1683667885308,BICD 100R,A02,202019,Smith; Laurie,0,3,32,32
1683667885308,BICD 100R,A03,202020,Smith; Laurie,0,1,32,32
1683667885308,BICD 100R,A04,202021,Smith; Laurie,6,0,32,26
1683667885308,BICD 100R,A05,202022,Smith; Laurie,11,0,32,21
1683667886337,BICD 136,A01,193242,Gustafson-Brown; Cindy,0,2,32,32
1683667886337,BICD 136,A02,193244,Gustafson-Brown; Cindy,13,0,32,19
1683667887362,BIEB 102,A01,193249,Butler; Shannon Rhey,1,2,32,31
1683667887362,BIEB 102,A02,193251,Butler; Shannon Rhey,0,0,32,32
1683667887362,BIEB 102,A03,193253,Butler; Shannon Rhey,0,0,32,32
1683667887362,BIEB 102,A04,193255,Butler; Shannon Rhey,14,0,32,18
1683667887362,BIEB 102,A05,193265,Butler; Shannon Rhey,25,0,32,7
1683667887362,BIEB 102,A06,193269,Butler; Shannon Rhey,14,0,32,18
1683667889412,BIEB 150,A01,193274,Staff,0,0,32,32
1683667889412,BIEB 150,A02,193285,Staff,24,0,32,8
1683667890441,BIEB 194,A00,193286,Kurle; Carolyn M.,20,0,32,12
1683667891465,BILD 1,A01,192291,Staff,15,0,32,17
1683667891465,BILD 1,A02,192292,Staff,30,0,32,2
1683667891465,BILD 1,B01,192520,Reuther; Keefe,0,1,0,0
1683667891465,BILD 1,B02,192532,Reuther; Keefe,0,1,0,0
1683667892490,BILD 3,A01,192556,Butler; Shannon Rhey,0,0,32,32
1683667892490,BILD 3,A02,192581,Butler; Shannon Rhey,0,0,32,32
1683667892490,BILD 3,A03,192611,Butler; Shannon Rhey,20,0,32,12
1683667892490,BILD 3,A04,192612,Butler; Shannon Rhey,24,0,32,8
1683667892490,BILD 3,A05,192613,Butler; Shannon Rhey,26,0,32,6
1683667892490,BILD 3,A06,192679,Butler; Shannon Rhey,27,0,32,5
1683667892490,BILD 3,A07,192682,Butler; Shannon Rhey,20,0,32,12
1683667893515,BILD 4,A01,192836,Reuther; Keefe,1,0,24,23
1683667893515,BILD 4,A02,193044,Reuther; Keefe,4,0,24,20
1683667894538,BILD 10,A01,193142,Gustafson-Brown; Cindy,29,0,32,3
1683667894538,BILD 10,A02,193149,Gustafson-Brown; Cindy,31,0,32,1
1683667895561,BIMM 100,A01,193301,Staff,0,6,32,32
1683667895561,BIMM 100,A02,193312,Staff,0,7,32,32
1683667895561,BIMM 100,A03,193323,Staff,0,9,32,32
1683667896590,BIMM 101,A01,193329,McDonnell; Lisa Marie,1,4,24,23
1683667896590,BIMM 101,A02,193339,McDonnell; Lisa Marie,1,4,24,23
1683667896590,BIMM 101,B01,193354,McDonnell; Lisa Marie,0,4,24,24
1683667896590,BIMM 101,B02,193357,McDonnell; Lisa Marie,0,3,24,24
1683667897614,BIMM 110,A01,193377,Tat; John,0,11,32,32
1683667897614,BIMM 110,A02,193378,Tat; John,0,10,32,32
1683667898640,BIMM 120,A01,206116,Staff,0,0,32,32
1683667898640,BIMM 120,A02,206117,Staff,6,0,32,26
1683667898640,BIMM 120,A03,206121,Staff,21,0,32,11
1683667899665,BIPN 100,A01,193393,Park; Ji Young,0,15,32,32
1683667899665,BIPN 100,A02,193402,Park; Ji Young,0,14,32,32
1683667899665,BIPN 100,A03,193413,Park; Ji Young,0,14,32,32
1683667899665,BIPN 100,A04,193414,Park; Ji Young,0,13,32,32
1683667900746,BIPN 102,A01,193429,Staff,0,0,32,32
1683667900746,BIPN 102,A02,193438,Staff,18,0,32,14
1683667901773,BIPN 106,A01,193450,Reyes Gonzalez; Catalina,0,2,40,40
1683667902798,BIPN 134,A01,193465,Cooke; James Edward,0,0,32,32
1683667902798,BIPN 134,A02,193474,Cooke; James Edward,25,0,32,7
1683667902798,BIPN 134,A03,193485,Cooke; James Edward,29,0,32,3
1683667902798,BIPN 134,A04,193486,Cooke; James Edward,20,0,32,12
1683667902798,BIPN 134,A05,193491,Cooke; James Edward,31,0,32,1
1683667902798,BIPN 134,A06,193501,Cooke; James Edward,30,0,32,2
1683667902798,BIPN 134,A07,193510,Cooke; James Edward,29,0,32,3
1683667904848,BISP 194,A00,222522,Staff,14,0,32,18
1683667905872,CAT 124,A01,202407,Staff,19,0,25,6
1683667906900,CAT 125,A00,202408,Marchisotto; Jennifer Anne,2,0,20,18
1683667907925,CAT 125R,A00,202409,Smith; Lauryn Alissa,0,11,20,20
1683667907925,CAT 125R,B00,202410,Morales; Celeste Georgianna,0,11,20,20
1683667907925,CAT 125R,C00,202411,Irwin; Matthew Joseph,0,12,20,20
1683667908949,CENG 15,A01,204712,Yang; Kesong,0,1,0,0
1683667909976,CENG 114,A00,202070,Jahed Motlagh; Zeinab,5,0,20,15
1683667910999,CGS 105,A00,185477,Wesling; Megan E.,24,0,40,16
1683667912025,CGS 106,A00,185494,Staff,11,0,22,11
1683667913048,CGS 108,A00,185495,Staff,14,0,20,6
1683667914072,CGS 114,A00,185496,Staff,13,0,18,5
1683667915098,CGS 119,A00,185501,Staff,15,0,20,5
1683667916121,CGS 120,A00,185511,Staff,12,0,20,8
1683667917146,CHEM 4,A01,184675,Bussey; Thomas J,97,0,100,3
1683667918168,CHEM 6A,A01,184677,Staff,32,0,60,28
1683667919191,CHEM 6B,A01,184679,Staff,63,0,100,37
1683667920215,CHEM 6C,A01,184681,Bussey; Thomas J,0,0,50,50
1683667920215,CHEM 6C,A02,184682,Bussey; Thomas J,32,0,50,18
1683667921244,CHEM 40A,A01,184684,Albizati; Kim F.,34,0,100,66
1683667922269,CHEM 40B,A01,184686,Albizati; Kim F.,0,22,100,100
1683667923295,CHEM 41B,A01,184690,Staff,51,0,100,49
1683667924319,COGS 3,A01,184715,Boyle; Mary E. T.,0,27,40,40
1683667925344,COGS 14B,A01,185172,Staff,0,14,38,38
1683667926369,COGS 18,A01,184736,Staff,14,0,80,66
1683667927395,COGS 100,A01,184932,Staff,0,8,73,73
1683667928423,COGS 101A,A01,184935,Staff,0,40,30,30
1683667929451,COGS 101B,A01,184944,Staff,0,2,30,30
1683667930474,COGS 101C,A01,184946,Staff,0,10,30,30
1683667931501,COGS 102A,A01,184951,Johnson; Christine M.,2,0,40,38
1683667932524,COGS 107B,A01,184953,Mooshagian; Eric Frederick,0,51,40,40
1683667933547,COGS 118B,A01,184959,Gupta; Anjum,0,50,40,40
1683667934572,COGS 153,A00,184961,Staff,0,16,30,30
1683667935597,COGS 177,A00,184962,Staff,0,21,30,30
1683667936624,COGS 187A,A01,184969,Boyle; Mary E. T.,0,19,40,40
1683667937650,COMM 10,A01,185174,Staff,0,5,25,25
1683667937650,COMM 10,A02,185189,Staff,0,2,25,25
1683667937650,COMM 10,A03,269821,Staff,0,1,0,0
1683667938676,COMM 100B,A01,185475,Staff,0,1,0,2
1683667938676,COMM 100B,A02,185476,Staff,12,0,25,13
1683667939700,COMM 100C,A01,185314,Staff,1,0,25,24
1683667939700,COMM 100C,A02,185327,Staff,18,0,25,7
1683667940724,COMM 110M,A00,185349,Staff,0,0,40,40
1683667941750,COMM 113T,A00,185352,Staff,25,0,40,15
1683667942778,COMM 114I,A00,185353,Staff,31,0,40,9
1683667943802,COMM 131,A00,185354,Staff,17,0,30,13
1683667944832,CSE 8A,A50,185358,Cao; Yingjun,0,46,10,10
1683667945858,CSE 8B,A01,185362,Staff,0,48,50,50
1683667946882,CSE 11,A01,185416,Cao; Yingjun,0,91,10,10
1683667947909,CSE 20,A01,185445,Briones; Jor-el Thomas Caparas,4,0,25,21
1683667948935,CSE 21,A01,185447,Staff,9,0,50,41
1683667949962,CSE 101,A01,185451,Staff,0,13,50,50
1683667949962,CSE 101,B01,185453,Jones; Miles E,0,14,50,50
1683667952013,CSE 141,A01,185458,Eldon; John,16,0,100,84
1683667953040,CSE 141L,A01,185461,Eldon; John,8,0,100,92
1683667954063,CSE 142,A01,185463,Staff,34,0,60,26
1683667954063,CSE 142,B01,201355,Staff,0,7,60,60
1683667955087,CSE 142L,A01,185470,Staff,34,0,60,26
1683667955087,CSE 142L,B01,201417,Staff,0,6,60,60
1683667956113,CSE 190,A00,201433,Staff,32,0,49,17
1683667957137,DOC 1,A01,259136,Strom; Megan C.,7,0,15,8
1683667957137,DOC 1,A02,259137,Strom; Megan C.,14,0,15,1
1683667957137,DOC 1,A03,259138,Strom; Megan C.,14,0,15,1
1683667957137,DOC 1,A04,259139,Strom; Megan C.,14,0,15,1
1683667958165,DOC 100D,A00,259140,Pass; Natalye Joann,14,0,25,11
1683667959190,DSGN 1,A01,184749,Rill; Bryan,0,26,30,30
1683667960216,DSGN 100,A01,185168,Staff,0,2,25,25
1683667961243,ECE 5,A01,185626,Morris; Karcher William,0,12,0,0
1683667962268,ECE 101,A01,185628,Staff,14,0,70,56
1683667963296,ECE 107,A01,185635,Baghdadchi; Saharnaz,0,0,20,20
1683667963296,ECE 107,A02,185638,Baghdadchi; Saharnaz,1,0,20,19
1683667964323,ECE 148,A01,185647,Silberman; Jack,0,0,16,16
1683667965354,ECON 1,A01,185537,Crane; Meredith Helen,54,0,70,16
1683667966380,ECON 3,A01,185549,Crane; Meredith Helen,29,0,70,41
1683667967405,ECON 4,A01,203354,Anderson; John Charles,0,5,10,10
1683667968432,ECON 100A,A01,185574,Staff,0,5,40,40
1683667969455,ECON 100B,A01,185576,Staff,0,12,50,50
1683667970483,ECON 100C,A01,185589,Newhouse; Herbert S,30,0,70,40
1683667971510,ECON 105,A00,185608,Vespa; Emanuel Ignacio,19,0,35,16
1683667972537,ECON 109,A01,185610,Shishkin; Denis,9,0,35,26
1683667973564,ECON 110A,A01,185612,Staff,9,0,40,31
1683667974591,ECON 120A,A01,185615,Staff,19,0,40,21
1683667975615,ECON 120C,A01,185617,Sun; Yixiao,0,20,70,70
1683667976643,ECON 144,A00,203346,Squires; Dale E,2,0,35,33
1683667977667,ECON 171,A01,203349,Newhouse; Herbert S,0,1,35,35
1683667978691,ECON 173A,A01,185621,Toda; Alexis Akira,20,0,35,15
1683667979716,EDS 25,A01,202413,Staff,0,1,0,0
1683667979716,EDS 25,A02,202414,Staff,0,1,0,0
1683667979716,EDS 25,A03,202415,Staff,0,0,0,0
1683667979716,EDS 25,A04,202416,Staff,0,1,0,0
1683667979716,EDS 25,A05,202439,Staff,0,0,0,0
1683667979716,EDS 25,A06,202440,Staff,0,0,0,0
1683667979716,EDS 25,B01,202631,Staff,0,0,0,0
1683667979716,EDS 25,B02,202632,Staff,0,0,0,0
1683667979716,EDS 25,B03,202639,Staff,0,0,0,0
1683667979716,EDS 25,B04,202640,Staff,0,0,0,0
1683667979716,EDS 25,B05,202643,Staff,0,0,0,0
1683667979716,EDS 25,B06,202644,Staff,0,0,0,0
1683667980741,EDS 38,A01,202659,Black; Alison Michelle,24,0,25,1
1683667981764,EDS 115,A00,202652,Staff,18,0,30,12
1683667982788,EDS 125,A00,202649,Staff,13,0,30,17
1683667983812,EDS 126,A01,203332,Staff,30,0,30,0
1683667984836,EDS 139,A00,202838,Staff,16,0,25,9
1683667985863,EDS 146,A01,202655,Staff,14,0,25,11
1683667986887,ENG 15,A00,185667,Staff,0,1,0,0
1683667986887,ENG 15,B00,185672,Staff,0,0,0,0
1683667986887,ENG 15,C00,185675,Staff,0,0,0,0
1683667986887,ENG 15,D00,185682,Staff,0,0,0,0
1683667986887,ENG 15,E00,185684,Staff,0,0,0,0
1683667987914,ETHN 103,A00,185710,Staff,0,8,35,35
1683667988947,ETHN 103A,A00,199228,Man; Simeon S,0,0,9,9
1683667989973,ETHN 109,A00,185711,Staff,15,0,35,20
1683667990999,ETHN 142,A00,185726,Staff,0,4,30,30
1683667992022,ETHN 163J,A00,199229,Man; Simeon S,5,0,8,3
1683667993049,ETHN 168,A00,185727,Staff,7,0,10,3
1683667994081,ETHN 182,A00,185728,Staff,0,0,35,35
1683667995103,ETHN 183,A00,185737,Staff,9,0,18,9
1683667996128,GLBH 111,A01,209361,Burgos; Jose L.,0,0,0,0
1683667998178,HIEU 104,A00,185792,Staff,14,0,20,6
1683667999204,HIEU 115,A00,185800,Staff,0,0,20,20
1683668000228,HIEU 128,A00,185801,Staff,0,9,20,20
1683668001252,HIEU 147,A00,185802,Staff,15,0,20,5
1683668002277,HIEU 154,A00,185823,Staff,11,0,20,9
1683668003300,HILA 102,A00,185826,Staff,14,0,20,6
1683668004397,HILD 2C,A01,185778,Staff,0,13,20,20
1683668005424,HILD 7B,A01,185780,Kwak; Nancy,0,17,32,32
1683668005424,HILD 7B,A02,185781,Kwak; Nancy,0,18,32,32
1683668006448,HILD 30,A01,185791,Staff,12,0,20,8
1683668007472,HISC 119,A00,185830,Golan; Tal,0,9,20,20
1683668008495,HITO 156GS,A00,185831,Patterson; Patrick H.,0,0,0,23
1683668009518,HIUS 103,A00,185832,Man; Simeon S,0,4,20,20
1683668010549,HIUS 117,A00,185836,Kwak; Nancy,2,0,20,18
1683668011573,HIUS 125,A00,185840,Man; Simeon S,0,2,23,23
1683668012597,HIUS 149,A00,185845,Staff,1,0,20,19
1683668013626,HUM 3,A01,185882,Zavodny; Tatiana Sophia,0,8,50,50
1683668013626,HUM 3,B01,185899,Caldwell; Michael Alan,0,18,50,50
1683668014653,HUM 3GS,A00,185900,Patterson; Patrick H.,0,0,0,23
1683668015679,HUM 4,A01,185938,Zroka; Amy Liane,29,0,50,21
1683668015679,HUM 4,B01,185956,Watkins; Eric,0,5,50,50
1683668015679,HUM 4,B02,202209,Watkins; Eric,0,5,50,50
1683668015679,HUM 4,B03,202210,Watkins; Eric,0,5,50,50
1683668016703,HUM 5,A01,185958,West; Geoffrey Scott,0,0,50,50
1683668016703,HUM 5,A02,202215,West; Geoffrey Scott,0,0,50,50
1683668017728,INTL 190,A00,185959,Gagnon; Jeffrey C,0,0,0,9
1683668017728,INTL 190,B00,185960,Lettieri; Michael Joseph,0,0,0,2
1683668018754,JAPN 180,A00,254509,Staff,5,0,30,25
1683668019780,LATI 10,A01,202853,Kennemore; Amy Michelle,4,0,35,31
1683668019780,LATI 10,A02,202854,Kennemore; Amy Michelle,2,0,35,33
1683668019780,LATI 10,A03,270054,Kennemore; Amy Michelle,30,0,30,0
1683668020806,LATI 180,A00,202855,Kennemore; Amy Michelle,11,0,20,9
1683668021831,LAWS 101,A00,201767,Golan; Tal,0,7,40,40
1683668022859,LIFR 1C,A00,185961,Staff,6,0,20,14
1683668023884,LIFR 1CX,A00,185962,Staff,7,0,20,13
1683668024908,LIFR 1D,A00,185963,Staff,7,0,20,13
1683668025933,LIFR 1DX,A00,185964,Staff,7,0,20,13
1683668026957,LIGN 101,A01,186039,Staff,43,0,50,7
1683668027980,LIGN 165,A00,186040,Staff,15,0,50,35
1683668029007,LTCS 108,A00,186041,Staff,5,0,10,5
1683668030031,LTCS 119,A00,186042,Staff,15,0,20,5
1683668031055,LTCS 130,A00,186043,Wesling; Megan E.,15,0,25,10
1683668033109,LTEA 138,A00,186119,Staff,14,0,40,26
1683668034133,LTEN 124,A00,186148,Staff,5,0,25,20
1683668035159,LTEN 178,A00,186149,Staff,7,0,15,8
1683668036186,LTEN 181,A00,186150,Blanco; John D,34,0,40,6
1683668037210,LTWL 120,A00,186160,Staff,19,0,25,6
1683668038233,LTWL 165,A00,186161,Staff,22,0,25,3
1683668039257,LTWR 100,A00,186162,Staff,0,5,15,15
1683668040282,LTWR 102,A00,186163,Doller; Ben,5,0,15,10
1683668041312,MAE 8,A01,186412,Staff,0,0,0,0
1683668042337,MAE 30B,A00,186445,Bahadori; Mohammad Yousef,82,0,100,18
1683668043365,MAE 40,A00,186592,Bewley; Thomas R,10,0,50,40
1683668044393,MAE 101B,A00,186593,Bahadori; Mohammad Yousef,80,0,100,20
1683668045421,MAE 105,A00,186594,Bandaru; Prabhakar,10,0,50,40
1683668046448,MAE 107,A00,186599,Pham; Hieu Tan,0,7,120,120
1683668047474,MAE 148,A01,186660,Silberman; Jack,3,0,16,13
1683668048502,MATH 10A,A01,188095,Staff,0,6,35,35
1683668049532,MATH 10B,A01,188097,Bowers; Adam R.,0,12,30,30
1683668049532,MATH 10B,A02,188099,Bowers; Adam R.,0,11,30,30
1683668049532,MATH 10B,B01,188104,Bowers; Adam R.,0,10,30,30
1683668049532,MATH 10B,B02,188106,Bowers; Adam R.,1,9,30,29
1683668050561,MATH 10C,A01,188111,Staff,0,19,30,30
1683668050561,MATH 10C,A02,188127,Staff,0,19,30,30
1683668050561,MATH 10C,A03,188131,Staff,0,19,30,30
1683668050561,MATH 10C,B01,188218,Staff,17,0,30,13
1683668050561,MATH 10C,B02,188244,Staff,13,0,30,17
1683668050561,MATH 10C,B03,188277,Staff,14,0,30,16
1683668051592,MATH 18,A01,188344,Bach; Quang Tran,18,0,30,12
1683668051592,MATH 18,A02,188345,Bach; Quang Tran,11,0,30,19
1683668051592,MATH 18,B01,188353,Bach; Quang Tran,11,0,30,19
1683668051592,MATH 18,B02,188354,Bach; Quang Tran,19,0,30,11
1683668052615,MATH 20A,A01,188374,Staff,11,0,35,24
1683668053643,MATH 20B,A01,188382,Ohm; Ko Woon,7,0,30,23
1683668053643,MATH 20B,A02,188383,Ohm; Ko Woon,22,0,30,8
1683668053643,MATH 20B,B01,188385,Ohm; Ko Woon,7,0,30,23
1683668053643,MATH 20B,B02,188392,Ohm; Ko Woon,22,0,30,8
1683668054672,MATH 20C,A01,188394,Harel; Guershon,10,0,30,20
1683668054672,MATH 20C,A02,188395,Harel; Guershon,13,0,30,17
1683668054672,MATH 20C,B01,188404,Harel; Guershon,5,0,30,25
1683668054672,MATH 20C,B02,188405,Harel; Guershon,18,0,30,12
1683668055705,MATH 20D,A01,188414,Hammock; Frances H,0,1,30,30
1683668055705,MATH 20D,A02,188415,Hammock; Frances H,0,1,30,30
1683668055705,MATH 20D,B01,188447,Hammock; Frances H,0,1,30,30
1683668055705,MATH 20D,B02,188486,Hammock; Frances H,3,0,30,27
1683668056729,MATH 20E,A01,188649,Staff,21,0,30,9
1683668056729,MATH 20E,A02,188650,Staff,21,0,30,9
1683668056729,MATH 20E,A03,188673,Staff,0,0,30,30
1683668057753,MATH 102,A01,188675,Staff,0,36,35,35
1683668058778,MATH 103B,A01,188681,Staff,3,0,35,32
1683668058778,MATH 103B,B01,188692,Staff,5,0,35,30
1683668059803,MATH 109,A01,188695,Salehi Golsefidy; Alireza,24,0,35,11
1683668059803,MATH 109,A02,188696,Salehi Golsefidy; Alireza,25,0,35,10
1683668060827,MATH 120A,A01,188698,Eggers; John Dietrich,7,0,35,28
1683668061851,MATH 142B,A01,188736,Ioana; Adrian,1,1,30,29
1683668061851,MATH 142B,A02,188741,Ioana; Adrian,0,1,30,30
1683668061851,MATH 142B,A03,188743,Ioana; Adrian,0,1,30,30
1683668062874,MATH 168A,A01,188790,Staff,0,10,35,35
1683668063900,MATH 170A,A01,188803,Nie; Jiawang,0,2,35,35
1683668063900,MATH 170A,A02,188811,Nie; Jiawang,0,0,35,35
1683668063900,MATH 170A,A03,188814,Nie; Jiawang,0,0,35,35
1683668063900,MATH 170A,A04,188815,Nie; Jiawang,8,0,35,27
1683668064924,MATH 193B,A01,188817,Staff,0,0,35,35
1683668064924,MATH 193B,A02,188818,Staff,6,0,35,29
1683668065948,MGT 4,A01,202857,Anderson; John Charles,60,0,80,20
1683668066971,MGT 12,A00,202858,Lindenberger; Wade Douglas,40,0,90,50
1683668067998,MGT 18,A00,202859,Staff,74,0,90,16
1683668069025,MGT 18GS,A00,202860,McKay; Michael J,13,0,28,15
1683668070051,MGT 45,A00,202861,Pecore; Joseph P.,11,0,90,79
1683668071075,MGT 100,A00,202863,Yavorsky; Daniel Ryan,28,0,90,62
1683668072100,MGT 103,A00,202864,Ehrich; Kristine R,0,18,90,90
1683668073127,MGT 112,A00,202865,Ehrich; Kristine R,15,0,90,75
1683668074154,MGT 121A,A00,202868,Staff,90,20,90,0
1683668075180,MGT 131B,A00,202869,Anderson; John Charles,59,0,90,31
1683668076206,MGT 136,A00,202871,Lindenberger; Wade Douglas,83,0,90,7
1683668077233,MGT 164,A00,202873,Staff,0,67,90,91
1683668078258,MGT 164GS,A00,202874,McKay; Mary A,13,0,28,15
1683668079282,MGT 180,A00,202875,Staff,0,51,90,91
1683668080310,MMW 11R,A01,205019,Herbst; Matthew,1,0,30,29
1683668080310,MMW 11R,A02,205026,Herbst; Matthew,29,0,30,1
1683668081335,MMW 15,A01,193512,Chang; Edmond Yi-Teh,0,8,28,28
1683668081335,MMW 15,A02,193513,Chang; Edmond Yi-Teh,0,5,28,28
1683668081335,MMW 15,A03,193514,Chang; Edmond Yi-Teh,0,5,28,28
1683668081335,MMW 15,A04,193515,Chang; Edmond Yi-Teh,0,5,28,28
1683668081335,MMW 15,A05,193516,Chang; Edmond Yi-Teh,0,5,28,28
1683668081335,MMW 15,A06,193517,Chang; Edmond Yi-Teh,0,6,28,28
1683668081335,MMW 15,B01,193519,Chang; Edmond Yi-Teh,0,5,28,28
1683668081335,MMW 15,B02,193520,Chang; Edmond Yi-Teh,0,5,28,28
1683668081335,MMW 15,B03,193521,Chang; Edmond Yi-Teh,0,5,28,28
1683668081335,MMW 15,B04,193522,Chang; Edmond Yi-Teh,0,5,28,28
1683668081335,MMW 15,B05,193523,Chang; Edmond Yi-Teh,0,5,28,28
1683668081335,MMW 15,B06,193524,Chang; Edmond Yi-Teh,0,5,28,28
1683668082363,MMW 122,A01,193526,Rahimi; Babak,0,16,28,28
1683668082363,MMW 122,A02,193527,Rahimi; Babak,0,15,28,28
1683668082363,MMW 122,A03,193528,Rahimi; Babak,0,0,0,0
1683668082363,MMW 122,A04,193529,Rahimi; Babak,0,0,0,0
1683668083390,MUS 1A,A01,186663,Staff,1,19,35,34
1683668084414,MUS 4,A01,186715,Staff,0,12,35,35
1683668085438,MUS 5R,A01,186796,Dubnov; Shlomo,0,17,35,35
1683668086463,MUS 6,A01,186798,Staff,0,5,25,25
1683668087487,MUS 7,A01,186830,Staff,11,0,35,24
1683668088518,MUS 8,A01,186930,Staff,0,26,35,35
1683668089547,MUS 15,A01,186932,Staff,0,15,35,35
1683668089547,MUS 15,B01,186934,Staff,1,17,35,34
1683668090572,MUS 80,A00,186935,Staff,0,0,20,20
1683668090572,MUS 80,B00,186936,Staff,24,0,25,1
1683668091600,NANO 11,A00,204702,Lipomi; Darren John,0,0,0,0
1683668092627,NANO 15,A01,204709,Yang; Kesong,0,1,0,0
1683668093652,NANO 114,A00,202069,Jahed Motlagh; Zeinab,3,0,10,7
1683668094698,PHIL 1,A00,186955,Grush; Rick Scott,31,0,40,9
1683668095727,PHIL 10,A01,186973,Grush; Rick Scott,27,0,35,8
1683668095727,PHIL 10,A02,186974,Grush; Rick Scott,33,0,35,2
1683668096756,PHIL 13,A01,186976,Staff,3,0,35,32
1683668096756,PHIL 13,A02,186977,Staff,16,0,35,19
1683668097783,PHIL 14,A01,186979,Staff,31,0,35,4
1683668097783,PHIL 14,A02,186986,Staff,32,0,35,3
1683668098809,PHIL 28,A01,186988,Staff,16,0,30,14
1683668098809,PHIL 28,A02,186989,Staff,1,0,30,29
1683668098809,PHIL 28,A03,186990,Staff,10,0,30,20
1683668098809,PHIL 28,A04,186991,Staff,26,0,30,4
1683668099834,PHIL 120,A00,186997,Staff,23,0,40,17
1683668100859,PHIL 137,A00,187003,Staff,7,0,40,33
1683668101884,PHIL 150,A00,187015,Staff,47,0,70,23
1683668102911,PHIL 167,A00,187021,Lamey; Andy M.,34,0,40,6
1683668103935,PHIL 174,A01,202226,Staff,17,0,20,3
1683668103935,PHIL 174,A02,202235,Staff,20,0,20,0
1683668104969,PHIL 191A,A00,258918,Staff,0,0,1,1
1683668105993,PHYS 1A,A00,187028,Staff,26,0,60,34
1683668107018,PHYS 1AL,001,187036,Staff,3,0,30,27
1683668107018,PHYS 1AL,002,187049,Staff,18,0,30,12
1683668108103,PHYS 1B,A00,187058,Staff,22,0,60,38
1683668109129,PHYS 1BL,001,187064,Staff,0,1,30,30
1683668109129,PHYS 1BL,002,187070,Staff,4,0,30,26
1683668110151,PHYS 1C,A00,187082,Staff,29,0,120,91
1683668111175,PHYS 1CL,001,187088,Staff,0,9,30,30
1683668111175,PHYS 1CL,002,187089,Staff,0,1,30,30
1683668111175,PHYS 1CL,009,262693,Staff,9,0,30,21
1683668112197,PHYS 2B,A01,187097,Staff,55,0,115,60
1683668113221,PHYS 2C,A01,187099,Staff,63,0,115,52
1683668114245,PHYS 2CL,A01,187101,Staff,5,0,28,23
1683668114245,PHYS 2CL,A02,187102,Staff,15,0,28,13
1683668115273,PHYS 2D,A01,187123,Shotwell; Brian,95,0,115,20
1683668116301,PHYS 4B,A01,187133,Grinstein; Benjamin,35,0,50,15
1683668117327,POLI 10,A00,188819,Staff,0,4,50,50
1683668118351,POLI 11,A00,188827,Staff,43,0,50,7
1683668119374,POLI 13R,A00,188828,Staff,0,1,20,20
1683668120398,POLI 27,A01,188830,Elgin; Samuel Zincke,0,2,70,70
1683668121423,POLI 30,A00,188832,Desposato; Scott,30,0,50,20
1683668122446,POLI 102F,A00,188834,Staff,0,0,40,40
1683668123469,POLI 104A,A00,188852,Staff,13,0,30,17
1683668124493,POLI 104I,A00,188853,Staff,0,7,20,20
1683668125521,POLI 110B,A00,188854,Wiens; David,6,0,20,14
1683668126548,POLI 112A,A00,188855,Wiens; David,3,0,30,27
1683668127572,POLI 117R,A00,188856,Forman; Fonna,0,12,20,20
1683668128599,POLI 118,A00,188857,Ingham; Sean,8,0,20,12
1683668129626,POLI 120G,A00,188858,Staff,8,0,30,22
1683668130651,POLI 131CR,A00,188863,Hoston; Germaine,21,0,50,29
1683668131675,POLI 133,A00,188864,Nellis; Gareth Hb,44,0,50,6
1683668132699,POLI 134D,A00,188865,Desposato; Scott,27,0,30,3
1683668133721,POLI 142A,A00,188871,Gartzke; Erik,21,0,50,29
1683668134745,POLI 142K,A00,188874,Staff,38,0,50,12
1683668135771,POLI 143,A00,188940,Gartzke; Erik,16,0,30,14
1683668136794,POLI 153,A00,188943,Staff,2,0,20,18
1683668137817,POLI 160AA,A00,188944,Staff,11,0,40,29
1683668138841,POLI 170A,A00,188945,Staff,11,0,30,19
1683668140895,PSYC 1,A00,188952,Staff,36,0,90,54
1683668141918,PSYC 2,B00,188953,Staff,19,0,35,16
1683668142945,PSYC 6,A00,188970,Staff,47,0,60,13
1683668143969,PSYC 7,A00,188973,Staff,35,0,45,10
1683668144995,PSYC 60,A01,188980,Rickard; Timothy C.,42,0,60,18
1683668146024,PSYC 70,A01,189001,Steiner; Eric Tomas,22,0,45,23
1683668147051,PSYC 100,A00,189005,Lacefield; Katharine I,0,99,120,120
1683668148078,PSYC 102,A00,189008,Staff,8,0,30,22
1683668149104,PSYC 106,B00,189026,Gorman; Michael R.,27,0,60,33
1683668150128,PSYC 114,B01,189033,Winkielman; Piotr,0,31,30,30
1683668151157,PSYC 131,A00,189036,Anagnostaras; Stephan,0,43,60,60
1683668152188,PSYC 136,A00,189041,Lowe; Angela Beth,0,7,25,25
1683668153215,PSYC 137,A00,189057,Winkielman; Piotr,1,37,25,24
1683668154240,PSYC 144,A00,189107,Wixted; John T,0,11,50,50
1683668156288,PSYC 162,A00,189142,Staff,0,9,85,85
1683668157312,PSYC 172,A00,189144,Gorman; Michael R.,0,6,30,30
1683668159363,PSYC 179,A00,189146,Lacefield; Katharine I,0,87,120,120
1683668160390,PSYC 181,A00,189147,Anagnostaras; Stephan,0,44,90,90
1683668161414,PSYC 190R,A00,189148,Barner; David A.,0,23,80,80
1683668162442,PSYC 191,A00,189275,Rickard; Timothy C.,0,10,25,25
1683668163471,PSYC 193,A00,189276,Chapman; Eddie Nathaniel,0,1,0,4
1683668164494,PSYC 193L,A01,189281,Lowe; Angela Beth,10,0,20,10
1683668164494,PSYC 193L,B01,189285,Staff,28,0,35,7
1683668165522,RELI 149,A00,187137,Rahimi; Babak,7,0,40,33
1683668166546,SE 9,A01,187315,Staff,0,2,18,18
1683668167569,SE 101B,A00,187409,Staff,24,0,30,6
1683668168596,SE 110B,A00,187444,Staff,10,0,40,30
1683668169620,SE 130B,A00,187449,Staff,31,0,40,9
1683668170644,SE 150A,A00,187516,Staff,8,0,20,12
1683668171671,SE 154,A00,187528,Staff,29,0,50,21
1683668172696,SIO 3,A01,258171,Staff,35,0,40,5
1683668173720,SIO 10,A00,187144,Cook; Geoffrey W,0,7,75,75
1683668174748,SIO 45,A00,187152,Cook; Geoffrey W,0,5,100,100
1683668175773,SIO 109R,A00,194486,Staff,0,4,20,20
1683668177828,SIO 187,A01,187233,Kacev; David,12,0,40,28
1683668178853,SOCI 1,A01,258656,Thorpe; Charles Robert,28,0,30,2
1683668178853,SOCI 1,A02,258658,Thorpe; Charles Robert,30,0,30,0
1683668178853,SOCI 1,A03,258661,Thorpe; Charles Robert,25,0,25,0
1683668178853,SOCI 1,A04,258666,Thorpe; Charles Robert,22,0,25,3
1683668178853,SOCI 1,A05,258897,Thorpe; Charles Robert,22,0,25,3
1683668178853,SOCI 1,A06,258898,Thorpe; Charles Robert,25,0,25,0
1683668179907,SOCI 30,A01,258903,Pardo Guerra; Juan Pablo,14,0,30,16
1683668180932,SOCI 102,A00,258904,Staff,9,0,25,16
1683668181959,SOCI 106,A00,258905,Staff,19,0,25,6
1683668182983,SOCI 111,A00,258907,Ribas Norris; Janet Vanesa,26,0,30,4
1683668184010,SOCI 121R,A00,258908,Pardo Guerra; Juan Pablo,8,0,30,22
1683668185036,SOCI 126,A01,203330,Staff,14,0,20,6
1683668186065,SOCI 131,A00,258909,Thorpe; Charles Robert,30,0,60,30
1683668187093,SOCI 135,A00,258910,Payne; Christine Anna,0,11,30,30
1683668188118,SOCI 157,A00,258911,Staff,12,0,30,18
1683668189143,SOCI 184,A00,258912,Staff,25,0,30,5
1683668190169,SOCI 188D,A00,258913,Staff,22,0,30,8
1683668191195,SYN 2,001,187529,Staff,9,0,16,7
1683668191195,SYN 2,002,201452,Staff,0,20,16,16
1683668191195,SYN 2,003,201469,Staff,1,0,16,15
1683668192222,SYN 100,A01,187531,Staff,0,9,20,20
1683668192222,SYN 100,B01,201491,Staff,0,10,20,20
1683668193250,TDAC 1,A00,189286,Walsh; Kim C.,3,0,20,17
1683668193250,TDAC 1,B00,189287,Harting; Carla Kelso,10,0,20,10
1683668194277,TDAC 101,A00,189300,Walsh; Kim C.,16,0,20,4
1683668194277,TDAC 101,B00,189301,Harting; Carla Kelso,18,0,20,2
1683668195306,TDAC 102,A00,189304,Basso; Beatrice,14,0,20,6
1683668196336,TDAC 108,A00,189305,Staff,18,0,20,2
1683668197361,TDDE 131,A00,189310,Staff,19,0,20,1
1683668197361,TDDE 131,B00,189314,Staff,19,0,20,1
1683668197361,TDDE 131,C00,189315,Staff,48,0,50,2
1683668197361,TDDE 131,D00,189316,Staff,14,0,15,1
1683668197361,TDDE 131,E00,204841,Staff,20,0,20,0
1683668198387,TDGE 10,A00,189289,Staff,27,0,50,23
1683668198387,TDGE 10,B00,189290,Havis; Allan,0,1,50,50
1683668199412,TDGE 11,A00,189291,Fulton; Julia,0,4,50,50
1683668199412,TDGE 11,B00,189292,Staff,20,0,25,5
1683668199412,TDGE 11,C00,260270,Staff,0,0,0,0
1683668200438,TDGE 25,A00,189294,Staff,2,0,20,18
1683668201464,TDGE 124,A00,189318,Fulton; Julia,0,8,50,50
1683668202487,TDGE 125,A00,189319,Staff,13,0,25,12
1683668202487,TDGE 125,B00,189320,Staff,23,0,25,2
1683668203512,TDGE 127,A00,189322,Havis; Allan,1,0,50,49
1683668204547,TDHT 101,A00,189323,Staff,18,0,25,7
1683668204547,TDHT 101,B00,189324,Staff,25,0,25,0
1683668205570,TDHT 102,A00,189325,Staff,49,0,50,1
1683668206598,TDMV 1,A00,189295,Arcidiacono; Kristin,20,0,30,10
1683668206598,TDMV 1,B00,189296,Caligagan; Maria T.,24,0,30,6
1683668207624,TDMV 2,A00,189297,Sammartano; Tonnie,27,0,30,3
1683668207624,TDMV 2,B00,189299,Arcidiacono; Kristin,23,0,30,7
1683668208651,TDMV 3,A00,204998,Rincon; Alicia,22,0,30,8
1683668209675,TDMV 120,A00,189458,Sammartano; Tonnie,28,0,30,2
1683668210703,TDMV 138,A00,189541,Jun; Grace Shin Hae,20,0,40,20
1683668211785,TDMV 142,A00,189717,Caligagan; Tony,25,0,30,5
1683668211785,TDMV 142,B00,189718,Caligagan; Maria T.,25,0,30,5
1683668212816,TMC 2,A01,187533,Staff,25,0,25,0
1683668212816,TMC 2,A02,187534,Staff,25,0,25,0
1683668213840,USP 1,A01,187536,Kwak; Nancy,0,16,25,25
1683668214864,USP 5,A01,187538,Staff,9,0,25,16
1683668215893,USP 101,A00,199253,Staff,0,4,0,0
1683668216920,USP 124,A00,187562,Boomhower; Matthew Charles,0,0,30,30
1683668217944,USP 138,A00,187582,Staff,20,0,25,5
1683668218969,USP 152,A01,187597,Staff,3,0,25,22
1683668219996,USP 153,A00,187598,Staff,19,0,25,6
1683668221021,USP 168,A00,187607,Kwak; Nancy,2,0,5,3
1683668222045,USP 173,A00,187619,Staff,4,0,25,21
1683668223071,USP 181,A00,187638,Staff,0,4,25,25
1683668224102,VIS 103,A00,187650,Cruz; Edwin Teddy,17,0,75,58
1683668225126,VIS 110D,A00,187669,Staff,13,0,22,9
1683668226164,VIS 127C,A00,187720,Shen; Kuiyi,68,0,146,78
1683668227190,VIS 149,A00,187731,Yoldas; Pinar,1,14,22,21
1683668228214,VIS 151,A01,188091,Staff,22,0,34,12
1683668228214,VIS 151,A02,188092,Staff,11,0,34,23
1683668229241,VIS 160B,A00,188093,Stalbaum; Brett,0,1,10,10
1683668231290,WCWP 10B,A00,201720,Staff,10,0,15,5
1683668231290,WCWP 10B,B00,201722,Staff,9,0,15,6
1683668232313,WCWP 100,A00,201725,Gagnon; Jeffrey C,0,0,2,2
1683668232313,WCWP 100,B00,201727,Staff,0,4,15,15
1683668235443,ANBI 133,A00,258401,Wilder; Linnea Lorene,34,0,40,6
1683668236467,ANBI 140,A00,258395,Hrvoj Mihic; Branka,18,0,25,7
1683668237494,ANSC 120,A00,258402,Bialecki; Jon Anthony,26,0,40,14
1683668238521,ANSC 144,A00,258400,Staff,12,0,40,28
1683668240573,ANSC 166,A00,258396,Parish; Steven Martin,156,0,175,19
1683668241598,ANSC 180,A00,193533,Staff,8,0,20,12
1683668242622,ANSC 188,A00,258397,Jassal; Aftab,34,0,40,6
1683668243649,ANTH 3,A01,258316,Staff,23,0,30,7
1683668244676,ANTH 5,A00,258394,Semendeferi; Ekaterini,16,0,20,4
1683668245701,ANTH 21,A01,258331,Staff,4,0,40,36
1683668246727,ANTH 103,A00,258398,Varma; Saiba,15,0,25,10
1683668247758,AWP 10,001,202034,Staff,0,0,0,0
1683668247758,AWP 10,002,202035,Staff,0,0,0,0
1683668247758,AWP 10,003,202036,Staff,0,0,0,0
1683668247758,AWP 10,004,202037,Staff,0,0,0,0
1683668247758,AWP 10,005,202038,Staff,0,0,0,0
1683668247758,AWP 10,006,202039,Staff,0,0,0,0
1683668247758,AWP 10,007,202040,Staff,0,0,0,0
1683668247758,AWP 10,008,202041,Staff,0,0,0,0
1683668247758,AWP 10,009,202042,Staff,0,0,0,0
1683668247758,AWP 10,010,202043,Staff,0,0,0,0
1683668247758,AWP 10,011,202044,Staff,0,0,0,0
1683668247758,AWP 10,012,202045,Staff,0,0,0,0
1683668247758,AWP 10,013,202046,Staff,0,0,0,0
1683668247758,AWP 10,014,202047,Staff,0,0,0,0
1683668247758,AWP 10,015,202048,Staff,0,0,0,0
1683668247758,AWP 10,016,202049,Staff,0,0,0,0
1683668247758,AWP 10,017,202050,Staff,0,0,0,0
1683668247758,AWP 10,018,202051,Staff,0,0,0,0
1683668247758,AWP 10,019,202052,Staff,0,0,0,0
1683668247758,AWP 10,020,202053,Staff,0,0,0,0
1683668247758,AWP 10,021,202054,Staff,0,0,0,0
1683668247758,AWP 10,022,202055,Staff,0,0,0,0
1683668247758,AWP 10,023,202056,Staff,0,0,0,0
1683668247758,AWP 10,024,202057,Staff,0,0,0,0
1683668247758,AWP 10,025,202058,Staff,0,0,0,0
1683668247758,AWP 10,026,202059,Staff,0,0,0,0
1683668248783,AWP 102,001,202032,Staff,0,0,0,0
1683668248783,AWP 102,002,202033,Staff,0,0,0,0
1683668249807,BENG 100,A01,254234,Taylor Amos; Alyssa C,31,0,40,9
1683668250831,BENG 196,001,270013,Engler; Adam J.,9999,0,9999,0
1683668251856,BICD 100R,A01,202018,Smith; Laurie,0,7,32,32
1683668251856,BICD 100R,A02,202019,Smith; Laurie,0,3,32,32
1683668251856,BICD 100R,A03,202020,Smith; Laurie,0,1,32,32
1683668251856,BICD 100R,A04,202021,Smith; Laurie,6,0,32,26
1683668251856,BICD 100R,A05,202022,Smith; Laurie,11,0,32,21
1683668252880,BICD 136,A01,193242,Gustafson-Brown; Cindy,0,2,32,32
1683668252880,BICD 136,A02,193244,Gustafson-Brown; Cindy,13,0,32,19
1683668253910,BIEB 102,A01,193249,Butler; Shannon Rhey,1,2,32,31
1683668253910,BIEB 102,A02,193251,Butler; Shannon Rhey,0,0,32,32
1683668253910,BIEB 102,A03,193253,Butler; Shannon Rhey,0,0,32,32
1683668253910,BIEB 102,A04,193255,Butler; Shannon Rhey,14,0,32,18
1683668253910,BIEB 102,A05,193265,Butler; Shannon Rhey,25,0,32,7
1683668253910,BIEB 102,A06,193269,Butler; Shannon Rhey,14,0,32,18
1683668255959,BIEB 150,A01,193274,Staff,0,0,32,32
1683668255959,BIEB 150,A02,193285,Staff,24,0,32,8
1683668256986,BIEB 194,A00,193286,Kurle; Carolyn M.,20,0,32,12
1683668258013,BILD 1,A01,192291,Staff,15,0,32,17
1683668258013,BILD 1,A02,192292,Staff,30,0,32,2
1683668258013,BILD 1,B01,192520,Reuther; Keefe,0,1,0,0
1683668258013,BILD 1,B02,192532,Reuther; Keefe,0,1,0,0
1683668259042,BILD 3,A01,192556,Butler; Shannon Rhey,0,0,32,32
1683668259042,BILD 3,A02,192581,Butler; Shannon Rhey,0,0,32,32
1683668259042,BILD 3,A03,192611,Butler; Shannon Rhey,20,0,32,12
1683668259042,BILD 3,A04,192612,Butler; Shannon Rhey,24,0,32,8
1683668259042,BILD 3,A05,192613,Butler; Shannon Rhey,26,0,32,6
1683668259042,BILD 3,A06,192679,Butler; Shannon Rhey,27,0,32,5
1683668259042,BILD 3,A07,192682,Butler; Shannon Rhey,20,0,32,12
1683668260067,BILD 4,A01,192836,Reuther; Keefe,1,0,24,23
1683668260067,BILD 4,A02,193044,Reuther; Keefe,4,0,24,20
1683668261091,BILD 10,A01,193142,Gustafson-Brown; Cindy,29,0,32,3
1683668261091,BILD 10,A02,193149,Gustafson-Brown; Cindy,31,0,32,1
1683668262119,BIMM 100,A01,193301,Staff,0,6,32,32
1683668262119,BIMM 100,A02,193312,Staff,0,7,32,32
1683668262119,BIMM 100,A03,193323,Staff,0,9,32,32
1683668263148,BIMM 101,A01,193329,McDonnell; Lisa Marie,1,4,24,23
1683668263148,BIMM 101,A02,193339,McDonnell; Lisa Marie,1,4,24,23
1683668263148,BIMM 101,B01,193354,McDonnell; Lisa Marie,0,4,24,24
1683668263148,BIMM 101,B02,193357,McDonnell; Lisa Marie,0,3,24,24
1683668264175,BIMM 110,A01,193377,Tat; John,0,11,32,32
1683668264175,BIMM 110,A02,193378,Tat; John,0,10,32,32
1683668265200,BIMM 120,A01,206116,Staff,0,0,32,32
1683668265200,BIMM 120,A02,206117,Staff,7,0,32,25
1683668265200,BIMM 120,A03,206121,Staff,21,0,32,11
1683668266225,BIPN 100,A01,193393,Park; Ji Young,0,15,32,32
1683668266225,BIPN 100,A02,193402,Park; Ji Young,0,14,32,32
1683668266225,BIPN 100,A03,193413,Park; Ji Young,0,14,32,32
1683668266225,BIPN 100,A04,193414,Park; Ji Young,0,13,32,32
1683668267251,BIPN 102,A01,193429,Staff,0,0,32,32
1683668267251,BIPN 102,A02,193438,Staff,18,0,32,14
1683668268279,BIPN 106,A01,193450,Reyes Gonzalez; Catalina,0,2,40,40
1683668269308,BIPN 134,A01,193465,Cooke; James Edward,0,0,32,32
1683668269308,BIPN 134,A02,193474,Cooke; James Edward,25,0,32,7
1683668269308,BIPN 134,A03,193485,Cooke; James Edward,29,0,32,3
1683668269308,BIPN 134,A04,193486,Cooke; James Edward,20,0,32,12
1683668269308,BIPN 134,A05,193491,Cooke; James Edward,31,0,32,1
1683668269308,BIPN 134,A06,193501,Cooke; James Edward,30,0,32,2
1683668269308,BIPN 134,A07,193510,Cooke; James Edward,29,0,32,3
1683668271361,BISP 194,A00,222522,Staff,14,0,32,18
1683668272384,CAT 124,A01,202407,Staff,19,0,25,6
1683668273409,CAT 125,A00,202408,Marchisotto; Jennifer Anne,2,0,20,18
1683668274438,CAT 125R,A00,202409,Smith; Lauryn Alissa,0,11,20,20
1683668274438,CAT 125R,B00,202410,Morales; Celeste Georgianna,0,11,20,20
1683668274438,CAT 125R,C00,202411,Irwin; Matthew Joseph,0,12,20,20
1683668275465,CENG 15,A01,204712,Yang; Kesong,0,1,0,0
1683668276491,CENG 114,A00,202070,Jahed Motlagh; Zeinab,5,0,20,15
1683668277515,CGS 105,A00,185477,Wesling; Megan E.,24,0,40,16
1683668278543,CGS 106,A00,185494,Staff,11,0,22,11
1683668279569,CGS 108,A00,185495,Staff,14,0,20,6
1683668280596,CGS 114,A00,185496,Staff,13,0,18,5
1683668281620,CGS 119,A00,185501,Staff,15,0,20,5
1683668282645,CGS 120,A00,185511,Staff,12,0,20,8
1683668283670,CHEM 4,A01,184675,Bussey; Thomas J,97,0,100,3
1683668284697,CHEM 6A,A01,184677,Staff,32,0,60,28
1683668285721,CHEM 6B,A01,184679,Staff,63,0,100,37
1683668286745,CHEM 6C,A01,184681,Bussey; Thomas J,0,0,50,50
1683668286745,CHEM 6C,A02,184682,Bussey; Thomas J,32,0,50,18
1683668287774,CHEM 40A,A01,184684,Albizati; Kim F.,34,0,100,66
1683668288802,CHEM 40B,A01,184686,Albizati; Kim F.,0,22,100,100
1683668289832,CHEM 41B,A01,184690,Staff,51,0,100,49
1683668290868,COGS 3,A01,184715,Boyle; Mary E. T.,0,27,40,40
1683668291893,COGS 14B,A01,185172,Staff,0,14,38,38
1683668292916,COGS 18,A01,184736,Staff,14,0,80,66
1683668293940,COGS 100,A01,184932,Staff,0,8,73,73
1683668294964,COGS 101A,A01,184935,Staff,0,40,30,30
1683668295988,COGS 101B,A01,184944,Staff,0,2,30,30
1683668297014,COGS 101C,A01,184946,Staff,0,10,30,30
1683668298037,COGS 102A,A01,184951,Johnson; Christine M.,2,0,40,38
1683668299065,COGS 107B,A01,184953,Mooshagian; Eric Frederick,0,51,40,40
1683668300089,COGS 118B,A01,184959,Gupta; Anjum,0,50,40,40
1683668301116,COGS 153,A00,184961,Staff,0,16,30,30
1683668302140,COGS 177,A00,184962,Staff,0,21,30,30
1683668303164,COGS 187A,A01,184969,Boyle; Mary E. T.,0,19,40,40
1683668304192,COMM 10,A01,185174,Staff,0,5,25,25
1683668304192,COMM 10,A02,185189,Staff,0,2,25,25
1683668304192,COMM 10,A03,269821,Staff,0,1,0,0
1683668305217,COMM 100B,A01,185475,Staff,0,1,0,2
1683668305217,COMM 100B,A02,185476,Staff,12,0,25,13
1683668306242,COMM 100C,A01,185314,Staff,1,0,25,24
1683668306242,COMM 100C,A02,185327,Staff,18,0,25,7
1683668307266,COMM 110M,A00,185349,Staff,0,0,40,40
1683668308289,COMM 113T,A00,185352,Staff,25,0,40,15
1683668309315,COMM 114I,A00,185353,Staff,31,0,40,9
1683668310345,COMM 131,A00,185354,Staff,17,0,30,13
1683668311368,CSE 8A,A50,185358,Cao; Yingjun,0,46,10,10
1683668312392,CSE 8B,A01,185362,Staff,0,48,50,50
1683668313420,CSE 11,A01,185416,Cao; Yingjun,0,91,10,10
1683668314444,CSE 20,A01,185445,Briones; Jor-el Thomas Caparas,4,0,25,21
1683668315541,CSE 21,A01,185447,Staff,9,0,50,41
1683668316565,CSE 101,A01,185451,Staff,0,13,50,50
1683668316565,CSE 101,B01,185453,Jones; Miles E,0,14,50,50
1683668318616,CSE 141,A01,185458,Eldon; John,16,0,100,84
1683668319642,CSE 141L,A01,185461,Eldon; John,8,0,100,92
1683668320667,CSE 142,A01,185463,Staff,34,0,60,26
1683668320667,CSE 142,B01,201355,Staff,0,7,60,60
1683668321694,CSE 142L,A01,185470,Staff,34,0,60,26
1683668321694,CSE 142L,B01,201417,Staff,0,6,60,60
1683668322718,CSE 190,A00,201433,Staff,32,0,49,17
1683668323746,DOC 1,A01,259136,Strom; Megan C.,7,0,15,8
1683668323746,DOC 1,A02,259137,Strom; Megan C.,14,0,15,1
1683668323746,DOC 1,A03,259138,Strom; Megan C.,14,0,15,1
1683668323746,DOC 1,A04,259139,Strom; Megan C.,14,0,15,1
1683668324776,DOC 100D,A00,259140,Pass; Natalye Joann,14,0,25,11
1683668325808,DSGN 1,A01,184749,Rill; Bryan,0,26,30,30
1683668326833,DSGN 100,A01,185168,Staff,0,2,25,25
1683668327860,ECE 5,A01,185626,Morris; Karcher William,0,12,0,0
1683668328886,ECE 101,A01,185628,Staff,14,0,70,56
1683668329910,ECE 107,A01,185635,Baghdadchi; Saharnaz,0,0,20,20
1683668329910,ECE 107,A02,185638,Baghdadchi; Saharnaz,1,0,20,19
1683668330934,ECE 148,A01,185647,Silberman; Jack,0,0,16,16
1683668331961,ECON 1,A01,185537,Crane; Meredith Helen,54,0,70,16
1683668332985,ECON 3,A01,185549,Crane; Meredith Helen,29,0,70,41
1683668334010,ECON 4,A01,203354,Anderson; John Charles,0,5,10,10
1683668335039,ECON 100A,A01,185574,Staff,0,5,40,40
1683668336063,ECON 100B,A01,185576,Staff,0,12,50,50
1683668337090,ECON 100C,A01,185589,Newhouse; Herbert S,30,0,70,40
1683668338113,ECON 105,A00,185608,Vespa; Emanuel Ignacio,19,0,35,16
1683668339137,ECON 109,A01,185610,Shishkin; Denis,9,0,35,26
1683668340167,ECON 110A,A01,185612,Staff,9,0,40,31
1683668341189,ECON 120A,A01,185615,Staff,19,0,40,21
1683668342216,ECON 120C,A01,185617,Sun; Yixiao,0,20,70,70
1683668343241,ECON 144,A00,203346,Squires; Dale E,2,0,35,33
1683668344271,ECON 171,A01,203349,Newhouse; Herbert S,0,1,35,35
1683668345296,ECON 173A,A01,185621,Toda; Alexis Akira,20,0,35,15
1683668346326,EDS 25,A01,202413,Staff,0,1,0,0
1683668346326,EDS 25,A02,202414,Staff,0,1,0,0
1683668346326,EDS 25,A03,202415,Staff,0,0,0,0
1683668346326,EDS 25,A04,202416,Staff,0,1,0,0
1683668346326,EDS 25,A05,202439,Staff,0,0,0,0
1683668346326,EDS 25,A06,202440,Staff,0,0,0,0
1683668346326,EDS 25,B01,202631,Staff,0,0,0,0
1683668346326,EDS 25,B02,202632,Staff,0,0,0,0
1683668346326,EDS 25,B03,202639,Staff,0,0,0,0
1683668346326,EDS 25,B04,202640,Staff,0,0,0,0
1683668346326,EDS 25,B05,202643,Staff,0,0,0,0
1683668346326,EDS 25,B06,202644,Staff,0,0,0,0
1683668347354,EDS 38,A01,202659,Black; Alison Michelle,24,0,25,1
1683668348383,EDS 115,A00,202652,Staff,18,0,30,12
1683668349406,EDS 125,A00,202649,Staff,13,0,30,17
1683668350433,EDS 126,A01,203332,Staff,30,0,30,0
1683668351457,EDS 139,A00,202838,Staff,16,0,25,9
1683668352481,EDS 146,A01,202655,Staff,14,0,25,11
1683668353505,ENG 15,A00,185667,Staff,0,1,0,0
1683668353505,ENG 15,B00,185672,Staff,0,0,0,0
1683668353505,ENG 15,C00,185675,Staff,0,0,0,0
1683668353505,ENG 15,D00,185682,Staff,0,0,0,0
1683668353505,ENG 15,E00,185684,Staff,0,0,0,0
1683668354529,ETHN 103,A00,185710,Staff,0,8,35,35
1683668355559,ETHN 103A,A00,199228,Man; Simeon S,0,0,9,9
1683668356583,ETHN 109,A00,185711,Staff,15,0,35,20
1683668357609,ETHN 142,A00,185726,Staff,0,4,30,30
1683668358632,ETHN 163J,A00,199229,Man; Simeon S,5,0,8,3
1683668359655,ETHN 168,A00,185727,Staff,7,0,10,3
1683668360678,ETHN 182,A00,185728,Staff,0,0,35,35
1683668361705,ETHN 183,A00,185737,Staff,9,0,18,9
1683668362732,GLBH 111,A01,209361,Burgos; Jose L.,0,0,0,0
1683668364782,HIEU 104,A00,185792,Staff,14,0,20,6
1683668365809,HIEU 115,A00,185800,Staff,0,0,20,20
1683668366832,HIEU 128,A00,185801,Staff,0,9,20,20
1683668367858,HIEU 147,A00,185802,Staff,15,0,20,5
1683668368884,HIEU 154,A00,185823,Staff,11,0,20,9
1683668369908,HILA 102,A00,185826,Staff,14,0,20,6
1683668370932,HILD 2C,A01,185778,Staff,0,13,20,20
1683668371960,HILD 7B,A01,185780,Kwak; Nancy,0,17,32,32
1683668371960,HILD 7B,A02,185781,Kwak; Nancy,0,18,32,32
1683668372986,HILD 30,A01,185791,Staff,12,0,20,8
1683668374017,HISC 119,A00,185830,Golan; Tal,0,9,20,20
1683668375041,HITO 156GS,A00,185831,Patterson; Patrick H.,0,0,0,23
1683668376067,HIUS 103,A00,185832,Man; Simeon S,0,4,20,20
1683668377090,HIUS 117,A00,185836,Kwak; Nancy,2,0,20,18
1683668378113,HIUS 125,A00,185840,Man; Simeon S,0,2,23,23
1683668379137,HIUS 149,A00,185845,Staff,1,0,20,19
1683668380161,HUM 3,A01,185882,Zavodny; Tatiana Sophia,0,8,50,50
1683668380161,HUM 3,B01,185899,Caldwell; Michael Alan,0,18,50,50
1683668381185,HUM 3GS,A00,185900,Patterson; Patrick H.,0,0,0,23
1683668382214,HUM 4,A01,185938,Zroka; Amy Liane,29,0,50,21
1683668382214,HUM 4,B01,185956,Watkins; Eric,0,5,50,50
1683668382214,HUM 4,B02,202209,Watkins; Eric,0,5,50,50
1683668382214,HUM 4,B03,202210,Watkins; Eric,0,5,50,50
1683668383237,HUM 5,A01,185958,West; Geoffrey Scott,0,0,50,50
1683668383237,HUM 5,A02,202215,West; Geoffrey Scott,0,0,50,50
1683668384263,INTL 190,A00,185959,Gagnon; Jeffrey C,0,0,0,9
1683668384263,INTL 190,B00,185960,Lettieri; Michael Joseph,0,0,0,2
1683668385287,JAPN 180,A00,254509,Staff,5,0,30,25
1683668386315,LATI 10,A01,202853,Kennemore; Amy Michelle,4,0,35,31
1683668386315,LATI 10,A02,202854,Kennemore; Amy Michelle,2,0,35,33
1683668386315,LATI 10,A03,270054,Kennemore; Amy Michelle,30,0,30,0
1683668387344,LATI 180,A00,202855,Kennemore; Amy Michelle,11,0,20,9
1683668388368,LAWS 101,A00,201767,Golan; Tal,0,7,40,40
1683668389390,LIFR 1C,A00,185961,Staff,6,0,20,14
1683668390416,LIFR 1CX,A00,185962,Staff,7,0,20,13
1683668391440,LIFR 1D,A00,185963,Staff,7,0,20,13
1683668392464,LIFR 1DX,A00,185964,Staff,7,0,20,13
1683668393489,LIGN 101,A01,186039,Staff,43,0,50,7
1683668394514,LIGN 165,A00,186040,Staff,15,0,50,35
1683668395540,LTCS 108,A00,186041,Staff,5,0,10,5
1683668396565,LTCS 119,A00,186042,Staff,15,0,20,5
1683668397587,LTCS 130,A00,186043,Wesling; Megan E.,15,0,25,10
1683668399633,LTEA 138,A00,186119,Staff,14,0,40,26
1683668400660,LTEN 124,A00,186148,Staff,5,0,25,20
1683668401682,LTEN 178,A00,186149,Staff,7,0,15,8
1683668402707,LTEN 181,A00,186150,Blanco; John D,34,0,40,6
1683668403731,LTWL 120,A00,186160,Staff,19,0,25,6
1683668404756,LTWL 165,A00,186161,Staff,22,0,25,3
1683668405779,LTWR 100,A00,186162,Staff,0,5,15,15
1683668406803,LTWR 102,A00,186163,Doller; Ben,5,0,15,10
1683668407830,MAE 8,A01,186412,Staff,0,0,0,0
1683668408858,MAE 30B,A00,186445,Bahadori; Mohammad Yousef,82,0,100,18
1683668409884,MAE 40,A00,186592,Bewley; Thomas R,10,0,50,40
1683668410939,MAE 101B,A00,186593,Bahadori; Mohammad Yousef,80,0,100,20
1683668411965,MAE 105,A00,186594,Bandaru; Prabhakar,10,0,50,40
1683668412994,MAE 107,A00,186599,Pham; Hieu Tan,0,7,120,120
1683668414018,MAE 148,A01,186660,Silberman; Jack,3,0,16,13
1683668415047,MATH 10A,A01,188095,Staff,0,6,35,35
1683668416074,MATH 10B,A01,188097,Bowers; Adam R.,0,12,30,30
1683668416074,MATH 10B,A02,188099,Bowers; Adam R.,0,11,30,30
1683668416074,MATH 10B,B01,188104,Bowers; Adam R.,0,10,30,30
1683668416074,MATH 10B,B02,188106,Bowers; Adam R.,1,9,30,29
1683668417103,MATH 10C,A01,188111,Staff,0,19,30,30
1683668417103,MATH 10C,A02,188127,Staff,0,19,30,30
1683668417103,MATH 10C,A03,188131,Staff,0,19,30,30
1683668417103,MATH 10C,B01,188218,Staff,17,0,30,13
1683668417103,MATH 10C,B02,188244,Staff,13,0,30,17
1683668417103,MATH 10C,B03,188277,Staff,14,0,30,16
1683668418129,MATH 18,A01,188344,Bach; Quang Tran,18,0,30,12
1683668418129,MATH 18,A02,188345,Bach; Quang Tran,11,0,30,19
1683668418129,MATH 18,B01,188353,Bach; Quang Tran,11,0,30,19
1683668418129,MATH 18,B02,188354,Bach; Quang Tran,19,0,30,11
1683668419213,MATH 20A,A01,188374,Staff,11,0,35,24
1683668420248,MATH 20B,A01,188382,Ohm; Ko Woon,7,0,30,23
1683668420248,MATH 20B,A02,188383,Ohm; Ko Woon,22,0,30,8
1683668420248,MATH 20B,B01,188385,Ohm; Ko Woon,7,0,30,23
1683668420248,MATH 20B,B02,188392,Ohm; Ko Woon,22,0,30,8
1683668421273,MATH 20C,A01,188394,Harel; Guershon,10,0,30,20
1683668421273,MATH 20C,A02,188395,Harel; Guershon,13,0,30,17
1683668421273,MATH 20C,B01,188404,Harel; Guershon,5,0,30,25
1683668421273,MATH 20C,B02,188405,Harel; Guershon,18,0,30,12
1683668422299,MATH 20D,A01,188414,Hammock; Frances H,0,1,30,30
1683668422299,MATH 20D,A02,188415,Hammock; Frances H,0,1,30,30
1683668422299,MATH 20D,B01,188447,Hammock; Frances H,0,1,30,30
1683668422299,MATH 20D,B02,188486,Hammock; Frances H,3,0,30,27
1683668423327,MATH 20E,A01,188649,Staff,21,0,30,9
1683668423327,MATH 20E,A02,188650,Staff,21,0,30,9
1683668423327,MATH 20E,A03,188673,Staff,0,0,30,30
1683668424351,MATH 102,A01,188675,Staff,0,36,35,35
1683668425379,MATH 103B,A01,188681,Staff,3,0,35,32
1683668425379,MATH 103B,B01,188692,Staff,5,0,35,30
1683668426405,MATH 109,A01,188695,Salehi Golsefidy; Alireza,24,0,35,11
1683668426405,MATH 109,A02,188696,Salehi Golsefidy; Alireza,25,0,35,10
1683668427428,MATH 120A,A01,188698,Eggers; John Dietrich,7,0,35,28
1683668428452,MATH 142B,A01,188736,Ioana; Adrian,1,1,30,29
1683668428452,MATH 142B,A02,188741,Ioana; Adrian,0,1,30,30
1683668428452,MATH 142B,A03,188743,Ioana; Adrian,0,1,30,30
1683668429475,MATH 168A,A01,188790,Staff,0,10,35,35
1683668430500,MATH 170A,A01,188803,Nie; Jiawang,0,2,35,35
1683668430500,MATH 170A,A02,188811,Nie; Jiawang,0,0,35,35
1683668430500,MATH 170A,A03,188814,Nie; Jiawang,0,0,35,35
1683668430500,MATH 170A,A04,188815,Nie; Jiawang,8,0,35,27
1683668431528,MATH 193B,A01,188817,Staff,0,0,35,35
1683668431528,MATH 193B,A02,188818,Staff,6,0,35,29
1683668432555,MGT 4,A01,202857,Anderson; John Charles,60,0,80,20
1683668433582,MGT 12,A00,202858,Lindenberger; Wade Douglas,40,0,90,50
1683668434608,MGT 18,A00,202859,Staff,74,0,90,16
1683668435635,MGT 18GS,A00,202860,McKay; Michael J,13,0,28,15
1683668436662,MGT 45,A00,202861,Pecore; Joseph P.,11,0,90,79
1683668437689,MGT 100,A00,202863,Yavorsky; Daniel Ryan,28,0,90,62
1683668438714,MGT 103,A00,202864,Ehrich; Kristine R,0,18,90,90
1683668439741,MGT 112,A00,202865,Ehrich; Kristine R,15,0,90,75
1683668440768,MGT 121A,A00,202868,Staff,90,20,90,0
1683668441799,MGT 131B,A00,202869,Anderson; John Charles,59,0,90,31
1683668442828,MGT 136,A00,202871,Lindenberger; Wade Douglas,83,0,90,7
1683668443858,MGT 164,A00,202873,Staff,0,67,90,91
1683668444883,MGT 164GS,A00,202874,McKay; Mary A,13,0,28,15
1683668445926,MGT 180,A00,202875,Staff,0,51,90,91
1683668446949,MMW 11R,A01,205019,Herbst; Matthew,1,0,30,29
1683668446949,MMW 11R,A02,205026,Herbst; Matthew,29,0,30,1
1683668447975,MMW 15,A01,193512,Chang; Edmond Yi-Teh,0,8,28,28
1683668447975,MMW 15,A02,193513,Chang; Edmond Yi-Teh,0,5,28,28
1683668447975,MMW 15,A03,193514,Chang; Edmond Yi-Teh,0,5,28,28
1683668447975,MMW 15,A04,193515,Chang; Edmond Yi-Teh,0,5,28,28
1683668447975,MMW 15,A05,193516,Chang; Edmond Yi-Teh,0,5,28,28
1683668447975,MMW 15,A06,193517,Chang; Edmond Yi-Teh,0,6,28,28
1683668447975,MMW 15,B01,193519,Chang; Edmond Yi-Teh,0,5,28,28
1683668447975,MMW 15,B02,193520,Chang; Edmond Yi-Teh,0,5,28,28
1683668447975,MMW 15,B03,193521,Chang; Edmond Yi-Teh,0,5,28,28
1683668447975,MMW 15,B04,193522,Chang; Edmond Yi-Teh,0,5,28,28
1683668447975,MMW 15,B05,193523,Chang; Edmond Yi-Teh,0,5,28,28
1683668447975,MMW 15,B06,193524,Chang; Edmond Yi-Teh,0,5,28,28
1683668449005,MMW 122,A01,193526,Rahimi; Babak,0,16,28,28
1683668449005,MMW 122,A02,193527,Rahimi; Babak,0,15,28,28
1683668449005,MMW 122,A03,193528,Rahimi; Babak,0,0,0,0
1683668449005,MMW 122,A04,193529,Rahimi; Babak,0,0,0,0
1683668450029,MUS 1A,A01,186663,Staff,1,19,35,34
1683668451052,MUS 4,A01,186715,Staff,0,12,35,35
1683668452075,MUS 5R,A01,186796,Dubnov; Shlomo,0,17,35,35
1683668453101,MUS 6,A01,186798,Staff,0,5,25,25
1683668454125,MUS 7,A01,186830,Staff,11,0,35,24
1683668455150,MUS 8,A01,186930,Staff,0,26,35,35
1683668456176,MUS 15,A01,186932,Staff,0,15,35,35
1683668456176,MUS 15,B01,186934,Staff,1,17,35,34
1683668457203,MUS 80,A00,186935,Staff,0,0,20,20
1683668457203,MUS 80,B00,186936,Staff,24,0,25,1
1683668458228,NANO 11,A00,204702,Lipomi; Darren John,0,0,0,0
1683668459255,NANO 15,A01,204709,Yang; Kesong,0,1,0,0
1683668460282,NANO 114,A00,202069,Jahed Motlagh; Zeinab,3,0,10,7
1683668461313,PHIL 1,A00,186955,Grush; Rick Scott,31,0,40,9
1683668462337,PHIL 10,A01,186973,Grush; Rick Scott,27,0,35,8
1683668462337,PHIL 10,A02,186974,Grush; Rick Scott,33,0,35,2
1683668463362,PHIL 13,A01,186976,Staff,3,0,35,32
1683668463362,PHIL 13,A02,186977,Staff,16,0,35,19
1683668464387,PHIL 14,A01,186979,Staff,31,0,35,4
1683668464387,PHIL 14,A02,186986,Staff,32,0,35,3
1683668465413,PHIL 28,A01,186988,Staff,16,0,30,14
1683668465413,PHIL 28,A02,186989,Staff,1,0,30,29
1683668465413,PHIL 28,A03,186990,Staff,10,0,30,20
1683668465413,PHIL 28,A04,186991,Staff,26,0,30,4
1683668466441,PHIL 120,A00,186997,Staff,23,0,40,17
1683668467467,PHIL 137,A00,187003,Staff,7,0,40,33
1683668468492,PHIL 150,A00,187015,Staff,47,0,70,23
1683668469516,PHIL 167,A00,187021,Lamey; Andy M.,34,0,40,6
1683668470541,PHIL 174,A01,202226,Staff,17,0,20,3
1683668470541,PHIL 174,A02,202235,Staff,20,0,20,0
1683668471567,PHIL 191A,A00,258918,Staff,0,0,1,1
1683668472590,PHYS 1A,A00,187028,Staff,26,0,60,34
1683668473614,PHYS 1AL,001,187036,Staff,3,0,30,27
1683668473614,PHYS 1AL,002,187049,Staff,18,0,30,12
1683668474638,PHYS 1B,A00,187058,Staff,22,0,60,38
1683668475662,PHYS 1BL,001,187064,Staff,0,1,30,30
1683668475662,PHYS 1BL,002,187070,Staff,4,0,30,26
1683668476685,PHYS 1C,A00,187082,Staff,29,0,120,91
1683668477709,PHYS 1CL,001,187088,Staff,0,9,30,30
1683668477709,PHYS 1CL,002,187089,Staff,0,1,30,30
1683668477709,PHYS 1CL,009,262693,Staff,9,0,30,21
1683668478737,PHYS 2B,A01,187097,Staff,55,0,115,60
1683668479776,PHYS 2C,A01,187099,Staff,63,0,115,52
1683668480801,PHYS 2CL,A01,187101,Staff,5,0,28,23
1683668480801,PHYS 2CL,A02,187102,Staff,15,0,28,13
1683668481826,PHYS 2D,A01,187123,Shotwell; Brian,95,0,115,20
1683668482851,PHYS 4B,A01,187133,Grinstein; Benjamin,35,0,50,15
1683668483879,POLI 10,A00,188819,Staff,0,4,50,50
1683668484905,POLI 11,A00,188827,Staff,43,0,50,7
1683668485932,POLI 13R,A00,188828,Staff,0,1,20,20
1683668486961,POLI 27,A01,188830,Elgin; Samuel Zincke,0,2,70,70
1683668487988,POLI 30,A00,188832,Desposato; Scott,30,0,50,20
1683668489012,POLI 102F,A00,188834,Staff,0,0,40,40
1683668490040,POLI 104A,A00,188852,Staff,13,0,30,17
1683668491062,POLI 104I,A00,188853,Staff,0,7,20,20
1683668492085,POLI 110B,A00,188854,Wiens; David,6,0,20,14
1683668493110,POLI 112A,A00,188855,Wiens; David,3,0,30,27
1683668494134,POLI 117R,A00,188856,Forman; Fonna,0,12,20,20
1683668495157,POLI 118,A00,188857,Ingham; Sean,8,0,20,12
1683668496181,POLI 120G,A00,188858,Staff,8,0,30,22
1683668497205,POLI 131CR,A00,188863,Hoston; Germaine,21,0,50,29
1683668498232,POLI 133,A00,188864,Nellis; Gareth Hb,44,0,50,6
1683668499256,POLI 134D,A00,188865,Desposato; Scott,27,0,30,3
1683668500281,POLI 142A,A00,188871,Gartzke; Erik,21,0,50,29
1683668501309,POLI 142K,A00,188874,Staff,38,0,50,12
1683668502333,POLI 143,A00,188940,Gartzke; Erik,16,0,30,14
1683668503361,POLI 153,A00,188943,Staff,2,0,20,18
1683668504388,POLI 160AA,A00,188944,Staff,11,0,40,29
1683668505410,POLI 170A,A00,188945,Staff,11,0,30,19
1683668507461,PSYC 1,A00,188952,Staff,36,0,90,54
1683668508488,PSYC 2,B00,188953,Staff,19,0,35,16
1683668509515,PSYC 6,A00,188970,Staff,47,0,60,13
1683668510539,PSYC 7,A00,188973,Staff,35,0,45,10
1683668511564,PSYC 60,A01,188980,Rickard; Timothy C.,42,0,60,18
1683668512589,PSYC 70,A01,189001,Steiner; Eric Tomas,22,0,45,23
1683668513617,PSYC 100,A00,189005,Lacefield; Katharine I,0,99,120,120
1683668514643,PSYC 102,A00,189008,Staff,8,0,30,22
1683668515669,PSYC 106,B00,189026,Gorman; Michael R.,27,0,60,33
1683668516694,PSYC 114,B01,189033,Winkielman; Piotr,0,31,30,30
1683668517718,PSYC 131,A00,189036,Anagnostaras; Stephan,0,43,60,60
1683668518745,PSYC 136,A00,189041,Lowe; Angela Beth,0,7,25,25
1683668519772,PSYC 137,A00,189057,Winkielman; Piotr,1,37,25,24
1683668520798,PSYC 144,A00,189107,Wixted; John T,0,11,50,50
1683668522908,PSYC 162,A00,189142,Staff,0,9,85,85
1683668523936,PSYC 172,A00,189144,Gorman; Michael R.,0,6,30,30
1683668525982,PSYC 179,A00,189146,Lacefield; Katharine I,0,87,120,120
1683668527005,PSYC 181,A00,189147,Anagnostaras; Stephan,0,44,90,90
1683668528029,PSYC 190R,A00,189148,Barner; David A.,0,23,80,80
1683668529054,PSYC 191,A00,189275,Rickard; Timothy C.,0,10,25,25
1683668530080,PSYC 193,A00,189276,Chapman; Eddie Nathaniel,0,1,0,4
1683668531105,PSYC 193L,A01,189281,Lowe; Angela Beth,10,0,20,10
1683668531105,PSYC 193L,B01,189285,Staff,28,0,35,7
1683668532129,RELI 149,A00,187137,Rahimi; Babak,7,0,40,33
1683668533153,SE 9,A01,187315,Staff,0,2,18,18
1683668534180,SE 101B,A00,187409,Staff,24,0,30,6
1683668535208,SE 110B,A00,187444,Staff,10,0,40,30
1683668536235,SE 130B,A00,187449,Staff,31,0,40,9
1683668537258,SE 150A,A00,187516,Staff,8,0,20,12
1683668538286,SE 154,A00,187528,Staff,29,0,50,21
1683668539309,SIO 3,A01,258171,Staff,35,0,40,5
1683668540333,SIO 10,A00,187144,Cook; Geoffrey W,0,7,75,75
1683668541360,SIO 45,A00,187152,Cook; Geoffrey W,0,5,100,100
1683668542385,SIO 109R,A00,194486,Staff,0,4,20,20
1683668544434,SIO 187,A01,187233,Kacev; David,12,0,40,28
1683668545457,SOCI 1,A01,258656,Thorpe; Charles Robert,28,0,30,2
1683668545457,SOCI 1,A02,258658,Thorpe; Charles Robert,30,0,30,0
1683668545457,SOCI 1,A03,258661,Thorpe; Charles Robert,25,0,25,0
1683668545457,SOCI 1,A04,258666,Thorpe; Charles Robert,22,0,25,3
1683668545457,SOCI 1,A05,258897,Thorpe; Charles Robert,22,0,25,3
1683668545457,SOCI 1,A06,258898,Thorpe; Charles Robert,25,0,25,0
1683668546484,SOCI 30,A01,258903,Pardo Guerra; Juan Pablo,14,0,30,16
1683668547510,SOCI 102,A00,258904,Staff,9,0,25,16
1683668548534,SOCI 106,A00,258905,Staff,19,0,25,6
1683668549558,SOCI 111,A00,258907,Ribas Norris; Janet Vanesa,26,0,30,4
1683668550582,SOCI 121R,A00,258908,Pardo Guerra; Juan Pablo,8,0,30,22
1683668551608,SOCI 126,A01,203330,Staff,14,0,20,6
1683668552634,SOCI 131,A00,258909,Thorpe; Charles Robert,30,0,60,30
1683668553659,SOCI 135,A00,258910,Payne; Christine Anna,0,11,30,30
1683668554684,SOCI 157,A00,258911,Staff,12,0,30,18
1683668555707,SOCI 184,A00,258912,Staff,25,0,30,5
1683668556731,SOCI 188D,A00,258913,Staff,22,0,30,8
1683668557757,SYN 2,001,187529,Staff,9,0,16,7
1683668557757,SYN 2,002,201452,Staff,0,20,16,16
1683668557757,SYN 2,003,201469,Staff,1,0,16,15
1683668558781,SYN 100,A01,187531,Staff,0,9,20,20
1683668558781,SYN 100,B01,201491,Staff,0,10,20,20
1683668559806,TDAC 1,A00,189286,Walsh; Kim C.,3,0,20,17
1683668559806,TDAC 1,B00,189287,Harting; Carla Kelso,10,0,20,10
1683668560830,TDAC 101,A00,189300,Walsh; Kim C.,16,0,20,4
1683668560830,TDAC 101,B00,189301,Harting; Carla Kelso,18,0,20,2
1683668561854,TDAC 102,A00,189304,Basso; Beatrice,14,0,20,6
1683668562878,TDAC 108,A00,189305,Staff,18,0,20,2
1683668563915,TDDE 131,A00,189310,Staff,19,0,20,1
1683668563915,TDDE 131,B00,189314,Staff,19,0,20,1
1683668563915,TDDE 131,C00,189315,Staff,48,0,50,2
1683668563915,TDDE 131,D00,189316,Staff,14,0,15,1
1683668563915,TDDE 131,E00,204841,Staff,20,0,20,0
1683668564938,TDGE 10,A00,189289,Staff,27,0,50,23
1683668564938,TDGE 10,B00,189290,Havis; Allan,0,1,50,50
1683668565965,TDGE 11,A00,189291,Fulton; Julia,0,4,50,50
1683668565965,TDGE 11,B00,189292,Staff,20,0,25,5
1683668565965,TDGE 11,C00,260270,Staff,0,0,0,0
1683668566988,TDGE 25,A00,189294,Staff,2,0,20,18
1683668568012,TDGE 124,A00,189318,Fulton; Julia,0,8,50,50
1683668569035,TDGE 125,A00,189319,Staff,13,0,25,12
1683668569035,TDGE 125,B00,189320,Staff,23,0,25,2
1683668570064,TDGE 127,A00,189322,Havis; Allan,1,0,50,49
1683668571091,TDHT 101,A00,189323,Staff,18,0,25,7
1683668571091,TDHT 101,B00,189324,Staff,25,0,25,0
1683668572115,TDHT 102,A00,189325,Staff,49,0,50,1
1683668573142,TDMV 1,A00,189295,Arcidiacono; Kristin,20,0,30,10
1683668573142,TDMV 1,B00,189296,Caligagan; Maria T.,24,0,30,6
1683668574167,TDMV 2,A00,189297,Sammartano; Tonnie,27,0,30,3
1683668574167,TDMV 2,B00,189299,Arcidiacono; Kristin,23,0,30,7
1683668575190,TDMV 3,A00,204998,Rincon; Alicia,22,0,30,8
1683668576217,TDMV 120,A00,189458,Sammartano; Tonnie,28,0,30,2
1683668577244,TDMV 138,A00,189541,Jun; Grace Shin Hae,20,0,40,20
1683668578268,TDMV 142,A00,189717,Caligagan; Tony,25,0,30,5
1683668578268,TDMV 142,B00,189718,Caligagan; Maria T.,25,0,30,5
1683668579294,TMC 2,A01,187533,Staff,25,0,25,0
1683668579294,TMC 2,A02,187534,Staff,25,0,25,0
1683668580318,USP 1,A01,187536,Kwak; Nancy,0,16,25,25
1683668581341,USP 5,A01,187538,Staff,9,0,25,16
1683668582370,USP 101,A00,199253,Staff,0,4,0,0
1683668583397,USP 124,A00,187562,Boomhower; Matthew Charles,0,0,30,30
1683668584420,USP 138,A00,187582,Staff,20,0,25,5
1683668585446,USP 152,A01,187597,Staff,3,0,25,22
1683668586471,USP 153,A00,187598,Staff,19,0,25,6
1683668587497,USP 168,A00,187607,Kwak; Nancy,2,0,5,3
1683668588524,USP 173,A00,187619,Staff,4,0,25,21
1683668589548,USP 181,A00,187638,Staff,0,4,25,25
1683668590572,VIS 103,A00,187650,Cruz; Edwin Teddy,17,0,75,58
1683668591596,VIS 110D,A00,187669,Staff,13,0,22,9
1683668592627,VIS 127C,A00,187720,Shen; Kuiyi,68,0,146,78
1683668593653,VIS 149,A00,187731,Yoldas; Pinar,1,14,22,21
1683668594678,VIS 151,A01,188091,Staff,22,0,34,12
1683668594678,VIS 151,A02,188092,Staff,11,0,34,23
1683668595701,VIS 160B,A00,188093,Stalbaum; Brett,0,1,10,10
1683668597751,WCWP 10B,A00,201720,Staff,10,0,15,5
1683668597751,WCWP 10B,B00,201722,Staff,9,0,15,6
1683668598774,WCWP 100,A00,201725,Gagnon; Jeffrey C,0,0,2,2
1683668598774,WCWP 100,B00,201727,Staff,0,4,15,15
1683668601863,ANBI 133,A00,258401,Wilder; Linnea Lorene,34,0,40,6
1683668602887,ANBI 140,A00,258395,Hrvoj Mihic; Branka,18,0,25,7
1683668603910,ANSC 120,A00,258402,Bialecki; Jon Anthony,26,0,40,14
1683668604943,ANSC 144,A00,258400,Staff,12,0,40,28
1683668606998,ANSC 166,A00,258396,Parish; Steven Martin,156,0,175,19
1683668608024,ANSC 180,A00,193533,Staff,8,0,20,12
1683668609047,ANSC 188,A00,258397,Jassal; Aftab,34,0,40,6
1683668610074,ANTH 3,A01,258316,Staff,23,0,30,7
1683668611097,ANTH 5,A00,258394,Semendeferi; Ekaterini,16,0,20,4
1683668612120,ANTH 21,A01,258331,Staff,4,0,40,36
1683668613142,ANTH 103,A00,258398,Varma; Saiba,15,0,25,10
1683668614173,AWP 10,001,202034,Staff,0,0,0,0
1683668614173,AWP 10,002,202035,Staff,0,0,0,0
1683668614173,AWP 10,003,202036,Staff,0,0,0,0
1683668614173,AWP 10,004,202037,Staff,0,0,0,0
1683668614173,AWP 10,005,202038,Staff,0,0,0,0
1683668614173,AWP 10,006,202039,Staff,0,0,0,0
1683668614173,AWP 10,007,202040,Staff,0,0,0,0
1683668614173,AWP 10,008,202041,Staff,0,0,0,0
1683668614173,AWP 10,009,202042,Staff,0,0,0,0
1683668614173,AWP 10,010,202043,Staff,0,0,0,0
1683668614173,AWP 10,011,202044,Staff,0,0,0,0
1683668614173,AWP 10,012,202045,Staff,0,0,0,0
1683668614173,AWP 10,013,202046,Staff,0,0,0,0
1683668614173,AWP 10,014,202047,Staff,0,0,0,0
1683668614173,AWP 10,015,202048,Staff,0,0,0,0
1683668614173,AWP 10,016,202049,Staff,0,0,0,0
1683668614173,AWP 10,017,202050,Staff,0,0,0,0
1683668614173,AWP 10,018,202051,Staff,0,0,0,0
1683668614173,AWP 10,019,202052,Staff,0,0,0,0
1683668614173,AWP 10,020,202053,Staff,0,0,0,0
1683668614173,AWP 10,021,202054,Staff,0,0,0,0
1683668614173,AWP 10,022,202055,Staff,0,0,0,0
1683668614173,AWP 10,023,202056,Staff,0,0,0,0
1683668614173,AWP 10,024,202057,Staff,0,0,0,0
1683668614173,AWP 10,025,202058,Staff,0,0,0,0
1683668614173,AWP 10,026,202059,Staff,0,0,0,0
1683668615260,AWP 102,001,202032,Staff,0,0,0,0
1683668615260,AWP 102,002,202033,Staff,0,0,0,0
1683668616284,BENG 100,A01,254234,Taylor Amos; Alyssa C,31,0,40,9
1683668617308,BENG 196,001,270013,Engler; Adam J.,9999,0,9999,0
1683668618336,BICD 100R,A01,202018,Smith; Laurie,0,7,32,32
1683668618336,BICD 100R,A02,202019,Smith; Laurie,0,3,32,32
1683668618336,BICD 100R,A03,202020,Smith; Laurie,0,1,32,32
1683668618336,BICD 100R,A04,202021,Smith; Laurie,6,0,32,26
1683668618336,BICD 100R,A05,202022,Smith; Laurie,11,0,32,21
1683668619359,BICD 136,A01,193242,Gustafson-Brown; Cindy,0,2,32,32
1683668619359,BICD 136,A02,193244,Gustafson-Brown; Cindy,13,0,32,19
1683668620388,BIEB 102,A01,193249,Butler; Shannon Rhey,1,2,32,31
1683668620388,BIEB 102,A02,193251,Butler; Shannon Rhey,0,0,32,32
1683668620388,BIEB 102,A03,193253,Butler; Shannon Rhey,0,0,32,32
1683668620388,BIEB 102,A04,193255,Butler; Shannon Rhey,14,0,32,18
1683668620388,BIEB 102,A05,193265,Butler; Shannon Rhey,25,0,32,7
1683668620388,BIEB 102,A06,193269,Butler; Shannon Rhey,14,0,32,18
1683668622435,BIEB 150,A01,193274,Staff,0,0,32,32
1683668622435,BIEB 150,A02,193285,Staff,24,0,32,8
1683668623459,BIEB 194,A00,193286,Kurle; Carolyn M.,20,0,32,12
1683668624486,BILD 1,A01,192291,Staff,15,0,32,17
1683668624486,BILD 1,A02,192292,Staff,30,0,32,2
1683668624486,BILD 1,B01,192520,Reuther; Keefe,0,1,0,0
1683668624486,BILD 1,B02,192532,Reuther; Keefe,0,1,0,0
1683668625512,BILD 3,A01,192556,Butler; Shannon Rhey,0,0,32,32
1683668625512,BILD 3,A02,192581,Butler; Shannon Rhey,0,0,32,32
1683668625512,BILD 3,A03,192611,Butler; Shannon Rhey,20,0,32,12
1683668625512,BILD 3,A04,192612,Butler; Shannon Rhey,24,0,32,8
1683668625512,BILD 3,A05,192613,Butler; Shannon Rhey,26,0,32,6
1683668625512,BILD 3,A06,192679,Butler; Shannon Rhey,27,0,32,5
1683668625512,BILD 3,A07,192682,Butler; Shannon Rhey,20,0,32,12
1683668626604,BILD 4,A01,192836,Reuther; Keefe,1,0,24,23
1683668626604,BILD 4,A02,193044,Reuther; Keefe,4,0,24,20
1683668627627,BILD 10,A01,193142,Gustafson-Brown; Cindy,29,0,32,3
1683668627627,BILD 10,A02,193149,Gustafson-Brown; Cindy,31,0,32,1
1683668628650,BIMM 100,A01,193301,Staff,0,6,32,32
1683668628650,BIMM 100,A02,193312,Staff,0,7,32,32
1683668628650,BIMM 100,A03,193323,Staff,0,9,32,32
1683668629678,BIMM 101,A01,193329,McDonnell; Lisa Marie,1,4,24,23
1683668629678,BIMM 101,A02,193339,McDonnell; Lisa Marie,1,4,24,23
1683668629678,BIMM 101,B01,193354,McDonnell; Lisa Marie,0,4,24,24
1683668629678,BIMM 101,B02,193357,McDonnell; Lisa Marie,0,3,24,24
1683668630700,BIMM 110,A01,193377,Tat; John,0,11,32,32
1683668630700,BIMM 110,A02,193378,Tat; John,0,10,32,32
1683668631725,BIMM 120,A01,206116,Staff,0,0,32,32
1683668631725,BIMM 120,A02,206117,Staff,7,0,32,25
1683668631725,BIMM 120,A03,206121,Staff,21,0,32,11
1683668632755,BIPN 100,A01,193393,Park; Ji Young,0,15,32,32
1683668632755,BIPN 100,A02,193402,Park; Ji Young,0,14,32,32
1683668632755,BIPN 100,A03,193413,Park; Ji Young,0,14,32,32
1683668632755,BIPN 100,A04,193414,Park; Ji Young,0,13,32,32
1683668633780,BIPN 102,A01,193429,Staff,0,0,32,32
1683668633780,BIPN 102,A02,193438,Staff,18,0,32,14
1683668634806,BIPN 106,A01,193450,Reyes Gonzalez; Catalina,0,2,40,40
1683668635833,BIPN 134,A01,193465,Cooke; James Edward,0,0,32,32
1683668635833,BIPN 134,A02,193474,Cooke; James Edward,25,0,32,7
1683668635833,BIPN 134,A03,193485,Cooke; James Edward,29,0,32,3
1683668635833,BIPN 134,A04,193486,Cooke; James Edward,20,0,32,12
1683668635833,BIPN 134,A05,193491,Cooke; James Edward,31,0,32,1
1683668635833,BIPN 134,A06,193501,Cooke; James Edward,30,0,32,2
1683668635833,BIPN 134,A07,193510,Cooke; James Edward,29,0,32,3
1683668637881,BISP 194,A00,222522,Staff,14,0,32,18
1683668638908,CAT 124,A01,202407,Staff,19,0,25,6
1683668639936,CAT 125,A00,202408,Marchisotto; Jennifer Anne,2,0,20,18
1683668640958,CAT 125R,A00,202409,Smith; Lauryn Alissa,0,11,20,20
1683668640958,CAT 125R,B00,202410,Morales; Celeste Georgianna,0,11,20,20
1683668640958,CAT 125R,C00,202411,Irwin; Matthew Joseph,0,12,20,20
1683668641986,CENG 15,A01,204712,Yang; Kesong,0,1,0,0
1683668643013,CENG 114,A00,202070,Jahed Motlagh; Zeinab,5,0,20,15
1683668644038,CGS 105,A00,185477,Wesling; Megan E.,24,0,40,16
1683668645062,CGS 106,A00,185494,Staff,11,0,22,11
1683668646086,CGS 108,A00,185495,Staff,14,0,20,6
1683668647111,CGS 114,A00,185496,Staff,13,0,18,5
1683668648137,CGS 119,A00,185501,Staff,15,0,20,5
1683668649168,CGS 120,A00,185511,Staff,12,0,20,8
1683668650193,CHEM 4,A01,184675,Bussey; Thomas J,97,0,100,3
1683668651220,CHEM 6A,A01,184677,Staff,32,0,60,28
1683668652245,CHEM 6B,A01,184679,Staff,63,0,100,37
1683668653267,CHEM 6C,A01,184681,Bussey; Thomas J,0,0,50,50
1683668653267,CHEM 6C,A02,184682,Bussey; Thomas J,32,0,50,18
1683668654296,CHEM 40A,A01,184684,Albizati; Kim F.,34,0,100,66
1683668655323,CHEM 40B,A01,184686,Albizati; Kim F.,0,22,100,100
1683668656348,CHEM 41B,A01,184690,Staff,51,0,100,49
1683668657373,COGS 3,A01,184715,Boyle; Mary E. T.,0,27,40,40
1683668658398,COGS 14B,A01,185172,Staff,0,14,38,38
1683668659423,COGS 18,A01,184736,Staff,14,0,80,66
1683668660447,COGS 100,A01,184932,Staff,0,8,73,73
1683668661475,COGS 101A,A01,184935,Staff,0,40,30,30
1683668662500,COGS 101B,A01,184944,Staff,0,2,30,30
1683668663525,COGS 101C,A01,184946,Staff,0,10,30,30
1683668664548,COGS 102A,A01,184951,Johnson; Christine M.,2,0,40,38
1683668665573,COGS 107B,A01,184953,Mooshagian; Eric Frederick,0,51,40,40
1683668666598,COGS 118B,A01,184959,Gupta; Anjum,0,50,40,40
1683668667621,COGS 153,A00,184961,Staff,0,16,30,30
1683668668646,COGS 177,A00,184962,Staff,0,21,30,30
1683668669674,COGS 187A,A01,184969,Boyle; Mary E. T.,0,19,40,40
1683668670699,COMM 10,A01,185174,Staff,0,5,25,25
1683668670699,COMM 10,A02,185189,Staff,0,2,25,25
1683668670699,COMM 10,A03,269821,Staff,0,1,0,0
1683668671724,COMM 100B,A01,185475,Staff,0,1,0,2
1683668671724,COMM 100B,A02,185476,Staff,12,0,25,13
1683668672748,COMM 100C,A01,185314,Staff,1,0,25,24
1683668672748,COMM 100C,A02,185327,Staff,18,0,25,7
1683668673775,COMM 110M,A00,185349,Staff,0,0,40,40
1683668674809,COMM 113T,A00,185352,Staff,25,0,40,15
1683668675835,COMM 114I,A00,185353,Staff,31,0,40,9
1683668676861,COMM 131,A00,185354,Staff,17,0,30,13
1683668677885,CSE 8A,A50,185358,Cao; Yingjun,0,46,10,10
1683668678912,CSE 8B,A01,185362,Staff,0,48,50,50
1683668679939,CSE 11,A01,185416,Cao; Yingjun,0,91,10,10
1683668680963,CSE 20,A01,185445,Briones; Jor-el Thomas Caparas,4,0,25,21
1683668681985,CSE 21,A01,185447,Staff,9,0,50,41
1683668683013,CSE 101,A01,185451,Staff,0,13,50,50
1683668683013,CSE 101,B01,185453,Jones; Miles E,0,14,50,50
1683668685064,CSE 141,A01,185458,Eldon; John,16,0,100,84
1683668686088,CSE 141L,A01,185461,Eldon; John,8,0,100,92
1683668687112,CSE 142,A01,185463,Staff,34,0,60,26
1683668687112,CSE 142,B01,201355,Staff,0,7,60,60
1683668688139,CSE 142L,A01,185470,Staff,34,0,60,26
1683668688139,CSE 142L,B01,201417,Staff,0,6,60,60
1683668689164,CSE 190,A00,201433,Staff,32,0,49,17
1683668690189,DOC 1,A01,259136,Strom; Megan C.,7,0,15,8
1683668690189,DOC 1,A02,259137,Strom; Megan C.,14,0,15,1
1683668690189,DOC 1,A03,259138,Strom; Megan C.,14,0,15,1
1683668690189,DOC 1,A04,259139,Strom; Megan C.,14,0,15,1
1683668691213,DOC 100D,A00,259140,Pass; Natalye Joann,14,0,25,11
1683668692237,DSGN 1,A01,184749,Rill; Bryan,0,26,30,30
1683668693260,DSGN 100,A01,185168,Staff,0,2,25,25
1683668694289,ECE 5,A01,185626,Morris; Karcher William,0,12,0,0
1683668695310,ECE 101,A01,185628,Staff,14,0,70,56
1683668696334,ECE 107,A01,185635,Baghdadchi; Saharnaz,0,0,20,20
1683668696334,ECE 107,A02,185638,Baghdadchi; Saharnaz,1,0,20,19
1683668697361,ECE 148,A01,185647,Silberman; Jack,0,0,16,16
1683668698386,ECON 1,A01,185537,Crane; Meredith Helen,54,0,70,16
1683668699412,ECON 3,A01,185549,Crane; Meredith Helen,29,0,70,41
1683668700436,ECON 4,A01,203354,Anderson; John Charles,0,5,10,10
1683668701464,ECON 100A,A01,185574,Staff,0,5,40,40
1683668702493,ECON 100B,A01,185576,Staff,0,12,50,50
1683668703515,ECON 100C,A01,185589,Newhouse; Herbert S,30,0,70,40
1683668704541,ECON 105,A00,185608,Vespa; Emanuel Ignacio,19,0,35,16
1683668705564,ECON 109,A01,185610,Shishkin; Denis,9,0,35,26
1683668706589,ECON 110A,A01,185612,Staff,9,0,40,31
1683668707614,ECON 120A,A01,185615,Staff,19,0,40,21
1683668708640,ECON 120C,A01,185617,Sun; Yixiao,0,20,70,70
1683668709668,ECON 144,A00,203346,Squires; Dale E,2,0,35,33
1683668710691,ECON 171,A01,203349,Newhouse; Herbert S,0,1,35,35
1683668711715,ECON 173A,A01,185621,Toda; Alexis Akira,20,0,35,15
1683668712743,EDS 25,A01,202413,Staff,0,1,0,0
1683668712743,EDS 25,A02,202414,Staff,0,1,0,0
1683668712743,EDS 25,A03,202415,Staff,0,0,0,0
1683668712743,EDS 25,A04,202416,Staff,0,1,0,0
1683668712743,EDS 25,A05,202439,Staff,0,0,0,0
1683668712743,EDS 25,A06,202440,Staff,0,0,0,0
1683668712743,EDS 25,B01,202631,Staff,0,0,0,0
1683668712743,EDS 25,B02,202632,Staff,0,0,0,0
1683668712743,EDS 25,B03,202639,Staff,0,0,0,0
1683668712743,EDS 25,B04,202640,Staff,0,0,0,0
1683668712743,EDS 25,B05,202643,Staff,0,0,0,0
1683668712743,EDS 25,B06,202644,Staff,0,0,0,0
1683668713769,EDS 38,A01,202659,Black; Alison Michelle,24,0,25,1
1683668714792,EDS 115,A00,202652,Staff,18,0,30,12
1683668715820,EDS 125,A00,202649,Staff,13,0,30,17
1683668716844,EDS 126,A01,203332,Staff,30,0,30,0
1683668717878,EDS 139,A00,202838,Staff,16,0,25,9
1683668718907,EDS 146,A01,202655,Staff,14,0,25,11
1683668719934,ENG 15,A00,185667,Staff,0,1,0,0
1683668719934,ENG 15,B00,185672,Staff,0,0,0,0
1683668719934,ENG 15,C00,185675,Staff,0,0,0,0
1683668719934,ENG 15,D00,185682,Staff,0,0,0,0
1683668719934,ENG 15,E00,185684,Staff,0,0,0,0
1683668720958,ETHN 103,A00,185710,Staff,0,8,35,35
1683668721982,ETHN 103A,A00,199228,Man; Simeon S,0,0,9,9
1683668723008,ETHN 109,A00,185711,Staff,15,0,35,20
1683668724035,ETHN 142,A00,185726,Staff,0,4,30,30
1683668725060,ETHN 163J,A00,199229,Man; Simeon S,5,0,8,3
1683668726084,ETHN 168,A00,185727,Staff,7,0,10,3
1683668727107,ETHN 182,A00,185728,Staff,0,0,35,35
1683668728130,ETHN 183,A00,185737,Staff,9,0,18,9
1683668729155,GLBH 111,A01,209361,Burgos; Jose L.,0,0,0,0
1683668731257,HIEU 104,A00,185792,Staff,14,0,20,6
1683668732284,HIEU 115,A00,185800,Staff,0,0,20,20
1683668733309,HIEU 128,A00,185801,Staff,0,9,20,20
1683668734331,HIEU 147,A00,185802,Staff,15,0,20,5
1683668735356,HIEU 154,A00,185823,Staff,11,0,20,9
1683668736382,HILA 102,A00,185826,Staff,14,0,20,6
1683668737411,HILD 2C,A01,185778,Staff,0,13,20,20
1683668738437,HILD 7B,A01,185780,Kwak; Nancy,0,17,32,32
1683668738437,HILD 7B,A02,185781,Kwak; Nancy,0,18,32,32
1683668739463,HILD 30,A01,185791,Staff,12,0,20,8
1683668740490,HISC 119,A00,185830,Golan; Tal,0,9,20,20
1683668741516,HITO 156GS,A00,185831,Patterson; Patrick H.,0,0,0,23
1683668742539,HIUS 103,A00,185832,Man; Simeon S,0,4,20,20
1683668743565,HIUS 117,A00,185836,Kwak; Nancy,2,0,20,18
1683668744591,HIUS 125,A00,185840,Man; Simeon S,0,2,23,23
1683668745615,HIUS 149,A00,185845,Staff,1,0,20,19
1683668746641,HUM 3,A01,185882,Zavodny; Tatiana Sophia,0,8,50,50
1683668746641,HUM 3,B01,185899,Caldwell; Michael Alan,0,18,50,50
1683668747666,HUM 3GS,A00,185900,Patterson; Patrick H.,0,0,0,23
1683668748695,HUM 4,A01,185938,Zroka; Amy Liane,29,0,50,21
1683668748695,HUM 4,B01,185956,Watkins; Eric,0,5,50,50
1683668748695,HUM 4,B02,202209,Watkins; Eric,0,5,50,50
1683668748695,HUM 4,B03,202210,Watkins; Eric,0,5,50,50
1683668749730,HUM 5,A01,185958,West; Geoffrey Scott,0,0,50,50
1683668749730,HUM 5,A02,202215,West; Geoffrey Scott,0,0,50,50
1683668750757,INTL 190,A00,185959,Gagnon; Jeffrey C,0,0,0,9
1683668750757,INTL 190,B00,185960,Lettieri; Michael Joseph,0,0,0,2
1683668751781,JAPN 180,A00,254509,Staff,5,0,30,25
1683668752809,LATI 10,A01,202853,Kennemore; Amy Michelle,4,0,35,31
1683668752809,LATI 10,A02,202854,Kennemore; Amy Michelle,2,0,35,33
1683668752809,LATI 10,A03,270054,Kennemore; Amy Michelle,30,0,30,0
1683668753835,LATI 180,A00,202855,Kennemore; Amy Michelle,11,0,20,9
1683668754863,LAWS 101,A00,201767,Golan; Tal,0,7,40,40
1683668755888,LIFR 1C,A00,185961,Staff,6,0,20,14
1683668756912,LIFR 1CX,A00,185962,Staff,7,0,20,13
1683668757935,LIFR 1D,A00,185963,Staff,7,0,20,13
1683668758961,LIFR 1DX,A00,185964,Staff,7,0,20,13
1683668759989,LIGN 101,A01,186039,Staff,43,0,50,7
1683668761012,LIGN 165,A00,186040,Staff,15,0,50,35
1683668762036,LTCS 108,A00,186041,Staff,5,0,10,5
1683668763062,LTCS 119,A00,186042,Staff,15,0,20,5
1683668764092,LTCS 130,A00,186043,Wesling; Megan E.,15,0,25,10
1683668766145,LTEA 138,A00,186119,Staff,14,0,40,26
1683668767170,LTEN 124,A00,186148,Staff,5,0,25,20
1683668768193,LTEN 178,A00,186149,Staff,7,0,15,8
1683668769221,LTEN 181,A00,186150,Blanco; John D,34,0,40,6
1683668770245,LTWL 120,A00,186160,Staff,19,0,25,6
1683668771272,LTWL 165,A00,186161,Staff,22,0,25,3
1683668772297,LTWR 100,A00,186162,Staff,0,5,15,15
1683668773325,LTWR 102,A00,186163,Doller; Ben,5,0,15,10
1683668774351,MAE 8,A01,186412,Staff,0,0,0,0
1683668775375,MAE 30B,A00,186445,Bahadori; Mohammad Yousef,82,0,100,18
1683668776401,MAE 40,A00,186592,Bewley; Thomas R,10,0,50,40
1683668777426,MAE 101B,A00,186593,Bahadori; Mohammad Yousef,80,0,100,20
1683668778450,MAE 105,A00,186594,Bandaru; Prabhakar,10,0,50,40
1683668779475,MAE 107,A00,186599,Pham; Hieu Tan,0,7,120,120
1683668780500,MAE 148,A01,186660,Silberman; Jack,3,0,16,13
1683668781528,MATH 10A,A01,188095,Staff,0,6,35,35
1683668782553,MATH 10B,A01,188097,Bowers; Adam R.,0,12,30,30
1683668782553,MATH 10B,A02,188099,Bowers; Adam R.,0,11,30,30
1683668782553,MATH 10B,B01,188104,Bowers; Adam R.,0,10,30,30
1683668782553,MATH 10B,B02,188106,Bowers; Adam R.,1,9,30,29
1683668783582,MATH 10C,A01,188111,Staff,0,19,30,30
1683668783582,MATH 10C,A02,188127,Staff,0,19,30,30
1683668783582,MATH 10C,A03,188131,Staff,0,19,30,30
1683668783582,MATH 10C,B01,188218,Staff,17,0,30,13
1683668783582,MATH 10C,B02,188244,Staff,13,0,30,17
1683668783582,MATH 10C,B03,188277,Staff,14,0,30,16
1683668784613,MATH 18,A01,188344,Bach; Quang Tran,18,0,30,12
1683668784613,MATH 18,A02,188345,Bach; Quang Tran,11,0,30,19
1683668784613,MATH 18,B01,188353,Bach; Quang Tran,11,0,30,19
1683668784613,MATH 18,B02,188354,Bach; Quang Tran,19,0,30,11
1683668785646,MATH 20A,A01,188374,Staff,11,0,35,24
1683668786675,MATH 20B,A01,188382,Ohm; Ko Woon,7,0,30,23
1683668786675,MATH 20B,A02,188383,Ohm; Ko Woon,22,0,30,8
1683668786675,MATH 20B,B01,188385,Ohm; Ko Woon,7,0,30,23
1683668786675,MATH 20B,B02,188392,Ohm; Ko Woon,22,0,30,8
1683668787699,MATH 20C,A01,188394,Harel; Guershon,10,0,30,20
1683668787699,MATH 20C,A02,188395,Harel; Guershon,13,0,30,17
1683668787699,MATH 20C,B01,188404,Harel; Guershon,5,0,30,25
1683668787699,MATH 20C,B02,188405,Harel; Guershon,18,0,30,12
1683668788854,MATH 20D,A01,188414,Hammock; Frances H,0,1,30,30
1683668788854,MATH 20D,A02,188415,Hammock; Frances H,0,1,30,30
1683668788854,MATH 20D,B01,188447,Hammock; Frances H,0,1,30,30
1683668788854,MATH 20D,B02,188486,Hammock; Frances H,3,0,30,27
1683668789881,MATH 20E,A01,188649,Staff,21,0,30,9
1683668789881,MATH 20E,A02,188650,Staff,21,0,30,9
1683668789881,MATH 20E,A03,188673,Staff,0,0,30,30
1683668790907,MATH 102,A01,188675,Staff,0,36,35,35
1683668791977,MATH 103B,A01,188681,Staff,3,0,35,32
1683668791977,MATH 103B,B01,188692,Staff,5,0,35,30
1683668793002,MATH 109,A01,188695,Salehi Golsefidy; Alireza,24,0,35,11
1683668793002,MATH 109,A02,188696,Salehi Golsefidy; Alireza,25,0,35,10
1683668794031,MATH 120A,A01,188698,Eggers; John Dietrich,7,0,35,28
1683668800788,MATH 142B,A01,188736,Ioana; Adrian,1,1,30,29
1683668800788,MATH 142B,A02,188741,Ioana; Adrian,0,1,30,30
1683668800788,MATH 142B,A03,188743,Ioana; Adrian,0,1,30,30
1683668801814,MATH 168A,A01,188790,Staff,0,10,35,35
1683668802953,MATH 170A,A01,188803,Nie; Jiawang,0,2,35,35
1683668802953,MATH 170A,A02,188811,Nie; Jiawang,0,0,35,35
1683668802953,MATH 170A,A03,188814,Nie; Jiawang,0,0,35,35
1683668802953,MATH 170A,A04,188815,Nie; Jiawang,8,0,35,27
1683668803981,MATH 193B,A01,188817,Staff,0,0,35,35
1683668803981,MATH 193B,A02,188818,Staff,6,0,35,29
1683668805234,MGT 4,A01,202857,Anderson; John Charles,60,0,80,20
1683668806263,MGT 12,A00,202858,Lindenberger; Wade Douglas,40,0,90,50
1683668807288,MGT 18,A00,202859,Staff,74,0,90,16
1683668808314,MGT 18GS,A00,202860,McKay; Michael J,13,0,28,15
1683668809340,MGT 45,A00,202861,Pecore; Joseph P.,11,0,90,79
1683668810556,MGT 100,A00,202863,Yavorsky; Daniel Ryan,28,0,90,62
1683668811583,MGT 103,A00,202864,Ehrich; Kristine R,0,18,90,90
1683668812611,MGT 112,A00,202865,Ehrich; Kristine R,15,0,90,75
1683668814115,MGT 121A,A00,202868,Staff,90,20,90,0
1683668815143,MGT 131B,A00,202869,Anderson; John Charles,59,0,90,31
1683668816172,MGT 136,A00,202871,Lindenberger; Wade Douglas,83,0,90,7
1683668817195,MGT 164,A00,202873,Staff,0,67,90,91
1683668825266,MGT 164GS,A00,202874,McKay; Mary A,13,0,28,15
1683668826292,MGT 180,A00,202875,Staff,0,51,90,91
1683668833498,MMW 11R,A01,205019,Herbst; Matthew,0,0,30,30
1683668833498,MMW 11R,A02,205026,Herbst; Matthew,29,0,30,1
1683668840189,MMW 15,A01,193512,Chang; Edmond Yi-Teh,0,8,28,28
1683668840189,MMW 15,A02,193513,Chang; Edmond Yi-Teh,0,5,28,28
1683668840189,MMW 15,A03,193514,Chang; Edmond Yi-Teh,0,5,28,28
1683668840189,MMW 15,A04,193515,Chang; Edmond Yi-Teh,0,5,28,28
1683668840189,MMW 15,A05,193516,Chang; Edmond Yi-Teh,0,5,28,28
1683668840189,MMW 15,A06,193517,Chang; Edmond Yi-Teh,0,6,28,28
1683668840189,MMW 15,B01,193519,Chang; Edmond Yi-Teh,0,5,28,28
1683668840189,MMW 15,B02,193520,Chang; Edmond Yi-Teh,0,5,28,28
1683668840189,MMW 15,B03,193521,Chang; Edmond Yi-Teh,0,5,28,28
1683668840189,MMW 15,B04,193522,Chang; Edmond Yi-Teh,0,5,28,28
1683668840189,MMW 15,B05,193523,Chang; Edmond Yi-Teh,0,5,28,28
1683668840189,MMW 15,B06,193524,Chang; Edmond Yi-Teh,0,5,28,28
1683668846409,MMW 122,A01,193526,Rahimi; Babak,0,16,28,28
1683668846409,MMW 122,A02,193527,Rahimi; Babak,0,15,28,28
1683668846409,MMW 122,A03,193528,Rahimi; Babak,0,0,0,0
1683668846409,MMW 122,A04,193529,Rahimi; Babak,0,0,0,0
1683668853927,MUS 1A,A01,186663,Staff,1,19,35,34
1683668861789,MUS 4,A01,186715,Staff,0,12,35,35
1683668870136,MUS 5R,A01,186796,Dubnov; Shlomo,0,17,35,35
1683668876993,MUS 6,A01,186798,Staff,0,5,25,25
1683668883887,MUS 7,A01,186830,Staff,11,0,35,24
1683668891799,MUS 8,A01,186930,Staff,0,26,35,35
1683668899602,MUS 15,A01,186932,Staff,0,15,35,35
1683668899602,MUS 15,B01,186934,Staff,1,17,35,34
1683668905239,MUS 80,A00,186935,Staff,0,0,20,20
1683668905239,MUS 80,B00,186936,Staff,24,0,25,1
1683668912865,NANO 11,A00,204702,Lipomi; Darren John,0,0,0,0
1683668919582,NANO 15,A01,204709,Yang; Kesong,0,1,0,0
1683668925448,NANO 114,A00,202069,Jahed Motlagh; Zeinab,3,0,10,7
1683668932884,PHIL 1,A00,186955,Grush; Rick Scott,31,0,40,9
1683668939756,PHIL 10,A01,186973,Grush; Rick Scott,27,0,35,8
1683668939756,PHIL 10,A02,186974,Grush; Rick Scott,33,0,35,2
1683668944755,PHIL 13,A01,186976,Staff,3,0,35,32
1683668944755,PHIL 13,A02,186977,Staff,16,0,35,19
1683668949067,PHIL 14,A01,186979,Staff,31,0,35,4
1683668949067,PHIL 14,A02,186986,Staff,32,0,35,3
1683668954358,PHIL 28,A01,186988,Staff,16,0,30,14
1683668954358,PHIL 28,A02,186989,Staff,1,0,30,29
1683668954358,PHIL 28,A03,186990,Staff,10,0,30,20
1683668954358,PHIL 28,A04,186991,Staff,26,0,30,4
1683668959992,PHIL 120,A00,186997,Staff,23,0,40,17
1683668964846,PHIL 137,A00,187003,Staff,7,0,40,33
1683668969909,PHIL 150,A00,187015,Staff,47,0,70,23
1683668973907,PHIL 167,A00,187021,Lamey; Andy M.,34,0,40,6
1683668978735,PHIL 174,A01,202226,Staff,17,0,20,3
1683668978735,PHIL 174,A02,202235,Staff,20,0,20,0
1683668983567,PHIL 191A,A00,258918,Staff,0,0,1,1
1683668988302,PHYS 1A,A00,187028,Staff,26,0,60,34
1683668993902,PHYS 1AL,001,187036,Staff,3,0,30,27
1683668993902,PHYS 1AL,002,187049,Staff,18,0,30,12
1683668999476,PHYS 1B,A00,187058,Staff,22,0,60,38
1683669004363,PHYS 1BL,001,187064,Staff,0,1,30,30
1683669004363,PHYS 1BL,002,187070,Staff,4,0,30,26
1683669009992,PHYS 1C,A00,187082,Staff,29,0,120,91
1683669016160,PHYS 1CL,001,187088,Staff,0,9,30,30
1683669016160,PHYS 1CL,002,187089,Staff,0,1,30,30
1683669016160,PHYS 1CL,009,262693,Staff,9,0,30,21
1683669021066,PHYS 2B,A01,187097,Staff,55,0,115,60
1683669026080,PHYS 2C,A01,187099,Staff,63,0,115,52
1683669029982,PHYS 2CL,A01,187101,Staff,5,0,28,23
1683669029982,PHYS 2CL,A02,187102,Staff,15,0,28,13
1683669036899,PHYS 2D,A01,187123,Shotwell; Brian,95,0,115,20
1683669042935,PHYS 4B,A01,187133,Grinstein; Benjamin,35,0,50,15
1683669047698,POLI 10,A00,188819,Staff,0,4,50,50
1683669053597,POLI 11,A00,188827,Staff,43,0,50,7
1683669058574,POLI 13R,A00,188828,Staff,0,1,20,20
1683669063809,POLI 27,A01,188830,Elgin; Samuel Zincke,0,2,70,70
1683669068937,POLI 30,A00,188832,Desposato; Scott,30,0,50,20
1683669073842,POLI 102F,A00,188834,Staff,0,0,40,40
1683669077728,POLI 104A,A00,188852,Staff,13,0,30,17
1683669082338,POLI 104I,A00,188853,Staff,0,7,20,20
1683669086765,POLI 110B,A00,188854,Wiens; David,6,0,20,14
1683669090748,POLI 112A,A00,188855,Wiens; David,3,0,30,27
1683669094714,POLI 117R,A00,188856,Forman; Fonna,0,12,20,20
1683669099760,POLI 118,A00,188857,Ingham; Sean,8,0,20,12
1683669105722,POLI 120G,A00,188858,Staff,8,0,30,22
1683669110373,POLI 131CR,A00,188863,Hoston; Germaine,21,0,50,29
1683669118604,POLI 133,A00,188864,Nellis; Gareth Hb,44,0,50,6
1683669127231,POLI 134D,A00,188865,Desposato; Scott,27,0,30,3
1683669131806,POLI 142A,A00,188871,Gartzke; Erik,21,0,50,29
1683669136505,POLI 142K,A00,188874,Staff,38,0,50,12
1683669149345,POLI 143,A00,188940,Gartzke; Erik,16,0,30,14
1683669158801,POLI 153,A00,188943,Staff,2,0,20,18
1683669171837,POLI 160AA,A00,188944,Staff,11,0,40,29
1683669189393,POLI 170A,A00,188945,Staff,11,0,30,19
